fra;vaccin;jour;n_dose1;n_dose2;n_cum_dose1;n_cum_dose2
FR;1;2020-12-27;21;0;21;0
FR;1;2020-12-28;76;0;97;0
FR;1;2020-12-29;108;0;205;0
FR;1;2020-12-30;125;0;330;0
FR;1;2020-12-31;88;0;418;0
FR;1;2021-01-01;76;0;494;0
FR;1;2021-01-02;91;0;585;0
FR;1;2021-01-03;99;0;684;0
FR;1;2021-01-04;1483;0;2167;0
FR;1;2021-01-05;5433;0;7600;0
FR;1;2021-01-06;11336;0;18936;0
FR;1;2021-01-07;28683;0;47619;0
FR;1;2021-01-08;36366;0;83985;0
FR;1;2021-01-09;10964;0;94949;0
FR;1;2021-01-10;5652;0;100601;0
FR;1;2021-01-11;39175;0;139776;0
FR;1;2021-01-12;61097;0;200873;0
FR;1;2021-01-13;64016;0;264889;0
FR;1;2021-01-14;80005;0;344894;0
FR;1;2021-01-15;67478;0;412372;0
FR;1;2021-01-16;19600;78;431972;78
FR;1;2021-01-17;10490;42;442462;120
FR;1;2021-01-18;81668;162;524130;282
FR;1;2021-01-19;124217;126;648347;408
FR;1;2021-01-20;130627;157;778974;565
FR;1;2021-01-21;150676;135;929650;700
FR;1;2021-01-22;114180;162;1043830;862
FR;1;2021-01-23;36165;50;1079995;912
FR;1;2021-01-24;9283;27;1089278;939
FR;1;2021-01-25;73412;1219;1162690;2158
FR;1;2021-01-26;95249;3112;1257939;5270
FR;1;2021-01-27;102393;5596;1360332;10866
FR;1;2021-01-28;119121;14362;1479453;25228
FR;1;2021-01-29;87976;17284;1567429;42512
FR;1;2021-01-30;27649;4226;1595078;46738
FR;1;2021-01-31;4883;1679;1599961;48417
FR;1;2021-02-01;48426;21127;1648387;69544
FR;1;2021-02-02;66509;34565;1714896;104109
FR;1;2021-02-03;66081;36961;1780977;141070
FR;1;2021-02-04;76029;50063;1857006;191133
FR;1;2021-02-05;62648;45340;1919654;236473
FR;1;2021-02-06;19102;10398;1938756;246871
FR;1;2021-02-07;3438;5042;1942194;251913
FR;1;2021-02-08;35914;45981;1978108;297894
FR;1;2021-02-09;50006;72398;2028114;370292
FR;1;2021-02-10;51009;76705;2079123;446997
FR;1;2021-02-11;62396;99093;2141519;546090
FR;1;2021-02-12;55023;73986;2196542;620076
FR;1;2021-02-13;15191;19270;2211733;639346
FR;1;2021-02-14;3437;7191;2215170;646537
FR;1;2021-02-15;23664;73449;2238834;719986
FR;1;2021-02-16;32187;96867;2271021;816853
FR;1;2021-02-17;34490;98592;2305511;915445
FR;1;2021-02-18;48361;113444;2353872;1028889
FR;1;2021-02-19;44633;86439;2398505;1115328
FR;1;2021-02-20;13081;26921;2411586;1142249
FR;1;2021-02-21;2124;6286;2413710;1148535
FR;1;2021-02-22;24141;69429;2437851;1217964
FR;1;2021-02-23;36781;80373;2474632;1298337
FR;1;2021-02-24;39529;77656;2514161;1375993
FR;1;2021-02-25;49181;87975;2563342;1463968
FR;1;2021-02-26;46301;67890;2609643;1531858
FR;1;2021-02-27;15256;20932;2624899;1552790
FR;1;2021-02-28;3238;4386;2628137;1557176
FR;1;2021-03-01;38851;49020;2666988;1606196
FR;1;2021-03-02;54820;61513;2721808;1667709
FR;1;2021-03-03;59742;60654;2781550;1728363
FR;1;2021-03-04;71462;64901;2853012;1793264
FR;1;2021-03-05;73378;59249;2926390;1852513
FR;1;2021-03-06;81532;16090;3007922;1868603
FR;1;2021-03-07;63019;5415;3070941;1874018
FR;1;2021-03-08;58989;42470;3129930;1916488
FR;1;2021-03-09;84655;48320;3214585;1964808
FR;1;2021-03-10;89280;48073;3303865;2012881
FR;1;2021-03-11;103479;53858;3407344;2066739
FR;1;2021-03-12;102459;45291;3509803;2112030
FR;1;2021-03-13;87946;12746;3597749;2124776
FR;1;2021-03-14;43760;3031;3641509;2127807
FR;1;2021-03-15;94097;29128;3735606;2156935
FR;1;2021-03-16;122190;34895;3857796;2191830
FR;1;2021-03-17;127835;34836;3985631;2226666
FR;1;2021-03-18;141305;39720;4126936;2266386
FR;1;2021-03-19;134616;32909;4261552;2299295
FR;1;2021-03-20;75107;10209;4336659;2309504
FR;1;2021-03-21;25800;2476;4362459;2311980
FR;1;2021-03-22;113180;31184;4475639;2343164
FR;1;2021-03-23;141315;38179;4616954;2381343
FR;1;2021-03-24;140247;38778;4757201;2420121
FR;1;2021-03-25;163202;39630;4920403;2459751
FR;1;2021-03-26;164882;37502;5085285;2497253
FR;1;2021-03-27;110028;15255;5195313;2512508
FR;1;2021-03-28;41759;3621;5237072;2516129
FR;1;2021-03-29;128586;49962;5365658;2566091
FR;1;2021-03-30;165972;63598;5531630;2629689
FR;1;2021-03-31;169241;66905;5700871;2696594
FR;1;2021-04-01;191745;79268;5892616;2775862
FR;1;2021-04-02;162755;84323;6055371;2860185
FR;1;2021-04-03;87260;58179;6142631;2918364
FR;1;2021-04-04;32369;17733;6175000;2936097
FR;1;2021-04-05;42472;10176;6217472;2946273
FR;1;2021-04-06;158026;100892;6375498;3047165
FR;1;2021-04-07;194579;108265;6570077;3155430
FR;1;2021-04-08;219189;112393;6789266;3267823
FR;1;2021-04-09;212050;107513;7001316;3375336
FR;1;2021-04-10;116045;73459;7117361;3448795
FR;1;2021-04-11;40066;30286;7157427;3479081
FR;1;2021-04-12;166717;103793;7324144;3582874
FR;1;2021-04-13;201471;128256;7525615;3711130
FR;1;2021-04-14;205828;122814;7731443;3833944
FR;1;2021-04-15;218601;126762;7950044;3960706
FR;1;2021-04-16;204136;125148;8154180;4085854
FR;1;2021-04-17;121051;67486;8275231;4153340
FR;1;2021-04-18;35263;20993;8310494;4174333
FR;1;2021-04-19;162040;121926;8472534;4296259
FR;1;2021-04-20;187365;148781;8659899;4445040
FR;1;2021-04-21;191862;146720;8851761;4591760
FR;1;2021-04-22;206648;162654;9058409;4754414
FR;1;2021-04-23;196984;156936;9255393;4911350
FR;1;2021-04-24;125111;95512;9380504;5006862
FR;1;2021-04-25;52919;30141;9433423;5037003
FR;1;2021-04-26;179448;138284;9612871;5175287
FR;1;2021-04-27;219249;162001;9832120;5337288
FR;1;2021-04-28;236323;155123;10068443;5492411
FR;1;2021-04-29;267811;160083;10336254;5652494
FR;1;2021-04-30;269521;148165;10605775;5800659
FR;1;2021-05-01;138478;40713;10744253;5841372
FR;1;2021-05-02;80554;28156;10824807;5869528
FR;1;2021-05-03;247572;146483;11072379;6016011
FR;1;2021-05-04;262860;186854;11335239;6202865
FR;1;2021-05-05;279694;184586;11614933;6387451
FR;1;2021-05-06;306139;183052;11921072;6570503
FR;1;2021-05-07;281226;195745;12202298;6766248
FR;1;2021-05-08;189579;48345;12391877;6814593
FR;1;2021-05-09;113201;36221;12505078;6850814
FR;1;2021-05-10;253668;194285;12758746;7045099
FR;1;2021-05-11;315445;211422;13074191;7256521
FR;1;2021-05-12;352182;185925;13426373;7442446
FR;1;2021-05-13;279812;47658;13706185;7490104
FR;1;2021-05-14;366462;128911;14072647;7619015
FR;1;2021-05-15;294279;66159;14366926;7685174
FR;1;2021-05-16;156369;15583;14523295;7700757
FR;1;2021-05-17;315839;116710;14839134;7817467
FR;1;2021-05-18;378482;111355;15217616;7928822
FR;1;2021-05-19;391309;102933;15608925;8031755
FR;1;2021-05-20;416557;96333;16025482;8128088
FR;1;2021-05-21;395377;97402;16420859;8225490
FR;1;2021-05-22;273537;42111;16694396;8267601
FR;1;2021-05-23;121981;11218;16816377;8278819
FR;1;2021-05-24;241361;26328;17057738;8305147
FR;1;2021-05-25;361966;131969;17419704;8437116
FR;1;2021-05-26;374598;125768;17794302;8562884
FR;1;2021-05-27;401325;128320;18195627;8691204
FR;1;2021-05-28;361493;145637;18557120;8836841
FR;1;2021-05-29;251228;81047;18808348;8917888
FR;1;2021-05-30;99406;22603;18907754;8940491
FR;1;2021-05-31;310212;148917;19217966;9089408
FR;1;2021-06-01;347607;166933;19565573;9256341
FR;1;2021-06-02;349701;153455;19915274;9409796
FR;1;2021-06-03;379686;147878;20294960;9557674
FR;1;2021-06-04;352567;175776;20647527;9733450
FR;1;2021-06-05;253772;112858;20901299;9846308
FR;1;2021-06-06;123620;37565;21024919;9883873
FR;1;2021-06-07;291857;208340;21316776;10092213
FR;1;2021-06-08;321108;221231;21637884;10313444
FR;1;2021-06-09;327159;212799;21965043;10526243
FR;1;2021-06-10;329876;202481;22294919;10728724
FR;1;2021-06-11;303138;235657;22598057;10964381
FR;1;2021-06-12;238772;150966;22836829;11115347
FR;1;2021-06-13;97579;61121;22934408;11176468
FR;1;2021-06-14;199036;289307;23133444;11465775
FR;1;2021-06-15;245540;282724;23378984;11748499
FR;1;2021-06-16;264677;270736;23643661;12019235
FR;1;2021-06-17;259797;244664;23903458;12263899
FR;1;2021-06-18;249791;296296;24153249;12560195
FR;1;2021-06-19;188917;209801;24342166;12769996
FR;1;2021-06-20;67343;89242;24409509;12859238
FR;1;2021-06-21;164677;320308;24574186;13179546
FR;1;2021-06-22;178194;347959;24752380;13527505
FR;1;2021-06-23;196242;339719;24948622;13867224
FR;1;2021-06-24;194002;282061;25142624;14149285
FR;1;2021-06-25;174709;372243;25317333;14521528
FR;1;2021-06-26;127925;278624;25445258;14800152
FR;1;2021-06-27;50887;123107;25496145;14923259
FR;1;2021-06-28;130144;368691;25626289;15291950
FR;1;2021-06-29;148099;389692;25774388;15681642
FR;1;2021-06-30;171525;378437;25945913;16060079
FR;1;2021-07-01;179539;332493;26125452;16392572
FR;1;2021-07-02;173528;368118;26298980;16760690
FR;1;2021-07-03;120040;280808;26419020;17041498
FR;1;2021-07-04;51808;113830;26470828;17155328
FR;1;2021-07-05;141751;356494;26612579;17511822
FR;1;2021-07-06;162852;383004;26775431;17894826
FR;2;2020-12-27;0;0;0;0
FR;2;2020-12-28;0;0;0;0
FR;2;2020-12-29;0;0;0;0
FR;2;2020-12-30;0;0;0;0
FR;2;2020-12-31;0;0;0;0
FR;2;2021-01-01;0;0;0;0
FR;2;2021-01-02;0;0;0;0
FR;2;2021-01-03;0;0;0;0
FR;2;2021-01-04;0;0;0;0
FR;2;2021-01-05;0;0;0;0
FR;2;2021-01-06;0;0;0;0
FR;2;2021-01-07;0;0;0;0
FR;2;2021-01-08;0;0;0;0
FR;2;2021-01-09;0;0;0;0
FR;2;2021-01-10;0;0;0;0
FR;2;2021-01-11;0;0;0;0
FR;2;2021-01-12;0;0;0;0
FR;2;2021-01-13;0;0;0;0
FR;2;2021-01-14;153;0;153;0
FR;2;2021-01-15;218;0;371;0
FR;2;2021-01-16;185;0;556;0
FR;2;2021-01-17;4;0;560;0
FR;2;2021-01-18;2917;0;3477;0
FR;2;2021-01-19;4524;0;8001;0
FR;2;2021-01-20;4924;0;12925;0
FR;2;2021-01-21;5132;0;18057;0
FR;2;2021-01-22;4884;0;22941;0
FR;2;2021-01-23;1737;0;24678;0
FR;2;2021-01-24;102;0;24780;0
FR;2;2021-01-25;3642;0;28422;0
FR;2;2021-01-26;3756;0;32178;0
FR;2;2021-01-27;3445;0;35623;0
FR;2;2021-01-28;3517;0;39140;0
FR;2;2021-01-29;3083;0;42223;0
FR;2;2021-01-30;1064;0;43287;0
FR;2;2021-01-31;0;0;43287;0
FR;2;2021-02-01;3264;0;46551;0
FR;2;2021-02-02;4310;0;50861;0
FR;2;2021-02-03;5034;0;55895;0
FR;2;2021-02-04;4735;3;60630;3
FR;2;2021-02-05;4622;6;65252;9
FR;2;2021-02-06;1932;3;67184;12
FR;2;2021-02-07;42;0;67226;12
FR;2;2021-02-08;7428;8;74654;20
FR;2;2021-02-09;8265;15;82919;35
FR;2;2021-02-10;9144;49;92063;84
FR;2;2021-02-11;10060;67;102123;151
FR;2;2021-02-12;9818;238;111941;389
FR;2;2021-02-13;3021;222;114962;611
FR;2;2021-02-14;296;0;115258;611
FR;2;2021-02-15;3359;3067;118617;3678
FR;2;2021-02-16;4921;3881;123538;7559
FR;2;2021-02-17;4109;4402;127647;11961
FR;2;2021-02-18;5244;5089;132891;17050
FR;2;2021-02-19;5219;4323;138110;21373
FR;2;2021-02-20;1765;1509;139875;22882
FR;2;2021-02-21;199;86;140074;22968
FR;2;2021-02-22;3539;3723;143613;26691
FR;2;2021-02-23;4838;3693;148451;30384
FR;2;2021-02-24;4776;3468;153227;33852
FR;2;2021-02-25;5292;3426;158519;37278
FR;2;2021-02-26;4197;3125;162716;40403
FR;2;2021-02-27;1504;1042;164220;41445
FR;2;2021-02-28;100;28;164320;41473
FR;2;2021-03-01;4967;3764;169287;45237
FR;2;2021-03-02;6313;4727;175600;49964
FR;2;2021-03-03;6249;4883;181849;54847
FR;2;2021-03-04;8080;3967;189929;58814
FR;2;2021-03-05;7773;4060;197702;62874
FR;2;2021-03-06;4622;1683;202324;64557
FR;2;2021-03-07;2284;29;204608;64586
FR;2;2021-03-08;3978;8311;208586;72897
FR;2;2021-03-09;7274;8430;215860;81327
FR;2;2021-03-10;6864;9108;222724;90435
FR;2;2021-03-11;9093;9208;231817;99643
FR;2;2021-03-12;7724;8162;239541;107805
FR;2;2021-03-13;9879;2511;249420;110316
FR;2;2021-03-14;4754;402;254174;110718
FR;2;2021-03-15;10655;3484;264829;114202
FR;2;2021-03-16;16465;4621;281294;118823
FR;2;2021-03-17;19905;3953;301199;122776
FR;2;2021-03-18;22962;4910;324161;127686
FR;2;2021-03-19;22896;4537;347057;132223
FR;2;2021-03-20;25162;1540;372219;133763
FR;2;2021-03-21;17478;147;389697;133910
FR;2;2021-03-22;17412;3079;407109;136989
FR;2;2021-03-23;22286;4184;429395;141173
FR;2;2021-03-24;23560;4987;452955;146160
FR;2;2021-03-25;26293;5020;479248;151180
FR;2;2021-03-26;26596;4262;505844;155442
FR;2;2021-03-27;15642;1308;521486;156750
FR;2;2021-03-28;10399;92;531885;156842
FR;2;2021-03-29;18665;4281;550550;161123
FR;2;2021-03-30;24191;6020;574741;167143
FR;2;2021-03-31;28150;5955;602891;173098
FR;2;2021-04-01;34010;8479;636901;181577
FR;2;2021-04-02;29567;7687;666468;189264
FR;2;2021-04-03;16741;3583;683209;192847
FR;2;2021-04-04;9164;919;692373;193766
FR;2;2021-04-05;12134;811;704507;194577
FR;2;2021-04-06;26779;6927;731286;201504
FR;2;2021-04-07;30600;7157;761886;208661
FR;2;2021-04-08;36512;8819;798398;217480
FR;2;2021-04-09;33407;8597;831805;226077
FR;2;2021-04-10;19463;8969;851268;235046
FR;2;2021-04-11;7820;4271;859088;239317
FR;2;2021-04-12;16814;11254;875902;250571
FR;2;2021-04-13;19126;16426;895028;266997
FR;2;2021-04-14;17680;16280;912708;283277
FR;2;2021-04-15;21870;20757;934578;304034
FR;2;2021-04-16;20409;20078;954987;324112
FR;2;2021-04-17;13061;22462;968048;346574
FR;2;2021-04-18;5791;14403;973839;360977
FR;2;2021-04-19;16496;16255;990335;377232
FR;2;2021-04-20;18997;21591;1009332;398823
FR;2;2021-04-21;19854;21666;1029186;420489
FR;2;2021-04-22;23424;24859;1052610;445348
FR;2;2021-04-23;24232;25351;1076842;470699
FR;2;2021-04-24;25109;15107;1101951;485806
FR;2;2021-04-25;9501;8589;1111452;494395
FR;2;2021-04-26;16923;17199;1128375;511594
FR;2;2021-04-27;19030;24308;1147405;535902
FR;2;2021-04-28;22065;26184;1169470;562086
FR;2;2021-04-29;25213;30133;1194683;592219
FR;2;2021-04-30;25350;27779;1220033;619998
FR;2;2021-05-01;14817;9861;1234850;629859
FR;2;2021-05-02;6532;9184;1241382;639043
FR;2;2021-05-03;19684;19324;1261066;658367
FR;2;2021-05-04;18067;29058;1279133;687425
FR;2;2021-05-05;18015;29410;1297148;716835
FR;2;2021-05-06;23246;35291;1320394;752126
FR;2;2021-05-07;24902;33240;1345296;785366
FR;2;2021-05-08;21047;9702;1366343;795068
FR;2;2021-05-09;13034;7893;1379377;802961
FR;2;2021-05-10;32572;22219;1411949;825180
FR;2;2021-05-11;43189;21074;1455138;846254
FR;2;2021-05-12;49432;19902;1504570;866156
FR;2;2021-05-13;50833;5768;1555403;871924
FR;2;2021-05-14;60899;12955;1616302;884879
FR;2;2021-05-15;65491;7151;1681793;892030
FR;2;2021-05-16;43270;2576;1725063;894606
FR;2;2021-05-17;44327;12589;1769390;907195
FR;2;2021-05-18;54111;12245;1823501;919440
FR;2;2021-05-19;56666;10619;1880167;930059
FR;2;2021-05-20;62857;10877;1943024;940936
FR;2;2021-05-21;63730;11670;2006754;952606
FR;2;2021-05-22;61132;4514;2067886;957120
FR;2;2021-05-23;37199;570;2105085;957690
FR;2;2021-05-24;16916;2028;2122001;959718
FR;2;2021-05-25;20687;12240;2142688;971958
FR;2;2021-05-26;19272;11465;2161960;983423
FR;2;2021-05-27;22513;12671;2184473;996094
FR;2;2021-05-28;28889;14983;2213362;1011077
FR;2;2021-05-29;30066;8189;2243428;1019266
FR;2;2021-05-30;4498;1812;2247926;1021078
FR;2;2021-05-31;28153;18759;2276079;1039837
FR;2;2021-06-01;44720;20077;2320799;1059914
FR;2;2021-06-02;36709;19315;2357508;1079229
FR;2;2021-06-03;50477;23400;2407985;1102629
FR;2;2021-06-04;64659;24102;2472644;1126731
FR;2;2021-06-05;34035;24045;2506679;1150776
FR;2;2021-06-06;4743;6204;2511422;1156980
FR;2;2021-06-07;27623;23106;2539045;1180086
FR;2;2021-06-08;45481;22964;2584526;1203050
FR;2;2021-06-09;33596;20916;2618122;1223966
FR;2;2021-06-10;41531;19162;2659653;1243128
FR;2;2021-06-11;54342;25253;2713995;1268381
FR;2;2021-06-12;29990;19820;2743985;1288201
FR;2;2021-06-13;3125;9190;2747110;1297391
FR;2;2021-06-14;24676;24197;2771786;1321588
FR;2;2021-06-15;38254;22898;2810040;1344486
FR;2;2021-06-16;29541;21550;2839581;1366036
FR;2;2021-06-17;36177;25909;2875758;1391945
FR;2;2021-06-18;45954;28803;2921712;1420748
FR;2;2021-06-19;24085;24925;2945797;1445673
FR;2;2021-06-20;2605;10075;2948402;1455748
FR;2;2021-06-21;16858;42783;2965260;1498531
FR;2;2021-06-22;27742;49636;2993002;1548167
FR;2;2021-06-23;21202;49641;3014204;1597808
FR;2;2021-06-24;27731;50324;3041935;1648132
FR;2;2021-06-25;32681;60444;3074616;1708576
FR;2;2021-06-26;15981;59355;3090597;1767931
FR;2;2021-06-27;2432;29369;3093029;1797300
FR;2;2021-06-28;12211;54393;3105240;1851693
FR;2;2021-06-29;19359;59875;3124599;1911568
FR;2;2021-06-30;15851;57776;3140450;1969344
FR;2;2021-07-01;19250;59929;3159700;2029273
FR;2;2021-07-02;22899;62231;3182599;2091504
FR;2;2021-07-03;11546;57119;3194145;2148623
FR;2;2021-07-04;1819;23337;3195964;2171960
FR;2;2021-07-05;8360;29378;3204324;2201338
FR;2;2021-07-06;13595;36227;3217919;2237565
FR;3;2020-12-27;0;0;0;0
FR;3;2020-12-28;0;0;0;0
FR;3;2020-12-29;0;0;0;0
FR;3;2020-12-30;0;0;0;0
FR;3;2020-12-31;0;0;0;0
FR;3;2021-01-01;0;0;0;0
FR;3;2021-01-02;0;0;0;0
FR;3;2021-01-03;0;0;0;0
FR;3;2021-01-04;0;0;0;0
FR;3;2021-01-05;0;0;0;0
FR;3;2021-01-06;0;0;0;0
FR;3;2021-01-07;0;0;0;0
FR;3;2021-01-08;0;0;0;0
FR;3;2021-01-09;0;0;0;0
FR;3;2021-01-10;0;0;0;0
FR;3;2021-01-11;0;0;0;0
FR;3;2021-01-12;0;0;0;0
FR;3;2021-01-13;0;0;0;0
FR;3;2021-01-14;0;0;0;0
FR;3;2021-01-15;0;0;0;0
FR;3;2021-01-16;0;0;0;0
FR;3;2021-01-17;0;0;0;0
FR;3;2021-01-18;0;0;0;0
FR;3;2021-01-19;0;0;0;0
FR;3;2021-01-20;0;0;0;0
FR;3;2021-01-21;0;0;0;0
FR;3;2021-01-22;0;0;0;0
FR;3;2021-01-23;0;0;0;0
FR;3;2021-01-24;0;0;0;0
FR;3;2021-01-25;0;0;0;0
FR;3;2021-01-26;0;0;0;0
FR;3;2021-01-27;0;0;0;0
FR;3;2021-01-28;0;0;0;0
FR;3;2021-01-29;0;0;0;0
FR;3;2021-01-30;0;0;0;0
FR;3;2021-01-31;0;0;0;0
FR;3;2021-02-01;0;0;0;0
FR;3;2021-02-02;0;0;0;0
FR;3;2021-02-03;0;0;0;0
FR;3;2021-02-04;0;0;0;0
FR;3;2021-02-05;0;0;0;0
FR;3;2021-02-06;347;0;347;0
FR;3;2021-02-07;1349;0;1696;0
FR;3;2021-02-08;2634;0;4330;0
FR;3;2021-02-09;6649;0;10979;0
FR;3;2021-02-10;9264;0;20243;0
FR;3;2021-02-11;13379;0;33622;0
FR;3;2021-02-12;13075;0;46697;0
FR;3;2021-02-13;3522;0;50219;0
FR;3;2021-02-14;870;0;51089;0
FR;3;2021-02-15;10149;0;61238;0
FR;3;2021-02-16;12210;0;73448;0
FR;3;2021-02-17;10846;0;84294;0
FR;3;2021-02-18;14621;0;98915;0
FR;3;2021-02-19;14146;0;113061;0
FR;3;2021-02-20;3188;0;116249;0
FR;3;2021-02-21;549;0;116798;0
FR;3;2021-02-22;8932;0;125730;0
FR;3;2021-02-23;11132;0;136862;0
FR;3;2021-02-24;13947;0;150809;0
FR;3;2021-02-25;44502;0;195311;0
FR;3;2021-02-26;61505;0;256816;0
FR;3;2021-02-27;34538;7;291354;7
FR;3;2021-02-28;2356;0;293710;7
FR;3;2021-03-01;20003;9;313713;16
FR;3;2021-03-02;38431;13;352144;29
FR;3;2021-03-03;48063;16;400207;45
FR;3;2021-03-04;81460;19;481667;64
FR;3;2021-03-05;117338;56;599005;120
FR;3;2021-03-06;119687;49;718692;169
FR;3;2021-03-07;54742;27;773434;196
FR;3;2021-03-08;42272;20;815706;216
FR;3;2021-03-09;78277;30;893983;246
FR;3;2021-03-10;80111;38;974094;284
FR;3;2021-03-11;127590;46;1101684;330
FR;3;2021-03-12;181735;67;1283419;397
FR;3;2021-03-13;131412;53;1414831;450
FR;3;2021-03-14;13839;4;1428670;454
FR;3;2021-03-15;51639;37;1480309;491
FR;3;2021-03-16;950;13;1481259;504
FR;3;2021-03-17;692;6;1481951;510
FR;3;2021-03-18;1248;4;1483199;514
FR;3;2021-03-19;69909;36;1553108;550
FR;3;2021-03-20;64781;35;1617889;585
FR;3;2021-03-21;5543;4;1623432;589
FR;3;2021-03-22;37040;32;1660472;621
FR;3;2021-03-23;83982;49;1744454;670
FR;3;2021-03-24;90347;91;1834801;761
FR;3;2021-03-25;149357;114;1984158;875
FR;3;2021-03-26;164738;154;2148896;1029
FR;3;2021-03-27;68003;88;2216899;1117
FR;3;2021-03-28;6279;19;2223178;1136
FR;3;2021-03-29;53738;59;2276916;1195
FR;3;2021-03-30;92672;87;2369588;1282
FR;3;2021-03-31;63011;82;2432599;1364
FR;3;2021-04-01;85507;102;2518106;1466
FR;3;2021-04-02;86446;143;2604552;1609
FR;3;2021-04-03;35545;109;2640097;1718
FR;3;2021-04-04;3433;15;2643530;1733
FR;3;2021-04-05;4311;21;2647841;1754
FR;3;2021-04-06;29292;75;2677133;1829
FR;3;2021-04-07;31824;59;2708957;1888
FR;3;2021-04-08;78242;234;2787199;2122
FR;3;2021-04-09;161076;405;2948275;2527
FR;3;2021-04-10;75205;330;3023480;2857
FR;3;2021-04-11;7111;42;3030591;2899
FR;3;2021-04-12;50950;195;3081541;3094
FR;3;2021-04-13;85623;312;3167164;3406
FR;3;2021-04-14;67097;339;3234261;3745
FR;3;2021-04-15;92257;366;3326518;4111
FR;3;2021-04-16;111721;569;3438239;4680
FR;3;2021-04-17;52725;325;3490964;5005
FR;3;2021-04-18;9503;32;3500467;5037
FR;3;2021-04-19;24638;231;3525105;5268
FR;3;2021-04-20;45041;392;3570146;5660
FR;3;2021-04-21;38286;446;3608432;6106
FR;3;2021-04-22;53985;787;3662417;6893
FR;3;2021-04-23;69769;1016;3732186;7909
FR;3;2021-04-24;36730;971;3768916;8880
FR;3;2021-04-25;5945;154;3774861;9034
FR;3;2021-04-26;19224;656;3794085;9690
FR;3;2021-04-27;33870;1245;3827955;10935
FR;3;2021-04-28;28376;1926;3856331;12861
FR;3;2021-04-29;44704;5955;3901035;18816
FR;3;2021-04-30;54757;8929;3955792;27745
FR;3;2021-05-01;9215;1968;3965007;29713
FR;3;2021-05-02;2820;499;3967827;30212
FR;3;2021-05-03;12583;3881;3980410;34093
FR;3;2021-05-04;22549;8444;4002959;42537
FR;3;2021-05-05;18100;10574;4021059;53111
FR;3;2021-05-06;33929;20905;4054988;74016
FR;3;2021-05-07;43465;28402;4098453;102418
FR;3;2021-05-08;6392;8892;4104845;111310
FR;3;2021-05-09;1601;2653;4106446;113963
FR;3;2021-05-10;14462;12563;4120908;126526
FR;3;2021-05-11;26461;25730;4147369;152256
FR;3;2021-05-12;16749;27451;4164118;179707
FR;3;2021-05-13;2022;3485;4166140;183192
FR;3;2021-05-14;14100;25743;4180240;208935
FR;3;2021-05-15;6923;20731;4187163;229666
FR;3;2021-05-16;830;2678;4187993;232344
FR;3;2021-05-17;7531;19912;4195524;252256
FR;3;2021-05-18;12931;29632;4208455;281888
FR;3;2021-05-19;8839;31862;4217294;313750
FR;3;2021-05-20;12313;53218;4229607;366968
FR;3;2021-05-21;12295;65538;4241902;432506
FR;3;2021-05-22;4678;33298;4246580;465804
FR;3;2021-05-23;540;2665;4247120;468469
FR;3;2021-05-24;597;4920;4247717;473389
FR;3;2021-05-25;4972;45173;4252689;518562
FR;3;2021-05-26;4596;51055;4257285;569617
FR;3;2021-05-27;5955;77844;4263240;647461
FR;3;2021-05-28;7164;99107;4270404;746568
FR;3;2021-05-29;3083;60285;4273487;806853
FR;3;2021-05-30;382;8243;4273869;815096
FR;3;2021-05-31;2086;35996;4275955;851092
FR;3;2021-06-01;2979;64818;4278934;915910
FR;3;2021-06-02;2377;58358;4281311;974268
FR;3;2021-06-03;3188;87583;4284499;1061851
FR;3;2021-06-04;3849;105128;4288348;1166979
FR;3;2021-06-05;1784;52247;4290132;1219226
FR;3;2021-06-06;261;5399;4290393;1224625
FR;3;2021-06-07;1101;31182;4291494;1255807
FR;3;2021-06-08;1723;47284;4293217;1303091
FR;3;2021-06-09;1438;42397;4294655;1345488
FR;3;2021-06-10;1846;68008;4296501;1413496
FR;3;2021-06-11;2218;96807;4298719;1510303
FR;3;2021-06-12;1006;40841;4299725;1551144
FR;3;2021-06-13;139;3823;4299864;1554967
FR;3;2021-06-14;755;42669;4300619;1597636
FR;3;2021-06-15;1171;80698;4301790;1678334
FR;3;2021-06-16;1040;65788;4302830;1744122
FR;3;2021-06-17;1443;101860;4304273;1845982
FR;3;2021-06-18;1725;117932;4305998;1963914
FR;3;2021-06-19;706;39407;4306704;2003321
FR;3;2021-06-20;76;3384;4306780;2006705
FR;3;2021-06-21;559;39289;4307339;2045994
FR;3;2021-06-22;893;70024;4308232;2116018
FR;3;2021-06-23;759;50854;4308991;2166872
FR;3;2021-06-24;1149;77224;4310140;2244096
FR;3;2021-06-25;1258;89981;4311398;2334077
FR;3;2021-06-26;542;33139;4311940;2367216
FR;3;2021-06-27;94;4029;4312034;2371245
FR;3;2021-06-28;468;30463;4312502;2401708
FR;3;2021-06-29;728;56137;4313230;2457845
FR;3;2021-06-30;733;45048;4313963;2502893
FR;3;2021-07-01;993;65674;4314956;2568567
FR;3;2021-07-02;1173;90458;4316129;2659025
FR;3;2021-07-03;548;31195;4316677;2690220
FR;3;2021-07-04;80;4275;4316757;2694495
FR;3;2021-07-05;475;33937;4317232;2728432
FR;3;2021-07-06;776;56133;4318008;2784565
FR;4;2020-12-27;0;0;0;0
FR;4;2020-12-28;0;0;0;0
FR;4;2020-12-29;0;0;0;0
FR;4;2020-12-30;0;0;0;0
FR;4;2020-12-31;0;0;0;0
FR;4;2021-01-01;0;0;0;0
FR;4;2021-01-02;0;0;0;0
FR;4;2021-01-03;0;0;0;0
FR;4;2021-01-04;0;0;0;0
FR;4;2021-01-05;0;0;0;0
FR;4;2021-01-06;0;0;0;0
FR;4;2021-01-07;0;0;0;0
FR;4;2021-01-08;0;0;0;0
FR;4;2021-01-09;0;0;0;0
FR;4;2021-01-10;0;0;0;0
FR;4;2021-01-11;0;0;0;0
FR;4;2021-01-12;0;0;0;0
FR;4;2021-01-13;0;0;0;0
FR;4;2021-01-14;0;0;0;0
FR;4;2021-01-15;0;0;0;0
FR;4;2021-01-16;0;0;0;0
FR;4;2021-01-17;0;0;0;0
FR;4;2021-01-18;0;0;0;0
FR;4;2021-01-19;0;0;0;0
FR;4;2021-01-20;0;0;0;0
FR;4;2021-01-21;0;0;0;0
FR;4;2021-01-22;0;0;0;0
FR;4;2021-01-23;0;0;0;0
FR;4;2021-01-24;0;0;0;0
FR;4;2021-01-25;0;0;0;0
FR;4;2021-01-26;0;0;0;0
FR;4;2021-01-27;0;0;0;0
FR;4;2021-01-28;0;0;0;0
FR;4;2021-01-29;0;0;0;0
FR;4;2021-01-30;0;0;0;0
FR;4;2021-01-31;0;0;0;0
FR;4;2021-02-01;0;0;0;0
FR;4;2021-02-02;0;0;0;0
FR;4;2021-02-03;0;0;0;0
FR;4;2021-02-04;0;0;0;0
FR;4;2021-02-05;0;0;0;0
FR;4;2021-02-06;0;0;0;0
FR;4;2021-02-07;0;0;0;0
FR;4;2021-02-08;0;0;0;0
FR;4;2021-02-09;0;0;0;0
FR;4;2021-02-10;0;0;0;0
FR;4;2021-02-11;0;0;0;0
FR;4;2021-02-12;0;0;0;0
FR;4;2021-02-13;0;0;0;0
FR;4;2021-02-14;0;0;0;0
FR;4;2021-02-15;0;0;0;0
FR;4;2021-02-16;0;0;0;0
FR;4;2021-02-17;0;0;0;0
FR;4;2021-02-18;0;0;0;0
FR;4;2021-02-19;0;0;0;0
FR;4;2021-02-20;0;0;0;0
FR;4;2021-02-21;0;0;0;0
FR;4;2021-02-22;0;0;0;0
FR;4;2021-02-23;0;0;0;0
FR;4;2021-02-24;0;0;0;0
FR;4;2021-02-25;0;0;0;0
FR;4;2021-02-26;0;0;0;0
FR;4;2021-02-27;0;0;0;0
FR;4;2021-02-28;0;0;0;0
FR;4;2021-03-01;0;0;0;0
FR;4;2021-03-02;0;0;0;0
FR;4;2021-03-03;0;0;0;0
FR;4;2021-03-04;0;0;0;0
FR;4;2021-03-05;0;0;0;0
FR;4;2021-03-06;0;0;0;0
FR;4;2021-03-07;0;0;0;0
FR;4;2021-03-08;0;0;0;0
FR;4;2021-03-09;0;0;0;0
FR;4;2021-03-10;0;0;0;0
FR;4;2021-03-11;0;0;0;0
FR;4;2021-03-12;0;0;0;0
FR;4;2021-03-13;0;0;0;0
FR;4;2021-03-14;0;0;0;0
FR;4;2021-03-15;0;0;0;0
FR;4;2021-03-16;0;0;0;0
FR;4;2021-03-17;0;0;0;0
FR;4;2021-03-18;0;0;0;0
FR;4;2021-03-19;0;0;0;0
FR;4;2021-03-20;0;0;0;0
FR;4;2021-03-21;0;0;0;0
FR;4;2021-03-22;0;0;0;0
FR;4;2021-03-23;0;0;0;0
FR;4;2021-03-24;0;0;0;0
FR;4;2021-03-25;0;0;0;0
FR;4;2021-03-26;0;0;0;0
FR;4;2021-03-27;0;0;0;0
FR;4;2021-03-28;0;0;0;0
FR;4;2021-03-29;0;0;0;0
FR;4;2021-03-30;0;0;0;0
FR;4;2021-03-31;0;0;0;0
FR;4;2021-04-01;0;0;0;0
FR;4;2021-04-02;0;0;0;0
FR;4;2021-04-03;0;0;0;0
FR;4;2021-04-04;0;0;0;0
FR;4;2021-04-05;0;0;0;0
FR;4;2021-04-06;0;0;0;0
FR;4;2021-04-07;0;0;0;0
FR;4;2021-04-08;0;0;0;0
FR;4;2021-04-09;0;1;0;1
FR;4;2021-04-10;0;0;0;1
FR;4;2021-04-11;0;0;0;1
FR;4;2021-04-12;0;0;0;1
FR;4;2021-04-13;0;0;0;1
FR;4;2021-04-14;0;0;0;1
FR;4;2021-04-15;0;0;0;1
FR;4;2021-04-16;0;0;0;1
FR;4;2021-04-17;0;0;0;1
FR;4;2021-04-18;0;0;0;1
FR;4;2021-04-19;0;0;0;1
FR;4;2021-04-20;0;0;0;1
FR;4;2021-04-21;0;0;0;1
FR;4;2021-04-22;0;0;0;1
FR;4;2021-04-23;866;0;866;1
FR;4;2021-04-24;1552;0;2418;1
FR;4;2021-04-25;117;0;2535;1
FR;4;2021-04-26;2835;0;5370;1
FR;4;2021-04-27;9398;4;14768;5
FR;4;2021-04-28;9788;3;24556;8
FR;4;2021-04-29;15899;7;40455;15
FR;4;2021-04-30;19093;7;59548;22
FR;4;2021-05-01;1904;5;61452;27
FR;4;2021-05-02;443;0;61895;27
FR;4;2021-05-03;4935;1;66830;28
FR;4;2021-05-04;8262;8;75092;36
FR;4;2021-05-05;6014;6;81106;42
FR;4;2021-05-06;11263;11;92369;53
FR;4;2021-05-07;18918;8;111287;61
FR;4;2021-05-08;2263;6;113550;67
FR;4;2021-05-09;630;2;114180;69
FR;4;2021-05-10;7099;8;121279;77
FR;4;2021-05-11;14138;12;135417;89
FR;4;2021-05-12;9975;14;145392;103
FR;4;2021-05-13;1447;3;146839;106
FR;4;2021-05-14;7598;8;154437;114
FR;4;2021-05-15;3599;9;158036;123
FR;4;2021-05-16;363;1;158399;124
FR;4;2021-05-17;4354;2;162753;126
FR;4;2021-05-18;8602;10;171355;136
FR;4;2021-05-19;5531;5;176886;141
FR;4;2021-05-20;9241;6;186127;147
FR;4;2021-05-21;12537;27;198664;174
FR;4;2021-05-22;4932;12;203596;186
FR;4;2021-05-23;429;2;204025;188
FR;4;2021-05-24;946;3;204971;191
FR;4;2021-05-25;7414;16;212385;207
FR;4;2021-05-26;7563;13;219948;220
FR;4;2021-05-27;14133;34;234081;254
FR;4;2021-05-28;26287;77;260368;331
FR;4;2021-05-29;11168;20;271536;351
FR;4;2021-05-30;859;2;272395;353
FR;4;2021-05-31;12443;19;284838;372
FR;4;2021-06-01;19862;40;304700;412
FR;4;2021-06-02;14234;33;318934;445
FR;4;2021-06-03;19173;23;338107;468
FR;4;2021-06-04;22156;45;360263;513
FR;4;2021-06-05;9520;28;369783;541
FR;4;2021-06-06;922;0;370705;541
FR;4;2021-06-07;8942;16;379647;557
FR;4;2021-06-08;14331;26;393978;583
FR;4;2021-06-09;11926;24;405904;607
FR;4;2021-06-10;15054;25;420958;632
FR;4;2021-06-11;16650;51;437608;683
FR;4;2021-06-12;7244;26;444852;709
FR;4;2021-06-13;838;8;445690;717
FR;4;2021-06-14;6434;22;452124;739
FR;4;2021-06-15;10632;31;462756;770
FR;4;2021-06-16;8659;13;471415;783
FR;4;2021-06-17;10591;27;482006;810
FR;4;2021-06-18;12091;38;494097;848
FR;4;2021-06-19;5377;24;499474;872
FR;4;2021-06-20;593;2;500067;874
FR;4;2021-06-21;4814;10;504881;884
FR;4;2021-06-22;7639;18;512520;902
FR;4;2021-06-23;6828;33;519348;935
FR;4;2021-06-24;8364;31;527712;966
FR;4;2021-06-25;9789;36;537501;1002
FR;4;2021-06-26;4547;18;542048;1020
FR;4;2021-06-27;569;2;542617;1022
FR;4;2021-06-28;4462;14;547079;1036
FR;4;2021-06-29;6620;15;553699;1051
FR;4;2021-06-30;6225;35;559924;1086
FR;4;2021-07-01;7538;20;567462;1106
FR;4;2021-07-02;8872;44;576334;1150
FR;4;2021-07-03;4498;17;580832;1167
FR;4;2021-07-04;530;5;581362;1172
FR;4;2021-07-05;4348;17;585710;1189
FR;4;2021-07-06;7160;19;592870;1208
FR;0;2020-12-27;21;0;21;0
FR;0;2020-12-28;76;0;97;0
FR;0;2020-12-29;108;0;205;0
FR;0;2020-12-30;125;0;330;0
FR;0;2020-12-31;88;0;418;0
FR;0;2021-01-01;76;0;494;0
FR;0;2021-01-02;91;0;585;0
FR;0;2021-01-03;99;0;684;0
FR;0;2021-01-04;1483;0;2167;0
FR;0;2021-01-05;5433;0;7600;0
FR;0;2021-01-06;11336;0;18936;0
FR;0;2021-01-07;28683;0;47619;0
FR;0;2021-01-08;36366;0;83985;0
FR;0;2021-01-09;10964;0;94949;0
FR;0;2021-01-10;5652;0;100601;0
FR;0;2021-01-11;39175;0;139776;0
FR;0;2021-01-12;61097;0;200873;0
FR;0;2021-01-13;64016;0;264889;0
FR;0;2021-01-14;80158;0;345047;0
FR;0;2021-01-15;67696;0;412743;0
FR;0;2021-01-16;19785;78;432528;78
FR;0;2021-01-17;10494;42;443022;120
FR;0;2021-01-18;84585;162;527607;282
FR;0;2021-01-19;128741;126;656348;408
FR;0;2021-01-20;135551;157;791899;565
FR;0;2021-01-21;155808;135;947707;700
FR;0;2021-01-22;119064;162;1066771;862
FR;0;2021-01-23;37902;50;1104673;912
FR;0;2021-01-24;9385;27;1114058;939
FR;0;2021-01-25;77054;1219;1191112;2158
FR;0;2021-01-26;99005;3112;1290117;5270
FR;0;2021-01-27;105838;5596;1395955;10866
FR;0;2021-01-28;122638;14362;1518593;25228
FR;0;2021-01-29;91059;17284;1609652;42512
FR;0;2021-01-30;28713;4226;1638365;46738
FR;0;2021-01-31;4883;1679;1643248;48417
FR;0;2021-02-01;51690;21127;1694938;69544
FR;0;2021-02-02;70819;34565;1765757;104109
FR;0;2021-02-03;71115;36961;1836872;141070
FR;0;2021-02-04;80764;50066;1917636;191136
FR;0;2021-02-05;67270;45346;1984906;236482
FR;0;2021-02-06;21381;10401;2006287;246883
FR;0;2021-02-07;4829;5042;2011116;251925
FR;0;2021-02-08;45976;45989;2057092;297914
FR;0;2021-02-09;64920;72413;2122012;370327
FR;0;2021-02-10;69417;76754;2191429;447081
FR;0;2021-02-11;85835;99160;2277264;546241
FR;0;2021-02-12;77916;74224;2355180;620465
FR;0;2021-02-13;21734;19492;2376914;639957
FR;0;2021-02-14;4603;7191;2381517;647148
FR;0;2021-02-15;37172;76516;2418689;723664
FR;0;2021-02-16;49318;100748;2468007;824412
FR;0;2021-02-17;49445;102994;2517452;927406
FR;0;2021-02-18;68226;118533;2585678;1045939
FR;0;2021-02-19;63998;90762;2649676;1136701
FR;0;2021-02-20;18034;28430;2667710;1165131
FR;0;2021-02-21;2872;6372;2670582;1171503
FR;0;2021-02-22;36612;73152;2707194;1244655
FR;0;2021-02-23;52751;84066;2759945;1328721
FR;0;2021-02-24;58252;81124;2818197;1409845
FR;0;2021-02-25;98975;91401;2917172;1501246
FR;0;2021-02-26;112003;71015;3029175;1572261
FR;0;2021-02-27;51298;21981;3080473;1594242
FR;0;2021-02-28;5694;4414;3086167;1598656
FR;0;2021-03-01;63821;52793;3149988;1651449
FR;0;2021-03-02;99564;66253;3249552;1717702
FR;0;2021-03-03;114054;65553;3363606;1783255
FR;0;2021-03-04;161002;68887;3524608;1852142
FR;0;2021-03-05;198489;63365;3723097;1915507
FR;0;2021-03-06;205841;17822;3928938;1933329
FR;0;2021-03-07;120045;5471;4048983;1938800
FR;0;2021-03-08;105239;50801;4154222;1989601
FR;0;2021-03-09;170206;56780;4324428;2046381
FR;0;2021-03-10;176255;57219;4500683;2103600
FR;0;2021-03-11;240162;63112;4740845;2166712
FR;0;2021-03-12;291918;53520;5032763;2220232
FR;0;2021-03-13;229237;15310;5262000;2235542
FR;0;2021-03-14;62353;3437;5324353;2238979
FR;0;2021-03-15;156391;32649;5480744;2271628
FR;0;2021-03-16;139605;39529;5620349;2311157
FR;0;2021-03-17;148432;38795;5768781;2349952
FR;0;2021-03-18;165515;44634;5934296;2394586
FR;0;2021-03-19;227421;37482;6161717;2432068
FR;0;2021-03-20;165050;11784;6326767;2443852
FR;0;2021-03-21;48821;2627;6375588;2446479
FR;0;2021-03-22;167632;34295;6543220;2480774
FR;0;2021-03-23;247583;42412;6790803;2523186
FR;0;2021-03-24;254154;43856;7044957;2567042
FR;0;2021-03-25;338852;44764;7383809;2611806
FR;0;2021-03-26;356216;41918;7740025;2653724
FR;0;2021-03-27;193673;16651;7933698;2670375
FR;0;2021-03-28;58437;3732;7992135;2674107
FR;0;2021-03-29;200989;54302;8193124;2728409
FR;0;2021-03-30;282835;69705;8475959;2798114
FR;0;2021-03-31;260402;72942;8736361;2871056
FR;0;2021-04-01;311262;87849;9047623;2958905
FR;0;2021-04-02;278768;92153;9326391;3051058
FR;0;2021-04-03;139546;61871;9465937;3112929
FR;0;2021-04-04;44966;18667;9510903;3131596
FR;0;2021-04-05;58917;11008;9569820;3142604
FR;0;2021-04-06;214097;107894;9783917;3250498
FR;0;2021-04-07;257003;115481;10040920;3365979
FR;0;2021-04-08;333943;121446;10374863;3487425
FR;0;2021-04-09;406533;116516;10781396;3603941
FR;0;2021-04-10;210713;82758;10992109;3686699
FR;0;2021-04-11;54997;34599;11047106;3721298
FR;0;2021-04-12;234481;115242;11281587;3836540
FR;0;2021-04-13;306220;144994;11587807;3981534
FR;0;2021-04-14;290605;139433;11878412;4120967
FR;0;2021-04-15;332728;147885;12211140;4268852
FR;0;2021-04-16;336266;145795;12547406;4414647
FR;0;2021-04-17;186837;90273;12734243;4504920
FR;0;2021-04-18;50557;35428;12784800;4540348
FR;0;2021-04-19;203174;138412;12987974;4678760
FR;0;2021-04-20;251403;170764;13239377;4849524
FR;0;2021-04-21;250002;168832;13489379;5018356
FR;0;2021-04-22;284057;188300;13773436;5206656
FR;0;2021-04-23;291851;183303;14065287;5389959
FR;0;2021-04-24;188502;111590;14253789;5501549
FR;0;2021-04-25;68482;38884;14322271;5540433
FR;0;2021-04-26;218430;156139;14540701;5696572
FR;0;2021-04-27;281547;187558;14822248;5884130
FR;0;2021-04-28;296552;183236;15118800;6067366
FR;0;2021-04-29;353627;196178;15472427;6263544
FR;0;2021-04-30;368721;184880;15841148;6448424
FR;0;2021-05-01;164414;52547;16005562;6500971
FR;0;2021-05-02;90349;37839;16095911;6538810
FR;0;2021-05-03;284774;169689;16380685;6708499
FR;0;2021-05-04;311738;224364;16692423;6932863
FR;0;2021-05-05;321823;224576;17014246;7157439
FR;0;2021-05-06;374577;239259;17388823;7396698
FR;0;2021-05-07;368511;257395;17757334;7654093
FR;0;2021-05-08;219281;66945;17976615;7721038
FR;0;2021-05-09;128466;46769;18105081;7767807
FR;0;2021-05-10;307801;229075;18412882;7996882
FR;0;2021-05-11;399233;258238;18812115;8255120
FR;0;2021-05-12;428338;233292;19240453;8488412
FR;0;2021-05-13;334114;56914;19574567;8545326
FR;0;2021-05-14;449059;167617;20023626;8712943
FR;0;2021-05-15;370292;94050;20393918;8806993
FR;0;2021-05-16;200832;20838;20594750;8827831
FR;0;2021-05-17;372051;149213;20966801;8977044
FR;0;2021-05-18;454126;153242;21420927;9130286
FR;0;2021-05-19;462345;145419;21883272;9275705
FR;0;2021-05-20;500968;160434;22384240;9436139
FR;0;2021-05-21;483939;174637;22868179;9610776
FR;0;2021-05-22;344279;79935;23212458;9690711
FR;0;2021-05-23;160149;14455;23372607;9705166
FR;0;2021-05-24;259820;33279;23632427;9738445
FR;0;2021-05-25;395039;189398;24027466;9927843
FR;0;2021-05-26;406029;188301;24433495;10116144
FR;0;2021-05-27;443926;218869;24877421;10335013
FR;0;2021-05-28;423833;259804;25301254;10594817
FR;0;2021-05-29;295545;149541;25596799;10744358
FR;0;2021-05-30;105145;32660;25701944;10777018
FR;0;2021-05-31;352894;203691;26054838;10980709
FR;0;2021-06-01;415168;251868;26470006;11232577
FR;0;2021-06-02;403021;231161;26873027;11463738
FR;0;2021-06-03;452524;258884;27325551;11722622
FR;0;2021-06-04;443231;305051;27768782;12027673
FR;0;2021-06-05;299111;189178;28067893;12216851
FR;0;2021-06-06;129546;49168;28197439;12266019
FR;0;2021-06-07;329523;262644;28526962;12528663
FR;0;2021-06-08;382643;291505;28909605;12820168
FR;0;2021-06-09;374119;276136;29283724;13096304
FR;0;2021-06-10;388307;289676;29672031;13385980
FR;0;2021-06-11;376348;357768;30048379;13743748
FR;0;2021-06-12;277012;211653;30325391;13955401
FR;0;2021-06-13;101681;74142;30427072;14029543
FR;0;2021-06-14;230901;356195;30657973;14385738
FR;0;2021-06-15;295597;386351;30953570;14772089
FR;0;2021-06-16;303917;358087;31257487;15130176
FR;0;2021-06-17;308008;372460;31565495;15502636
FR;0;2021-06-18;309561;443069;31875056;15945705
FR;0;2021-06-19;219085;274157;32094141;16219862
FR;0;2021-06-20;70617;102703;32164758;16322565
FR;0;2021-06-21;186908;402390;32351666;16724955
FR;0;2021-06-22;214468;467637;32566134;17192592
FR;0;2021-06-23;225031;440247;32791165;17632839
FR;0;2021-06-24;231246;409640;33022411;18042479
FR;0;2021-06-25;218437;522704;33240848;18565183
FR;0;2021-06-26;148995;371136;33389843;18936319
FR;0;2021-06-27;53982;156507;33443825;19092826
FR;0;2021-06-28;147285;453561;33591110;19546387
FR;0;2021-06-29;174806;505719;33765916;20052106
FR;0;2021-06-30;194334;481296;33960250;20533402
FR;0;2021-07-01;207320;458116;34167570;20991518
FR;0;2021-07-02;206472;520851;34374042;21512369
FR;0;2021-07-03;136632;369139;34510674;21881508
FR;0;2021-07-04;54237;141447;34564911;22022955
FR;0;2021-07-05;154934;419826;34719845;22442781
FR;0;2021-07-06;184383;475383;34904228;22918164
