fra;vaccin;jour;n_dose1;n_dose2;n_dose3;n_dose4;n_rappel;n_cum_dose1;n_cum_dose2;n_cum_dose3;n_cum_dose4;n_cum_rappel
FR;1;2020-12-27;597;0;0;0;0;597;0;0;0;0
FR;1;2020-12-28;651;0;0;0;0;1248;0;0;0;0
FR;1;2020-12-29;369;0;0;0;0;1617;0;0;0;0
FR;1;2020-12-30;433;0;0;0;0;2050;0;0;0;0
FR;1;2020-12-31;370;0;0;0;0;2420;0;0;0;0
FR;1;2021-01-01;1110;0;0;0;0;3530;0;0;0;0
FR;1;2021-01-02;348;1;0;0;0;3878;1;0;0;0
FR;1;2021-01-03;397;0;0;0;0;4275;1;0;0;0
FR;1;2021-01-04;2074;0;0;0;0;6349;1;0;0;0
FR;1;2021-01-05;6945;2;0;0;0;13294;3;0;0;0
FR;1;2021-01-06;12299;6;0;0;0;25593;9;0;0;0
FR;1;2021-01-07;29434;7;0;0;0;55027;16;0;0;0
FR;1;2021-01-08;37107;3;0;0;0;92134;19;0;0;0
FR;1;2021-01-09;11206;2;0;0;0;103340;21;0;0;0
FR;1;2021-01-10;5988;0;0;0;0;109328;21;0;0;0
FR;1;2021-01-11;39915;8;0;0;0;149243;29;0;0;0
FR;1;2021-01-12;62103;7;0;0;0;211346;36;0;0;0
FR;1;2021-01-13;65054;16;0;0;0;276400;52;0;0;0
FR;1;2021-01-14;81422;29;0;0;0;357822;81;0;0;0
FR;1;2021-01-15;68578;10;0;0;0;426400;91;0;0;0
FR;1;2021-01-16;19891;75;0;0;0;446291;166;0;0;0
FR;1;2021-01-17;10895;45;0;0;0;457186;211;0;0;0
FR;1;2021-01-18;82737;169;0;0;0;539923;380;0;0;0
FR;1;2021-01-19;125881;145;0;0;0;665804;525;0;0;0
FR;1;2021-01-20;132358;167;0;0;0;798162;692;0;0;0
FR;1;2021-01-21;153016;144;0;0;0;951178;836;0;0;0
FR;1;2021-01-22;115907;175;0;0;0;1067085;1011;0;0;0
FR;1;2021-01-23;36592;57;0;0;0;1103677;1068;0;0;0
FR;1;2021-01-24;9577;51;0;0;0;1113254;1119;0;0;0
FR;1;2021-01-25;74393;1232;0;0;0;1187647;2351;0;0;0
FR;1;2021-01-26;96420;3164;1;0;0;1284067;5515;1;0;0
FR;1;2021-01-27;103613;5725;0;0;0;1387680;11240;1;0;0
FR;1;2021-01-28;120566;14478;0;0;0;1508246;25718;1;0;0
FR;1;2021-01-29;88861;17395;0;0;0;1597107;43113;1;0;0
FR;1;2021-01-30;27971;4225;0;0;0;1625078;47338;1;0;0
FR;1;2021-01-31;5175;1716;0;0;0;1630253;49054;1;0;0
FR;1;2021-02-01;49688;21156;0;0;0;1679941;70210;1;0;0
FR;1;2021-02-02;67779;34811;0;0;0;1747720;105021;1;0;0
FR;1;2021-02-03;67039;37151;0;0;0;1814759;142172;1;0;0
FR;1;2021-02-04;77092;50239;0;0;0;1891851;192411;1;0;0
FR;1;2021-02-05;63397;45458;0;0;0;1955248;237869;1;0;0
FR;1;2021-02-06;19395;10557;0;0;0;1974643;248426;1;0;0
FR;1;2021-02-07;3654;5060;0;0;0;1978297;253486;1;0;0
FR;1;2021-02-08;36476;46188;0;0;0;2014773;299674;1;0;0
FR;1;2021-02-09;50779;72661;0;0;0;2065552;372335;1;0;0
FR;1;2021-02-10;52021;76964;0;0;0;2117573;449299;1;0;0
FR;1;2021-02-11;63335;99104;0;0;0;2180908;548403;1;0;0
FR;1;2021-02-12;55826;74111;0;0;0;2236734;622514;1;0;0
FR;1;2021-02-13;15445;19360;0;0;0;2252179;641874;1;0;0
FR;1;2021-02-14;3740;7238;0;0;0;2255919;649112;1;0;0
FR;1;2021-02-15;24122;73611;0;0;0;2280041;722723;1;0;0
FR;1;2021-02-16;32744;96672;0;0;0;2312785;819395;1;0;0
FR;1;2021-02-17;35077;98845;1;0;0;2347862;918240;2;0;0
FR;1;2021-02-18;49392;113660;0;0;0;2397254;1031900;2;0;0
FR;1;2021-02-19;45352;86459;1;0;0;2442606;1118359;3;0;0
FR;1;2021-02-20;13374;26986;0;0;0;2455980;1145345;3;0;0
FR;1;2021-02-21;2448;6313;0;0;0;2458428;1151658;3;0;0
FR;1;2021-02-22;24696;69516;2;0;0;2483124;1221174;5;0;0
FR;1;2021-02-23;37406;80507;1;0;0;2520530;1301681;6;0;0
FR;1;2021-02-24;40652;77761;1;0;0;2561182;1379442;7;0;0
FR;1;2021-02-25;50123;87797;1;0;0;2611305;1467239;8;0;0
FR;1;2021-02-26;47172;67816;0;0;0;2658477;1535055;8;0;0
FR;1;2021-02-27;15664;20983;0;0;0;2674141;1556038;8;0;0
FR;1;2021-02-28;3551;4394;1;0;0;2677692;1560432;9;0;0
FR;1;2021-03-01;40123;49196;1;0;0;2717815;1609628;10;0;0
FR;1;2021-03-02;55930;61560;2;0;0;2773745;1671188;12;0;0
FR;1;2021-03-03;61167;60529;0;0;0;2834912;1731717;12;0;0
FR;1;2021-03-04;72952;65165;3;0;0;2907864;1796882;15;0;0
FR;1;2021-03-05;74718;59073;3;0;0;2982582;1855955;18;0;0
FR;1;2021-03-06;82422;16059;2;0;0;3065004;1872014;20;0;0
FR;1;2021-03-07;63696;5311;1;0;0;3128700;1877325;21;0;0
FR;1;2021-03-08;60130;42364;2;0;0;3188830;1919689;23;0;0
FR;1;2021-03-09;85933;48181;1;0;0;3274763;1967870;24;0;0
FR;1;2021-03-10;90840;47997;5;0;0;3365603;2015867;29;0;0
FR;1;2021-03-11;104991;53872;1;0;0;3470594;2069739;30;0;0
FR;1;2021-03-12;104066;45144;0;0;0;3574660;2114883;30;0;0
FR;1;2021-03-13;89169;12715;1;0;0;3663829;2127598;31;0;0
FR;1;2021-03-14;44436;3008;1;0;0;3708265;2130606;32;0;0
FR;1;2021-03-15;95453;29021;3;0;0;3803718;2159627;35;0;0
FR;1;2021-03-16;123556;34821;4;0;0;3927274;2194448;39;0;0
FR;1;2021-03-17;129244;34644;4;0;0;4056518;2229092;43;0;0
FR;1;2021-03-18;142823;39691;5;0;0;4199341;2268783;48;0;0
FR;1;2021-03-19;136196;32773;2;0;0;4335537;2301556;50;0;0
FR;1;2021-03-20;75966;10129;1;0;0;4411503;2311685;51;0;0
FR;1;2021-03-21;26481;2446;1;0;0;4437984;2314131;52;0;0
FR;1;2021-03-22;114672;31072;2;0;0;4552656;2345203;54;0;0
FR;1;2021-03-23;142961;38175;1;0;0;4695617;2383378;55;0;0
FR;1;2021-03-24;141938;38733;0;0;0;4837555;2422111;55;0;0
FR;1;2021-03-25;164952;39549;4;0;0;5002507;2461660;59;0;0
FR;1;2021-03-26;166346;37453;4;0;0;5168853;2499113;63;0;0
FR;1;2021-03-27;110855;15247;1;0;0;5279708;2514360;64;0;0
FR;1;2021-03-28;42282;3737;3;0;0;5321990;2518097;67;0;0
FR;1;2021-03-29;129778;49832;4;0;0;5451768;2567929;71;0;0
FR;1;2021-03-30;167638;63497;4;0;0;5619406;2631426;75;0;0
FR;1;2021-03-31;170864;66913;4;0;0;5790270;2698339;79;0;0
FR;1;2021-04-01;194659;79557;11;0;0;5984929;2777896;90;0;0
FR;1;2021-04-02;164391;84406;7;0;0;6149320;2862302;97;0;0
FR;1;2021-04-03;88212;58080;5;0;0;6237532;2920382;102;0;0
FR;1;2021-04-04;33437;17728;0;0;0;6270969;2938110;102;0;0
FR;1;2021-04-05;46360;10116;11;0;0;6317329;2948226;113;0;0
FR;1;2021-04-06;160210;101124;16;0;0;6477539;3049350;129;0;0
FR;1;2021-04-07;196893;108070;16;0;0;6674432;3157420;145;0;0
FR;1;2021-04-08;221986;112308;13;0;0;6896418;3269728;158;0;0
FR;1;2021-04-09;214480;107356;21;0;0;7110898;3377084;179;0;0
FR;1;2021-04-10;117132;73321;14;0;0;7228030;3450405;193;0;0
FR;1;2021-04-11;40804;30224;6;0;0;7268834;3480629;199;0;0
FR;1;2021-04-12;168318;103699;45;0;0;7437152;3584328;244;0;0
FR;1;2021-04-13;203702;128050;96;1;0;7640854;3712378;340;1;0
FR;1;2021-04-14;208491;122627;204;0;0;7849345;3835005;544;1;0
FR;1;2021-04-15;221560;126708;311;0;0;8070905;3961713;855;1;0
FR;1;2021-04-16;205969;124993;307;0;0;8276874;4086706;1162;1;0
FR;1;2021-04-17;122049;67380;102;0;0;8398923;4154086;1264;1;0
FR;1;2021-04-18;35915;20999;39;0;0;8434838;4175085;1303;1;0
FR;1;2021-04-19;163669;121740;429;0;0;8598507;4296825;1732;1;0
FR;1;2021-04-20;189311;148591;530;0;0;8787818;4445416;2262;1;0
FR;1;2021-04-21;193868;146635;754;0;0;8981686;4592051;3016;1;0
FR;1;2021-04-22;208858;162621;777;0;0;9190544;4754672;3793;1;0
FR;1;2021-04-23;198896;156776;667;0;0;9389440;4911448;4460;1;0
FR;1;2021-04-24;126296;95433;145;0;0;9515736;5006881;4605;1;0
FR;1;2021-04-25;53544;30085;46;0;0;9569280;5036966;4651;1;0
FR;1;2021-04-26;181046;138127;538;0;0;9750326;5175093;5189;1;0
FR;1;2021-04-27;221276;161770;899;0;0;9971602;5336863;6088;1;0
FR;1;2021-04-28;238200;154926;1308;1;1;10209802;5491789;7396;2;1
FR;1;2021-04-29;270190;159957;1206;0;0;10479992;5651746;8602;2;1
FR;1;2021-04-30;271901;147954;1069;0;0;10751893;5799700;9671;2;1
FR;1;2021-05-01;141064;40680;172;0;0;10892957;5840380;9843;2;1
FR;1;2021-05-02;81448;28123;80;0;0;10974405;5868503;9923;2;1
FR;1;2021-05-03;250640;146122;797;0;0;11225045;6014625;10720;2;1
FR;1;2021-05-04;265727;186786;1197;0;0;11490772;6201411;11917;2;1
FR;1;2021-05-05;283723;184457;1263;0;0;11774495;6385868;13180;2;1
FR;1;2021-05-06;309818;182907;1494;0;0;12084313;6568775;14674;2;1
FR;1;2021-05-07;283986;195508;1125;0;0;12368299;6764283;15799;2;1
FR;1;2021-05-08;191618;48335;283;0;0;12559917;6812618;16082;2;1
FR;1;2021-05-09;114008;36089;236;0;0;12673925;6848707;16318;2;1
FR;1;2021-05-10;258013;193980;1178;0;0;12931938;7042687;17496;2;1
FR;1;2021-05-11;318754;211088;1461;0;0;13250692;7253775;18957;2;1
FR;1;2021-05-12;356492;185695;1397;0;0;13607184;7439470;20354;2;1
FR;1;2021-05-13;283346;47722;398;0;0;13890530;7487192;20752;2;1
FR;1;2021-05-14;370398;128602;985;0;0;14260928;7615794;21737;2;1
FR;1;2021-05-15;297928;66071;402;0;0;14558856;7681865;22139;2;1
FR;1;2021-05-16;157708;15529;158;0;0;14716564;7697394;22297;2;1
FR;1;2021-05-17;318798;116458;1434;0;0;15035362;7813852;23731;2;1
FR;1;2021-05-18;383039;111129;1794;0;0;15418401;7924981;25525;2;1
FR;1;2021-05-19;395148;102654;2167;0;0;15813549;8027635;27692;2;1
FR;1;2021-05-20;421627;96147;2038;0;0;16235176;8123782;29730;2;1
FR;1;2021-05-21;399686;97204;1752;0;0;16634862;8220986;31482;2;1
FR;1;2021-05-22;275619;42010;601;0;0;16910481;8262996;32083;2;1
FR;1;2021-05-23;122946;11178;224;0;0;17033427;8274174;32307;2;1
FR;1;2021-05-24;243947;26247;564;0;0;17277374;8300421;32871;2;1
FR;1;2021-05-25;366016;131666;2103;1;0;17643390;8432087;34974;3;1
FR;1;2021-05-26;380704;125619;1983;0;0;18024094;8557706;36957;3;1
FR;1;2021-05-27;406018;127985;1968;0;0;18430112;8685691;38925;3;1
FR;1;2021-05-28;365905;145302;1694;0;0;18796017;8830993;40619;3;1
FR;1;2021-05-29;253782;80866;524;0;0;19049799;8911859;41143;3;1
FR;1;2021-05-30;100900;22527;156;0;0;19150699;8934386;41299;3;1
FR;1;2021-05-31;314173;148833;1279;1;1;19464872;9083219;42578;4;2
FR;1;2021-06-01;361124;166554;1720;1;1;19825996;9249773;44298;5;3
FR;1;2021-06-02;364149;153103;1786;0;0;20190145;9402876;46084;5;3
FR;1;2021-06-03;389835;147601;1643;0;0;20579980;9550477;47727;5;3
FR;1;2021-06-04;363278;175566;1488;1;1;20943258;9726043;49215;6;4
FR;1;2021-06-05;258420;112674;596;0;0;21201678;9838717;49811;6;4
FR;1;2021-06-06;126714;37527;215;0;0;21328392;9876244;50026;6;4
FR;1;2021-06-07;299687;207893;1357;0;0;21628079;10084137;51383;6;4
FR;1;2021-06-08;330454;220770;1630;0;0;21958533;10304907;53013;6;4
FR;1;2021-06-09;336277;212328;1600;0;0;22294810;10517235;54613;6;4
FR;1;2021-06-10;343579;202023;1605;0;0;22638389;10719258;56218;6;4
FR;1;2021-06-11;311655;235275;1288;0;0;22950044;10954533;57506;6;4
FR;1;2021-06-12;243984;150649;430;0;0;23194028;11105182;57936;6;4
FR;1;2021-06-13;100299;61000;188;0;0;23294327;11166182;58124;6;4
FR;1;2021-06-14;207640;288990;1313;1;0;23501967;11455172;59437;7;4
FR;1;2021-06-15;256608;282241;1386;1;0;23758575;11737413;60823;8;4
FR;1;2021-06-16;273449;270588;1260;1;0;24032024;12008001;62083;9;4
FR;1;2021-06-17;268024;244511;1229;1;0;24300048;12252512;63312;10;4
FR;1;2021-06-18;260375;295651;1146;1;0;24560423;12548163;64458;11;4
FR;1;2021-06-19;193398;209461;385;0;0;24753821;12757624;64843;11;4
FR;1;2021-06-20;69634;89129;117;0;0;24823455;12846753;64960;11;4
FR;1;2021-06-21;172167;319826;925;1;1;24995622;13166579;65885;12;5
FR;1;2021-06-22;185640;347803;1093;10;2;25181262;13514382;66978;22;7
FR;1;2021-06-23;203992;339437;1047;0;0;25385254;13853819;68025;22;7
FR;1;2021-06-24;203351;281987;1161;0;0;25588605;14135806;69186;22;7
FR;1;2021-06-25;182438;371766;1196;0;0;25771043;14507572;70382;22;7
FR;1;2021-06-26;131309;278283;501;0;0;25902352;14785855;70883;22;7
FR;1;2021-06-27;52361;122948;143;0;0;25954713;14908803;71026;22;7
FR;1;2021-06-28;136471;368257;1055;0;0;26091184;15277060;72081;22;7
FR;1;2021-06-29;154714;390508;1847;0;0;26245898;15667568;73928;22;7
FR;1;2021-06-30;179846;378550;1661;4;2;26425744;16046118;75589;26;9
FR;1;2021-07-01;201078;332169;1886;5;1;26626822;16378287;77475;31;10
FR;1;2021-07-02;193096;367667;1764;5;3;26819918;16745954;79239;36;13
FR;1;2021-07-03;124322;280462;704;3;1;26944240;17026416;79943;39;14
FR;1;2021-07-04;53893;113686;244;0;0;26998133;17140102;80187;39;14
FR;1;2021-07-05;153520;356088;1499;8;2;27151653;17496190;81686;47;16
FR;1;2021-07-06;173184;382539;1597;44;8;27324837;17878729;83283;91;24
FR;1;2021-07-07;190406;362565;1654;24;5;27515243;18241294;84937;115;29
FR;1;2021-07-08;201245;323104;1825;20;8;27716488;18564398;86762;135;37
FR;1;2021-07-09;189624;387196;1851;3;2;27906112;18951594;88613;138;39
FR;1;2021-07-10;129826;281121;814;1;1;28035938;19232715;89427;139;40
FR;1;2021-07-11;57604;102485;260;0;0;28093542;19335200;89687;139;40
FR;1;2021-07-12;149410;417009;1573;4;0;28242952;19752209;91260;143;40
FR;1;2021-07-13;234010;439485;1803;8;2;28476962;20191694;93063;151;42
FR;1;2021-07-14;171638;151567;415;0;0;28648600;20343261;93478;151;42
FR;1;2021-07-15;279351;424800;1856;1;0;28927951;20768061;95334;152;42
FR;1;2021-07-16;290132;401255;1709;3;1;29218083;21169316;97043;155;43
FR;1;2021-07-17;217237;282125;754;1;0;29435320;21451441;97797;156;43
FR;1;2021-07-18;101950;107318;288;0;0;29537270;21558759;98085;156;43
FR;1;2021-07-19;238019;379388;1495;3;0;29775289;21938147;99580;159;43
FR;1;2021-07-20;305528;380913;1467;0;0;30080817;22319060;101047;159;43
FR;1;2021-07-21;333052;353570;1412;4;2;30413869;22672630;102459;163;45
FR;1;2021-07-22;364353;319494;1500;3;2;30778222;22992124;103959;166;47
FR;1;2021-07-23;347656;343786;1582;4;2;31125878;23335910;105541;170;49
FR;1;2021-07-24;238891;241072;695;1;0;31364769;23576982;106236;171;49
FR;1;2021-07-25;112732;76062;214;0;0;31477501;23653044;106450;171;49
FR;1;2021-07-26;298963;290280;1495;2;2;31776464;23943324;107945;173;51
FR;1;2021-07-27;385650;268906;1457;4;2;32162114;24212230;109402;177;53
FR;1;2021-07-28;390052;251599;1460;4;2;32552166;24463829;110862;181;55
FR;1;2021-07-29;405949;228411;1537;2;1;32958115;24692240;112399;183;56
FR;1;2021-07-30;370490;247108;1632;4;1;33328605;24939348;114031;187;57
FR;1;2021-07-31;243326;165124;792;1;0;33571931;25104472;114823;188;57
FR;1;2021-08-01;105491;47232;232;0;0;33677422;25151704;115055;188;57
FR;1;2021-08-02;296861;213320;1473;2;0;33974283;25365024;116528;190;57
FR;1;2021-08-03;331024;209320;1544;2;1;34305307;25574344;118072;192;58
FR;1;2021-08-04;327667;184439;1435;5;3;34632974;25758783;119507;197;61
FR;1;2021-08-05;300993;193595;1478;0;0;34933967;25952378;120985;197;61
FR;1;2021-08-06;290710;224656;1558;3;1;35224677;26177034;122543;200;62
FR;1;2021-08-07;182543;158824;654;4;3;35407220;26335858;123197;204;65
FR;1;2021-08-08;68811;59145;246;0;0;35476031;26395003;123443;204;65
FR;1;2021-08-09;222568;236094;1436;4;3;35698599;26631097;124879;208;68
FR;1;2021-08-10;252397;240994;1485;2;1;35950996;26872091;126364;210;69
FR;1;2021-08-11;235936;232557;1267;5;1;36186932;27104648;127631;215;70
FR;1;2021-08-12;220470;240320;1482;3;1;36407402;27344968;129113;218;71
FR;1;2021-08-13;201547;238535;1352;2;2;36608949;27583503;130465;220;73
FR;1;2021-08-14;122789;174167;645;0;0;36731738;27757670;131110;220;73
FR;1;2021-08-15;34633;46120;195;1;0;36766371;27803790;131305;221;73
FR;1;2021-08-16;156690;289932;1420;0;0;36923061;28093722;132725;221;73
FR;1;2021-08-17;171441;291775;1418;4;1;37094502;28385497;134143;225;74
FR;1;2021-08-18;161207;287195;1382;6;3;37255709;28672692;135525;231;77
FR;1;2021-08-19;148720;277600;1393;1;0;37404429;28950292;136918;232;77
FR;1;2021-08-20;140267;308480;1518;2;2;37544696;29258772;138436;234;79
FR;1;2021-08-21;84193;213254;584;0;0;37628889;29472026;139020;234;79
FR;1;2021-08-22;28526;82690;229;0;0;37657415;29554716;139249;234;79
FR;1;2021-08-23;118536;321239;1416;2;1;37775951;29875955;140665;236;80
FR;1;2021-08-24;126538;319953;1592;5;1;37902489;30195908;142257;241;81
FR;1;2021-08-25;121369;306612;1773;8;3;38023858;30502520;144030;249;84
FR;1;2021-08-26;106464;286169;2154;10;1;38130322;30788689;146184;259;85
FR;1;2021-08-27;107472;321167;2298;8;3;38237794;31109856;148482;267;88
FR;1;2021-08-28;70930;220671;1100;0;0;38308724;31330527;149582;267;88
FR;1;2021-08-29;24125;78129;462;1;0;38332849;31408656;150044;268;88
FR;1;2021-08-30;96775;286551;4307;6;5164;38429624;31695207;154351;274;5252
FR;1;2021-08-31;97955;276495;9266;14;10200;38527579;31971702;163617;288;15452
FR;1;2021-09-01;111315;245276;21084;7;21989;38638894;32216978;184701;295;37441
FR;1;2021-09-02;84294;198050;24516;11;25399;38723188;32415028;209217;306;62840
FR;1;2021-09-03;82063;227661;26931;21;27939;38805251;32642689;236148;327;90779
FR;1;2021-09-04;71455;189701;11137;11;11616;38876706;32832390;247285;338;102395
FR;1;2021-09-05;18581;41197;4117;2;4283;38895287;32873587;251402;340;106678
FR;1;2021-09-06;59304;151691;30161;15;31048;38954591;33025278;281563;355;137726
FR;1;2021-09-07;56568;139740;30194;27;31049;39011159;33165018;311757;382;168775
FR;1;2021-09-08;70097;173828;26904;20;27751;39081256;33338846;338661;402;196526
FR;1;2021-09-09;53337;124453;28582;23;29543;39134593;33463299;367243;425;226069
FR;1;2021-09-10;65248;152053;30413;21;31475;39199841;33615352;397656;446;257544
FR;1;2021-09-11;51834;146588;9715;13;10211;39251675;33761940;407371;459;267755
FR;1;2021-09-12;10707;29250;2479;2;2627;39262382;33791190;409850;461;270382
FR;1;2021-09-13;51269;104609;38706;28;39687;39313651;33895799;448556;489;310069
FR;1;2021-09-14;53084;96114;51220;65;52601;39366735;33991913;499776;554;362670
FR;1;2021-09-15;60200;139238;50423;56;46886;39426935;34131151;550199;610;409556
FR;1;2021-09-16;46410;81398;53257;72;49393;39473345;34212549;603456;682;458949
FR;1;2021-09-17;53015;109381;45003;60;42568;39526360;34321930;648459;742;501517
FR;1;2021-09-18;37789;118456;11785;19;11244;39564149;34440386;660244;761;512761
FR;1;2021-09-19;6468;21034;2031;1;1967;39570617;34461420;662275;762;514728
FR;1;2021-09-20;36367;74884;46131;66;44000;39606984;34536304;708406;828;558728
FR;1;2021-09-21;34060;68148;56169;71;52484;39641044;34604452;764575;899;611212
FR;1;2021-09-22;38666;118388;49784;77;46702;39679710;34722840;814359;976;657914
FR;1;2021-09-23;31840;62694;54418;86;50650;39711550;34785534;868777;1062;708564
FR;1;2021-09-24;36608;89840;43606;92;41827;39748158;34875374;912383;1154;750391
FR;1;2021-09-25;27567;96532;12293;27;12150;39775725;34971906;924676;1181;762541
FR;1;2021-09-26;4347;15216;1766;4;1703;39780072;34987122;926442;1185;764244
FR;1;2021-09-27;27277;60235;42859;89;41522;39807349;35047357;969301;1274;805766
FR;1;2021-09-28;26802;49436;47110;75;44276;39834151;35096793;1016411;1349;850042
FR;1;2021-09-29;35795;80357;47207;86;45458;39869946;35177150;1063618;1435;895500
FR;1;2021-09-30;25888;46391;47445;80;45269;39895834;35223541;1111063;1515;940769
FR;1;2021-10-01;46674;64698;44835;83;44367;39942508;35288239;1155898;1598;985136
FR;1;2021-10-02;32219;62265;16094;32;16282;39974727;35350504;1171992;1630;1001418
FR;1;2021-10-03;4294;8603;2026;3;2036;39979021;35359107;1174018;1633;1003454
FR;1;2021-10-04;28522;44383;47062;78;46873;40007543;35403490;1221080;1711;1050327
FR;1;2021-10-05;23832;41577;49796;116;49102;40031375;35445067;1270876;1827;1099429
FR;1;2021-10-06;34107;61168;57393;102;57040;40065482;35506235;1328269;1929;1156469
FR;1;2021-10-07;20786;39670;52964;75;51777;40086268;35545905;1381233;2004;1208246
FR;1;2021-10-08;34619;59506;60324;83;60988;40120887;35605411;1441557;2087;1269234
FR;1;2021-10-09;27309;47922;25456;29;25956;40148196;35653333;1467013;2116;1295190
FR;1;2021-10-10;3568;5714;2741;7;2840;40151764;35659047;1469754;2123;1298030
FR;1;2021-10-11;24543;38147;54540;88;55139;40176307;35697194;1524294;2211;1353169
FR;1;2021-10-12;22909;36540;57998;126;59009;40199216;35733734;1582292;2337;1412178
FR;1;2021-10-13;32666;47695;64127;124;65571;40231882;35781429;1646419;2461;1477749
FR;1;2021-10-14;21516;34636;53705;103;54215;40253398;35816065;1700124;2564;1531964
FR;1;2021-10-15;32417;48648;72279;165;74898;40285815;35864713;1772403;2729;1606862
FR;1;2021-10-16;25874;35239;34846;45;36369;40311689;35899952;1807249;2774;1643231
FR;1;2021-10-17;3079;4034;3403;2;3311;40314768;35903986;1810652;2776;1646542
FR;1;2021-10-18;22390;34520;66783;131;69618;40337158;35938506;1877435;2907;1716160
FR;1;2021-10-19;20404;33035;75606;136;79476;40357562;35971541;1953041;3043;1795636
FR;1;2021-10-20;29704;43996;96106;176;99673;40387266;36015537;2049147;3219;1895309
FR;1;2021-10-21;19421;35016;83088;107;86939;40406687;36050553;2132235;3326;1982248
FR;1;2021-10-22;29470;47422;103667;195;109508;40436157;36097975;2235902;3521;2091756
FR;1;2021-10-23;22926;35087;44835;57;47329;40459083;36133062;2280737;3578;2139085
FR;1;2021-10-24;2365;3870;3577;6;3740;40461448;36136932;2284314;3584;2142825
FR;1;2021-10-25;22348;30729;81967;143;85721;40483796;36167661;2366281;3727;2228546
FR;1;2021-10-26;19244;27581;86034;162;90221;40503040;36195242;2452315;3889;2318767
FR;1;2021-10-27;26079;39637;107727;252;112551;40529119;36234879;2560042;4141;2431318
FR;1;2021-10-28;18484;26943;86868;150;91519;40547603;36261822;2646910;4291;2522837
FR;1;2021-10-29;25814;39801;114760;201;121445;40573417;36301623;2761670;4492;2644282
FR;1;2021-10-30;17532;28552;49320;75;51900;40590949;36330175;2810990;4567;2696182
FR;1;2021-10-31;2046;3214;3440;2;3679;40592995;36333389;2814430;4569;2699861
FR;1;2021-11-01;7473;4133;3012;3;3258;40600468;36337522;2817442;4572;2703119
FR;1;2021-11-02;21543;33096;92311;157;97618;40622011;36370618;2909753;4729;2800737
FR;1;2021-11-03;26033;41325;117406;215;123719;40648044;36411943;3027159;4944;2924456
FR;1;2021-11-04;19369;30218;105695;212;111772;40667413;36442161;3132854;5156;3036228
FR;1;2021-11-05;26780;42047;138674;227;147216;40694193;36484208;3271528;5383;3183444
FR;1;2021-11-06;18703;29775;63420;123;66367;40712896;36513983;3334948;5506;3249811
FR;1;2021-11-07;1774;3375;4944;6;5295;40714670;36517358;3339892;5512;3255106
FR;1;2021-11-08;17403;32262;125880;224;132398;40732073;36549620;3465772;5736;3387504
FR;1;2021-11-09;19081;37646;159178;336;168841;40751154;36587266;3624950;6072;3556345
FR;1;2021-11-10;28458;48820;181783;440;192263;40779612;36636086;3806733;6512;3748608
FR;1;2021-11-11;3417;5611;12166;26;12964;40783029;36641697;3818899;6538;3761572
FR;1;2021-11-12;25854;46834;174710;241;186283;40808883;36688531;3993609;6779;3947855
FR;1;2021-11-13;18609;29210;76781;111;81717;40827492;36717741;4070390;6890;4029572
FR;1;2021-11-14;1993;3355;6808;5;7386;40829485;36721096;4077198;6895;4036958
FR;1;2021-11-15;18445;34858;156272;303;166020;40847930;36755954;4233470;7198;4202978
FR;1;2021-11-16;20874;37807;191956;377;204672;40868804;36793761;4425426;7575;4407650
FR;1;2021-11-17;28349;45640;193114;399;204864;40897153;36839401;4618540;7974;4612514
FR;1;2021-11-18;20920;37734;182347;457;194289;40918073;36877135;4800887;8431;4806803
FR;1;2021-11-19;30709;53297;230095;529;246470;40948782;36930432;5030982;8960;5053273
FR;1;2021-11-20;23610;33241;96921;200;103552;40972392;36963673;5127903;9160;5156825
FR;1;2021-11-21;2303;4040;9087;18;9978;40974695;36967713;5136990;9178;5166803
FR;1;2021-11-22;21287;30348;175764;465;189256;40995982;36998061;5312754;9643;5356059
FR;1;2021-11-23;23731;40980;221034;538;237654;41019713;37039041;5533788;10181;5593713
FR;1;2021-11-24;30170;49640;217229;703;234312;41049883;37088681;5751017;10884;5828025
FR;1;2021-11-25;23393;43744;244306;719;263843;41073276;37132425;5995323;11603;6091868
FR;1;2021-11-26;30461;66463;356627;834;388338;41103737;37198888;6351950;12437;6480206
FR;1;2021-11-27;21646;45167;202526;372;222485;41125383;37244055;6554476;12809;6702691
FR;1;2021-11-28;3132;9691;54742;63;61036;41128515;37253746;6609218;12872;6763727
FR;1;2021-11-29;17775;49428;326228;841;354171;41146290;37303174;6935446;13713;7117898
FR;1;2021-11-30;22455;64767;430975;948;470529;41168745;37367941;7366421;14661;7588427
FR;1;2021-12-01;24125;69167;442680;1129;481482;41192870;37437108;7809101;15790;8069909
FR;1;2021-12-02;19790;64237;489207;1224;532607;41212660;37501345;8298308;17014;8602516
FR;1;2021-12-03;22690;81681;542552;1303;591484;41235350;37583026;8840860;18317;9194000
FR;1;2021-12-04;16335;53863;298997;652;328810;41251685;37636889;9139857;18969;9522810
FR;1;2021-12-05;3622;13917;81481;143;91060;41255307;37650806;9221338;19112;9613870
FR;1;2021-12-06;16786;62685;415261;1062;454950;41272093;37713491;9636599;20174;10068820
FR;1;2021-12-07;19694;75703;522740;1531;572280;41291787;37789194;10159339;21705;10641100
FR;1;2021-12-08;21443;75466;458173;1541;501848;41313230;37864660;10617512;23246;11142948
FR;1;2021-12-09;19293;73919;492705;1626;540545;41332523;37938579;11110217;24872;11683493
FR;1;2021-12-10;22375;87510;547184;1583;599765;41354898;38026089;11657401;26455;12283258
FR;1;2021-12-11;16488;58916;302652;746;335392;41371386;38085005;11960053;27201;12618650
FR;1;2021-12-12;4330;15960;83158;179;94069;41375716;38100965;12043211;27380;12712719
FR;1;2021-12-13;15397;63671;366769;1095;406118;41391113;38164636;12409980;28475;13118837
FR;1;2021-12-14;19959;80116;464488;1738;514962;41411072;38244752;12874468;30213;13633799
FR;1;2021-12-15;21229;77174;408862;1307;452908;41432301;38321926;13283330;31520;14086707
FR;1;2021-12-16;19839;77232;451613;1575;500402;41452140;38399158;13734943;33095;14587109
FR;1;2021-12-17;22385;86599;479731;1734;530842;41474525;38485757;14214674;34829;15117951
FR;1;2021-12-18;17567;54636;257533;730;288451;41492092;38540393;14472207;35559;15406402
FR;1;2021-12-19;5533;17178;79120;194;90775;41497625;38557571;14551327;35753;15497177
FR;1;2021-12-20;20724;63015;316057;1081;355127;41518349;38620586;14867384;36834;15852304
FR;1;2021-12-21;26038;73033;372569;1421;417935;41544387;38693619;15239953;38255;16270239
FR;1;2021-12-22;24846;65743;310450;1214;349419;41569233;38759362;15550403;39469;16619658
FR;1;2021-12-23;21154;52224;241345;949;272943;41590387;38811586;15791748;40418;16892601
FR;1;2021-12-24;7050;18223;67092;256;77028;41597437;38829809;15858840;40674;16969629
FR;1;2021-12-25;494;2757;5565;15;6536;41597931;38832566;15864405;40689;16976165
FR;1;2021-12-26;2746;7585;26914;68;31445;41600677;38840151;15891319;40757;17007610
FR;1;2021-12-27;18054;53235;234974;707;265645;41618731;38893386;16126293;41464;17273255
FR;1;2021-12-28;23187;61785;291908;1024;330073;41641918;38955171;16418201;42488;17603328
FR;1;2021-12-29;22156;55439;254875;918;288109;41664074;39010610;16673076;43406;17891437
FR;1;2021-12-30;21172;46064;212056;857;239521;41685246;39056674;16885132;44263;18130958
FR;1;2021-12-31;7251;16515;61808;229;70327;41692497;39073189;16946940;44492;18201285
FR;1;2022-01-01;775;2474;5638;29;6571;41693272;39075663;16952578;44521;18207856
FR;1;2022-01-02;3031;8068;28855;50;33517;41696303;39083731;16981433;44571;18241373
FR;1;2022-01-03;18958;52189;228039;783;257316;41715261;39135920;17209472;45354;18498689
FR;1;2022-01-04;24621;64507;299111;1234;337113;41739882;39200427;17508583;46588;18835802
FR;1;2022-01-05;28942;63508;274719;1097;310016;41768824;39263935;17783302;47685;19145818
FR;1;2022-01-06;26359;65802;306737;1393;346371;41795183;39329737;18090039;49078;19492189
FR;1;2022-01-07;31160;74323;349683;1534;393731;41826343;39404060;18439722;50612;19885920
FR;1;2022-01-08;23296;51367;222441;694;251076;41849639;39455427;18662163;51306;20136996
FR;1;2022-01-09;7072;17224;65999;163;76158;41856711;39472651;18728162;51469;20213154
FR;1;2022-01-10;21230;53545;236630;951;266875;41877941;39526196;18964792;52420;20480029
FR;1;2022-01-11;26348;62614;282143;1276;317671;41904289;39588810;19246935;53696;20797700
FR;1;2022-01-12;28540;61857;246095;1103;277854;41932829;39650667;19493030;54799;21075554
FR;1;2022-01-13;24292;59641;262626;1250;295971;41957121;39710308;19755656;56049;21371525
FR;1;2022-01-14;27688;66406;313825;1364;351105;41984809;39776714;20069481;57413;21722630
FR;1;2022-01-15;19239;44297;199232;618;223817;42004048;39821011;20268713;58031;21946447
FR;1;2022-01-16;5131;13004;51480;135;59570;42009179;39834015;20320193;58166;22006017
FR;1;2022-01-17;16683;39611;184734;779;206794;42025862;39873626;20504927;58945;22212811
FR;1;2022-01-18;19187;45452;212297;1149;236921;42045049;39919078;20717224;60094;22449732
FR;1;2022-01-19;20063;43756;175993;894;197117;42065112;39962834;20893217;60988;22646849
FR;1;2022-01-20;16516;40217;183512;1136;204584;42081628;40003051;21076729;62124;22851433
FR;1;2022-01-21;19625;46901;228835;1400;253251;42101253;40049952;21305564;63524;23104684
FR;1;2022-01-22;13824;33079;144446;578;161332;42115077;40083031;21450010;64102;23266016
FR;1;2022-01-23;3340;8830;33392;130;38331;42118417;40091861;21483402;64232;23304347
FR;1;2022-01-24;11691;32525;142114;705;158211;42130108;40124386;21625516;64937;23462558
FR;1;2022-01-25;14065;37782;163293;1049;181488;42144173;40162168;21788809;65986;23644046
FR;1;2022-01-26;14784;36618;150138;927;166176;42158957;40198786;21938947;66913;23810222
FR;1;2022-01-27;12255;32550;143322;878;157790;42171212;40231336;22082269;67791;23968012
FR;1;2022-01-28;16175;53808;198190;1143;222433;42187387;40285144;22280459;68934;24190445
FR;1;2022-01-29;10242;35436;135158;520;151535;42197629;40320580;22415617;69454;24341980
FR;1;2022-01-30;2471;9339;29654;84;34462;42200100;40329919;22445271;69538;24376442
FR;1;2022-01-31;8706;32312;104273;530;117379;42208806;40362231;22549544;70068;24493821
FR;1;2022-02-01;9973;35862;126967;861;141134;42218779;40398093;22676511;70929;24634955
FR;1;2022-02-02;11099;40794;130233;777;145769;42229878;40438887;22806744;71706;24780724
FR;1;2022-02-03;8655;32989;116899;780;130289;42238533;40471876;22923643;72486;24911013
FR;1;2022-02-04;11335;47885;172468;963;192735;42249868;40519761;23096111;73449;25103748
FR;1;2022-02-05;7686;33923;117531;391;133038;42257554;40553684;23213642;73840;25236786
FR;1;2022-02-06;1687;8067;22725;83;26902;42259241;40561751;23236367;73923;25263688
FR;1;2022-02-07;6964;35229;119005;449;134936;42266205;40596980;23355372;74372;25398624
FR;1;2022-02-08;7481;31377;125565;692;140534;42273686;40628357;23480937;75064;25539158
FR;1;2022-02-09;8373;35806;135156;692;152348;42282059;40664163;23616093;75756;25691506
FR;1;2022-02-10;6519;28881;116224;673;129935;42288578;40693044;23732317;76429;25821441
FR;1;2022-02-11;8520;41158;165004;873;185197;42297098;40734202;23897321;77302;26006638
FR;1;2022-02-12;5257;27493;106648;378;120815;42302355;40761695;24003969;77680;26127453
FR;1;2022-02-13;1210;5686;21686;61;25297;42303565;40767381;24025655;77741;26152750
FR;1;2022-02-14;5325;27001;117980;387;132995;42308890;40794382;24143635;78128;26285745
FR;1;2022-02-15;5544;27941;118751;609;132320;42314434;40822323;24262386;78737;26418065
FR;1;2022-02-16;5609;27874;110305;591;122889;42320043;40850197;24372691;79328;26540954
FR;1;2022-02-17;4370;18858;73041;484;80071;42324413;40869055;24445732;79812;26621025
FR;1;2022-02-18;5450;26285;99089;667;108008;42329863;40895340;24544821;80479;26729033
FR;1;2022-02-19;3506;17053;59439;303;66007;42333369;40912393;24604260;80782;26795040
FR;1;2022-02-20;776;3208;10674;35;12294;42334145;40915601;24614934;80817;26807334
FR;1;2022-02-21;3317;14424;52760;286;57595;42337462;40930025;24667694;81103;26864929
FR;1;2022-02-22;3664;15299;51831;496;55544;42341126;40945324;24719525;81599;26920473
FR;1;2022-02-23;4137;17450;57381;508;62459;42345263;40962774;24776906;82107;26982932
FR;1;2022-02-24;3208;12517;43523;432;46282;42348471;40975291;24820429;82539;27029214
FR;1;2022-02-25;4340;19212;64786;691;68624;42352811;40994503;24885215;83230;27097838
FR;1;2022-02-26;2665;12501;41321;306;45074;42355476;41007004;24926536;83536;27142912
FR;1;2022-02-27;634;2160;7107;42;7969;42356110;41009164;24933643;83578;27150881
FR;1;2022-02-28;2539;9954;34876;300;37291;42358649;41019118;24968519;83878;27188172
FR;1;2022-03-01;2572;10162;38415;387;39321;42361221;41029280;25006934;84265;27227493
FR;1;2022-03-02;3360;11735;41663;388;43702;42364581;41041015;25048597;84653;27271195
FR;1;2022-03-03;2232;7313;25893;297;26202;42366813;41048328;25074490;84950;27297397
FR;1;2022-03-04;2616;10114;35275;569;34738;42369429;41058442;25109765;85519;27332135
FR;1;2022-03-05;1632;6265;21903;275;22283;42371061;41064707;25131668;85794;27354418
FR;1;2022-03-06;339;925;2904;37;3099;42371400;41065632;25134572;85831;27357517
FR;1;2022-03-07;1310;4499;16331;242;15786;42372710;41070131;25150903;86073;27373303
FR;1;2022-03-08;1476;4979;17008;302;15827;42374186;41075110;25167911;86375;27389130
FR;1;2022-03-09;1819;6302;19583;364;18935;42376005;41081412;25187494;86739;27408065
FR;1;2022-03-10;1238;4064;14806;291;13822;42377243;41085476;25202300;87030;27421887
FR;1;2022-03-11;1660;6061;21534;478;19671;42378903;41091537;25223834;87508;27441558
FR;1;2022-03-12;1194;4561;15282;274;14816;42380097;41096098;25239116;87782;27456374
FR;1;2022-03-13;235;590;2017;114;1964;42380332;41096688;25241133;87896;27458338
FR;1;2022-03-14;1030;3470;13201;3873;12328;42381362;41100158;25254334;91769;27470666
FR;1;2022-03-15;1206;3710;14153;6847;12630;42382568;41103868;25268487;98616;27483296
FR;1;2022-03-16;1556;4571;16579;11503;15650;42384124;41108439;25285066;110119;27498946
FR;1;2022-03-17;1059;2982;11089;9587;10161;42385183;41111421;25296155;119706;27509107
FR;1;2022-03-18;1609;4571;17641;16431;16051;42386792;41115992;25313796;136137;27525158
FR;1;2022-03-19;1083;3124;11806;8440;11270;42387875;41119116;25325602;144577;27536428
FR;1;2022-03-20;205;505;1620;1000;1646;42388080;41119621;25327222;145577;27538074
FR;1;2022-03-21;1006;2573;10645;13363;9992;42389086;41122194;25337867;158940;27548066
FR;1;2022-03-22;1135;2945;11657;18640;10647;42390221;41125139;25349524;177580;27558713
FR;1;2022-03-23;1393;3772;13532;20027;13095;42391614;41128911;25363056;197607;27571808
FR;1;2022-03-24;1002;2386;9659;15893;8920;42392616;41131297;25372715;213500;27580728
FR;1;2022-03-25;1435;3864;16123;25197;14776;42394051;41135161;25388838;238697;27595504
FR;1;2022-03-26;1079;2757;10620;11385;10262;42395130;41137918;25399458;250082;27605766
FR;1;2022-03-27;221;529;1694;1355;1747;42395351;41138447;25401152;251437;27607513
FR;1;2022-03-28;1000;2229;9416;15688;9013;42396351;41140676;25410568;267125;27616526
FR;1;2022-03-29;1085;2593;11006;24719;10353;42397436;41143269;25421574;291844;27626879
FR;1;2022-03-30;1540;3313;13229;23892;12751;42398976;41146582;25434803;315736;27639630
FR;1;2022-03-31;1223;2466;10801;21984;10297;42400199;41149048;25445604;337720;27649927
FR;1;2022-04-01;1508;3284;14489;27812;13426;42401707;41152332;25460093;365532;27663353
FR;1;2022-04-02;792;1754;7664;9075;7403;42402499;41154086;25467757;374607;27670756
FR;1;2022-04-03;153;340;1358;1021;1362;42402652;41154426;25469115;375628;27672118
FR;1;2022-04-04;933;1834;8689;16358;8071;42403585;41156260;25477804;391986;27680189
FR;1;2022-04-05;1130;2189;11234;28112;10231;42404715;41158449;25489038;420098;27690420
FR;2;2020-12-27;0;0;0;0;0;0;0;0;0;0
FR;2;2020-12-28;0;0;0;0;0;0;0;0;0;0
FR;2;2020-12-29;0;0;0;0;0;0;0;0;0;0
FR;2;2020-12-30;0;0;0;0;0;0;0;0;0;0
FR;2;2020-12-31;0;0;0;0;0;0;0;0;0;0
FR;2;2021-01-01;0;0;0;0;0;0;0;0;0;0
FR;2;2021-01-02;0;0;0;0;0;0;0;0;0;0
FR;2;2021-01-03;0;0;0;0;0;0;0;0;0;0
FR;2;2021-01-04;0;0;0;0;0;0;0;0;0;0
FR;2;2021-01-05;0;0;0;0;0;0;0;0;0;0
FR;2;2021-01-06;0;0;0;0;0;0;0;0;0;0
FR;2;2021-01-07;0;0;0;0;0;0;0;0;0;0
FR;2;2021-01-08;0;0;0;0;0;0;0;0;0;0
FR;2;2021-01-09;0;0;0;0;0;0;0;0;0;0
FR;2;2021-01-10;0;0;0;0;0;0;0;0;0;0
FR;2;2021-01-11;0;0;0;0;0;0;0;0;0;0
FR;2;2021-01-12;0;0;0;0;0;0;0;0;0;0
FR;2;2021-01-13;0;0;0;0;0;0;0;0;0;0
FR;2;2021-01-14;1701;0;0;0;0;1701;0;0;0;0
FR;2;2021-01-15;390;0;0;0;0;2091;0;0;0;0
FR;2;2021-01-16;312;0;0;0;0;2403;0;0;0;0
FR;2;2021-01-17;80;0;0;0;0;2483;0;0;0;0
FR;2;2021-01-18;3072;0;0;0;0;5555;0;0;0;0
FR;2;2021-01-19;4674;0;0;0;0;10229;0;0;0;0
FR;2;2021-01-20;5133;3;0;0;0;15362;3;0;0;0
FR;2;2021-01-21;5332;4;0;0;0;20694;7;0;0;0
FR;2;2021-01-22;5114;1;0;0;0;25808;8;0;0;0
FR;2;2021-01-23;1863;0;0;0;0;27671;8;0;0;0
FR;2;2021-01-24;160;1;0;0;0;27831;9;0;0;0
FR;2;2021-01-25;3810;3;0;0;0;31641;12;0;0;0
FR;2;2021-01-26;3914;0;0;0;0;35555;12;0;0;0
FR;2;2021-01-27;3595;1;0;0;0;39150;13;0;0;0
FR;2;2021-01-28;3743;2;0;0;0;42893;15;0;0;0
FR;2;2021-01-29;3286;2;0;0;0;46179;17;0;0;0
FR;2;2021-01-30;1129;1;0;0;0;47308;18;0;0;0
FR;2;2021-01-31;45;1;0;0;0;47353;19;0;0;0
FR;2;2021-02-01;3399;2;0;0;0;50752;21;0;0;0
FR;2;2021-02-02;4485;9;0;0;0;55237;30;0;0;0
FR;2;2021-02-03;5216;5;0;0;0;60453;35;0;0;0
FR;2;2021-02-04;4927;7;0;0;0;65380;42;0;0;0
FR;2;2021-02-05;4809;13;0;0;0;70189;55;0;0;0
FR;2;2021-02-06;2037;9;0;0;0;72226;64;0;0;0
FR;2;2021-02-07;97;4;0;0;0;72323;68;0;0;0
FR;2;2021-02-08;7549;16;0;0;0;79872;84;0;0;0
FR;2;2021-02-09;8419;25;0;0;0;88291;109;0;0;0
FR;2;2021-02-10;9336;56;0;0;0;97627;165;0;0;0
FR;2;2021-02-11;10271;79;0;0;0;107898;244;0;0;0
FR;2;2021-02-12;10048;249;0;0;0;117946;493;0;0;0
FR;2;2021-02-13;3117;227;0;0;0;121063;720;0;0;0
FR;2;2021-02-14;349;2;0;0;0;121412;722;0;0;0
FR;2;2021-02-15;3453;3081;0;0;0;124865;3803;0;0;0
FR;2;2021-02-16;5064;3935;0;0;0;129929;7738;0;0;0
FR;2;2021-02-17;4249;4429;0;0;0;134178;12167;0;0;0
FR;2;2021-02-18;5399;5101;0;0;0;139577;17268;0;0;0
FR;2;2021-02-19;5320;4355;0;0;0;144897;21623;0;0;0
FR;2;2021-02-20;1864;1506;0;0;0;146761;23129;0;0;0
FR;2;2021-02-21;239;86;0;0;0;147000;23215;0;0;0
FR;2;2021-02-22;3610;3722;0;0;0;150610;26937;0;0;0
FR;2;2021-02-23;4951;3690;0;0;0;155561;30627;0;0;0
FR;2;2021-02-24;5007;3466;0;0;0;160568;34093;0;0;0
FR;2;2021-02-25;5479;3443;0;0;0;166047;37536;0;0;0
FR;2;2021-02-26;4355;3137;0;0;0;170402;40673;0;0;0
FR;2;2021-02-27;1623;1045;0;0;0;172025;41718;0;0;0
FR;2;2021-02-28;176;32;0;0;0;172201;41750;0;0;0
FR;2;2021-03-01;5172;3744;0;0;0;177373;45494;0;0;0
FR;2;2021-03-02;6526;4720;0;0;0;183899;50214;0;0;0
FR;2;2021-03-03;6531;4898;0;0;0;190430;55112;0;0;0
FR;2;2021-03-04;8393;3987;0;0;0;198823;59099;0;0;0
FR;2;2021-03-05;8023;4062;0;0;0;206846;63161;0;0;0
FR;2;2021-03-06;4782;1682;0;0;0;211628;64843;0;0;0
FR;2;2021-03-07;2371;30;0;0;0;213999;64873;0;0;0
FR;2;2021-03-08;4163;8315;0;0;0;218162;73188;0;0;0
FR;2;2021-03-09;7482;8452;1;0;0;225644;81640;1;0;0
FR;2;2021-03-10;7093;9107;0;0;0;232737;90747;1;0;0
FR;2;2021-03-11;9371;9197;1;0;0;242108;99944;2;0;0
FR;2;2021-03-12;7969;8186;0;0;0;250077;108130;2;0;0
FR;2;2021-03-13;10046;2529;0;0;0;260123;110659;2;0;0
FR;2;2021-03-14;4838;401;0;0;0;264961;111060;2;0;0
FR;2;2021-03-15;10904;3512;0;0;0;275865;114572;2;0;0
FR;2;2021-03-16;16753;4637;1;0;0;292618;119209;3;0;0
FR;2;2021-03-17;20217;3959;0;0;0;312835;123168;3;0;0
FR;2;2021-03-18;23361;4919;0;0;0;336196;128087;3;0;0
FR;2;2021-03-19;23295;4540;0;0;0;359491;132627;3;0;0
FR;2;2021-03-20;25439;1542;0;0;0;384930;134169;3;0;0
FR;2;2021-03-21;17668;145;0;0;0;402598;134314;3;0;0
FR;2;2021-03-22;17781;3097;0;0;0;420379;137411;3;0;0
FR;2;2021-03-23;22682;4198;0;0;0;443061;141609;3;0;0
FR;2;2021-03-24;23953;4992;0;0;0;467014;146601;3;0;0
FR;2;2021-03-25;26734;5043;1;0;0;493748;151644;4;0;0
FR;2;2021-03-26;26973;4234;0;0;0;520721;155878;4;0;0
FR;2;2021-03-27;15914;1322;0;0;0;536635;157200;4;0;0
FR;2;2021-03-28;10560;110;0;0;0;547195;157310;4;0;0
FR;2;2021-03-29;18980;4277;0;0;0;566175;161587;4;0;0
FR;2;2021-03-30;24571;6016;0;0;0;590746;167603;4;0;0
FR;2;2021-03-31;28548;5941;0;0;0;619294;173544;4;0;0
FR;2;2021-04-01;34542;8489;1;0;0;653836;182033;5;0;0
FR;2;2021-04-02;29974;7666;0;0;0;683810;189699;5;0;0
FR;2;2021-04-03;16952;3623;0;0;0;700762;193322;5;0;0
FR;2;2021-04-04;9304;939;2;0;0;710066;194261;7;0;0
FR;2;2021-04-05;12437;809;0;0;0;722503;195070;7;0;0
FR;2;2021-04-06;27136;6948;0;0;0;749639;202018;7;0;0
FR;2;2021-04-07;30923;7166;1;0;0;780562;209184;8;0;0
FR;2;2021-04-08;36877;8786;1;0;0;817439;217970;9;0;0
FR;2;2021-04-09;33823;8585;28;0;0;851262;226555;37;0;0
FR;2;2021-04-10;19677;8990;1;0;0;870939;235545;38;0;0
FR;2;2021-04-11;7939;4259;1;0;0;878878;239804;39;0;0
FR;2;2021-04-12;17119;11206;0;0;0;895997;251010;39;0;0
FR;2;2021-04-13;19445;16337;1;0;0;915442;267347;40;0;0
FR;2;2021-04-14;18056;16268;7;0;0;933498;283615;47;0;0
FR;2;2021-04-15;22183;20765;26;0;0;955681;304380;73;0;0
FR;2;2021-04-16;20704;20050;45;0;0;976385;324430;118;0;0
FR;2;2021-04-17;13250;22441;5;0;0;989635;346871;123;0;0
FR;2;2021-04-18;5907;14389;6;0;0;995542;361260;129;0;0
FR;2;2021-04-19;16826;16247;24;0;0;1012368;377507;153;0;0
FR;2;2021-04-20;19313;21550;38;0;0;1031681;399057;191;0;0
FR;2;2021-04-21;20280;21660;76;0;0;1051961;420717;267;0;0
FR;2;2021-04-22;23804;24849;41;0;0;1075765;445566;308;0;0
FR;2;2021-04-23;24509;25338;76;0;0;1100274;470904;384;0;0
FR;2;2021-04-24;25299;15083;102;0;0;1125573;485987;486;0;0
FR;2;2021-04-25;9592;8593;5;0;0;1135165;494580;491;0;0
FR;2;2021-04-26;17154;17204;21;0;0;1152319;511784;512;0;0
FR;2;2021-04-27;19238;24274;40;0;0;1171557;536058;552;0;0
FR;2;2021-04-28;22331;26180;112;0;0;1193888;562238;664;0;0
FR;2;2021-04-29;25462;30133;69;0;0;1219350;592371;733;0;0
FR;2;2021-04-30;25529;27746;49;1;0;1244879;620117;782;1;0
FR;2;2021-05-01;14980;9870;6;0;0;1259859;629987;788;1;0
FR;2;2021-05-02;6634;9174;2;0;0;1266493;639161;790;1;0
FR;2;2021-05-03;20012;19289;40;0;0;1286505;658450;830;1;0
FR;2;2021-05-04;18280;29028;33;0;0;1304785;687478;863;1;0
FR;2;2021-05-05;18358;29375;48;0;0;1323143;716853;911;1;0
FR;2;2021-05-06;23536;35232;131;0;0;1346679;752085;1042;1;0
FR;2;2021-05-07;25320;33202;97;0;0;1371999;785287;1139;1;0
FR;2;2021-05-08;21333;9714;14;0;0;1393332;795001;1153;1;0
FR;2;2021-05-09;13161;7876;7;0;0;1406493;802877;1160;1;0
FR;2;2021-05-10;32935;22179;48;0;0;1439428;825056;1208;1;0
FR;2;2021-05-11;43591;21052;101;0;0;1483019;846108;1309;1;0
FR;2;2021-05-12;50033;19877;143;0;0;1533052;865985;1452;1;0
FR;2;2021-05-13;51286;5765;31;0;0;1584338;871750;1483;1;0
FR;2;2021-05-14;61337;12921;132;0;0;1645675;884671;1615;1;0
FR;2;2021-05-15;65918;7137;39;0;0;1711593;891808;1654;1;0
FR;2;2021-05-16;43577;2568;10;0;0;1755170;894376;1664;1;0
FR;2;2021-05-17;44739;12562;113;0;0;1799909;906938;1777;1;0
FR;2;2021-05-18;54631;12236;191;0;0;1854540;919174;1968;1;0
FR;2;2021-05-19;57159;10601;281;0;0;1911699;929775;2249;1;0
FR;2;2021-05-20;63428;10842;286;0;0;1975127;940617;2535;1;0
FR;2;2021-05-21;64282;11651;230;0;0;2039409;952268;2765;1;0
FR;2;2021-05-22;61475;4504;65;0;0;2100884;956772;2830;1;0
FR;2;2021-05-23;37529;569;22;0;0;2138413;957341;2852;1;0
FR;2;2021-05-24;17232;2032;33;0;0;2155645;959373;2885;1;0
FR;2;2021-05-25;21100;12231;239;0;0;2176745;971604;3124;1;0
FR;2;2021-05-26;19925;11444;229;0;0;2196670;983048;3353;1;0
FR;2;2021-05-27;22989;12660;181;0;0;2219659;995708;3534;1;0
FR;2;2021-05-28;29385;14950;190;0;0;2249044;1010658;3724;1;0
FR;2;2021-05-29;30413;8177;57;0;0;2279457;1018835;3781;1;0
FR;2;2021-05-30;4646;1813;6;0;0;2284103;1020648;3787;1;0
FR;2;2021-05-31;28583;18716;183;0;0;2312686;1039364;3970;1;0
FR;2;2021-06-01;45709;20022;221;0;0;2358395;1059386;4191;1;0
FR;2;2021-06-02;37459;19298;181;0;0;2395854;1078684;4372;1;0
FR;2;2021-06-03;51263;23350;161;0;0;2447117;1102034;4533;1;0
FR;2;2021-06-04;65507;24047;215;0;0;2512624;1126081;4748;1;0
FR;2;2021-06-05;34596;24024;51;0;0;2547220;1150105;4799;1;0
FR;2;2021-06-06;4947;6199;10;0;0;2552167;1156304;4809;1;0
FR;2;2021-06-07;28159;23056;146;0;0;2580326;1179360;4955;1;0
FR;2;2021-06-08;46369;22923;143;0;0;2626695;1202283;5098;1;0
FR;2;2021-06-09;34277;20918;107;0;0;2660972;1223201;5205;1;0
FR;2;2021-06-10;42631;19136;95;1;0;2703603;1242337;5300;2;0
FR;2;2021-06-11;55277;25226;133;0;0;2758880;1267563;5433;2;0
FR;2;2021-06-12;30557;19779;53;0;0;2789437;1287342;5486;2;0
FR;2;2021-06-13;3327;9183;13;0;0;2792764;1296525;5499;2;0
FR;2;2021-06-14;25294;24162;92;0;0;2818058;1320687;5591;2;0
FR;2;2021-06-15;39025;22853;154;0;0;2857083;1343540;5745;2;0
FR;2;2021-06-16;30155;21454;134;0;0;2887238;1364994;5879;2;0
FR;2;2021-06-17;36898;25868;150;0;0;2924136;1390862;6029;2;0
FR;2;2021-06-18;46841;28793;122;0;0;2970977;1419655;6151;2;0
FR;2;2021-06-19;24523;24894;39;0;0;2995500;1444549;6190;2;0
FR;2;2021-06-20;3737;10062;10;0;0;2999237;1454611;6200;2;0
FR;2;2021-06-21;17520;42837;87;0;0;3016757;1497448;6287;2;0
FR;2;2021-06-22;28353;49541;110;0;0;3045110;1546989;6397;2;0
FR;2;2021-06-23;21784;49563;106;1;1;3066894;1596552;6503;3;1
FR;2;2021-06-24;28372;50290;133;0;0;3095266;1646842;6636;3;1
FR;2;2021-06-25;33393;60378;127;0;0;3128659;1707220;6763;3;1
FR;2;2021-06-26;16368;59238;54;1;0;3145027;1766458;6817;4;1
FR;2;2021-06-27;2564;29322;22;1;0;3147591;1795780;6839;5;1
FR;2;2021-06-28;12633;54337;80;0;0;3160224;1850117;6919;5;1
FR;2;2021-06-29;19837;59880;178;0;0;3180061;1909997;7097;5;1
FR;2;2021-06-30;16315;57845;251;17;0;3196376;1967842;7348;22;1
FR;2;2021-07-01;20472;59886;227;0;0;3216848;2027728;7575;22;1
FR;2;2021-07-02;24067;62121;183;0;0;3240915;2089849;7758;22;1
FR;2;2021-07-03;12106;57079;153;0;0;3253021;2146928;7911;22;1
FR;2;2021-07-04;1958;23310;18;0;0;3254979;2170238;7929;22;1
FR;2;2021-07-05;9169;29360;106;0;0;3264148;2199598;8035;22;1
FR;2;2021-07-06;14572;36193;134;0;0;3278720;2235791;8169;22;1
FR;2;2021-07-07;14398;33665;138;0;0;3293118;2269456;8307;22;1
FR;2;2021-07-08;19709;40294;162;0;0;3312827;2309750;8469;22;1
FR;2;2021-07-09;27088;54257;202;1;0;3339915;2364007;8671;23;1
FR;2;2021-07-10;13380;33660;107;0;0;3353295;2397667;8778;23;1
FR;2;2021-07-11;1801;4336;16;0;0;3355096;2402003;8794;23;1
FR;2;2021-07-12;12959;37266;118;0;0;3368055;2439269;8912;23;1
FR;2;2021-07-13;37106;53231;150;0;0;3405161;2492500;9062;23;1
FR;2;2021-07-14;6601;3570;15;0;0;3411762;2496070;9077;23;1
FR;2;2021-07-15;47220;47025;156;0;0;3458982;2543095;9233;23;1
FR;2;2021-07-16;64301;55821;187;0;0;3523283;2598916;9420;23;1
FR;2;2021-07-17;31590;23931;96;0;0;3554873;2622847;9516;23;1
FR;2;2021-07-18;6086;4894;19;0;0;3560959;2627741;9535;23;1
FR;2;2021-07-19;32981;28682;93;0;0;3593940;2656423;9628;23;1
FR;2;2021-07-20;51983;44561;155;0;0;3645923;2700984;9783;23;1
FR;2;2021-07-21;45243;34781;93;0;0;3691166;2735765;9876;23;1
FR;2;2021-07-22;56269;41114;128;1;0;3747435;2776879;10004;24;1
FR;2;2021-07-23;68271;49091;170;0;0;3815706;2825970;10174;24;1
FR;2;2021-07-24;36162;21574;82;0;0;3851868;2847544;10256;24;1
FR;2;2021-07-25;6736;2658;10;0;0;3858604;2850202;10266;24;1
FR;2;2021-07-26;36289;22466;91;1;0;3894893;2872668;10357;25;1
FR;2;2021-07-27;62342;34622;180;0;0;3957235;2907290;10537;25;1
FR;2;2021-07-28;55279;26460;133;0;0;4012514;2933750;10670;25;1
FR;2;2021-07-29;68433;32776;189;0;0;4080947;2966526;10859;25;1
FR;2;2021-07-30;74419;37777;222;1;1;4155366;3004303;11081;26;2
FR;2;2021-07-31;34745;16175;104;0;0;4190111;3020478;11185;26;2
FR;2;2021-08-01;5393;2292;19;0;0;4195504;3022770;11204;26;2
FR;2;2021-08-02;35848;16206;101;0;0;4231352;3038976;11305;26;2
FR;2;2021-08-03;55949;28288;142;0;0;4287301;3067264;11447;26;2
FR;2;2021-08-04;46615;20861;128;0;0;4333916;3088125;11575;26;2
FR;2;2021-08-05;54601;31580;215;0;0;4388517;3119705;11790;26;2
FR;2;2021-08-06;58067;42382;242;1;0;4446584;3162087;12032;27;2
FR;2;2021-08-07;25130;17600;89;0;0;4471714;3179687;12121;27;2
FR;2;2021-08-08;3831;3669;21;0;0;4475545;3183356;12142;27;2
FR;2;2021-08-09;29282;21134;91;0;0;4504827;3204490;12233;27;2
FR;2;2021-08-10;44978;33510;152;0;0;4549805;3238000;12385;27;2
FR;2;2021-08-11;35260;25164;150;0;0;4585065;3263164;12535;27;2
FR;2;2021-08-12;41878;35731;162;0;0;4626943;3298895;12697;27;2
FR;2;2021-08-13;42579;37016;218;0;0;4669522;3335911;12915;27;2
FR;2;2021-08-14;18502;22265;93;0;0;4688024;3358176;13008;27;2
FR;2;2021-08-15;3794;3815;17;0;0;4691818;3361991;13025;27;2
FR;2;2021-08-16;25070;27218;110;0;0;4716888;3389209;13135;27;2
FR;2;2021-08-17;38245;43482;205;2;0;4755133;3432691;13340;29;2
FR;2;2021-08-18;32242;36386;194;1;1;4787375;3469077;13534;30;3
FR;2;2021-08-19;37424;46599;224;0;0;4824799;3515676;13758;30;3
FR;2;2021-08-20;40551;55581;269;1;0;4865350;3571257;14027;31;3
FR;2;2021-08-21;18112;24300;113;0;0;4883462;3595557;14140;31;3
FR;2;2021-08-22;2901;4326;22;1;1;4886363;3599883;14162;32;4
FR;2;2021-08-23;19238;35148;131;1;1;4905601;3635031;14293;33;5
FR;2;2021-08-24;31934;56026;235;0;0;4937535;3691057;14528;33;5
FR;2;2021-08-25;25925;43424;250;0;0;4963460;3734481;14778;33;5
FR;2;2021-08-26;32339;55775;387;0;0;4995799;3790256;15165;33;5
FR;2;2021-08-27;36993;65564;478;3;1;5032792;3855820;15643;36;6
FR;2;2021-08-28;17807;28460;300;0;0;5050599;3884280;15943;36;6
FR;2;2021-08-29;2653;5035;47;0;0;5053252;3889315;15990;36;6
FR;2;2021-08-30;18407;37746;399;0;761;5071659;3927061;16389;36;767
FR;2;2021-08-31;28073;57500;882;4;1535;5099732;3984561;17271;40;2302
FR;2;2021-09-01;21583;39819;1305;0;2084;5121315;4024380;18576;40;4386
FR;2;2021-09-02;25474;48594;1957;2;3273;5146789;4072974;20533;42;7659
FR;2;2021-09-03;33403;64467;2986;3;4814;5180192;4137441;23519;45;12473
FR;2;2021-09-04;16822;27677;1441;1;2343;5197014;4165118;24960;46;14816
FR;2;2021-09-05;2258;3618;263;0;412;5199272;4168736;25223;46;15228
FR;2;2021-09-06;14030;28731;1768;1;2929;5213302;4197467;26991;47;18157
FR;2;2021-09-07;21097;41052;3019;13;4843;5234399;4238519;30010;60;23000
FR;2;2021-09-08;17236;31908;2729;6;4442;5251635;4270427;32739;66;27442
FR;2;2021-09-09;20969;40434;4427;3;6722;5272604;4310861;37166;69;34164
FR;2;2021-09-10;28190;51096;5278;4;8775;5300794;4361957;42444;73;42939
FR;2;2021-09-11;13649;22337;2402;5;3919;5314443;4384294;44846;78;46858
FR;2;2021-09-12;1822;2794;282;0;502;5316265;4387088;45128;78;47360
FR;2;2021-09-13;11655;21454;2465;4;3993;5327920;4408542;47593;82;51353
FR;2;2021-09-14;18564;32767;5080;13;9002;5346484;4441309;52673;95;60355
FR;2;2021-09-15;14908;28284;5163;3;7779;5361392;4469593;57836;98;68134
FR;2;2021-09-16;16063;32753;6731;14;10515;5377455;4502346;64567;112;78649
FR;2;2021-09-17;20908;47070;8775;10;14565;5398363;4549416;73342;122;93214
FR;2;2021-09-18;9852;20915;3801;6;6021;5408215;4570331;77143;128;99235
FR;2;2021-09-19;1164;2657;395;0;650;5409379;4572988;77538;128;99885
FR;2;2021-09-20;7486;18804;3850;7;6148;5416865;4591792;81388;135;106033
FR;2;2021-09-21;11200;30010;6492;5;10736;5428065;4621802;87880;140;116769
FR;2;2021-09-22;9405;23549;5489;7;8510;5437470;4645351;93369;147;125279
FR;2;2021-09-23;10720;28869;7876;9;12631;5448190;4674220;101245;156;137910
FR;2;2021-09-24;15060;42831;10867;18;17155;5463250;4717051;112112;174;155065
FR;2;2021-09-25;7256;18705;3959;10;6073;5470506;4735756;116071;184;161138
FR;2;2021-09-26;1078;2564;494;0;638;5471584;4738320;116565;184;161776
FR;2;2021-09-27;6308;16448;4286;7;6550;5477892;4754768;120851;191;168326
FR;2;2021-09-28;9239;25538;7759;13;12052;5487131;4780306;128610;204;180378
FR;2;2021-09-29;8078;20206;6065;25;9252;5495209;4800512;134675;229;189630
FR;2;2021-09-30;9862;25774;9496;16;14069;5505071;4826286;144171;245;203699
FR;2;2021-10-01;13962;35614;12907;25;19214;5519033;4861900;157078;270;222913
FR;2;2021-10-02;6870;15865;4843;6;6994;5525903;4877765;161921;276;229907
FR;2;2021-10-03;841;1962;491;1;520;5526744;4879727;162412;277;230427
FR;2;2021-10-04;5816;13922;5512;5;7856;5532560;4893649;167924;282;238283
FR;2;2021-10-05;9047;22539;11119;19;15706;5541607;4916188;179043;301;253989
FR;2;2021-10-06;7776;17742;8236;11;11062;5549383;4933930;187279;312;265051
FR;2;2021-10-07;9193;22177;12369;15;16815;5558576;4956107;199648;327;281866
FR;2;2021-10-08;13420;32028;17344;27;23514;5571996;4988135;216992;354;305380
FR;2;2021-10-09;5996;12817;6039;6;7871;5577992;5000952;223031;360;313251
FR;2;2021-10-10;881;1637;435;2;629;5578873;5002589;223466;362;313880
FR;2;2021-10-11;5601;11616;6454;17;8835;5584474;5014205;229920;379;322715
FR;2;2021-10-12;8032;17750;12532;13;16721;5592506;5031955;242452;392;339436
FR;2;2021-10-13;6936;14853;10244;11;13601;5599442;5046808;252696;403;353037
FR;2;2021-10-14;8312;17928;14984;13;19439;5607754;5064736;267680;416;372476
FR;2;2021-10-15;11843;26257;20894;26;27926;5619597;5090993;288574;442;400402
FR;2;2021-10-16;5136;8729;1815;0;3205;5624733;5099722;290389;442;403607
FR;2;2021-10-17;650;1198;183;0;377;5625383;5100920;290572;442;403984
FR;2;2021-10-18;4555;7436;660;2;1679;5629938;5108356;291232;444;405663
FR;2;2021-10-19;6236;9904;728;5;2065;5636174;5118260;291960;449;407728
FR;2;2021-10-20;5159;8115;756;3;1686;5641333;5126375;292716;452;409414
FR;2;2021-10-21;6086;9975;777;5;2094;5647419;5136350;293493;457;411508
FR;2;2021-10-22;8442;14547;1141;4;2859;5655861;5150897;294634;461;414367
FR;2;2021-10-23;3840;5995;580;0;1235;5659701;5156892;295214;461;415602
FR;2;2021-10-24;493;881;99;0;198;5660194;5157773;295313;461;415800
FR;2;2021-10-25;3358;5385;298;1;829;5663552;5163158;295611;462;416629
FR;2;2021-10-26;4172;7245;1118;4;1994;5667724;5170403;296729;466;418623
FR;2;2021-10-27;3671;6634;1191;5;2001;5671395;5177037;297920;471;420624
FR;2;2021-10-28;4594;7693;1724;3;2734;5675989;5184730;299644;474;423358
FR;2;2021-10-29;5406;11077;2428;4;3663;5681395;5195807;302072;478;427021
FR;2;2021-10-30;2748;4431;971;1;1425;5684143;5200238;303043;479;428446
FR;2;2021-10-31;364;550;138;1;187;5684507;5200788;303181;480;428633
FR;2;2021-11-01;412;554;171;0;261;5684919;5201342;303352;480;428894
FR;2;2021-11-02;3285;6768;1179;0;1759;5688204;5208110;304531;480;430653
FR;2;2021-11-03;3332;6253;1380;2;1964;5691536;5214363;305911;482;432617
FR;2;2021-11-04;3984;7107;1756;4;2487;5695520;5221470;307667;486;435104
FR;2;2021-11-05;5221;10496;2863;5;3940;5700741;5231966;310530;491;439044
FR;2;2021-11-06;2589;4657;1396;0;1803;5703330;5236623;311926;491;440847
FR;2;2021-11-07;507;869;215;0;288;5703837;5237492;312141;491;441135
FR;2;2021-11-08;2576;5379;1199;3;1682;5706413;5242871;313340;494;442817
FR;2;2021-11-09;2748;6957;2391;6;3173;5709161;5249828;315731;500;445990
FR;2;2021-11-10;2583;5712;5088;6;6258;5711744;5255540;320819;506;452248
FR;2;2021-11-11;432;737;730;2;911;5712176;5256277;321549;508;453159
FR;2;2021-11-12;2946;8111;8958;8;10892;5715122;5264388;330507;516;464051
FR;2;2021-11-13;1529;3364;3864;7;4520;5716651;5267752;334371;523;468571
FR;2;2021-11-14;254;612;345;1;486;5716905;5268364;334716;524;469057
FR;2;2021-11-15;1618;3714;4432;9;5324;5718523;5272078;339148;533;474381
FR;2;2021-11-16;2181;5957;8286;14;10062;5720704;5278035;347434;547;484443
FR;2;2021-11-17;1737;4572;6614;8;7831;5722441;5282607;354048;555;492274
FR;2;2021-11-18;2186;5942;9169;11;10988;5724627;5288549;363217;566;503262
FR;2;2021-11-19;2696;7793;12954;19;15458;5727323;5296342;376171;585;518720
FR;2;2021-11-20;1565;3317;5164;5;6061;5728888;5299659;381335;590;524781
FR;2;2021-11-21;246;524;539;0;666;5729134;5300183;381874;590;525447
FR;2;2021-11-22;1274;2632;4467;5;5399;5730408;5302815;386341;595;530846
FR;2;2021-11-23;1613;4322;8184;9;9889;5732021;5307137;394525;604;540735
FR;2;2021-11-24;1420;3808;7455;14;8710;5733441;5310945;401980;618;549445
FR;2;2021-11-25;1809;4900;11441;21;13637;5735250;5315845;413421;639;563082
FR;2;2021-11-26;2533;7781;22642;31;26058;5737783;5323626;436063;670;589140
FR;2;2021-11-27;1497;4136;12254;18;13991;5739280;5327762;448317;688;603131
FR;2;2021-11-28;291;843;1965;3;2291;5739571;5328605;450282;691;605422
FR;2;2021-11-29;1444;4393;15070;23;17235;5741015;5332998;465352;714;622657
FR;2;2021-11-30;1911;6762;26218;36;29974;5742926;5339760;491570;750;652631
FR;2;2021-12-01;1899;6108;26181;29;29501;5744825;5345868;517751;779;682132
FR;2;2021-12-02;1909;6833;37680;52;41921;5746734;5352701;555431;831;724053
FR;2;2021-12-03;2549;10087;53583;112;59293;5749283;5362788;609014;943;783346
FR;2;2021-12-04;1847;6278;37084;38;40744;5751130;5369066;646098;981;824090
FR;2;2021-12-05;458;2292;14248;13;15991;5751588;5371358;660346;994;840081
FR;2;2021-12-06;2453;9891;77672;109;84729;5754041;5381249;738018;1103;924810
FR;2;2021-12-07;3441;15333;122405;238;133676;5757482;5396582;860423;1341;1058486
FR;2;2021-12-08;3715;16044;133163;330;145354;5761197;5412626;993586;1671;1203840
FR;2;2021-12-09;4543;19598;170129;554;185464;5765740;5432224;1163715;2225;1389304
FR;2;2021-12-10;4667;22805;188597;489;206016;5770407;5455029;1352312;2714;1595320
FR;2;2021-12-11;3682;16612;132417;238;144842;5774089;5471641;1484729;2952;1740162
FR;2;2021-12-12;1257;7143;59071;83;65127;5775346;5478784;1543800;3035;1805289
FR;2;2021-12-13;5522;26848;220637;604;242916;5780868;5505632;1764437;3639;2048205
FR;2;2021-12-14;7016;37506;300698;910;332149;5787884;5543138;2065135;4549;2380354
FR;2;2021-12-15;6557;36219;285153;955;315731;5794441;5579357;2350288;5504;2696085
FR;2;2021-12-16;7765;37931;312086;981;343682;5802206;5617288;2662374;6485;3039767
FR;2;2021-12-17;8682;41215;327814;975;360865;5810888;5658503;2990188;7460;3400632
FR;2;2021-12-18;6517;26563;212310;448;233613;5817405;5685066;3202498;7908;3634245
FR;2;2021-12-19;2602;11503;90196;184;100381;5820007;5696569;3292694;8092;3734626
FR;2;2021-12-20;9549;33608;275130;707;303305;5829556;5730177;3567824;8799;4037931
FR;2;2021-12-21;11554;38297;309573;970;341328;5841110;5768474;3877397;9769;4379259
FR;2;2021-12-22;10453;32871;265066;952;292459;5851563;5801345;4142463;10721;4671718
FR;2;2021-12-23;9428;26712;199439;700;221246;5860991;5828057;4341902;11421;4892964
FR;2;2021-12-24;2780;7505;43841;140;49562;5863771;5835562;4385743;11561;4942526
FR;2;2021-12-25;201;704;2000;10;2500;5863972;5836266;4387743;11571;4945026
FR;2;2021-12-26;1322;4214;25143;71;28680;5865294;5840480;4412886;11642;4973706
FR;2;2021-12-27;8076;29922;218372;658;243283;5873370;5870402;4631258;12300;5216989
FR;2;2021-12-28;9841;36347;272057;741;301946;5883211;5906749;4903315;13041;5518935
FR;2;2021-12-29;9493;32292;246092;766;272667;5892704;5939041;5149407;13807;5791602
FR;2;2021-12-30;9450;28138;208798;662;231463;5902154;5967179;5358205;14469;6023065
FR;2;2021-12-31;3008;8392;54973;177;61239;5905162;5975571;5413178;14646;6084304
FR;2;2022-01-01;227;690;2848;7;3337;5905389;5976261;5416026;14653;6087641
FR;2;2022-01-02;1505;4851;29505;74;33393;5906894;5981112;5445531;14727;6121034
FR;2;2022-01-03;9577;35347;266493;807;293848;5916471;6016459;5712024;15534;6414882
FR;2;2022-01-04;12838;45350;342049;1067;376927;5929309;6061809;6054073;16601;6791809
FR;2;2022-01-05;11271;38663;294120;884;323788;5940580;6100472;6348193;17485;7115597
FR;2;2022-01-06;13650;43459;331906;1296;364666;5954230;6143931;6680099;18781;7480263
FR;2;2022-01-07;14224;47617;361057;1268;396375;5968454;6191548;7041156;20049;7876638
FR;2;2022-01-08;7946;28140;201244;514;221664;5976400;6219688;7242400;20563;8098302
FR;2;2022-01-09;2748;9030;62513;137;69534;5979148;6228718;7304913;20700;8167836
FR;2;2022-01-10;10085;31919;232429;857;255032;5989233;6260637;7537342;21557;8422868
FR;2;2022-01-11;11463;36255;265856;1030;290552;6000696;6296892;7803198;22587;8713420
FR;2;2022-01-12;8755;29844;206284;861;226163;6009451;6326736;8009482;23448;8939583
FR;2;2022-01-13;9384;31335;224450;830;244795;6018835;6358071;8233932;24278;9184378
FR;2;2022-01-14;9739;35681;254498;919;277668;6028574;6393752;8488430;25197;9462046
FR;2;2022-01-15;5354;19448;140757;359;153625;6033928;6413200;8629187;25556;9615671
FR;2;2022-01-16;1513;5535;35862;80;39848;6035441;6418735;8665049;25636;9655519
FR;2;2022-01-17;5545;19308;135378;601;147245;6040986;6438043;8800427;26237;9802764
FR;2;2022-01-18;6416;21540;148596;648;160473;6047402;6459583;8949023;26885;9963237
FR;2;2022-01-19;4386;16374;105072;552;113682;6051788;6475957;9054095;27437;10076919
FR;2;2022-01-20;4865;17587;115262;601;123659;6056653;6493544;9169357;28038;10200578
FR;2;2022-01-21;5190;20061;137317;677;147735;6061843;6513605;9306674;28715;10348313
FR;2;2022-01-22;3027;10974;74249;259;80327;6064870;6524579;9380923;28974;10428640
FR;2;2022-01-23;722;2738;15233;41;16840;6065592;6527317;9396156;29015;10445480
FR;2;2022-01-24;3290;12838;75053;430;81011;6068882;6540155;9471209;29445;10526491
FR;2;2022-01-25;3573;14435;79602;495;85443;6072455;6554590;9550811;29940;10611934
FR;2;2022-01-26;2514;10655;58953;363;62984;6074969;6565245;9609764;30303;10674918
FR;2;2022-01-27;2683;11215;64154;388;67887;6077652;6576460;9673918;30691;10742805
FR;2;2022-01-28;3540;18440;91702;430;98964;6081192;6594900;9765620;31121;10841769
FR;2;2022-01-29;1890;9264;48833;164;52918;6083082;6604164;9814453;31285;10894687
FR;2;2022-01-30;466;2252;9453;37;10611;6083548;6606416;9823906;31322;10905298
FR;2;2022-01-31;1886;9611;43811;208;47342;6085434;6616027;9867717;31530;10952640
FR;2;2022-02-01;1907;10049;47015;278;50100;6087341;6626076;9914732;31808;11002740
FR;2;2022-02-02;1602;9032;41094;251;44164;6088943;6635108;9955826;32059;11046904
FR;2;2022-02-03;1715;8937;40503;204;42905;6090658;6644045;9996329;32263;11089809
FR;2;2022-02-04;2152;15223;66614;297;71336;6092810;6659268;10062943;32560;11161145
FR;2;2022-02-05;1360;8544;35929;131;39228;6094170;6667812;10098872;32691;11200373
FR;2;2022-02-06;274;1783;6122;16;6897;6094444;6669595;10104994;32707;11207270
FR;2;2022-02-07;1347;9612;37740;133;41300;6095791;6679207;10142734;32840;11248570
FR;2;2022-02-08;1296;9803;40924;173;43703;6097087;6689010;10183658;33013;11292273
FR;2;2022-02-09;1160;8805;37028;172;40446;6098247;6697815;10220686;33185;11332719
FR;2;2022-02-10;1015;7970;33826;203;36493;6099262;6705785;10254512;33388;11369212
FR;2;2022-02-11;1390;12074;53332;222;57676;6100652;6717859;10307844;33610;11426888
FR;2;2022-02-12;750;6523;27982;83;30799;6101402;6724382;10335826;33693;11457687
FR;2;2022-02-13;198;1333;4832;20;5572;6101600;6725715;10340658;33713;11463259
FR;2;2022-02-14;834;6722;30255;89;33219;6102434;6732437;10370913;33802;11496478
FR;2;2022-02-15;772;6444;28039;140;29978;6103206;6738881;10398952;33942;11526456
FR;2;2022-02-16;654;5335;22031;123;23588;6103860;6744216;10420983;34065;11550044
FR;2;2022-02-17;512;3766;14139;98;14602;6104372;6747982;10435122;34163;11564646
FR;2;2022-02-18;721;5356;20425;133;21119;6105093;6753338;10455547;34296;11585765
FR;2;2022-02-19;427;3044;10526;66;11239;6105520;6756382;10466073;34362;11597004
FR;2;2022-02-20;101;510;1455;3;1602;6105621;6756892;10467528;34365;11598606
FR;2;2022-02-21;416;2679;9110;65;9485;6106037;6759571;10476638;34430;11608091
FR;2;2022-02-22;390;2560;8886;75;8787;6106427;6762131;10485524;34505;11616878
FR;2;2022-02-23;431;2594;8978;82;9258;6106858;6764725;10494502;34587;11626136
FR;2;2022-02-24;312;2023;6794;81;6820;6107170;6766748;10501296;34668;11632956
FR;2;2022-02-25;455;3189;11406;108;11269;6107625;6769937;10512702;34776;11644225
FR;2;2022-02-26;291;1887;6032;49;6337;6107916;6771824;10518734;34825;11650562
FR;2;2022-02-27;74;311;903;5;945;6107990;6772135;10519637;34830;11651507
FR;2;2022-02-28;328;1673;5511;50;5516;6108318;6773808;10525148;34880;11657023
FR;2;2022-03-01;270;1548;5465;44;5180;6108588;6775356;10530613;34924;11662203
FR;2;2022-03-02;296;1428;5234;43;5075;6108884;6776784;10535847;34967;11667278
FR;2;2022-03-03;223;1095;3690;40;3465;6109107;6777879;10539537;35007;11670743
FR;2;2022-03-04;231;1455;4843;73;4488;6109338;6779334;10544380;35080;11675231
FR;2;2022-03-05;167;895;2969;32;2709;6109505;6780229;10547349;35112;11677940
FR;2;2022-03-06;36;177;269;5;310;6109541;6780406;10547618;35117;11678250
FR;2;2022-03-07;152;650;1978;68;1769;6109693;6781056;10549596;35185;11680019
FR;2;2022-03-08;142;649;2261;49;1894;6109835;6781705;10551857;35234;11681913
FR;2;2022-03-09;149;691;2331;36;2031;6109984;6782396;10554188;35270;11683944
FR;2;2022-03-10;116;586;1661;34;1437;6110100;6782982;10555849;35304;11685381
FR;2;2022-03-11;166;746;2760;57;2358;6110266;6783728;10558609;35361;11687739
FR;2;2022-03-12;140;475;1780;27;1548;6110406;6784203;10560389;35388;11689287
FR;2;2022-03-13;25;73;201;29;202;6110431;6784276;10560590;35417;11689489
FR;2;2022-03-14;119;451;1541;529;1272;6110550;6784727;10562131;35946;11690761
FR;2;2022-03-15;141;409;1693;687;1306;6110691;6785136;10563824;36633;11692067
FR;2;2022-03-16;136;451;1976;1610;1553;6110827;6785587;10565800;38243;11693620
FR;2;2022-03-17;92;407;1395;1190;1135;6110919;6785994;10567195;39433;11694755
FR;2;2022-03-18;138;485;2007;1787;1648;6111057;6786479;10569202;41220;11696403
FR;2;2022-03-19;106;318;1206;936;1012;6111163;6786797;10570408;42156;11697415
FR;2;2022-03-20;12;73;181;58;154;6111175;6786870;10570589;42214;11697569
FR;2;2022-03-21;94;289;1180;1479;1036;6111269;6787159;10571769;43693;11698605
FR;2;2022-03-22;115;376;1510;1826;1271;6111384;6787535;10573279;45519;11699876
FR;2;2022-03-23;136;331;1645;3023;1429;6111520;6787866;10574924;48542;11701305
FR;2;2022-03-24;107;278;1155;1540;965;6111627;6788144;10576079;50082;11702270
FR;2;2022-03-25;113;352;1768;2437;1440;6111740;6788496;10577847;52519;11703710
FR;2;2022-03-26;68;242;1185;1220;932;6111808;6788738;10579032;53739;11704642
FR;2;2022-03-27;18;36;150;93;128;6111826;6788774;10579182;53832;11704770
FR;2;2022-03-28;88;275;1112;1570;969;6111914;6789049;10580294;55402;11705739
FR;2;2022-03-29;102;246;1296;2457;1078;6112016;6789295;10581590;57859;11706817
FR;2;2022-03-30;85;292;1455;3104;1280;6112101;6789587;10583045;60963;11708097
FR;2;2022-03-31;101;264;1221;2135;1021;6112202;6789851;10584266;63098;11709118
FR;2;2022-04-01;106;284;1422;2271;1191;6112308;6790135;10585688;65369;11710309
FR;2;2022-04-02;58;145;808;880;699;6112366;6790280;10586496;66249;11711008
FR;2;2022-04-03;15;42;108;101;117;6112381;6790322;10586604;66350;11711125
FR;2;2022-04-04;98;202;899;1284;708;6112479;6790524;10587503;67634;11711833
FR;2;2022-04-05;119;256;1168;2327;998;6112598;6790780;10588671;69961;11712831
FR;3;2020-12-27;0;0;0;0;0;0;0;0;0;0
FR;3;2020-12-28;0;0;0;0;0;0;0;0;0;0
FR;3;2020-12-29;0;0;0;0;0;0;0;0;0;0
FR;3;2020-12-30;0;0;0;0;0;0;0;0;0;0
FR;3;2020-12-31;0;0;0;0;0;0;0;0;0;0
FR;3;2021-01-01;0;0;0;0;0;0;0;0;0;0
FR;3;2021-01-02;0;0;0;0;0;0;0;0;0;0
FR;3;2021-01-03;0;0;0;0;0;0;0;0;0;0
FR;3;2021-01-04;0;0;0;0;0;0;0;0;0;0
FR;3;2021-01-05;0;0;0;0;0;0;0;0;0;0
FR;3;2021-01-06;0;0;0;0;0;0;0;0;0;0
FR;3;2021-01-07;0;0;0;0;0;0;0;0;0;0
FR;3;2021-01-08;0;0;0;0;0;0;0;0;0;0
FR;3;2021-01-09;0;0;0;0;0;0;0;0;0;0
FR;3;2021-01-10;0;0;0;0;0;0;0;0;0;0
FR;3;2021-01-11;0;0;0;0;0;0;0;0;0;0
FR;3;2021-01-12;0;0;0;0;0;0;0;0;0;0
FR;3;2021-01-13;0;0;0;0;0;0;0;0;0;0
FR;3;2021-01-14;0;0;0;0;0;0;0;0;0;0
FR;3;2021-01-15;0;0;0;0;0;0;0;0;0;0
FR;3;2021-01-16;0;0;0;0;0;0;0;0;0;0
FR;3;2021-01-17;0;0;0;0;0;0;0;0;0;0
FR;3;2021-01-18;0;0;0;0;0;0;0;0;0;0
FR;3;2021-01-19;0;0;0;0;0;0;0;0;0;0
FR;3;2021-01-20;0;0;0;0;0;0;0;0;0;0
FR;3;2021-01-21;0;0;0;0;0;0;0;0;0;0
FR;3;2021-01-22;0;0;0;0;0;0;0;0;0;0
FR;3;2021-01-23;0;0;0;0;0;0;0;0;0;0
FR;3;2021-01-24;0;0;0;0;0;0;0;0;0;0
FR;3;2021-01-25;0;0;0;0;0;0;0;0;0;0
FR;3;2021-01-26;0;0;0;0;0;0;0;0;0;0
FR;3;2021-01-27;0;0;0;0;0;0;0;0;0;0
FR;3;2021-01-28;0;0;0;0;0;0;0;0;0;0
FR;3;2021-01-29;0;0;0;0;0;0;0;0;0;0
FR;3;2021-01-30;0;0;0;0;0;0;0;0;0;0
FR;3;2021-01-31;0;0;0;0;0;0;0;0;0;0
FR;3;2021-02-01;0;0;0;0;0;0;0;0;0;0
FR;3;2021-02-02;0;0;0;0;0;0;0;0;0;0
FR;3;2021-02-03;0;0;0;0;0;0;0;0;0;0
FR;3;2021-02-04;0;0;0;0;0;0;0;0;0;0
FR;3;2021-02-05;0;0;0;0;0;0;0;0;0;0
FR;3;2021-02-06;1702;0;0;0;0;1702;0;0;0;0
FR;3;2021-02-07;1422;0;0;0;0;3124;0;0;0;0
FR;3;2021-02-08;2779;0;0;0;0;5903;0;0;0;0
FR;3;2021-02-09;6780;0;0;0;0;12683;0;0;0;0
FR;3;2021-02-10;9601;0;0;0;0;22284;0;0;0;0
FR;3;2021-02-11;13607;0;0;0;0;35891;0;0;0;0
FR;3;2021-02-12;13393;0;0;0;0;49284;0;0;0;0
FR;3;2021-02-13;3778;0;0;0;0;53062;0;0;0;0
FR;3;2021-02-14;972;0;0;0;0;54034;0;0;0;0
FR;3;2021-02-15;10476;0;0;0;0;64510;0;0;0;0
FR;3;2021-02-16;12541;1;0;0;0;77051;1;0;0;0
FR;3;2021-02-17;11149;0;0;0;0;88200;1;0;0;0
FR;3;2021-02-18;14933;0;0;0;0;103133;1;0;0;0
FR;3;2021-02-19;14358;1;0;0;0;117491;2;0;0;0
FR;3;2021-02-20;3329;0;0;0;0;120820;2;0;0;0
FR;3;2021-02-21;618;0;0;0;0;121438;2;0;0;0
FR;3;2021-02-22;9160;0;0;0;0;130598;2;0;0;0
FR;3;2021-02-23;11394;1;0;0;0;141992;3;0;0;0
FR;3;2021-02-24;14298;0;0;0;0;156290;3;0;0;0
FR;3;2021-02-25;44927;1;0;0;0;201217;4;0;0;0
FR;3;2021-02-26;61881;2;0;0;0;263098;6;0;0;0
FR;3;2021-02-27;34800;5;0;0;0;297898;11;0;0;0
FR;3;2021-02-28;2463;0;0;0;0;300361;11;0;0;0
FR;3;2021-03-01;20503;9;0;0;0;320864;20;0;0;0
FR;3;2021-03-02;38859;17;0;0;0;359723;37;0;0;0
FR;3;2021-03-03;48727;16;0;0;0;408450;53;0;0;0
FR;3;2021-03-04;82210;19;0;0;0;490660;72;0;0;0
FR;3;2021-03-05;118120;37;0;0;0;608780;109;0;0;0
FR;3;2021-03-06;120706;49;1;0;0;729486;158;1;0;0
FR;3;2021-03-07;55174;26;0;0;0;784660;184;1;0;0
FR;3;2021-03-08;42805;23;0;0;0;827465;207;1;0;0
FR;3;2021-03-09;78967;39;0;0;0;906432;246;1;0;0
FR;3;2021-03-10;80960;42;0;0;0;987392;288;1;0;0
FR;3;2021-03-11;128410;48;0;0;0;1115802;336;1;0;0
FR;3;2021-03-12;182714;75;0;0;0;1298516;411;1;0;0
FR;3;2021-03-13;132136;57;0;0;0;1430652;468;1;0;0
FR;3;2021-03-14;14054;4;0;0;0;1444706;472;1;0;0
FR;3;2021-03-15;52219;39;0;0;0;1496925;511;1;0;0
FR;3;2021-03-16;1207;17;0;0;0;1498132;528;1;0;0
FR;3;2021-03-17;940;20;0;0;0;1499072;548;1;0;0
FR;3;2021-03-18;1563;9;0;0;0;1500635;557;1;0;0
FR;3;2021-03-19;70443;44;0;0;0;1571078;601;1;0;0
FR;3;2021-03-20;65223;40;0;0;0;1636301;641;1;0;0
FR;3;2021-03-21;5754;4;0;0;0;1642055;645;1;0;0
FR;3;2021-03-22;37492;36;0;0;0;1679547;681;1;0;0
FR;3;2021-03-23;84647;59;0;0;0;1764194;740;1;0;0
FR;3;2021-03-24;90928;91;0;0;0;1855122;831;1;0;0
FR;3;2021-03-25;150039;122;0;0;0;2005161;953;1;0;0
FR;3;2021-03-26;165408;149;0;0;0;2170569;1102;1;0;0
FR;3;2021-03-27;68453;94;0;0;0;2239022;1196;1;0;0
FR;3;2021-03-28;6468;19;0;0;0;2245490;1215;1;0;0
FR;3;2021-03-29;54151;68;0;0;0;2299641;1283;1;0;0
FR;3;2021-03-30;93154;96;0;0;0;2392795;1379;1;0;0
FR;3;2021-03-31;63517;85;0;0;0;2456312;1464;1;0;0
FR;3;2021-04-01;86115;101;0;0;0;2542427;1565;1;0;0
FR;3;2021-04-02;86884;146;0;0;0;2629311;1711;1;0;0
FR;3;2021-04-03;35866;113;0;0;0;2665177;1824;1;0;0
FR;3;2021-04-04;3569;14;0;0;0;2668746;1838;1;0;0
FR;3;2021-04-05;4481;26;0;0;0;2673227;1864;1;0;0
FR;3;2021-04-06;29738;78;0;0;0;2702965;1942;1;0;0
FR;3;2021-04-07;32333;70;0;0;0;2735298;2012;1;0;0
FR;3;2021-04-08;78806;235;0;0;0;2814104;2247;1;0;0
FR;3;2021-04-09;161744;409;0;0;0;2975848;2656;1;0;0
FR;3;2021-04-10;75751;331;0;0;0;3051599;2987;1;0;0
FR;3;2021-04-11;7307;44;0;0;0;3058906;3031;1;0;0
FR;3;2021-04-12;51465;200;0;0;0;3110371;3231;1;0;0
FR;3;2021-04-13;86215;312;0;0;0;3196586;3543;1;0;0
FR;3;2021-04-14;67832;338;0;0;0;3264418;3881;1;0;0
FR;3;2021-04-15;93219;365;0;0;0;3357637;4246;1;0;0
FR;3;2021-04-16;112513;565;0;0;0;3470150;4811;1;0;0
FR;3;2021-04-17;53311;318;1;0;0;3523461;5129;2;0;0
FR;3;2021-04-18;9741;32;0;0;0;3533202;5161;2;0;0
FR;3;2021-04-19;25101;234;0;0;0;3558303;5395;2;0;0
FR;3;2021-04-20;45667;391;0;0;0;3603970;5786;2;0;0
FR;3;2021-04-21;38960;460;0;0;0;3642930;6246;2;0;0
FR;3;2021-04-22;54699;777;0;0;0;3697629;7023;2;0;0
FR;3;2021-04-23;70477;1010;0;0;0;3768106;8033;2;0;0
FR;3;2021-04-24;37240;971;0;0;0;3805346;9004;2;0;0
FR;3;2021-04-25;6201;156;0;0;0;3811547;9160;2;0;0
FR;3;2021-04-26;19780;646;0;0;0;3831327;9806;2;0;0
FR;3;2021-04-27;34467;1248;0;0;0;3865794;11054;2;0;0
FR;3;2021-04-28;28956;1928;0;0;0;3894750;12982;2;0;0
FR;3;2021-04-29;45371;5947;0;0;0;3940121;18929;2;0;0
FR;3;2021-04-30;55450;8915;1;0;0;3995571;27844;3;0;0
FR;3;2021-05-01;9507;1963;0;0;0;4005078;29807;3;0;0
FR;3;2021-05-02;3069;489;0;0;0;4008147;30296;3;0;0
FR;3;2021-05-03;13053;3882;0;0;0;4021200;34178;3;0;0
FR;3;2021-05-04;23107;8394;0;0;0;4044307;42572;3;0;0
FR;3;2021-05-05;18746;10568;0;0;0;4063053;53140;3;0;0
FR;3;2021-05-06;34613;20870;0;0;0;4097666;74010;3;0;0
FR;3;2021-05-07;44196;28375;0;0;0;4141862;102385;3;0;0
FR;3;2021-05-08;6777;8840;0;0;0;4148639;111225;3;0;0
FR;3;2021-05-09;1792;2652;0;0;0;4150431;113877;3;0;0
FR;3;2021-05-10;14984;12550;0;0;0;4165415;126427;3;0;0
FR;3;2021-05-11;27090;25709;0;0;0;4192505;152136;3;0;0
FR;3;2021-05-12;17262;27433;0;0;0;4209767;179569;3;0;0
FR;3;2021-05-13;2275;3481;0;0;0;4212042;183050;3;0;0
FR;3;2021-05-14;14510;25702;0;0;0;4226552;208752;3;0;0
FR;3;2021-05-15;7228;20735;0;0;0;4233780;229487;3;0;0
FR;3;2021-05-16;973;2675;0;0;0;4234753;232162;3;0;0
FR;3;2021-05-17;7956;19908;0;0;0;4242709;252070;3;0;0
FR;3;2021-05-18;13403;29613;0;0;0;4256112;281683;3;0;0
FR;3;2021-05-19;9260;31781;0;0;0;4265372;313464;3;0;0
FR;3;2021-05-20;12800;53165;3;0;0;4278172;366629;6;0;0
FR;3;2021-05-21;12758;65475;2;0;0;4290930;432104;8;0;0
FR;3;2021-05-22;4958;33257;1;0;0;4295888;465361;9;0;0
FR;3;2021-05-23;649;2662;0;0;0;4296537;468023;9;0;0
FR;3;2021-05-24;875;4922;0;0;0;4297412;472945;9;0;0
FR;3;2021-05-25;5294;45147;1;0;0;4302706;518092;10;0;0
FR;3;2021-05-26;4966;51015;1;0;0;4307672;569107;11;0;0
FR;3;2021-05-27;6318;77769;3;0;0;4313990;646876;14;0;0
FR;3;2021-05-28;7539;99005;2;0;0;4321529;745881;16;0;0
FR;3;2021-05-29;3343;60230;1;0;0;4324872;806111;17;0;0
FR;3;2021-05-30;544;8231;0;0;0;4325416;814342;17;0;0
FR;3;2021-05-31;2429;35938;3;0;0;4327845;850280;20;0;0
FR;3;2021-06-01;3394;64754;10;0;0;4331239;915034;30;0;0
FR;3;2021-06-02;2721;58282;6;0;0;4333960;973316;36;0;0
FR;3;2021-06-03;3489;87492;10;0;0;4337449;1060808;46;0;0
FR;3;2021-06-04;4103;105030;22;0;0;4341552;1165838;68;0;0
FR;3;2021-06-05;1970;52212;4;0;0;4343522;1218050;72;0;0
FR;3;2021-06-06;504;5397;1;0;0;4344026;1223447;73;0;0
FR;3;2021-06-07;1461;31134;11;0;0;4345487;1254581;84;0;0
FR;3;2021-06-08;2043;47220;18;0;0;4347530;1301801;102;0;0
FR;3;2021-06-09;1782;42349;13;0;0;4349312;1344150;115;0;0
FR;3;2021-06-10;2240;67912;17;0;0;4351552;1412062;132;0;0
FR;3;2021-06-11;2469;96708;34;0;0;4354021;1508770;166;0;0
FR;3;2021-06-12;1171;40814;6;0;0;4355192;1549584;172;0;0
FR;3;2021-06-13;275;3818;3;0;0;4355467;1553402;175;0;0
FR;3;2021-06-14;1035;42631;17;0;0;4356502;1596033;192;0;0
FR;3;2021-06-15;1362;80615;20;0;0;4357864;1676648;212;0;0
FR;3;2021-06-16;1253;65710;19;0;0;4359117;1742358;231;0;0
FR;3;2021-06-17;1656;101768;41;0;0;4360773;1844126;272;0;0
FR;3;2021-06-18;1867;117854;61;0;0;4362640;1961980;333;0;0
FR;3;2021-06-19;801;39355;22;0;0;4363441;2001335;355;0;0
FR;3;2021-06-20;158;3389;0;0;0;4363599;2004724;355;0;0
FR;3;2021-06-21;761;39262;16;0;0;4364360;2043986;371;0;0
FR;3;2021-06-22;1060;69960;52;0;0;4365420;2113946;423;0;0
FR;3;2021-06-23;940;50801;38;0;0;4366360;2164747;461;0;0
FR;3;2021-06-24;1303;77131;48;0;0;4367663;2241878;509;0;0
FR;3;2021-06-25;1399;89908;73;0;0;4369062;2331786;582;0;0
FR;3;2021-06-26;624;33126;29;0;0;4369686;2364912;611;0;0
FR;3;2021-06-27;163;4013;1;0;0;4369849;2368925;612;0;0
FR;3;2021-06-28;646;30419;27;0;0;4370495;2399344;639;0;0
FR;3;2021-06-29;851;56137;95;0;0;4371346;2455481;734;0;0
FR;3;2021-06-30;897;45061;93;0;0;4372243;2500542;827;0;0
FR;3;2021-07-01;1160;65643;108;0;0;4373403;2566185;935;0;0
FR;3;2021-07-02;1291;90356;170;0;0;4374694;2656541;1105;0;0
FR;3;2021-07-03;600;31169;52;0;0;4375294;2687710;1157;0;0
FR;3;2021-07-04;141;4274;3;0;0;4375435;2691984;1160;0;0
FR;3;2021-07-05;606;33905;60;0;0;4376041;2725889;1220;0;0
FR;3;2021-07-06;953;56060;88;0;0;4376994;2781949;1308;0;0
FR;3;2021-07-07;868;43044;79;0;0;4377862;2824993;1387;0;0
FR;3;2021-07-08;1121;60711;99;0;0;4378983;2885704;1486;0;0
FR;3;2021-07-09;1258;68800;128;0;0;4380241;2954504;1614;0;0
FR;3;2021-07-10;639;25043;59;0;0;4380880;2979547;1673;0;0
FR;3;2021-07-11;127;3307;4;0;0;4381007;2982854;1677;0;0
FR;3;2021-07-12;658;23890;59;0;0;4381665;3006744;1736;0;0
FR;3;2021-07-13;1643;34735;90;0;0;4383308;3041479;1826;0;0
FR;3;2021-07-14;260;2648;2;0;0;4383568;3044127;1828;0;0
FR;3;2021-07-15;1930;30674;85;0;0;4385498;3074801;1913;0;0
FR;3;2021-07-16;2519;38869;122;0;0;4388017;3113670;2035;0;0
FR;3;2021-07-17;1043;13750;26;0;0;4389060;3127420;2061;0;0
FR;3;2021-07-18;261;2617;3;0;0;4389321;3130037;2064;0;0
FR;3;2021-07-19;1271;17219;37;0;0;4390592;3147256;2101;0;0
FR;3;2021-07-20;1820;27156;98;0;0;4392412;3174412;2199;0;0
FR;3;2021-07-21;1643;19733;44;0;0;4394055;3194145;2243;0;0
FR;3;2021-07-22;1846;27769;82;0;0;4395901;3221914;2325;0;0
FR;3;2021-07-23;2211;30453;117;0;0;4398112;3252367;2442;0;0
FR;3;2021-07-24;820;7012;25;0;0;4398932;3259379;2467;0;0
FR;3;2021-07-25;208;1355;1;0;0;4399140;3260734;2468;0;0
FR;3;2021-07-26;919;10716;28;0;0;4400059;3271450;2496;0;0
FR;3;2021-07-27;1164;16959;56;0;0;4401223;3288409;2552;0;0
FR;3;2021-07-28;985;12112;40;0;0;4402208;3300521;2592;0;0
FR;3;2021-07-29;1126;15853;63;0;0;4403334;3316374;2655;0;0
FR;3;2021-07-30;1123;18111;79;0;0;4404457;3334485;2734;0;0
FR;3;2021-07-31;406;3744;15;0;0;4404863;3338229;2749;0;0
FR;3;2021-08-01;111;484;1;0;0;4404974;3338713;2750;0;0
FR;3;2021-08-02;417;5159;22;0;0;4405391;3343872;2772;0;0
FR;3;2021-08-03;485;7600;27;0;0;4405876;3351472;2799;0;0
FR;3;2021-08-04;434;4900;26;0;0;4406310;3356372;2825;0;0
FR;3;2021-08-05;427;3745;12;0;0;4406737;3360117;2837;0;0
FR;3;2021-08-06;450;4801;30;0;0;4407187;3364918;2867;0;0
FR;3;2021-08-07;214;1919;11;0;0;4407401;3366837;2878;0;0
FR;3;2021-08-08;243;432;2;0;0;4407644;3367269;2880;0;0
FR;3;2021-08-09;310;2521;11;0;0;4407954;3369790;2891;0;0
FR;3;2021-08-10;357;3892;15;0;0;4408311;3373682;2906;0;0
FR;3;2021-08-11;284;2726;15;0;0;4408595;3376408;2921;0;0
FR;3;2021-08-12;273;2635;12;0;0;4408868;3379043;2933;0;0
FR;3;2021-08-13;274;2267;16;0;0;4409142;3381310;2949;0;0
FR;3;2021-08-14;167;923;1;0;0;4409309;3382233;2950;0;0
FR;3;2021-08-15;55;169;0;0;0;4409364;3382402;2950;0;0
FR;3;2021-08-16;122;1092;8;0;0;4409486;3383494;2958;0;0
FR;3;2021-08-17;186;1510;8;0;0;4409672;3385004;2966;0;0
FR;3;2021-08-18;191;1374;10;0;0;4409863;3386378;2976;0;0
FR;3;2021-08-19;161;1435;10;0;0;4410024;3387813;2986;0;0
FR;3;2021-08-20;162;1638;16;0;0;4410186;3389451;3002;0;0
FR;3;2021-08-21;93;587;2;0;0;4410279;3390038;3004;0;0
FR;3;2021-08-22;38;187;1;0;0;4410317;3390225;3005;0;0
FR;3;2021-08-23;139;940;7;0;0;4410456;3391165;3012;0;0
FR;3;2021-08-24;123;966;10;0;0;4410579;3392131;3022;0;0
FR;3;2021-08-25;135;850;2;0;0;4410714;3392981;3024;0;0
FR;3;2021-08-26;168;875;9;0;0;4410882;3393856;3033;0;0
FR;3;2021-08-27;171;967;9;0;0;4411053;3394823;3042;0;0
FR;3;2021-08-28;95;369;4;0;0;4411148;3395192;3046;0;0
FR;3;2021-08-29;124;134;1;0;0;4411272;3395326;3047;0;0
FR;3;2021-08-30;94;600;0;0;137;4411366;3395926;3047;0;137
FR;3;2021-08-31;125;717;7;0;157;4411491;3396643;3054;0;294
FR;3;2021-09-01;113;482;5;0;126;4411604;3397125;3059;0;420
FR;3;2021-09-02;99;636;22;0;123;4411703;3397761;3081;0;543
FR;3;2021-09-03;112;593;17;0;131;4411815;3398354;3098;0;674
FR;3;2021-09-04;51;299;3;0;59;4411866;3398653;3101;0;733
FR;3;2021-09-05;51;69;5;0;30;4411917;3398722;3106;0;763
FR;3;2021-09-06;111;405;4;0;151;4412028;3399127;3110;0;914
FR;3;2021-09-07;120;482;14;0;133;4412148;3399609;3124;0;1047
FR;3;2021-09-08;114;370;2;0;104;4412262;3399979;3126;0;1151
FR;3;2021-09-09;87;401;8;0;117;4412349;3400380;3134;0;1268
FR;3;2021-09-10;98;426;3;0;106;4412447;3400806;3137;0;1374
FR;3;2021-09-11;73;235;4;0;65;4412520;3401041;3141;0;1439
FR;3;2021-09-12;36;49;1;0;17;4412556;3401090;3142;0;1456
FR;3;2021-09-13;65;331;7;0;112;4412621;3401421;3149;0;1568
FR;3;2021-09-14;66;293;6;0;107;4412687;3401714;3155;0;1675
FR;3;2021-09-15;58;263;3;0;6;4412745;3401977;3158;0;1681
FR;3;2021-09-16;59;342;5;0;5;4412804;3402319;3163;0;1686
FR;3;2021-09-17;49;349;3;0;7;4412853;3402668;3166;0;1693
FR;3;2021-09-18;34;178;1;0;1;4412887;3402846;3167;0;1694
FR;3;2021-09-19;27;32;2;0;1;4412914;3402878;3169;0;1695
FR;3;2021-09-20;76;212;0;0;1;4412990;3403090;3169;0;1696
FR;3;2021-09-21;55;290;6;0;7;4413045;3403380;3175;0;1703
FR;3;2021-09-22;61;230;6;0;7;4413106;3403610;3181;0;1710
FR;3;2021-09-23;34;274;10;0;6;4413140;3403884;3191;0;1716
FR;3;2021-09-24;23;319;12;0;19;4413163;3404203;3203;0;1735
FR;3;2021-09-25;28;156;3;0;3;4413191;3404359;3206;0;1738
FR;3;2021-09-26;15;55;1;0;1;4413206;3404414;3207;0;1739
FR;3;2021-09-27;38;289;3;0;5;4413244;3404703;3210;0;1744
FR;3;2021-09-28;49;258;6;0;10;4413293;3404961;3216;0;1754
FR;3;2021-09-29;32;224;10;0;13;4413325;3405185;3226;0;1767
FR;3;2021-09-30;37;200;8;0;10;4413362;3405385;3234;0;1777
FR;3;2021-10-01;17;169;5;0;6;4413379;3405554;3239;0;1783
FR;3;2021-10-02;14;92;0;0;0;4413393;3405646;3239;0;1783
FR;3;2021-10-03;18;20;1;0;2;4413411;3405666;3240;0;1785
FR;3;2021-10-04;28;164;4;0;4;4413439;3405830;3244;0;1789
FR;3;2021-10-05;15;157;10;0;13;4413454;3405987;3254;0;1802
FR;3;2021-10-06;30;163;7;0;8;4413484;3406150;3261;0;1810
FR;3;2021-10-07;17;147;6;0;6;4413501;3406297;3267;0;1816
FR;3;2021-10-08;20;146;10;0;9;4413521;3406443;3277;0;1825
FR;3;2021-10-09;11;73;1;0;1;4413532;3406516;3278;0;1826
FR;3;2021-10-10;8;16;2;0;2;4413540;3406532;3280;0;1828
FR;3;2021-10-11;13;126;4;0;5;4413553;3406658;3284;0;1833
FR;3;2021-10-12;16;116;4;0;4;4413569;3406774;3288;0;1837
FR;3;2021-10-13;22;119;7;0;5;4413591;3406893;3295;0;1842
FR;3;2021-10-14;16;162;3;0;4;4413607;3407055;3298;0;1846
FR;3;2021-10-15;21;154;8;0;11;4413628;3407209;3306;0;1857
FR;3;2021-10-16;10;80;6;0;8;4413638;3407289;3312;0;1865
FR;3;2021-10-17;9;24;0;0;0;4413647;3407313;3312;0;1865
FR;3;2021-10-18;17;131;2;0;1;4413664;3407444;3314;0;1866
FR;3;2021-10-19;16;129;19;0;21;4413680;3407573;3333;0;1887
FR;3;2021-10-20;18;136;5;0;6;4413698;3407709;3338;0;1893
FR;3;2021-10-21;22;137;17;0;13;4413720;3407846;3355;0;1906
FR;3;2021-10-22;17;128;16;0;20;4413737;3407974;3371;0;1926
FR;3;2021-10-23;11;59;2;0;1;4413748;3408033;3373;0;1927
FR;3;2021-10-24;7;27;0;0;0;4413755;3408060;3373;0;1927
FR;3;2021-10-25;21;154;6;0;6;4413776;3408214;3379;0;1933
FR;3;2021-10-26;17;119;22;0;19;4413793;3408333;3401;0;1952
FR;3;2021-10-27;15;117;9;0;9;4413808;3408450;3410;0;1961
FR;3;2021-10-28;19;129;33;0;36;4413827;3408579;3443;0;1997
FR;3;2021-10-29;10;124;64;0;54;4413837;3408703;3507;0;2051
FR;3;2021-10-30;8;73;11;1;10;4413845;3408776;3518;1;2061
FR;3;2021-10-31;5;23;1;0;1;4413850;3408799;3519;1;2062
FR;3;2021-11-01;5;21;2;0;1;4413855;3408820;3521;1;2063
FR;3;2021-11-02;9;110;8;0;10;4413864;3408930;3529;1;2073
FR;3;2021-11-03;19;125;9;0;9;4413883;3409055;3538;1;2082
FR;3;2021-11-04;15;98;3;0;2;4413898;3409153;3541;1;2084
FR;3;2021-11-05;16;148;8;1;5;4413914;3409301;3549;2;2089
FR;3;2021-11-06;6;67;3;0;3;4413920;3409368;3552;2;2092
FR;3;2021-11-07;6;21;1;0;1;4413926;3409389;3553;2;2093
FR;3;2021-11-08;9;144;7;0;5;4413935;3409533;3560;2;2098
FR;3;2021-11-09;9;156;5;0;5;4413944;3409689;3565;2;2103
FR;3;2021-11-10;11;191;13;0;14;4413955;3409880;3578;2;2117
FR;3;2021-11-11;5;53;3;0;3;4413960;3409933;3581;2;2120
FR;3;2021-11-12;9;165;6;0;4;4413969;3410098;3587;2;2124
FR;3;2021-11-13;5;79;8;0;10;4413974;3410177;3595;2;2134
FR;3;2021-11-14;2;20;0;0;0;4413976;3410197;3595;2;2134
FR;3;2021-11-15;3;195;9;0;9;4413979;3410392;3604;2;2143
FR;3;2021-11-16;2;169;11;0;10;4413981;3410561;3615;2;2153
FR;3;2021-11-17;5;185;10;0;7;4413986;3410746;3625;2;2160
FR;3;2021-11-18;10;186;10;0;11;4413996;3410932;3635;2;2171
FR;3;2021-11-19;5;238;22;0;27;4414001;3411170;3657;2;2198
FR;3;2021-11-20;5;119;5;0;5;4414006;3411289;3662;2;2203
FR;3;2021-11-21;3;30;3;0;3;4414009;3411319;3665;2;2206
FR;3;2021-11-22;10;243;10;0;10;4414019;3411562;3675;2;2216
FR;3;2021-11-23;6;236;15;0;14;4414025;3411798;3690;2;2230
FR;3;2021-11-24;5;251;9;0;17;4414030;3412049;3699;2;2247
FR;3;2021-11-25;9;289;11;0;10;4414039;3412338;3710;2;2257
FR;3;2021-11-26;5;380;33;0;30;4414044;3412718;3743;2;2287
FR;3;2021-11-27;5;179;19;0;20;4414049;3412897;3762;2;2307
FR;3;2021-11-28;2;61;7;0;7;4414051;3412958;3769;2;2314
FR;3;2021-11-29;4;334;19;0;20;4414055;3413292;3788;2;2334
FR;3;2021-11-30;4;425;26;0;29;4414059;3413717;3814;2;2363
FR;3;2021-12-01;18;472;32;0;33;4414077;3414189;3846;2;2396
FR;3;2021-12-02;9;500;33;0;36;4414086;3414689;3879;2;2432
FR;3;2021-12-03;3;576;37;0;38;4414089;3415265;3916;2;2470
FR;3;2021-12-04;3;283;26;0;28;4414092;3415548;3942;2;2498
FR;3;2021-12-05;1;83;5;0;5;4414093;3415631;3947;2;2503
FR;3;2021-12-06;5;517;14;0;16;4414098;3416148;3961;2;2519
FR;3;2021-12-07;4;612;20;0;24;4414102;3416760;3981;2;2543
FR;3;2021-12-08;3;544;29;0;29;4414105;3417304;4010;2;2572
FR;3;2021-12-09;3;605;17;0;22;4414108;3417909;4027;2;2594
FR;3;2021-12-10;9;637;29;0;25;4414117;3418546;4056;2;2619
FR;3;2021-12-11;4;395;10;0;9;4414121;3418941;4066;2;2628
FR;3;2021-12-12;1;122;3;0;3;4414122;3419063;4069;2;2631
FR;3;2021-12-13;2;607;19;0;20;4414124;3419670;4088;2;2651
FR;3;2021-12-14;7;771;18;0;21;4414131;3420441;4106;2;2672
FR;3;2021-12-15;7;733;17;0;21;4414138;3421174;4123;2;2693
FR;3;2021-12-16;9;738;19;0;18;4414147;3421912;4142;2;2711
FR;3;2021-12-17;4;809;18;0;19;4414151;3422721;4160;2;2730
FR;3;2021-12-18;4;415;4;0;5;4414155;3423136;4164;2;2735
FR;3;2021-12-19;3;207;2;0;2;4414158;3423343;4166;2;2737
FR;3;2021-12-20;8;731;23;0;28;4414166;3424074;4189;2;2765
FR;3;2021-12-21;3;816;10;0;14;4414169;3424890;4199;2;2779
FR;3;2021-12-22;6;763;9;0;11;4414175;3425653;4208;2;2790
FR;3;2021-12-23;1;657;9;0;8;4414176;3426310;4217;2;2798
FR;3;2021-12-24;2;276;3;0;6;4414178;3426586;4220;2;2804
FR;3;2021-12-25;0;25;0;0;0;4414178;3426611;4220;2;2804
FR;3;2021-12-26;0;95;1;0;1;4414178;3426706;4221;2;2805
FR;3;2021-12-27;7;544;17;0;19;4414185;3427250;4238;2;2824
FR;3;2021-12-28;1;694;6;0;5;4414186;3427944;4244;2;2829
FR;3;2021-12-29;4;575;14;0;16;4414190;3428519;4258;2;2845
FR;3;2021-12-30;1;604;7;0;10;4414191;3429123;4265;2;2855
FR;3;2021-12-31;0;208;5;0;6;4414191;3429331;4270;2;2861
FR;3;2022-01-01;0;27;0;0;2;4414191;3429358;4270;2;2863
FR;3;2022-01-02;0;82;0;0;0;4414191;3429440;4270;2;2863
FR;3;2022-01-03;3;564;17;0;20;4414194;3430004;4287;2;2883
FR;3;2022-01-04;6;625;9;0;8;4414200;3430629;4296;2;2891
FR;3;2022-01-05;3;557;10;0;14;4414203;3431186;4306;2;2905
FR;3;2022-01-06;4;554;9;0;12;4414207;3431740;4315;2;2917
FR;3;2022-01-07;2;577;11;0;14;4414209;3432317;4326;2;2931
FR;3;2022-01-08;2;286;4;0;5;4414211;3432603;4330;2;2936
FR;3;2022-01-09;0;118;0;0;0;4414211;3432721;4330;2;2936
FR;3;2022-01-10;2;481;12;0;12;4414213;3433202;4342;2;2948
FR;3;2022-01-11;2;535;1;0;1;4414215;3433737;4343;2;2949
FR;3;2022-01-12;3;449;9;0;10;4414218;3434186;4352;2;2959
FR;3;2022-01-13;3;427;11;0;12;4414221;3434613;4363;2;2971
FR;3;2022-01-14;3;483;10;0;12;4414224;3435096;4373;2;2983
FR;3;2022-01-15;0;299;2;0;3;4414224;3435395;4375;2;2986
FR;3;2022-01-16;0;116;1;0;1;4414224;3435511;4376;2;2987
FR;3;2022-01-17;2;352;8;0;10;4414226;3435863;4384;2;2997
FR;3;2022-01-18;2;419;1;0;2;4414228;3436282;4385;2;2999
FR;3;2022-01-19;1;351;5;0;10;4414229;3436633;4390;2;3009
FR;3;2022-01-20;1;380;5;0;3;4414230;3437013;4395;2;3012
FR;3;2022-01-21;2;376;5;0;8;4414232;3437389;4400;2;3020
FR;3;2022-01-22;2;233;1;0;3;4414234;3437622;4401;2;3023
FR;3;2022-01-23;0;82;0;0;1;4414234;3437704;4401;2;3024
FR;3;2022-01-24;2;351;1;0;6;4414236;3438055;4402;2;3030
FR;3;2022-01-25;0;194;0;0;0;4414236;3438249;4402;2;3030
FR;3;2022-01-26;0;89;0;0;0;4414236;3438338;4402;2;3030
FR;3;2022-01-27;0;60;0;0;0;4414236;3438398;4402;2;3030
FR;3;2022-01-28;0;134;0;0;0;4414236;3438532;4402;2;3030
FR;3;2022-01-29;0;110;0;0;0;4414236;3438642;4402;2;3030
FR;3;2022-01-30;0;51;0;0;0;4414236;3438693;4402;2;3030
FR;3;2022-01-31;0;98;0;0;0;4414236;3438791;4402;2;3030
FR;3;2022-02-01;0;110;0;0;1;4414236;3438901;4402;2;3031
FR;3;2022-02-02;0;98;0;0;0;4414236;3438999;4402;2;3031
FR;3;2022-02-03;0;101;0;0;0;4414236;3439100;4402;2;3031
FR;3;2022-02-04;0;124;0;0;0;4414236;3439224;4402;2;3031
FR;3;2022-02-05;0;73;0;0;0;4414236;3439297;4402;2;3031
FR;3;2022-02-06;0;11;0;0;0;4414236;3439308;4402;2;3031
FR;3;2022-02-07;0;89;0;0;1;4414236;3439397;4402;2;3032
FR;3;2022-02-08;0;0;0;0;0;4414236;3439397;4402;2;3032
FR;3;2022-02-09;0;0;0;0;0;4414236;3439397;4402;2;3032
FR;3;2022-02-10;0;0;0;0;0;4414236;3439397;4402;2;3032
FR;3;2022-02-11;0;0;0;0;0;4414236;3439397;4402;2;3032
FR;3;2022-02-12;0;0;0;0;0;4414236;3439397;4402;2;3032
FR;3;2022-02-13;0;0;0;0;0;4414236;3439397;4402;2;3032
FR;3;2022-02-14;0;0;0;0;0;4414236;3439397;4402;2;3032
FR;3;2022-02-15;0;0;0;0;0;4414236;3439397;4402;2;3032
FR;3;2022-02-16;0;0;0;0;0;4414236;3439397;4402;2;3032
FR;3;2022-02-17;0;0;0;0;0;4414236;3439397;4402;2;3032
FR;3;2022-02-18;0;0;0;0;0;4414236;3439397;4402;2;3032
FR;3;2022-02-19;0;0;0;0;0;4414236;3439397;4402;2;3032
FR;3;2022-02-20;0;0;0;0;0;4414236;3439397;4402;2;3032
FR;3;2022-02-21;2;0;0;0;0;4414238;3439397;4402;2;3032
FR;3;2022-02-22;0;0;0;0;0;4414238;3439397;4402;2;3032
FR;3;2022-02-23;0;0;0;0;0;4414238;3439397;4402;2;3032
FR;3;2022-02-24;0;0;0;0;0;4414238;3439397;4402;2;3032
FR;3;2022-02-25;0;0;0;0;0;4414238;3439397;4402;2;3032
FR;3;2022-02-26;0;0;0;0;0;4414238;3439397;4402;2;3032
FR;3;2022-02-27;0;0;0;0;0;4414238;3439397;4402;2;3032
FR;3;2022-02-28;1;0;0;0;0;4414239;3439397;4402;2;3032
FR;3;2022-03-01;1;0;0;0;0;4414240;3439397;4402;2;3032
FR;3;2022-03-02;0;0;0;0;0;4414240;3439397;4402;2;3032
FR;3;2022-03-03;0;0;0;0;0;4414240;3439397;4402;2;3032
FR;3;2022-03-04;0;0;0;0;0;4414240;3439397;4402;2;3032
FR;3;2022-03-05;0;0;0;0;0;4414240;3439397;4402;2;3032
FR;3;2022-03-06;1;0;0;0;0;4414241;3439397;4402;2;3032
FR;3;2022-03-07;0;0;0;0;0;4414241;3439397;4402;2;3032
FR;3;2022-03-08;1;0;0;0;0;4414242;3439397;4402;2;3032
FR;3;2022-03-09;0;0;0;0;0;4414242;3439397;4402;2;3032
FR;3;2022-03-10;0;0;0;0;0;4414242;3439397;4402;2;3032
FR;3;2022-03-11;0;0;0;0;0;4414242;3439397;4402;2;3032
FR;3;2022-03-12;0;0;0;0;0;4414242;3439397;4402;2;3032
FR;3;2022-03-13;0;0;0;0;0;4414242;3439397;4402;2;3032
FR;3;2022-03-14;0;0;0;0;0;4414242;3439397;4402;2;3032
FR;3;2022-03-15;0;0;0;0;0;4414242;3439397;4402;2;3032
FR;3;2022-03-16;0;0;0;0;0;4414242;3439397;4402;2;3032
FR;3;2022-03-17;0;0;0;0;0;4414242;3439397;4402;2;3032
FR;3;2022-03-18;0;0;0;0;0;4414242;3439397;4402;2;3032
FR;3;2022-03-19;0;0;0;0;0;4414242;3439397;4402;2;3032
FR;3;2022-03-20;1;0;0;0;0;4414243;3439397;4402;2;3032
FR;3;2022-03-21;0;0;0;0;0;4414243;3439397;4402;2;3032
FR;3;2022-03-22;0;0;0;0;0;4414243;3439397;4402;2;3032
FR;3;2022-03-23;1;0;0;0;0;4414244;3439397;4402;2;3032
FR;3;2022-03-24;0;0;0;0;0;4414244;3439397;4402;2;3032
FR;3;2022-03-25;1;0;0;0;0;4414245;3439397;4402;2;3032
FR;3;2022-03-26;0;0;0;0;0;4414245;3439397;4402;2;3032
FR;3;2022-03-27;0;0;0;0;0;4414245;3439397;4402;2;3032
FR;3;2022-03-28;0;0;0;0;0;4414245;3439397;4402;2;3032
FR;3;2022-03-29;0;0;0;0;0;4414245;3439397;4402;2;3032
FR;3;2022-03-30;0;0;0;0;0;4414245;3439397;4402;2;3032
FR;3;2022-03-31;0;0;0;0;0;4414245;3439397;4402;2;3032
FR;3;2022-04-01;0;0;0;0;0;4414245;3439397;4402;2;3032
FR;3;2022-04-02;0;0;0;0;0;4414245;3439397;4402;2;3032
FR;3;2022-04-03;0;0;0;0;0;4414245;3439397;4402;2;3032
FR;3;2022-04-04;0;0;0;0;0;4414245;3439397;4402;2;3032
FR;3;2022-04-05;0;0;0;0;0;4414245;3439397;4402;2;3032
FR;4;2020-12-27;0;0;0;0;0;0;0;0;0;0
FR;4;2020-12-28;0;0;0;0;0;0;0;0;0;0
FR;4;2020-12-29;0;0;0;0;0;0;0;0;0;0
FR;4;2020-12-30;0;0;0;0;0;0;0;0;0;0
FR;4;2020-12-31;0;0;0;0;0;0;0;0;0;0
FR;4;2021-01-01;0;0;0;0;0;0;0;0;0;0
FR;4;2021-01-02;0;0;0;0;0;0;0;0;0;0
FR;4;2021-01-03;0;0;0;0;0;0;0;0;0;0
FR;4;2021-01-04;0;0;0;0;0;0;0;0;0;0
FR;4;2021-01-05;0;0;0;0;0;0;0;0;0;0
FR;4;2021-01-06;0;0;0;0;0;0;0;0;0;0
FR;4;2021-01-07;0;0;0;0;0;0;0;0;0;0
FR;4;2021-01-08;0;0;0;0;0;0;0;0;0;0
FR;4;2021-01-09;0;0;0;0;0;0;0;0;0;0
FR;4;2021-01-10;0;0;0;0;0;0;0;0;0;0
FR;4;2021-01-11;0;0;0;0;0;0;0;0;0;0
FR;4;2021-01-12;0;0;0;0;0;0;0;0;0;0
FR;4;2021-01-13;0;0;0;0;0;0;0;0;0;0
FR;4;2021-01-14;0;0;0;0;0;0;0;0;0;0
FR;4;2021-01-15;0;0;0;0;0;0;0;0;0;0
FR;4;2021-01-16;0;0;0;0;0;0;0;0;0;0
FR;4;2021-01-17;0;0;0;0;0;0;0;0;0;0
FR;4;2021-01-18;0;0;0;0;0;0;0;0;0;0
FR;4;2021-01-19;0;0;0;0;0;0;0;0;0;0
FR;4;2021-01-20;0;0;0;0;0;0;0;0;0;0
FR;4;2021-01-21;0;0;0;0;0;0;0;0;0;0
FR;4;2021-01-22;0;0;0;0;0;0;0;0;0;0
FR;4;2021-01-23;0;0;0;0;0;0;0;0;0;0
FR;4;2021-01-24;0;0;0;0;0;0;0;0;0;0
FR;4;2021-01-25;0;0;0;0;0;0;0;0;0;0
FR;4;2021-01-26;0;0;0;0;0;0;0;0;0;0
FR;4;2021-01-27;0;0;0;0;0;0;0;0;0;0
FR;4;2021-01-28;0;0;0;0;0;0;0;0;0;0
FR;4;2021-01-29;0;0;0;0;0;0;0;0;0;0
FR;4;2021-01-30;0;0;0;0;0;0;0;0;0;0
FR;4;2021-01-31;0;0;0;0;0;0;0;0;0;0
FR;4;2021-02-01;0;0;0;0;0;0;0;0;0;0
FR;4;2021-02-02;0;0;0;0;0;0;0;0;0;0
FR;4;2021-02-03;0;0;0;0;0;0;0;0;0;0
FR;4;2021-02-04;0;0;0;0;0;0;0;0;0;0
FR;4;2021-02-05;0;0;0;0;0;0;0;0;0;0
FR;4;2021-02-06;0;0;0;0;0;0;0;0;0;0
FR;4;2021-02-07;0;0;0;0;0;0;0;0;0;0
FR;4;2021-02-08;0;0;0;0;0;0;0;0;0;0
FR;4;2021-02-09;0;0;0;0;0;0;0;0;0;0
FR;4;2021-02-10;0;0;0;0;0;0;0;0;0;0
FR;4;2021-02-11;0;0;0;0;0;0;0;0;0;0
FR;4;2021-02-12;0;0;0;0;0;0;0;0;0;0
FR;4;2021-02-13;0;0;0;0;0;0;0;0;0;0
FR;4;2021-02-14;0;0;0;0;0;0;0;0;0;0
FR;4;2021-02-15;0;0;0;0;0;0;0;0;0;0
FR;4;2021-02-16;0;0;0;0;0;0;0;0;0;0
FR;4;2021-02-17;0;0;0;0;0;0;0;0;0;0
FR;4;2021-02-18;0;0;0;0;0;0;0;0;0;0
FR;4;2021-02-19;0;0;0;0;0;0;0;0;0;0
FR;4;2021-02-20;0;0;0;0;0;0;0;0;0;0
FR;4;2021-02-21;0;0;0;0;0;0;0;0;0;0
FR;4;2021-02-22;0;0;0;0;0;0;0;0;0;0
FR;4;2021-02-23;0;0;0;0;0;0;0;0;0;0
FR;4;2021-02-24;0;0;0;0;0;0;0;0;0;0
FR;4;2021-02-25;0;0;0;0;0;0;0;0;0;0
FR;4;2021-02-26;0;0;0;0;0;0;0;0;0;0
FR;4;2021-02-27;0;0;0;0;0;0;0;0;0;0
FR;4;2021-02-28;0;0;0;0;0;0;0;0;0;0
FR;4;2021-03-01;0;0;0;0;0;0;0;0;0;0
FR;4;2021-03-02;0;0;0;0;0;0;0;0;0;0
FR;4;2021-03-03;0;0;0;0;0;0;0;0;0;0
FR;4;2021-03-04;0;0;0;0;0;0;0;0;0;0
FR;4;2021-03-05;0;0;0;0;0;0;0;0;0;0
FR;4;2021-03-06;0;0;0;0;0;0;0;0;0;0
FR;4;2021-03-07;0;0;0;0;0;0;0;0;0;0
FR;4;2021-03-08;0;0;0;0;0;0;0;0;0;0
FR;4;2021-03-09;0;0;0;0;0;0;0;0;0;0
FR;4;2021-03-10;0;0;0;0;0;0;0;0;0;0
FR;4;2021-03-11;0;0;0;0;0;0;0;0;0;0
FR;4;2021-03-12;0;0;0;0;0;0;0;0;0;0
FR;4;2021-03-13;0;0;0;0;0;0;0;0;0;0
FR;4;2021-03-14;0;0;0;0;0;0;0;0;0;0
FR;4;2021-03-15;0;0;0;0;0;0;0;0;0;0
FR;4;2021-03-16;0;0;0;0;0;0;0;0;0;0
FR;4;2021-03-17;0;0;0;0;0;0;0;0;0;0
FR;4;2021-03-18;0;0;0;0;0;0;0;0;0;0
FR;4;2021-03-19;0;0;0;0;0;0;0;0;0;0
FR;4;2021-03-20;0;0;0;0;0;0;0;0;0;0
FR;4;2021-03-21;0;0;0;0;0;0;0;0;0;0
FR;4;2021-03-22;0;0;0;0;0;0;0;0;0;0
FR;4;2021-03-23;0;0;0;0;0;0;0;0;0;0
FR;4;2021-03-24;0;0;0;0;0;0;0;0;0;0
FR;4;2021-03-25;0;0;0;0;0;0;0;0;0;0
FR;4;2021-03-26;0;0;0;0;0;0;0;0;0;0
FR;4;2021-03-27;0;0;0;0;0;0;0;0;0;0
FR;4;2021-03-28;0;0;0;0;0;0;0;0;0;0
FR;4;2021-03-29;0;0;0;0;0;0;0;0;0;0
FR;4;2021-03-30;0;0;0;0;0;0;0;0;0;0
FR;4;2021-03-31;0;0;0;0;0;0;0;0;0;0
FR;4;2021-04-01;0;0;0;0;0;0;0;0;0;0
FR;4;2021-04-02;0;0;0;0;0;0;0;0;0;0
FR;4;2021-04-03;0;0;0;0;0;0;0;0;0;0
FR;4;2021-04-04;0;0;0;0;0;0;0;0;0;0
FR;4;2021-04-05;0;0;0;0;0;0;0;0;0;0
FR;4;2021-04-06;0;0;0;0;0;0;0;0;0;0
FR;4;2021-04-07;0;0;0;0;0;0;0;0;0;0
FR;4;2021-04-08;0;0;0;0;0;0;0;0;0;0
FR;4;2021-04-09;0;0;0;0;0;0;0;0;0;0
FR;4;2021-04-10;0;0;0;0;0;0;0;0;0;0
FR;4;2021-04-11;0;0;0;0;0;0;0;0;0;0
FR;4;2021-04-12;0;0;0;0;0;0;0;0;0;0
FR;4;2021-04-13;0;0;0;0;0;0;0;0;0;0
FR;4;2021-04-14;0;0;0;0;0;0;0;0;0;0
FR;4;2021-04-15;0;0;0;0;0;0;0;0;0;0
FR;4;2021-04-16;0;0;0;0;0;0;0;0;0;0
FR;4;2021-04-17;0;0;0;0;0;0;0;0;0;0
FR;4;2021-04-18;0;0;0;0;0;0;0;0;0;0
FR;4;2021-04-19;0;0;0;0;0;0;0;0;0;0
FR;4;2021-04-20;0;0;0;0;0;0;0;0;0;0
FR;4;2021-04-21;0;0;0;0;0;0;0;0;0;0
FR;4;2021-04-22;0;0;0;0;0;0;0;0;0;0
FR;4;2021-04-23;4085;0;0;0;0;4085;0;0;0;0
FR;4;2021-04-24;1569;0;0;0;0;5654;0;0;0;0
FR;4;2021-04-25;124;0;0;0;0;5778;0;0;0;0
FR;4;2021-04-26;2869;1;0;0;0;8647;1;0;0;0
FR;4;2021-04-27;9519;3;0;0;0;18166;4;0;0;0
FR;4;2021-04-28;9904;6;0;0;0;28070;10;0;0;0
FR;4;2021-04-29;15989;8;0;0;0;44059;18;0;0;0
FR;4;2021-04-30;19226;10;0;0;0;63285;28;0;0;0
FR;4;2021-05-01;1990;6;0;0;0;65275;34;0;0;0
FR;4;2021-05-02;481;0;0;0;0;65756;34;0;0;0
FR;4;2021-05-03;5057;2;0;0;0;70813;36;0;0;0
FR;4;2021-05-04;8396;10;0;0;0;79209;46;0;0;0
FR;4;2021-05-05;6179;7;0;0;0;85388;53;0;0;0
FR;4;2021-05-06;11379;11;0;0;0;96767;64;0;0;0
FR;4;2021-05-07;19115;9;0;0;0;115882;73;0;0;0
FR;4;2021-05-08;2375;6;0;0;0;118257;79;0;0;0
FR;4;2021-05-09;685;3;0;0;0;118942;82;0;0;0
FR;4;2021-05-10;7235;5;1;0;0;126177;87;1;0;0
FR;4;2021-05-11;14310;12;0;0;0;140487;99;1;0;0
FR;4;2021-05-12;10157;15;0;0;0;150644;114;1;0;0
FR;4;2021-05-13;1578;3;0;0;0;152222;117;1;0;0
FR;4;2021-05-14;7754;6;0;0;0;159976;123;1;0;0
FR;4;2021-05-15;3712;8;1;0;0;163688;131;2;0;0
FR;4;2021-05-16;418;1;0;0;0;164106;132;2;0;0
FR;4;2021-05-17;4474;6;0;0;0;168580;138;2;0;0
FR;4;2021-05-18;8743;9;0;0;0;177323;147;2;0;0
FR;4;2021-05-19;5686;7;0;0;0;183009;154;2;0;0
FR;4;2021-05-20;9476;7;0;0;0;192485;161;2;0;0
FR;4;2021-05-21;12783;29;0;0;0;205268;190;2;0;0
FR;4;2021-05-22;5052;15;0;0;0;210320;205;2;0;0
FR;4;2021-05-23;494;4;0;0;0;210814;209;2;0;0
FR;4;2021-05-24;1049;7;0;0;0;211863;216;2;0;0
FR;4;2021-05-25;7618;15;0;0;0;219481;231;2;0;0
FR;4;2021-05-26;7718;16;0;0;0;227199;247;2;0;0
FR;4;2021-05-27;14327;35;0;0;0;241526;282;2;0;0
FR;4;2021-05-28;26578;82;1;0;0;268104;364;3;0;0
FR;4;2021-05-29;11381;18;0;0;0;279485;382;3;0;0
FR;4;2021-05-30;970;6;0;0;0;280455;388;3;0;0
FR;4;2021-05-31;12683;21;0;0;0;293138;409;3;0;0
FR;4;2021-06-01;20243;46;1;0;0;313381;455;4;0;0
FR;4;2021-06-02;14514;33;0;0;0;327895;488;4;0;0
FR;4;2021-06-03;19400;24;1;0;0;347295;512;5;0;0
FR;4;2021-06-04;22504;47;0;0;0;369799;559;5;0;0
FR;4;2021-06-05;9712;32;0;0;0;379511;591;5;0;0
FR;4;2021-06-06;1037;0;0;0;0;380548;591;5;0;0
FR;4;2021-06-07;9223;19;0;0;0;389771;610;5;0;0
FR;4;2021-06-08;14607;31;0;0;0;404378;641;5;0;0
FR;4;2021-06-09;12200;25;0;0;0;416578;666;5;0;0
FR;4;2021-06-10;15395;30;0;0;0;431973;696;5;0;0
FR;4;2021-06-11;16972;55;0;0;0;448945;751;5;0;0
FR;4;2021-06-12;7443;27;0;0;0;456388;778;5;0;0
FR;4;2021-06-13;908;2;0;0;0;457296;780;5;0;0
FR;4;2021-06-14;6646;25;0;0;0;463942;805;5;0;0
FR;4;2021-06-15;10878;37;0;0;0;474820;842;5;0;0
FR;4;2021-06-16;8901;14;0;0;0;483721;856;5;0;0
FR;4;2021-06-17;10893;36;0;0;0;494614;892;5;0;0
FR;4;2021-06-18;12416;45;0;0;0;507030;937;5;0;0
FR;4;2021-06-19;5566;25;0;0;0;512596;962;5;0;0
FR;4;2021-06-20;815;5;0;0;0;513411;967;5;0;0
FR;4;2021-06-21;5079;20;0;0;0;518490;987;5;0;0
FR;4;2021-06-22;7904;27;2;0;0;526394;1014;7;0;0
FR;4;2021-06-23;7089;39;2;0;0;533483;1053;9;0;0
FR;4;2021-06-24;8645;45;1;0;0;542128;1098;10;0;0
FR;4;2021-06-25;10166;39;2;0;0;552294;1137;12;0;0
FR;4;2021-06-26;4839;21;0;0;0;557133;1158;12;0;0
FR;4;2021-06-27;758;3;0;0;0;557891;1161;12;0;0
FR;4;2021-06-28;4813;16;1;0;0;562704;1177;13;0;0
FR;4;2021-06-29;7095;27;2;0;0;569799;1204;15;0;0
FR;4;2021-06-30;6708;40;2;0;0;576507;1244;17;0;0
FR;4;2021-07-01;8184;40;0;0;0;584691;1284;17;0;0
FR;4;2021-07-02;9413;52;1;0;0;594104;1336;18;0;0
FR;4;2021-07-03;4840;19;0;0;0;598944;1355;18;0;0
FR;4;2021-07-04;685;5;0;0;0;599629;1360;18;0;0
FR;4;2021-07-05;4766;19;2;0;0;604395;1379;20;0;0
FR;4;2021-07-06;7711;28;4;0;0;612106;1407;24;0;0
FR;4;2021-07-07;7062;34;2;0;0;619168;1441;26;0;0
FR;4;2021-07-08;9215;38;2;0;0;628383;1479;28;0;0
FR;4;2021-07-09;10270;33;1;0;0;638653;1512;29;0;0
FR;4;2021-07-10;4634;14;2;0;0;643287;1526;31;0;0
FR;4;2021-07-11;579;4;1;0;0;643866;1530;32;0;0
FR;4;2021-07-12;5868;29;0;0;0;649734;1559;32;0;0
FR;4;2021-07-13;14226;29;0;0;0;663960;1588;32;0;0
FR;4;2021-07-14;2281;14;0;0;0;666241;1602;32;0;0
FR;4;2021-07-15;18227;36;0;0;0;684468;1638;32;0;0
FR;4;2021-07-16;22813;70;2;0;0;707281;1708;34;0;0
FR;4;2021-07-17;9733;20;0;0;0;717014;1728;34;0;0
FR;4;2021-07-18;1350;4;0;0;0;718364;1732;34;0;0
FR;4;2021-07-19;12971;28;1;0;0;731335;1760;35;0;0
FR;4;2021-07-20;17324;26;1;0;0;748659;1786;36;0;0
FR;4;2021-07-21;15600;33;0;0;0;764259;1819;36;0;0
FR;4;2021-07-22;18230;43;2;0;0;782489;1862;38;0;0
FR;4;2021-07-23;20399;57;7;0;0;802888;1919;45;0;0
FR;4;2021-07-24;9271;32;0;0;0;812159;1951;45;0;0
FR;4;2021-07-25;1342;8;0;0;0;813501;1959;45;0;0
FR;4;2021-07-26;11021;20;0;0;0;824522;1979;45;0;0
FR;4;2021-07-27;14650;35;3;0;0;839172;2014;48;0;0
FR;4;2021-07-28;12912;26;2;0;0;852084;2040;50;0;0
FR;4;2021-07-29;14066;54;4;0;0;866150;2094;54;0;0
FR;4;2021-07-30;15470;45;2;0;0;881620;2139;56;0;0
FR;4;2021-07-31;6817;14;2;0;0;888437;2153;58;0;0
FR;4;2021-08-01;902;1;0;0;0;889339;2154;58;0;0
FR;4;2021-08-02;7893;29;0;0;0;897232;2183;58;0;0
FR;4;2021-08-03;10786;32;2;0;0;908018;2215;60;0;0
FR;4;2021-08-04;9719;29;0;0;0;917737;2244;60;0;0
FR;4;2021-08-05;9801;41;0;0;0;927538;2285;60;0;0
FR;4;2021-08-06;10169;31;3;0;0;937707;2316;63;0;0
FR;4;2021-08-07;5079;30;1;0;0;942786;2346;64;0;0
FR;4;2021-08-08;1212;13;0;0;0;943998;2359;64;0;0
FR;4;2021-08-09;6320;30;0;0;0;950318;2389;64;0;0
FR;4;2021-08-10;8737;19;0;0;0;959055;2408;64;0;0
FR;4;2021-08-11;7923;33;3;0;0;966978;2441;67;0;0
FR;4;2021-08-12;8578;29;1;0;0;975556;2470;68;0;0
FR;4;2021-08-13;7537;24;0;1;0;983093;2494;68;1;0
FR;4;2021-08-14;3782;20;0;0;0;986875;2514;68;1;0
FR;4;2021-08-15;767;5;0;0;0;987642;2519;68;1;0
FR;4;2021-08-16;3999;16;0;0;0;991641;2535;68;1;0
FR;4;2021-08-17;5611;15;1;0;0;997252;2550;69;1;0
FR;4;2021-08-18;5152;34;0;0;0;1002404;2584;69;1;0
FR;4;2021-08-19;5470;34;3;0;0;1007874;2618;72;1;0
FR;4;2021-08-20;5200;23;1;0;0;1013074;2641;73;1;0
FR;4;2021-08-21;2304;21;1;0;0;1015378;2662;74;1;0
FR;4;2021-08-22;400;2;0;0;0;1015778;2664;74;1;0
FR;4;2021-08-23;2914;18;1;0;0;1018692;2682;75;1;0
FR;4;2021-08-24;3737;15;0;0;0;1022429;2697;75;1;0
FR;4;2021-08-25;3531;25;0;0;0;1025960;2722;75;1;0
FR;4;2021-08-26;3699;20;1;0;0;1029659;2742;76;1;0
FR;4;2021-08-27;3597;31;2;0;0;1033256;2773;78;1;0
FR;4;2021-08-28;1721;10;1;0;0;1034977;2783;79;1;0
FR;4;2021-08-29;387;7;1;0;0;1035364;2790;80;1;0
FR;4;2021-08-30;2000;24;0;0;14;1037364;2814;80;1;14
FR;4;2021-08-31;2473;20;0;0;13;1039837;2834;80;1;27
FR;4;2021-09-01;2071;38;1;0;21;1041908;2872;81;1;48
FR;4;2021-09-02;2299;31;4;0;18;1044207;2903;85;1;66
FR;4;2021-09-03;2352;44;5;0;32;1046559;2947;90;1;98
FR;4;2021-09-04;1371;17;0;0;5;1047930;2964;90;1;103
FR;4;2021-09-05;428;2;0;0;2;1048358;2966;90;1;105
FR;4;2021-09-06;1701;62;0;0;23;1050059;3028;90;1;128
FR;4;2021-09-07;1671;18;0;0;8;1051730;3046;90;1;136
FR;4;2021-09-08;1278;26;3;1;19;1053008;3072;93;2;155
FR;4;2021-09-09;1384;23;2;0;9;1054392;3095;95;2;164
FR;4;2021-09-10;1513;31;2;0;23;1055905;3126;97;2;187
FR;4;2021-09-11;734;11;0;0;3;1056639;3137;97;2;190
FR;4;2021-09-12;168;4;0;0;2;1056807;3141;97;2;192
FR;4;2021-09-13;1308;21;1;0;15;1058115;3162;98;2;207
FR;4;2021-09-14;1490;9;2;0;6;1059605;3171;100;2;213
FR;4;2021-09-15;1087;26;1;0;24;1060692;3197;101;2;237
FR;4;2021-09-16;1094;22;2;0;15;1061786;3219;103;2;252
FR;4;2021-09-17;889;21;1;0;12;1062675;3240;104;2;264
FR;4;2021-09-18;460;5;1;0;4;1063135;3245;105;2;268
FR;4;2021-09-19;182;2;0;0;1;1063317;3247;105;2;269
FR;4;2021-09-20;442;18;0;0;12;1063759;3265;105;2;281
FR;4;2021-09-21;420;11;0;0;7;1064179;3276;105;2;288
FR;4;2021-09-22;372;19;2;0;13;1064551;3295;107;2;301
FR;4;2021-09-23;475;13;1;0;12;1065026;3308;108;2;313
FR;4;2021-09-24;407;13;2;0;9;1065433;3321;110;2;322
FR;4;2021-09-25;281;9;1;0;4;1065714;3330;111;2;326
FR;4;2021-09-26;71;2;0;0;1;1065785;3332;111;2;327
FR;4;2021-09-27;259;10;1;0;8;1066044;3342;112;2;335
FR;4;2021-09-28;313;8;0;0;8;1066357;3350;112;2;343
FR;4;2021-09-29;370;19;1;0;13;1066727;3369;113;2;356
FR;4;2021-09-30;357;39;0;0;20;1067084;3408;113;2;376
FR;4;2021-10-01;400;49;0;0;43;1067484;3457;113;2;419
FR;4;2021-10-02;193;22;1;0;13;1067677;3479;114;2;432
FR;4;2021-10-03;83;1;0;0;0;1067760;3480;114;2;432
FR;4;2021-10-04;353;19;1;0;15;1068113;3499;115;2;447
FR;4;2021-10-05;272;19;2;0;15;1068385;3518;117;2;462
FR;4;2021-10-06;242;22;1;0;18;1068627;3540;118;2;480
FR;4;2021-10-07;251;26;2;0;14;1068878;3566;120;2;494
FR;4;2021-10-08;351;22;2;0;18;1069229;3588;122;2;512
FR;4;2021-10-09;191;6;6;0;7;1069420;3594;128;2;519
FR;4;2021-10-10;93;3;2;0;3;1069513;3597;130;2;522
FR;4;2021-10-11;243;14;1;0;13;1069756;3611;131;2;535
FR;4;2021-10-12;202;14;0;0;13;1069958;3625;131;2;548
FR;4;2021-10-13;218;27;1;0;24;1070176;3652;132;2;572
FR;4;2021-10-14;304;20;4;0;14;1070480;3672;136;2;586
FR;4;2021-10-15;318;24;5;0;25;1070798;3696;141;2;611
FR;4;2021-10-16;163;6;2;0;6;1070961;3702;143;2;617
FR;4;2021-10-17;70;2;0;0;1;1071031;3704;143;2;618
FR;4;2021-10-18;275;16;1;0;12;1071306;3720;144;2;630
FR;4;2021-10-19;205;14;2;0;15;1071511;3734;146;2;645
FR;4;2021-10-20;224;27;3;0;14;1071735;3761;149;2;659
FR;4;2021-10-21;231;17;0;0;13;1071966;3778;149;2;672
FR;4;2021-10-22;206;26;2;0;21;1072172;3804;151;2;693
FR;4;2021-10-23;115;16;1;0;15;1072287;3820;152;2;708
FR;4;2021-10-24;37;4;0;0;1;1072324;3824;152;2;709
FR;4;2021-10-25;205;7;2;0;9;1072529;3831;154;2;718
FR;4;2021-10-26;194;13;0;0;11;1072723;3844;154;2;729
FR;4;2021-10-27;189;11;4;0;11;1072912;3855;158;2;740
FR;4;2021-10-28;180;18;4;0;21;1073092;3873;162;2;761
FR;4;2021-10-29;218;16;2;0;14;1073310;3889;164;2;775
FR;4;2021-10-30;100;2;1;0;2;1073410;3891;165;2;777
FR;4;2021-10-31;55;3;2;0;3;1073465;3894;167;2;780
FR;4;2021-11-01;74;27;4;0;24;1073539;3921;171;2;804
FR;4;2021-11-02;151;20;2;0;21;1073690;3941;173;2;825
FR;4;2021-11-03;127;20;8;1;18;1073817;3961;181;3;843
FR;4;2021-11-04;173;13;1;0;10;1073990;3974;182;3;853
FR;4;2021-11-05;123;17;1;0;16;1074113;3991;183;3;869
FR;4;2021-11-06;77;6;1;0;6;1074190;3997;184;3;875
FR;4;2021-11-07;73;2;2;0;4;1074263;3999;186;3;879
FR;4;2021-11-08;158;16;1;0;16;1074421;4015;187;3;895
FR;4;2021-11-09;150;14;3;0;16;1074571;4029;190;3;911
FR;4;2021-11-10;110;27;6;0;29;1074681;4056;196;3;940
FR;4;2021-11-11;80;9;0;0;9;1074761;4065;196;3;949
FR;4;2021-11-12;95;18;2;0;18;1074856;4083;198;3;967
FR;4;2021-11-13;72;15;2;0;14;1074928;4098;200;3;981
FR;4;2021-11-14;52;5;3;0;7;1074980;4103;203;3;988
FR;4;2021-11-15;94;26;2;0;24;1075074;4129;205;3;1012
FR;4;2021-11-16;98;12;2;0;14;1075172;4141;207;3;1026
FR;4;2021-11-17;111;29;4;0;29;1075283;4170;211;3;1055
FR;4;2021-11-18;95;34;11;0;39;1075378;4204;222;3;1094
FR;4;2021-11-19;78;19;3;0;20;1075456;4223;225;3;1114
FR;4;2021-11-20;60;6;1;0;6;1075516;4229;226;3;1120
FR;4;2021-11-21;61;7;2;0;9;1075577;4236;228;3;1129
FR;4;2021-11-22;100;27;6;0;29;1075677;4263;234;3;1158
FR;4;2021-11-23;71;28;5;0;25;1075748;4291;239;3;1183
FR;4;2021-11-24;84;23;9;0;22;1075832;4314;248;3;1205
FR;4;2021-11-25;83;29;14;0;31;1075915;4343;262;3;1236
FR;4;2021-11-26;78;42;12;0;44;1075993;4385;274;3;1280
FR;4;2021-11-27;31;22;17;0;25;1076024;4407;291;3;1305
FR;4;2021-11-28;46;8;0;0;7;1076070;4415;291;3;1312
FR;4;2021-11-29;80;31;14;0;38;1076150;4446;305;3;1350
FR;4;2021-11-30;58;36;12;0;40;1076208;4482;317;3;1390
FR;4;2021-12-01;69;60;18;0;66;1076277;4542;335;3;1456
FR;4;2021-12-02;95;48;19;0;53;1076372;4590;354;3;1509
FR;4;2021-12-03;98;36;15;0;44;1076470;4626;369;3;1553
FR;4;2021-12-04;67;31;19;0;44;1076537;4657;388;3;1597
FR;4;2021-12-05;56;5;1;0;6;1076593;4662;389;3;1603
FR;4;2021-12-06;93;45;21;0;60;1076686;4707;410;3;1663
FR;4;2021-12-07;76;33;10;0;33;1076762;4740;420;3;1696
FR;4;2021-12-08;64;28;18;0;33;1076826;4768;438;3;1729
FR;4;2021-12-09;58;32;10;0;38;1076884;4800;448;3;1767
FR;4;2021-12-10;59;62;21;0;67;1076943;4862;469;3;1834
FR;4;2021-12-11;24;33;7;0;33;1076967;4895;476;3;1867
FR;4;2021-12-12;21;10;3;0;13;1076988;4905;479;3;1880
FR;4;2021-12-13;64;39;13;0;48;1077052;4944;492;3;1928
FR;4;2021-12-14;53;43;14;0;51;1077105;4987;506;3;1979
FR;4;2021-12-15;56;61;29;0;81;1077161;5048;535;3;2060
FR;4;2021-12-16;29;43;18;0;55;1077190;5091;553;3;2115
FR;4;2021-12-17;36;54;12;0;59;1077226;5145;565;3;2174
FR;4;2021-12-18;47;29;2;0;30;1077273;5174;567;3;2204
FR;4;2021-12-19;15;4;1;0;4;1077288;5178;568;3;2208
FR;4;2021-12-20;35;38;12;0;43;1077323;5216;580;3;2251
FR;4;2021-12-21;24;30;14;0;35;1077347;5246;594;3;2286
FR;4;2021-12-22;35;35;10;0;36;1077382;5281;604;3;2322
FR;4;2021-12-23;38;43;8;0;47;1077420;5324;612;3;2369
FR;4;2021-12-24;22;25;10;0;29;1077442;5349;622;3;2398
FR;4;2021-12-25;6;3;3;0;4;1077448;5352;625;3;2402
FR;4;2021-12-26;4;3;1;0;2;1077452;5355;626;3;2404
FR;4;2021-12-27;26;42;9;0;43;1077478;5397;635;3;2447
FR;4;2021-12-28;24;28;8;0;29;1077502;5425;643;3;2476
FR;4;2021-12-29;44;23;10;0;27;1077546;5448;653;3;2503
FR;4;2021-12-30;36;16;12;0;19;1077582;5464;665;3;2522
FR;4;2021-12-31;18;4;8;0;10;1077600;5468;673;3;2532
FR;4;2022-01-01;4;4;4;0;6;1077604;5472;677;3;2538
FR;4;2022-01-02;38;4;14;0;17;1077642;5476;691;3;2555
FR;4;2022-01-03;36;49;19;1;54;1077678;5525;710;4;2609
FR;4;2022-01-04;25;24;11;1;25;1077703;5549;721;5;2634
FR;4;2022-01-05;42;19;16;0;19;1077745;5568;737;5;2653
FR;4;2022-01-06;41;19;20;0;31;1077786;5587;757;5;2684
FR;4;2022-01-07;18;19;15;0;19;1077804;5606;772;5;2703
FR;4;2022-01-08;7;5;9;0;11;1077811;5611;781;5;2714
FR;4;2022-01-09;15;1;1;0;2;1077826;5612;782;5;2716
FR;4;2022-01-10;34;21;16;0;32;1077860;5633;798;5;2748
FR;4;2022-01-11;21;29;12;0;31;1077881;5662;810;5;2779
FR;4;2022-01-12;29;16;12;0;17;1077910;5678;822;5;2796
FR;4;2022-01-13;46;17;26;0;33;1077956;5695;848;5;2829
FR;4;2022-01-14;19;26;12;0;28;1077975;5721;860;5;2857
FR;4;2022-01-15;10;6;7;0;11;1077985;5727;867;5;2868
FR;4;2022-01-16;9;8;10;0;17;1077994;5735;877;5;2885
FR;4;2022-01-17;22;17;11;0;22;1078016;5752;888;5;2907
FR;4;2022-01-18;15;13;7;0;17;1078031;5765;895;5;2924
FR;4;2022-01-19;26;20;9;0;27;1078057;5785;904;5;2951
FR;4;2022-01-20;29;33;13;0;36;1078086;5818;917;5;2987
FR;4;2022-01-21;7;12;18;1;15;1078093;5830;935;6;3002
FR;4;2022-01-22;28;9;2;0;9;1078121;5839;937;6;3011
FR;4;2022-01-23;5;2;4;0;6;1078126;5841;941;6;3017
FR;4;2022-01-24;13;20;8;0;27;1078139;5861;949;6;3044
FR;4;2022-01-25;20;30;8;1;34;1078159;5891;957;7;3078
FR;4;2022-01-26;17;15;6;1;16;1078176;5906;963;8;3094
FR;4;2022-01-27;15;18;5;0;21;1078191;5924;968;8;3115
FR;4;2022-01-28;12;22;7;0;24;1078203;5946;975;8;3139
FR;4;2022-01-29;14;5;3;0;7;1078217;5951;978;8;3146
FR;4;2022-01-30;16;2;0;0;2;1078233;5953;978;8;3148
FR;4;2022-01-31;18;25;6;0;28;1078251;5978;984;8;3176
FR;4;2022-02-01;9;18;11;0;18;1078260;5996;995;8;3194
FR;4;2022-02-02;16;11;9;2;15;1078276;6007;1004;10;3209
FR;4;2022-02-03;10;19;9;0;22;1078286;6026;1013;10;3231
FR;4;2022-02-04;5;5;7;0;9;1078291;6031;1020;10;3240
FR;4;2022-02-05;6;14;1;0;13;1078297;6045;1021;10;3253
FR;4;2022-02-06;5;2;1;0;2;1078302;6047;1022;10;3255
FR;4;2022-02-07;11;17;6;0;17;1078313;6064;1028;10;3272
FR;4;2022-02-08;13;18;12;1;19;1078326;6082;1040;11;3291
FR;4;2022-02-09;13;11;7;0;14;1078339;6093;1047;11;3305
FR;4;2022-02-10;18;22;8;0;22;1078357;6115;1055;11;3327
FR;4;2022-02-11;17;14;7;0;18;1078374;6129;1062;11;3345
FR;4;2022-02-12;23;5;0;0;3;1078397;6134;1062;11;3348
FR;4;2022-02-13;7;3;3;0;6;1078404;6137;1065;11;3354
FR;4;2022-02-14;16;10;7;0;13;1078420;6147;1072;11;3367
FR;4;2022-02-15;14;7;0;0;6;1078434;6154;1072;11;3373
FR;4;2022-02-16;10;8;9;0;13;1078444;6162;1081;11;3386
FR;4;2022-02-17;8;3;4;0;5;1078452;6165;1085;11;3391
FR;4;2022-02-18;16;13;6;0;17;1078468;6178;1091;11;3408
FR;4;2022-02-19;16;2;1;0;3;1078484;6180;1092;11;3411
FR;4;2022-02-20;6;2;0;0;1;1078490;6182;1092;11;3412
FR;4;2022-02-21;22;3;2;0;3;1078512;6185;1094;11;3415
FR;4;2022-02-22;8;4;8;0;8;1078520;6189;1102;11;3423
FR;4;2022-02-23;15;6;6;0;6;1078535;6195;1108;11;3429
FR;4;2022-02-24;7;3;2;0;3;1078542;6198;1110;11;3432
FR;4;2022-02-25;15;4;7;0;5;1078557;6202;1117;11;3437
FR;4;2022-02-26;24;3;0;0;3;1078581;6205;1117;11;3440
FR;4;2022-02-27;8;0;0;0;0;1078589;6205;1117;11;3440
FR;4;2022-02-28;13;3;2;0;3;1078602;6208;1119;11;3443
FR;4;2022-03-01;5;2;7;0;3;1078607;6210;1126;11;3446
FR;4;2022-03-02;8;2;3;0;4;1078615;6212;1129;11;3450
FR;4;2022-03-03;10;2;1;0;1;1078625;6214;1130;11;3451
FR;4;2022-03-04;6;6;2;1;5;1078631;6220;1132;12;3456
FR;4;2022-03-05;8;2;0;0;2;1078639;6222;1132;12;3458
FR;4;2022-03-06;2;0;1;0;1;1078641;6222;1133;12;3459
FR;4;2022-03-07;8;4;1;0;3;1078649;6226;1134;12;3462
FR;4;2022-03-08;13;1;0;0;1;1078662;6227;1134;12;3463
FR;4;2022-03-09;7;3;2;0;4;1078669;6230;1136;12;3467
FR;4;2022-03-10;4;0;4;0;1;1078673;6230;1140;12;3468
FR;4;2022-03-11;6;2;5;0;1;1078679;6232;1145;12;3469
FR;4;2022-03-12;9;2;0;0;0;1078688;6234;1145;12;3469
FR;4;2022-03-13;4;0;0;0;0;1078692;6234;1145;12;3469
FR;4;2022-03-14;3;0;0;0;0;1078695;6234;1145;12;3469
FR;4;2022-03-15;3;2;1;0;0;1078698;6236;1146;12;3469
FR;4;2022-03-16;4;1;3;0;2;1078702;6237;1149;12;3471
FR;4;2022-03-17;0;1;1;0;2;1078702;6238;1150;12;3473
FR;4;2022-03-18;6;0;0;0;0;1078708;6238;1150;12;3473
FR;4;2022-03-19;1;0;0;0;0;1078709;6238;1150;12;3473
FR;4;2022-03-20;2;0;0;0;0;1078711;6238;1150;12;3473
FR;4;2022-03-21;5;1;0;0;1;1078716;6239;1150;12;3474
FR;4;2022-03-22;0;2;0;0;2;1078716;6241;1150;12;3476
FR;4;2022-03-23;6;3;3;0;5;1078722;6244;1153;12;3481
FR;4;2022-03-24;2;3;0;1;2;1078724;6247;1153;13;3483
FR;4;2022-03-25;2;2;1;0;2;1078726;6249;1154;13;3485
FR;4;2022-03-26;5;5;0;0;5;1078731;6254;1154;13;3490
FR;4;2022-03-27;0;0;0;0;0;1078731;6254;1154;13;3490
FR;4;2022-03-28;3;1;0;0;0;1078734;6255;1154;13;3490
FR;4;2022-03-29;4;0;3;1;0;1078738;6255;1157;14;3490
FR;4;2022-03-30;0;3;0;0;3;1078738;6258;1157;14;3493
FR;4;2022-03-31;1;1;1;1;1;1078739;6259;1158;15;3494
FR;4;2022-04-01;11;0;1;0;1;1078750;6259;1159;15;3495
FR;4;2022-04-02;3;0;0;0;0;1078753;6259;1159;15;3495
FR;4;2022-04-03;0;0;0;0;0;1078753;6259;1159;15;3495
FR;4;2022-04-04;3;0;0;0;0;1078756;6259;1159;15;3495
FR;4;2022-04-05;3;1;0;0;0;1078759;6260;1159;15;3495
FR;5;2020-12-27;0;0;0;0;0;0;0;0;0;0
FR;5;2020-12-28;0;0;0;0;0;0;0;0;0;0
FR;5;2020-12-29;0;0;0;0;0;0;0;0;0;0
FR;5;2020-12-30;0;0;0;0;0;0;0;0;0;0
FR;5;2020-12-31;0;0;0;0;0;0;0;0;0;0
FR;5;2021-01-01;0;0;0;0;0;0;0;0;0;0
FR;5;2021-01-02;0;0;0;0;0;0;0;0;0;0
FR;5;2021-01-03;0;0;0;0;0;0;0;0;0;0
FR;5;2021-01-04;0;0;0;0;0;0;0;0;0;0
FR;5;2021-01-05;0;0;0;0;0;0;0;0;0;0
FR;5;2021-01-06;0;0;0;0;0;0;0;0;0;0
FR;5;2021-01-07;0;0;0;0;0;0;0;0;0;0
FR;5;2021-01-08;0;0;0;0;0;0;0;0;0;0
FR;5;2021-01-09;0;0;0;0;0;0;0;0;0;0
FR;5;2021-01-10;0;0;0;0;0;0;0;0;0;0
FR;5;2021-01-11;0;0;0;0;0;0;0;0;0;0
FR;5;2021-01-12;0;0;0;0;0;0;0;0;0;0
FR;5;2021-01-13;0;0;0;0;0;0;0;0;0;0
FR;5;2021-01-14;0;0;0;0;0;0;0;0;0;0
FR;5;2021-01-15;0;0;0;0;0;0;0;0;0;0
FR;5;2021-01-16;0;0;0;0;0;0;0;0;0;0
FR;5;2021-01-17;0;0;0;0;0;0;0;0;0;0
FR;5;2021-01-18;0;0;0;0;0;0;0;0;0;0
FR;5;2021-01-19;0;0;0;0;0;0;0;0;0;0
FR;5;2021-01-20;0;0;0;0;0;0;0;0;0;0
FR;5;2021-01-21;0;0;0;0;0;0;0;0;0;0
FR;5;2021-01-22;0;0;0;0;0;0;0;0;0;0
FR;5;2021-01-23;0;0;0;0;0;0;0;0;0;0
FR;5;2021-01-24;0;0;0;0;0;0;0;0;0;0
FR;5;2021-01-25;0;0;0;0;0;0;0;0;0;0
FR;5;2021-01-26;0;0;0;0;0;0;0;0;0;0
FR;5;2021-01-27;0;0;0;0;0;0;0;0;0;0
FR;5;2021-01-28;0;0;0;0;0;0;0;0;0;0
FR;5;2021-01-29;0;0;0;0;0;0;0;0;0;0
FR;5;2021-01-30;0;0;0;0;0;0;0;0;0;0
FR;5;2021-01-31;0;0;0;0;0;0;0;0;0;0
FR;5;2021-02-01;0;0;0;0;0;0;0;0;0;0
FR;5;2021-02-02;0;0;0;0;0;0;0;0;0;0
FR;5;2021-02-03;0;0;0;0;0;0;0;0;0;0
FR;5;2021-02-04;0;0;0;0;0;0;0;0;0;0
FR;5;2021-02-05;0;0;0;0;0;0;0;0;0;0
FR;5;2021-02-06;0;0;0;0;0;0;0;0;0;0
FR;5;2021-02-07;0;0;0;0;0;0;0;0;0;0
FR;5;2021-02-08;0;0;0;0;0;0;0;0;0;0
FR;5;2021-02-09;0;0;0;0;0;0;0;0;0;0
FR;5;2021-02-10;0;0;0;0;0;0;0;0;0;0
FR;5;2021-02-11;0;0;0;0;0;0;0;0;0;0
FR;5;2021-02-12;0;0;0;0;0;0;0;0;0;0
FR;5;2021-02-13;0;0;0;0;0;0;0;0;0;0
FR;5;2021-02-14;0;0;0;0;0;0;0;0;0;0
FR;5;2021-02-15;0;0;0;0;0;0;0;0;0;0
FR;5;2021-02-16;0;0;0;0;0;0;0;0;0;0
FR;5;2021-02-17;0;0;0;0;0;0;0;0;0;0
FR;5;2021-02-18;0;0;0;0;0;0;0;0;0;0
FR;5;2021-02-19;0;0;0;0;0;0;0;0;0;0
FR;5;2021-02-20;0;0;0;0;0;0;0;0;0;0
FR;5;2021-02-21;0;0;0;0;0;0;0;0;0;0
FR;5;2021-02-22;0;0;0;0;0;0;0;0;0;0
FR;5;2021-02-23;0;0;0;0;0;0;0;0;0;0
FR;5;2021-02-24;0;0;0;0;0;0;0;0;0;0
FR;5;2021-02-25;0;0;0;0;0;0;0;0;0;0
FR;5;2021-02-26;0;0;0;0;0;0;0;0;0;0
FR;5;2021-02-27;0;0;0;0;0;0;0;0;0;0
FR;5;2021-02-28;0;0;0;0;0;0;0;0;0;0
FR;5;2021-03-01;0;0;0;0;0;0;0;0;0;0
FR;5;2021-03-02;0;0;0;0;0;0;0;0;0;0
FR;5;2021-03-03;0;0;0;0;0;0;0;0;0;0
FR;5;2021-03-04;0;0;0;0;0;0;0;0;0;0
FR;5;2021-03-05;0;0;0;0;0;0;0;0;0;0
FR;5;2021-03-06;0;0;0;0;0;0;0;0;0;0
FR;5;2021-03-07;0;0;0;0;0;0;0;0;0;0
FR;5;2021-03-08;0;0;0;0;0;0;0;0;0;0
FR;5;2021-03-09;0;0;0;0;0;0;0;0;0;0
FR;5;2021-03-10;0;0;0;0;0;0;0;0;0;0
FR;5;2021-03-11;0;0;0;0;0;0;0;0;0;0
FR;5;2021-03-12;0;0;0;0;0;0;0;0;0;0
FR;5;2021-03-13;0;0;0;0;0;0;0;0;0;0
FR;5;2021-03-14;0;0;0;0;0;0;0;0;0;0
FR;5;2021-03-15;0;0;0;0;0;0;0;0;0;0
FR;5;2021-03-16;0;0;0;0;0;0;0;0;0;0
FR;5;2021-03-17;0;0;0;0;0;0;0;0;0;0
FR;5;2021-03-18;0;0;0;0;0;0;0;0;0;0
FR;5;2021-03-19;0;0;0;0;0;0;0;0;0;0
FR;5;2021-03-20;0;0;0;0;0;0;0;0;0;0
FR;5;2021-03-21;0;0;0;0;0;0;0;0;0;0
FR;5;2021-03-22;0;0;0;0;0;0;0;0;0;0
FR;5;2021-03-23;0;0;0;0;0;0;0;0;0;0
FR;5;2021-03-24;0;0;0;0;0;0;0;0;0;0
FR;5;2021-03-25;0;0;0;0;0;0;0;0;0;0
FR;5;2021-03-26;0;0;0;0;0;0;0;0;0;0
FR;5;2021-03-27;0;0;0;0;0;0;0;0;0;0
FR;5;2021-03-28;0;0;0;0;0;0;0;0;0;0
FR;5;2021-03-29;0;0;0;0;0;0;0;0;0;0
FR;5;2021-03-30;0;0;0;0;0;0;0;0;0;0
FR;5;2021-03-31;0;0;0;0;0;0;0;0;0;0
FR;5;2021-04-01;0;0;0;0;0;0;0;0;0;0
FR;5;2021-04-02;0;0;0;0;0;0;0;0;0;0
FR;5;2021-04-03;0;0;0;0;0;0;0;0;0;0
FR;5;2021-04-04;0;0;0;0;0;0;0;0;0;0
FR;5;2021-04-05;0;0;0;0;0;0;0;0;0;0
FR;5;2021-04-06;0;0;0;0;0;0;0;0;0;0
FR;5;2021-04-07;0;0;0;0;0;0;0;0;0;0
FR;5;2021-04-08;0;0;0;0;0;0;0;0;0;0
FR;5;2021-04-09;0;0;0;0;0;0;0;0;0;0
FR;5;2021-04-10;0;0;0;0;0;0;0;0;0;0
FR;5;2021-04-11;0;0;0;0;0;0;0;0;0;0
FR;5;2021-04-12;0;0;0;0;0;0;0;0;0;0
FR;5;2021-04-13;0;0;0;0;0;0;0;0;0;0
FR;5;2021-04-14;0;0;0;0;0;0;0;0;0;0
FR;5;2021-04-15;0;0;0;0;0;0;0;0;0;0
FR;5;2021-04-16;0;0;0;0;0;0;0;0;0;0
FR;5;2021-04-17;0;0;0;0;0;0;0;0;0;0
FR;5;2021-04-18;0;0;0;0;0;0;0;0;0;0
FR;5;2021-04-19;0;0;0;0;0;0;0;0;0;0
FR;5;2021-04-20;0;0;0;0;0;0;0;0;0;0
FR;5;2021-04-21;0;0;0;0;0;0;0;0;0;0
FR;5;2021-04-22;0;0;0;0;0;0;0;0;0;0
FR;5;2021-04-23;0;0;0;0;0;0;0;0;0;0
FR;5;2021-04-24;0;0;0;0;0;0;0;0;0;0
FR;5;2021-04-25;0;0;0;0;0;0;0;0;0;0
FR;5;2021-04-26;0;0;0;0;0;0;0;0;0;0
FR;5;2021-04-27;0;0;0;0;0;0;0;0;0;0
FR;5;2021-04-28;0;0;0;0;0;0;0;0;0;0
FR;5;2021-04-29;0;0;0;0;0;0;0;0;0;0
FR;5;2021-04-30;0;0;0;0;0;0;0;0;0;0
FR;5;2021-05-01;0;0;0;0;0;0;0;0;0;0
FR;5;2021-05-02;0;0;0;0;0;0;0;0;0;0
FR;5;2021-05-03;0;0;0;0;0;0;0;0;0;0
FR;5;2021-05-04;0;0;0;0;0;0;0;0;0;0
FR;5;2021-05-05;0;0;0;0;0;0;0;0;0;0
FR;5;2021-05-06;0;0;0;0;0;0;0;0;0;0
FR;5;2021-05-07;0;0;0;0;0;0;0;0;0;0
FR;5;2021-05-08;0;0;0;0;0;0;0;0;0;0
FR;5;2021-05-09;0;0;0;0;0;0;0;0;0;0
FR;5;2021-05-10;0;0;0;0;0;0;0;0;0;0
FR;5;2021-05-11;0;0;0;0;0;0;0;0;0;0
FR;5;2021-05-12;0;0;0;0;0;0;0;0;0;0
FR;5;2021-05-13;0;0;0;0;0;0;0;0;0;0
FR;5;2021-05-14;0;0;0;0;0;0;0;0;0;0
FR;5;2021-05-15;0;0;0;0;0;0;0;0;0;0
FR;5;2021-05-16;0;0;0;0;0;0;0;0;0;0
FR;5;2021-05-17;0;0;0;0;0;0;0;0;0;0
FR;5;2021-05-18;0;0;0;0;0;0;0;0;0;0
FR;5;2021-05-19;0;0;0;0;0;0;0;0;0;0
FR;5;2021-05-20;0;0;0;0;0;0;0;0;0;0
FR;5;2021-05-21;0;0;0;0;0;0;0;0;0;0
FR;5;2021-05-22;0;0;0;0;0;0;0;0;0;0
FR;5;2021-05-23;0;0;0;0;0;0;0;0;0;0
FR;5;2021-05-24;0;0;0;0;0;0;0;0;0;0
FR;5;2021-05-25;0;0;0;0;0;0;0;0;0;0
FR;5;2021-05-26;0;0;0;0;0;0;0;0;0;0
FR;5;2021-05-27;0;0;0;0;0;0;0;0;0;0
FR;5;2021-05-28;0;0;0;0;0;0;0;0;0;0
FR;5;2021-05-29;0;0;0;0;0;0;0;0;0;0
FR;5;2021-05-30;0;0;0;0;0;0;0;0;0;0
FR;5;2021-05-31;0;0;0;0;0;0;0;0;0;0
FR;5;2021-06-01;0;0;0;0;0;0;0;0;0;0
FR;5;2021-06-02;0;0;0;0;0;0;0;0;0;0
FR;5;2021-06-03;0;0;0;0;0;0;0;0;0;0
FR;5;2021-06-04;0;0;0;0;0;0;0;0;0;0
FR;5;2021-06-05;0;0;0;0;0;0;0;0;0;0
FR;5;2021-06-06;0;0;0;0;0;0;0;0;0;0
FR;5;2021-06-07;0;0;0;0;0;0;0;0;0;0
FR;5;2021-06-08;0;0;0;0;0;0;0;0;0;0
FR;5;2021-06-09;0;0;0;0;0;0;0;0;0;0
FR;5;2021-06-10;0;0;0;0;0;0;0;0;0;0
FR;5;2021-06-11;0;0;0;0;0;0;0;0;0;0
FR;5;2021-06-12;0;0;0;0;0;0;0;0;0;0
FR;5;2021-06-13;0;0;0;0;0;0;0;0;0;0
FR;5;2021-06-14;0;0;0;0;0;0;0;0;0;0
FR;5;2021-06-15;0;0;0;0;0;0;0;0;0;0
FR;5;2021-06-16;0;0;0;0;0;0;0;0;0;0
FR;5;2021-06-17;0;0;0;0;0;0;0;0;0;0
FR;5;2021-06-18;0;0;0;0;0;0;0;0;0;0
FR;5;2021-06-19;0;0;0;0;0;0;0;0;0;0
FR;5;2021-06-20;0;0;0;0;0;0;0;0;0;0
FR;5;2021-06-21;0;0;0;0;0;0;0;0;0;0
FR;5;2021-06-22;0;0;0;0;0;0;0;0;0;0
FR;5;2021-06-23;0;0;0;0;0;0;0;0;0;0
FR;5;2021-06-24;0;0;0;0;0;0;0;0;0;0
FR;5;2021-06-25;0;0;0;0;0;0;0;0;0;0
FR;5;2021-06-26;0;0;0;0;0;0;0;0;0;0
FR;5;2021-06-27;0;0;0;0;0;0;0;0;0;0
FR;5;2021-06-28;0;0;0;0;0;0;0;0;0;0
FR;5;2021-06-29;0;0;0;0;0;0;0;0;0;0
FR;5;2021-06-30;0;0;0;0;0;0;0;0;0;0
FR;5;2021-07-01;0;0;0;0;0;0;0;0;0;0
FR;5;2021-07-02;0;0;0;0;0;0;0;0;0;0
FR;5;2021-07-03;0;0;0;0;0;0;0;0;0;0
FR;5;2021-07-04;0;0;0;0;0;0;0;0;0;0
FR;5;2021-07-05;0;0;0;0;0;0;0;0;0;0
FR;5;2021-07-06;0;0;0;0;0;0;0;0;0;0
FR;5;2021-07-07;0;0;0;0;0;0;0;0;0;0
FR;5;2021-07-08;0;0;0;0;0;0;0;0;0;0
FR;5;2021-07-09;0;0;0;0;0;0;0;0;0;0
FR;5;2021-07-10;0;0;0;0;0;0;0;0;0;0
FR;5;2021-07-11;0;0;0;0;0;0;0;0;0;0
FR;5;2021-07-12;0;0;0;0;0;0;0;0;0;0
FR;5;2021-07-13;0;0;0;0;0;0;0;0;0;0
FR;5;2021-07-14;0;0;0;0;0;0;0;0;0;0
FR;5;2021-07-15;0;0;0;0;0;0;0;0;0;0
FR;5;2021-07-16;0;0;0;0;0;0;0;0;0;0
FR;5;2021-07-17;0;0;0;0;0;0;0;0;0;0
FR;5;2021-07-18;0;0;0;0;0;0;0;0;0;0
FR;5;2021-07-19;0;0;0;0;0;0;0;0;0;0
FR;5;2021-07-20;0;0;0;0;0;0;0;0;0;0
FR;5;2021-07-21;0;0;0;0;0;0;0;0;0;0
FR;5;2021-07-22;0;0;0;0;0;0;0;0;0;0
FR;5;2021-07-23;0;0;0;0;0;0;0;0;0;0
FR;5;2021-07-24;0;0;0;0;0;0;0;0;0;0
FR;5;2021-07-25;0;0;0;0;0;0;0;0;0;0
FR;5;2021-07-26;0;0;0;0;0;0;0;0;0;0
FR;5;2021-07-27;0;0;0;0;0;0;0;0;0;0
FR;5;2021-07-28;0;0;0;0;0;0;0;0;0;0
FR;5;2021-07-29;0;0;0;0;0;0;0;0;0;0
FR;5;2021-07-30;0;0;0;0;0;0;0;0;0;0
FR;5;2021-07-31;0;0;0;0;0;0;0;0;0;0
FR;5;2021-08-01;0;0;0;0;0;0;0;0;0;0
FR;5;2021-08-02;0;0;0;0;0;0;0;0;0;0
FR;5;2021-08-03;0;0;0;0;0;0;0;0;0;0
FR;5;2021-08-04;0;0;0;0;0;0;0;0;0;0
FR;5;2021-08-05;0;0;0;0;0;0;0;0;0;0
FR;5;2021-08-06;0;0;0;0;0;0;0;0;0;0
FR;5;2021-08-07;0;0;0;0;0;0;0;0;0;0
FR;5;2021-08-08;0;0;0;0;0;0;0;0;0;0
FR;5;2021-08-09;0;0;0;0;0;0;0;0;0;0
FR;5;2021-08-10;0;0;0;0;0;0;0;0;0;0
FR;5;2021-08-11;0;0;0;0;0;0;0;0;0;0
FR;5;2021-08-12;0;0;0;0;0;0;0;0;0;0
FR;5;2021-08-13;0;0;0;0;0;0;0;0;0;0
FR;5;2021-08-14;0;0;0;0;0;0;0;0;0;0
FR;5;2021-08-15;0;0;0;0;0;0;0;0;0;0
FR;5;2021-08-16;0;0;0;0;0;0;0;0;0;0
FR;5;2021-08-17;0;0;0;0;0;0;0;0;0;0
FR;5;2021-08-18;0;0;0;0;0;0;0;0;0;0
FR;5;2021-08-19;0;0;0;0;0;0;0;0;0;0
FR;5;2021-08-20;0;0;0;0;0;0;0;0;0;0
FR;5;2021-08-21;0;0;0;0;0;0;0;0;0;0
FR;5;2021-08-22;0;0;0;0;0;0;0;0;0;0
FR;5;2021-08-23;0;0;0;0;0;0;0;0;0;0
FR;5;2021-08-24;0;0;0;0;0;0;0;0;0;0
FR;5;2021-08-25;0;0;0;0;0;0;0;0;0;0
FR;5;2021-08-26;0;0;0;0;0;0;0;0;0;0
FR;5;2021-08-27;0;0;0;0;0;0;0;0;0;0
FR;5;2021-08-28;0;0;0;0;0;0;0;0;0;0
FR;5;2021-08-29;0;0;0;0;0;0;0;0;0;0
FR;5;2021-08-30;0;0;0;0;0;0;0;0;0;0
FR;5;2021-08-31;0;0;0;0;0;0;0;0;0;0
FR;5;2021-09-01;0;0;0;0;0;0;0;0;0;0
FR;5;2021-09-02;0;0;0;0;0;0;0;0;0;0
FR;5;2021-09-03;0;0;0;0;0;0;0;0;0;0
FR;5;2021-09-04;0;0;0;0;0;0;0;0;0;0
FR;5;2021-09-05;0;0;0;0;0;0;0;0;0;0
FR;5;2021-09-06;0;0;0;0;0;0;0;0;0;0
FR;5;2021-09-07;0;0;0;0;0;0;0;0;0;0
FR;5;2021-09-08;0;0;0;0;0;0;0;0;0;0
FR;5;2021-09-09;0;0;0;0;0;0;0;0;0;0
FR;5;2021-09-10;0;0;0;0;0;0;0;0;0;0
FR;5;2021-09-11;0;0;0;0;0;0;0;0;0;0
FR;5;2021-09-12;0;0;0;0;0;0;0;0;0;0
FR;5;2021-09-13;0;0;0;0;0;0;0;0;0;0
FR;5;2021-09-14;0;0;0;0;0;0;0;0;0;0
FR;5;2021-09-15;0;0;0;0;0;0;0;0;0;0
FR;5;2021-09-16;0;0;0;0;0;0;0;0;0;0
FR;5;2021-09-17;0;0;0;0;0;0;0;0;0;0
FR;5;2021-09-18;0;0;0;0;0;0;0;0;0;0
FR;5;2021-09-19;0;0;0;0;0;0;0;0;0;0
FR;5;2021-09-20;0;0;0;0;0;0;0;0;0;0
FR;5;2021-09-21;0;0;0;0;0;0;0;0;0;0
FR;5;2021-09-22;0;0;0;0;0;0;0;0;0;0
FR;5;2021-09-23;0;0;0;0;0;0;0;0;0;0
FR;5;2021-09-24;0;0;0;0;0;0;0;0;0;0
FR;5;2021-09-25;0;0;0;0;0;0;0;0;0;0
FR;5;2021-09-26;0;0;0;0;0;0;0;0;0;0
FR;5;2021-09-27;0;0;0;0;0;0;0;0;0;0
FR;5;2021-09-28;0;0;0;0;0;0;0;0;0;0
FR;5;2021-09-29;0;0;0;0;0;0;0;0;0;0
FR;5;2021-09-30;0;0;0;0;0;0;0;0;0;0
FR;5;2021-10-01;0;0;0;0;0;0;0;0;0;0
FR;5;2021-10-02;0;0;0;0;0;0;0;0;0;0
FR;5;2021-10-03;0;0;0;0;0;0;0;0;0;0
FR;5;2021-10-04;0;0;0;0;0;0;0;0;0;0
FR;5;2021-10-05;0;0;0;0;0;0;0;0;0;0
FR;5;2021-10-06;0;0;0;0;0;0;0;0;0;0
FR;5;2021-10-07;0;0;0;0;0;0;0;0;0;0
FR;5;2021-10-08;0;0;0;0;0;0;0;0;0;0
FR;5;2021-10-09;0;0;0;0;0;0;0;0;0;0
FR;5;2021-10-10;0;0;0;0;0;0;0;0;0;0
FR;5;2021-10-11;0;0;0;0;0;0;0;0;0;0
FR;5;2021-10-12;0;0;0;0;0;0;0;0;0;0
FR;5;2021-10-13;0;0;0;0;0;0;0;0;0;0
FR;5;2021-10-14;0;0;0;0;0;0;0;0;0;0
FR;5;2021-10-15;0;0;0;0;0;0;0;0;0;0
FR;5;2021-10-16;0;0;0;0;0;0;0;0;0;0
FR;5;2021-10-17;0;0;0;0;0;0;0;0;0;0
FR;5;2021-10-18;0;0;0;0;0;0;0;0;0;0
FR;5;2021-10-19;0;0;0;0;0;0;0;0;0;0
FR;5;2021-10-20;0;0;0;0;0;0;0;0;0;0
FR;5;2021-10-21;0;0;0;0;0;0;0;0;0;0
FR;5;2021-10-22;0;0;0;0;0;0;0;0;0;0
FR;5;2021-10-23;0;0;0;0;0;0;0;0;0;0
FR;5;2021-10-24;0;0;0;0;0;0;0;0;0;0
FR;5;2021-10-25;0;0;0;0;0;0;0;0;0;0
FR;5;2021-10-26;0;0;0;0;0;0;0;0;0;0
FR;5;2021-10-27;0;0;0;0;0;0;0;0;0;0
FR;5;2021-10-28;0;0;0;0;0;0;0;0;0;0
FR;5;2021-10-29;0;0;0;0;0;0;0;0;0;0
FR;5;2021-10-30;0;0;0;0;0;0;0;0;0;0
FR;5;2021-10-31;0;0;0;0;0;0;0;0;0;0
FR;5;2021-11-01;0;0;0;0;0;0;0;0;0;0
FR;5;2021-11-02;0;0;0;0;0;0;0;0;0;0
FR;5;2021-11-03;0;0;0;0;0;0;0;0;0;0
FR;5;2021-11-04;0;0;0;0;0;0;0;0;0;0
FR;5;2021-11-05;0;0;0;0;0;0;0;0;0;0
FR;5;2021-11-06;0;0;0;0;0;0;0;0;0;0
FR;5;2021-11-07;0;0;0;0;0;0;0;0;0;0
FR;5;2021-11-08;0;0;0;0;0;0;0;0;0;0
FR;5;2021-11-09;0;0;0;0;0;0;0;0;0;0
FR;5;2021-11-10;0;0;0;0;0;0;0;0;0;0
FR;5;2021-11-11;0;0;0;0;0;0;0;0;0;0
FR;5;2021-11-12;0;0;0;0;0;0;0;0;0;0
FR;5;2021-11-13;0;0;0;0;0;0;0;0;0;0
FR;5;2021-11-14;0;0;0;0;0;0;0;0;0;0
FR;5;2021-11-15;0;0;0;0;0;0;0;0;0;0
FR;5;2021-11-16;0;0;0;0;0;0;0;0;0;0
FR;5;2021-11-17;0;0;0;0;0;0;0;0;0;0
FR;5;2021-11-18;0;0;0;0;0;0;0;0;0;0
FR;5;2021-11-19;0;0;0;0;0;0;0;0;0;0
FR;5;2021-11-20;0;0;0;0;0;0;0;0;0;0
FR;5;2021-11-21;0;0;0;0;0;0;0;0;0;0
FR;5;2021-11-22;0;0;0;0;0;0;0;0;0;0
FR;5;2021-11-23;0;0;0;0;0;0;0;0;0;0
FR;5;2021-11-24;0;0;0;0;0;0;0;0;0;0
FR;5;2021-11-25;0;0;0;0;0;0;0;0;0;0
FR;5;2021-11-26;0;0;0;0;0;0;0;0;0;0
FR;5;2021-11-27;0;0;0;0;0;0;0;0;0;0
FR;5;2021-11-28;0;0;0;0;0;0;0;0;0;0
FR;5;2021-11-29;0;0;0;0;0;0;0;0;0;0
FR;5;2021-11-30;0;0;0;0;0;0;0;0;0;0
FR;5;2021-12-01;0;0;0;0;0;0;0;0;0;0
FR;5;2021-12-02;0;0;0;0;0;0;0;0;0;0
FR;5;2021-12-03;0;0;0;0;0;0;0;0;0;0
FR;5;2021-12-04;0;0;0;0;0;0;0;0;0;0
FR;5;2021-12-05;0;0;0;0;0;0;0;0;0;0
FR;5;2021-12-06;0;0;0;0;0;0;0;0;0;0
FR;5;2021-12-07;0;0;0;0;0;0;0;0;0;0
FR;5;2021-12-08;0;0;0;0;0;0;0;0;0;0
FR;5;2021-12-09;0;0;0;0;0;0;0;0;0;0
FR;5;2021-12-10;0;0;0;0;0;0;0;0;0;0
FR;5;2021-12-11;0;0;0;0;0;0;0;0;0;0
FR;5;2021-12-12;0;0;0;0;0;0;0;0;0;0
FR;5;2021-12-13;0;0;0;0;0;0;0;0;0;0
FR;5;2021-12-14;28;45;77;0;88;28;45;77;0;88
FR;5;2021-12-15;195;44;37;0;49;223;89;114;0;137
FR;5;2021-12-16;180;21;44;0;48;403;110;158;0;185
FR;5;2021-12-17;310;16;72;0;74;713;126;230;0;259
FR;5;2021-12-18;762;24;22;0;29;1475;150;252;0;288
FR;5;2021-12-19;586;15;15;0;17;2061;165;267;0;305
FR;5;2021-12-20;1220;31;35;0;38;3281;196;302;0;343
FR;5;2021-12-21;1535;22;54;1;60;4816;218;356;1;403
FR;5;2021-12-22;4069;40;37;0;46;8885;258;393;1;449
FR;5;2021-12-23;3041;16;21;0;25;11926;274;414;1;474
FR;5;2021-12-24;759;18;9;0;15;12685;292;423;1;489
FR;5;2021-12-25;61;5;1;0;2;12746;297;424;1;491
FR;5;2021-12-26;623;6;3;0;4;13369;303;427;1;495
FR;5;2021-12-27;4080;25;21;0;23;17449;328;448;1;518
FR;5;2021-12-28;5199;23;41;1;43;22648;351;489;2;561
FR;5;2021-12-29;8101;34;65;2;68;30749;385;554;4;629
FR;5;2021-12-30;5171;18;33;0;39;35920;403;587;4;668
FR;5;2021-12-31;1553;8;10;0;11;37473;411;597;4;679
FR;5;2022-01-01;185;1;2;0;2;37658;412;599;4;681
FR;5;2022-01-02;1489;1;1;0;1;39147;413;600;4;682
FR;5;2022-01-03;3054;36;33;0;32;42201;449;633;4;714
FR;5;2022-01-04;3034;39;33;0;42;45235;488;666;4;756
FR;5;2022-01-05;19312;203;97;1;108;64547;691;763;5;864
FR;5;2022-01-06;3739;133;122;0;142;68286;824;885;5;1006
FR;5;2022-01-07;5006;200;48;2;56;73292;1024;933;7;1062
FR;5;2022-01-08;13650;513;45;0;52;86942;1537;978;7;1114
FR;5;2022-01-09;5755;399;15;0;20;92697;1936;993;7;1134
FR;5;2022-01-10;3452;326;25;0;29;96149;2262;1018;7;1163
FR;5;2022-01-11;3667;284;38;0;41;99816;2546;1056;7;1204
FR;5;2022-01-12;22650;3003;90;0;113;122466;5549;1146;7;1317
FR;5;2022-01-13;4033;622;30;0;32;126499;6171;1176;7;1349
FR;5;2022-01-14;4842;581;43;0;50;131341;6752;1219;7;1399
FR;5;2022-01-15;14678;1746;38;3;49;146019;8498;1257;10;1448
FR;5;2022-01-16;4727;666;3;0;5;150746;9164;1260;10;1453
FR;5;2022-01-17;2294;715;26;0;29;153040;9879;1286;10;1482
FR;5;2022-01-18;2429;870;30;0;40;155469;10749;1316;10;1522
FR;5;2022-01-19;18479;6418;74;2;142;173948;17167;1390;12;1664
FR;5;2022-01-20;1919;1067;24;0;33;175867;18234;1414;12;1697
FR;5;2022-01-21;3074;1370;47;1;59;178941;19604;1461;13;1756
FR;5;2022-01-22;10721;3454;33;1;43;189662;23058;1494;14;1799
FR;5;2022-01-23;2628;1413;5;0;8;192290;24471;1499;14;1807
FR;5;2022-01-24;1157;1340;19;0;23;193447;25811;1518;14;1830
FR;5;2022-01-25;1218;1548;19;2;29;194665;27359;1537;16;1859
FR;5;2022-01-26;10747;12015;50;1;89;205412;39374;1587;17;1948
FR;5;2022-01-27;1291;1690;10;0;17;206703;41064;1597;17;1965
FR;5;2022-01-28;1695;3347;16;0;19;208398;44411;1613;17;1984
FR;5;2022-01-29;6237;8040;68;0;96;214635;52451;1681;17;2080
FR;5;2022-01-30;1509;2950;5;0;18;216144;55401;1686;17;2098
FR;5;2022-01-31;587;1772;23;0;24;216731;57173;1709;17;2122
FR;5;2022-02-01;709;1702;10;0;15;217440;58875;1719;17;2137
FR;5;2022-02-02;6952;15653;52;0;94;224392;74528;1771;17;2231
FR;5;2022-02-03;486;1688;13;0;11;224878;76216;1784;17;2242
FR;5;2022-02-04;939;3001;19;0;31;225817;79217;1803;17;2273
FR;5;2022-02-05;3531;8914;23;0;37;229348;88131;1826;17;2310
FR;5;2022-02-06;736;2397;10;0;19;230084;90528;1836;17;2329
FR;5;2022-02-07;882;1595;22;0;24;230966;92123;1858;17;2353
FR;5;2022-02-08;719;1285;18;0;20;231685;93408;1876;17;2373
FR;5;2022-02-09;4533;12874;44;0;76;236218;106282;1920;17;2449
FR;5;2022-02-10;645;1058;13;0;14;236863;107340;1933;17;2463
FR;5;2022-02-11;793;2026;16;0;21;237656;109366;1949;17;2484
FR;5;2022-02-12;2285;6811;32;0;52;239941;116177;1981;17;2536
FR;5;2022-02-13;465;1539;8;0;8;240406;117716;1989;17;2544
FR;5;2022-02-14;678;1288;10;0;13;241084;119004;1999;17;2557
FR;5;2022-02-15;482;883;9;0;14;241566;119887;2008;17;2571
FR;5;2022-02-16;2977;9122;41;1;58;244543;129009;2049;18;2629
FR;5;2022-02-17;435;803;6;0;7;244978;129812;2055;18;2636
FR;5;2022-02-18;648;1407;13;0;17;245626;131219;2068;18;2653
FR;5;2022-02-19;1370;4314;16;0;28;246996;135533;2084;18;2681
FR;5;2022-02-20;247;879;6;0;8;247243;136412;2090;18;2689
FR;5;2022-02-21;221;607;2;0;4;247464;137019;2092;18;2693
FR;5;2022-02-22;259;544;17;0;17;247723;137563;2109;18;2710
FR;5;2022-02-23;1907;6923;22;1;42;249630;144486;2131;19;2752
FR;5;2022-02-24;182;371;5;1;5;249812;144857;2136;20;2757
FR;5;2022-02-25;333;949;13;0;12;250145;145806;2149;20;2769
FR;5;2022-02-26;970;3066;10;0;14;251115;148872;2159;20;2783
FR;5;2022-02-27;146;506;0;0;3;251261;149378;2159;20;2786
FR;5;2022-02-28;160;369;1;0;1;251421;149747;2160;20;2787
FR;5;2022-03-01;123;278;6;0;7;251544;150025;2166;20;2794
FR;5;2022-03-02;1236;4146;28;3;40;252780;154171;2194;23;2834
FR;5;2022-03-03;119;249;6;0;9;252899;154420;2200;23;2843
FR;5;2022-03-04;192;484;13;0;13;253091;154904;2213;23;2856
FR;5;2022-03-05;676;1990;8;0;16;253767;156894;2221;23;2872
FR;5;2022-03-06;107;260;0;0;0;253874;157154;2221;23;2872
FR;5;2022-03-07;70;228;5;0;3;253944;157382;2226;23;2875
FR;5;2022-03-08;46;130;7;1;7;253990;157512;2233;24;2882
FR;5;2022-03-09;908;3075;23;0;35;254898;160587;2256;24;2917
FR;5;2022-03-10;82;200;7;0;10;254980;160787;2263;24;2927
FR;5;2022-03-11;145;368;14;1;15;255125;161155;2277;25;2942
FR;5;2022-03-12;758;1613;12;1;29;255883;162768;2289;26;2971
FR;5;2022-03-13;76;99;0;0;0;255959;162867;2289;26;2971
FR;5;2022-03-14;67;116;7;1;7;256026;162983;2296;27;2978
FR;5;2022-03-15;81;99;3;0;6;256107;163082;2299;27;2984
FR;5;2022-03-16;880;1822;15;3;34;256987;164904;2314;30;3018
FR;5;2022-03-17;66;122;8;4;10;257053;165026;2322;34;3028
FR;5;2022-03-18;170;318;13;3;18;257223;165344;2335;37;3046
FR;5;2022-03-19;748;1162;12;5;33;257971;166506;2347;42;3079
FR;5;2022-03-20;44;92;1;0;1;258015;166598;2348;42;3080
FR;5;2022-03-21;71;116;10;6;15;258086;166714;2358;48;3095
FR;5;2022-03-22;55;114;8;6;8;258141;166828;2366;54;3103
FR;5;2022-03-23;800;1458;13;8;35;258941;168286;2379;62;3138
FR;5;2022-03-24;67;89;8;7;7;259008;168375;2387;69;3145
FR;5;2022-03-25;220;288;15;8;18;259228;168663;2402;77;3163
FR;5;2022-03-26;706;850;12;5;26;259934;169513;2414;82;3189
FR;5;2022-03-27;74;78;0;0;3;260008;169591;2414;82;3192
FR;5;2022-03-28;79;91;1;2;3;260087;169682;2415;84;3195
FR;5;2022-03-29;68;82;10;4;12;260155;169764;2425;88;3207
FR;5;2022-03-30;815;1112;15;13;28;260970;170876;2440;101;3235
FR;5;2022-03-31;95;122;1;4;6;261065;170998;2441;105;3241
FR;5;2022-04-01;109;84;6;12;11;261174;171082;2447;117;3252
FR;5;2022-04-02;326;343;3;3;14;261500;171425;2450;120;3266
FR;5;2022-04-03;54;59;1;0;1;261554;171484;2451;120;3267
FR;5;2022-04-04;35;54;3;1;7;261589;171538;2454;121;3274
FR;5;2022-04-05;49;59;6;6;9;261638;171597;2460;127;3283
FR;6;2020-12-27;0;0;0;0;0;0;0;0;0;0
FR;6;2020-12-28;0;0;0;0;0;0;0;0;0;0
FR;6;2020-12-29;0;0;0;0;0;0;0;0;0;0
FR;6;2020-12-30;0;0;0;0;0;0;0;0;0;0
FR;6;2020-12-31;0;0;0;0;0;0;0;0;0;0
FR;6;2021-01-01;0;0;0;0;0;0;0;0;0;0
FR;6;2021-01-02;0;0;0;0;0;0;0;0;0;0
FR;6;2021-01-03;0;0;0;0;0;0;0;0;0;0
FR;6;2021-01-04;0;0;0;0;0;0;0;0;0;0
FR;6;2021-01-05;0;0;0;0;0;0;0;0;0;0
FR;6;2021-01-06;0;0;0;0;0;0;0;0;0;0
FR;6;2021-01-07;0;0;0;0;0;0;0;0;0;0
FR;6;2021-01-08;0;0;0;0;0;0;0;0;0;0
FR;6;2021-01-09;0;0;0;0;0;0;0;0;0;0
FR;6;2021-01-10;0;0;0;0;0;0;0;0;0;0
FR;6;2021-01-11;0;0;0;0;0;0;0;0;0;0
FR;6;2021-01-12;0;0;0;0;0;0;0;0;0;0
FR;6;2021-01-13;0;0;0;0;0;0;0;0;0;0
FR;6;2021-01-14;0;0;0;0;0;0;0;0;0;0
FR;6;2021-01-15;0;0;0;0;0;0;0;0;0;0
FR;6;2021-01-16;0;0;0;0;0;0;0;0;0;0
FR;6;2021-01-17;0;0;0;0;0;0;0;0;0;0
FR;6;2021-01-18;0;0;0;0;0;0;0;0;0;0
FR;6;2021-01-19;0;0;0;0;0;0;0;0;0;0
FR;6;2021-01-20;0;0;0;0;0;0;0;0;0;0
FR;6;2021-01-21;0;0;0;0;0;0;0;0;0;0
FR;6;2021-01-22;0;0;0;0;0;0;0;0;0;0
FR;6;2021-01-23;0;0;0;0;0;0;0;0;0;0
FR;6;2021-01-24;0;0;0;0;0;0;0;0;0;0
FR;6;2021-01-25;0;0;0;0;0;0;0;0;0;0
FR;6;2021-01-26;0;0;0;0;0;0;0;0;0;0
FR;6;2021-01-27;0;0;0;0;0;0;0;0;0;0
FR;6;2021-01-28;0;0;0;0;0;0;0;0;0;0
FR;6;2021-01-29;0;0;0;0;0;0;0;0;0;0
FR;6;2021-01-30;0;0;0;0;0;0;0;0;0;0
FR;6;2021-01-31;0;0;0;0;0;0;0;0;0;0
FR;6;2021-02-01;0;0;0;0;0;0;0;0;0;0
FR;6;2021-02-02;0;0;0;0;0;0;0;0;0;0
FR;6;2021-02-03;0;0;0;0;0;0;0;0;0;0
FR;6;2021-02-04;0;0;0;0;0;0;0;0;0;0
FR;6;2021-02-05;0;0;0;0;0;0;0;0;0;0
FR;6;2021-02-06;0;0;0;0;0;0;0;0;0;0
FR;6;2021-02-07;0;0;0;0;0;0;0;0;0;0
FR;6;2021-02-08;0;0;0;0;0;0;0;0;0;0
FR;6;2021-02-09;0;0;0;0;0;0;0;0;0;0
FR;6;2021-02-10;0;0;0;0;0;0;0;0;0;0
FR;6;2021-02-11;0;0;0;0;0;0;0;0;0;0
FR;6;2021-02-12;0;0;0;0;0;0;0;0;0;0
FR;6;2021-02-13;0;0;0;0;0;0;0;0;0;0
FR;6;2021-02-14;0;0;0;0;0;0;0;0;0;0
FR;6;2021-02-15;0;0;0;0;0;0;0;0;0;0
FR;6;2021-02-16;0;0;0;0;0;0;0;0;0;0
FR;6;2021-02-17;0;0;0;0;0;0;0;0;0;0
FR;6;2021-02-18;0;0;0;0;0;0;0;0;0;0
FR;6;2021-02-19;0;0;0;0;0;0;0;0;0;0
FR;6;2021-02-20;0;0;0;0;0;0;0;0;0;0
FR;6;2021-02-21;0;0;0;0;0;0;0;0;0;0
FR;6;2021-02-22;0;0;0;0;0;0;0;0;0;0
FR;6;2021-02-23;0;0;0;0;0;0;0;0;0;0
FR;6;2021-02-24;0;0;0;0;0;0;0;0;0;0
FR;6;2021-02-25;0;0;0;0;0;0;0;0;0;0
FR;6;2021-02-26;0;0;0;0;0;0;0;0;0;0
FR;6;2021-02-27;0;0;0;0;0;0;0;0;0;0
FR;6;2021-02-28;0;0;0;0;0;0;0;0;0;0
FR;6;2021-03-01;0;0;0;0;0;0;0;0;0;0
FR;6;2021-03-02;0;0;0;0;0;0;0;0;0;0
FR;6;2021-03-03;0;0;0;0;0;0;0;0;0;0
FR;6;2021-03-04;0;0;0;0;0;0;0;0;0;0
FR;6;2021-03-05;0;0;0;0;0;0;0;0;0;0
FR;6;2021-03-06;0;0;0;0;0;0;0;0;0;0
FR;6;2021-03-07;0;0;0;0;0;0;0;0;0;0
FR;6;2021-03-08;0;0;0;0;0;0;0;0;0;0
FR;6;2021-03-09;0;0;0;0;0;0;0;0;0;0
FR;6;2021-03-10;0;0;0;0;0;0;0;0;0;0
FR;6;2021-03-11;0;0;0;0;0;0;0;0;0;0
FR;6;2021-03-12;0;0;0;0;0;0;0;0;0;0
FR;6;2021-03-13;0;0;0;0;0;0;0;0;0;0
FR;6;2021-03-14;0;0;0;0;0;0;0;0;0;0
FR;6;2021-03-15;0;0;0;0;0;0;0;0;0;0
FR;6;2021-03-16;0;0;0;0;0;0;0;0;0;0
FR;6;2021-03-17;0;0;0;0;0;0;0;0;0;0
FR;6;2021-03-18;0;0;0;0;0;0;0;0;0;0
FR;6;2021-03-19;0;0;0;0;0;0;0;0;0;0
FR;6;2021-03-20;0;0;0;0;0;0;0;0;0;0
FR;6;2021-03-21;0;0;0;0;0;0;0;0;0;0
FR;6;2021-03-22;0;0;0;0;0;0;0;0;0;0
FR;6;2021-03-23;0;0;0;0;0;0;0;0;0;0
FR;6;2021-03-24;0;0;0;0;0;0;0;0;0;0
FR;6;2021-03-25;0;0;0;0;0;0;0;0;0;0
FR;6;2021-03-26;0;0;0;0;0;0;0;0;0;0
FR;6;2021-03-27;0;0;0;0;0;0;0;0;0;0
FR;6;2021-03-28;0;0;0;0;0;0;0;0;0;0
FR;6;2021-03-29;0;0;0;0;0;0;0;0;0;0
FR;6;2021-03-30;0;0;0;0;0;0;0;0;0;0
FR;6;2021-03-31;0;0;0;0;0;0;0;0;0;0
FR;6;2021-04-01;0;0;0;0;0;0;0;0;0;0
FR;6;2021-04-02;0;0;0;0;0;0;0;0;0;0
FR;6;2021-04-03;0;0;0;0;0;0;0;0;0;0
FR;6;2021-04-04;0;0;0;0;0;0;0;0;0;0
FR;6;2021-04-05;0;0;0;0;0;0;0;0;0;0
FR;6;2021-04-06;0;0;0;0;0;0;0;0;0;0
FR;6;2021-04-07;0;0;0;0;0;0;0;0;0;0
FR;6;2021-04-08;0;0;0;0;0;0;0;0;0;0
FR;6;2021-04-09;0;0;0;0;0;0;0;0;0;0
FR;6;2021-04-10;0;0;0;0;0;0;0;0;0;0
FR;6;2021-04-11;0;0;0;0;0;0;0;0;0;0
FR;6;2021-04-12;0;0;0;0;0;0;0;0;0;0
FR;6;2021-04-13;0;0;0;0;0;0;0;0;0;0
FR;6;2021-04-14;0;0;0;0;0;0;0;0;0;0
FR;6;2021-04-15;0;0;0;0;0;0;0;0;0;0
FR;6;2021-04-16;0;0;0;0;0;0;0;0;0;0
FR;6;2021-04-17;0;0;0;0;0;0;0;0;0;0
FR;6;2021-04-18;0;0;0;0;0;0;0;0;0;0
FR;6;2021-04-19;0;0;0;0;0;0;0;0;0;0
FR;6;2021-04-20;0;0;0;0;0;0;0;0;0;0
FR;6;2021-04-21;0;0;0;0;0;0;0;0;0;0
FR;6;2021-04-22;0;0;0;0;0;0;0;0;0;0
FR;6;2021-04-23;0;0;0;0;0;0;0;0;0;0
FR;6;2021-04-24;0;0;0;0;0;0;0;0;0;0
FR;6;2021-04-25;0;0;0;0;0;0;0;0;0;0
FR;6;2021-04-26;0;0;0;0;0;0;0;0;0;0
FR;6;2021-04-27;0;0;0;0;0;0;0;0;0;0
FR;6;2021-04-28;0;0;0;0;0;0;0;0;0;0
FR;6;2021-04-29;0;0;0;0;0;0;0;0;0;0
FR;6;2021-04-30;0;0;0;0;0;0;0;0;0;0
FR;6;2021-05-01;0;0;0;0;0;0;0;0;0;0
FR;6;2021-05-02;0;0;0;0;0;0;0;0;0;0
FR;6;2021-05-03;0;0;0;0;0;0;0;0;0;0
FR;6;2021-05-04;0;0;0;0;0;0;0;0;0;0
FR;6;2021-05-05;0;0;0;0;0;0;0;0;0;0
FR;6;2021-05-06;0;0;0;0;0;0;0;0;0;0
FR;6;2021-05-07;0;0;0;0;0;0;0;0;0;0
FR;6;2021-05-08;0;0;0;0;0;0;0;0;0;0
FR;6;2021-05-09;0;0;0;0;0;0;0;0;0;0
FR;6;2021-05-10;0;0;0;0;0;0;0;0;0;0
FR;6;2021-05-11;0;0;0;0;0;0;0;0;0;0
FR;6;2021-05-12;0;0;0;0;0;0;0;0;0;0
FR;6;2021-05-13;0;0;0;0;0;0;0;0;0;0
FR;6;2021-05-14;0;0;0;0;0;0;0;0;0;0
FR;6;2021-05-15;0;0;0;0;0;0;0;0;0;0
FR;6;2021-05-16;0;0;0;0;0;0;0;0;0;0
FR;6;2021-05-17;0;0;0;0;0;0;0;0;0;0
FR;6;2021-05-18;0;0;0;0;0;0;0;0;0;0
FR;6;2021-05-19;0;0;0;0;0;0;0;0;0;0
FR;6;2021-05-20;0;0;0;0;0;0;0;0;0;0
FR;6;2021-05-21;0;0;0;0;0;0;0;0;0;0
FR;6;2021-05-22;0;0;0;0;0;0;0;0;0;0
FR;6;2021-05-23;0;0;0;0;0;0;0;0;0;0
FR;6;2021-05-24;0;0;0;0;0;0;0;0;0;0
FR;6;2021-05-25;0;0;0;0;0;0;0;0;0;0
FR;6;2021-05-26;0;0;0;0;0;0;0;0;0;0
FR;6;2021-05-27;0;0;0;0;0;0;0;0;0;0
FR;6;2021-05-28;0;0;0;0;0;0;0;0;0;0
FR;6;2021-05-29;0;0;0;0;0;0;0;0;0;0
FR;6;2021-05-30;0;0;0;0;0;0;0;0;0;0
FR;6;2021-05-31;0;0;0;0;0;0;0;0;0;0
FR;6;2021-06-01;0;0;0;0;0;0;0;0;0;0
FR;6;2021-06-02;0;0;0;0;0;0;0;0;0;0
FR;6;2021-06-03;0;0;0;0;0;0;0;0;0;0
FR;6;2021-06-04;0;0;0;0;0;0;0;0;0;0
FR;6;2021-06-05;0;0;0;0;0;0;0;0;0;0
FR;6;2021-06-06;0;0;0;0;0;0;0;0;0;0
FR;6;2021-06-07;0;0;0;0;0;0;0;0;0;0
FR;6;2021-06-08;0;0;0;0;0;0;0;0;0;0
FR;6;2021-06-09;0;0;0;0;0;0;0;0;0;0
FR;6;2021-06-10;0;0;0;0;0;0;0;0;0;0
FR;6;2021-06-11;0;0;0;0;0;0;0;0;0;0
FR;6;2021-06-12;0;0;0;0;0;0;0;0;0;0
FR;6;2021-06-13;0;0;0;0;0;0;0;0;0;0
FR;6;2021-06-14;0;0;0;0;0;0;0;0;0;0
FR;6;2021-06-15;0;0;0;0;0;0;0;0;0;0
FR;6;2021-06-16;0;0;0;0;0;0;0;0;0;0
FR;6;2021-06-17;0;0;0;0;0;0;0;0;0;0
FR;6;2021-06-18;0;0;0;0;0;0;0;0;0;0
FR;6;2021-06-19;0;0;0;0;0;0;0;0;0;0
FR;6;2021-06-20;0;0;0;0;0;0;0;0;0;0
FR;6;2021-06-21;0;0;0;0;0;0;0;0;0;0
FR;6;2021-06-22;0;0;0;0;0;0;0;0;0;0
FR;6;2021-06-23;0;0;0;0;0;0;0;0;0;0
FR;6;2021-06-24;0;0;0;0;0;0;0;0;0;0
FR;6;2021-06-25;0;0;0;0;0;0;0;0;0;0
FR;6;2021-06-26;0;0;0;0;0;0;0;0;0;0
FR;6;2021-06-27;0;0;0;0;0;0;0;0;0;0
FR;6;2021-06-28;0;0;0;0;0;0;0;0;0;0
FR;6;2021-06-29;0;0;0;0;0;0;0;0;0;0
FR;6;2021-06-30;0;0;0;0;0;0;0;0;0;0
FR;6;2021-07-01;0;0;0;0;0;0;0;0;0;0
FR;6;2021-07-02;0;0;0;0;0;0;0;0;0;0
FR;6;2021-07-03;0;0;0;0;0;0;0;0;0;0
FR;6;2021-07-04;0;0;0;0;0;0;0;0;0;0
FR;6;2021-07-05;0;0;0;0;0;0;0;0;0;0
FR;6;2021-07-06;0;0;0;0;0;0;0;0;0;0
FR;6;2021-07-07;0;0;0;0;0;0;0;0;0;0
FR;6;2021-07-08;0;0;0;0;0;0;0;0;0;0
FR;6;2021-07-09;0;0;0;0;0;0;0;0;0;0
FR;6;2021-07-10;0;0;0;0;0;0;0;0;0;0
FR;6;2021-07-11;0;0;0;0;0;0;0;0;0;0
FR;6;2021-07-12;0;0;0;0;0;0;0;0;0;0
FR;6;2021-07-13;0;0;0;0;0;0;0;0;0;0
FR;6;2021-07-14;0;0;0;0;0;0;0;0;0;0
FR;6;2021-07-15;0;0;0;0;0;0;0;0;0;0
FR;6;2021-07-16;0;0;0;0;0;0;0;0;0;0
FR;6;2021-07-17;0;0;0;0;0;0;0;0;0;0
FR;6;2021-07-18;0;0;0;0;0;0;0;0;0;0
FR;6;2021-07-19;0;0;0;0;0;0;0;0;0;0
FR;6;2021-07-20;0;0;0;0;0;0;0;0;0;0
FR;6;2021-07-21;0;0;0;0;0;0;0;0;0;0
FR;6;2021-07-22;0;0;0;0;0;0;0;0;0;0
FR;6;2021-07-23;0;0;0;0;0;0;0;0;0;0
FR;6;2021-07-24;0;0;0;0;0;0;0;0;0;0
FR;6;2021-07-25;0;0;0;0;0;0;0;0;0;0
FR;6;2021-07-26;0;0;0;0;0;0;0;0;0;0
FR;6;2021-07-27;0;0;0;0;0;0;0;0;0;0
FR;6;2021-07-28;0;0;0;0;0;0;0;0;0;0
FR;6;2021-07-29;0;0;0;0;0;0;0;0;0;0
FR;6;2021-07-30;0;0;0;0;0;0;0;0;0;0
FR;6;2021-07-31;0;0;0;0;0;0;0;0;0;0
FR;6;2021-08-01;0;0;0;0;0;0;0;0;0;0
FR;6;2021-08-02;0;0;0;0;0;0;0;0;0;0
FR;6;2021-08-03;0;0;0;0;0;0;0;0;0;0
FR;6;2021-08-04;0;0;0;0;0;0;0;0;0;0
FR;6;2021-08-05;0;0;0;0;0;0;0;0;0;0
FR;6;2021-08-06;0;0;0;0;0;0;0;0;0;0
FR;6;2021-08-07;0;0;0;0;0;0;0;0;0;0
FR;6;2021-08-08;0;0;0;0;0;0;0;0;0;0
FR;6;2021-08-09;0;0;0;0;0;0;0;0;0;0
FR;6;2021-08-10;0;0;0;0;0;0;0;0;0;0
FR;6;2021-08-11;0;0;0;0;0;0;0;0;0;0
FR;6;2021-08-12;0;0;0;0;0;0;0;0;0;0
FR;6;2021-08-13;0;0;0;0;0;0;0;0;0;0
FR;6;2021-08-14;0;0;0;0;0;0;0;0;0;0
FR;6;2021-08-15;0;0;0;0;0;0;0;0;0;0
FR;6;2021-08-16;0;0;0;0;0;0;0;0;0;0
FR;6;2021-08-17;0;0;0;0;0;0;0;0;0;0
FR;6;2021-08-18;0;0;0;0;0;0;0;0;0;0
FR;6;2021-08-19;0;0;0;0;0;0;0;0;0;0
FR;6;2021-08-20;0;0;0;0;0;0;0;0;0;0
FR;6;2021-08-21;0;0;0;0;0;0;0;0;0;0
FR;6;2021-08-22;0;0;0;0;0;0;0;0;0;0
FR;6;2021-08-23;0;0;0;0;0;0;0;0;0;0
FR;6;2021-08-24;0;0;0;0;0;0;0;0;0;0
FR;6;2021-08-25;0;0;0;0;0;0;0;0;0;0
FR;6;2021-08-26;0;0;0;0;0;0;0;0;0;0
FR;6;2021-08-27;0;0;0;0;0;0;0;0;0;0
FR;6;2021-08-28;0;0;0;0;0;0;0;0;0;0
FR;6;2021-08-29;0;0;0;0;0;0;0;0;0;0
FR;6;2021-08-30;0;0;0;0;0;0;0;0;0;0
FR;6;2021-08-31;0;0;0;0;0;0;0;0;0;0
FR;6;2021-09-01;0;0;0;0;0;0;0;0;0;0
FR;6;2021-09-02;0;0;0;0;0;0;0;0;0;0
FR;6;2021-09-03;0;0;0;0;0;0;0;0;0;0
FR;6;2021-09-04;0;0;0;0;0;0;0;0;0;0
FR;6;2021-09-05;0;0;0;0;0;0;0;0;0;0
FR;6;2021-09-06;0;0;0;0;0;0;0;0;0;0
FR;6;2021-09-07;0;0;0;0;0;0;0;0;0;0
FR;6;2021-09-08;0;0;0;0;0;0;0;0;0;0
FR;6;2021-09-09;0;0;0;0;0;0;0;0;0;0
FR;6;2021-09-10;0;0;0;0;0;0;0;0;0;0
FR;6;2021-09-11;0;0;0;0;0;0;0;0;0;0
FR;6;2021-09-12;0;0;0;0;0;0;0;0;0;0
FR;6;2021-09-13;0;0;0;0;0;0;0;0;0;0
FR;6;2021-09-14;0;0;0;0;0;0;0;0;0;0
FR;6;2021-09-15;0;0;0;0;0;0;0;0;0;0
FR;6;2021-09-16;0;0;0;0;0;0;0;0;0;0
FR;6;2021-09-17;0;0;0;0;0;0;0;0;0;0
FR;6;2021-09-18;0;0;0;0;0;0;0;0;0;0
FR;6;2021-09-19;0;0;0;0;0;0;0;0;0;0
FR;6;2021-09-20;0;0;0;0;0;0;0;0;0;0
FR;6;2021-09-21;0;0;0;0;0;0;0;0;0;0
FR;6;2021-09-22;0;0;0;0;0;0;0;0;0;0
FR;6;2021-09-23;0;0;0;0;0;0;0;0;0;0
FR;6;2021-09-24;0;0;0;0;0;0;0;0;0;0
FR;6;2021-09-25;0;0;0;0;0;0;0;0;0;0
FR;6;2021-09-26;0;0;0;0;0;0;0;0;0;0
FR;6;2021-09-27;0;0;0;0;0;0;0;0;0;0
FR;6;2021-09-28;0;0;0;0;0;0;0;0;0;0
FR;6;2021-09-29;0;0;0;0;0;0;0;0;0;0
FR;6;2021-09-30;0;0;0;0;0;0;0;0;0;0
FR;6;2021-10-01;0;0;0;0;0;0;0;0;0;0
FR;6;2021-10-02;0;0;0;0;0;0;0;0;0;0
FR;6;2021-10-03;0;0;0;0;0;0;0;0;0;0
FR;6;2021-10-04;0;0;0;0;0;0;0;0;0;0
FR;6;2021-10-05;0;0;0;0;0;0;0;0;0;0
FR;6;2021-10-06;0;0;0;0;0;0;0;0;0;0
FR;6;2021-10-07;0;0;0;0;0;0;0;0;0;0
FR;6;2021-10-08;0;0;0;0;0;0;0;0;0;0
FR;6;2021-10-09;0;0;0;0;0;0;0;0;0;0
FR;6;2021-10-10;0;0;0;0;0;0;0;0;0;0
FR;6;2021-10-11;0;0;0;0;0;0;0;0;0;0
FR;6;2021-10-12;0;0;0;0;0;0;0;0;0;0
FR;6;2021-10-13;0;0;0;0;0;0;0;0;0;0
FR;6;2021-10-14;0;0;0;0;0;0;0;0;0;0
FR;6;2021-10-15;0;0;0;0;0;0;0;0;0;0
FR;6;2021-10-16;0;0;0;0;0;0;0;0;0;0
FR;6;2021-10-17;0;0;0;0;0;0;0;0;0;0
FR;6;2021-10-18;0;0;0;0;0;0;0;0;0;0
FR;6;2021-10-19;0;0;0;0;0;0;0;0;0;0
FR;6;2021-10-20;0;0;0;0;0;0;0;0;0;0
FR;6;2021-10-21;0;0;0;0;0;0;0;0;0;0
FR;6;2021-10-22;0;0;0;0;0;0;0;0;0;0
FR;6;2021-10-23;0;0;0;0;0;0;0;0;0;0
FR;6;2021-10-24;0;0;0;0;0;0;0;0;0;0
FR;6;2021-10-25;0;0;0;0;0;0;0;0;0;0
FR;6;2021-10-26;0;0;0;0;0;0;0;0;0;0
FR;6;2021-10-27;0;0;0;0;0;0;0;0;0;0
FR;6;2021-10-28;0;0;0;0;0;0;0;0;0;0
FR;6;2021-10-29;0;0;0;0;0;0;0;0;0;0
FR;6;2021-10-30;0;0;0;0;0;0;0;0;0;0
FR;6;2021-10-31;0;0;0;0;0;0;0;0;0;0
FR;6;2021-11-01;0;0;0;0;0;0;0;0;0;0
FR;6;2021-11-02;0;0;0;0;0;0;0;0;0;0
FR;6;2021-11-03;0;0;0;0;0;0;0;0;0;0
FR;6;2021-11-04;0;0;0;0;0;0;0;0;0;0
FR;6;2021-11-05;0;0;0;0;0;0;0;0;0;0
FR;6;2021-11-06;0;0;0;0;0;0;0;0;0;0
FR;6;2021-11-07;0;0;0;0;0;0;0;0;0;0
FR;6;2021-11-08;0;0;0;0;0;0;0;0;0;0
FR;6;2021-11-09;0;0;0;0;0;0;0;0;0;0
FR;6;2021-11-10;0;0;0;0;0;0;0;0;0;0
FR;6;2021-11-11;0;0;0;0;0;0;0;0;0;0
FR;6;2021-11-12;0;0;0;0;0;0;0;0;0;0
FR;6;2021-11-13;0;0;0;0;0;0;0;0;0;0
FR;6;2021-11-14;0;0;0;0;0;0;0;0;0;0
FR;6;2021-11-15;0;0;0;0;0;0;0;0;0;0
FR;6;2021-11-16;0;0;0;0;0;0;0;0;0;0
FR;6;2021-11-17;0;0;0;0;0;0;0;0;0;0
FR;6;2021-11-18;0;0;0;0;0;0;0;0;0;0
FR;6;2021-11-19;0;0;0;0;0;0;0;0;0;0
FR;6;2021-11-20;0;0;0;0;0;0;0;0;0;0
FR;6;2021-11-21;0;0;0;0;0;0;0;0;0;0
FR;6;2021-11-22;0;0;0;0;0;0;0;0;0;0
FR;6;2021-11-23;0;0;0;0;0;0;0;0;0;0
FR;6;2021-11-24;0;0;0;0;0;0;0;0;0;0
FR;6;2021-11-25;0;0;0;0;0;0;0;0;0;0
FR;6;2021-11-26;0;0;0;0;0;0;0;0;0;0
FR;6;2021-11-27;0;0;0;0;0;0;0;0;0;0
FR;6;2021-11-28;0;0;0;0;0;0;0;0;0;0
FR;6;2021-11-29;0;0;0;0;0;0;0;0;0;0
FR;6;2021-11-30;0;0;0;0;0;0;0;0;0;0
FR;6;2021-12-01;0;0;0;0;0;0;0;0;0;0
FR;6;2021-12-02;0;0;0;0;0;0;0;0;0;0
FR;6;2021-12-03;0;0;0;0;0;0;0;0;0;0
FR;6;2021-12-04;0;0;0;0;0;0;0;0;0;0
FR;6;2021-12-05;0;0;0;0;0;0;0;0;0;0
FR;6;2021-12-06;0;0;0;0;0;0;0;0;0;0
FR;6;2021-12-07;0;0;0;0;0;0;0;0;0;0
FR;6;2021-12-08;0;0;0;0;0;0;0;0;0;0
FR;6;2021-12-09;0;0;0;0;0;0;0;0;0;0
FR;6;2021-12-10;0;0;0;0;0;0;0;0;0;0
FR;6;2021-12-11;0;0;0;0;0;0;0;0;0;0
FR;6;2021-12-12;0;0;0;0;0;0;0;0;0;0
FR;6;2021-12-13;0;0;0;0;0;0;0;0;0;0
FR;6;2021-12-14;0;0;0;0;0;0;0;0;0;0
FR;6;2021-12-15;0;0;0;0;0;0;0;0;0;0
FR;6;2021-12-16;0;0;0;0;0;0;0;0;0;0
FR;6;2021-12-17;0;0;0;0;0;0;0;0;0;0
FR;6;2021-12-18;0;0;0;0;0;0;0;0;0;0
FR;6;2021-12-19;0;0;0;0;0;0;0;0;0;0
FR;6;2021-12-20;0;0;0;0;0;0;0;0;0;0
FR;6;2021-12-21;0;0;0;0;0;0;0;0;0;0
FR;6;2021-12-22;0;0;0;0;0;0;0;0;0;0
FR;6;2021-12-23;0;0;0;0;0;0;0;0;0;0
FR;6;2021-12-24;0;0;0;0;0;0;0;0;0;0
FR;6;2021-12-25;0;0;0;0;0;0;0;0;0;0
FR;6;2021-12-26;0;0;0;0;0;0;0;0;0;0
FR;6;2021-12-27;0;0;0;0;0;0;0;0;0;0
FR;6;2021-12-28;0;0;0;0;0;0;0;0;0;0
FR;6;2021-12-29;0;0;0;0;0;0;0;0;0;0
FR;6;2021-12-30;0;0;0;0;0;0;0;0;0;0
FR;6;2021-12-31;0;0;0;0;0;0;0;0;0;0
FR;6;2022-01-01;0;0;0;0;0;0;0;0;0;0
FR;6;2022-01-02;0;0;0;0;0;0;0;0;0;0
FR;6;2022-01-03;0;0;0;0;0;0;0;0;0;0
FR;6;2022-01-04;0;0;0;0;0;0;0;0;0;0
FR;6;2022-01-05;0;0;0;0;0;0;0;0;0;0
FR;6;2022-01-06;0;0;0;0;0;0;0;0;0;0
FR;6;2022-01-07;0;0;0;0;0;0;0;0;0;0
FR;6;2022-01-08;0;0;0;0;0;0;0;0;0;0
FR;6;2022-01-09;0;0;0;0;0;0;0;0;0;0
FR;6;2022-01-10;0;0;0;0;0;0;0;0;0;0
FR;6;2022-01-11;0;0;0;0;0;0;0;0;0;0
FR;6;2022-01-12;0;0;0;0;0;0;0;0;0;0
FR;6;2022-01-13;0;0;0;0;0;0;0;0;0;0
FR;6;2022-01-14;0;0;0;0;0;0;0;0;0;0
FR;6;2022-01-15;0;0;0;0;0;0;0;0;0;0
FR;6;2022-01-16;0;0;0;0;0;0;0;0;0;0
FR;6;2022-01-17;0;0;0;0;0;0;0;0;0;0
FR;6;2022-01-18;0;0;0;0;0;0;0;0;0;0
FR;6;2022-01-19;0;0;0;0;0;0;0;0;0;0
FR;6;2022-01-20;0;0;0;0;0;0;0;0;0;0
FR;6;2022-01-21;0;0;0;0;0;0;0;0;0;0
FR;6;2022-01-22;0;0;0;0;0;0;0;0;0;0
FR;6;2022-01-23;0;0;0;0;0;0;0;0;0;0
FR;6;2022-01-24;0;0;0;0;0;0;0;0;0;0
FR;6;2022-01-25;0;0;0;0;0;0;0;0;0;0
FR;6;2022-01-26;0;0;0;0;0;0;0;0;0;0
FR;6;2022-01-27;0;0;0;0;0;0;0;0;0;0
FR;6;2022-01-28;0;0;0;0;0;0;0;0;0;0
FR;6;2022-01-29;0;0;0;0;0;0;0;0;0;0
FR;6;2022-01-30;0;0;0;0;0;0;0;0;0;0
FR;6;2022-01-31;0;0;0;0;0;0;0;0;0;0
FR;6;2022-02-01;0;0;0;0;0;0;0;0;0;0
FR;6;2022-02-02;0;0;0;0;0;0;0;0;0;0
FR;6;2022-02-03;0;0;0;0;0;0;0;0;0;0
FR;6;2022-02-04;0;0;0;0;0;0;0;0;0;0
FR;6;2022-02-05;0;0;0;0;0;0;0;0;0;0
FR;6;2022-02-06;0;0;0;0;0;0;0;0;0;0
FR;6;2022-02-07;0;0;0;0;0;0;0;0;0;0
FR;6;2022-02-08;0;0;0;0;0;0;0;0;0;0
FR;6;2022-02-09;0;0;0;0;0;0;0;0;0;0
FR;6;2022-02-10;0;0;0;0;0;0;0;0;0;0
FR;6;2022-02-11;0;0;0;0;0;0;0;0;0;0
FR;6;2022-02-12;0;0;0;0;0;0;0;0;0;0
FR;6;2022-02-13;0;0;0;0;0;0;0;0;0;0
FR;6;2022-02-14;0;0;0;0;0;0;0;0;0;0
FR;6;2022-02-15;0;0;0;0;0;0;0;0;0;0
FR;6;2022-02-16;0;0;0;0;0;0;0;0;0;0
FR;6;2022-02-17;0;0;0;0;0;0;0;0;0;0
FR;6;2022-02-18;0;0;0;0;0;0;0;0;0;0
FR;6;2022-02-19;0;0;0;0;0;0;0;0;0;0
FR;6;2022-02-20;0;0;0;0;0;0;0;0;0;0
FR;6;2022-02-21;0;0;0;0;0;0;0;0;0;0
FR;6;2022-02-22;0;0;0;0;0;0;0;0;0;0
FR;6;2022-02-23;0;0;0;0;0;0;0;0;0;0
FR;6;2022-02-24;0;0;0;0;0;0;0;0;0;0
FR;6;2022-02-25;0;0;0;0;0;0;0;0;0;0
FR;6;2022-02-26;0;0;0;0;0;0;0;0;0;0
FR;6;2022-02-27;0;0;0;0;0;0;0;0;0;0
FR;6;2022-02-28;0;0;0;0;0;0;0;0;0;0
FR;6;2022-03-01;0;0;0;0;0;0;0;0;0;0
FR;6;2022-03-02;96;9;2;0;7;96;9;2;0;7
FR;6;2022-03-03;0;0;0;0;0;96;9;2;0;7
FR;6;2022-03-04;91;4;0;0;4;187;13;2;0;11
FR;6;2022-03-05;391;23;2;0;14;578;36;4;0;25
FR;6;2022-03-06;7;1;0;0;0;585;37;4;0;25
FR;6;2022-03-07;337;19;0;0;13;922;56;4;0;38
FR;6;2022-03-08;230;14;0;0;5;1152;70;4;0;43
FR;6;2022-03-09;519;29;2;0;21;1671;99;6;0;64
FR;6;2022-03-10;206;18;0;1;12;1877;117;6;1;76
FR;6;2022-03-11;328;21;6;0;21;2205;138;12;1;97
FR;6;2022-03-12;518;25;1;0;20;2723;163;13;1;117
FR;6;2022-03-13;40;2;0;0;1;2763;165;13;1;118
FR;6;2022-03-14;201;4;2;0;3;2964;169;15;1;121
FR;6;2022-03-15;112;11;2;0;9;3076;180;17;1;130
FR;6;2022-03-16;310;16;1;1;14;3386;196;18;2;144
FR;6;2022-03-17;117;6;1;2;4;3503;202;19;4;148
FR;6;2022-03-18;213;11;0;0;6;3716;213;19;4;154
FR;6;2022-03-19;303;20;2;0;10;4019;233;21;4;164
FR;6;2022-03-20;15;5;0;0;1;4034;238;21;4;165
FR;6;2022-03-21;130;23;1;0;4;4164;261;22;4;169
FR;6;2022-03-22;97;8;0;0;2;4261;269;22;4;171
FR;6;2022-03-23;225;108;3;0;14;4486;377;25;4;185
FR;6;2022-03-24;99;14;1;3;4;4585;391;26;7;189
FR;6;2022-03-25;203;141;2;1;15;4788;532;28;8;204
FR;6;2022-03-26;331;296;7;1;19;5119;828;35;9;223
FR;6;2022-03-27;32;30;1;0;1;5151;858;36;9;224
FR;6;2022-03-28;200;207;8;1;17;5351;1065;44;10;241
FR;6;2022-03-29;126;188;12;2;12;5477;1253;56;12;253
FR;6;2022-03-30;303;475;9;2;21;5780;1728;65;14;274
FR;6;2022-03-31;122;139;9;0;12;5902;1867;74;14;286
FR;6;2022-04-01;193;150;10;2;23;6095;2017;84;16;309
FR;6;2022-04-02;205;240;9;1;13;6300;2257;93;17;322
FR;6;2022-04-03;17;21;0;0;1;6317;2278;93;17;323
FR;6;2022-04-04;127;113;5;1;9;6444;2391;98;18;332
FR;6;2022-04-05;141;88;14;1;10;6585;2479;112;19;342
FR;0;2020-12-27;597;0;0;0;0;597;0;0;0;0
FR;0;2020-12-28;651;0;0;0;0;1248;0;0;0;0
FR;0;2020-12-29;369;0;0;0;0;1617;0;0;0;0
FR;0;2020-12-30;433;0;0;0;0;2050;0;0;0;0
FR;0;2020-12-31;370;0;0;0;0;2420;0;0;0;0
FR;0;2021-01-01;1110;0;0;0;0;3530;0;0;0;0
FR;0;2021-01-02;348;1;0;0;0;3878;1;0;0;0
FR;0;2021-01-03;397;0;0;0;0;4275;1;0;0;0
FR;0;2021-01-04;2074;0;0;0;0;6349;1;0;0;0
FR;0;2021-01-05;6945;2;0;0;0;13294;3;0;0;0
FR;0;2021-01-06;12299;6;0;0;0;25593;9;0;0;0
FR;0;2021-01-07;29434;7;0;0;0;55027;16;0;0;0
FR;0;2021-01-08;37107;3;0;0;0;92134;19;0;0;0
FR;0;2021-01-09;11206;2;0;0;0;103340;21;0;0;0
FR;0;2021-01-10;5988;0;0;0;0;109328;21;0;0;0
FR;0;2021-01-11;39915;8;0;0;0;149243;29;0;0;0
FR;0;2021-01-12;62103;7;0;0;0;211346;36;0;0;0
FR;0;2021-01-13;65054;16;0;0;0;276400;52;0;0;0
FR;0;2021-01-14;83123;29;0;0;0;359523;81;0;0;0
FR;0;2021-01-15;68968;10;0;0;0;428491;91;0;0;0
FR;0;2021-01-16;20203;75;0;0;0;448694;166;0;0;0
FR;0;2021-01-17;10975;45;0;0;0;459669;211;0;0;0
FR;0;2021-01-18;85809;169;0;0;0;545478;380;0;0;0
FR;0;2021-01-19;130555;145;0;0;0;676033;525;0;0;0
FR;0;2021-01-20;137491;170;0;0;0;813524;695;0;0;0
FR;0;2021-01-21;158348;148;0;0;0;971872;843;0;0;0
FR;0;2021-01-22;121021;176;0;0;0;1092893;1019;0;0;0
FR;0;2021-01-23;38455;57;0;0;0;1131348;1076;0;0;0
FR;0;2021-01-24;9737;52;0;0;0;1141085;1128;0;0;0
FR;0;2021-01-25;78203;1235;0;0;0;1219288;2363;0;0;0
FR;0;2021-01-26;100334;3164;1;0;0;1319622;5527;1;0;0
FR;0;2021-01-27;107208;5726;0;0;0;1426830;11253;1;0;0
FR;0;2021-01-28;124309;14480;0;0;0;1551139;25733;1;0;0
FR;0;2021-01-29;92147;17397;0;0;0;1643286;43130;1;0;0
FR;0;2021-01-30;29100;4226;0;0;0;1672386;47356;1;0;0
FR;0;2021-01-31;5220;1717;0;0;0;1677606;49073;1;0;0
FR;0;2021-02-01;53087;21158;0;0;0;1730693;70231;1;0;0
FR;0;2021-02-02;72264;34820;0;0;0;1802957;105051;1;0;0
FR;0;2021-02-03;72255;37156;0;0;0;1875212;142207;1;0;0
FR;0;2021-02-04;82019;50246;0;0;0;1957231;192453;1;0;0
FR;0;2021-02-05;68206;45471;0;0;0;2025437;237924;1;0;0
FR;0;2021-02-06;23134;10566;0;0;0;2048571;248490;1;0;0
FR;0;2021-02-07;5173;5064;0;0;0;2053744;253554;1;0;0
FR;0;2021-02-08;46804;46204;0;0;0;2100548;299758;1;0;0
FR;0;2021-02-09;65978;72686;0;0;0;2166526;372444;1;0;0
FR;0;2021-02-10;70958;77020;0;0;0;2237484;449464;1;0;0
FR;0;2021-02-11;87213;99183;0;0;0;2324697;548647;1;0;0
FR;0;2021-02-12;79267;74360;0;0;0;2403964;623007;1;0;0
FR;0;2021-02-13;22340;19587;0;0;0;2426304;642594;1;0;0
FR;0;2021-02-14;5061;7240;0;0;0;2431365;649834;1;0;0
FR;0;2021-02-15;38051;76692;0;0;0;2469416;726526;1;0;0
FR;0;2021-02-16;50349;100608;0;0;0;2519765;827134;1;0;0
FR;0;2021-02-17;50475;103274;1;0;0;2570240;930408;2;0;0
FR;0;2021-02-18;69724;118761;0;0;0;2639964;1049169;2;0;0
FR;0;2021-02-19;65030;90815;1;0;0;2704994;1139984;3;0;0
FR;0;2021-02-20;18567;28492;0;0;0;2723561;1168476;3;0;0
FR;0;2021-02-21;3305;6399;0;0;0;2726866;1174875;3;0;0
FR;0;2021-02-22;37466;73238;2;0;0;2764332;1248113;5;0;0
FR;0;2021-02-23;53751;84198;1;0;0;2818083;1332311;6;0;0
FR;0;2021-02-24;59957;81227;1;0;0;2878040;1413538;7;0;0
FR;0;2021-02-25;100529;91241;1;0;0;2978569;1504779;8;0;0
FR;0;2021-02-26;113408;70955;0;0;0;3091977;1575734;8;0;0
FR;0;2021-02-27;52087;22033;0;0;0;3144064;1597767;8;0;0
FR;0;2021-02-28;6190;4426;1;0;0;3150254;1602193;9;0;0
FR;0;2021-03-01;65798;52949;1;0;0;3216052;1655142;10;0;0
FR;0;2021-03-02;101315;66297;2;0;0;3317367;1721439;12;0;0
FR;0;2021-03-03;116425;65443;0;0;0;3433792;1786882;12;0;0
FR;0;2021-03-04;163555;69171;3;0;0;3597347;1856053;15;0;0
FR;0;2021-03-05;200861;63172;3;0;0;3798208;1919225;18;0;0
FR;0;2021-03-06;207910;17790;3;0;0;4006118;1937015;21;0;0
FR;0;2021-03-07;121241;5367;1;0;0;4127359;1942382;22;0;0
FR;0;2021-03-08;107098;50702;2;0;0;4234457;1993084;24;0;0
FR;0;2021-03-09;172382;56672;2;0;0;4406839;2049756;26;0;0
FR;0;2021-03-10;178893;57146;5;0;0;4585732;2106902;31;0;0
FR;0;2021-03-11;242772;63117;2;0;0;4828504;2170019;33;0;0
FR;0;2021-03-12;294749;53405;0;0;0;5123253;2223424;33;0;0
FR;0;2021-03-13;231352;15301;1;0;0;5354605;2238725;34;0;0
FR;0;2021-03-14;63328;3413;1;0;0;5417933;2242138;35;0;0
FR;0;2021-03-15;158576;32572;3;0;0;5576509;2274710;38;0;0
FR;0;2021-03-16;141516;39475;5;0;0;5718025;2314185;43;0;0
FR;0;2021-03-17;150401;38623;4;0;0;5868426;2352808;47;0;0
FR;0;2021-03-18;167747;44619;5;0;0;6036173;2397427;52;0;0
FR;0;2021-03-19;229934;37357;2;0;0;6266107;2434784;54;0;0
FR;0;2021-03-20;166628;11711;1;0;0;6432735;2446495;55;0;0
FR;0;2021-03-21;49903;2595;1;0;0;6482638;2449090;56;0;0
FR;0;2021-03-22;169945;34205;2;0;0;6652583;2483295;58;0;0
FR;0;2021-03-23;250290;42432;1;0;0;6902873;2525727;59;0;0
FR;0;2021-03-24;256819;43816;0;0;0;7159692;2569543;59;0;0
FR;0;2021-03-25;341725;44714;5;0;0;7501417;2614257;64;0;0
FR;0;2021-03-26;358727;41836;4;0;0;7860144;2656093;68;0;0
FR;0;2021-03-27;195222;16663;1;0;0;8055366;2672756;69;0;0
FR;0;2021-03-28;59310;3866;3;0;0;8114676;2676622;72;0;0
FR;0;2021-03-29;202909;54177;4;0;0;8317585;2730799;76;0;0
FR;0;2021-03-30;285363;69609;4;0;0;8602948;2800408;80;0;0
FR;0;2021-03-31;262929;72939;4;0;0;8865877;2873347;84;0;0
FR;0;2021-04-01;315316;88147;12;0;0;9181193;2961494;96;0;0
FR;0;2021-04-02;281249;92218;7;0;0;9462442;3053712;103;0;0
FR;0;2021-04-03;141030;61816;5;0;0;9603472;3115528;108;0;0
FR;0;2021-04-04;46310;18681;2;0;0;9649782;3134209;110;0;0
FR;0;2021-04-05;63278;10951;11;0;0;9713060;3145160;121;0;0
FR;0;2021-04-06;217084;108150;16;0;0;9930144;3253310;137;0;0
FR;0;2021-04-07;260149;115306;17;0;0;10190293;3368616;154;0;0
FR;0;2021-04-08;337669;121329;14;0;0;10527962;3489945;168;0;0
FR;0;2021-04-09;410047;116351;49;0;0;10938009;3606296;217;0;0
FR;0;2021-04-10;212560;82642;15;0;0;11150569;3688938;232;0;0
FR;0;2021-04-11;56050;34527;7;0;0;11206619;3723465;239;0;0
FR;0;2021-04-12;236902;115105;45;0;0;11443521;3838570;284;0;0
FR;0;2021-04-13;309362;144699;97;1;0;11752883;3983269;381;1;0
FR;0;2021-04-14;294379;139233;211;0;0;12047262;4122502;592;1;0
FR;0;2021-04-15;336962;147838;337;0;0;12384224;4270340;929;1;0
FR;0;2021-04-16;339186;145608;352;0;0;12723410;4415948;1281;1;0
FR;0;2021-04-17;188610;90139;108;0;0;12912020;4506087;1389;1;0
FR;0;2021-04-18;51563;35420;45;0;0;12963583;4541507;1434;1;0
FR;0;2021-04-19;205596;138221;453;0;0;13169179;4679728;1887;1;0
FR;0;2021-04-20;254291;170532;568;0;0;13423470;4850260;2455;1;0
FR;0;2021-04-21;253108;168755;830;0;0;13676578;5019015;3285;1;0
FR;0;2021-04-22;287361;188247;818;0;0;13963939;5207262;4103;1;0
FR;0;2021-04-23;297967;183124;743;0;0;14261906;5390386;4846;1;0
FR;0;2021-04-24;190404;111487;247;0;0;14452310;5501873;5093;1;0
FR;0;2021-04-25;69461;38834;51;0;0;14521771;5540707;5144;1;0
FR;0;2021-04-26;220849;155978;559;0;0;14742620;5696685;5703;1;0
FR;0;2021-04-27;284500;187295;939;0;0;15027120;5883980;6642;1;0
FR;0;2021-04-28;299391;183040;1420;1;1;15326511;6067020;8062;2;1
FR;0;2021-04-29;357012;196045;1275;0;0;15683523;6263065;9337;2;1
FR;0;2021-04-30;372106;184625;1119;1;0;16055629;6447690;10456;3;1
FR;0;2021-05-01;167541;52519;178;0;0;16223170;6500209;10634;3;1
FR;0;2021-05-02;91632;37786;82;0;0;16314802;6537995;10716;3;1
FR;0;2021-05-03;288762;169295;837;0;0;16603564;6707290;11553;3;1
FR;0;2021-05-04;315510;224218;1230;0;0;16919074;6931508;12783;3;1
FR;0;2021-05-05;327006;224407;1311;0;0;17246080;7155915;14094;3;1
FR;0;2021-05-06;379346;239020;1625;0;0;17625426;7394935;15719;3;1
FR;0;2021-05-07;372617;257095;1222;0;0;17998043;7652030;16941;3;1
FR;0;2021-05-08;222103;66895;297;0;0;18220146;7718925;17238;3;1
FR;0;2021-05-09;129646;46620;243;0;0;18349792;7765545;17481;3;1
FR;0;2021-05-10;313167;228714;1227;0;0;18662959;7994259;18708;3;1
FR;0;2021-05-11;403745;257861;1562;0;0;19066704;8252120;20270;3;1
FR;0;2021-05-12;433944;233020;1540;0;0;19500648;8485140;21810;3;1
FR;0;2021-05-13;338485;56971;429;0;0;19839133;8542111;22239;3;1
FR;0;2021-05-14;453999;167231;1117;0;0;20293132;8709342;23356;3;1
FR;0;2021-05-15;374786;93951;442;0;0;20667918;8803293;23798;3;1
FR;0;2021-05-16;202676;20773;168;0;0;20870594;8824066;23966;3;1
FR;0;2021-05-17;375967;148934;1547;0;0;21246561;8973000;25513;3;1
FR;0;2021-05-18;459816;152987;1985;0;0;21706377;9125987;27498;3;1
FR;0;2021-05-19;467253;145043;2448;0;0;22173630;9271030;29946;3;1
FR;0;2021-05-20;507331;160161;2327;0;0;22680961;9431191;32273;3;1
FR;0;2021-05-21;489509;174359;1984;0;0;23170470;9605550;34257;3;1
FR;0;2021-05-22;347104;79786;667;0;0;23517574;9685336;34924;3;1
FR;0;2021-05-23;161618;14413;246;0;0;23679192;9699749;35170;3;1
FR;0;2021-05-24;263103;33208;597;0;0;23942295;9732957;35767;3;1
FR;0;2021-05-25;400028;189059;2343;1;0;24342323;9922016;38110;4;1
FR;0;2021-05-26;413313;188094;2213;0;0;24755636;10110110;40323;4;1
FR;0;2021-05-27;449652;218450;2152;0;0;25205288;10328560;42475;4;1
FR;0;2021-05-28;429407;259339;1887;0;0;25634695;10587899;44362;4;1
FR;0;2021-05-29;298919;149291;582;0;0;25933614;10737190;44944;4;1
FR;0;2021-05-30;107060;32577;162;0;0;26040674;10769767;45106;4;1
FR;0;2021-05-31;357868;203508;1465;1;1;26398542;10973275;46571;5;2
FR;0;2021-06-01;430470;251376;1952;1;1;26829012;11224651;48523;6;3
FR;0;2021-06-02;418843;230716;1973;0;0;27247855;11455367;50496;6;3
FR;0;2021-06-03;463987;258467;1815;0;0;27711842;11713834;52311;6;3
FR;0;2021-06-04;455392;304690;1725;1;1;28167234;12018524;54036;7;4
FR;0;2021-06-05;304698;188942;651;0;0;28471932;12207466;54687;7;4
FR;0;2021-06-06;133202;49123;226;0;0;28605134;12256589;54913;7;4
FR;0;2021-06-07;338530;262102;1514;0;0;28943664;12518691;56427;7;4
FR;0;2021-06-08;393473;290944;1791;0;0;29337137;12809635;58218;7;4
FR;0;2021-06-09;384536;275620;1720;0;0;29721673;13085255;59938;7;4
FR;0;2021-06-10;403845;289101;1717;1;0;30125518;13374356;61655;8;4
FR;0;2021-06-11;386373;357264;1455;0;0;30511891;13731620;63110;8;4
FR;0;2021-06-12;283155;211269;489;0;0;30795046;13942889;63599;8;4
FR;0;2021-06-13;104809;74003;204;0;0;30899855;14016892;63803;8;4
FR;0;2021-06-14;240615;355808;1422;1;0;31140470;14372700;65225;9;4
FR;0;2021-06-15;307873;385746;1560;1;0;31448343;14758446;66785;10;4
FR;0;2021-06-16;313758;357766;1413;1;0;31762101;15116212;68198;11;4
FR;0;2021-06-17;317471;372183;1420;1;0;32079572;15488395;69618;12;4
FR;0;2021-06-18;321499;442343;1329;1;0;32401071;15930738;70947;13;4
FR;0;2021-06-19;224288;273735;446;0;0;32625359;16204473;71393;13;4
FR;0;2021-06-20;74344;102585;127;0;0;32699703;16307058;71520;13;4
FR;0;2021-06-21;195527;401945;1028;1;1;32895230;16709003;72548;14;5
FR;0;2021-06-22;222957;467331;1257;10;2;33118187;17176334;73805;24;7
FR;0;2021-06-23;233805;439840;1193;1;1;33351992;17616174;74998;25;8
FR;0;2021-06-24;241671;409453;1343;0;0;33593663;18025627;76341;25;8
FR;0;2021-06-25;227396;522091;1398;0;0;33821059;18547718;77739;25;8
FR;0;2021-06-26;153140;370668;584;1;0;33974199;18918386;78323;26;8
FR;0;2021-06-27;55846;156286;166;1;0;34030045;19074672;78489;27;8
FR;0;2021-06-28;154563;453029;1163;0;0;34184608;19527701;79652;27;8
FR;0;2021-06-29;182497;506552;2122;0;0;34367105;20034253;81774;27;8
FR;0;2021-06-30;203766;481496;2007;21;2;34570871;20515749;83781;48;10
FR;0;2021-07-01;230894;457738;2221;5;1;34801765;20973487;86002;53;11
FR;0;2021-07-02;227867;520196;2118;5;3;35029632;21493683;88120;58;14
FR;0;2021-07-03;141868;368729;909;3;1;35171500;21862412;89029;61;15
FR;0;2021-07-04;56677;141275;265;0;0;35228177;22003687;89294;61;15
FR;0;2021-07-05;168061;419372;1667;8;2;35396238;22423059;90961;69;17
FR;0;2021-07-06;196420;474820;1823;44;8;35592658;22897879;92784;113;25
FR;0;2021-07-07;212734;439308;1873;24;5;35805392;23337187;94657;137;30
FR;0;2021-07-08;231290;424147;2088;20;8;36036682;23761334;96745;157;38
FR;0;2021-07-09;228240;510286;2182;4;2;36264922;24271620;98927;161;40
FR;0;2021-07-10;148479;339838;982;1;1;36413401;24611458;99909;162;41
FR;0;2021-07-11;60111;110132;281;0;0;36473512;24721590;100190;162;41
FR;0;2021-07-12;168895;478194;1750;4;0;36642407;25199784;101940;166;41
FR;0;2021-07-13;286985;527480;2043;8;2;36929392;25727264;103983;174;43
FR;0;2021-07-14;180780;157799;432;0;0;37110172;25885063;104415;174;43
FR;0;2021-07-15;346728;502535;2097;1;0;37456900;26387598;106512;175;43
FR;0;2021-07-16;379765;496015;2020;3;1;37836665;26883613;108532;178;44
FR;0;2021-07-17;259603;319826;876;1;0;38096268;27203439;109408;179;44
FR;0;2021-07-18;109647;114833;310;0;0;38205915;27318272;109718;179;44
FR;0;2021-07-19;285242;425317;1626;3;0;38491157;27743589;111344;182;44
FR;0;2021-07-20;376655;452656;1721;0;0;38867812;28196245;113065;182;44
FR;0;2021-07-21;395538;408117;1549;4;2;39263350;28604362;114614;186;46
FR;0;2021-07-22;440698;388420;1712;4;2;39704048;28992782;116326;190;48
FR;0;2021-07-23;438537;423387;1876;4;2;40142585;29416169;118202;194;50
FR;0;2021-07-24;285144;269690;802;1;0;40427729;29685859;119004;195;50
FR;0;2021-07-25;121018;80083;225;0;0;40548747;29765942;119229;195;50
FR;0;2021-07-26;347192;323482;1614;3;2;40895939;30089424;120843;198;52
FR;0;2021-07-27;463806;320522;1696;4;2;41359745;30409946;122539;202;54
FR;0;2021-07-28;459228;290197;1635;4;2;41818973;30700143;124174;206;56
FR;0;2021-07-29;489574;277094;1793;2;1;42308547;30977237;125967;208;57
FR;0;2021-07-30;461502;303041;1935;5;2;42770049;31280278;127902;213;59
FR;0;2021-07-31;285294;185057;913;1;0;43055343;31465335;128815;214;59
FR;0;2021-08-01;111897;50009;252;0;0;43167240;31515344;129067;214;59
FR;0;2021-08-02;341019;234714;1596;2;0;43508259;31750058;130663;216;59
FR;0;2021-08-03;398244;245240;1715;2;1;43906503;31995298;132378;218;60
FR;0;2021-08-04;384435;210229;1589;5;3;44290938;32205527;133967;223;63
FR;0;2021-08-05;365822;228961;1705;0;0;44656760;32434488;135672;223;63
FR;0;2021-08-06;359396;271870;1833;4;1;45016156;32706358;137505;227;64
FR;0;2021-08-07;212966;178373;755;4;3;45229122;32884731;138260;231;67
FR;0;2021-08-08;74097;63259;269;0;0;45303219;32947990;138529;231;67
FR;0;2021-08-09;258480;259779;1538;4;3;45561699;33207769;140067;235;70
FR;0;2021-08-10;306469;278415;1652;2;1;45868168;33486184;141719;237;71
FR;0;2021-08-11;279403;260480;1435;5;1;46147571;33746664;143154;242;72
FR;0;2021-08-12;271199;278715;1657;3;1;46418770;34025379;144811;245;73
FR;0;2021-08-13;251937;277842;1586;3;2;46670707;34303221;146397;248;75
FR;0;2021-08-14;145240;197375;739;0;0;46815947;34500596;147136;248;75
FR;0;2021-08-15;39249;50109;212;1;0;46855196;34550705;147348;249;75
FR;0;2021-08-16;185881;318258;1538;0;0;47041077;34868963;148886;249;75
FR;0;2021-08-17;215483;336782;1632;6;1;47256560;35205745;150518;255;76
FR;0;2021-08-18;198792;324989;1586;7;4;47455352;35530734;152104;262;80
FR;0;2021-08-19;191775;325668;1630;1;0;47647127;35856402;153734;263;80
FR;0;2021-08-20;186180;365722;1804;3;2;47833307;36222124;155538;266;82
FR;0;2021-08-21;104702;238162;700;0;0;47938009;36460286;156238;266;82
FR;0;2021-08-22;31865;87205;252;1;1;47969874;36547491;156490;267;83
FR;0;2021-08-23;140827;357345;1555;3;2;48110701;36904836;158045;270;85
FR;0;2021-08-24;162332;376960;1837;5;1;48273033;37281796;159882;275;86
FR;0;2021-08-25;150960;350911;2025;8;3;48423993;37632707;161907;283;89
FR;0;2021-08-26;142670;342839;2551;10;1;48566663;37975546;164458;293;90
FR;0;2021-08-27;148233;387729;2787;11;4;48714896;38363275;167245;304;94
FR;0;2021-08-28;90553;249510;1405;0;0;48805449;38612785;168650;304;94
FR;0;2021-08-29;27289;83305;511;1;0;48832738;38696090;169161;305;94
FR;0;2021-08-30;117276;324921;4706;6;6076;48950014;39021011;173867;311;6170
FR;0;2021-08-31;128626;334732;10155;18;11905;49078640;39355743;184022;329;18075
FR;0;2021-09-01;135082;285615;22395;7;24220;49213722;39641358;206417;336;42295
FR;0;2021-09-02;112166;247311;26499;13;28813;49325888;39888669;232916;349;71108
FR;0;2021-09-03;117930;292765;29939;24;32916;49443818;40181434;262855;373;104024
FR;0;2021-09-04;89699;217694;12581;12;14023;49533517;40399128;275436;385;118047
FR;0;2021-09-05;21318;44886;4385;2;4727;49554835;40444014;279821;387;122774
FR;0;2021-09-06;75146;180889;31933;16;34151;49629981;40624903;311754;403;156925
FR;0;2021-09-07;79456;181292;33227;40;36033;49709437;40806195;344981;443;192958
FR;0;2021-09-08;88725;206132;29638;27;32316;49798162;41012327;374619;470;225274
FR;0;2021-09-09;75777;165311;33019;26;36391;49873939;41177638;407638;496;261665
FR;0;2021-09-10;95049;203606;35696;25;40379;49968988;41381244;443334;521;302044
FR;0;2021-09-11;66290;169171;12121;18;14198;50035278;41550415;455455;539;316242
FR;0;2021-09-12;12733;32097;2762;2;3148;50048011;41582512;458217;541;319390
FR;0;2021-09-13;64297;126415;41179;32;43807;50112308;41708927;499396;573;363197
FR;0;2021-09-14;73204;129183;56308;78;61716;50185512;41838110;555704;651;424913
FR;0;2021-09-15;76253;167811;55590;59;54695;50261765;42005921;611294;710;479608
FR;0;2021-09-16;63626;114515;59995;86;59928;50325391;42120436;671289;796;539536
FR;0;2021-09-17;74861;156821;53782;70;57152;50400252;42277257;725071;866;596688
FR;0;2021-09-18;48135;139554;15588;25;17270;50448387;42416811;740659;891;613958
FR;0;2021-09-19;7841;23725;2428;1;2619;50456228;42440536;743087;892;616577
FR;0;2021-09-20;44371;93918;49981;73;50161;50500599;42534454;793068;965;666738
FR;0;2021-09-21;45735;98459;62667;76;63234;50546334;42632913;855735;1041;729972
FR;0;2021-09-22;48504;142186;55281;84;55232;50594838;42775099;911016;1125;785204
FR;0;2021-09-23;43069;91850;62305;95;63299;50637907;42866949;973321;1220;848503
FR;0;2021-09-24;52098;133003;54487;110;59010;50690005;42999952;1027808;1330;907513
FR;0;2021-09-25;35132;115402;16256;37;18230;50725137;43115354;1044064;1367;925743
FR;0;2021-09-26;5511;17837;2261;4;2343;50730648;43133191;1046325;1371;928086
FR;0;2021-09-27;33882;76982;47149;96;48085;50764530;43210173;1093474;1467;976171
FR;0;2021-09-28;36403;75240;54875;88;56346;50800933;43285413;1148349;1555;1032517
FR;0;2021-09-29;44275;100806;53283;111;54736;50845208;43386219;1201632;1666;1087253
FR;0;2021-09-30;36144;72404;56949;96;59368;50881352;43458623;1258581;1762;1146621
FR;0;2021-10-01;61053;100530;57747;108;63630;50942405;43559153;1316328;1870;1210251
FR;0;2021-10-02;39296;78244;20938;38;23289;50981701;43637397;1337266;1908;1233540
FR;0;2021-10-03;5236;10586;2518;4;2558;50986937;43647983;1339784;1912;1236098
FR;0;2021-10-04;34719;58488;52579;83;54748;51021656;43706471;1392363;1995;1290846
FR;0;2021-10-05;33166;64292;60927;135;64836;51054822;43770763;1453290;2130;1355682
FR;0;2021-10-06;42155;79095;65637;113;68128;51096977;43849858;1518927;2243;1423810
FR;0;2021-10-07;30247;62020;65341;90;68612;51127224;43911878;1584268;2333;1492422
FR;0;2021-10-08;48410;91702;77680;110;84529;51175634;44003580;1661948;2443;1576951
FR;0;2021-10-09;33507;60818;31502;35;33835;51209141;44064398;1693450;2478;1610786
FR;0;2021-10-10;4550;7370;3180;9;3474;51213691;44071768;1696630;2487;1614260
FR;0;2021-10-11;30400;49903;60999;105;63992;51244091;44121671;1757629;2592;1678252
FR;0;2021-10-12;31159;54420;70534;139;75747;51275250;44176091;1828163;2731;1753999
FR;0;2021-10-13;39842;62694;74379;135;79201;51315092;44238785;1902542;2866;1833200
FR;0;2021-10-14;30148;52746;68696;116;73672;51345240;44291531;1971238;2982;1906872
FR;0;2021-10-15;44599;75083;93186;191;102860;51389839;44366614;2064424;3173;2009732
FR;0;2021-10-16;31183;44054;36669;45;39588;51421022;44410668;2101093;3218;2049320
FR;0;2021-10-17;3808;5258;3586;2;3689;51424830;44415926;2104679;3220;2053009
FR;0;2021-10-18;27237;42103;67446;133;71310;51452067;44458029;2172125;3353;2124319
FR;0;2021-10-19;26861;43082;76355;141;81577;51478928;44501111;2248480;3494;2205896
FR;0;2021-10-20;35105;52274;96870;179;101379;51514033;44553385;2345350;3673;2307275
FR;0;2021-10-21;25760;45145;83882;112;89059;51539793;44598530;2429232;3785;2396334
FR;0;2021-10-22;38135;62123;104826;199;112408;51577928;44660653;2534058;3984;2508742
FR;0;2021-10-23;26892;41157;45418;57;48580;51604820;44701810;2579476;4041;2557322
FR;0;2021-10-24;2902;4782;3676;6;3939;51607722;44706592;2583152;4047;2561261
FR;0;2021-10-25;25932;36275;82273;144;86565;51633654;44742867;2665425;4191;2647826
FR;0;2021-10-26;23627;34958;87174;166;92245;51657281;44777825;2752599;4357;2740071
FR;0;2021-10-27;29954;46399;108931;257;114572;51687235;44824224;2861530;4614;2854643
FR;0;2021-10-28;23277;34783;88629;153;94310;51710512;44859007;2950159;4767;2948953
FR;0;2021-10-29;31448;51018;117254;205;125176;51741960;44910025;3067413;4972;3074129
FR;0;2021-10-30;20388;33058;50303;77;53337;51762348;44943083;3117716;5049;3127466
FR;0;2021-10-31;2470;3790;3581;3;3870;51764818;44946873;3121297;5052;3131336
FR;0;2021-11-01;7964;4735;3189;3;3544;51772782;44951608;3124486;5055;3134880
FR;0;2021-11-02;24988;39994;93500;157;99408;51797770;44991602;3217986;5212;3234288
FR;0;2021-11-03;29511;47723;118803;218;125710;51827281;45039325;3336789;5430;3359998
FR;0;2021-11-04;23541;37436;107455;216;114271;51850822;45076761;3444244;5646;3474269
FR;0;2021-11-05;32140;52708;141546;233;151177;51882962;45129469;3585790;5879;3625446
FR;0;2021-11-06;21375;34505;64820;123;68179;51904337;45163974;3650610;6002;3693625
FR;0;2021-11-07;2360;4267;5162;6;5588;51906697;45168241;3655772;6008;3699213
FR;0;2021-11-08;20146;37801;127087;227;134101;51926843;45206042;3782859;6235;3833314
FR;0;2021-11-09;21988;44773;161577;342;172035;51948831;45250815;3944436;6577;4005349
FR;0;2021-11-10;31162;54750;186890;446;198564;51979993;45305565;4131326;7023;4203913
FR;0;2021-11-11;3934;6410;12899;28;13887;51983927;45311975;4144225;7051;4217800
FR;0;2021-11-12;28904;55128;183676;249;197197;52012831;45367103;4327901;7300;4414997
FR;0;2021-11-13;20215;32668;80655;118;86261;52033046;45399771;4408556;7418;4501258
FR;0;2021-11-14;2301;3992;7156;6;7879;52035347;45403763;4415712;7424;4509137
FR;0;2021-11-15;20160;38793;160715;312;171377;52055507;45442556;4576427;7736;4680514
FR;0;2021-11-16;23155;43945;200255;391;214758;52078662;45486501;4776682;8127;4895272
FR;0;2021-11-17;30202;50426;199742;407;212731;52108864;45536927;4976424;8534;5108003
FR;0;2021-11-18;23211;43896;191537;468;205327;52132075;45580823;5167961;9002;5313330
FR;0;2021-11-19;33488;61347;243074;548;261975;52165563;45642170;5411035;9550;5575305
FR;0;2021-11-20;25240;36683;102091;205;109624;52190803;45678853;5513126;9755;5684929
FR;0;2021-11-21;2613;4601;9631;18;10656;52193416;45683454;5522757;9773;5695585
FR;0;2021-11-22;22671;33250;180247;470;194694;52216087;45716704;5703004;10243;5890279
FR;0;2021-11-23;25421;45566;229238;547;247582;52241508;45762270;5932242;10790;6137861
FR;0;2021-11-24;31679;53722;224702;717;243061;52273187;45815992;6156944;11507;6380922
FR;0;2021-11-25;25294;48962;255772;740;277521;52298481;45864954;6412716;12247;6658443
FR;0;2021-11-26;33077;74666;379314;865;414470;52331558;45939620;6792030;13112;7072913
FR;0;2021-11-27;23179;49504;214816;390;236521;52354737;45989124;7006846;13502;7309434
FR;0;2021-11-28;3471;10603;56714;66;63341;52358208;45999727;7063560;13568;7372775
FR;0;2021-11-29;19303;54186;341331;864;371464;52377511;46053913;7404891;14432;7744239
FR;0;2021-11-30;24428;71990;457231;984;500572;52401939;46125903;7862122;15416;8244811
FR;0;2021-12-01;26111;75807;468911;1158;511082;52428050;46201710;8331033;16574;8755893
FR;0;2021-12-02;21803;71618;526939;1276;574617;52449853;46273328;8857972;17850;9330510
FR;0;2021-12-03;25340;92380;596187;1415;650859;52475193;46365708;9454159;19265;9981369
FR;0;2021-12-04;18252;60455;336126;690;369626;52493445;46426163;9790285;19955;10350995
FR;0;2021-12-05;4137;16297;95735;156;107062;52497582;46442460;9886020;20111;10458057
FR;0;2021-12-06;19337;73138;492968;1171;539755;52516919;46515598;10378988;21282;10997812
FR;0;2021-12-07;23215;91681;645175;1769;706013;52540134;46607279;11024163;23051;11703825
FR;0;2021-12-08;25225;92082;591383;1871;647264;52565359;46699361;11615546;24922;12351089
FR;0;2021-12-09;23897;94154;662861;2180;726069;52589256;46793515;12278407;27102;13077158
FR;0;2021-12-10;27110;111014;735831;2072;805873;52616366;46904529;13014238;29174;13883031
FR;0;2021-12-11;20198;75956;435086;984;480276;52636564;46980485;13449324;30158;14363307
FR;0;2021-12-12;5609;23235;142235;262;159212;52642173;47003720;13591559;30420;14522519
FR;0;2021-12-13;20985;91165;587438;1699;649102;52663158;47094885;14178997;32119;15171621
FR;0;2021-12-14;27063;118481;765295;2648;847271;52690221;47213366;14944292;34767;16018892
FR;0;2021-12-15;28044;114231;694098;2262;768790;52718265;47327597;15638390;37029;16787682
FR;0;2021-12-16;27822;115965;763780;2556;844205;52746087;47443562;16402170;39585;17631887
FR;0;2021-12-17;31417;128693;807647;2709;891859;52777504;47572255;17209817;42294;18523746
FR;0;2021-12-18;24897;81667;469871;1178;522128;52802401;47653922;17679688;43472;19045874
FR;0;2021-12-19;8739;28907;169334;378;191179;52811140;47682829;17849022;43850;19237053
FR;0;2021-12-20;31536;97423;591257;1788;658541;52842676;47780252;18440279;45638;19895594
FR;0;2021-12-21;39154;112198;682220;2392;759372;52881830;47892450;19122499;48030;20654966
FR;0;2021-12-22;39409;99452;575572;2166;641971;52921239;47991902;19698071;50196;21296937
FR;0;2021-12-23;33662;79652;440822;1649;494269;52954901;48071554;20138893;51845;21791206
FR;0;2021-12-24;10613;26047;110955;396;126640;52965514;48097601;20249848;52241;21917846
FR;0;2021-12-25;762;3494;7569;25;9042;52966276;48101095;20257417;52266;21926888
FR;0;2021-12-26;4695;11903;52062;139;60132;52970971;48112998;20309479;52405;21987020
FR;0;2021-12-27;30243;83768;453393;1365;509013;53001214;48196766;20762872;53770;22496033
FR;0;2021-12-28;38252;98877;564020;1766;632096;53039466;48295643;21326892;55536;23128129
FR;0;2021-12-29;39798;88363;501056;1686;560887;53079264;48384006;21827948;57222;23689016
FR;0;2021-12-30;35830;74840;420906;1519;471052;53115094;48458846;22248854;58741;24160068
FR;0;2021-12-31;11830;25127;116804;406;131593;53126924;48483973;22365658;59147;24291661
FR;0;2022-01-01;1191;3196;8492;36;9918;53128115;48487169;22374150;59183;24301579
FR;0;2022-01-02;6063;13006;58375;124;66928;53134178;48500175;22432525;59307;24368507
FR;0;2022-01-03;31628;88185;494601;1591;551270;53165806;48588360;22927126;60898;24919777
FR;0;2022-01-04;40524;110545;641213;2302;714115;53206330;48698905;23568339;63200;25633892
FR;0;2022-01-05;59570;102950;568962;1982;633945;53265900;48801855;24137301;65182;26267837
FR;0;2022-01-06;43793;109967;638794;2689;711222;53309693;48911822;24776095;67871;26979059
FR;0;2022-01-07;50410;122736;710814;2804;790195;53360103;49034558;25486909;70675;27769254
FR;0;2022-01-08;44901;80311;423743;1208;472808;53405004;49114869;25910652;71883;28242062
FR;0;2022-01-09;15590;26772;128528;300;145714;53420594;49141641;26039180;72183;28387776
FR;0;2022-01-10;34803;86292;469112;1808;521980;53455397;49227933;26508292;73991;28909756
FR;0;2022-01-11;41501;99717;548050;2306;608296;53496898;49327650;27056342;76297;29518052
FR;0;2022-01-12;59977;95169;452490;1964;504157;53556875;49422819;27508832;78261;30022209
FR;0;2022-01-13;37758;92042;487143;2080;540843;53594633;49514861;27995975;80341;30563052
FR;0;2022-01-14;42291;103177;568388;2283;628863;53636924;49618038;28564363;82624;31191915
FR;0;2022-01-15;39281;65796;340036;980;377505;53676205;49683834;28904399;83604;31569420
FR;0;2022-01-16;11380;19329;87356;215;99441;53687585;49703163;28991755;83819;31668861
FR;0;2022-01-17;24546;60003;320157;1380;354100;53712131;49763166;29311912;85199;32022961
FR;0;2022-01-18;28049;68294;360931;1797;397453;53740180;49831460;29672843;86996;32420414
FR;0;2022-01-19;42955;66919;281153;1448;310978;53783135;49898379;29953996;88444;32731392
FR;0;2022-01-20;23330;59284;298816;1737;328315;53806465;49957663;30252812;90181;33059707
FR;0;2022-01-21;27898;68720;366222;2079;401068;53834363;50026383;30619034;92260;33460775
FR;0;2022-01-22;27602;47749;218731;838;241714;53861965;50074132;30837765;93098;33702489
FR;0;2022-01-23;6695;13065;48634;171;55186;53868660;50087197;30886399;93269;33757675
FR;0;2022-01-24;16153;47074;217195;1135;239278;53884813;50134271;31103594;94404;33996953
FR;0;2022-01-25;18876;53989;242922;1547;266994;53903689;50188260;31346516;95951;34263947
FR;0;2022-01-26;28062;59392;209147;1292;229265;53931751;50247652;31555663;97243;34493212
FR;0;2022-01-27;16244;45533;207491;1266;225715;53947995;50293185;31763154;98509;34718927
FR;0;2022-01-28;21422;75751;289915;1573;321440;53969417;50368936;32053069;100082;35040367
FR;0;2022-01-29;18383;52855;184062;684;204556;53987800;50421791;32237131;100766;35244923
FR;0;2022-01-30;4462;14594;39112;121;45093;53992262;50436385;32276243;100887;35290016
FR;0;2022-01-31;11197;43818;148113;738;164773;54003459;50480203;32424356;101625;35454789
FR;0;2022-02-01;12598;47741;174003;1139;191268;54016057;50527944;32598359;102764;35646057
FR;0;2022-02-02;19669;65588;171388;1030;190042;54035726;50593532;32769747;103794;35836099
FR;0;2022-02-03;10866;43734;157424;984;173227;54046592;50637266;32927171;104778;36009326
FR;0;2022-02-04;14431;66238;239108;1260;264111;54061023;50703504;33166279;106038;36273437
FR;0;2022-02-05;12583;51468;153484;522;172316;54073606;50754972;33319763;106560;36445753
FR;0;2022-02-06;2702;12260;28858;99;33820;54076308;50767232;33348621;106659;36479573
FR;0;2022-02-07;9204;46542;156773;582;176278;54085512;50813774;33505394;107241;36655851
FR;0;2022-02-08;9509;42483;166519;866;184276;54095021;50856257;33671913;108107;36840127
FR;0;2022-02-09;14079;57496;172235;864;192884;54109100;50913753;33844148;108971;37033011
FR;0;2022-02-10;8197;37931;150071;876;166464;54117297;50951684;33994219;109847;37199475
FR;0;2022-02-11;10720;55272;218359;1095;242912;54128017;51006956;34212578;110942;37442387
FR;0;2022-02-12;8315;40832;134662;461;151669;54136332;51047788;34347240;111403;37594056
FR;0;2022-02-13;1880;8561;26529;81;30883;54138212;51056349;34373769;111484;37624939
FR;0;2022-02-14;6853;35021;148252;476;166240;54145065;51091370;34522021;111960;37791179
FR;0;2022-02-15;6812;35275;146799;749;162318;54151877;51126645;34668820;112709;37953497
FR;0;2022-02-16;9250;42339;132386;715;146548;54161127;51168984;34801206;113424;38100045
FR;0;2022-02-17;5325;23430;87190;582;94685;54166452;51192414;34888396;114006;38194730
FR;0;2022-02-18;6835;33061;119533;800;129161;54173287;51225475;35007929;114806;38323891
FR;0;2022-02-19;5319;24413;69982;369;77277;54178606;51249888;35077911;115175;38401168
FR;0;2022-02-20;1130;4599;12135;38;13905;54179736;51254487;35090046;115213;38415073
FR;0;2022-02-21;3978;17713;61874;351;67087;54183714;51272200;35151920;115564;38482160
FR;0;2022-02-22;4321;18407;60742;571;64356;54188035;51290607;35212662;116135;38546516
FR;0;2022-02-23;6490;26973;66387;591;71765;54194525;51317580;35279049;116726;38618281
FR;0;2022-02-24;3709;14914;50324;514;53110;54198234;51332494;35329373;117240;38671391
FR;0;2022-02-25;5143;23354;76212;799;79910;54203377;51355848;35405585;118039;38751301
FR;0;2022-02-26;3950;17457;47363;355;51428;54207327;51373305;35452948;118394;38802729
FR;0;2022-02-27;862;2977;8010;47;8917;54208189;51376282;35460958;118441;38811646
FR;0;2022-02-28;3041;11999;40390;350;42811;54211230;51388281;35501348;118791;38854457
FR;0;2022-03-01;2971;11990;43893;431;44511;54214201;51400271;35545241;119222;38898968
FR;0;2022-03-02;4996;17320;46930;434;48828;54219197;51417591;35592171;119656;38947796
FR;0;2022-03-03;2584;8659;29590;337;29677;54221781;51426250;35621761;119993;38977473
FR;0;2022-03-04;3136;12063;40133;643;39248;54224917;51438313;35661894;120636;39016721
FR;0;2022-03-05;2874;9175;24882;307;25024;54227791;51447488;35686776;120943;39041745
FR;0;2022-03-06;492;1363;3174;42;3410;54228283;51448851;35689950;120985;39045155
FR;0;2022-03-07;1877;5400;18315;310;17574;54230160;51454251;35708265;121295;39062729
FR;0;2022-03-08;1908;5773;19276;352;17734;54232068;51460024;35727541;121647;39080463
FR;0;2022-03-09;3402;10100;21941;400;21026;54235470;51470124;35749482;122047;39101489
FR;0;2022-03-10;1646;4868;16478;326;15282;54237116;51474992;35765960;122373;39116771
FR;0;2022-03-11;2305;7198;24319;536;22066;54239421;51482190;35790279;122909;39138837
FR;0;2022-03-12;2619;6676;17075;302;16413;54242040;51488866;35807354;123211;39155250
FR;0;2022-03-13;380;764;2218;143;2167;54242420;51489630;35809572;123354;39157417
FR;0;2022-03-14;1420;4041;14751;4403;13610;54243840;51493671;35824323;127757;39171027
FR;0;2022-03-15;1543;4231;15852;7534;13951;54245383;51497902;35840175;135291;39184978
FR;0;2022-03-16;2886;6861;18574;13117;17253;54248269;51504763;35858749;148408;39202231
FR;0;2022-03-17;1334;3518;12494;10783;11312;54249603;51508281;35871243;159191;39213543
FR;0;2022-03-18;2136;5385;19661;18221;17723;54251739;51513666;35890904;177412;39231266
FR;0;2022-03-19;2241;4624;13026;9381;12325;54253980;51518290;35903930;186793;39243591
FR;0;2022-03-20;279;675;1802;1058;1802;54254259;51518965;35905732;187851;39245393
FR;0;2022-03-21;1306;3002;11836;14848;11048;54255565;51521967;35917568;202699;39256441
FR;0;2022-03-22;1402;3445;13175;20472;11930;54256967;51525412;35930743;223171;39268371
FR;0;2022-03-23;2561;5672;15196;23058;14578;54259528;51531084;35945939;246229;39282949
FR;0;2022-03-24;1277;2770;10823;17444;9898;54260805;51533854;35956762;263673;39292847
FR;0;2022-03-25;1974;4647;17909;27643;16251;54262779;51538501;35974671;291316;39309098
FR;0;2022-03-26;2189;4150;11824;12611;11244;54264968;51542651;35986495;303927;39320342
FR;0;2022-03-27;345;673;1845;1448;1879;54265313;51543324;35988340;305375;39322221
FR;0;2022-03-28;1370;2803;10537;17261;10002;54266683;51546127;35998877;322636;39332223
FR;0;2022-03-29;1385;3109;12327;27183;11455;54268068;51549236;36011204;349819;39343678
FR;0;2022-03-30;2743;5195;14708;27011;14083;54270811;51554431;36025912;376830;39357761
FR;0;2022-03-31;1542;2992;12033;24124;11337;54272353;51557423;36037945;400954;39369098
FR;0;2022-04-01;1927;3802;15928;30097;14652;54274280;51561225;36053873;431051;39383750
FR;0;2022-04-02;1384;2482;8484;9959;8129;54275664;51563707;36062357;441010;39391879
FR;0;2022-04-03;239;462;1467;1122;1481;54275903;51564169;36063824;442132;39393360
FR;0;2022-04-04;1196;2203;9596;17644;8795;54277099;51566372;36073420;459776;39402155
FR;0;2022-04-05;1442;2593;12422;30446;11248;54278541;51568965;36085842;490222;39413403
