fra;vaccin;jour;n_dose1;n_dose2;n_cum_dose1;n_cum_dose2
FR;1;2020-12-27;20;0;20;0
FR;1;2020-12-28;69;0;89;0
FR;1;2020-12-29;108;0;197;0
FR;1;2020-12-30;120;0;317;0
FR;1;2020-12-31;83;0;400;0
FR;1;2021-01-01;67;0;467;0
FR;1;2021-01-02;78;0;545;0
FR;1;2021-01-03;89;0;634;0
FR;1;2021-01-04;1472;0;2106;0
FR;1;2021-01-05;5386;0;7492;0
FR;1;2021-01-06;11290;0;18782;0
FR;1;2021-01-07;28543;0;47325;0
FR;1;2021-01-08;36162;0;83487;0
FR;1;2021-01-09;10901;0;94388;0
FR;1;2021-01-10;5610;0;99998;0
FR;1;2021-01-11;38930;0;138928;0
FR;1;2021-01-12;60774;0;199702;0
FR;1;2021-01-13;63675;0;263377;0
FR;1;2021-01-14;79650;0;343027;0
FR;1;2021-01-15;67158;0;410185;0
FR;1;2021-01-16;19420;78;429605;78
FR;1;2021-01-17;10460;42;440065;120
FR;1;2021-01-18;81394;163;521459;283
FR;1;2021-01-19;123841;127;645300;410
FR;1;2021-01-20;130034;159;775334;569
FR;1;2021-01-21;150020;135;925354;704
FR;1;2021-01-22;113552;162;1038906;866
FR;1;2021-01-23;36038;50;1074944;916
FR;1;2021-01-24;9256;27;1084200;943
FR;1;2021-01-25;73114;1218;1157314;2161
FR;1;2021-01-26;94981;3110;1252295;5271
FR;1;2021-01-27;102136;5600;1354431;10871
FR;1;2021-01-28;118726;14361;1473157;25232
FR;1;2021-01-29;87748;17294;1560905;42526
FR;1;2021-01-30;27571;4225;1588476;46751
FR;1;2021-01-31;4864;1681;1593340;48432
FR;1;2021-02-01;48258;21134;1641598;69566
FR;1;2021-02-02;66297;34586;1707895;104152
FR;1;2021-02-03;65883;36984;1773778;141136
FR;1;2021-02-04;75720;50079;1849498;191215
FR;1;2021-02-05;62417;45342;1911915;236557
FR;1;2021-02-06;19036;10398;1930951;246955
FR;1;2021-02-07;3434;5046;1934385;252001
FR;1;2021-02-08;35761;45989;1970146;297990
FR;1;2021-02-09;49813;72406;2019959;370396
FR;1;2021-02-10;50843;76662;2070802;447058
FR;1;2021-02-11;62131;99107;2132933;546165
FR;1;2021-02-12;54810;74060;2187743;620225
FR;1;2021-02-13;15130;19274;2202873;639499
FR;1;2021-02-14;3420;7193;2206293;646692
FR;1;2021-02-15;23562;73445;2229855;720137
FR;1;2021-02-16;32108;96887;2261963;817024
FR;1;2021-02-17;34370;98586;2296333;915610
FR;1;2021-02-18;48063;113505;2344396;1029115
FR;1;2021-02-19;44407;86437;2388803;1115552
FR;1;2021-02-20;13019;26923;2401822;1142475
FR;1;2021-02-21;2116;6290;2403938;1148765
FR;1;2021-02-22;24020;69418;2427958;1218183
FR;1;2021-02-23;36600;80454;2464558;1298637
FR;1;2021-02-24;39352;77670;2503910;1376307
FR;1;2021-02-25;48877;88001;2552787;1464308
FR;1;2021-02-26;46063;67893;2598850;1532201
FR;1;2021-02-27;15173;20929;2614023;1553130
FR;1;2021-02-28;3229;4386;2617252;1557516
FR;1;2021-03-01;38695;49040;2655947;1606556
FR;1;2021-03-02;54644;61542;2710591;1668098
FR;1;2021-03-03;59436;60660;2770027;1728758
FR;1;2021-03-04;71010;64908;2841037;1793666
FR;1;2021-03-05;73087;59281;2914124;1852947
FR;1;2021-03-06;81297;16091;2995421;1869038
FR;1;2021-03-07;62960;5422;3058381;1874460
FR;1;2021-03-08;58680;42479;3117061;1916939
FR;1;2021-03-09;84333;48323;3201394;1965262
FR;1;2021-03-10;88898;48067;3290292;2013329
FR;1;2021-03-11;103123;53882;3393415;2067211
FR;1;2021-03-12;102091;45279;3495506;2112490
FR;1;2021-03-13;87496;12729;3583002;2125219
FR;1;2021-03-14;43626;3031;3626628;2128250
FR;1;2021-03-15;93721;29168;3720349;2157418
FR;1;2021-03-16;121820;34919;3842169;2192337
FR;1;2021-03-17;127336;34884;3969505;2227221
FR;1;2021-03-18;140707;39755;4110212;2266976
FR;1;2021-03-19;134111;32918;4244323;2299894
FR;1;2021-03-20;74889;10211;4319212;2310105
FR;1;2021-03-21;25767;2477;4344979;2312582
FR;1;2021-03-22;112833;31190;4457812;2343772
FR;1;2021-03-23;140699;38180;4598511;2381952
FR;1;2021-03-24;139778;38793;4738289;2420745
FR;1;2021-03-25;162571;39633;4900860;2460378
FR;1;2021-03-26;164008;37504;5064868;2497882
FR;1;2021-03-27;109790;15261;5174658;2513143
FR;1;2021-03-28;41717;3624;5216375;2516767
FR;1;2021-03-29;128188;49979;5344563;2566746
FR;1;2021-03-30;165377;63597;5509940;2630343
FR;1;2021-03-31;168542;66913;5678482;2697256
FR;1;2021-04-01;190802;79261;5869284;2776517
FR;1;2021-04-02;162085;84326;6031369;2860843
FR;1;2021-04-03;87061;58188;6118430;2919031
FR;1;2021-04-04;32289;17732;6150719;2936763
FR;1;2021-04-05;42383;10177;6193102;2946940
FR;1;2021-04-06;157088;100908;6350190;3047848
FR;1;2021-04-07;193765;108274;6543955;3156122
FR;1;2021-04-08;218193;112414;6762148;3268536
FR;1;2021-04-09;210908;107554;6973056;3376090
FR;1;2021-04-10;116050;73467;7089106;3449557
FR;1;2021-04-11;40118;30292;7129224;3479849
FR;1;2021-04-12;166124;103804;7295348;3583653
FR;1;2021-04-13;200504;128287;7495852;3711940
FR;1;2021-04-14;204867;122822;7700719;3834762
FR;1;2021-04-15;217565;126780;7918284;3961542
FR;1;2021-04-16;202755;125163;8121039;4086705
FR;1;2021-04-17;120617;67486;8241656;4154191
FR;1;2021-04-18;35179;20993;8276835;4175184
FR;1;2021-04-19;161020;121986;8437855;4297170
FR;1;2021-04-20;185682;148832;8623537;4446002
FR;1;2021-04-21;190417;146790;8813954;4592792
FR;1;2021-04-22;204693;162689;9018647;4755481
FR;1;2021-04-23;194900;157066;9213547;4912547
FR;1;2021-04-24;124214;95512;9337761;5008059
FR;1;2021-04-25;52442;30135;9390203;5038194
FR;1;2021-04-26;176615;138304;9566818;5176498
FR;1;2021-04-27;217496;162022;9784314;5338520
FR;1;2021-04-28;234276;155200;10018590;5493720
FR;1;2021-04-29;265380;160168;10283970;5653888
FR;1;2021-04-30;267064;148239;10551034;5802127
FR;1;2021-05-01;137130;40718;10688164;5842845
FR;1;2021-05-02;79660;28165;10767824;5871010
FR;1;2021-05-03;244766;146612;11012590;6017622
FR;1;2021-05-04;259260;186895;11271850;6204517
FR;1;2021-05-05;275648;184721;11547498;6389238
FR;1;2021-05-06;302668;183233;11850166;6572471
FR;1;2021-05-07;278232;196130;12128398;6768601
FR;1;2021-05-08;179107;48503;12307505;6817104
FR;1;2021-05-09;112243;36237;12419748;6853341
FR;1;2021-05-10;248810;194469;12668558;7047810
FR;1;2021-05-11;311797;211547;12980355;7259357
FR;1;2021-05-12;345387;186151;13325742;7445508
FR;1;2021-05-13;274046;47716;13599788;7493224
FR;1;2021-05-14;358598;128998;13958386;7622222
FR;1;2021-05-15;286869;66177;14245255;7688399
FR;1;2021-05-16;155133;15588;14400388;7703987
FR;1;2021-05-17;310814;116798;14711202;7820785
FR;1;2021-05-18;369803;111531;15081005;7932316
FR;1;2021-05-19;384481;103247;15465486;8035563
FR;1;2021-05-20;409625;96629;15875111;8132192
FR;1;2021-05-21;387946;97676;16263057;8229868
FR;1;2021-05-22;269901;42193;16532958;8272061
FR;1;2021-05-23;120546;11250;16653504;8283311
FR;1;2021-05-24;238123;26398;16891627;8309709
FR;1;2021-05-25;356201;132445;17247828;8442154
FR;1;2021-05-26;363725;128988;17611553;8571142
FR;1;2021-05-27;394316;121210;18005869;8692352
FR;1;2021-05-28;354817;145713;18360686;8838065
FR;1;2021-05-29;249137;81076;18609823;8919141
FR;1;2021-05-30;98281;22616;18708104;8941757
FR;2;2020-12-27;0;0;0;0
FR;2;2020-12-28;0;0;0;0
FR;2;2020-12-29;0;0;0;0
FR;2;2020-12-30;0;0;0;0
FR;2;2020-12-31;0;0;0;0
FR;2;2021-01-01;0;0;0;0
FR;2;2021-01-02;0;0;0;0
FR;2;2021-01-03;0;0;0;0
FR;2;2021-01-04;0;0;0;0
FR;2;2021-01-05;0;0;0;0
FR;2;2021-01-06;0;0;0;0
FR;2;2021-01-07;0;0;0;0
FR;2;2021-01-08;0;0;0;0
FR;2;2021-01-09;0;0;0;0
FR;2;2021-01-10;0;0;0;0
FR;2;2021-01-11;0;0;0;0
FR;2;2021-01-12;0;0;0;0
FR;2;2021-01-13;0;0;0;0
FR;2;2021-01-14;143;0;143;0
FR;2;2021-01-15;217;0;360;0
FR;2;2021-01-16;185;0;545;0
FR;2;2021-01-17;3;0;548;0
FR;2;2021-01-18;2903;0;3451;0
FR;2;2021-01-19;4491;0;7942;0
FR;2;2021-01-20;4921;0;12863;0
FR;2;2021-01-21;5095;0;17958;0
FR;2;2021-01-22;4859;0;22817;0
FR;2;2021-01-23;1728;0;24545;0
FR;2;2021-01-24;97;0;24642;0
FR;2;2021-01-25;3634;0;28276;0
FR;2;2021-01-26;3711;0;31987;0
FR;2;2021-01-27;3421;0;35408;0
FR;2;2021-01-28;3484;0;38892;0
FR;2;2021-01-29;3072;0;41964;0
FR;2;2021-01-30;1059;0;43023;0
FR;2;2021-01-31;0;0;43023;0
FR;2;2021-02-01;3248;0;46271;0
FR;2;2021-02-02;4303;0;50574;0
FR;2;2021-02-03;5030;0;55604;0
FR;2;2021-02-04;4729;3;60333;3
FR;2;2021-02-05;4609;6;64942;9
FR;2;2021-02-06;1930;3;66872;12
FR;2;2021-02-07;42;0;66914;12
FR;2;2021-02-08;7417;8;74331;20
FR;2;2021-02-09;8252;15;82583;35
FR;2;2021-02-10;9136;49;91719;84
FR;2;2021-02-11;10051;67;101770;151
FR;2;2021-02-12;9801;238;111571;389
FR;2;2021-02-13;3012;222;114583;611
FR;2;2021-02-14;296;0;114879;611
FR;2;2021-02-15;3357;3067;118236;3678
FR;2;2021-02-16;4899;3881;123135;7559
FR;2;2021-02-17;4101;4403;127236;11962
FR;2;2021-02-18;5229;5107;132465;17069
FR;2;2021-02-19;5156;4329;137621;21398
FR;2;2021-02-20;1763;1509;139384;22907
FR;2;2021-02-21;197;87;139581;22994
FR;2;2021-02-22;3512;3725;143093;26719
FR;2;2021-02-23;4802;3694;147895;30413
FR;2;2021-02-24;4744;3483;152639;33896
FR;2;2021-02-25;5290;3427;157929;37323
FR;2;2021-02-26;4193;3149;162122;40472
FR;2;2021-02-27;1500;1042;163622;41514
FR;2;2021-02-28;99;28;163721;41542
FR;2;2021-03-01;4957;3764;168678;45306
FR;2;2021-03-02;6301;4728;174979;50034
FR;2;2021-03-03;6240;4883;181219;54917
FR;2;2021-03-04;8069;3967;189288;58884
FR;2;2021-03-05;7767;4059;197055;62943
FR;2;2021-03-06;4620;1682;201675;64625
FR;2;2021-03-07;2283;29;203958;64654
FR;2;2021-03-08;3978;8309;207936;72963
FR;2;2021-03-09;7264;8430;215200;81393
FR;2;2021-03-10;6854;9113;222054;90506
FR;2;2021-03-11;9051;9209;231105;99715
FR;2;2021-03-12;7712;8174;238817;107889
FR;2;2021-03-13;9867;2510;248684;110399
FR;2;2021-03-14;4753;401;253437;110800
FR;2;2021-03-15;10630;3482;264067;114282
FR;2;2021-03-16;16435;4621;280502;118903
FR;2;2021-03-17;19908;3952;300410;122855
FR;2;2021-03-18;22943;4911;323353;127766
FR;2;2021-03-19;22881;4538;346234;132304
FR;2;2021-03-20;25141;1540;371375;133844
FR;2;2021-03-21;17468;147;388843;133991
FR;2;2021-03-22;17383;3080;406226;137071
FR;2;2021-03-23;22258;4183;428484;141254
FR;2;2021-03-24;23537;4989;452021;146243
FR;2;2021-03-25;26259;5020;478280;151263
FR;2;2021-03-26;26576;4260;504856;155523
FR;2;2021-03-27;15635;1309;520491;156832
FR;2;2021-03-28;10391;94;530882;156926
FR;2;2021-03-29;18626;4280;549508;161206
FR;2;2021-03-30;24159;6002;573667;167208
FR;2;2021-03-31;28087;5957;601754;173165
FR;2;2021-04-01;33899;8496;635653;181661
FR;2;2021-04-02;29400;7663;665053;189324
FR;2;2021-04-03;16723;3582;681776;192906
FR;2;2021-04-04;9156;918;690932;193824
FR;2;2021-04-05;12114;811;703046;194635
FR;2;2021-04-06;26658;6935;729704;201570
FR;2;2021-04-07;30579;7174;760283;208744
FR;2;2021-04-08;36476;8818;796759;217562
FR;2;2021-04-09;33346;8601;830105;226163
FR;2;2021-04-10;19436;8969;849541;235132
FR;2;2021-04-11;7812;4271;857353;239403
FR;2;2021-04-12;16785;11254;874138;250657
FR;2;2021-04-13;19051;16426;893189;267083
FR;2;2021-04-14;17642;16285;910831;283368
FR;2;2021-04-15;21819;20791;932650;304159
FR;2;2021-04-16;20339;20076;952989;324235
FR;2;2021-04-17;13032;22463;966021;346698
FR;2;2021-04-18;5781;14405;971802;361103
FR;2;2021-04-19;16441;16264;988243;377367
FR;2;2021-04-20;18917;21597;1007160;398964
FR;2;2021-04-21;19602;21667;1026762;420631
FR;2;2021-04-22;23228;24866;1049990;445497
FR;2;2021-04-23;24081;25375;1074071;470872
FR;2;2021-04-24;25003;15115;1099074;485987
FR;2;2021-04-25;9413;8590;1108487;494577
FR;2;2021-04-26;16651;17202;1125138;511779
FR;2;2021-04-27;18923;24311;1144061;536090
FR;2;2021-04-28;21518;26209;1165579;562299
FR;2;2021-04-29;24828;30139;1190407;592438
FR;2;2021-04-30;25054;27783;1215461;620221
FR;2;2021-05-01;14753;9863;1230214;630084
FR;2;2021-05-02;6478;9184;1236692;639268
FR;2;2021-05-03;19025;19328;1255717;658596
FR;2;2021-05-04;17889;29056;1273606;687652
FR;2;2021-05-05;17896;29416;1291502;717068
FR;2;2021-05-06;23099;35298;1314601;752366
FR;2;2021-05-07;23657;33255;1338258;785621
FR;2;2021-05-08;19909;9715;1358167;795336
FR;2;2021-05-09;12896;7894;1371063;803230
FR;2;2021-05-10;32181;22234;1403244;825464
FR;2;2021-05-11;42381;21080;1445625;846544
FR;2;2021-05-12;47745;19908;1493370;866452
FR;2;2021-05-13;50446;5772;1543816;872224
FR;2;2021-05-14;60409;12958;1604225;885182
FR;2;2021-05-15;65182;7154;1669407;892336
FR;2;2021-05-16;42935;2575;1712342;894911
FR;2;2021-05-17;44048;12599;1756390;907510
FR;2;2021-05-18;52632;12279;1809022;919789
FR;2;2021-05-19;55332;10653;1864354;930442
FR;2;2021-05-20;62387;10916;1926741;941358
FR;2;2021-05-21;62180;11732;1988921;953090
FR;2;2021-05-22;60709;4527;2049630;957617
FR;2;2021-05-23;36908;577;2086538;958194
FR;2;2021-05-24;16815;2033;2103353;960227
FR;2;2021-05-25;20412;12319;2123765;972546
FR;2;2021-05-26;18280;11709;2142045;984255
FR;2;2021-05-27;22238;11964;2164283;996219
FR;2;2021-05-28;27736;14987;2192019;1011206
FR;2;2021-05-29;29330;8188;2221349;1019394
FR;2;2021-05-30;4389;1810;2225738;1021204
FR;3;2020-12-27;0;0;0;0
FR;3;2020-12-28;0;0;0;0
FR;3;2020-12-29;0;0;0;0
FR;3;2020-12-30;0;0;0;0
FR;3;2020-12-31;0;0;0;0
FR;3;2021-01-01;0;0;0;0
FR;3;2021-01-02;0;0;0;0
FR;3;2021-01-03;0;0;0;0
FR;3;2021-01-04;0;0;0;0
FR;3;2021-01-05;0;0;0;0
FR;3;2021-01-06;0;0;0;0
FR;3;2021-01-07;0;0;0;0
FR;3;2021-01-08;0;0;0;0
FR;3;2021-01-09;0;0;0;0
FR;3;2021-01-10;0;0;0;0
FR;3;2021-01-11;0;0;0;0
FR;3;2021-01-12;0;0;0;0
FR;3;2021-01-13;0;0;0;0
FR;3;2021-01-14;0;0;0;0
FR;3;2021-01-15;0;0;0;0
FR;3;2021-01-16;0;0;0;0
FR;3;2021-01-17;0;0;0;0
FR;3;2021-01-18;0;0;0;0
FR;3;2021-01-19;0;0;0;0
FR;3;2021-01-20;0;0;0;0
FR;3;2021-01-21;0;0;0;0
FR;3;2021-01-22;0;0;0;0
FR;3;2021-01-23;0;0;0;0
FR;3;2021-01-24;0;0;0;0
FR;3;2021-01-25;0;0;0;0
FR;3;2021-01-26;0;0;0;0
FR;3;2021-01-27;0;0;0;0
FR;3;2021-01-28;0;0;0;0
FR;3;2021-01-29;0;0;0;0
FR;3;2021-01-30;0;0;0;0
FR;3;2021-01-31;0;0;0;0
FR;3;2021-02-01;0;0;0;0
FR;3;2021-02-02;0;0;0;0
FR;3;2021-02-03;0;0;0;0
FR;3;2021-02-04;0;0;0;0
FR;3;2021-02-05;0;0;0;0
FR;3;2021-02-06;311;0;311;0
FR;3;2021-02-07;1348;0;1659;0
FR;3;2021-02-08;2629;0;4288;0
FR;3;2021-02-09;6628;0;10916;0
FR;3;2021-02-10;9212;0;20128;0
FR;3;2021-02-11;13323;0;33451;0
FR;3;2021-02-12;13024;0;46475;0
FR;3;2021-02-13;3500;0;49975;0
FR;3;2021-02-14;863;0;50838;0
FR;3;2021-02-15;10100;0;60938;0
FR;3;2021-02-16;12154;0;73092;0
FR;3;2021-02-17;10811;0;83903;0
FR;3;2021-02-18;14527;0;98430;0
FR;3;2021-02-19;14076;0;112506;0
FR;3;2021-02-20;3173;0;115679;0
FR;3;2021-02-21;544;0;116223;0
FR;3;2021-02-22;8897;0;125120;0
FR;3;2021-02-23;11065;0;136185;0
FR;3;2021-02-24;13857;0;150042;0
FR;3;2021-02-25;44264;0;194306;0
FR;3;2021-02-26;61309;0;255615;0
FR;3;2021-02-27;34401;8;290016;8
FR;3;2021-02-28;2334;0;292350;8
FR;3;2021-03-01;19798;11;312148;19
FR;3;2021-03-02;38214;13;350362;32
FR;3;2021-03-03;47590;17;397952;49
FR;3;2021-03-04;80699;20;478651;69
FR;3;2021-03-05;116501;60;595152;129
FR;3;2021-03-06;118230;52;713382;181
FR;3;2021-03-07;54318;29;767700;210
FR;3;2021-03-08;41762;24;809462;234
FR;3;2021-03-09;77419;30;886881;264
FR;3;2021-03-10;79257;42;966138;306
FR;3;2021-03-11;126332;50;1092470;356
FR;3;2021-03-12;180190;70;1272660;426
FR;3;2021-03-13;130165;53;1402825;479
FR;3;2021-03-14;13660;5;1416485;484
FR;3;2021-03-15;51021;41;1467506;525
FR;3;2021-03-16;885;14;1468391;539
FR;3;2021-03-17;596;6;1468987;545
FR;3;2021-03-18;1155;4;1470142;549
FR;3;2021-03-19;69165;37;1539307;586
FR;3;2021-03-20;64210;36;1603517;622
FR;3;2021-03-21;5473;4;1608990;626
FR;3;2021-03-22;36565;33;1645555;659
FR;3;2021-03-23;83288;50;1728843;709
FR;3;2021-03-24;89541;91;1818384;800
FR;3;2021-03-25;148037;114;1966421;914
FR;3;2021-03-26;163415;156;2129836;1070
FR;3;2021-03-27;67197;88;2197033;1158
FR;3;2021-03-28;6161;19;2203194;1177
FR;3;2021-03-29;53261;61;2256455;1238
FR;3;2021-03-30;91892;88;2348347;1326
FR;3;2021-03-31;62271;82;2410618;1408
FR;3;2021-04-01;84557;104;2495175;1512
FR;3;2021-04-02;85648;148;2580823;1660
FR;3;2021-04-03;35172;109;2615995;1769
FR;3;2021-04-04;3372;16;2619367;1785
FR;3;2021-04-05;4207;21;2623574;1806
FR;3;2021-04-06;28847;76;2652421;1882
FR;3;2021-04-07;31484;61;2683905;1943
FR;3;2021-04-08;77425;236;2761330;2179
FR;3;2021-04-09;159693;412;2921023;2591
FR;3;2021-04-10;74386;332;2995409;2923
FR;3;2021-04-11;7008;44;3002417;2967
FR;3;2021-04-12;50501;197;3052918;3164
FR;3;2021-04-13;85000;315;3137918;3479
FR;3;2021-04-14;66468;342;3204386;3821
FR;3;2021-04-15;91600;369;3295986;4190
FR;3;2021-04-16;110951;574;3406937;4764
FR;3;2021-04-17;52176;336;3459113;5100
FR;3;2021-04-18;9424;35;3468537;5135
FR;3;2021-04-19;24391;239;3492928;5374
FR;3;2021-04-20;44775;398;3537703;5772
FR;3;2021-04-21;38012;458;3575715;6230
FR;3;2021-04-22;53621;793;3629336;7023
FR;3;2021-04-23;69400;1031;3698736;8054
FR;3;2021-04-24;36478;985;3735214;9039
FR;3;2021-04-25;5909;168;3741123;9207
FR;3;2021-04-26;19071;665;3760194;9872
FR;3;2021-04-27;33691;1245;3793885;11117
FR;3;2021-04-28;28236;1926;3822121;13043
FR;3;2021-04-29;44495;5959;3866616;19002
FR;3;2021-04-30;54524;8933;3921140;27935
FR;3;2021-05-01;9159;1968;3930299;29903
FR;3;2021-05-02;2800;501;3933099;30404
FR;3;2021-05-03;12488;3888;3945587;34292
FR;3;2021-05-04;22390;8456;3967977;42748
FR;3;2021-05-05;18015;10573;3985992;53321
FR;3;2021-05-06;33849;20907;4019841;74228
FR;3;2021-05-07;43286;28414;4063127;102642
FR;3;2021-05-08;6331;8915;4069458;111557
FR;3;2021-05-09;1560;2655;4071018;114212
FR;3;2021-05-10;14376;12564;4085394;126776
FR;3;2021-05-11;26341;25751;4111735;152527
FR;3;2021-05-12;16666;27477;4128401;180004
FR;3;2021-05-13;1988;3487;4130389;183491
FR;3;2021-05-14;14022;25750;4144411;209241
FR;3;2021-05-15;6894;20743;4151305;229984
FR;3;2021-05-16;809;2682;4152114;232666
FR;3;2021-05-17;7471;19923;4159585;252589
FR;3;2021-05-18;12865;29672;4172450;282261
FR;3;2021-05-19;8767;31891;4181217;314152
FR;3;2021-05-20;12201;53292;4193418;367444
FR;3;2021-05-21;12173;65642;4205591;433086
FR;3;2021-05-22;4622;33365;4210213;466451
FR;3;2021-05-23;525;2681;4210738;469132
FR;3;2021-05-24;573;4922;4211311;474054
FR;3;2021-05-25;4754;45457;4216065;519511
FR;3;2021-05-26;4506;51718;4220571;571229
FR;3;2021-05-27;5824;76514;4226395;647743
FR;3;2021-05-28;6952;99110;4233347;746853
FR;3;2021-05-29;2963;60286;4236310;807139
FR;3;2021-05-30;347;8243;4236657;815382
FR;4;2020-12-27;0;0;0;0
FR;4;2020-12-28;0;0;0;0
FR;4;2020-12-29;0;0;0;0
FR;4;2020-12-30;0;0;0;0
FR;4;2020-12-31;0;0;0;0
FR;4;2021-01-01;0;0;0;0
FR;4;2021-01-02;0;0;0;0
FR;4;2021-01-03;0;0;0;0
FR;4;2021-01-04;0;0;0;0
FR;4;2021-01-05;0;0;0;0
FR;4;2021-01-06;0;0;0;0
FR;4;2021-01-07;0;0;0;0
FR;4;2021-01-08;0;0;0;0
FR;4;2021-01-09;0;0;0;0
FR;4;2021-01-10;0;0;0;0
FR;4;2021-01-11;0;0;0;0
FR;4;2021-01-12;0;0;0;0
FR;4;2021-01-13;0;0;0;0
FR;4;2021-01-14;0;0;0;0
FR;4;2021-01-15;0;0;0;0
FR;4;2021-01-16;0;0;0;0
FR;4;2021-01-17;0;0;0;0
FR;4;2021-01-18;0;0;0;0
FR;4;2021-01-19;0;0;0;0
FR;4;2021-01-20;0;0;0;0
FR;4;2021-01-21;0;0;0;0
FR;4;2021-01-22;0;0;0;0
FR;4;2021-01-23;0;0;0;0
FR;4;2021-01-24;0;0;0;0
FR;4;2021-01-25;0;0;0;0
FR;4;2021-01-26;0;0;0;0
FR;4;2021-01-27;0;0;0;0
FR;4;2021-01-28;0;0;0;0
FR;4;2021-01-29;0;0;0;0
FR;4;2021-01-30;0;0;0;0
FR;4;2021-01-31;0;0;0;0
FR;4;2021-02-01;0;0;0;0
FR;4;2021-02-02;0;0;0;0
FR;4;2021-02-03;0;0;0;0
FR;4;2021-02-04;0;0;0;0
FR;4;2021-02-05;0;0;0;0
FR;4;2021-02-06;0;0;0;0
FR;4;2021-02-07;0;0;0;0
FR;4;2021-02-08;0;0;0;0
FR;4;2021-02-09;0;0;0;0
FR;4;2021-02-10;0;0;0;0
FR;4;2021-02-11;0;0;0;0
FR;4;2021-02-12;0;0;0;0
FR;4;2021-02-13;0;0;0;0
FR;4;2021-02-14;0;0;0;0
FR;4;2021-02-15;0;0;0;0
FR;4;2021-02-16;0;0;0;0
FR;4;2021-02-17;0;0;0;0
FR;4;2021-02-18;0;0;0;0
FR;4;2021-02-19;0;0;0;0
FR;4;2021-02-20;0;0;0;0
FR;4;2021-02-21;0;0;0;0
FR;4;2021-02-22;0;0;0;0
FR;4;2021-02-23;0;0;0;0
FR;4;2021-02-24;0;0;0;0
FR;4;2021-02-25;0;0;0;0
FR;4;2021-02-26;0;0;0;0
FR;4;2021-02-27;0;0;0;0
FR;4;2021-02-28;0;0;0;0
FR;4;2021-03-01;0;0;0;0
FR;4;2021-03-02;0;0;0;0
FR;4;2021-03-03;0;0;0;0
FR;4;2021-03-04;0;0;0;0
FR;4;2021-03-05;0;0;0;0
FR;4;2021-03-06;0;0;0;0
FR;4;2021-03-07;0;0;0;0
FR;4;2021-03-08;0;0;0;0
FR;4;2021-03-09;0;0;0;0
FR;4;2021-03-10;0;0;0;0
FR;4;2021-03-11;0;0;0;0
FR;4;2021-03-12;0;0;0;0
FR;4;2021-03-13;0;0;0;0
FR;4;2021-03-14;0;0;0;0
FR;4;2021-03-15;0;0;0;0
FR;4;2021-03-16;0;0;0;0
FR;4;2021-03-17;0;0;0;0
FR;4;2021-03-18;0;0;0;0
FR;4;2021-03-19;0;0;0;0
FR;4;2021-03-20;0;0;0;0
FR;4;2021-03-21;0;0;0;0
FR;4;2021-03-22;0;0;0;0
FR;4;2021-03-23;0;0;0;0
FR;4;2021-03-24;0;0;0;0
FR;4;2021-03-25;0;0;0;0
FR;4;2021-03-26;0;0;0;0
FR;4;2021-03-27;0;0;0;0
FR;4;2021-03-28;0;0;0;0
FR;4;2021-03-29;0;0;0;0
FR;4;2021-03-30;0;0;0;0
FR;4;2021-03-31;0;0;0;0
FR;4;2021-04-01;0;0;0;0
FR;4;2021-04-02;0;0;0;0
FR;4;2021-04-03;0;0;0;0
FR;4;2021-04-04;0;0;0;0
FR;4;2021-04-05;0;0;0;0
FR;4;2021-04-06;0;0;0;0
FR;4;2021-04-07;0;0;0;0
FR;4;2021-04-08;0;0;0;0
FR;4;2021-04-09;0;0;0;0
FR;4;2021-04-10;0;0;0;0
FR;4;2021-04-11;0;0;0;0
FR;4;2021-04-12;0;0;0;0
FR;4;2021-04-13;0;0;0;0
FR;4;2021-04-14;0;0;0;0
FR;4;2021-04-15;0;0;0;0
FR;4;2021-04-16;0;0;0;0
FR;4;2021-04-17;0;0;0;0
FR;4;2021-04-18;0;0;0;0
FR;4;2021-04-19;0;0;0;0
FR;4;2021-04-20;0;0;0;0
FR;4;2021-04-21;0;0;0;0
FR;4;2021-04-22;0;0;0;0
FR;4;2021-04-23;620;0;620;0
FR;4;2021-04-24;1553;0;2173;0
FR;4;2021-04-25;117;0;2290;0
FR;4;2021-04-26;2826;0;5116;0
FR;4;2021-04-27;9350;3;14466;3
FR;4;2021-04-28;9752;3;24218;6
FR;4;2021-04-29;15860;7;40078;13
FR;4;2021-04-30;19054;7;59132;20
FR;4;2021-05-01;1891;5;61023;25
FR;4;2021-05-02;437;0;61460;25
FR;4;2021-05-03;4903;1;66363;26
FR;4;2021-05-04;8243;8;74606;34
FR;4;2021-05-05;5995;7;80601;41
FR;4;2021-05-06;11246;11;91847;52
FR;4;2021-05-07;18887;8;110734;60
FR;4;2021-05-08;2247;4;112981;64
FR;4;2021-05-09;627;2;113608;66
FR;4;2021-05-10;7053;13;120661;79
FR;4;2021-05-11;14078;12;134739;91
FR;4;2021-05-12;9925;14;144664;105
FR;4;2021-05-13;1435;3;146099;108
FR;4;2021-05-14;7561;8;153660;116
FR;4;2021-05-15;3568;9;157228;125
FR;4;2021-05-16;348;1;157576;126
FR;4;2021-05-17;4218;3;161794;129
FR;4;2021-05-18;8431;10;170225;139
FR;4;2021-05-19;5471;5;175696;144
FR;4;2021-05-20;9142;7;184838;151
FR;4;2021-05-21;12440;26;197278;177
FR;4;2021-05-22;4888;13;202166;190
FR;4;2021-05-23;419;2;202585;192
FR;4;2021-05-24;918;3;203503;195
FR;4;2021-05-25;7304;16;210807;211
FR;4;2021-05-26;7419;12;218226;223
FR;4;2021-05-27;13870;34;232096;257
FR;4;2021-05-28;25688;70;257784;327
FR;4;2021-05-29;10747;17;268531;344
FR;4;2021-05-30;818;2;269349;346
FR;0;2020-12-27;20;0;20;0
FR;0;2020-12-28;69;0;89;0
FR;0;2020-12-29;108;0;197;0
FR;0;2020-12-30;120;0;317;0
FR;0;2020-12-31;83;0;400;0
FR;0;2021-01-01;67;0;467;0
FR;0;2021-01-02;78;0;545;0
FR;0;2021-01-03;89;0;634;0
FR;0;2021-01-04;1472;0;2106;0
FR;0;2021-01-05;5386;0;7492;0
FR;0;2021-01-06;11290;0;18782;0
FR;0;2021-01-07;28543;0;47325;0
FR;0;2021-01-08;36162;0;83487;0
FR;0;2021-01-09;10901;0;94388;0
FR;0;2021-01-10;5610;0;99998;0
FR;0;2021-01-11;38930;0;138928;0
FR;0;2021-01-12;60774;0;199702;0
FR;0;2021-01-13;63675;0;263377;0
FR;0;2021-01-14;79793;0;343170;0
FR;0;2021-01-15;67375;0;410545;0
FR;0;2021-01-16;19605;78;430150;78
FR;0;2021-01-17;10463;42;440613;120
FR;0;2021-01-18;84297;163;524910;283
FR;0;2021-01-19;128332;127;653242;410
FR;0;2021-01-20;134955;159;788197;569
FR;0;2021-01-21;155115;135;943312;704
FR;0;2021-01-22;118411;162;1061723;866
FR;0;2021-01-23;37766;50;1099489;916
FR;0;2021-01-24;9353;27;1108842;943
FR;0;2021-01-25;76748;1218;1185590;2161
FR;0;2021-01-26;98692;3110;1284282;5271
FR;0;2021-01-27;105557;5600;1389839;10871
FR;0;2021-01-28;122210;14361;1512049;25232
FR;0;2021-01-29;90820;17294;1602869;42526
FR;0;2021-01-30;28630;4225;1631499;46751
FR;0;2021-01-31;4864;1681;1636363;48432
FR;0;2021-02-01;51506;21134;1687869;69566
FR;0;2021-02-02;70600;34586;1758469;104152
FR;0;2021-02-03;70913;36984;1829382;141136
FR;0;2021-02-04;80449;50082;1909831;191218
FR;0;2021-02-05;67026;45348;1976857;236566
FR;0;2021-02-06;21277;10401;1998134;246967
FR;0;2021-02-07;4824;5046;2002958;252013
FR;0;2021-02-08;45807;45997;2048765;298010
FR;0;2021-02-09;64693;72421;2113458;370431
FR;0;2021-02-10;69191;76711;2182649;447142
FR;0;2021-02-11;85505;99174;2268154;546316
FR;0;2021-02-12;77635;74298;2345789;620614
FR;0;2021-02-13;21642;19496;2367431;640110
FR;0;2021-02-14;4579;7193;2372010;647303
FR;0;2021-02-15;37019;76512;2409029;723815
FR;0;2021-02-16;49161;100768;2458190;824583
FR;0;2021-02-17;49282;102989;2507472;927572
FR;0;2021-02-18;67819;118612;2575291;1046184
FR;0;2021-02-19;63639;90766;2638930;1136950
FR;0;2021-02-20;17955;28432;2656885;1165382
FR;0;2021-02-21;2857;6377;2659742;1171759
FR;0;2021-02-22;36429;73143;2696171;1244902
FR;0;2021-02-23;52467;84148;2748638;1329050
FR;0;2021-02-24;57953;81153;2806591;1410203
FR;0;2021-02-25;98431;91428;2905022;1501631
FR;0;2021-02-26;111565;71042;3016587;1572673
FR;0;2021-02-27;51074;21979;3067661;1594652
FR;0;2021-02-28;5662;4414;3073323;1599066
FR;0;2021-03-01;63450;52815;3136773;1651881
FR;0;2021-03-02;99159;66283;3235932;1718164
FR;0;2021-03-03;113266;65560;3349198;1783724
FR;0;2021-03-04;159778;68895;3508976;1852619
FR;0;2021-03-05;197355;63400;3706331;1916019
FR;0;2021-03-06;204147;17825;3910478;1933844
FR;0;2021-03-07;119561;5480;4030039;1939324
FR;0;2021-03-08;104420;50812;4134459;1990136
FR;0;2021-03-09;169016;56783;4303475;2046919
FR;0;2021-03-10;175009;57222;4478484;2104141
FR;0;2021-03-11;238506;63141;4716990;2167282
FR;0;2021-03-12;289993;53523;5006983;2220805
FR;0;2021-03-13;227528;15292;5234511;2236097
FR;0;2021-03-14;62039;3437;5296550;2239534
FR;0;2021-03-15;155372;32691;5451922;2272225
FR;0;2021-03-16;139140;39554;5591062;2311779
FR;0;2021-03-17;147840;38842;5738902;2350621
FR;0;2021-03-18;164805;44670;5903707;2395291
FR;0;2021-03-19;226157;37493;6129864;2432784
FR;0;2021-03-20;164240;11787;6294104;2444571
FR;0;2021-03-21;48708;2628;6342812;2447199
FR;0;2021-03-22;166781;34303;6509593;2481502
FR;0;2021-03-23;246245;42413;6755838;2523915
FR;0;2021-03-24;252856;43873;7008694;2567788
FR;0;2021-03-25;336867;44767;7345561;2612555
FR;0;2021-03-26;353999;41920;7699560;2654475
FR;0;2021-03-27;192622;16658;7892182;2671133
FR;0;2021-03-28;58269;3737;7950451;2674870
FR;0;2021-03-29;200075;54320;8150526;2729190
FR;0;2021-03-30;281428;69687;8431954;2798877
FR;0;2021-03-31;258900;72952;8690854;2871829
FR;0;2021-04-01;309258;87861;9000112;2959690
FR;0;2021-04-02;277133;92137;9277245;3051827
FR;0;2021-04-03;138956;61879;9416201;3113706
FR;0;2021-04-04;44817;18666;9461018;3132372
FR;0;2021-04-05;58704;11009;9519722;3143381
FR;0;2021-04-06;212593;107919;9732315;3251300
FR;0;2021-04-07;255828;115509;9988143;3366809
FR;0;2021-04-08;332094;121468;10320237;3488277
FR;0;2021-04-09;403947;116567;10724184;3604844
FR;0;2021-04-10;209872;82768;10934056;3687612
FR;0;2021-04-11;54938;34607;10988994;3722219
FR;0;2021-04-12;233410;115255;11222404;3837474
FR;0;2021-04-13;304555;145028;11526959;3982502
FR;0;2021-04-14;288977;139449;11815936;4121951
FR;0;2021-04-15;330984;147940;12146920;4269891
FR;0;2021-04-16;334045;145813;12480965;4415704
FR;0;2021-04-17;185825;90285;12666790;4505989
FR;0;2021-04-18;50384;35433;12717174;4541422
FR;0;2021-04-19;201852;138489;12919026;4679911
FR;0;2021-04-20;249374;170827;13168400;4850738
FR;0;2021-04-21;248031;168915;13416431;5019653
FR;0;2021-04-22;281542;188348;13697973;5208001
FR;0;2021-04-23;289001;183472;13986974;5391473
FR;0;2021-04-24;187248;111612;14174222;5503085
FR;0;2021-04-25;67881;38893;14242103;5541978
FR;0;2021-04-26;215163;156171;14457266;5698149
FR;0;2021-04-27;279460;187581;14736726;5885730
FR;0;2021-04-28;293782;183338;15030508;6069068
FR;0;2021-04-29;350563;196273;15381071;6265341
FR;0;2021-04-30;365696;184962;15746767;6450303
FR;0;2021-05-01;162933;52554;15909700;6502857
FR;0;2021-05-02;89375;37850;15999075;6540707
FR;0;2021-05-03;281182;169829;16280257;6710536
FR;0;2021-05-04;307782;224415;16588039;6934951
FR;0;2021-05-05;317554;224717;16905593;7159668
FR;0;2021-05-06;370862;239449;17276455;7399117
FR;0;2021-05-07;364062;257807;17640517;7656924
FR;0;2021-05-08;207594;67137;17848111;7724061
FR;0;2021-05-09;127326;46788;17975437;7770849
FR;0;2021-05-10;302420;229280;18277857;8000129
FR;0;2021-05-11;394597;258390;18672454;8258519
FR;0;2021-05-12;419723;233550;19092177;8492069
FR;0;2021-05-13;327915;56978;19420092;8549047
FR;0;2021-05-14;440590;167714;19860682;8716761
FR;0;2021-05-15;362513;94083;20223195;8810844
FR;0;2021-05-16;199225;20846;20422420;8831690
FR;0;2021-05-17;366551;149323;20788971;8981013
FR;0;2021-05-18;443731;153492;21232702;9134505
FR;0;2021-05-19;454051;145796;21686753;9280301
FR;0;2021-05-20;493355;160844;22180108;9441145
FR;0;2021-05-21;474739;175076;22654847;9616221
FR;0;2021-05-22;340120;80098;22994967;9696319
FR;0;2021-05-23;158398;14510;23153365;9710829
FR;0;2021-05-24;256429;33356;23409794;9744185
FR;0;2021-05-25;388671;190237;23798465;9934422
FR;0;2021-05-26;393930;192427;24192395;10126849
FR;0;2021-05-27;436248;209722;24628643;10336571
FR;0;2021-05-28;415193;259880;25043836;10596451
FR;0;2021-05-29;292177;149567;25336013;10746018
FR;0;2021-05-30;103835;32671;25439848;10778689
