fra;vaccin;jour;n_dose1;n_dose2;n_cum_dose1;n_cum_dose2
FR;1;2020-12-27;20;0;20;0
FR;1;2020-12-28;71;0;91;0
FR;1;2020-12-29;108;0;199;0
FR;1;2020-12-30;123;0;322;0
FR;1;2020-12-31;87;0;409;0
FR;1;2021-01-01;73;0;482;0
FR;1;2021-01-02;88;0;570;0
FR;1;2021-01-03;92;0;662;0
FR;1;2021-01-04;1479;0;2141;0
FR;1;2021-01-05;5409;0;7550;0
FR;1;2021-01-06;11318;0;18868;0
FR;1;2021-01-07;28572;0;47440;0
FR;1;2021-01-08;36280;0;83720;0
FR;1;2021-01-09;10937;0;94657;0
FR;1;2021-01-10;5632;0;100289;0
FR;1;2021-01-11;39089;0;139378;0
FR;1;2021-01-12;60973;0;200351;0
FR;1;2021-01-13;63920;0;264271;0
FR;1;2021-01-14;79817;0;344088;0
FR;1;2021-01-15;67351;0;411439;0
FR;1;2021-01-16;19556;87;430995;87
FR;1;2021-01-17;10470;42;441465;129
FR;1;2021-01-18;81559;164;523024;293
FR;1;2021-01-19;124028;128;647052;421
FR;1;2021-01-20;130428;160;777480;581
FR;1;2021-01-21;150414;141;927894;722
FR;1;2021-01-22;113860;163;1041754;885
FR;1;2021-01-23;36122;52;1077876;937
FR;1;2021-01-24;9267;28;1087143;965
FR;1;2021-01-25;73256;1219;1160399;2184
FR;1;2021-01-26;95170;3113;1255569;5297
FR;1;2021-01-27;102268;5599;1357837;10896
FR;1;2021-01-28;118935;14361;1476772;25257
FR;1;2021-01-29;87856;17293;1564628;42550
FR;1;2021-01-30;27593;4225;1592221;46775
FR;1;2021-01-31;4872;1679;1597093;48454
FR;1;2021-02-01;48361;21128;1645454;69582
FR;1;2021-02-02;66431;34568;1711885;104150
FR;1;2021-02-03;65992;36961;1777877;141111
FR;1;2021-02-04;75933;50059;1853810;191170
FR;1;2021-02-05;62562;45337;1916372;236507
FR;1;2021-02-06;19090;10396;1935462;246903
FR;1;2021-02-07;3436;5041;1938898;251944
FR;1;2021-02-08;35848;45986;1974746;297930
FR;1;2021-02-09;49938;72392;2024684;370322
FR;1;2021-02-10;50957;76646;2075641;446968
FR;1;2021-02-11;62287;99077;2137928;546045
FR;1;2021-02-12;54961;74038;2192889;620083
FR;1;2021-02-13;15180;19270;2208069;639353
FR;1;2021-02-14;3432;7190;2211501;646543
FR;1;2021-02-15;23600;73440;2235101;719983
FR;1;2021-02-16;32143;96865;2267244;816848
FR;1;2021-02-17;34390;98569;2301634;915417
FR;1;2021-02-18;48233;113474;2349867;1028891
FR;1;2021-02-19;44517;86414;2394384;1115305
FR;1;2021-02-20;13066;26920;2407450;1142225
FR;1;2021-02-21;2119;6287;2409569;1148512
FR;1;2021-02-22;24112;69415;2433681;1217927
FR;1;2021-02-23;36740;80366;2470421;1298293
FR;1;2021-02-24;39484;77662;2509905;1375955
FR;1;2021-02-25;49069;87994;2558974;1463949
FR;1;2021-02-26;46177;67888;2605151;1531837
FR;1;2021-02-27;15247;20931;2620398;1552768
FR;1;2021-02-28;3234;4386;2623632;1557154
FR;1;2021-03-01;38787;49031;2662419;1606185
FR;1;2021-03-02;54771;61505;2717190;1667690
FR;1;2021-03-03;59665;60653;2776855;1728343
FR;1;2021-03-04;71352;64894;2848207;1793237
FR;1;2021-03-05;73291;59274;2921498;1852511
FR;1;2021-03-06;81450;16094;3002948;1868605
FR;1;2021-03-07;62999;5424;3065947;1874029
FR;1;2021-03-08;58904;42480;3124851;1916509
FR;1;2021-03-09;84571;48318;3209422;1964827
FR;1;2021-03-10;89148;48067;3298570;2012894
FR;1;2021-03-11;103401;53866;3401971;2066760
FR;1;2021-03-12;102295;45270;3504266;2112030
FR;1;2021-03-13;87868;12722;3592134;2124752
FR;1;2021-03-14;43747;3031;3635881;2127783
FR;1;2021-03-15;94001;29152;3729882;2156935
FR;1;2021-03-16;122081;34908;3851963;2191843
FR;1;2021-03-17;127665;34869;3979628;2226712
FR;1;2021-03-18;141144;39756;4120772;2266468
FR;1;2021-03-19;134457;32914;4255229;2299382
FR;1;2021-03-20;75072;10212;4330301;2309594
FR;1;2021-03-21;25774;2477;4356075;2312071
FR;1;2021-03-22;113075;31191;4469150;2343262
FR;1;2021-03-23;141109;38176;4610259;2381438
FR;1;2021-03-24;140012;38791;4750271;2420229
FR;1;2021-03-25;162918;39620;4913189;2459849
FR;1;2021-03-26;164406;37500;5077595;2497349
FR;1;2021-03-27;109948;15260;5187543;2512609
FR;1;2021-03-28;41737;3624;5229280;2516233
FR;1;2021-03-29;128433;49969;5357713;2566202
FR;1;2021-03-30;165739;63600;5523452;2629802
FR;1;2021-03-31;168972;66916;5692424;2696718
FR;1;2021-04-01;191343;79256;5883767;2775974
FR;1;2021-04-02;162410;84319;6046177;2860293
FR;1;2021-04-03;87165;58188;6133342;2918481
FR;1;2021-04-04;32334;17733;6165676;2936214
FR;1;2021-04-05;42428;10178;6208104;2946392
FR;1;2021-04-06;157796;100891;6365900;3047283
FR;1;2021-04-07;194247;108272;6560147;3155555
FR;1;2021-04-08;218814;112406;6778961;3267961
FR;1;2021-04-09;211663;107520;6990624;3375481
FR;1;2021-04-10;115987;73465;7106611;3448946
FR;1;2021-04-11;40040;30288;7146651;3479234
FR;1;2021-04-12;166510;103797;7313161;3583031
FR;1;2021-04-13;201081;128263;7514242;3711294
FR;1;2021-04-14;205453;122820;7719695;3834114
FR;1;2021-04-15;218263;126766;7937958;3960880
FR;1;2021-04-16;203812;125155;8141770;4086035
FR;1;2021-04-17;120945;67490;8262715;4153525
FR;1;2021-04-18;35219;20995;8297934;4174520
FR;1;2021-04-19;161870;121935;8459804;4296455
FR;1;2021-04-20;187072;148804;8646876;4445259
FR;1;2021-04-21;191606;146761;8838482;4592020
FR;1;2021-04-22;206337;162652;9044819;4754672
FR;1;2021-04-23;196573;156940;9241392;4911612
FR;1;2021-04-24;124972;95520;9366364;5007132
FR;1;2021-04-25;52870;30140;9419234;5037272
FR;1;2021-04-26;179185;138282;9598419;5175554
FR;1;2021-04-27;218962;162011;9817381;5337565
FR;1;2021-04-28;236064;155142;10053445;5492707
FR;1;2021-04-29;267436;160093;10320881;5652800
FR;1;2021-04-30;269204;148183;10590085;5800983
FR;1;2021-05-01;138151;40719;10728236;5841702
FR;1;2021-05-02;80414;28165;10808650;5869867
FR;1;2021-05-03;247086;146549;11055736;6016416
FR;1;2021-05-04;262162;186878;11317898;6203294
FR;1;2021-05-05;277654;184604;11595552;6387898
FR;1;2021-05-06;304654;183074;11900206;6570972
FR;1;2021-05-07;279828;195761;12180034;6766733
FR;1;2021-05-08;181989;48340;12362023;6815073
FR;1;2021-05-09;112523;36234;12474546;6851307
FR;1;2021-05-10;250729;194294;12725275;7045601
FR;1;2021-05-11;313393;211459;13038668;7257060
FR;1;2021-05-12;347477;185960;13386145;7443020
FR;1;2021-05-13;277663;47685;13663808;7490705
FR;1;2021-05-14;363990;128946;14027798;7619651
FR;1;2021-05-15;291839;66180;14319637;7685831
FR;1;2021-05-16;155318;15588;14474955;7701419
FR;1;2021-05-17;313191;116749;14788146;7818168
FR;1;2021-05-18;372770;111416;15160916;7929584
FR;1;2021-05-19;387640;103024;15548556;8032608
FR;1;2021-05-20;412989;96425;15961545;8129033
FR;1;2021-05-21;392123;97537;16353668;8226570
FR;1;2021-05-22;271487;42191;16625155;8268761
FR;1;2021-05-23;121061;11256;16746216;8280017
FR;1;2021-05-24;238931;26394;16985147;8306411
FR;1;2021-05-25;358592;132083;17343739;8438494
FR;1;2021-05-26;370279;125872;17714018;8564366
FR;1;2021-05-27;398854;128460;18112872;8692826
FR;1;2021-05-28;359519;145745;18472391;8838571
FR;1;2021-05-29;250350;81092;18722741;8919663
FR;1;2021-05-30;99062;22619;18821803;8942282
FR;1;2021-05-31;309144;148973;19130947;9091255
FR;1;2021-06-01;345933;166978;19476880;9258233
FR;1;2021-06-02;347452;153501;19824332;9411734
FR;1;2021-06-03;378112;147942;20202444;9559676
FR;1;2021-06-04;351304;175826;20553748;9735502
FR;1;2021-06-05;252897;112887;20806645;9848389
FR;1;2021-06-06;123040;37572;20929685;9885961
FR;1;2021-06-07;289728;208381;21219413;10094342
FR;1;2021-06-08;323679;224327;21543092;10318669
FR;1;2021-06-09;322348;216751;21865440;10535420
FR;1;2021-06-10;326480;202541;22191920;10737961
FR;1;2021-06-11;300983;235696;22492903;10973657
FR;1;2021-06-12;237431;150987;22730334;11124644
FR;1;2021-06-13;97314;61135;22827648;11185779
FR;1;2021-06-14;197300;289339;23024948;11475118
FR;1;2021-06-15;242616;282768;23267564;11757886
FR;2;2020-12-27;0;0;0;0
FR;2;2020-12-28;0;0;0;0
FR;2;2020-12-29;0;0;0;0
FR;2;2020-12-30;0;0;0;0
FR;2;2020-12-31;0;0;0;0
FR;2;2021-01-01;0;0;0;0
FR;2;2021-01-02;0;0;0;0
FR;2;2021-01-03;0;0;0;0
FR;2;2021-01-04;0;0;0;0
FR;2;2021-01-05;0;0;0;0
FR;2;2021-01-06;0;0;0;0
FR;2;2021-01-07;0;0;0;0
FR;2;2021-01-08;0;0;0;0
FR;2;2021-01-09;0;0;0;0
FR;2;2021-01-10;0;0;0;0
FR;2;2021-01-11;0;0;0;0
FR;2;2021-01-12;0;0;0;0
FR;2;2021-01-13;0;0;0;0
FR;2;2021-01-14;152;0;152;0
FR;2;2021-01-15;218;0;370;0
FR;2;2021-01-16;186;0;556;0
FR;2;2021-01-17;3;0;559;0
FR;2;2021-01-18;2914;0;3473;0
FR;2;2021-01-19;4514;0;7987;0
FR;2;2021-01-20;4921;0;12908;0
FR;2;2021-01-21;5126;0;18034;0
FR;2;2021-01-22;4881;0;22915;0
FR;2;2021-01-23;1734;0;24649;0
FR;2;2021-01-24;102;0;24751;0
FR;2;2021-01-25;3635;0;28386;0
FR;2;2021-01-26;3750;0;32136;0
FR;2;2021-01-27;3440;0;35576;0
FR;2;2021-01-28;3514;0;39090;0
FR;2;2021-01-29;3082;0;42172;0
FR;2;2021-01-30;1064;0;43236;0
FR;2;2021-01-31;0;0;43236;0
FR;2;2021-02-01;3259;0;46495;0
FR;2;2021-02-02;4308;0;50803;0
FR;2;2021-02-03;5031;0;55834;0
FR;2;2021-02-04;4735;4;60569;4
FR;2;2021-02-05;4620;6;65189;10
FR;2;2021-02-06;1930;3;67119;13
FR;2;2021-02-07;42;0;67161;13
FR;2;2021-02-08;7427;8;74588;21
FR;2;2021-02-09;8258;16;82846;37
FR;2;2021-02-10;9141;49;91987;86
FR;2;2021-02-11;10056;67;102043;153
FR;2;2021-02-12;9815;238;111858;391
FR;2;2021-02-13;3016;222;114874;613
FR;2;2021-02-14;296;0;115170;613
FR;2;2021-02-15;3359;3067;118529;3680
FR;2;2021-02-16;4909;3881;123438;7561
FR;2;2021-02-17;4104;4403;127542;11964
FR;2;2021-02-18;5234;5089;132776;17053
FR;2;2021-02-19;5213;4323;137989;21376
FR;2;2021-02-20;1764;1509;139753;22885
FR;2;2021-02-21;197;86;139950;22971
FR;2;2021-02-22;3515;3723;143465;26694
FR;2;2021-02-23;4837;3693;148302;30387
FR;2;2021-02-24;4757;3468;153059;33855
FR;2;2021-02-25;5293;3426;158352;37281
FR;2;2021-02-26;4197;3125;162549;40406
FR;2;2021-02-27;1502;1042;164051;41448
FR;2;2021-02-28;99;28;164150;41476
FR;2;2021-03-01;4960;3764;169110;45240
FR;2;2021-03-02;6308;4728;175418;49968
FR;2;2021-03-03;6244;4883;181662;54851
FR;2;2021-03-04;8072;3967;189734;58818
FR;2;2021-03-05;7769;4060;197503;62878
FR;2;2021-03-06;4621;1682;202124;64560
FR;2;2021-03-07;2284;29;204408;64589
FR;2;2021-03-08;3973;8310;208381;72899
FR;2;2021-03-09;7265;8429;215646;81328
FR;2;2021-03-10;6862;9109;222508;90437
FR;2;2021-03-11;9084;9208;231592;99645
FR;2;2021-03-12;7716;8170;239308;107815
FR;2;2021-03-13;9872;2511;249180;110326
FR;2;2021-03-14;4753;402;253933;110728
FR;2;2021-03-15;10651;3484;264584;114212
FR;2;2021-03-16;16456;4621;281040;118833
FR;2;2021-03-17;19897;3952;300937;122785
FR;2;2021-03-18;22958;4910;323895;127695
FR;2;2021-03-19;22884;4538;346779;132233
FR;2;2021-03-20;25145;1540;371924;133773
FR;2;2021-03-21;17472;147;389396;133920
FR;2;2021-03-22;17397;3078;406793;136998
FR;2;2021-03-23;22268;4183;429061;141181
FR;2;2021-03-24;23552;4988;452613;146169
FR;2;2021-03-25;26279;5022;478892;151191
FR;2;2021-03-26;26589;4261;505481;155452
FR;2;2021-03-27;15639;1309;521120;156761
FR;2;2021-03-28;10395;94;531515;156855
FR;2;2021-03-29;18649;4281;550164;161136
FR;2;2021-03-30;24173;6002;574337;167138
FR;2;2021-03-31;28124;5959;602461;173097
FR;2;2021-04-01;33980;8495;636441;181592
FR;2;2021-04-02;29556;7662;665997;189254
FR;2;2021-04-03;16729;3582;682726;192836
FR;2;2021-04-04;9161;918;691887;193754
FR;2;2021-04-05;12122;811;704009;194565
FR;2;2021-04-06;26767;6933;730776;201498
FR;2;2021-04-07;30583;7174;761359;208672
FR;2;2021-04-08;36497;8818;797856;217490
FR;2;2021-04-09;33394;8602;831250;226092
FR;2;2021-04-10;19447;8969;850697;235061
FR;2;2021-04-11;7815;4272;858512;239333
FR;2;2021-04-12;16805;11255;875317;250588
FR;2;2021-04-13;19110;16426;894427;267014
FR;2;2021-04-14;17661;16285;912088;283299
FR;2;2021-04-15;21847;20757;933935;304056
FR;2;2021-04-16;20387;20073;954322;324129
FR;2;2021-04-17;13054;22462;967376;346591
FR;2;2021-04-18;5785;14405;973161;360996
FR;2;2021-04-19;16484;16263;989645;377259
FR;2;2021-04-20;18993;21595;1008638;398854
FR;2;2021-04-21;19747;21665;1028385;420519
FR;2;2021-04-22;23411;24863;1051796;445382
FR;2;2021-04-23;24214;25352;1076010;470734
FR;2;2021-04-24;25104;15111;1101114;485845
FR;2;2021-04-25;9496;8589;1110610;494434
FR;2;2021-04-26;16903;17196;1127513;511630
FR;2;2021-04-27;19023;24307;1146536;535937
FR;2;2021-04-28;21856;26189;1168392;562126
FR;2;2021-04-29;25181;30137;1193573;592263
FR;2;2021-04-30;25317;27782;1218890;620045
FR;2;2021-05-01;14795;9863;1233685;629908
FR;2;2021-05-02;6517;9184;1240202;639092
FR;2;2021-05-03;19566;19328;1259768;658420
FR;2;2021-05-04;18034;29056;1277802;687476
FR;2;2021-05-05;17950;29415;1295752;716891
FR;2;2021-05-06;23196;35293;1318948;752184
FR;2;2021-05-07;24804;33243;1343752;785427
FR;2;2021-05-08;20222;9704;1363974;795131
FR;2;2021-05-09;12965;7894;1376939;803025
FR;2;2021-05-10;32257;22223;1409196;825248
FR;2;2021-05-11;42991;21078;1452187;846326
FR;2;2021-05-12;48942;19907;1501129;866233
FR;2;2021-05-13;50494;5770;1551623;872003
FR;2;2021-05-14;60469;12957;1612092;884960
FR;2;2021-05-15;65207;7153;1677299;892113
FR;2;2021-05-16;42950;2575;1720249;894688
FR;2;2021-05-17;44079;12591;1764328;907279
FR;2;2021-05-18;53420;12256;1817748;919535
FR;2;2021-05-19;56166;10636;1873914;930171
FR;2;2021-05-20;62447;10900;1936361;941071
FR;2;2021-05-21;63197;11686;1999558;952757
FR;2;2021-05-22;60744;4528;2060302;957285
FR;2;2021-05-23;36921;577;2097223;957862
FR;2;2021-05-24;16821;2033;2114044;959895
FR;2;2021-05-25;20514;12244;2134558;972139
FR;2;2021-05-26;19053;11469;2153611;983608
FR;2;2021-05-27;22386;12669;2175997;996277
FR;2;2021-05-28;28730;14991;2204727;1011268
FR;2;2021-05-29;29956;8191;2234683;1019459
FR;2;2021-05-30;4468;1811;2239151;1021270
FR;2;2021-05-31;27984;18761;2267135;1040031
FR;2;2021-06-01;44169;20077;2311304;1060108
FR;2;2021-06-02;36393;19319;2347697;1079427
FR;2;2021-06-03;50242;23409;2397939;1102836
FR;2;2021-06-04;64349;24107;2462288;1126943
FR;2;2021-06-05;33777;24053;2496065;1150996
FR;2;2021-06-06;4724;6206;2500789;1157202
FR;2;2021-06-07;27471;23113;2528260;1180315
FR;2;2021-06-08;45524;23268;2573784;1203583
FR;2;2021-06-09;32773;21511;2606557;1225094
FR;2;2021-06-10;40833;19162;2647390;1244256
FR;2;2021-06-11;53855;25257;2701245;1269513
FR;2;2021-06-12;29619;19823;2730864;1289336
FR;2;2021-06-13;3058;9189;2733922;1298525
FR;2;2021-06-14;24403;24197;2758325;1322722
FR;2;2021-06-15;37385;22897;2795710;1345619
FR;3;2020-12-27;0;0;0;0
FR;3;2020-12-28;0;0;0;0
FR;3;2020-12-29;0;0;0;0
FR;3;2020-12-30;0;0;0;0
FR;3;2020-12-31;0;0;0;0
FR;3;2021-01-01;0;0;0;0
FR;3;2021-01-02;0;0;0;0
FR;3;2021-01-03;0;0;0;0
FR;3;2021-01-04;0;0;0;0
FR;3;2021-01-05;0;0;0;0
FR;3;2021-01-06;0;0;0;0
FR;3;2021-01-07;0;0;0;0
FR;3;2021-01-08;0;0;0;0
FR;3;2021-01-09;0;0;0;0
FR;3;2021-01-10;0;0;0;0
FR;3;2021-01-11;0;0;0;0
FR;3;2021-01-12;0;0;0;0
FR;3;2021-01-13;0;0;0;0
FR;3;2021-01-14;0;0;0;0
FR;3;2021-01-15;0;0;0;0
FR;3;2021-01-16;0;0;0;0
FR;3;2021-01-17;0;0;0;0
FR;3;2021-01-18;0;0;0;0
FR;3;2021-01-19;0;0;0;0
FR;3;2021-01-20;0;0;0;0
FR;3;2021-01-21;0;0;0;0
FR;3;2021-01-22;0;0;0;0
FR;3;2021-01-23;0;0;0;0
FR;3;2021-01-24;0;0;0;0
FR;3;2021-01-25;0;0;0;0
FR;3;2021-01-26;0;0;0;0
FR;3;2021-01-27;0;0;0;0
FR;3;2021-01-28;0;0;0;0
FR;3;2021-01-29;0;0;0;0
FR;3;2021-01-30;0;0;0;0
FR;3;2021-01-31;0;0;0;0
FR;3;2021-02-01;0;0;0;0
FR;3;2021-02-02;0;0;0;0
FR;3;2021-02-03;0;0;0;0
FR;3;2021-02-04;0;0;0;0
FR;3;2021-02-05;0;0;0;0
FR;3;2021-02-06;328;0;328;0
FR;3;2021-02-07;1348;0;1676;0
FR;3;2021-02-08;2635;0;4311;0
FR;3;2021-02-09;6643;0;10954;0
FR;3;2021-02-10;9240;0;20194;0
FR;3;2021-02-11;13355;0;33549;0
FR;3;2021-02-12;13048;0;46597;0
FR;3;2021-02-13;3517;0;50114;0
FR;3;2021-02-14;868;0;50982;0
FR;3;2021-02-15;10128;0;61110;0
FR;3;2021-02-16;12177;0;73287;0
FR;3;2021-02-17;10818;0;84105;0
FR;3;2021-02-18;14580;0;98685;0
FR;3;2021-02-19;14121;0;112806;0
FR;3;2021-02-20;3181;0;115987;0
FR;3;2021-02-21;544;0;116531;0
FR;3;2021-02-22;8916;0;125447;0
FR;3;2021-02-23;11113;0;136560;0
FR;3;2021-02-24;13904;0;150464;0
FR;3;2021-02-25;44403;0;194867;0
FR;3;2021-02-26;61430;0;256297;0
FR;3;2021-02-27;34485;8;290782;8
FR;3;2021-02-28;2347;0;293129;8
FR;3;2021-03-01;19948;9;313077;17
FR;3;2021-03-02;38363;14;351440;31
FR;3;2021-03-03;47921;18;399361;49
FR;3;2021-03-04;81244;23;480605;72
FR;3;2021-03-05;117101;61;597706;133
FR;3;2021-03-06;119199;53;716905;186
FR;3;2021-03-07;54616;28;771521;214
FR;3;2021-03-08;42145;21;813666;235
FR;3;2021-03-09;78108;31;891774;266
FR;3;2021-03-10;79909;39;971683;305
FR;3;2021-03-11;127289;49;1098972;354
FR;3;2021-03-12;181354;70;1280326;424
FR;3;2021-03-13;131107;56;1411433;480
FR;3;2021-03-14;13787;4;1425220;484
FR;3;2021-03-15;51472;38;1476692;522
FR;3;2021-03-16;926;13;1477618;535
FR;3;2021-03-17;654;6;1478272;541
FR;3;2021-03-18;1208;4;1479480;545
FR;3;2021-03-19;69743;36;1549223;581
FR;3;2021-03-20;64626;38;1613849;619
FR;3;2021-03-21;5516;4;1619365;623
FR;3;2021-03-22;36890;32;1656255;655
FR;3;2021-03-23;83756;50;1740011;705
FR;3;2021-03-24;90011;93;1830022;798
FR;3;2021-03-25;148778;116;1978800;914
FR;3;2021-03-26;164161;157;2142961;1071
FR;3;2021-03-27;67619;90;2210580;1161
FR;3;2021-03-28;6232;19;2216812;1180
FR;3;2021-03-29;53515;61;2270327;1241
FR;3;2021-03-30;92287;88;2362614;1329
FR;3;2021-03-31;62638;83;2425252;1412
FR;3;2021-04-01;85033;104;2510285;1516
FR;3;2021-04-02;86013;147;2596298;1663
FR;3;2021-04-03;35304;109;2631602;1772
FR;3;2021-04-04;3391;15;2634993;1787
FR;3;2021-04-05;4240;21;2639233;1808
FR;3;2021-04-06;29036;76;2668269;1884
FR;3;2021-04-07;31600;60;2699869;1944
FR;3;2021-04-08;77647;234;2777516;2178
FR;3;2021-04-09;160179;410;2937695;2588
FR;3;2021-04-10;74695;331;3012390;2919
FR;3;2021-04-11;7039;44;3019429;2963
FR;3;2021-04-12;50629;197;3070058;3160
FR;3;2021-04-13;85167;315;3155225;3475
FR;3;2021-04-14;66601;341;3221826;3816
FR;3;2021-04-15;91743;369;3313569;4185
FR;3;2021-04-16;111108;571;3424677;4756
FR;3;2021-04-17;52343;327;3477020;5083
FR;3;2021-04-18;9438;34;3486458;5117
FR;3;2021-04-19;24471;234;3510929;5351
FR;3;2021-04-20;44844;395;3555773;5746
FR;3;2021-04-21;38052;450;3593825;6196
FR;3;2021-04-22;53714;791;3647539;6987
FR;3;2021-04-23;69472;1019;3717011;8006
FR;3;2021-04-24;36527;976;3753538;8982
FR;3;2021-04-25;5916;158;3759454;9140
FR;3;2021-04-26;19091;662;3778545;9802
FR;3;2021-04-27;33717;1246;3812262;11048
FR;3;2021-04-28;28281;1925;3840543;12973
FR;3;2021-04-29;44562;5956;3885105;18929
FR;3;2021-04-30;54595;8932;3939700;27861
FR;3;2021-05-01;9176;1968;3948876;29829
FR;3;2021-05-02;2797;500;3951673;30329
FR;3;2021-05-03;12517;3881;3964190;34210
FR;3;2021-05-04;22437;8455;3986627;42665
FR;3;2021-05-05;18045;10574;4004672;53239
FR;3;2021-05-06;33871;20906;4038543;74145
FR;3;2021-05-07;43369;28412;4081912;102557
FR;3;2021-05-08;6353;8901;4088265;111458
FR;3;2021-05-09;1563;2655;4089828;114113
FR;3;2021-05-10;14424;12566;4104252;126679
FR;3;2021-05-11;26392;25738;4130644;152417
FR;3;2021-05-12;16705;27453;4147349;179870
FR;3;2021-05-13;2001;3480;4149350;183350
FR;3;2021-05-14;14060;25742;4163410;209092
FR;3;2021-05-15;6911;20734;4170321;229826
FR;3;2021-05-16;811;2680;4171132;232506
FR;3;2021-05-17;7504;19915;4178636;252421
FR;3;2021-05-18;12900;29634;4191536;282055
FR;3;2021-05-19;8798;31865;4200334;313920
FR;3;2021-05-20;12268;53220;4212602;367140
FR;3;2021-05-21;12242;65541;4224844;432681
FR;3;2021-05-22;4663;33300;4229507;465981
FR;3;2021-05-23;535;2665;4230042;468646
FR;3;2021-05-24;580;4920;4230622;473566
FR;3;2021-05-25;4899;45189;4235521;518755
FR;3;2021-05-26;4555;51055;4240076;569810
FR;3;2021-05-27;5937;77849;4246013;647659
FR;3;2021-05-28;7128;99104;4253141;746763
FR;3;2021-05-29;3067;60285;4256208;807048
FR;3;2021-05-30;379;8243;4256587;815291
FR;3;2021-05-31;2060;35999;4258647;851290
FR;3;2021-06-01;2971;64820;4261618;916110
FR;3;2021-06-02;2351;58360;4263969;974470
FR;3;2021-06-03;3176;87588;4267145;1062058
FR;3;2021-06-04;3839;105129;4270984;1167187
FR;3;2021-06-05;1752;52247;4272736;1219434
FR;3;2021-06-06;264;5400;4273000;1224834
FR;3;2021-06-07;1090;31183;4274090;1256017
FR;3;2021-06-08;2224;47890;4276314;1303907
FR;3;2021-06-09;1396;42455;4277710;1346362
FR;3;2021-06-10;1864;68014;4279574;1414376
FR;3;2021-06-11;2206;96814;4281780;1511190
FR;3;2021-06-12;995;40840;4282775;1552030
FR;3;2021-06-13;135;3823;4282910;1555853
FR;3;2021-06-14;727;42672;4283637;1598525
FR;3;2021-06-15;1136;80696;4284773;1679221
FR;4;2020-12-27;0;0;0;0
FR;4;2020-12-28;0;0;0;0
FR;4;2020-12-29;0;0;0;0
FR;4;2020-12-30;0;0;0;0
FR;4;2020-12-31;0;0;0;0
FR;4;2021-01-01;0;0;0;0
FR;4;2021-01-02;0;0;0;0
FR;4;2021-01-03;0;0;0;0
FR;4;2021-01-04;0;0;0;0
FR;4;2021-01-05;0;0;0;0
FR;4;2021-01-06;0;0;0;0
FR;4;2021-01-07;0;0;0;0
FR;4;2021-01-08;0;0;0;0
FR;4;2021-01-09;0;0;0;0
FR;4;2021-01-10;0;0;0;0
FR;4;2021-01-11;0;0;0;0
FR;4;2021-01-12;0;0;0;0
FR;4;2021-01-13;0;0;0;0
FR;4;2021-01-14;0;0;0;0
FR;4;2021-01-15;0;0;0;0
FR;4;2021-01-16;0;0;0;0
FR;4;2021-01-17;0;0;0;0
FR;4;2021-01-18;0;0;0;0
FR;4;2021-01-19;0;0;0;0
FR;4;2021-01-20;0;0;0;0
FR;4;2021-01-21;0;0;0;0
FR;4;2021-01-22;0;0;0;0
FR;4;2021-01-23;0;0;0;0
FR;4;2021-01-24;0;0;0;0
FR;4;2021-01-25;0;0;0;0
FR;4;2021-01-26;0;0;0;0
FR;4;2021-01-27;0;0;0;0
FR;4;2021-01-28;0;0;0;0
FR;4;2021-01-29;0;0;0;0
FR;4;2021-01-30;0;0;0;0
FR;4;2021-01-31;0;0;0;0
FR;4;2021-02-01;0;0;0;0
FR;4;2021-02-02;0;0;0;0
FR;4;2021-02-03;0;0;0;0
FR;4;2021-02-04;0;0;0;0
FR;4;2021-02-05;0;0;0;0
FR;4;2021-02-06;0;0;0;0
FR;4;2021-02-07;0;0;0;0
FR;4;2021-02-08;0;0;0;0
FR;4;2021-02-09;0;0;0;0
FR;4;2021-02-10;0;0;0;0
FR;4;2021-02-11;0;0;0;0
FR;4;2021-02-12;0;0;0;0
FR;4;2021-02-13;0;0;0;0
FR;4;2021-02-14;0;0;0;0
FR;4;2021-02-15;0;0;0;0
FR;4;2021-02-16;0;0;0;0
FR;4;2021-02-17;0;0;0;0
FR;4;2021-02-18;0;0;0;0
FR;4;2021-02-19;0;0;0;0
FR;4;2021-02-20;0;0;0;0
FR;4;2021-02-21;0;0;0;0
FR;4;2021-02-22;0;0;0;0
FR;4;2021-02-23;0;0;0;0
FR;4;2021-02-24;0;0;0;0
FR;4;2021-02-25;0;0;0;0
FR;4;2021-02-26;0;0;0;0
FR;4;2021-02-27;0;0;0;0
FR;4;2021-02-28;0;0;0;0
FR;4;2021-03-01;0;0;0;0
FR;4;2021-03-02;0;0;0;0
FR;4;2021-03-03;0;0;0;0
FR;4;2021-03-04;0;0;0;0
FR;4;2021-03-05;0;0;0;0
FR;4;2021-03-06;0;0;0;0
FR;4;2021-03-07;0;0;0;0
FR;4;2021-03-08;0;0;0;0
FR;4;2021-03-09;0;0;0;0
FR;4;2021-03-10;0;0;0;0
FR;4;2021-03-11;0;0;0;0
FR;4;2021-03-12;0;0;0;0
FR;4;2021-03-13;0;0;0;0
FR;4;2021-03-14;0;0;0;0
FR;4;2021-03-15;0;0;0;0
FR;4;2021-03-16;0;0;0;0
FR;4;2021-03-17;0;0;0;0
FR;4;2021-03-18;0;0;0;0
FR;4;2021-03-19;0;0;0;0
FR;4;2021-03-20;0;0;0;0
FR;4;2021-03-21;0;0;0;0
FR;4;2021-03-22;0;0;0;0
FR;4;2021-03-23;0;0;0;0
FR;4;2021-03-24;0;0;0;0
FR;4;2021-03-25;0;0;0;0
FR;4;2021-03-26;0;0;0;0
FR;4;2021-03-27;0;0;0;0
FR;4;2021-03-28;0;0;0;0
FR;4;2021-03-29;0;0;0;0
FR;4;2021-03-30;0;0;0;0
FR;4;2021-03-31;0;0;0;0
FR;4;2021-04-01;0;0;0;0
FR;4;2021-04-02;0;0;0;0
FR;4;2021-04-03;0;0;0;0
FR;4;2021-04-04;0;0;0;0
FR;4;2021-04-05;0;0;0;0
FR;4;2021-04-06;0;0;0;0
FR;4;2021-04-07;0;0;0;0
FR;4;2021-04-08;0;0;0;0
FR;4;2021-04-09;0;0;0;0
FR;4;2021-04-10;0;0;0;0
FR;4;2021-04-11;0;0;0;0
FR;4;2021-04-12;0;0;0;0
FR;4;2021-04-13;0;0;0;0
FR;4;2021-04-14;0;0;0;0
FR;4;2021-04-15;0;0;0;0
FR;4;2021-04-16;0;0;0;0
FR;4;2021-04-17;0;0;0;0
FR;4;2021-04-18;0;0;0;0
FR;4;2021-04-19;0;0;0;0
FR;4;2021-04-20;0;0;0;0
FR;4;2021-04-21;0;0;0;0
FR;4;2021-04-22;0;0;0;0
FR;4;2021-04-23;792;0;792;0
FR;4;2021-04-24;1552;0;2344;0
FR;4;2021-04-25;117;0;2461;0
FR;4;2021-04-26;2829;0;5290;0
FR;4;2021-04-27;9384;4;14674;4
FR;4;2021-04-28;9770;3;24444;7
FR;4;2021-04-29;15884;7;40328;14
FR;4;2021-04-30;19081;7;59409;21
FR;4;2021-05-01;1897;5;61306;26
FR;4;2021-05-02;440;0;61746;26
FR;4;2021-05-03;4928;1;66674;27
FR;4;2021-05-04;8249;8;74923;35
FR;4;2021-05-05;6002;7;80925;42
FR;4;2021-05-06;11256;11;92181;53
FR;4;2021-05-07;18904;8;111085;61
FR;4;2021-05-08;2258;5;113343;66
FR;4;2021-05-09;629;2;113972;68
FR;4;2021-05-10;7092;8;121064;76
FR;4;2021-05-11;14112;12;135176;88
FR;4;2021-05-12;9950;14;145126;102
FR;4;2021-05-13;1440;2;146566;104
FR;4;2021-05-14;7597;8;154163;112
FR;4;2021-05-15;3585;9;157748;121
FR;4;2021-05-16;356;1;158104;122
FR;4;2021-05-17;4258;2;162362;124
FR;4;2021-05-18;8578;10;170940;134
FR;4;2021-05-19;5515;5;176455;139
FR;4;2021-05-20;9186;6;185641;145
FR;4;2021-05-21;12512;26;198153;171
FR;4;2021-05-22;4927;13;203080;184
FR;4;2021-05-23;423;2;203503;186
FR;4;2021-05-24;937;3;204440;189
FR;4;2021-05-25;7395;16;211835;205
FR;4;2021-05-26;7547;12;219382;217
FR;4;2021-05-27;14083;34;233465;251
FR;4;2021-05-28;26234;74;259699;325
FR;4;2021-05-29;11123;18;270822;343
FR;4;2021-05-30;859;2;271681;345
FR;4;2021-05-31;12425;20;284106;365
FR;4;2021-06-01;19782;42;303888;407
FR;4;2021-06-02;14190;34;318078;441
FR;4;2021-06-03;19110;24;337188;465
FR;4;2021-06-04;22039;45;359227;510
FR;4;2021-06-05;9410;28;368637;538
FR;4;2021-06-06;909;0;369546;538
FR;4;2021-06-07;8871;16;378417;554
FR;4;2021-06-08;14172;51;392589;605
FR;4;2021-06-09;11467;423;404056;1028
FR;4;2021-06-10;14880;28;418936;1056
FR;4;2021-06-11;16479;53;435415;1109
FR;4;2021-06-12;7116;26;442531;1135
FR;4;2021-06-13;800;8;443331;1143
FR;4;2021-06-14;6261;22;449592;1165
FR;4;2021-06-15;10254;31;459846;1196
FR;0;2020-12-27;20;0;20;0
FR;0;2020-12-28;71;0;91;0
FR;0;2020-12-29;108;0;199;0
FR;0;2020-12-30;123;0;322;0
FR;0;2020-12-31;87;0;409;0
FR;0;2021-01-01;73;0;482;0
FR;0;2021-01-02;88;0;570;0
FR;0;2021-01-03;92;0;662;0
FR;0;2021-01-04;1479;0;2141;0
FR;0;2021-01-05;5409;0;7550;0
FR;0;2021-01-06;11318;0;18868;0
FR;0;2021-01-07;28572;0;47440;0
FR;0;2021-01-08;36280;0;83720;0
FR;0;2021-01-09;10937;0;94657;0
FR;0;2021-01-10;5632;0;100289;0
FR;0;2021-01-11;39089;0;139378;0
FR;0;2021-01-12;60973;0;200351;0
FR;0;2021-01-13;63920;0;264271;0
FR;0;2021-01-14;79969;0;344240;0
FR;0;2021-01-15;67569;0;411809;0
FR;0;2021-01-16;19742;87;431551;87
FR;0;2021-01-17;10473;42;442024;129
FR;0;2021-01-18;84473;164;526497;293
FR;0;2021-01-19;128542;128;655039;421
FR;0;2021-01-20;135349;160;790388;581
FR;0;2021-01-21;155540;141;945928;722
FR;0;2021-01-22;118741;163;1064669;885
FR;0;2021-01-23;37856;52;1102525;937
FR;0;2021-01-24;9369;28;1111894;965
FR;0;2021-01-25;76891;1219;1188785;2184
FR;0;2021-01-26;98920;3113;1287705;5297
FR;0;2021-01-27;105708;5599;1393413;10896
FR;0;2021-01-28;122449;14361;1515862;25257
FR;0;2021-01-29;90938;17293;1606800;42550
FR;0;2021-01-30;28657;4225;1635457;46775
FR;0;2021-01-31;4872;1679;1640329;48454
FR;0;2021-02-01;51620;21128;1691949;69582
FR;0;2021-02-02;70739;34568;1762688;104150
FR;0;2021-02-03;71023;36961;1833711;141111
FR;0;2021-02-04;80668;50063;1914379;191174
FR;0;2021-02-05;67182;45343;1981561;236517
FR;0;2021-02-06;21348;10399;2002909;246916
FR;0;2021-02-07;4826;5041;2007735;251957
FR;0;2021-02-08;45910;45994;2053645;297951
FR;0;2021-02-09;64839;72408;2118484;370359
FR;0;2021-02-10;69338;76695;2187822;447054
FR;0;2021-02-11;85698;99144;2273520;546198
FR;0;2021-02-12;77824;74276;2351344;620474
FR;0;2021-02-13;21713;19492;2373057;639966
FR;0;2021-02-14;4596;7190;2377653;647156
FR;0;2021-02-15;37087;76507;2414740;723663
FR;0;2021-02-16;49229;100746;2463969;824409
FR;0;2021-02-17;49312;102972;2513281;927381
FR;0;2021-02-18;68047;118563;2581328;1045944
FR;0;2021-02-19;63851;90737;2645179;1136681
FR;0;2021-02-20;18011;28429;2663190;1165110
FR;0;2021-02-21;2860;6373;2666050;1171483
FR;0;2021-02-22;36543;73138;2702593;1244621
FR;0;2021-02-23;52690;84059;2755283;1328680
FR;0;2021-02-24;58145;81130;2813428;1409810
FR;0;2021-02-25;98765;91420;2912193;1501230
FR;0;2021-02-26;111804;71013;3023997;1572243
FR;0;2021-02-27;51234;21981;3075231;1594224
FR;0;2021-02-28;5680;4414;3080911;1598638
FR;0;2021-03-01;63695;52804;3144606;1651442
FR;0;2021-03-02;99442;66247;3244048;1717689
FR;0;2021-03-03;113830;65554;3357878;1783243
FR;0;2021-03-04;160668;68884;3518546;1852127
FR;0;2021-03-05;198161;63395;3716707;1915522
FR;0;2021-03-06;205270;17829;3921977;1933351
FR;0;2021-03-07;119899;5481;4041876;1938832
FR;0;2021-03-08;105022;50811;4146898;1989643
FR;0;2021-03-09;169944;56778;4316842;2046421
FR;0;2021-03-10;175919;57215;4492761;2103636
FR;0;2021-03-11;239774;63123;4732535;2166759
FR;0;2021-03-12;291365;53510;5023900;2220269
FR;0;2021-03-13;228847;15289;5252747;2235558
FR;0;2021-03-14;62287;3437;5315034;2238995
FR;0;2021-03-15;156124;32674;5471158;2271669
FR;0;2021-03-16;139463;39542;5610621;2311211
FR;0;2021-03-17;148216;38827;5758837;2350038
FR;0;2021-03-18;165310;44670;5924147;2394708
FR;0;2021-03-19;227084;37488;6151231;2432196
FR;0;2021-03-20;164843;11790;6316074;2443986
FR;0;2021-03-21;48762;2628;6364836;2446614
FR;0;2021-03-22;167362;34301;6532198;2480915
FR;0;2021-03-23;247133;42409;6779331;2523324
FR;0;2021-03-24;253575;43872;7032906;2567196
FR;0;2021-03-25;337975;44758;7370881;2611954
FR;0;2021-03-26;355156;41918;7726037;2653872
FR;0;2021-03-27;193206;16659;7919243;2670531
FR;0;2021-03-28;58364;3737;7977607;2674268
FR;0;2021-03-29;200597;54311;8178204;2728579
FR;0;2021-03-30;282199;69690;8460403;2798269
FR;0;2021-03-31;259734;72958;8720137;2871227
FR;0;2021-04-01;310356;87855;9030493;2959082
FR;0;2021-04-02;277979;92128;9308472;3051210
FR;0;2021-04-03;139198;61879;9447670;3113089
FR;0;2021-04-04;44886;18666;9492556;3131755
FR;0;2021-04-05;58790;11010;9551346;3142765
FR;0;2021-04-06;213599;107900;9764945;3250665
FR;0;2021-04-07;256430;115506;10021375;3366171
FR;0;2021-04-08;332958;121458;10354333;3487629
FR;0;2021-04-09;405236;116532;10759569;3604161
FR;0;2021-04-10;210129;82765;10969698;3686926
FR;0;2021-04-11;54894;34604;11024592;3721530
FR;0;2021-04-12;233944;115249;11258536;3836779
FR;0;2021-04-13;305358;145004;11563894;3981783
FR;0;2021-04-14;289715;139446;11853609;4121229
FR;0;2021-04-15;331853;147892;12185462;4269121
FR;0;2021-04-16;335307;145799;12520769;4414920
FR;0;2021-04-17;186342;90279;12707111;4505199
FR;0;2021-04-18;50442;35434;12757553;4540633
FR;0;2021-04-19;202825;138432;12960378;4679065
FR;0;2021-04-20;250909;170794;13211287;4849859
FR;0;2021-04-21;249405;168876;13460692;5018735
FR;0;2021-04-22;283462;188306;13744154;5207041
FR;0;2021-04-23;291051;183311;14035205;5390352
FR;0;2021-04-24;188155;111607;14223360;5501959
FR;0;2021-04-25;68399;38887;14291759;5540846
FR;0;2021-04-26;218008;156140;14509767;5696986
FR;0;2021-04-27;281086;187568;14790853;5884554
FR;0;2021-04-28;295971;183259;15086824;6067813
FR;0;2021-04-29;353063;196193;15439887;6264006
FR;0;2021-04-30;368197;184904;15808084;6448910
FR;0;2021-05-01;164019;52555;15972103;6501465
FR;0;2021-05-02;90168;37849;16062271;6539314
FR;0;2021-05-03;284097;169759;16346368;6709073
FR;0;2021-05-04;310882;224397;16657250;6933470
FR;0;2021-05-05;319651;224600;16976901;7158070
FR;0;2021-05-06;372977;239284;17349878;7397354
FR;0;2021-05-07;366905;257424;17716783;7654778
FR;0;2021-05-08;210822;66950;17927605;7721728
FR;0;2021-05-09;127680;46785;18055285;7768513
FR;0;2021-05-10;304502;229091;18359787;7997604
FR;0;2021-05-11;396888;258287;18756675;8255891
FR;0;2021-05-12;423074;233334;19179749;8489225
FR;0;2021-05-13;331598;56937;19511347;8546162
FR;0;2021-05-14;446116;167653;19957463;8713815
FR;0;2021-05-15;367542;94076;20325005;8807891
FR;0;2021-05-16;199435;20844;20524440;8828735
FR;0;2021-05-17;369032;149257;20893472;8977992
FR;0;2021-05-18;447668;153316;21341140;9131308
FR;0;2021-05-19;458119;145530;21799259;9276838
FR;0;2021-05-20;496890;160551;22296149;9437389
FR;0;2021-05-21;480074;174790;22776223;9612179
FR;0;2021-05-22;341821;80032;23118044;9692211
FR;0;2021-05-23;158940;14500;23276984;9706711
FR;0;2021-05-24;257269;33350;23534253;9740061
FR;0;2021-05-25;391400;189532;23925653;9929593
FR;0;2021-05-26;401434;188408;24327087;10118001
FR;0;2021-05-27;441260;219012;24768347;10337013
FR;0;2021-05-28;421611;259914;25189958;10596927
FR;0;2021-05-29;294496;149586;25484454;10746513
FR;0;2021-05-30;104768;32675;25589222;10779188
FR;0;2021-05-31;351613;203753;25940835;10982941
FR;0;2021-06-01;412855;251917;26353690;11234858
FR;0;2021-06-02;400386;231214;26754076;11466072
FR;0;2021-06-03;450640;258963;27204716;11725035
FR;0;2021-06-04;441531;305107;27646247;12030142
FR;0;2021-06-05;297836;189215;27944083;12219357
FR;0;2021-06-06;128937;49178;28073020;12268535
FR;0;2021-06-07;327160;262693;28400180;12531228
FR;0;2021-06-08;385599;295536;28785779;12826764
FR;0;2021-06-09;367984;281140;29153763;13107904
FR;0;2021-06-10;384057;289745;29537820;13397649
FR;0;2021-06-11;373523;357820;29911343;13755469
FR;0;2021-06-12;275161;211676;30186504;13967145
FR;0;2021-06-13;101307;74155;30287811;14041300
FR;0;2021-06-14;228691;356230;30516502;14397530
FR;0;2021-06-15;291391;386392;30807893;14783922
