fra;vaccin;jour;n_dose1;n_dose2;n_dose3;n_dose4;n_rappel;n_cum_dose1;n_cum_dose2;n_cum_dose3;n_cum_dose4;n_cum_rappel
FR;1;2020-12-27;601;0;0;0;0;601;0;0;0;0
FR;1;2020-12-28;663;1;0;0;0;1264;1;0;0;0
FR;1;2020-12-29;371;0;0;0;0;1635;1;0;0;0
FR;1;2020-12-30;437;0;0;0;0;2072;1;0;0;0
FR;1;2020-12-31;413;0;0;0;0;2485;1;0;0;0
FR;1;2021-01-01;1135;1;0;0;0;3620;2;0;0;0
FR;1;2021-01-02;356;3;0;0;0;3976;5;0;0;0
FR;1;2021-01-03;398;0;0;0;0;4374;5;0;0;0
FR;1;2021-01-04;2086;2;0;0;0;6460;7;0;0;0
FR;1;2021-01-05;7547;2;0;0;0;14007;9;0;0;0
FR;1;2021-01-06;12410;10;0;0;0;26417;19;0;0;0
FR;1;2021-01-07;29445;9;0;0;0;55862;28;0;0;0
FR;1;2021-01-08;37121;9;0;0;0;92983;37;0;0;0
FR;1;2021-01-09;11209;4;0;0;0;104192;41;0;0;0
FR;1;2021-01-10;5996;3;0;0;0;110188;44;0;0;0
FR;1;2021-01-11;39922;16;0;0;0;150110;60;0;0;0
FR;1;2021-01-12;62119;15;0;0;0;212229;75;0;0;0
FR;1;2021-01-13;65096;28;0;0;0;277325;103;0;0;0
FR;1;2021-01-14;81433;69;0;0;0;358758;172;0;0;0
FR;1;2021-01-15;68591;26;0;0;0;427349;198;0;0;0
FR;1;2021-01-16;19893;70;0;0;0;447242;268;0;0;0
FR;1;2021-01-17;10896;46;0;0;0;458138;314;0;0;0
FR;1;2021-01-18;82800;163;0;0;0;540938;477;0;0;0
FR;1;2021-01-19;125894;170;0;0;0;666832;647;0;0;0
FR;1;2021-01-20;132387;166;0;0;0;799219;813;0;0;0
FR;1;2021-01-21;153032;160;0;0;0;952251;973;0;0;0
FR;1;2021-01-22;115921;195;0;0;0;1068172;1168;0;0;0
FR;1;2021-01-23;36598;63;0;0;0;1104770;1231;0;0;0
FR;1;2021-01-24;9580;68;0;0;0;1114350;1299;0;0;0
FR;1;2021-01-25;74405;1260;0;0;0;1188755;2559;0;0;0
FR;1;2021-01-26;96440;3276;1;0;0;1285195;5835;1;0;0
FR;1;2021-01-27;103625;5885;0;0;0;1388820;11720;1;0;0
FR;1;2021-01-28;120577;14916;0;0;0;1509397;26636;1;0;0
FR;1;2021-01-29;88878;17691;0;0;0;1598275;44327;1;0;0
FR;1;2021-01-30;27980;4257;0;0;0;1626255;48584;1;0;0
FR;1;2021-01-31;5180;1730;0;0;0;1631435;50314;1;0;0
FR;1;2021-02-01;49704;21503;0;0;0;1681139;71817;1;0;0
FR;1;2021-02-02;67786;35620;0;0;0;1748925;107437;1;0;0
FR;1;2021-02-03;67068;37871;0;0;0;1815993;145308;1;0;0
FR;1;2021-02-04;77116;51363;0;0;0;1893109;196671;1;0;0
FR;1;2021-02-05;63406;46026;0;0;0;1956515;242697;1;0;0
FR;1;2021-02-06;19401;10747;0;0;0;1975916;253444;1;0;0
FR;1;2021-02-07;3658;5252;0;0;0;1979574;258696;1;0;0
FR;1;2021-02-08;36480;46813;0;0;0;2016054;305509;1;0;0
FR;1;2021-02-09;50788;74151;0;0;0;2066842;379660;1;0;0
FR;1;2021-02-10;52041;78953;0;0;0;2118883;458613;1;0;0
FR;1;2021-02-11;63346;100890;0;0;0;2182229;559503;1;0;0
FR;1;2021-02-12;55836;74590;0;0;0;2238065;634093;1;0;0
FR;1;2021-02-13;15450;19276;0;0;0;2253515;653369;1;0;0
FR;1;2021-02-14;3744;7166;0;0;0;2257259;660535;1;0;0
FR;1;2021-02-15;24128;73508;0;0;0;2281387;734043;1;0;0
FR;1;2021-02-16;32753;96504;0;0;0;2314140;830547;1;0;0
FR;1;2021-02-17;35093;100103;1;0;0;2349233;930650;2;0;0
FR;1;2021-02-18;49422;115051;0;0;0;2398655;1045701;2;0;0
FR;1;2021-02-19;45364;86594;1;0;0;2444019;1132295;3;0;0
FR;1;2021-02-20;13376;27067;0;0;0;2457395;1159362;3;0;0
FR;1;2021-02-21;2454;6229;0;0;0;2459849;1165591;3;0;0
FR;1;2021-02-22;24703;69381;2;0;0;2484552;1234972;5;0;0
FR;1;2021-02-23;37412;80735;1;0;0;2521964;1315707;6;0;0
FR;1;2021-02-24;40670;78133;1;0;0;2562634;1393840;7;0;0
FR;1;2021-02-25;50131;87937;1;0;0;2612765;1481777;8;0;0
FR;1;2021-02-26;47183;67594;1;0;0;2659948;1549371;9;0;0
FR;1;2021-02-27;15667;21070;0;0;0;2675615;1570441;9;0;0
FR;1;2021-02-28;3551;4265;1;0;0;2679166;1574706;10;0;0
FR;1;2021-03-01;40142;49543;1;0;0;2719308;1624249;11;0;0
FR;1;2021-03-02;55955;61817;2;0;0;2775263;1686066;13;0;0
FR;1;2021-03-03;61197;60583;0;0;0;2836460;1746649;13;0;0
FR;1;2021-03-04;72968;66042;3;0;0;2909428;1812691;16;0;0
FR;1;2021-03-05;74732;59043;3;0;0;2984160;1871734;19;0;0
FR;1;2021-03-06;82428;15999;2;0;0;3066588;1887733;21;0;0
FR;1;2021-03-07;63702;4953;1;0;0;3130290;1892686;22;0;0
FR;1;2021-03-08;60140;42050;2;0;0;3190430;1934736;24;0;0
FR;1;2021-03-09;85958;47993;1;0;0;3276388;1982729;25;0;0
FR;1;2021-03-10;90868;47944;5;0;0;3367256;2030673;30;0;0
FR;1;2021-03-11;105030;54105;1;0;0;3472286;2084778;31;0;0
FR;1;2021-03-12;104078;45102;1;0;0;3576364;2129880;32;0;0
FR;1;2021-03-13;89178;12699;1;0;0;3665542;2142579;33;0;0
FR;1;2021-03-14;44442;2917;1;0;0;3709984;2145496;34;0;0
FR;1;2021-03-15;95471;28658;3;0;0;3805455;2174154;37;0;0
FR;1;2021-03-16;123568;34479;5;0;0;3929023;2208633;42;0;0
FR;1;2021-03-17;129275;34211;4;0;0;4058298;2242844;46;0;0
FR;1;2021-03-18;142849;39574;5;0;0;4201147;2282418;51;0;0
FR;1;2021-03-19;136212;32562;2;0;0;4337359;2314980;53;0;0
FR;1;2021-03-20;75972;10010;1;0;0;4413331;2324990;54;0;0
FR;1;2021-03-21;26493;2368;1;0;0;4439824;2327358;55;0;0
FR;1;2021-03-22;114715;30827;2;0;0;4554539;2358185;57;0;0
FR;1;2021-03-23;142993;38125;1;0;0;4697532;2396310;58;0;0
FR;1;2021-03-24;141957;38616;0;0;0;4839489;2434926;58;0;0
FR;1;2021-03-25;164965;39594;4;0;0;5004454;2474520;62;0;0
FR;1;2021-03-26;166355;37471;4;1;0;5170809;2511991;66;1;0
FR;1;2021-03-27;110864;15278;1;0;0;5281673;2527269;67;1;0
FR;1;2021-03-28;42291;3851;3;0;0;5323964;2531120;70;1;0
FR;1;2021-03-29;129784;49678;4;0;0;5453748;2580798;74;1;0
FR;1;2021-03-30;167671;63519;4;0;0;5621419;2644317;78;1;0
FR;1;2021-03-31;170885;67178;4;0;0;5792304;2711495;82;1;0
FR;1;2021-04-01;194713;80517;11;0;0;5987017;2792012;93;1;0
FR;1;2021-04-02;164407;84896;7;0;0;6151424;2876908;100;1;0
FR;1;2021-04-03;88223;58032;5;0;0;6239647;2934940;105;1;0
FR;1;2021-04-04;33573;17700;0;0;0;6273220;2952640;105;1;0
FR;1;2021-04-05;46374;9986;11;0;0;6319594;2962626;116;1;0
FR;1;2021-04-06;160256;102022;17;0;0;6479850;3064648;133;1;0
FR;1;2021-04-07;196925;108169;16;0;0;6676775;3172817;149;1;0
FR;1;2021-04-08;222043;112675;13;0;0;6898818;3285492;162;1;0
FR;1;2021-04-09;214497;107321;21;0;0;7113315;3392813;183;1;0
FR;1;2021-04-10;117147;73232;14;0;0;7230462;3466045;197;1;0
FR;1;2021-04-11;40872;30139;6;0;0;7271334;3496184;203;1;0
FR;1;2021-04-12;168406;103858;45;0;0;7439740;3600042;248;1;0
FR;1;2021-04-13;203749;128017;97;1;0;7643489;3728059;345;2;0
FR;1;2021-04-14;208536;122652;206;0;0;7852025;3850711;551;2;0
FR;1;2021-04-15;221599;126996;311;0;0;8073624;3977707;862;2;0
FR;1;2021-04-16;206001;125153;307;0;0;8279625;4102860;1169;2;0
FR;1;2021-04-17;122055;67295;102;0;0;8401680;4170155;1271;2;0
FR;1;2021-04-18;35953;20943;41;0;0;8437633;4191098;1312;2;0
FR;1;2021-04-19;163705;121701;430;0;0;8601338;4312799;1742;2;0
FR;1;2021-04-20;189353;148768;530;0;0;8790691;4461567;2272;2;0
FR;1;2021-04-21;193927;146874;758;0;0;8984618;4608441;3030;2;0
FR;1;2021-04-22;208972;162962;777;0;0;9193590;4771403;3807;2;0
FR;1;2021-04-23;198911;157012;671;0;0;9392501;4928415;4478;2;0
FR;1;2021-04-24;126298;95458;147;0;0;9518799;5023873;4625;2;0
FR;1;2021-04-25;53615;30026;46;0;0;9572414;5053899;4671;2;0
FR;1;2021-04-26;181081;138314;539;0;0;9753495;5192213;5210;2;0
FR;1;2021-04-27;221314;161836;899;0;0;9974809;5354049;6109;2;0
FR;1;2021-04-28;238231;154981;1310;1;1;10213040;5509030;7419;3;1
FR;1;2021-04-29;270219;160285;1207;0;0;10483259;5669315;8626;3;1
FR;1;2021-04-30;271920;148073;1069;0;0;10755179;5817388;9695;3;1
FR;1;2021-05-01;141112;40637;172;0;0;10896291;5858025;9867;3;1
FR;1;2021-05-02;81510;28106;81;0;0;10977801;5886131;9948;3;1
FR;1;2021-05-03;250721;145372;799;0;0;11228522;6031503;10747;3;1
FR;1;2021-05-04;265796;186879;1197;0;0;11494318;6218382;11944;3;1
FR;1;2021-05-05;283795;184678;1264;0;0;11778113;6403060;13208;3;1
FR;1;2021-05-06;309881;183192;1498;0;0;12087994;6586252;14706;3;1
FR;1;2021-05-07;284031;195596;1125;0;0;12372025;6781848;15831;3;1
FR;1;2021-05-08;191635;48561;283;0;0;12563660;6830409;16114;3;1
FR;1;2021-05-09;114043;35915;236;0;0;12677703;6866324;16350;3;1
FR;1;2021-05-10;258127;193972;1182;0;0;12935830;7060296;17532;3;1
FR;1;2021-05-11;318805;210976;1462;0;0;13254635;7271272;18994;3;1
FR;1;2021-05-12;356557;185673;1399;0;0;13611192;7456945;20393;3;1
FR;1;2021-05-13;283397;47710;399;0;0;13894589;7504655;20792;3;1
FR;1;2021-05-14;370435;128567;990;0;0;14265024;7633222;21782;3;1
FR;1;2021-05-15;298044;66088;402;0;0;14563068;7699310;22184;3;1
FR;1;2021-05-16;157744;15547;158;0;0;14720812;7714857;22342;3;1
FR;1;2021-05-17;318876;116327;1436;0;0;15039688;7831184;23778;3;1
FR;1;2021-05-18;383258;111159;1795;0;0;15422946;7942343;25573;3;1
FR;1;2021-05-19;395173;102605;2174;0;0;15818119;8044948;27747;3;1
FR;1;2021-05-20;421684;96130;2041;0;0;16239803;8141078;29788;3;1
FR;1;2021-05-21;399714;97151;1755;0;0;16639517;8238229;31543;3;1
FR;1;2021-05-22;275642;42025;602;0;0;16915159;8280254;32145;3;1
FR;1;2021-05-23;122961;11156;224;0;0;17038120;8291410;32369;3;1
FR;1;2021-05-24;243960;26214;565;0;0;17282080;8317624;32934;3;1
FR;1;2021-05-25;366116;131635;2108;1;0;17648196;8449259;35042;4;1
FR;1;2021-05-26;380731;125813;1987;0;0;18028927;8575072;37029;4;1
FR;1;2021-05-27;406049;127962;1973;0;0;18434976;8703034;39002;4;1
FR;1;2021-05-28;365932;145275;1696;0;0;18800908;8848309;40698;4;1
FR;1;2021-05-29;253797;80818;525;0;0;19054705;8929127;41223;4;1
FR;1;2021-05-30;100932;22540;157;0;0;19155637;8951667;41380;4;1
FR;1;2021-05-31;314207;148749;1279;1;1;19469844;9100416;42659;5;2
FR;1;2021-06-01;361466;166463;1724;1;1;19831310;9266879;44383;6;3
FR;1;2021-06-02;364578;153154;1791;0;0;20195888;9420033;46174;6;3
FR;1;2021-06-03;390349;147540;1647;0;0;20586237;9567573;47821;6;3
FR;1;2021-06-04;363554;175508;1492;1;1;20949791;9743081;49313;7;4
FR;1;2021-06-05;258454;112656;596;0;0;21208245;9855737;49909;7;4
FR;1;2021-06-06;126739;37545;215;0;0;21334984;9893282;50124;7;4
FR;1;2021-06-07;300067;207793;1361;0;0;21635051;10101075;51485;7;4
FR;1;2021-06-08;330533;220772;1635;0;0;21965584;10321847;53120;7;4
FR;1;2021-06-09;336381;212220;1607;0;0;22301965;10534067;54727;7;4
FR;1;2021-06-10;343681;201864;1607;0;0;22645646;10735931;56334;7;4
FR;1;2021-06-11;311724;235272;1291;0;0;22957370;10971203;57625;7;4
FR;1;2021-06-12;244024;150648;431;0;0;23201394;11121851;58056;7;4
FR;1;2021-06-13;100315;60995;188;0;0;23301709;11182846;58244;7;4
FR;1;2021-06-14;207665;288807;1316;1;0;23509374;11471653;59560;8;4
FR;1;2021-06-15;256693;282136;1390;1;0;23766067;11753789;60950;9;4
FR;1;2021-06-16;273514;270569;1261;1;0;24039581;12024358;62211;10;4
FR;1;2021-06-17;268092;244731;1231;1;0;24307673;12269089;63442;11;4
FR;1;2021-06-18;260418;295646;1148;1;0;24568091;12564735;64590;12;4
FR;1;2021-06-19;193411;209473;387;0;0;24761502;12774208;64977;12;4
FR;1;2021-06-20;69649;89150;117;0;0;24831151;12863358;65094;12;4
FR;1;2021-06-21;172192;319774;929;1;1;25003343;13183132;66023;13;5
FR;1;2021-06-22;185679;347857;1095;10;2;25189022;13530989;67118;23;7
FR;1;2021-06-23;204042;339492;1048;0;0;25393064;13870481;68166;23;7
FR;1;2021-06-24;203398;282104;1166;0;0;25596462;14152585;69332;23;7
FR;1;2021-06-25;182491;371815;1196;0;0;25778953;14524400;70528;23;7
FR;1;2021-06-26;131345;278306;502;0;0;25910298;14802706;71030;23;7
FR;1;2021-06-27;52372;122906;145;0;0;25962670;14925612;71175;23;7
FR;1;2021-06-28;136505;368135;1057;0;0;26099175;15293747;72232;23;7
FR;1;2021-06-29;154746;390692;1849;0;0;26253921;15684439;74081;23;7
FR;1;2021-06-30;179905;379336;1662;4;2;26433826;16063775;75743;27;9
FR;1;2021-07-01;201259;332200;1886;5;1;26635085;16395975;77629;32;10
FR;1;2021-07-02;193508;367669;1764;5;3;26828593;16763644;79393;37;13
FR;1;2021-07-03;124373;280450;704;3;1;26952966;17044094;80097;40;14
FR;1;2021-07-04;53903;113693;244;0;0;27006869;17157787;80341;40;14
FR;1;2021-07-05;153655;356032;1500;8;2;27160524;17513819;81841;48;16
FR;1;2021-07-06;173294;382521;1601;45;8;27333818;17896340;83442;93;24
FR;1;2021-07-07;190572;362563;1656;24;5;27524390;18258903;85098;117;29
FR;1;2021-07-08;201378;323103;1825;20;7;27725768;18582006;86923;137;36
FR;1;2021-07-09;189712;387537;1851;3;2;27915480;18969543;88774;140;38
FR;1;2021-07-10;129871;281130;814;1;1;28045351;19250673;89588;141;39
FR;1;2021-07-11;57624;102497;261;0;0;28102975;19353170;89849;141;39
FR;1;2021-07-12;149464;417028;1579;4;0;28252439;19770198;91428;145;39
FR;1;2021-07-13;234062;439469;1805;8;2;28486501;20209667;93233;153;41
FR;1;2021-07-14;171725;151542;416;0;0;28658226;20361209;93649;153;41
FR;1;2021-07-15;279457;424760;1856;1;0;28937683;20785969;95505;154;41
FR;1;2021-07-16;290254;401236;1710;3;1;29227937;21187205;97215;157;42
FR;1;2021-07-17;217275;282119;754;1;0;29445212;21469324;97969;158;42
FR;1;2021-07-18;101960;107311;288;0;0;29547172;21576635;98257;158;42
FR;1;2021-07-19;238068;379209;1495;3;0;29785240;21955844;99752;161;42
FR;1;2021-07-20;305569;380760;1467;0;0;30090809;22336604;101219;161;42
FR;1;2021-07-21;333124;353458;1412;4;2;30423933;22690062;102631;165;44
FR;1;2021-07-22;364512;319272;1501;3;2;30788445;23009334;104132;168;46
FR;1;2021-07-23;348898;343622;1586;4;2;31137343;23352956;105718;172;48
FR;1;2021-07-24;238908;240993;696;1;0;31376251;23593949;106414;173;48
FR;1;2021-07-25;112748;76060;215;0;0;31488999;23670009;106629;173;48
FR;1;2021-07-26;298991;290069;1495;2;2;31787990;23960078;108124;175;50
FR;1;2021-07-27;385698;268741;1457;4;2;32173688;24228819;109581;179;52
FR;1;2021-07-28;390081;251452;1460;4;2;32563769;24480271;111041;183;54
FR;1;2021-07-29;406016;228267;1538;2;1;32969785;24708538;112579;185;55
FR;1;2021-07-30;370590;246998;1632;4;1;33340375;24955536;114211;189;56
FR;1;2021-07-31;243352;165117;793;1;0;33583727;25120653;115004;190;56
FR;1;2021-08-01;105519;47241;232;0;0;33689246;25167894;115236;190;56
FR;1;2021-08-02;297023;213223;1475;2;0;33986269;25381117;116711;192;56
FR;1;2021-08-03;331152;209225;1545;2;1;34317421;25590342;118256;194;57
FR;1;2021-08-04;327822;184350;1436;5;3;34645243;25774692;119692;199;60
FR;1;2021-08-05;301114;193560;1482;0;0;34946357;25968252;121174;199;60
FR;1;2021-08-06;290828;224527;1558;3;1;35237185;26192779;122732;202;61
FR;1;2021-08-07;182598;158828;654;4;3;35419783;26351607;123386;206;64
FR;1;2021-08-08;68833;59134;247;0;0;35488616;26410741;123633;206;64
FR;1;2021-08-09;222627;235916;1438;4;3;35711243;26646657;125071;210;67
FR;1;2021-08-10;252495;240666;1486;2;1;35963738;26887323;126557;212;68
FR;1;2021-08-11;236034;232382;1270;5;1;36199772;27119705;127827;217;69
FR;1;2021-08-12;220617;240241;1484;3;1;36420389;27359946;129311;220;70
FR;1;2021-08-13;201621;238543;1355;2;2;36622010;27598489;130666;222;72
FR;1;2021-08-14;122811;174166;645;0;0;36744821;27772655;131311;222;72
FR;1;2021-08-15;34657;46118;198;1;0;36779478;27818773;131509;223;72
FR;1;2021-08-16;156830;289865;1421;0;0;36936308;28108638;132930;223;72
FR;1;2021-08-17;171501;291613;1419;5;1;37107809;28400251;134349;228;73
FR;1;2021-08-18;161309;287023;1389;6;3;37269118;28687274;135738;234;76
FR;1;2021-08-19;148808;277721;1396;1;0;37417926;28964995;137134;235;76
FR;1;2021-08-20;140405;309055;1524;2;2;37558331;29274050;138658;237;78
FR;1;2021-08-21;84230;213257;586;0;0;37642561;29487307;139244;237;78
FR;1;2021-08-22;28543;82690;230;0;0;37671104;29569997;139474;237;78
FR;1;2021-08-23;118580;321165;1419;2;1;37789684;29891162;140893;239;79
FR;1;2021-08-24;126591;319913;1599;5;1;37916275;30211075;142492;244;80
FR;1;2021-08-25;121457;306584;1776;8;3;38037732;30517659;144268;252;83
FR;1;2021-08-26;106511;286202;2155;10;1;38144243;30803861;146423;262;84
FR;1;2021-08-27;107591;321512;2300;8;3;38251834;31125373;148723;270;87
FR;1;2021-08-28;70962;220704;1100;0;0;38322796;31346077;149823;270;87
FR;1;2021-08-29;24135;78152;467;1;0;38346931;31424229;150290;271;87
FR;1;2021-08-30;96806;286537;4307;6;5125;38443737;31710766;154597;277;5212
FR;1;2021-08-31;98029;276452;9285;15;10177;38541766;31987218;163882;292;15389
FR;1;2021-09-01;111933;245333;21101;7;22069;38653699;32232551;184983;299;37458
FR;1;2021-09-02;84697;198013;24521;11;25424;38738396;32430564;209504;310;62882
FR;1;2021-09-03;82288;227619;26943;20;27972;38820684;32658183;236447;330;90854
FR;1;2021-09-04;71542;189713;11138;11;11650;38892226;32847896;247585;341;102504
FR;1;2021-09-05;18594;41191;4121;2;4288;38910820;32889087;251706;343;106792
FR;1;2021-09-06;59458;151641;30171;15;31144;38970278;33040728;281877;358;137936
FR;1;2021-09-07;57143;139715;30199;27;31097;39027421;33180443;312076;385;169033
FR;1;2021-09-08;70991;173883;26916;20;27862;39098412;33354326;338992;405;196895
FR;1;2021-09-09;54175;124544;28597;23;29638;39152587;33478870;367589;428;226533
FR;1;2021-09-10;65742;152097;30427;22;31548;39218329;33630967;398016;450;258081
FR;1;2021-09-11;52239;146614;9727;14;10297;39270568;33777581;407743;464;268378
FR;1;2021-09-12;10762;29242;2481;1;2635;39281330;33806823;410224;465;271013
FR;1;2021-09-13;51325;104599;38726;28;39907;39332655;33911422;448950;493;310920
FR;1;2021-09-14;53161;96051;51248;65;52844;39385816;34007473;500198;558;363764
FR;1;2021-09-15;60339;139294;50458;55;46961;39446155;34146767;550656;613;410725
FR;1;2021-09-16;46525;81427;53283;71;49459;39492680;34228194;603939;684;460184
FR;1;2021-09-17;53101;109392;45042;60;42632;39545781;34337586;648981;744;502816
FR;1;2021-09-18;37832;118491;11789;19;11254;39583613;34456077;660770;763;514070
FR;1;2021-09-19;6489;21031;2037;1;1973;39590102;34477108;662807;764;516043
FR;1;2021-09-20;36424;74923;46169;66;44084;39626526;34552031;708976;830;560127
FR;1;2021-09-21;34117;68165;56224;71;52603;39660643;34620196;765200;901;612730
FR;1;2021-09-22;38740;118501;49831;76;46808;39699383;34738697;815031;977;659538
FR;1;2021-09-23;31918;62824;54457;85;50801;39731301;34801521;869488;1062;710339
FR;1;2021-09-24;36693;90047;43635;92;41866;39767994;34891568;913123;1154;752205
FR;1;2021-09-25;27623;96603;12297;27;12161;39795617;34988171;925420;1181;764366
FR;1;2021-09-26;4357;15199;1769;5;1695;39799974;35003370;927189;1186;766061
FR;1;2021-09-27;27305;60231;42878;89;41556;39827279;35063601;970067;1275;807617
FR;1;2021-09-28;26841;49444;47152;75;44363;39854120;35113045;1017219;1350;851980
FR;1;2021-09-29;35823;80387;47243;87;45516;39889943;35193432;1064462;1437;897496
FR;1;2021-09-30;26006;46754;47485;79;45359;39915949;35240186;1111947;1516;942855
FR;1;2021-10-01;47103;64978;44853;83;44398;39963052;35305164;1156800;1599;987253
FR;1;2021-10-02;32328;62331;16101;32;16292;39995380;35367495;1172901;1631;1003545
FR;1;2021-10-03;4318;8581;2031;3;2025;39999698;35376076;1174932;1634;1005570
FR;1;2021-10-04;28725;44411;47088;79;46897;40028423;35420487;1222020;1713;1052467
FR;1;2021-10-05;24194;41630;49825;116;49168;40052617;35462117;1271845;1829;1101635
FR;1;2021-10-06;34347;61304;57438;102;57111;40086964;35523421;1329283;1931;1158746
FR;1;2021-10-07;20924;39777;52988;76;51800;40107888;35563198;1382271;2007;1210546
FR;1;2021-10-08;34918;59583;60356;83;61047;40142806;35622781;1442627;2090;1271593
FR;1;2021-10-09;27416;47963;25473;30;25969;40170222;35670744;1468100;2120;1297562
FR;1;2021-10-10;3597;5776;2746;7;2845;40173819;35676520;1470846;2127;1300407
FR;1;2021-10-11;24684;38162;54558;88;55165;40198503;35714682;1525404;2215;1355572
FR;1;2021-10-12;23059;36580;58019;126;59074;40221562;35751262;1583423;2341;1414646
FR;1;2021-10-13;32787;47784;64141;124;65602;40254349;35799046;1647564;2465;1480248
FR;1;2021-10-14;21585;34741;53723;103;54283;40275934;35833787;1701287;2568;1534531
FR;1;2021-10-15;32540;48783;72292;165;74907;40308474;35882570;1773579;2733;1609438
FR;1;2021-10-16;25955;35269;34857;44;36387;40334429;35917839;1808436;2777;1645825
FR;1;2021-10-17;3096;4064;3406;2;3316;40337525;35921903;1811842;2779;1649141
FR;1;2021-10-18;23393;34914;66803;131;69647;40360918;35956817;1878645;2910;1718788
FR;1;2021-10-19;20571;34326;75624;136;79509;40381489;35991143;1954269;3046;1798297
FR;1;2021-10-20;29785;44175;96136;177;99746;40411274;36035318;2050405;3223;1898043
FR;1;2021-10-21;19567;35082;83115;107;86970;40430841;36070400;2133520;3330;1985013
FR;1;2021-10-22;29506;47616;103696;195;109561;40460347;36118016;2237216;3525;2094574
FR;1;2021-10-23;22990;35154;44846;57;47344;40483337;36153170;2282062;3582;2141918
FR;1;2021-10-24;2373;3879;3579;6;3733;40485710;36157049;2285641;3588;2145651
FR;1;2021-10-25;22384;30808;81988;143;85752;40508094;36187857;2367629;3731;2231403
FR;1;2021-10-26;19293;27675;86056;162;90265;40527387;36215532;2453685;3893;2321668
FR;1;2021-10-27;26126;39648;107751;252;112585;40553513;36255180;2561436;4145;2434253
FR;1;2021-10-28;18576;27045;86890;150;91559;40572089;36282225;2648326;4295;2525812
FR;1;2021-10-29;25860;40105;114781;200;121499;40597949;36322330;2763107;4495;2647311
FR;1;2021-10-30;17662;28593;49338;75;51912;40615611;36350923;2812445;4570;2699223
FR;1;2021-10-31;2053;3204;3442;2;3677;40617664;36354127;2815887;4572;2702900
FR;1;2021-11-01;7691;4196;3018;3;3261;40625355;36358323;2818905;4575;2706161
FR;1;2021-11-02;21810;33195;92335;157;97669;40647165;36391518;2911240;4732;2803830
FR;1;2021-11-03;26259;41500;117433;215;123772;40673424;36433018;3028673;4947;2927602
FR;1;2021-11-04;19476;30284;105724;213;111807;40692900;36463302;3134397;5160;3039409
FR;1;2021-11-05;26890;42250;138709;227;147281;40719790;36505552;3273106;5387;3186690
FR;1;2021-11-06;18799;29825;63437;123;66402;40738589;36535377;3336543;5510;3253092
FR;1;2021-11-07;1787;3358;4952;6;5294;40740376;36538735;3341495;5516;3258386
FR;1;2021-11-08;17639;32310;125895;224;132445;40758015;36571045;3467390;5740;3390831
FR;1;2021-11-09;19208;37701;159205;335;168901;40777223;36608746;3626595;6075;3559732
FR;1;2021-11-10;28636;49133;181809;440;192345;40805859;36657879;3808404;6515;3752077
FR;1;2021-11-11;3764;5918;12187;26;12996;40809623;36663797;3820591;6541;3765073
FR;1;2021-11-12;25924;46871;174735;243;186331;40835547;36710668;3995326;6784;3951404
FR;1;2021-11-13;18674;29251;76798;111;81736;40854221;36739919;4072124;6895;4033140
FR;1;2021-11-14;2014;3321;6811;5;7385;40856235;36743240;4078935;6900;4040525
FR;1;2021-11-15;18562;34898;156325;303;166081;40874797;36778138;4235260;7203;4206606
FR;1;2021-11-16;21037;37916;191995;376;204764;40895834;36816054;4427255;7579;4411370
FR;1;2021-11-17;28474;45730;193138;399;204905;40924308;36861784;4620393;7978;4616275
FR;1;2021-11-18;21038;38771;182376;457;194341;40945346;36900555;4802769;8435;4810616
FR;1;2021-11-19;30765;53373;230134;529;246544;40976111;36953928;5032903;8964;5057160
FR;1;2021-11-20;23667;33315;96935;201;103571;40999778;36987243;5129838;9165;5160731
FR;1;2021-11-21;2312;4017;9095;18;9969;41002090;36991260;5138933;9183;5170700
FR;1;2021-11-22;21324;30451;175782;465;189292;41023414;37021711;5314715;9648;5359992
FR;1;2021-11-23;23852;41154;221082;538;237765;41047266;37062865;5535797;10186;5597757
FR;1;2021-11-24;30252;49735;217248;703;234348;41077518;37112600;5753045;10889;5832105
FR;1;2021-11-25;23476;43956;244334;719;263898;41100994;37156556;5997379;11608;6096003
FR;1;2021-11-26;30579;66554;356661;832;388351;41131573;37223110;6354040;12440;6484354
FR;1;2021-11-27;21752;45358;202544;371;222510;41153325;37268468;6556584;12811;6706864
FR;1;2021-11-28;3136;9677;54750;63;61029;41156461;37278145;6611334;12874;6767893
FR;1;2021-11-29;17853;49512;326258;840;354233;41174314;37327657;6937592;13714;7122126
FR;1;2021-11-30;22685;64980;431018;948;470582;41196999;37392637;7368610;14662;7592708
FR;1;2021-12-01;24813;69357;442730;1130;481565;41221812;37461994;7811340;15792;8074273
FR;1;2021-12-02;19945;64414;489238;1227;532670;41241757;37526408;8300578;17019;8606943
FR;1;2021-12-03;22804;81814;542594;1306;591569;41264561;37608222;8843172;18325;9198512
FR;1;2021-12-04;16364;53930;299018;652;328849;41280925;37662152;9142190;18977;9527361
FR;1;2021-12-05;3622;13919;81495;143;91049;41284547;37676071;9223685;19120;9618410
FR;1;2021-12-06;19870;62784;415291;1065;455004;41304417;37738855;9638976;20185;10073414
FR;1;2021-12-07;19773;75817;522793;1531;572383;41324190;37814672;10161769;21716;10645797
FR;1;2021-12-08;21538;75779;458202;1543;501872;41345728;37890451;10619971;23259;11147669
FR;1;2021-12-09;19384;74107;492746;1625;540612;41365112;37964558;11112717;24884;11688281
FR;1;2021-12-10;22883;87634;547251;1584;599844;41387995;38052192;11659968;26468;12288125
FR;1;2021-12-11;16507;59019;302670;747;335421;41404502;38111211;11962638;27215;12623546
FR;1;2021-12-12;4343;16022;83175;179;94080;41408845;38127233;12045813;27394;12717626
FR;1;2021-12-13;15451;63819;366818;1094;406186;41424296;38191052;12412631;28488;13123812
FR;1;2021-12-14;20423;80286;464529;1738;515003;41444719;38271338;12877160;30226;13638815
FR;1;2021-12-15;21356;77469;408906;1307;452973;41466075;38348807;13286066;31533;14091788
FR;1;2021-12-16;19942;77380;451665;1574;500451;41486017;38426187;13737731;33107;14592239
FR;1;2021-12-17;22497;86709;479779;1732;530916;41508514;38512896;14217510;34839;15123155
FR;1;2021-12-18;17581;54701;257554;730;288464;41526095;38567597;14475064;35569;15411619
FR;1;2021-12-19;5536;17130;79128;194;90741;41531631;38584727;14554192;35763;15502360
FR;1;2021-12-20;20769;63160;316087;1081;355159;41552400;38647887;14870279;36844;15857519
FR;1;2021-12-21;26091;73199;372613;1421;417963;41578491;38721086;15242892;38265;16275482
FR;1;2021-12-22;24887;65987;310497;1215;349466;41603378;38787073;15553389;39480;16624948
FR;1;2021-12-23;21226;52343;241380;953;272979;41624604;38839416;15794769;40433;16897927
FR;1;2021-12-24;7098;18241;67102;256;77019;41631702;38857657;15861871;40689;16974946
FR;1;2021-12-25;499;2767;5566;15;6529;41632201;38860424;15867437;40704;16981475
FR;1;2021-12-26;2747;7595;26921;70;31445;41634948;38868019;15894358;40774;17012920
FR;1;2021-12-27;18135;53566;235010;707;265697;41653083;38921585;16129368;41481;17278617
FR;1;2021-12-28;23233;61990;291942;1025;330123;41676316;38983575;16421310;42506;17608740
FR;1;2021-12-29;22192;55542;254909;918;288128;41698508;39039117;16676219;43424;17896868
FR;1;2021-12-30;21217;46262;212082;857;239545;41719725;39085379;16888301;44281;18136413
FR;1;2021-12-31;7454;16613;61830;229;70356;41727179;39101992;16950131;44510;18206769
FR;1;2022-01-01;886;2475;5641;29;6572;41728065;39104467;16955772;44539;18213341
FR;1;2022-01-02;3039;8068;28869;50;33522;41731104;39112535;16984641;44589;18246863
FR;1;2022-01-03;19827;53798;228098;786;257495;41750931;39166333;17212739;45375;18504358
FR;1;2022-01-04;24909;64814;299140;1235;337175;41775840;39231147;17511879;46610;18841533
FR;1;2022-01-05;29651;63846;274759;1098;310098;41805491;39294993;17786638;47708;19151631
FR;1;2022-01-06;26473;65976;306790;1395;346420;41831964;39360969;18093428;49103;19498051
FR;1;2022-01-07;31284;74643;349748;1534;393830;41863248;39435612;18443176;50637;19891881
FR;1;2022-01-08;23340;51376;222457;695;251088;41886588;39486988;18665633;51332;20142969
FR;1;2022-01-09;7076;17200;66006;163;76153;41893664;39504188;18731639;51495;20219122
FR;1;2022-01-10;21391;55361;236678;952;267029;41915055;39559549;18968317;52447;20486151
FR;1;2022-01-11;26466;62990;282190;1277;317734;41941521;39622539;19250507;53724;20803885
FR;1;2022-01-12;28680;62202;246139;1102;277906;41970201;39684741;19496646;54826;21081791
FR;1;2022-01-13;24404;59864;262696;1252;296028;41994605;39744605;19759342;56078;21377819
FR;1;2022-01-14;27762;66521;313895;1366;351179;42022367;39811126;20073237;57444;21728998
FR;1;2022-01-15;19254;44305;199264;619;223836;42041621;39855431;20272501;58063;21952834
FR;1;2022-01-16;5133;12991;51495;135;59576;42046754;39868422;20323996;58198;22012410
FR;1;2022-01-17;16726;39705;184771;779;206828;42063480;39908127;20508767;58977;22219238
FR;1;2022-01-18;19236;45636;212345;1151;236969;42082716;39953763;20721112;60128;22456207
FR;1;2022-01-19;20132;43886;176030;894;197158;42102848;39997649;20897142;61022;22653365
FR;1;2022-01-20;16583;40346;183571;1137;204649;42119431;40037995;21080713;62159;22858014
FR;1;2022-01-21;19702;46943;228875;1404;253287;42139133;40084938;21309588;63563;23111301
FR;1;2022-01-22;13825;33189;144464;578;161361;42152958;40118127;21454052;64141;23272662
FR;1;2022-01-23;3344;8810;33399;130;38330;42156302;40126937;21487451;64271;23310992
FR;1;2022-01-24;11725;32617;142154;706;158244;42168027;40159554;21629605;64977;23469236
FR;1;2022-01-25;14088;37934;163331;1049;181515;42182115;40197488;21792936;66026;23650751
FR;1;2022-01-26;14819;37333;150192;931;166249;42196934;40234821;21943128;66957;23817000
FR;1;2022-01-27;12277;32811;143374;882;157854;42209211;40267632;22086502;67839;23974854
FR;1;2022-01-28;16248;53834;198237;1143;222451;42225459;40321466;22284739;68982;24197305
FR;1;2022-01-29;10257;35426;135171;522;151540;42235716;40356892;22419910;69504;24348845
FR;1;2022-01-30;2475;9309;29667;86;34466;42238191;40366201;22449577;69590;24383311
FR;1;2022-01-31;8725;32346;104296;530;117387;42246916;40398547;22553873;70120;24500698
FR;1;2022-02-01;10157;36235;127012;862;141219;42257073;40434782;22680885;70982;24641917
FR;1;2022-02-02;11379;41072;130287;780;145832;42268452;40475854;22811172;71762;24787749
FR;1;2022-02-03;8713;33370;116951;780;130347;42277165;40509224;22928123;72542;24918096
FR;1;2022-02-04;11373;48077;172515;965;192777;42288538;40557301;23100638;73507;25110873
FR;1;2022-02-05;7870;33910;117547;391;133050;42296408;40591211;23218185;73898;25243923
FR;1;2022-02-06;1690;8057;22734;83;26908;42298098;40599268;23240919;73981;25270831
FR;1;2022-02-07;7036;35334;119034;452;134965;42305134;40634602;23359953;74433;25405796
FR;1;2022-02-08;7552;31515;125595;693;140569;42312686;40666117;23485548;75126;25546365
FR;1;2022-02-09;8438;36068;135199;692;152410;42321124;40702185;23620747;75818;25698775
FR;1;2022-02-10;6565;29237;116290;673;130030;42327689;40731422;23737037;76491;25828805
FR;1;2022-02-11;8533;41308;165068;875;185272;42336222;40772730;23902105;77366;26014077
FR;1;2022-02-12;5285;27522;106670;378;120841;42341507;40800252;24008775;77744;26134918
FR;1;2022-02-13;1220;5696;21703;62;25314;42342727;40805948;24030478;77806;26160232
FR;1;2022-02-14;5357;27059;118030;388;133048;42348084;40833007;24148508;78194;26293280
FR;1;2022-02-15;5581;28071;118836;609;132424;42353665;40861078;24267344;78803;26425704
FR;1;2022-02-16;5636;28073;110367;592;122959;42359301;40889151;24377711;79395;26548663
FR;1;2022-02-17;4405;19087;73085;486;80130;42363706;40908238;24450796;79881;26628793
FR;1;2022-02-18;5485;26429;99138;668;108076;42369191;40934667;24549934;80549;26736869
FR;1;2022-02-19;3523;17076;59454;304;66024;42372714;40951743;24609388;80853;26802893
FR;1;2022-02-20;780;3223;10688;35;12309;42373494;40954966;24620076;80888;26815202
FR;1;2022-02-21;3353;14462;52790;286;57634;42376847;40969428;24672866;81174;26872836
FR;1;2022-02-22;3705;15348;51868;499;55588;42380552;40984776;24724734;81673;26928424
FR;1;2022-02-23;4152;17589;57440;508;62537;42384704;41002365;24782174;82181;26990961
FR;1;2022-02-24;3240;12731;43561;436;46338;42387944;41015096;24825735;82617;27037299
FR;1;2022-02-25;4389;19383;64835;695;68696;42392333;41034479;24890570;83312;27105995
FR;1;2022-02-26;2676;12668;41341;308;45093;42395009;41047147;24931911;83620;27151088
FR;1;2022-02-27;636;2166;7114;42;7979;42395645;41049313;24939025;83662;27159067
FR;1;2022-02-28;2559;10058;34914;300;37336;42398204;41059371;24973939;83962;27196403
FR;1;2022-03-01;2696;10363;38635;389;39555;42400900;41069734;25012574;84351;27235958
FR;1;2022-03-02;3425;11846;41800;390;43847;42404325;41081580;25054374;84741;27279805
FR;1;2022-03-03;2284;7502;26115;319;26427;42406609;41089082;25080489;85060;27306232
FR;1;2022-03-04;2645;10201;35384;575;34862;42409254;41099283;25115873;85635;27341094
FR;1;2022-03-05;1668;6289;21938;277;22323;42410922;41105572;25137811;85912;27363417
FR;1;2022-03-06;348;935;2914;37;3112;42411270;41106507;25140725;85949;27366529
FR;1;2022-03-07;1358;4552;16404;244;15856;42412628;41111059;25157129;86193;27382385
FR;1;2022-03-08;1528;5077;17121;307;15940;42414156;41116136;25174250;86500;27398325
FR;1;2022-03-09;1858;6439;19772;366;19117;42416014;41122575;25194022;86866;27417442
FR;1;2022-03-10;1292;4334;15183;304;14188;42417306;41126909;25209205;87170;27431630
FR;1;2022-03-11;1689;6134;21666;480;19814;42418995;41133043;25230871;87650;27451444
FR;1;2022-03-12;1226;4589;15350;276;14894;42420221;41137632;25246221;87926;27466338
FR;1;2022-03-13;239;601;2100;115;2047;42420460;41138233;25248321;88041;27468385
FR;1;2022-03-14;1059;3532;13357;3873;12482;42421519;41141765;25261678;91914;27480867
FR;1;2022-03-15;1253;3813;14515;6861;12992;42422772;41145578;25276193;98775;27493859
FR;1;2022-03-16;1599;4708;17311;11513;16360;42424371;41150286;25293504;110288;27510219
FR;1;2022-03-17;1089;3135;11673;9637;10766;42425460;41153421;25305177;119925;27520985
FR;1;2022-03-18;1657;4675;17900;16482;16328;42427117;41158096;25323077;136407;27537313
FR;1;2022-03-19;1109;3166;11878;8450;11343;42428226;41161262;25334955;144857;27548656
FR;1;2022-03-20;216;531;1714;1006;1746;42428442;41161793;25336669;145863;27550402
FR;1;2022-03-21;1033;2672;11457;13440;10802;42429475;41164465;25348126;159303;27561204
FR;1;2022-03-22;1184;3045;12214;18681;11200;42430659;41167510;25360340;177984;27572404
FR;1;2022-03-23;1458;4142;15941;20090;15621;42432117;41171652;25376281;198074;27588025
FR;1;2022-03-24;1068;2505;10338;16012;9590;42433185;41174157;25386619;214086;27597615
FR;1;2022-03-25;1490;4006;16642;25278;15300;42434675;41178163;25403261;239364;27612915
FR;1;2022-03-26;1095;2834;10834;11425;10492;42435770;41180997;25414095;250789;27623407
FR;1;2022-03-27;227;536;1721;1376;1773;42435997;41181533;25415816;252165;27625180
FR;1;2022-03-28;1031;2324;9899;15858;9516;42437028;41183857;25425715;268023;27634696
FR;1;2022-03-29;1109;2691;11493;25059;10857;42438137;41186548;25437208;293082;27645553
FR;1;2022-03-30;1588;3449;14082;24145;13611;42439725;41189997;25451290;317227;27659164
FR;1;2022-03-31;1254;2580;11523;22530;11029;42440979;41192577;25462813;339757;27670193
FR;1;2022-04-01;1638;3704;18381;28445;17229;42442617;41196281;25481194;368202;27687422
FR;1;2022-04-02;877;1850;8156;9203;7904;42443494;41198131;25489350;377405;27695326
FR;1;2022-04-03;183;362;1426;1056;1426;42443677;41198493;25490776;378461;27696752
FR;1;2022-04-04;1027;2110;11092;17593;10461;42444704;41200603;25501868;396054;27707213
FR;1;2022-04-05;1233;2465;12884;31087;11901;42445937;41203068;25514752;427141;27719114
FR;1;2022-04-06;1306;2677;12047;23731;11460;42447243;41205745;25526799;450872;27730574
FR;1;2022-04-07;1121;2455;12241;30802;11696;42448364;41208200;25539040;481674;27742270
FR;1;2022-04-08;1548;3447;17444;40312;16353;42449912;41211647;25556484;521986;27758623
FR;1;2022-04-09;796;1968;8376;12470;8070;42450708;41213615;25564860;534456;27766693
FR;1;2022-04-10;179;451;1815;1830;1847;42450887;41214066;25566675;536286;27768540
FR;1;2022-04-11;932;2085;10902;22101;10611;42451819;41216151;25577577;558387;27779151
FR;1;2022-04-12;1183;2367;12670;37705;12154;42453002;41218518;25590247;596092;27791305
FR;1;2022-04-13;1147;2571;12100;30229;11823;42454149;41221089;25602347;626321;27803128
FR;1;2022-04-14;1158;2273;11921;33186;11898;42455307;41223362;25614268;659507;27815026
FR;1;2022-04-15;1392;2754;14242;32877;13616;42456699;41226116;25628510;692384;27828642
FR;1;2022-04-16;644;1386;5803;7964;5725;42457343;41227502;25634313;700348;27834367
FR;1;2022-04-17;147;270;926;1099;968;42457490;41227772;25635239;701447;27835335
FR;1;2022-04-18;114;361;2588;968;2610;42457604;41228133;25637827;702415;27837945
FR;1;2022-04-19;1177;2465;11663;27520;11296;42458781;41230598;25649490;729935;27849241
FR;1;2022-04-20;1240;2495;11988;26465;11813;42460021;41233093;25661478;756400;27861054
FR;1;2022-04-21;1197;2312;11377;32692;11540;42461218;41235405;25672855;789092;27872594
FR;1;2022-04-22;1453;2926;15101;35182;14680;42462671;41238331;25687956;824274;27887274
FR;1;2022-04-23;721;1549;6693;9854;6596;42463392;41239880;25694649;834128;27893870
FR;1;2022-04-24;180;351;1362;1503;1314;42463572;41240231;25696011;835631;27895184
FR;1;2022-04-25;971;2011;9757;19469;9640;42464543;41242242;25705768;855100;27904824
FR;1;2022-04-26;1273;2553;12476;36104;12064;42465816;41244795;25718244;891204;27916888
FR;1;2022-04-27;1252;2342;10505;28614;10605;42467068;41247137;25728749;919818;27927493
FR;1;2022-04-28;1225;2253;11362;33603;11172;42468293;41249390;25740111;953421;27938665
FR;1;2022-04-29;1543;2863;14112;34946;13531;42469836;41252253;25754223;988367;27952196
FR;1;2022-04-30;795;1418;6251;9073;6080;42470631;41253671;25760474;997440;27958276
FR;1;2022-05-01;134;255;773;909;777;42470765;41253926;25761247;998349;27959053
FR;1;2022-05-02;865;1725;9309;16438;9208;42471630;41255651;25770556;1014787;27968261
FR;1;2022-05-03;1335;2457;11961;32148;11874;42472965;41258108;25782517;1046935;27980135
FR;1;2022-05-04;1245;2317;9860;23140;10006;42474210;41260425;25792377;1070075;27990141
FR;1;2022-05-05;1286;2249;10701;30855;10490;42475496;41262674;25803078;1100930;28000631
FR;1;2022-05-06;1631;3032;13548;34324;13118;42477127;41265706;25816626;1135254;28013749
FR;1;2022-05-07;804;1412;5596;9006;5640;42477931;41267118;25822222;1144260;28019389
FR;1;2022-05-08;178;290;914;1427;982;42478109;41267408;25823136;1145687;28020371
FR;1;2022-05-09;971;1734;7847;18652;7757;42479080;41269142;25830983;1164339;28028128
FR;1;2022-05-10;1314;2384;11115;36039;10788;42480394;41271526;25842098;1200378;28038916
FR;1;2022-05-11;1334;2079;8877;25103;8793;42481728;41273605;25850975;1225481;28047709
FR;1;2022-05-12;1207;2127;9692;32354;9325;42482935;41275732;25860667;1257835;28057034
FR;1;2022-05-13;1523;2573;11856;34730;11505;42484458;41278305;25872523;1292565;28068539
FR;1;2022-05-14;734;1224;4951;9971;4836;42485192;41279529;25877474;1302536;28073375
FR;1;2022-05-15;196;330;997;1293;1077;42485388;41279859;25878471;1303829;28074452
FR;1;2022-05-16;874;1513;6546;18776;6600;42486262;41281372;25885017;1322605;28081052
FR;1;2022-05-17;1172;2036;9467;33919;9126;42487434;41283408;25894484;1356524;28090178
FR;1;2022-05-18;1131;1822;7504;23422;7422;42488565;41285230;25901988;1379946;28097600
FR;2;2020-12-27;0;0;0;0;0;0;0;0;0;0
FR;2;2020-12-28;0;0;0;0;0;0;0;0;0;0
FR;2;2020-12-29;0;0;0;0;0;0;0;0;0;0
FR;2;2020-12-30;0;0;0;0;0;0;0;0;0;0
FR;2;2020-12-31;0;0;0;0;0;0;0;0;0;0
FR;2;2021-01-01;0;0;0;0;0;0;0;0;0;0
FR;2;2021-01-02;0;0;0;0;0;0;0;0;0;0
FR;2;2021-01-03;0;0;0;0;0;0;0;0;0;0
FR;2;2021-01-04;0;0;0;0;0;0;0;0;0;0
FR;2;2021-01-05;0;0;0;0;0;0;0;0;0;0
FR;2;2021-01-06;0;0;0;0;0;0;0;0;0;0
FR;2;2021-01-07;0;0;0;0;0;0;0;0;0;0
FR;2;2021-01-08;0;0;0;0;0;0;0;0;0;0
FR;2;2021-01-09;0;0;0;0;0;0;0;0;0;0
FR;2;2021-01-10;0;0;0;0;0;0;0;0;0;0
FR;2;2021-01-11;0;0;0;0;0;0;0;0;0;0
FR;2;2021-01-12;0;0;0;0;0;0;0;0;0;0
FR;2;2021-01-13;0;0;0;0;0;0;0;0;0;0
FR;2;2021-01-14;1691;0;0;0;0;1691;0;0;0;0
FR;2;2021-01-15;394;0;0;0;0;2085;0;0;0;0
FR;2;2021-01-16;315;0;0;0;0;2400;0;0;0;0
FR;2;2021-01-17;80;0;0;0;0;2480;0;0;0;0
FR;2;2021-01-18;3073;2;0;0;0;5553;2;0;0;0
FR;2;2021-01-19;4675;0;0;0;0;10228;2;0;0;0
FR;2;2021-01-20;5135;4;0;0;0;15363;6;0;0;0
FR;2;2021-01-21;5336;8;0;0;0;20699;14;0;0;0
FR;2;2021-01-22;5115;4;0;0;0;25814;18;0;0;0
FR;2;2021-01-23;1866;0;0;0;0;27680;18;0;0;0
FR;2;2021-01-24;160;1;0;0;0;27840;19;0;0;0
FR;2;2021-01-25;3811;3;0;0;0;31651;22;0;0;0
FR;2;2021-01-26;3918;1;0;0;0;35569;23;0;0;0
FR;2;2021-01-27;3597;2;0;0;0;39166;25;0;0;0
FR;2;2021-01-28;3745;6;0;0;0;42911;31;0;0;0
FR;2;2021-01-29;3291;2;0;0;0;46202;33;0;0;0
FR;2;2021-01-30;1130;1;0;0;0;47332;34;0;0;0
FR;2;2021-01-31;45;1;0;0;0;47377;35;0;0;0
FR;2;2021-02-01;3399;2;0;0;0;50776;37;0;0;0
FR;2;2021-02-02;4487;10;0;0;0;55263;47;0;0;0
FR;2;2021-02-03;5216;6;0;0;0;60479;53;0;0;0
FR;2;2021-02-04;4930;10;0;0;0;65409;63;0;0;0
FR;2;2021-02-05;4810;13;0;0;0;70219;76;0;0;0
FR;2;2021-02-06;2040;12;0;0;0;72259;88;0;0;0
FR;2;2021-02-07;101;4;0;0;0;72360;92;0;0;0
FR;2;2021-02-08;7553;19;0;0;0;79913;111;0;0;0
FR;2;2021-02-09;8420;27;0;0;0;88333;138;0;0;0
FR;2;2021-02-10;9336;56;0;0;0;97669;194;0;0;0
FR;2;2021-02-11;10278;95;0;0;0;107947;289;0;0;0
FR;2;2021-02-12;10053;260;0;0;0;118000;549;0;0;0
FR;2;2021-02-13;3118;225;0;0;0;121118;774;0;0;0
FR;2;2021-02-14;354;8;0;0;0;121472;782;0;0;0
FR;2;2021-02-15;3454;3094;0;0;0;124926;3876;0;0;0
FR;2;2021-02-16;5066;4020;0;0;0;129992;7896;0;0;0
FR;2;2021-02-17;4251;4466;0;0;0;134243;12362;0;0;0
FR;2;2021-02-18;5399;5116;0;0;0;139642;17478;0;0;0
FR;2;2021-02-19;5324;4392;0;0;0;144966;21870;0;0;0
FR;2;2021-02-20;1868;1508;0;0;0;146834;23378;0;0;0
FR;2;2021-02-21;242;88;0;0;0;147076;23466;0;0;0
FR;2;2021-02-22;3611;3745;0;0;0;150687;27211;0;0;0
FR;2;2021-02-23;4952;3694;0;0;0;155639;30905;0;0;0
FR;2;2021-02-24;5009;3491;0;0;0;160648;34396;0;0;0
FR;2;2021-02-25;5481;3452;0;0;0;166129;37848;0;0;0
FR;2;2021-02-26;4356;3146;0;0;0;170485;40994;0;0;0
FR;2;2021-02-27;1623;1053;0;0;0;172108;42047;0;0;0
FR;2;2021-02-28;176;29;0;0;0;172284;42076;0;0;0
FR;2;2021-03-01;5174;3725;0;0;0;177458;45801;0;0;0
FR;2;2021-03-02;6528;4723;0;0;0;183986;50524;0;0;0
FR;2;2021-03-03;6533;4918;0;0;0;190519;55442;0;0;0
FR;2;2021-03-04;8394;4049;0;0;0;198913;59491;0;0;0
FR;2;2021-03-05;8026;4059;0;0;0;206939;63550;0;0;0
FR;2;2021-03-06;4783;1683;0;0;0;211722;65233;0;0;0
FR;2;2021-03-07;2372;31;0;0;0;214094;65264;0;0;0
FR;2;2021-03-08;4164;8330;0;0;0;218258;73594;0;0;0
FR;2;2021-03-09;7485;8493;1;0;0;225743;82087;1;0;0
FR;2;2021-03-10;7098;9138;0;0;0;232841;91225;1;0;0
FR;2;2021-03-11;9372;9235;1;0;0;242213;100460;2;0;0
FR;2;2021-03-12;7972;8220;0;0;0;250185;108680;2;0;0
FR;2;2021-03-13;10046;2552;0;0;0;260231;111232;2;0;0
FR;2;2021-03-14;4838;406;0;0;0;265069;111638;2;0;0
FR;2;2021-03-15;10905;3486;0;0;0;275974;115124;2;0;0
FR;2;2021-03-16;16760;4648;1;0;0;292734;119772;3;0;0
FR;2;2021-03-17;20223;3972;0;0;0;312957;123744;3;0;0
FR;2;2021-03-18;23363;4969;0;0;0;336320;128713;3;0;0
FR;2;2021-03-19;23300;4566;0;0;0;359620;133279;3;0;0
FR;2;2021-03-20;25441;1545;0;0;0;385061;134824;3;0;0
FR;2;2021-03-21;17669;149;0;0;0;402730;134973;3;0;0
FR;2;2021-03-22;17782;3138;0;0;0;420512;138111;3;0;0
FR;2;2021-03-23;22686;4201;0;0;0;443198;142312;3;0;0
FR;2;2021-03-24;23954;5013;0;0;0;467152;147325;3;0;0
FR;2;2021-03-25;26736;5135;1;0;0;493888;152460;4;0;0
FR;2;2021-03-26;26975;4198;0;0;0;520863;156658;4;0;0
FR;2;2021-03-27;15917;1328;0;0;0;536780;157986;4;0;0
FR;2;2021-03-28;10561;119;0;0;0;547341;158105;4;0;0
FR;2;2021-03-29;18984;4282;0;0;0;566325;162387;4;0;0
FR;2;2021-03-30;24575;6026;0;0;0;590900;168413;4;0;0
FR;2;2021-03-31;28553;5933;0;0;0;619453;174346;4;0;0
FR;2;2021-04-01;34546;8495;1;0;0;653999;182841;5;0;0
FR;2;2021-04-02;29975;7672;0;0;0;683974;190513;5;0;0
FR;2;2021-04-03;16952;3756;0;0;0;700926;194269;5;0;0
FR;2;2021-04-04;9305;1012;2;0;0;710231;195281;7;0;0
FR;2;2021-04-05;12443;806;0;0;0;722674;196087;7;0;0
FR;2;2021-04-06;27142;7024;0;0;0;749816;203111;7;0;0
FR;2;2021-04-07;30925;7146;1;0;0;780741;210257;8;0;0
FR;2;2021-04-08;36879;8734;1;0;0;817620;218991;9;0;0
FR;2;2021-04-09;33833;8547;28;0;0;851453;227538;37;0;0
FR;2;2021-04-10;19678;9051;1;0;0;871131;236589;38;0;0
FR;2;2021-04-11;7941;4255;1;0;0;879072;240844;39;0;0
FR;2;2021-04-12;17121;11145;0;0;0;896193;251989;39;0;0
FR;2;2021-04-13;19448;16209;1;0;0;915641;268198;40;0;0
FR;2;2021-04-14;18060;16295;7;0;0;933701;284493;47;0;0
FR;2;2021-04-15;22184;20947;27;0;0;955885;305440;74;0;0
FR;2;2021-04-16;20704;20132;45;0;0;976589;325572;119;0;0
FR;2;2021-04-17;13253;22431;5;0;0;989842;348003;124;0;0
FR;2;2021-04-18;5906;14393;6;0;0;995748;362396;130;0;0
FR;2;2021-04-19;16830;16269;24;0;0;1012578;378665;154;0;0
FR;2;2021-04-20;19317;21586;38;0;0;1031895;400251;192;0;0
FR;2;2021-04-21;20280;21699;76;0;0;1052175;421950;268;0;0
FR;2;2021-04-22;23809;24863;41;0;0;1075984;446813;309;0;0
FR;2;2021-04-23;24515;25347;76;0;0;1100499;472160;385;0;0
FR;2;2021-04-24;25300;15090;104;0;0;1125799;487250;489;0;0
FR;2;2021-04-25;9592;8599;5;0;0;1135391;495849;494;0;0
FR;2;2021-04-26;17157;17245;21;0;0;1152548;513094;515;0;0
FR;2;2021-04-27;19240;24223;40;0;0;1171788;537317;555;0;0
FR;2;2021-04-28;22331;26213;112;0;0;1194119;563530;667;0;0
FR;2;2021-04-29;25465;30153;69;0;0;1219584;593683;736;0;0
FR;2;2021-04-30;25529;27738;49;1;0;1245113;621421;785;1;0
FR;2;2021-05-01;14980;9877;6;0;0;1260093;631298;791;1;0
FR;2;2021-05-02;6635;9172;2;0;0;1266728;640470;793;1;0
FR;2;2021-05-03;20012;19251;40;0;0;1286740;659721;833;1;0
FR;2;2021-05-04;18280;29032;33;0;0;1305020;688753;866;1;0
FR;2;2021-05-05;18359;29383;48;0;0;1323379;718136;914;1;0
FR;2;2021-05-06;23538;35234;131;0;0;1346917;753370;1045;1;0
FR;2;2021-05-07;25322;33195;97;0;0;1372239;786565;1142;1;0
FR;2;2021-05-08;21336;9799;14;0;0;1393575;796364;1156;1;0
FR;2;2021-05-09;13162;7846;7;0;0;1406737;804210;1163;1;0
FR;2;2021-05-10;32937;22122;49;0;0;1439674;826332;1212;1;0
FR;2;2021-05-11;43595;21034;101;0;0;1483269;847366;1313;1;0
FR;2;2021-05-12;50039;19843;143;0;0;1533308;867209;1456;1;0
FR;2;2021-05-13;51289;5747;31;0;0;1584597;872956;1487;1;0
FR;2;2021-05-14;61343;12920;132;0;0;1645940;885876;1619;1;0
FR;2;2021-05-15;65923;7134;39;0;0;1711863;893010;1658;1;0
FR;2;2021-05-16;43580;2567;10;0;0;1755443;895577;1668;1;0
FR;2;2021-05-17;44742;12567;113;0;0;1800185;908144;1781;1;0
FR;2;2021-05-18;54633;12238;191;0;0;1854818;920382;1972;1;0
FR;2;2021-05-19;57162;10598;281;0;0;1911980;930980;2253;1;0
FR;2;2021-05-20;63429;10837;287;0;0;1975409;941817;2540;1;0
FR;2;2021-05-21;64288;11638;230;0;0;2039697;953455;2770;1;0
FR;2;2021-05-22;61478;4506;65;0;0;2101175;957961;2835;1;0
FR;2;2021-05-23;37531;570;22;0;0;2138706;958531;2857;1;0
FR;2;2021-05-24;17235;2033;34;0;0;2155941;960564;2891;1;0
FR;2;2021-05-25;21102;12224;240;0;0;2177043;972788;3131;1;0
FR;2;2021-05-26;19932;11454;229;0;0;2196975;984242;3360;1;0
FR;2;2021-05-27;22993;12663;182;0;0;2219968;996905;3542;1;0
FR;2;2021-05-28;29387;14946;190;0;0;2249355;1011851;3732;1;0
FR;2;2021-05-29;30416;8174;57;0;0;2279771;1020025;3789;1;0
FR;2;2021-05-30;4646;1814;6;0;0;2284417;1021839;3795;1;0
FR;2;2021-05-31;28584;18712;183;0;0;2313001;1040551;3978;1;0
FR;2;2021-06-01;45710;20007;224;0;0;2358711;1060558;4202;1;0
FR;2;2021-06-02;37461;19295;181;0;0;2396172;1079853;4383;1;0
FR;2;2021-06-03;51269;23322;161;0;0;2447441;1103175;4544;1;0
FR;2;2021-06-04;65508;24056;215;0;0;2512949;1127231;4759;1;0
FR;2;2021-06-05;34598;24031;51;0;0;2547547;1151262;4810;1;0
FR;2;2021-06-06;4953;6198;10;0;0;2552500;1157460;4820;1;0
FR;2;2021-06-07;28165;23039;146;0;0;2580665;1180499;4966;1;0
FR;2;2021-06-08;46368;22917;143;0;0;2627033;1203416;5109;1;0
FR;2;2021-06-09;34284;20919;107;0;0;2661317;1224335;5216;1;0
FR;2;2021-06-10;42635;19130;95;1;0;2703952;1243465;5311;2;0
FR;2;2021-06-11;55287;25220;134;0;0;2759239;1268685;5445;2;0
FR;2;2021-06-12;30559;19776;53;0;0;2789798;1288461;5498;2;0
FR;2;2021-06-13;3329;9186;13;0;0;2793127;1297647;5511;2;0
FR;2;2021-06-14;25295;24156;92;0;0;2818422;1321803;5603;2;0
FR;2;2021-06-15;39033;22844;154;0;0;2857455;1344647;5757;2;0
FR;2;2021-06-16;30158;21439;134;0;0;2887613;1366086;5891;2;0
FR;2;2021-06-17;36903;25858;150;0;0;2924516;1391944;6041;2;0
FR;2;2021-06-18;46845;28814;122;0;0;2971361;1420758;6163;2;0
FR;2;2021-06-19;24524;24892;39;0;0;2995885;1445650;6202;2;0
FR;2;2021-06-20;3742;10063;10;0;0;2999627;1455713;6212;2;0
FR;2;2021-06-21;17521;42839;87;0;0;3017148;1498552;6299;2;0
FR;2;2021-06-22;28353;49561;110;0;0;3045501;1548113;6409;2;0
FR;2;2021-06-23;21786;49554;106;1;1;3067287;1597667;6515;3;1
FR;2;2021-06-24;28375;50280;133;0;0;3095662;1647947;6648;3;1
FR;2;2021-06-25;33398;60392;127;0;0;3129060;1708339;6775;3;1
FR;2;2021-06-26;16379;59246;54;1;0;3145439;1767585;6829;4;1
FR;2;2021-06-27;2564;29322;22;1;0;3148003;1796907;6851;5;1
FR;2;2021-06-28;12637;54342;81;0;0;3160640;1851249;6932;5;1
FR;2;2021-06-29;19841;59886;178;0;0;3180481;1911135;7110;5;1
FR;2;2021-06-30;16321;57870;252;17;0;3196802;1969005;7362;22;1
FR;2;2021-07-01;20482;59892;227;0;0;3217284;2028897;7589;22;1
FR;2;2021-07-02;24069;62131;184;0;0;3241353;2091028;7773;22;1
FR;2;2021-07-03;12111;57086;153;0;0;3253464;2148114;7926;22;1
FR;2;2021-07-04;1958;23308;18;0;0;3255422;2171422;7944;22;1
FR;2;2021-07-05;9170;29365;106;0;0;3264592;2200787;8050;22;1
FR;2;2021-07-06;14574;36203;135;0;0;3279166;2236990;8185;22;1
FR;2;2021-07-07;14404;33671;139;0;0;3293570;2270661;8324;22;1
FR;2;2021-07-08;19713;40296;162;0;0;3313283;2310957;8486;22;1
FR;2;2021-07-09;27093;54268;202;1;0;3340376;2365225;8688;23;1
FR;2;2021-07-10;13384;33662;107;0;0;3353760;2398887;8795;23;1
FR;2;2021-07-11;1805;4350;16;0;0;3355565;2403237;8811;23;1
FR;2;2021-07-12;12960;37278;118;0;0;3368525;2440515;8929;23;1
FR;2;2021-07-13;37108;53219;150;0;0;3405633;2493734;9079;23;1
FR;2;2021-07-14;6607;3559;15;0;0;3412240;2497293;9094;23;1
FR;2;2021-07-15;47231;47023;156;0;0;3459471;2544316;9250;23;1
FR;2;2021-07-16;64306;55815;187;0;0;3523777;2600131;9437;23;1
FR;2;2021-07-17;31592;23931;96;0;0;3555369;2624062;9533;23;1
FR;2;2021-07-18;6087;4881;19;0;0;3561456;2628943;9552;23;1
FR;2;2021-07-19;32987;28680;94;0;0;3594443;2657623;9646;23;1
FR;2;2021-07-20;51989;44564;155;0;0;3646432;2702187;9801;23;1
FR;2;2021-07-21;45243;34756;93;0;0;3691675;2736943;9894;23;1
FR;2;2021-07-22;56272;41095;128;1;0;3747947;2778038;10022;24;1
FR;2;2021-07-23;68275;49084;170;0;0;3816222;2827122;10192;24;1
FR;2;2021-07-24;36165;21590;82;0;0;3852387;2848712;10274;24;1
FR;2;2021-07-25;6742;2654;10;0;0;3859129;2851366;10284;24;1
FR;2;2021-07-26;36295;22452;91;1;0;3895424;2873818;10375;25;1
FR;2;2021-07-27;62353;34622;180;0;0;3957777;2908440;10555;25;1
FR;2;2021-07-28;55296;26456;132;0;0;4013073;2934896;10687;25;1
FR;2;2021-07-29;68455;32784;189;0;0;4081528;2967680;10876;25;1
FR;2;2021-07-30;74430;37777;222;1;1;4155958;3005457;11098;26;2
FR;2;2021-07-31;34750;16185;104;0;0;4190708;3021642;11202;26;2
FR;2;2021-08-01;5397;2284;19;0;0;4196105;3023926;11221;26;2
FR;2;2021-08-02;35859;16201;101;0;0;4231964;3040127;11322;26;2
FR;2;2021-08-03;55959;28291;142;0;0;4287923;3068418;11464;26;2
FR;2;2021-08-04;46621;20864;128;1;0;4334544;3089282;11592;27;2
FR;2;2021-08-05;54617;31584;215;0;0;4389161;3120866;11807;27;2
FR;2;2021-08-06;58079;42391;242;1;0;4447240;3163257;12049;28;2
FR;2;2021-08-07;25132;17600;89;0;0;4472372;3180857;12138;28;2
FR;2;2021-08-08;3832;3671;21;0;0;4476204;3184528;12159;28;2
FR;2;2021-08-09;29296;21133;91;0;0;4505500;3205661;12250;28;2
FR;2;2021-08-10;44988;33513;154;0;0;4550488;3239174;12404;28;2
FR;2;2021-08-11;35264;25171;151;0;0;4585752;3264345;12555;28;2
FR;2;2021-08-12;41891;35728;162;0;0;4627643;3300073;12717;28;2
FR;2;2021-08-13;42585;37056;218;0;0;4670228;3337129;12935;28;2
FR;2;2021-08-14;18507;22254;93;0;0;4688735;3359383;13028;28;2
FR;2;2021-08-15;3815;3816;17;0;0;4692550;3363199;13045;28;2
FR;2;2021-08-16;25077;27199;110;0;0;4717627;3390398;13155;28;2
FR;2;2021-08-17;38249;43486;205;2;0;4755876;3433884;13360;30;2
FR;2;2021-08-18;32246;36371;195;1;1;4788122;3470255;13555;31;3
FR;2;2021-08-19;37427;46586;224;0;0;4825549;3516841;13779;31;3
FR;2;2021-08-20;40555;55606;269;1;0;4866104;3572447;14048;32;3
FR;2;2021-08-21;18116;24306;114;0;0;4884220;3596753;14162;32;3
FR;2;2021-08-22;2902;4319;22;1;1;4887122;3601072;14184;33;4
FR;2;2021-08-23;19238;35159;131;1;1;4906360;3636231;14315;34;5
FR;2;2021-08-24;31939;56033;235;0;0;4938299;3692264;14550;34;5
FR;2;2021-08-25;25926;43429;250;0;0;4964225;3735693;14800;34;5
FR;2;2021-08-26;32348;55792;387;0;0;4996573;3791485;15187;34;5
FR;2;2021-08-27;36992;65590;478;3;1;5033565;3857075;15665;37;6
FR;2;2021-08-28;17813;28471;300;0;0;5051378;3885546;15965;37;6
FR;2;2021-08-29;2655;5040;47;0;0;5054033;3890586;16012;37;6
FR;2;2021-08-30;18409;37749;399;0;753;5072442;3928335;16411;37;759
FR;2;2021-08-31;28077;57492;884;4;1538;5100519;3985827;17295;41;2297
FR;2;2021-09-01;21590;39842;1307;0;2091;5122109;4025669;18602;41;4388
FR;2;2021-09-02;25476;48611;1960;2;3289;5147585;4074280;20562;43;7677
FR;2;2021-09-03;33404;64475;2986;3;4827;5180989;4138755;23548;46;12504
FR;2;2021-09-04;16826;27702;1442;1;2354;5197815;4166457;24990;47;14858
FR;2;2021-09-05;2259;3607;264;0;411;5200074;4170064;25254;47;15269
FR;2;2021-09-06;14034;28731;1769;1;2930;5214108;4198795;27023;48;18199
FR;2;2021-09-07;21102;41051;3020;13;4855;5235210;4239846;30043;61;23054
FR;2;2021-09-08;17240;31934;2732;6;4468;5252450;4271780;32775;67;27522
FR;2;2021-09-09;20973;40433;4432;3;6755;5273423;4312213;37207;70;34277
FR;2;2021-09-10;28196;51142;5281;4;8821;5301619;4363355;42488;74;43098
FR;2;2021-09-11;13652;22353;2403;5;3939;5315271;4385708;44891;79;47037
FR;2;2021-09-12;1822;2787;284;0;505;5317093;4388495;45175;79;47542
FR;2;2021-09-13;11656;21446;2468;4;4009;5328749;4409941;47643;83;51551
FR;2;2021-09-14;18567;32768;5084;13;9035;5347316;4442709;52727;96;60586
FR;2;2021-09-15;14910;28281;5164;3;7780;5362226;4470990;57891;99;68366
FR;2;2021-09-16;16069;32767;6735;14;10530;5378295;4503757;64626;113;78896
FR;2;2021-09-17;20911;47083;8775;10;14570;5399206;4550840;73401;123;93466
FR;2;2021-09-18;9855;20929;3803;6;6023;5409061;4571769;77204;129;99489
FR;2;2021-09-19;1165;2648;395;0;645;5410226;4574417;77599;129;100134
FR;2;2021-09-20;7490;18785;3851;7;6153;5417716;4593202;81450;136;106287
FR;2;2021-09-21;11205;29997;6494;5;10738;5428921;4623199;87944;141;117025
FR;2;2021-09-22;9405;23549;5491;7;8512;5438326;4646748;93435;148;125537
FR;2;2021-09-23;10721;28874;7879;9;12637;5449047;4675622;101314;157;138174
FR;2;2021-09-24;15063;42863;10873;18;17189;5464110;4718485;112187;175;155363
FR;2;2021-09-25;7258;18730;3962;10;6083;5471368;4737215;116149;185;161446
FR;2;2021-09-26;1079;2558;494;0;632;5472447;4739773;116643;185;162078
FR;2;2021-09-27;6312;16452;4286;7;6550;5478759;4756225;120929;192;168628
FR;2;2021-09-28;9239;25546;7768;13;12070;5487998;4781771;128697;205;180698
FR;2;2021-09-29;8080;20211;6066;25;9261;5496078;4801982;134763;230;189959
FR;2;2021-09-30;9862;25783;9503;16;14075;5505940;4827765;144266;246;204034
FR;2;2021-10-01;13967;35635;12912;25;19228;5519907;4863400;157178;271;223262
FR;2;2021-10-02;6873;15882;4845;6;7012;5526780;4879282;162023;277;230274
FR;2;2021-10-03;841;1938;491;1;512;5527621;4881220;162514;278;230786
FR;2;2021-10-04;5817;13924;5514;5;7853;5533438;4895144;168028;283;238639
FR;2;2021-10-05;9052;22546;11121;19;15712;5542490;4917690;179149;302;254351
FR;2;2021-10-06;7778;17740;8238;11;11069;5550268;4935430;187387;313;265420
FR;2;2021-10-07;9193;22173;12378;15;16832;5559461;4957603;199765;328;282252
FR;2;2021-10-08;13423;32052;17345;27;23535;5572884;4989655;217110;355;305787
FR;2;2021-10-09;5999;12823;6041;6;7874;5578883;5002478;223151;361;313661
FR;2;2021-10-10;883;1635;436;2;633;5579766;5004113;223587;363;314294
FR;2;2021-10-11;5604;11605;6454;17;8837;5585370;5015718;230041;380;323131
FR;2;2021-10-12;8035;17753;12536;13;16727;5593405;5033471;242577;393;339858
FR;2;2021-10-13;6944;14849;10245;11;13608;5600349;5048320;252822;404;353466
FR;2;2021-10-14;8310;17939;14989;13;19449;5608659;5066259;267811;417;372915
FR;2;2021-10-15;11844;26278;20901;26;27945;5620503;5092537;288712;443;400860
FR;2;2021-10-16;5136;8721;1816;0;3203;5625639;5101258;290528;443;404063
FR;2;2021-10-17;651;1188;184;0;374;5626290;5102446;290712;443;404437
FR;2;2021-10-18;4558;7417;661;2;1671;5630848;5109863;291373;445;406108
FR;2;2021-10-19;6238;9895;729;5;2055;5637086;5119758;292102;450;408163
FR;2;2021-10-20;5161;8101;756;3;1684;5642247;5127859;292858;453;409847
FR;2;2021-10-21;6088;9968;779;5;2101;5648335;5137827;293637;458;411948
FR;2;2021-10-22;8446;14574;1147;4;2873;5656781;5152401;294784;462;414821
FR;2;2021-10-23;3840;5995;584;0;1234;5660621;5158396;295368;462;416055
FR;2;2021-10-24;494;888;100;0;203;5661115;5159284;295468;462;416258
FR;2;2021-10-25;3357;5371;301;1;825;5664472;5164655;295769;463;417083
FR;2;2021-10-26;4173;7257;1124;4;2004;5668645;5171912;296893;467;419087
FR;2;2021-10-27;3672;6626;1193;5;1998;5672317;5178538;298086;472;421085
FR;2;2021-10-28;4596;7694;1727;3;2745;5676913;5186232;299813;475;423830
FR;2;2021-10-29;5405;11078;2430;4;3667;5682318;5197310;302243;479;427497
FR;2;2021-10-30;2748;4433;972;1;1428;5685066;5201743;303215;480;428925
FR;2;2021-10-31;363;537;139;1;186;5685429;5202280;303354;481;429111
FR;2;2021-11-01;416;561;174;0;266;5685845;5202841;303528;481;429377
FR;2;2021-11-02;3287;6761;1179;0;1757;5689132;5209602;304707;481;431134
FR;2;2021-11-03;3337;6251;1383;2;1965;5692469;5215853;306090;483;433099
FR;2;2021-11-04;3985;7099;1760;4;2491;5696454;5222952;307850;487;435590
FR;2;2021-11-05;5226;10510;2863;5;3944;5701680;5233462;310713;492;439534
FR;2;2021-11-06;2594;4670;1397;0;1809;5704274;5238132;312110;492;441343
FR;2;2021-11-07;508;865;216;0;285;5704782;5238997;312326;492;441628
FR;2;2021-11-08;2575;5363;1201;3;1679;5707357;5244360;313527;495;443307
FR;2;2021-11-09;2749;6945;2392;6;3173;5710106;5251305;315919;501;446480
FR;2;2021-11-10;2584;5713;5093;6;6271;5712690;5257018;321012;507;452751
FR;2;2021-11-11;433;744;731;2;914;5713123;5257762;321743;509;453665
FR;2;2021-11-12;2951;8109;8963;8;10901;5716074;5265871;330706;517;464566
FR;2;2021-11-13;1534;3381;3865;7;4528;5717608;5269252;334571;524;469094
FR;2;2021-11-14;254;603;348;1;485;5717862;5269855;334919;525;469579
FR;2;2021-11-15;1620;3693;4434;9;5318;5719482;5273548;339353;534;474897
FR;2;2021-11-16;2184;5946;8293;14;10070;5721666;5279494;347646;548;484967
FR;2;2021-11-17;1740;4566;6619;8;7834;5723406;5284060;354265;556;492801
FR;2;2021-11-18;2189;5949;9169;11;10994;5725595;5290009;363434;567;503795
FR;2;2021-11-19;2697;7804;12958;19;15464;5728292;5297813;376392;586;519259
FR;2;2021-11-20;1563;3332;5169;5;6073;5729855;5301145;381561;591;525332
FR;2;2021-11-21;246;518;540;0;663;5730101;5301663;382101;591;525995
FR;2;2021-11-22;1275;2623;4469;5;5401;5731376;5304286;386570;596;531396
FR;2;2021-11-23;1613;4315;8186;9;9895;5732989;5308601;394756;605;541291
FR;2;2021-11-24;1418;3800;7462;14;8720;5734407;5312401;402218;619;550011
FR;2;2021-11-25;1812;4892;11446;21;13641;5736219;5317293;413664;640;563652
FR;2;2021-11-26;2537;7777;22649;31;26062;5738756;5325070;436313;671;589714
FR;2;2021-11-27;1497;4129;12255;18;13992;5740253;5329199;448568;689;603706
FR;2;2021-11-28;291;842;1965;3;2286;5740544;5330041;450533;692;605992
FR;2;2021-11-29;1444;4386;15073;23;17242;5741988;5334427;465606;715;623234
FR;2;2021-11-30;1913;6752;26220;36;29973;5743901;5341179;491826;751;653207
FR;2;2021-12-01;1904;6101;26182;29;29501;5745805;5347280;518008;780;682708
FR;2;2021-12-02;1908;6831;37684;52;41928;5747713;5354111;555692;832;724636
FR;2;2021-12-03;2550;10108;53586;112;59307;5750263;5364219;609278;944;783943
FR;2;2021-12-04;1849;6302;37089;38;40765;5752112;5370521;646367;982;824708
FR;2;2021-12-05;458;2263;14252;14;15988;5752570;5372784;660619;996;840696
FR;2;2021-12-06;2463;9897;77682;109;84730;5755033;5382681;738301;1105;925426
FR;2;2021-12-07;3445;15332;122407;238;133689;5758478;5398013;860708;1343;1059115
FR;2;2021-12-08;3717;16058;133169;330;145370;5762195;5414071;993877;1673;1204485
FR;2;2021-12-09;4543;19629;170142;554;185499;5766738;5433700;1164019;2227;1389984
FR;2;2021-12-10;4671;22811;188607;490;206038;5771409;5456511;1352626;2717;1596022
FR;2;2021-12-11;3681;16623;132419;239;144851;5775090;5473134;1485045;2956;1740873
FR;2;2021-12-12;1257;7130;59080;83;65127;5776347;5480264;1544125;3039;1806000
FR;2;2021-12-13;5525;26858;220652;604;242930;5781872;5507122;1764777;3643;2048930
FR;2;2021-12-14;7016;37535;300711;910;332185;5788888;5544657;2065488;4553;2381115
FR;2;2021-12-15;6559;36236;285170;955;315768;5795447;5580893;2350658;5508;2696883
FR;2;2021-12-16;7762;37922;312099;981;343679;5803209;5618815;2662757;6489;3040562
FR;2;2021-12-17;8680;41247;327828;975;360906;5811889;5660062;2990585;7464;3401468
FR;2;2021-12-18;6516;26560;212316;448;233613;5818405;5686622;3202901;7912;3635081
FR;2;2021-12-19;2600;11490;90201;184;100379;5821005;5698112;3293102;8096;3735460
FR;2;2021-12-20;9550;33605;275152;706;303316;5830555;5731717;3568254;8802;4038776
FR;2;2021-12-21;11555;38324;309587;969;341374;5842110;5770041;3877841;9771;4380150
FR;2;2021-12-22;10458;32856;265080;952;292466;5852568;5802897;4142921;10723;4672616
FR;2;2021-12-23;9426;26707;199457;700;221258;5861994;5829604;4342378;11423;4893874
FR;2;2021-12-24;2781;7496;43845;140;49560;5864775;5837100;4386223;11563;4943434
FR;2;2021-12-25;201;700;2000;10;2495;5864976;5837800;4388223;11573;4945929
FR;2;2021-12-26;1322;4216;25146;71;28677;5866298;5842016;4413369;11644;4974606
FR;2;2021-12-27;8075;29941;218377;659;243298;5874373;5871957;4631746;12303;5217904
FR;2;2021-12-28;9840;36337;272062;741;301946;5884213;5908294;4903808;13044;5519850
FR;2;2021-12-29;9492;32292;246104;766;272679;5893705;5940586;5149912;13810;5792529
FR;2;2021-12-30;9453;28142;208806;662;231466;5903158;5968728;5358718;14472;6023995
FR;2;2021-12-31;3008;8378;54978;177;61236;5906166;5977106;5413696;14649;6085231
FR;2;2022-01-01;227;692;2849;7;3344;5906393;5977798;5416545;14656;6088575
FR;2;2022-01-02;1505;4854;29504;75;33389;5907898;5982652;5446049;14731;6121964
FR;2;2022-01-03;9583;35370;266501;807;293863;5917481;6018022;5712550;15538;6415827
FR;2;2022-01-04;12842;45377;342059;1067;376943;5930323;6063399;6054609;16605;6792770
FR;2;2022-01-05;11269;38660;294150;885;323803;5941592;6102059;6348759;17490;7116573
FR;2;2022-01-06;13649;43494;331927;1298;364703;5955241;6145553;6680686;18788;7481276
FR;2;2022-01-07;14220;47638;361072;1270;396403;5969461;6193191;7041758;20058;7877679
FR;2;2022-01-08;7946;28148;201255;515;221683;5977407;6221339;7243013;20573;8099362
FR;2;2022-01-09;2749;8998;62517;137;69522;5980156;6230337;7305530;20710;8168884
FR;2;2022-01-10;10086;31920;232447;858;255032;5990242;6262257;7537977;21568;8423916
FR;2;2022-01-11;11470;36253;265879;1030;290572;6001712;6298510;7803856;22598;8714488
FR;2;2022-01-12;8758;29841;206297;862;226173;6010470;6328351;8010153;23460;8940661
FR;2;2022-01-13;9386;31346;224461;831;244808;6019856;6359697;8234614;24291;9185469
FR;2;2022-01-14;9743;35664;254517;919;277679;6029599;6395361;8489131;25210;9463148
FR;2;2022-01-15;5355;19454;140766;359;153634;6034954;6414815;8629897;25569;9616782
FR;2;2022-01-16;1512;5522;35870;80;39849;6036466;6420337;8665767;25649;9656631
FR;2;2022-01-17;5545;19302;135384;601;147248;6042011;6439639;8801151;26250;9803879
FR;2;2022-01-18;6417;21528;148608;648;160469;6048428;6461167;8949759;26898;9964348
FR;2;2022-01-19;4389;16358;105081;552;113698;6052817;6477525;9054840;27450;10078046
FR;2;2022-01-20;4867;17596;115273;603;123669;6057684;6495121;9170113;28053;10201715
FR;2;2022-01-21;5194;20063;137324;678;147743;6062878;6515184;9307437;28731;10349458
FR;2;2022-01-22;3027;10962;74254;259;80327;6065905;6526146;9381691;28990;10429785
FR;2;2022-01-23;722;2736;15236;41;16837;6066627;6528882;9396927;29031;10446622
FR;2;2022-01-24;3293;12826;75057;430;81017;6069920;6541708;9471984;29461;10527639
FR;2;2022-01-25;3570;14438;79611;495;85448;6073490;6556146;9551595;29956;10613087
FR;2;2022-01-26;2515;10662;58957;363;62982;6076005;6566808;9610552;30319;10676069
FR;2;2022-01-27;2683;11264;64163;388;67901;6078688;6578072;9674715;30707;10743970
FR;2;2022-01-28;3543;18386;91710;430;98960;6082231;6596458;9766425;31137;10842930
FR;2;2022-01-29;1892;9253;48834;164;52920;6084123;6605711;9815259;31301;10895850
FR;2;2022-01-30;466;2242;9453;38;10606;6084589;6607953;9824712;31339;10906456
FR;2;2022-01-31;1887;9590;43817;208;47340;6086476;6617543;9868529;31547;10953796
FR;2;2022-02-01;1912;10048;47018;278;50100;6088388;6627591;9915547;31825;11003896
FR;2;2022-02-02;1605;9032;41100;251;44174;6089993;6636623;9956647;32076;11048070
FR;2;2022-02-03;1722;8945;40506;204;42905;6091715;6645568;9997153;32280;11090975
FR;2;2022-02-04;2152;15217;66626;297;71346;6093867;6660785;10063779;32577;11162321
FR;2;2022-02-05;1362;8538;35935;131;39232;6095229;6669323;10099714;32708;11201553
FR;2;2022-02-06;274;1780;6124;16;6899;6095503;6671103;10105838;32724;11208452
FR;2;2022-02-07;1350;9609;37746;133;41304;6096853;6680712;10143584;32857;11249756
FR;2;2022-02-08;1298;9811;40926;173;43710;6098151;6690523;10184510;33030;11293466
FR;2;2022-02-09;1160;8812;37032;172;40451;6099311;6699335;10221542;33202;11333917
FR;2;2022-02-10;1024;7985;33831;203;36498;6100335;6707320;10255373;33405;11370415
FR;2;2022-02-11;1389;12077;53337;222;57682;6101724;6719397;10308710;33627;11428097
FR;2;2022-02-12;749;6529;27985;83;30802;6102473;6725926;10336695;33710;11458899
FR;2;2022-02-13;200;1335;4833;20;5574;6102673;6727261;10341528;33730;11464473
FR;2;2022-02-14;834;6726;30262;89;33225;6103507;6733987;10371790;33819;11497698
FR;2;2022-02-15;771;6447;28044;141;29981;6104278;6740434;10399834;33960;11527679
FR;2;2022-02-16;656;5340;22048;123;23607;6104934;6745774;10421882;34083;11551286
FR;2;2022-02-17;513;3770;14144;98;14607;6105447;6749544;10436026;34181;11565893
FR;2;2022-02-18;721;5361;20427;134;21124;6106168;6754905;10456453;34315;11587017
FR;2;2022-02-19;430;3046;10527;66;11241;6106598;6757951;10466980;34381;11598258
FR;2;2022-02-20;101;512;1456;3;1604;6106699;6758463;10468436;34384;11599862
FR;2;2022-02-21;420;2682;9116;65;9492;6107119;6761145;10477552;34449;11609354
FR;2;2022-02-22;390;2564;8887;76;8791;6107509;6763709;10486439;34525;11618145
FR;2;2022-02-23;432;2600;8986;82;9265;6107941;6766309;10495425;34607;11627410
FR;2;2022-02-24;313;2028;6795;81;6824;6108254;6768337;10502220;34688;11634234
FR;2;2022-02-25;455;3194;11413;108;11276;6108709;6771531;10513633;34796;11645510
FR;2;2022-02-26;294;1889;6035;49;6340;6109003;6773420;10519668;34845;11651850
FR;2;2022-02-27;75;312;905;5;948;6109078;6773732;10520573;34850;11652798
FR;2;2022-02-28;330;1680;5519;53;5527;6109408;6775412;10526092;34903;11658325
FR;2;2022-03-01;274;1557;5473;44;5191;6109682;6776969;10531565;34947;11663516
FR;2;2022-03-02;296;1429;5242;43;5082;6109978;6778398;10536807;34990;11668598
FR;2;2022-03-03;225;1101;3703;42;3478;6110203;6779499;10540510;35032;11672076
FR;2;2022-03-04;240;1461;4852;73;4497;6110443;6780960;10545362;35105;11676573
FR;2;2022-03-05;171;903;2973;32;2716;6110614;6781863;10548335;35137;11679289
FR;2;2022-03-06;40;181;277;5;316;6110654;6782044;10548612;35142;11679605
FR;2;2022-03-07;155;652;1981;69;1772;6110809;6782696;10550593;35211;11681377
FR;2;2022-03-08;143;652;2270;51;1902;6110952;6783348;10552863;35262;11683279
FR;2;2022-03-09;152;695;2341;37;2042;6111104;6784043;10555204;35299;11685321
FR;2;2022-03-10;119;592;1685;34;1457;6111223;6784635;10556889;35333;11686778
FR;2;2022-03-11;169;752;2767;57;2365;6111392;6785387;10559656;35390;11689143
FR;2;2022-03-12;143;480;1784;27;1553;6111535;6785867;10561440;35417;11690696
FR;2;2022-03-13;25;75;201;29;202;6111560;6785942;10561641;35446;11690898
FR;2;2022-03-14;124;464;1560;529;1289;6111684;6786406;10563201;35975;11692187
FR;2;2022-03-15;138;417;1705;688;1321;6111822;6786823;10564906;36663;11693508
FR;2;2022-03-16;140;461;2010;1611;1587;6111962;6787284;10566916;38274;11695095
FR;2;2022-03-17;93;411;1404;1192;1141;6112055;6787695;10568320;39466;11696236
FR;2;2022-03-18;143;489;2016;1787;1659;6112198;6788184;10570336;41253;11697895
FR;2;2022-03-19;108;318;1209;940;1013;6112306;6788502;10571545;42193;11698908
FR;2;2022-03-20;12;76;190;59;166;6112318;6788578;10571735;42252;11699074
FR;2;2022-03-21;96;301;1209;1481;1073;6112414;6788879;10572944;43733;11700147
FR;2;2022-03-22;116;382;1528;1827;1290;6112530;6789261;10574472;45560;11701437
FR;2;2022-03-23;137;343;1664;3031;1455;6112667;6789604;10576136;48591;11702892
FR;2;2022-03-24;115;290;1179;1546;995;6112782;6789894;10577315;50137;11703887
FR;2;2022-03-25;119;360;1801;2449;1471;6112901;6790254;10579116;52586;11705358
FR;2;2022-03-26;76;246;1202;1220;952;6112977;6790500;10580318;53806;11706310
FR;2;2022-03-27;19;36;150;98;130;6112996;6790536;10580468;53904;11706440
FR;2;2022-03-28;93;285;1133;1588;992;6113089;6790821;10581601;55492;11707432
FR;2;2022-03-29;106;257;1324;2462;1104;6113195;6791078;10582925;57954;11708536
FR;2;2022-03-30;90;312;1482;3183;1315;6113285;6791390;10584407;61137;11709851
FR;2;2022-03-31;103;279;1268;2312;1082;6113388;6791669;10585675;63449;11710933
FR;2;2022-04-01;118;313;1558;2340;1310;6113506;6791982;10587233;65789;11712243
FR;2;2022-04-02;72;160;845;889;737;6113578;6792142;10588078;66678;11712980
FR;2;2022-04-03;16;53;128;112;142;6113594;6792195;10588206;66790;11713122
FR;2;2022-04-04;106;224;982;1434;789;6113700;6792419;10589188;68224;11713911
FR;2;2022-04-05;142;286;1300;2868;1128;6113842;6792705;10590488;71092;11715039
FR;2;2022-04-06;87;242;1300;2498;1111;6113929;6792947;10591788;73590;11716150
FR;2;2022-04-07;118;214;1290;2681;1030;6114047;6793161;10593078;76271;11717180
FR;2;2022-04-08;123;327;1617;3207;1316;6114170;6793488;10594695;79478;11718496
FR;2;2022-04-09;90;218;896;1045;731;6114260;6793706;10595591;80523;11719227
FR;2;2022-04-10;36;43;143;161;116;6114296;6793749;10595734;80684;11719343
FR;2;2022-04-11;85;184;878;1518;769;6114381;6793933;10596612;82202;11720112
FR;2;2022-04-12;177;259;1169;2700;1041;6114558;6794192;10597781;84902;11721153
FR;2;2022-04-13;139;222;1109;2405;967;6114697;6794414;10598890;87307;11722120
FR;2;2022-04-14;114;216;1076;2653;906;6114811;6794630;10599966;89960;11723026
FR;2;2022-04-15;111;238;1185;2247;1042;6114922;6794868;10601151;92207;11724068
FR;2;2022-04-16;64;108;537;543;449;6114986;6794976;10601688;92750;11724517
FR;2;2022-04-17;14;26;57;53;53;6115000;6795002;10601745;92803;11724570
FR;2;2022-04-18;11;34;118;64;112;6115011;6795036;10601863;92867;11724682
FR;2;2022-04-19;108;235;1110;1686;942;6115119;6795271;10602973;94553;11725624
FR;2;2022-04-20;94;236;1089;2099;917;6115213;6795507;10604062;96652;11726541
FR;2;2022-04-21;108;228;970;1810;828;6115321;6795735;10605032;98462;11727369
FR;2;2022-04-22;96;265;1226;2055;1006;6115417;6796000;10606258;100517;11728375
FR;2;2022-04-23;66;153;644;762;573;6115483;6796153;10606902;101279;11728948
FR;2;2022-04-24;10;28;98;68;76;6115493;6796181;10607000;101347;11729024
FR;2;2022-04-25;99;199;792;1293;700;6115592;6796380;10607792;102640;11729724
FR;2;2022-04-26;103;182;1027;1897;867;6115695;6796562;10608819;104537;11730591
FR;2;2022-04-27;92;175;850;1665;754;6115787;6796737;10609669;106202;11731345
FR;2;2022-04-28;90;208;941;1848;820;6115877;6796945;10610610;108050;11732165
FR;2;2022-04-29;74;275;1117;1685;1026;6115951;6797220;10611727;109735;11733191
FR;2;2022-04-30;63;124;462;534;421;6116014;6797344;10612189;110269;11733612
FR;2;2022-05-01;14;22;79;42;80;6116028;6797366;10612268;110311;11733692
FR;2;2022-05-02;111;205;715;1199;618;6116139;6797571;10612983;111510;11734310
FR;2;2022-05-03;144;221;953;1728;894;6116283;6797792;10613936;113238;11735204
FR;2;2022-05-04;84;211;882;1750;827;6116367;6798003;10614818;114988;11736031
FR;2;2022-05-05;118;189;814;1652;724;6116485;6798192;10615632;116640;11736755
FR;2;2022-05-06;125;231;1074;1828;989;6116610;6798423;10616706;118468;11737744
FR;2;2022-05-07;39;94;460;502;397;6116649;6798517;10617166;118970;11738141
FR;2;2022-05-08;41;45;101;70;89;6116690;6798562;10617267;119040;11738230
FR;2;2022-05-09;99;162;612;907;564;6116789;6798724;10617879;119947;11738794
FR;2;2022-05-10;108;227;859;1730;813;6116897;6798951;10618738;121677;11739607
FR;2;2022-05-11;95;158;751;1752;717;6116992;6799109;10619489;123429;11740324
FR;2;2022-05-12;101;162;790;1988;747;6117093;6799271;10620279;125417;11741071
FR;2;2022-05-13;93;221;914;1877;850;6117186;6799492;10621193;127294;11741921
FR;2;2022-05-14;75;106;421;544;382;6117261;6799598;10621614;127838;11742303
FR;2;2022-05-15;23;34;88;86;99;6117284;6799632;10621702;127924;11742402
FR;2;2022-05-16;99;151;534;902;474;6117383;6799783;10622236;128826;11742876
FR;2;2022-05-17;84;174;623;1553;593;6117467;6799957;10622859;130379;11743469
FR;2;2022-05-18;75;159;562;1171;540;6117542;6800116;10623421;131550;11744009
FR;3;2020-12-27;0;0;0;0;0;0;0;0;0;0
FR;3;2020-12-28;0;0;0;0;0;0;0;0;0;0
FR;3;2020-12-29;0;0;0;0;0;0;0;0;0;0
FR;3;2020-12-30;0;0;0;0;0;0;0;0;0;0
FR;3;2020-12-31;0;0;0;0;0;0;0;0;0;0
FR;3;2021-01-01;0;0;0;0;0;0;0;0;0;0
FR;3;2021-01-02;0;0;0;0;0;0;0;0;0;0
FR;3;2021-01-03;0;0;0;0;0;0;0;0;0;0
FR;3;2021-01-04;0;0;0;0;0;0;0;0;0;0
FR;3;2021-01-05;0;0;0;0;0;0;0;0;0;0
FR;3;2021-01-06;0;0;0;0;0;0;0;0;0;0
FR;3;2021-01-07;0;0;0;0;0;0;0;0;0;0
FR;3;2021-01-08;0;0;0;0;0;0;0;0;0;0
FR;3;2021-01-09;0;0;0;0;0;0;0;0;0;0
FR;3;2021-01-10;0;0;0;0;0;0;0;0;0;0
FR;3;2021-01-11;0;0;0;0;0;0;0;0;0;0
FR;3;2021-01-12;0;0;0;0;0;0;0;0;0;0
FR;3;2021-01-13;0;0;0;0;0;0;0;0;0;0
FR;3;2021-01-14;0;0;0;0;0;0;0;0;0;0
FR;3;2021-01-15;0;0;0;0;0;0;0;0;0;0
FR;3;2021-01-16;0;0;0;0;0;0;0;0;0;0
FR;3;2021-01-17;0;0;0;0;0;0;0;0;0;0
FR;3;2021-01-18;0;0;0;0;0;0;0;0;0;0
FR;3;2021-01-19;0;0;0;0;0;0;0;0;0;0
FR;3;2021-01-20;0;0;0;0;0;0;0;0;0;0
FR;3;2021-01-21;0;0;0;0;0;0;0;0;0;0
FR;3;2021-01-22;0;0;0;0;0;0;0;0;0;0
FR;3;2021-01-23;0;0;0;0;0;0;0;0;0;0
FR;3;2021-01-24;0;0;0;0;0;0;0;0;0;0
FR;3;2021-01-25;0;0;0;0;0;0;0;0;0;0
FR;3;2021-01-26;0;0;0;0;0;0;0;0;0;0
FR;3;2021-01-27;0;0;0;0;0;0;0;0;0;0
FR;3;2021-01-28;0;0;0;0;0;0;0;0;0;0
FR;3;2021-01-29;0;0;0;0;0;0;0;0;0;0
FR;3;2021-01-30;0;0;0;0;0;0;0;0;0;0
FR;3;2021-01-31;0;0;0;0;0;0;0;0;0;0
FR;3;2021-02-01;0;0;0;0;0;0;0;0;0;0
FR;3;2021-02-02;0;0;0;0;0;0;0;0;0;0
FR;3;2021-02-03;0;0;0;0;0;0;0;0;0;0
FR;3;2021-02-04;0;0;0;0;0;0;0;0;0;0
FR;3;2021-02-05;0;0;0;0;0;0;0;0;0;0
FR;3;2021-02-06;1673;0;0;0;0;1673;0;0;0;0
FR;3;2021-02-07;1422;0;0;0;0;3095;0;0;0;0
FR;3;2021-02-08;2782;1;0;0;0;5877;1;0;0;0
FR;3;2021-02-09;6782;0;0;0;0;12659;1;0;0;0
FR;3;2021-02-10;9603;0;0;0;0;22262;1;0;0;0
FR;3;2021-02-11;13610;0;0;0;0;35872;1;0;0;0
FR;3;2021-02-12;13397;0;0;0;0;49269;1;0;0;0
FR;3;2021-02-13;3783;1;0;0;0;53052;2;0;0;0
FR;3;2021-02-14;972;0;0;0;0;54024;2;0;0;0
FR;3;2021-02-15;10486;0;0;0;0;64510;2;0;0;0
FR;3;2021-02-16;12542;1;0;0;0;77052;3;0;0;0
FR;3;2021-02-17;11150;0;0;0;0;88202;3;0;0;0
FR;3;2021-02-18;14934;2;0;0;0;103136;5;0;0;0
FR;3;2021-02-19;14359;1;0;0;0;117495;6;0;0;0
FR;3;2021-02-20;3329;0;0;0;0;120824;6;0;0;0
FR;3;2021-02-21;618;0;0;0;0;121442;6;0;0;0
FR;3;2021-02-22;9162;0;0;0;0;130604;6;0;0;0
FR;3;2021-02-23;11394;1;0;0;0;141998;7;0;0;0
FR;3;2021-02-24;14298;0;0;0;0;156296;7;0;0;0
FR;3;2021-02-25;44929;1;0;0;0;201225;8;0;0;0
FR;3;2021-02-26;61883;3;0;0;0;263108;11;0;0;0
FR;3;2021-02-27;34801;5;0;0;0;297909;16;0;0;0
FR;3;2021-02-28;2463;0;0;0;0;300372;16;0;0;0
FR;3;2021-03-01;20510;10;0;0;0;320882;26;0;0;0
FR;3;2021-03-02;38862;18;0;0;0;359744;44;0;0;0
FR;3;2021-03-03;48729;16;0;0;0;408473;60;0;0;0
FR;3;2021-03-04;82217;20;0;0;0;490690;80;0;0;0
FR;3;2021-03-05;118122;39;0;0;0;608812;119;0;0;0
FR;3;2021-03-06;120709;53;1;0;0;729521;172;1;0;0
FR;3;2021-03-07;55176;27;0;0;0;784697;199;1;0;0
FR;3;2021-03-08;42806;24;0;0;0;827503;223;1;0;0
FR;3;2021-03-09;78966;41;0;0;0;906469;264;1;0;0
FR;3;2021-03-10;80965;46;0;0;0;987434;310;1;0;0
FR;3;2021-03-11;128418;54;0;0;0;1115852;364;1;0;0
FR;3;2021-03-12;182719;90;0;0;0;1298571;454;1;0;0
FR;3;2021-03-13;132144;63;0;0;0;1430715;517;1;0;0
FR;3;2021-03-14;14054;4;0;0;0;1444769;521;1;0;0
FR;3;2021-03-15;52222;46;0;0;0;1496991;567;1;0;0
FR;3;2021-03-16;1209;24;0;0;0;1498200;591;1;0;0
FR;3;2021-03-17;942;29;0;0;0;1499142;620;1;0;0
FR;3;2021-03-18;1564;12;0;0;0;1500706;632;1;0;0
FR;3;2021-03-19;70447;49;0;0;0;1571153;681;1;0;0
FR;3;2021-03-20;65226;44;0;0;0;1636379;725;1;0;0
FR;3;2021-03-21;5755;6;0;0;0;1642134;731;1;0;0
FR;3;2021-03-22;37495;37;0;0;0;1679629;768;1;0;0
FR;3;2021-03-23;84650;61;0;0;0;1764279;829;1;0;0
FR;3;2021-03-24;90935;91;0;0;0;1855214;920;1;0;0
FR;3;2021-03-25;150043;126;0;0;0;2005257;1046;1;0;0
FR;3;2021-03-26;165411;152;0;0;0;2170668;1198;1;0;0
FR;3;2021-03-27;68456;99;0;0;0;2239124;1297;1;0;0
FR;3;2021-03-28;6469;19;0;0;0;2245593;1316;1;0;0
FR;3;2021-03-29;54158;75;0;0;0;2299751;1391;1;0;0
FR;3;2021-03-30;93159;100;0;0;0;2392910;1491;1;0;0
FR;3;2021-03-31;63522;93;0;0;0;2456432;1584;1;0;0
FR;3;2021-04-01;86121;103;0;0;0;2542553;1687;1;0;0
FR;3;2021-04-02;86890;152;0;0;0;2629443;1839;1;0;0
FR;3;2021-04-03;35871;115;0;0;0;2665314;1954;1;0;0
FR;3;2021-04-04;3570;18;0;0;0;2668884;1972;1;0;0
FR;3;2021-04-05;4487;28;0;0;0;2673371;2000;1;0;0
FR;3;2021-04-06;29741;83;0;0;0;2703112;2083;1;0;0
FR;3;2021-04-07;32334;79;0;0;0;2735446;2162;1;0;0
FR;3;2021-04-08;78809;242;0;0;0;2814255;2404;1;0;0
FR;3;2021-04-09;161746;415;0;0;0;2976001;2819;1;0;0
FR;3;2021-04-10;75753;330;0;0;0;3051754;3149;1;0;0
FR;3;2021-04-11;7308;45;0;0;0;3059062;3194;1;0;0
FR;3;2021-04-12;51467;206;0;0;0;3110529;3400;1;0;0
FR;3;2021-04-13;86218;318;0;0;0;3196747;3718;1;0;0
FR;3;2021-04-14;67834;341;0;0;0;3264581;4059;1;0;0
FR;3;2021-04-15;93219;369;0;0;0;3357800;4428;1;0;0
FR;3;2021-04-16;112516;579;0;0;0;3470316;5007;1;0;0
FR;3;2021-04-17;53311;324;1;0;0;3523627;5331;2;0;0
FR;3;2021-04-18;9741;35;0;0;0;3533368;5366;2;0;0
FR;3;2021-04-19;25102;240;0;0;0;3558470;5606;2;0;0
FR;3;2021-04-20;45669;398;0;0;0;3604139;6004;2;0;0
FR;3;2021-04-21;38967;466;0;0;0;3643106;6470;2;0;0
FR;3;2021-04-22;54701;784;0;0;0;3697807;7254;2;0;0
FR;3;2021-04-23;70479;1018;0;0;0;3768286;8272;2;0;0
FR;3;2021-04-24;37240;993;0;0;0;3805526;9265;2;0;0
FR;3;2021-04-25;6204;153;0;0;0;3811730;9418;2;0;0
FR;3;2021-04-26;19781;652;0;0;0;3831511;10070;2;0;0
FR;3;2021-04-27;34470;1261;0;0;0;3865981;11331;2;0;0
FR;3;2021-04-28;28964;1941;0;0;0;3894945;13272;2;0;0
FR;3;2021-04-29;45375;5957;0;0;0;3940320;19229;2;0;0
FR;3;2021-04-30;55451;8931;1;0;0;3995771;28160;3;0;0
FR;3;2021-05-01;9510;1976;0;0;0;4005281;30136;3;0;0
FR;3;2021-05-02;3070;488;0;0;0;4008351;30624;3;0;0
FR;3;2021-05-03;13057;3883;0;0;0;4021408;34507;3;0;0
FR;3;2021-05-04;23109;8411;0;0;0;4044517;42918;3;0;0
FR;3;2021-05-05;18752;10613;0;0;0;4063269;53531;3;0;0
FR;3;2021-05-06;34618;20897;0;0;0;4097887;74428;3;0;0
FR;3;2021-05-07;44201;28433;0;0;0;4142088;102861;3;0;0
FR;3;2021-05-08;6784;8915;0;0;0;4148872;111776;3;0;0
FR;3;2021-05-09;1792;2659;0;0;0;4150664;114435;3;0;0
FR;3;2021-05-10;14989;12598;0;0;0;4165653;127033;3;0;0
FR;3;2021-05-11;27092;25767;0;0;0;4192745;152800;3;0;0
FR;3;2021-05-12;17266;27499;0;0;0;4210011;180299;3;0;0
FR;3;2021-05-13;2277;3471;0;0;0;4212288;183770;3;0;0
FR;3;2021-05-14;14513;25747;0;0;0;4226801;209517;3;0;0
FR;3;2021-05-15;7230;20782;0;0;0;4234031;230299;3;0;0
FR;3;2021-05-16;975;2677;0;0;0;4235006;232976;3;0;0
FR;3;2021-05-17;7960;19930;0;0;0;4242966;252906;3;0;0
FR;3;2021-05-18;13409;29648;0;0;0;4256375;282554;3;0;0
FR;3;2021-05-19;9262;31578;0;0;0;4265637;314132;3;0;0
FR;3;2021-05-20;12801;53214;3;0;0;4278438;367346;6;0;0
FR;3;2021-05-21;12759;65518;2;0;0;4291197;432864;8;0;0
FR;3;2021-05-22;4960;33298;1;0;0;4296157;466162;9;0;0
FR;3;2021-05-23;649;2673;0;0;0;4296806;468835;9;0;0
FR;3;2021-05-24;879;4917;0;0;0;4297685;473752;9;0;0
FR;3;2021-05-25;5296;45230;1;0;0;4302981;518982;10;0;0
FR;3;2021-05-26;4968;51084;1;0;0;4307949;570066;11;0;0
FR;3;2021-05-27;6325;77857;3;0;0;4314274;647923;14;0;0
FR;3;2021-05-28;7539;99080;2;0;0;4321813;747003;16;0;0
FR;3;2021-05-29;3344;60309;1;0;0;4325157;807312;17;0;0
FR;3;2021-05-30;545;8223;0;0;0;4325702;815535;17;0;0
FR;3;2021-05-31;2434;35897;3;0;0;4328136;851432;20;0;0
FR;3;2021-06-01;3399;64751;10;0;0;4331535;916183;30;0;0
FR;3;2021-06-02;2726;58325;6;0;0;4334261;974508;36;0;0
FR;3;2021-06-03;3491;87493;10;0;0;4337752;1062001;46;0;0
FR;3;2021-06-04;4110;105092;22;0;0;4341862;1167093;68;0;0
FR;3;2021-06-05;1978;52230;4;0;0;4343840;1219323;72;0;0
FR;3;2021-06-06;505;5387;1;0;0;4344345;1224710;73;0;0
FR;3;2021-06-07;1468;31094;11;0;0;4345813;1255804;84;0;0
FR;3;2021-06-08;2047;47232;18;0;0;4347860;1303036;102;0;0
FR;3;2021-06-09;1787;42320;13;0;0;4349647;1345356;115;0;0
FR;3;2021-06-10;2242;67897;17;0;0;4351889;1413253;132;0;0
FR;3;2021-06-11;2471;96696;34;0;0;4354360;1509949;166;0;0
FR;3;2021-06-12;1174;40831;6;0;0;4355534;1550780;172;0;0
FR;3;2021-06-13;278;3803;3;0;0;4355812;1554583;175;0;0
FR;3;2021-06-14;1038;42608;17;0;0;4356850;1597191;192;0;0
FR;3;2021-06-15;1363;80615;20;0;0;4358213;1677806;212;0;0
FR;3;2021-06-16;1255;65698;19;0;0;4359468;1743504;231;0;0
FR;3;2021-06-17;1659;101803;41;0;0;4361127;1845307;272;0;0
FR;3;2021-06-18;1868;117920;61;0;0;4362995;1963227;333;0;0
FR;3;2021-06-19;801;39389;22;0;0;4363796;2002616;355;0;0
FR;3;2021-06-20;158;3374;0;0;0;4363954;2005990;355;0;0
FR;3;2021-06-21;768;39238;16;0;0;4364722;2045228;371;0;0
FR;3;2021-06-22;1060;69950;52;0;0;4365782;2115178;423;0;0
FR;3;2021-06-23;942;50821;39;0;0;4366724;2165999;462;0;0
FR;3;2021-06-24;1304;77149;48;0;0;4368028;2243148;510;0;0
FR;3;2021-06-25;1399;89968;73;0;0;4369427;2333116;583;0;0
FR;3;2021-06-26;625;33118;29;0;0;4370052;2366234;612;0;0
FR;3;2021-06-27;165;3994;1;0;0;4370217;2370228;613;0;0
FR;3;2021-06-28;648;30397;27;0;0;4370865;2400625;640;0;0
FR;3;2021-06-29;853;56167;95;0;0;4371718;2456792;735;0;0
FR;3;2021-06-30;901;45077;93;0;0;4372619;2501869;828;0;0
FR;3;2021-07-01;1160;65679;108;0;0;4373779;2567548;936;0;0
FR;3;2021-07-02;1299;90361;170;0;0;4375078;2657909;1106;0;0
FR;3;2021-07-03;600;31183;52;0;0;4375678;2689092;1158;0;0
FR;3;2021-07-04;141;4260;3;0;0;4375819;2693352;1161;0;0
FR;3;2021-07-05;608;33903;60;0;0;4376427;2727255;1221;0;0
FR;3;2021-07-06;956;56052;88;0;0;4377383;2783307;1309;0;0
FR;3;2021-07-07;870;43034;79;0;0;4378253;2826341;1388;0;0
FR;3;2021-07-08;1123;60722;99;0;0;4379376;2887063;1487;0;0
FR;3;2021-07-09;1258;68808;128;0;0;4380634;2955871;1615;0;0
FR;3;2021-07-10;640;25054;59;0;0;4381274;2980925;1674;0;0
FR;3;2021-07-11;127;3289;4;0;0;4381401;2984214;1678;0;0
FR;3;2021-07-12;659;23877;59;0;0;4382060;3008091;1737;0;0
FR;3;2021-07-13;1645;34723;90;0;0;4383705;3042814;1827;0;0
FR;3;2021-07-14;261;2630;2;0;0;4383966;3045444;1829;0;0
FR;3;2021-07-15;1932;30661;85;0;0;4385898;3076105;1914;0;0
FR;3;2021-07-16;2520;38862;122;0;0;4388418;3114967;2036;0;0
FR;3;2021-07-17;1046;13750;26;0;0;4389464;3128717;2062;0;0
FR;3;2021-07-18;262;2607;3;0;0;4389726;3131324;2065;0;0
FR;3;2021-07-19;1273;17198;37;0;0;4390999;3148522;2102;0;0
FR;3;2021-07-20;1823;27133;98;0;0;4392822;3175655;2200;0;0
FR;3;2021-07-21;1647;19706;44;0;0;4394469;3195361;2244;0;0
FR;3;2021-07-22;1848;27747;82;0;0;4396317;3223108;2326;0;0
FR;3;2021-07-23;2212;30449;117;0;0;4398529;3253557;2443;0;0
FR;3;2021-07-24;822;7005;25;0;0;4399351;3260562;2468;0;0
FR;3;2021-07-25;210;1341;1;0;0;4399561;3261903;2469;0;0
FR;3;2021-07-26;921;10705;28;0;0;4400482;3272608;2497;0;0
FR;3;2021-07-27;1165;16945;56;0;0;4401647;3289553;2553;0;0
FR;3;2021-07-28;988;12098;40;0;0;4402635;3301651;2593;0;0
FR;3;2021-07-29;1126;15846;63;0;0;4403761;3317497;2656;0;0
FR;3;2021-07-30;1125;18093;79;0;0;4404886;3335590;2735;0;0
FR;3;2021-07-31;406;3747;15;0;0;4405292;3339337;2750;0;0
FR;3;2021-08-01;113;485;1;0;0;4405405;3339822;2751;0;0
FR;3;2021-08-02;418;5156;22;0;0;4405823;3344978;2773;0;0
FR;3;2021-08-03;488;7589;27;0;0;4406311;3352567;2800;0;0
FR;3;2021-08-04;435;4885;26;0;0;4406746;3357452;2826;0;0
FR;3;2021-08-05;428;3740;12;0;0;4407174;3361192;2838;0;0
FR;3;2021-08-06;452;4795;30;0;0;4407626;3365987;2868;0;0
FR;3;2021-08-07;214;1923;11;0;0;4407840;3367910;2879;0;0
FR;3;2021-08-08;247;432;2;0;0;4408087;3368342;2881;0;0
FR;3;2021-08-09;313;2507;11;0;0;4408400;3370849;2892;0;0
FR;3;2021-08-10;362;3882;15;0;0;4408762;3374731;2907;0;0
FR;3;2021-08-11;285;2723;15;0;0;4409047;3377454;2922;0;0
FR;3;2021-08-12;276;2635;12;0;0;4409323;3380089;2934;0;0
FR;3;2021-08-13;277;2267;16;0;0;4409600;3382356;2950;0;0
FR;3;2021-08-14;169;917;1;0;0;4409769;3383273;2951;0;0
FR;3;2021-08-15;55;169;0;0;0;4409824;3383442;2951;0;0
FR;3;2021-08-16;123;1089;8;0;0;4409947;3384531;2959;0;0
FR;3;2021-08-17;186;1504;8;0;0;4410133;3386035;2967;0;0
FR;3;2021-08-18;199;1371;10;0;0;4410332;3387406;2977;0;0
FR;3;2021-08-19;165;1417;10;0;0;4410497;3388823;2987;0;0
FR;3;2021-08-20;166;1633;16;0;0;4410663;3390456;3003;0;0
FR;3;2021-08-21;93;587;2;0;0;4410756;3391043;3005;0;0
FR;3;2021-08-22;39;188;1;0;0;4410795;3391231;3006;0;0
FR;3;2021-08-23;140;928;7;0;0;4410935;3392159;3013;0;0
FR;3;2021-08-24;123;967;10;0;0;4411058;3393126;3023;0;0
FR;3;2021-08-25;136;842;2;0;0;4411194;3393968;3025;0;0
FR;3;2021-08-26;170;872;9;0;0;4411364;3394840;3034;0;0
FR;3;2021-08-27;172;964;9;0;0;4411536;3395804;3043;0;0
FR;3;2021-08-28;98;373;4;0;0;4411634;3396177;3047;0;0
FR;3;2021-08-29;127;133;1;0;0;4411761;3396310;3048;0;0
FR;3;2021-08-30;97;600;0;0;136;4411858;3396910;3048;0;136
FR;3;2021-08-31;127;715;7;0;154;4411985;3397625;3055;0;290
FR;3;2021-09-01;113;481;5;0;125;4412098;3398106;3060;0;415
FR;3;2021-09-02;99;633;22;0;120;4412197;3398739;3082;0;535
FR;3;2021-09-03;115;587;17;0;128;4412312;3399326;3099;0;663
FR;3;2021-09-04;51;299;3;0;58;4412363;3399625;3102;0;721
FR;3;2021-09-05;51;68;5;0;28;4412414;3399693;3107;0;749
FR;3;2021-09-06;113;395;4;0;144;4412527;3400088;3111;0;893
FR;3;2021-09-07;122;477;14;0;130;4412649;3400565;3125;0;1023
FR;3;2021-09-08;115;371;2;0;103;4412764;3400936;3127;0;1126
FR;3;2021-09-09;92;397;8;0;114;4412856;3401333;3135;0;1240
FR;3;2021-09-10;100;423;3;0;104;4412956;3401756;3138;0;1344
FR;3;2021-09-11;74;239;4;0;66;4413030;3401995;3142;0;1410
FR;3;2021-09-12;36;48;1;0;17;4413066;3402043;3143;0;1427
FR;3;2021-09-13;69;323;7;0;110;4413135;3402366;3150;0;1537
FR;3;2021-09-14;70;293;6;0;107;4413205;3402659;3156;0;1644
FR;3;2021-09-15;59;264;3;0;6;4413264;3402923;3159;0;1650
FR;3;2021-09-16;59;340;5;0;5;4413323;3403263;3164;0;1655
FR;3;2021-09-17;50;348;3;0;7;4413373;3403611;3167;0;1662
FR;3;2021-09-18;36;173;1;0;1;4413409;3403784;3168;0;1663
FR;3;2021-09-19;27;32;2;0;1;4413436;3403816;3170;0;1664
FR;3;2021-09-20;79;212;0;0;1;4413515;3404028;3170;0;1665
FR;3;2021-09-21;58;288;6;0;7;4413573;3404316;3176;0;1672
FR;3;2021-09-22;63;229;6;0;7;4413636;3404545;3182;0;1679
FR;3;2021-09-23;34;274;11;0;7;4413670;3404819;3193;0;1686
FR;3;2021-09-24;24;323;12;0;19;4413694;3405142;3205;0;1705
FR;3;2021-09-25;29;152;3;0;3;4413723;3405294;3208;0;1708
FR;3;2021-09-26;15;55;1;0;1;4413738;3405349;3209;0;1709
FR;3;2021-09-27;39;290;3;0;5;4413777;3405639;3212;0;1714
FR;3;2021-09-28;49;255;6;0;10;4413826;3405894;3218;0;1724
FR;3;2021-09-29;34;223;10;0;13;4413860;3406117;3228;0;1737
FR;3;2021-09-30;38;199;8;0;10;4413898;3406316;3236;0;1747
FR;3;2021-10-01;17;170;6;0;7;4413915;3406486;3242;0;1754
FR;3;2021-10-02;14;91;0;0;0;4413929;3406577;3242;0;1754
FR;3;2021-10-03;18;20;1;0;2;4413947;3406597;3243;0;1756
FR;3;2021-10-04;30;162;4;0;4;4413977;3406759;3247;0;1760
FR;3;2021-10-05;16;154;10;0;13;4413993;3406913;3257;0;1773
FR;3;2021-10-06;31;158;7;0;8;4414024;3407071;3264;0;1781
FR;3;2021-10-07;17;143;6;0;6;4414041;3407214;3270;0;1787
FR;3;2021-10-08;22;144;10;0;9;4414063;3407358;3280;0;1796
FR;3;2021-10-09;12;73;1;0;1;4414075;3407431;3281;0;1797
FR;3;2021-10-10;11;16;2;0;2;4414086;3407447;3283;0;1799
FR;3;2021-10-11;14;124;4;0;5;4414100;3407571;3287;0;1804
FR;3;2021-10-12;17;116;5;0;5;4414117;3407687;3292;0;1809
FR;3;2021-10-13;23;120;7;0;5;4414140;3407807;3299;0;1814
FR;3;2021-10-14;16;161;3;0;4;4414156;3407968;3302;0;1818
FR;3;2021-10-15;21;157;8;0;11;4414177;3408125;3310;0;1829
FR;3;2021-10-16;11;79;6;0;8;4414188;3408204;3316;0;1837
FR;3;2021-10-17;9;24;0;0;0;4414197;3408228;3316;0;1837
FR;3;2021-10-18;17;128;2;0;1;4414214;3408356;3318;0;1838
FR;3;2021-10-19;16;126;19;0;21;4414230;3408482;3337;0;1859
FR;3;2021-10-20;20;132;5;0;6;4414250;3408614;3342;0;1865
FR;3;2021-10-21;24;138;17;0;13;4414274;3408752;3359;0;1878
FR;3;2021-10-22;18;128;16;0;20;4414292;3408880;3375;0;1898
FR;3;2021-10-23;12;58;2;0;1;4414304;3408938;3377;0;1899
FR;3;2021-10-24;7;31;0;0;0;4414311;3408969;3377;0;1899
FR;3;2021-10-25;22;150;7;0;7;4414333;3409119;3384;0;1906
FR;3;2021-10-26;18;115;22;0;19;4414351;3409234;3406;0;1925
FR;3;2021-10-27;15;119;9;0;9;4414366;3409353;3415;0;1934
FR;3;2021-10-28;20;125;33;0;36;4414386;3409478;3448;0;1970
FR;3;2021-10-29;10;124;64;0;54;4414396;3409602;3512;0;2024
FR;3;2021-10-30;8;67;11;1;10;4414404;3409669;3523;1;2034
FR;3;2021-10-31;5;22;1;0;1;4414409;3409691;3524;1;2035
FR;3;2021-11-01;7;22;2;0;1;4414416;3409713;3526;1;2036
FR;3;2021-11-02;9;108;8;0;10;4414425;3409821;3534;1;2046
FR;3;2021-11-03;19;119;10;0;10;4414444;3409940;3544;1;2056
FR;3;2021-11-04;18;99;4;0;3;4414462;3410039;3548;1;2059
FR;3;2021-11-05;17;142;8;1;5;4414479;3410181;3556;2;2064
FR;3;2021-11-06;6;67;3;0;3;4414485;3410248;3559;2;2067
FR;3;2021-11-07;6;21;1;0;1;4414491;3410269;3560;2;2068
FR;3;2021-11-08;11;141;7;0;5;4414502;3410410;3567;2;2073
FR;3;2021-11-09;10;150;5;0;5;4414512;3410560;3572;2;2078
FR;3;2021-11-10;12;180;13;0;14;4414524;3410740;3585;2;2092
FR;3;2021-11-11;8;53;3;0;3;4414532;3410793;3588;2;2095
FR;3;2021-11-12;10;158;6;0;4;4414542;3410951;3594;2;2099
FR;3;2021-11-13;5;79;8;0;10;4414547;3411030;3602;2;2109
FR;3;2021-11-14;2;20;0;0;0;4414549;3411050;3602;2;2109
FR;3;2021-11-15;4;190;9;0;9;4414553;3411240;3611;2;2118
FR;3;2021-11-16;2;167;11;0;10;4414555;3411407;3622;2;2128
FR;3;2021-11-17;5;181;10;0;7;4414560;3411588;3632;2;2135
FR;3;2021-11-18;11;181;10;0;11;4414571;3411769;3642;2;2146
FR;3;2021-11-19;6;230;22;0;27;4414577;3411999;3664;2;2173
FR;3;2021-11-20;6;117;5;0;5;4414583;3412116;3669;2;2178
FR;3;2021-11-21;3;26;3;0;3;4414586;3412142;3672;2;2181
FR;3;2021-11-22;10;238;10;0;10;4414596;3412380;3682;2;2191
FR;3;2021-11-23;6;234;15;0;14;4414602;3412614;3697;2;2205
FR;3;2021-11-24;5;242;9;0;17;4414607;3412856;3706;2;2222
FR;3;2021-11-25;9;285;11;0;10;4414616;3413141;3717;2;2232
FR;3;2021-11-26;5;369;34;0;31;4414621;3413510;3751;2;2263
FR;3;2021-11-27;8;175;20;0;21;4414629;3413685;3771;2;2284
FR;3;2021-11-28;3;65;7;0;7;4414632;3413750;3778;2;2291
FR;3;2021-11-29;4;326;19;0;20;4414636;3414076;3797;2;2311
FR;3;2021-11-30;5;417;26;0;29;4414641;3414493;3823;2;2340
FR;3;2021-12-01;18;464;32;0;33;4414659;3414957;3855;2;2373
FR;3;2021-12-02;9;497;33;0;36;4414668;3415454;3888;2;2409
FR;3;2021-12-03;3;566;37;0;38;4414671;3416020;3925;2;2447
FR;3;2021-12-04;3;282;26;0;28;4414674;3416302;3951;2;2475
FR;3;2021-12-05;1;82;5;0;5;4414675;3416384;3956;2;2480
FR;3;2021-12-06;5;509;14;0;16;4414680;3416893;3970;2;2496
FR;3;2021-12-07;4;610;20;0;24;4414684;3417503;3990;2;2520
FR;3;2021-12-08;3;537;29;0;30;4414687;3418040;4019;2;2550
FR;3;2021-12-09;3;589;17;0;22;4414690;3418629;4036;2;2572
FR;3;2021-12-10;9;627;29;0;25;4414699;3419256;4065;2;2597
FR;3;2021-12-11;4;386;10;0;9;4414703;3419642;4075;2;2606
FR;3;2021-12-12;1;121;3;0;3;4414704;3419763;4078;2;2609
FR;3;2021-12-13;2;599;19;0;21;4414706;3420362;4097;2;2630
FR;3;2021-12-14;7;757;18;0;21;4414713;3421119;4115;2;2651
FR;3;2021-12-15;9;721;17;0;21;4414722;3421840;4132;2;2672
FR;3;2021-12-16;9;730;19;0;18;4414731;3422570;4151;2;2690
FR;3;2021-12-17;4;795;18;0;19;4414735;3423365;4169;2;2709
FR;3;2021-12-18;4;413;4;0;5;4414739;3423778;4173;2;2714
FR;3;2021-12-19;3;207;2;0;2;4414742;3423985;4175;2;2716
FR;3;2021-12-20;8;719;23;0;28;4414750;3424704;4198;2;2744
FR;3;2021-12-21;3;808;10;0;13;4414753;3425512;4208;2;2757
FR;3;2021-12-22;6;756;9;0;10;4414759;3426268;4217;2;2767
FR;3;2021-12-23;1;650;9;0;8;4414760;3426918;4226;2;2775
FR;3;2021-12-24;2;272;3;0;6;4414762;3427190;4229;2;2781
FR;3;2021-12-25;0;25;0;0;0;4414762;3427215;4229;2;2781
FR;3;2021-12-26;0;95;1;0;1;4414762;3427310;4230;2;2782
FR;3;2021-12-27;7;542;17;0;19;4414769;3427852;4247;2;2801
FR;3;2021-12-28;1;690;6;0;5;4414770;3428542;4253;2;2806
FR;3;2021-12-29;4;574;14;0;16;4414774;3429116;4267;2;2822
FR;3;2021-12-30;1;600;7;0;10;4414775;3429716;4274;2;2832
FR;3;2021-12-31;0;205;5;0;6;4414775;3429921;4279;2;2838
FR;3;2022-01-01;0;27;0;0;2;4414775;3429948;4279;2;2840
FR;3;2022-01-02;0;82;0;0;0;4414775;3430030;4279;2;2840
FR;3;2022-01-03;3;564;17;0;20;4414778;3430594;4296;2;2860
FR;3;2022-01-04;6;623;9;0;8;4414784;3431217;4305;2;2868
FR;3;2022-01-05;4;553;10;0;14;4414788;3431770;4315;2;2882
FR;3;2022-01-06;5;548;9;0;12;4414793;3432318;4324;2;2894
FR;3;2022-01-07;2;576;11;0;14;4414795;3432894;4335;2;2908
FR;3;2022-01-08;2;285;4;0;5;4414797;3433179;4339;2;2913
FR;3;2022-01-09;0;118;0;0;0;4414797;3433297;4339;2;2913
FR;3;2022-01-10;2;479;12;0;12;4414799;3433776;4351;2;2925
FR;3;2022-01-11;2;531;1;0;1;4414801;3434307;4352;2;2926
FR;3;2022-01-12;2;445;9;0;10;4414803;3434752;4361;2;2936
FR;3;2022-01-13;3;424;11;0;12;4414806;3435176;4372;2;2948
FR;3;2022-01-14;3;475;10;0;13;4414809;3435651;4382;2;2961
FR;3;2022-01-15;0;298;2;0;3;4414809;3435949;4384;2;2964
FR;3;2022-01-16;0;116;1;0;1;4414809;3436065;4385;2;2965
FR;3;2022-01-17;2;349;8;0;10;4414811;3436414;4393;2;2975
FR;3;2022-01-18;2;413;1;0;2;4414813;3436827;4394;2;2977
FR;3;2022-01-19;1;349;5;0;10;4414814;3437176;4399;2;2987
FR;3;2022-01-20;1;379;5;0;3;4414815;3437555;4404;2;2990
FR;3;2022-01-21;3;373;5;0;7;4414818;3437928;4409;2;2997
FR;3;2022-01-22;2;232;1;0;2;4414820;3438160;4410;2;2999
FR;3;2022-01-23;0;82;0;0;1;4414820;3438242;4410;2;3000
FR;3;2022-01-24;2;349;1;0;6;4414822;3438591;4411;2;3006
FR;3;2022-01-25;0;192;0;0;0;4414822;3438783;4411;2;3006
FR;3;2022-01-26;0;88;0;0;0;4414822;3438871;4411;2;3006
FR;3;2022-01-27;0;59;0;0;0;4414822;3438930;4411;2;3006
FR;3;2022-01-28;0;133;0;0;0;4414822;3439063;4411;2;3006
FR;3;2022-01-29;0;110;0;0;0;4414822;3439173;4411;2;3006
FR;3;2022-01-30;0;51;0;0;0;4414822;3439224;4411;2;3006
FR;3;2022-01-31;0;97;0;0;0;4414822;3439321;4411;2;3006
FR;3;2022-02-01;0;108;0;0;1;4414822;3439429;4411;2;3007
FR;3;2022-02-02;0;95;0;0;0;4414822;3439524;4411;2;3007
FR;3;2022-02-03;0;101;0;0;0;4414822;3439625;4411;2;3007
FR;3;2022-02-04;0;124;0;0;0;4414822;3439749;4411;2;3007
FR;3;2022-02-05;0;73;0;0;0;4414822;3439822;4411;2;3007
FR;3;2022-02-06;0;11;0;0;0;4414822;3439833;4411;2;3007
FR;3;2022-02-07;0;89;0;0;1;4414822;3439922;4411;2;3008
FR;3;2022-02-08;0;0;0;0;0;4414822;3439922;4411;2;3008
FR;3;2022-02-09;0;0;0;0;0;4414822;3439922;4411;2;3008
FR;3;2022-02-10;0;0;0;0;0;4414822;3439922;4411;2;3008
FR;3;2022-02-11;0;0;0;0;0;4414822;3439922;4411;2;3008
FR;3;2022-02-12;0;0;0;0;0;4414822;3439922;4411;2;3008
FR;3;2022-02-13;0;0;0;0;0;4414822;3439922;4411;2;3008
FR;3;2022-02-14;0;0;0;0;0;4414822;3439922;4411;2;3008
FR;3;2022-02-15;0;0;0;0;0;4414822;3439922;4411;2;3008
FR;3;2022-02-16;0;0;0;0;0;4414822;3439922;4411;2;3008
FR;3;2022-02-17;0;0;0;0;0;4414822;3439922;4411;2;3008
FR;3;2022-02-18;0;0;0;0;0;4414822;3439922;4411;2;3008
FR;3;2022-02-19;0;0;0;0;0;4414822;3439922;4411;2;3008
FR;3;2022-02-20;0;0;0;0;0;4414822;3439922;4411;2;3008
FR;3;2022-02-21;2;0;0;0;0;4414824;3439922;4411;2;3008
FR;3;2022-02-22;0;0;0;0;0;4414824;3439922;4411;2;3008
FR;3;2022-02-23;0;0;0;0;0;4414824;3439922;4411;2;3008
FR;3;2022-02-24;0;0;0;0;0;4414824;3439922;4411;2;3008
FR;3;2022-02-25;0;0;0;0;0;4414824;3439922;4411;2;3008
FR;3;2022-02-26;0;0;0;0;0;4414824;3439922;4411;2;3008
FR;3;2022-02-27;0;0;0;0;0;4414824;3439922;4411;2;3008
FR;3;2022-02-28;1;0;0;0;0;4414825;3439922;4411;2;3008
FR;3;2022-03-01;1;0;0;0;0;4414826;3439922;4411;2;3008
FR;3;2022-03-02;0;0;0;0;0;4414826;3439922;4411;2;3008
FR;3;2022-03-03;0;0;0;0;0;4414826;3439922;4411;2;3008
FR;3;2022-03-04;0;0;0;0;0;4414826;3439922;4411;2;3008
FR;3;2022-03-05;0;0;0;0;0;4414826;3439922;4411;2;3008
FR;3;2022-03-06;1;0;0;0;0;4414827;3439922;4411;2;3008
FR;3;2022-03-07;0;0;0;0;0;4414827;3439922;4411;2;3008
FR;3;2022-03-08;1;0;0;0;0;4414828;3439922;4411;2;3008
FR;3;2022-03-09;0;0;0;0;0;4414828;3439922;4411;2;3008
FR;3;2022-03-10;0;0;0;0;0;4414828;3439922;4411;2;3008
FR;3;2022-03-11;0;0;0;0;0;4414828;3439922;4411;2;3008
FR;3;2022-03-12;0;0;0;0;0;4414828;3439922;4411;2;3008
FR;3;2022-03-13;0;0;0;0;0;4414828;3439922;4411;2;3008
FR;3;2022-03-14;0;0;0;0;0;4414828;3439922;4411;2;3008
FR;3;2022-03-15;0;0;0;0;0;4414828;3439922;4411;2;3008
FR;3;2022-03-16;0;0;0;0;0;4414828;3439922;4411;2;3008
FR;3;2022-03-17;0;0;0;0;0;4414828;3439922;4411;2;3008
FR;3;2022-03-18;0;0;0;0;0;4414828;3439922;4411;2;3008
FR;3;2022-03-19;0;0;0;0;0;4414828;3439922;4411;2;3008
FR;3;2022-03-20;1;0;0;0;0;4414829;3439922;4411;2;3008
FR;3;2022-03-21;0;0;0;0;0;4414829;3439922;4411;2;3008
FR;3;2022-03-22;0;0;0;0;0;4414829;3439922;4411;2;3008
FR;3;2022-03-23;1;0;0;0;0;4414830;3439922;4411;2;3008
FR;3;2022-03-24;0;0;0;0;0;4414830;3439922;4411;2;3008
FR;3;2022-03-25;1;0;0;0;0;4414831;3439922;4411;2;3008
FR;3;2022-03-26;0;0;0;0;0;4414831;3439922;4411;2;3008
FR;3;2022-03-27;0;0;0;0;0;4414831;3439922;4411;2;3008
FR;3;2022-03-28;0;0;0;0;0;4414831;3439922;4411;2;3008
FR;3;2022-03-29;0;0;0;0;0;4414831;3439922;4411;2;3008
FR;3;2022-03-30;0;0;0;0;0;4414831;3439922;4411;2;3008
FR;3;2022-03-31;0;0;0;0;0;4414831;3439922;4411;2;3008
FR;3;2022-04-01;0;0;0;0;0;4414831;3439922;4411;2;3008
FR;3;2022-04-02;0;0;0;0;0;4414831;3439922;4411;2;3008
FR;3;2022-04-03;0;0;0;0;0;4414831;3439922;4411;2;3008
FR;3;2022-04-04;0;0;0;0;0;4414831;3439922;4411;2;3008
FR;3;2022-04-05;0;0;0;0;0;4414831;3439922;4411;2;3008
FR;3;2022-04-06;0;0;0;0;0;4414831;3439922;4411;2;3008
FR;3;2022-04-07;0;0;0;0;0;4414831;3439922;4411;2;3008
FR;3;2022-04-08;0;0;0;0;0;4414831;3439922;4411;2;3008
FR;3;2022-04-09;0;0;0;0;0;4414831;3439922;4411;2;3008
FR;3;2022-04-10;0;0;0;0;0;4414831;3439922;4411;2;3008
FR;3;2022-04-11;0;0;0;0;0;4414831;3439922;4411;2;3008
FR;3;2022-04-12;0;0;0;0;0;4414831;3439922;4411;2;3008
FR;3;2022-04-13;0;0;0;0;0;4414831;3439922;4411;2;3008
FR;3;2022-04-14;0;0;0;0;0;4414831;3439922;4411;2;3008
FR;3;2022-04-15;1;0;0;0;0;4414832;3439922;4411;2;3008
FR;3;2022-04-16;0;0;0;0;0;4414832;3439922;4411;2;3008
FR;3;2022-04-17;0;0;0;0;0;4414832;3439922;4411;2;3008
FR;3;2022-04-18;0;0;0;0;0;4414832;3439922;4411;2;3008
FR;3;2022-04-19;0;0;0;0;0;4414832;3439922;4411;2;3008
FR;3;2022-04-20;0;0;0;0;0;4414832;3439922;4411;2;3008
FR;3;2022-04-21;0;0;0;0;0;4414832;3439922;4411;2;3008
FR;3;2022-04-22;0;0;0;0;0;4414832;3439922;4411;2;3008
FR;3;2022-04-23;0;0;0;0;0;4414832;3439922;4411;2;3008
FR;3;2022-04-24;0;0;0;0;0;4414832;3439922;4411;2;3008
FR;3;2022-04-25;0;0;0;0;0;4414832;3439922;4411;2;3008
FR;3;2022-04-26;0;0;0;0;0;4414832;3439922;4411;2;3008
FR;3;2022-04-27;0;0;0;0;0;4414832;3439922;4411;2;3008
FR;3;2022-04-28;0;0;0;0;0;4414832;3439922;4411;2;3008
FR;3;2022-04-29;0;0;0;0;0;4414832;3439922;4411;2;3008
FR;3;2022-04-30;0;0;0;0;0;4414832;3439922;4411;2;3008
FR;3;2022-05-01;0;0;0;0;0;4414832;3439922;4411;2;3008
FR;3;2022-05-02;0;0;0;0;0;4414832;3439922;4411;2;3008
FR;3;2022-05-03;0;0;0;0;0;4414832;3439922;4411;2;3008
FR;3;2022-05-04;0;0;0;0;0;4414832;3439922;4411;2;3008
FR;3;2022-05-05;0;0;0;0;0;4414832;3439922;4411;2;3008
FR;3;2022-05-06;0;0;0;0;0;4414832;3439922;4411;2;3008
FR;3;2022-05-07;0;0;0;0;0;4414832;3439922;4411;2;3008
FR;3;2022-05-08;0;0;0;0;0;4414832;3439922;4411;2;3008
FR;3;2022-05-09;0;0;0;0;0;4414832;3439922;4411;2;3008
FR;3;2022-05-10;0;0;0;0;0;4414832;3439922;4411;2;3008
FR;3;2022-05-11;0;0;0;0;0;4414832;3439922;4411;2;3008
FR;3;2022-05-12;0;0;0;0;0;4414832;3439922;4411;2;3008
FR;3;2022-05-13;0;0;0;0;0;4414832;3439922;4411;2;3008
FR;3;2022-05-14;1;0;0;0;0;4414833;3439922;4411;2;3008
FR;3;2022-05-15;0;0;0;0;0;4414833;3439922;4411;2;3008
FR;3;2022-05-16;0;0;0;0;0;4414833;3439922;4411;2;3008
FR;3;2022-05-17;0;0;0;0;0;4414833;3439922;4411;2;3008
FR;3;2022-05-18;0;0;0;0;0;4414833;3439922;4411;2;3008
FR;4;2020-12-27;0;0;0;0;0;0;0;0;0;0
FR;4;2020-12-28;0;0;0;0;0;0;0;0;0;0
FR;4;2020-12-29;0;0;0;0;0;0;0;0;0;0
FR;4;2020-12-30;0;0;0;0;0;0;0;0;0;0
FR;4;2020-12-31;0;0;0;0;0;0;0;0;0;0
FR;4;2021-01-01;0;0;0;0;0;0;0;0;0;0
FR;4;2021-01-02;0;0;0;0;0;0;0;0;0;0
FR;4;2021-01-03;0;0;0;0;0;0;0;0;0;0
FR;4;2021-01-04;0;0;0;0;0;0;0;0;0;0
FR;4;2021-01-05;0;0;0;0;0;0;0;0;0;0
FR;4;2021-01-06;0;0;0;0;0;0;0;0;0;0
FR;4;2021-01-07;0;0;0;0;0;0;0;0;0;0
FR;4;2021-01-08;0;0;0;0;0;0;0;0;0;0
FR;4;2021-01-09;0;0;0;0;0;0;0;0;0;0
FR;4;2021-01-10;0;0;0;0;0;0;0;0;0;0
FR;4;2021-01-11;0;0;0;0;0;0;0;0;0;0
FR;4;2021-01-12;0;0;0;0;0;0;0;0;0;0
FR;4;2021-01-13;0;0;0;0;0;0;0;0;0;0
FR;4;2021-01-14;0;0;0;0;0;0;0;0;0;0
FR;4;2021-01-15;0;0;0;0;0;0;0;0;0;0
FR;4;2021-01-16;0;0;0;0;0;0;0;0;0;0
FR;4;2021-01-17;0;0;0;0;0;0;0;0;0;0
FR;4;2021-01-18;0;0;0;0;0;0;0;0;0;0
FR;4;2021-01-19;0;0;0;0;0;0;0;0;0;0
FR;4;2021-01-20;0;0;0;0;0;0;0;0;0;0
FR;4;2021-01-21;0;0;0;0;0;0;0;0;0;0
FR;4;2021-01-22;0;0;0;0;0;0;0;0;0;0
FR;4;2021-01-23;0;0;0;0;0;0;0;0;0;0
FR;4;2021-01-24;0;0;0;0;0;0;0;0;0;0
FR;4;2021-01-25;0;0;0;0;0;0;0;0;0;0
FR;4;2021-01-26;0;0;0;0;0;0;0;0;0;0
FR;4;2021-01-27;0;0;0;0;0;0;0;0;0;0
FR;4;2021-01-28;0;0;0;0;0;0;0;0;0;0
FR;4;2021-01-29;0;0;0;0;0;0;0;0;0;0
FR;4;2021-01-30;0;0;0;0;0;0;0;0;0;0
FR;4;2021-01-31;0;0;0;0;0;0;0;0;0;0
FR;4;2021-02-01;0;0;0;0;0;0;0;0;0;0
FR;4;2021-02-02;0;0;0;0;0;0;0;0;0;0
FR;4;2021-02-03;0;0;0;0;0;0;0;0;0;0
FR;4;2021-02-04;0;0;0;0;0;0;0;0;0;0
FR;4;2021-02-05;0;0;0;0;0;0;0;0;0;0
FR;4;2021-02-06;0;0;0;0;0;0;0;0;0;0
FR;4;2021-02-07;0;0;0;0;0;0;0;0;0;0
FR;4;2021-02-08;0;0;0;0;0;0;0;0;0;0
FR;4;2021-02-09;0;0;0;0;0;0;0;0;0;0
FR;4;2021-02-10;0;0;0;0;0;0;0;0;0;0
FR;4;2021-02-11;0;0;0;0;0;0;0;0;0;0
FR;4;2021-02-12;0;0;0;0;0;0;0;0;0;0
FR;4;2021-02-13;0;0;0;0;0;0;0;0;0;0
FR;4;2021-02-14;0;0;0;0;0;0;0;0;0;0
FR;4;2021-02-15;0;0;0;0;0;0;0;0;0;0
FR;4;2021-02-16;0;0;0;0;0;0;0;0;0;0
FR;4;2021-02-17;0;0;0;0;0;0;0;0;0;0
FR;4;2021-02-18;0;0;0;0;0;0;0;0;0;0
FR;4;2021-02-19;0;0;0;0;0;0;0;0;0;0
FR;4;2021-02-20;0;0;0;0;0;0;0;0;0;0
FR;4;2021-02-21;0;0;0;0;0;0;0;0;0;0
FR;4;2021-02-22;0;0;0;0;0;0;0;0;0;0
FR;4;2021-02-23;0;0;0;0;0;0;0;0;0;0
FR;4;2021-02-24;0;0;0;0;0;0;0;0;0;0
FR;4;2021-02-25;0;0;0;0;0;0;0;0;0;0
FR;4;2021-02-26;0;0;0;0;0;0;0;0;0;0
FR;4;2021-02-27;0;0;0;0;0;0;0;0;0;0
FR;4;2021-02-28;0;0;0;0;0;0;0;0;0;0
FR;4;2021-03-01;0;0;0;0;0;0;0;0;0;0
FR;4;2021-03-02;0;0;0;0;0;0;0;0;0;0
FR;4;2021-03-03;0;0;0;0;0;0;0;0;0;0
FR;4;2021-03-04;0;0;0;0;0;0;0;0;0;0
FR;4;2021-03-05;0;0;0;0;0;0;0;0;0;0
FR;4;2021-03-06;0;0;0;0;0;0;0;0;0;0
FR;4;2021-03-07;0;0;0;0;0;0;0;0;0;0
FR;4;2021-03-08;0;0;0;0;0;0;0;0;0;0
FR;4;2021-03-09;0;0;0;0;0;0;0;0;0;0
FR;4;2021-03-10;0;0;0;0;0;0;0;0;0;0
FR;4;2021-03-11;0;0;0;0;0;0;0;0;0;0
FR;4;2021-03-12;0;0;0;0;0;0;0;0;0;0
FR;4;2021-03-13;0;0;0;0;0;0;0;0;0;0
FR;4;2021-03-14;0;0;0;0;0;0;0;0;0;0
FR;4;2021-03-15;0;0;0;0;0;0;0;0;0;0
FR;4;2021-03-16;0;0;0;0;0;0;0;0;0;0
FR;4;2021-03-17;0;0;0;0;0;0;0;0;0;0
FR;4;2021-03-18;0;0;0;0;0;0;0;0;0;0
FR;4;2021-03-19;0;0;0;0;0;0;0;0;0;0
FR;4;2021-03-20;0;0;0;0;0;0;0;0;0;0
FR;4;2021-03-21;0;0;0;0;0;0;0;0;0;0
FR;4;2021-03-22;0;0;0;0;0;0;0;0;0;0
FR;4;2021-03-23;0;0;0;0;0;0;0;0;0;0
FR;4;2021-03-24;0;0;0;0;0;0;0;0;0;0
FR;4;2021-03-25;0;0;0;0;0;0;0;0;0;0
FR;4;2021-03-26;0;0;0;0;0;0;0;0;0;0
FR;4;2021-03-27;0;0;0;0;0;0;0;0;0;0
FR;4;2021-03-28;0;0;0;0;0;0;0;0;0;0
FR;4;2021-03-29;0;0;0;0;0;0;0;0;0;0
FR;4;2021-03-30;0;0;0;0;0;0;0;0;0;0
FR;4;2021-03-31;0;0;0;0;0;0;0;0;0;0
FR;4;2021-04-01;0;0;0;0;0;0;0;0;0;0
FR;4;2021-04-02;0;0;0;0;0;0;0;0;0;0
FR;4;2021-04-03;0;0;0;0;0;0;0;0;0;0
FR;4;2021-04-04;0;0;0;0;0;0;0;0;0;0
FR;4;2021-04-05;0;0;0;0;0;0;0;0;0;0
FR;4;2021-04-06;0;0;0;0;0;0;0;0;0;0
FR;4;2021-04-07;0;0;0;0;0;0;0;0;0;0
FR;4;2021-04-08;0;0;0;0;0;0;0;0;0;0
FR;4;2021-04-09;0;0;0;0;0;0;0;0;0;0
FR;4;2021-04-10;0;0;0;0;0;0;0;0;0;0
FR;4;2021-04-11;0;0;0;0;0;0;0;0;0;0
FR;4;2021-04-12;0;0;0;0;0;0;0;0;0;0
FR;4;2021-04-13;0;0;0;0;0;0;0;0;0;0
FR;4;2021-04-14;0;0;0;0;0;0;0;0;0;0
FR;4;2021-04-15;0;0;0;0;0;0;0;0;0;0
FR;4;2021-04-16;0;0;0;0;0;0;0;0;0;0
FR;4;2021-04-17;0;0;0;0;0;0;0;0;0;0
FR;4;2021-04-18;0;0;0;0;0;0;0;0;0;0
FR;4;2021-04-19;0;0;0;0;0;0;0;0;0;0
FR;4;2021-04-20;0;0;0;0;0;0;0;0;0;0
FR;4;2021-04-21;0;0;0;0;0;0;0;0;0;0
FR;4;2021-04-22;0;0;0;0;0;0;0;0;0;0
FR;4;2021-04-23;4020;0;0;0;0;4020;0;0;0;0
FR;4;2021-04-24;1569;0;0;0;0;5589;0;0;0;0
FR;4;2021-04-25;125;0;0;0;0;5714;0;0;0;0
FR;4;2021-04-26;2869;1;0;0;0;8583;1;0;0;0
FR;4;2021-04-27;9519;3;0;0;0;18102;4;0;0;0
FR;4;2021-04-28;9904;6;0;0;0;28006;10;0;0;0
FR;4;2021-04-29;15991;8;0;0;0;43997;18;0;0;0
FR;4;2021-04-30;19228;10;0;0;0;63225;28;0;0;0
FR;4;2021-05-01;1992;6;0;0;0;65217;34;0;0;0
FR;4;2021-05-02;482;0;0;0;0;65699;34;0;0;0
FR;4;2021-05-03;5058;2;0;0;0;70757;36;0;0;0
FR;4;2021-05-04;8397;10;0;0;0;79154;46;0;0;0
FR;4;2021-05-05;6182;7;0;0;0;85336;53;0;0;0
FR;4;2021-05-06;11378;11;0;0;0;96714;64;0;0;0
FR;4;2021-05-07;19119;9;0;0;0;115833;73;0;0;0
FR;4;2021-05-08;2377;6;0;0;0;118210;79;0;0;0
FR;4;2021-05-09;685;3;0;0;0;118895;82;0;0;0
FR;4;2021-05-10;7239;5;1;0;0;126134;87;1;0;0
FR;4;2021-05-11;14313;12;0;0;0;140447;99;1;0;0
FR;4;2021-05-12;10161;15;0;0;0;150608;114;1;0;0
FR;4;2021-05-13;1579;3;0;0;0;152187;117;1;0;0
FR;4;2021-05-14;7758;6;0;0;0;159945;123;1;0;0
FR;4;2021-05-15;3717;8;1;0;0;163662;131;2;0;0
FR;4;2021-05-16;417;1;0;0;0;164079;132;2;0;0
FR;4;2021-05-17;4475;6;0;0;0;168554;138;2;0;0
FR;4;2021-05-18;8751;10;0;0;0;177305;148;2;0;0
FR;4;2021-05-19;5690;7;0;0;0;182995;155;2;0;0
FR;4;2021-05-20;9478;7;0;0;0;192473;162;2;0;0
FR;4;2021-05-21;12790;30;0;0;0;205263;192;2;0;0
FR;4;2021-05-22;5057;15;0;0;0;210320;207;2;0;0
FR;4;2021-05-23;494;4;0;0;0;210814;211;2;0;0
FR;4;2021-05-24;1054;7;0;0;0;211868;218;2;0;0
FR;4;2021-05-25;7619;16;0;0;0;219487;234;2;0;0
FR;4;2021-05-26;7723;16;0;0;0;227210;250;2;0;0
FR;4;2021-05-27;14330;35;0;0;0;241540;285;2;0;0
FR;4;2021-05-28;26582;82;1;0;0;268122;367;3;0;0
FR;4;2021-05-29;11380;18;0;0;0;279502;385;3;0;0
FR;4;2021-05-30;971;6;0;0;0;280473;391;3;0;0
FR;4;2021-05-31;12685;21;0;0;0;293158;412;3;0;0
FR;4;2021-06-01;20248;46;1;0;0;313406;458;4;0;0
FR;4;2021-06-02;14516;33;0;0;0;327922;491;4;0;0
FR;4;2021-06-03;19408;24;1;0;0;347330;515;5;0;0
FR;4;2021-06-04;22507;47;0;0;0;369837;562;5;0;0
FR;4;2021-06-05;9712;32;0;0;0;379549;594;5;0;0
FR;4;2021-06-06;1039;1;0;0;0;380588;595;5;0;0
FR;4;2021-06-07;9225;19;0;0;0;389813;614;5;0;0
FR;4;2021-06-08;14605;31;0;0;0;404418;645;5;0;0
FR;4;2021-06-09;12202;25;0;0;0;416620;670;5;0;0
FR;4;2021-06-10;15397;30;0;0;0;432017;700;5;0;0
FR;4;2021-06-11;16978;56;0;0;0;448995;756;5;0;0
FR;4;2021-06-12;7445;27;0;0;0;456440;783;5;0;0
FR;4;2021-06-13;906;2;0;0;0;457346;785;5;0;0
FR;4;2021-06-14;6646;25;0;0;0;463992;810;5;0;0
FR;4;2021-06-15;10882;37;0;0;0;474874;847;5;0;0
FR;4;2021-06-16;8905;15;0;0;0;483779;862;5;0;0
FR;4;2021-06-17;10897;36;0;0;0;494676;898;5;0;0
FR;4;2021-06-18;12419;45;0;0;0;507095;943;5;0;0
FR;4;2021-06-19;5567;25;0;0;0;512662;968;5;0;0
FR;4;2021-06-20;817;5;0;0;0;513479;973;5;0;0
FR;4;2021-06-21;5080;20;0;0;0;518559;993;5;0;0
FR;4;2021-06-22;7905;28;2;0;0;526464;1021;7;0;0
FR;4;2021-06-23;7091;39;2;0;0;533555;1060;9;0;0
FR;4;2021-06-24;8645;45;1;0;0;542200;1105;10;0;0
FR;4;2021-06-25;10172;39;2;0;0;552372;1144;12;0;0
FR;4;2021-06-26;4841;21;0;0;0;557213;1165;12;0;0
FR;4;2021-06-27;760;3;0;0;0;557973;1168;12;0;0
FR;4;2021-06-28;4820;16;1;0;0;562793;1184;13;0;0
FR;4;2021-06-29;7096;27;2;0;0;569889;1211;15;0;0
FR;4;2021-06-30;6705;39;2;0;0;576594;1250;17;0;0
FR;4;2021-07-01;8190;40;0;0;0;584784;1290;17;0;0
FR;4;2021-07-02;9411;52;1;0;0;594195;1342;18;0;0
FR;4;2021-07-03;4843;19;0;0;0;599038;1361;18;0;0
FR;4;2021-07-04;686;5;0;0;0;599724;1366;18;0;0
FR;4;2021-07-05;4765;19;2;0;0;604489;1385;20;0;0
FR;4;2021-07-06;7717;28;4;0;0;612206;1413;24;0;0
FR;4;2021-07-07;7067;34;2;0;0;619273;1447;26;0;0
FR;4;2021-07-08;9218;40;2;0;0;628491;1487;28;0;0
FR;4;2021-07-09;10275;34;1;0;0;638766;1521;29;0;0
FR;4;2021-07-10;4634;14;2;0;0;643400;1535;31;0;0
FR;4;2021-07-11;582;4;1;0;0;643982;1539;32;0;0
FR;4;2021-07-12;5867;29;0;0;0;649849;1568;32;0;0
FR;4;2021-07-13;14229;29;0;0;0;664078;1597;32;0;0
FR;4;2021-07-14;2281;14;0;0;0;666359;1611;32;0;0
FR;4;2021-07-15;18231;36;0;0;0;684590;1647;32;0;0
FR;4;2021-07-16;22815;70;2;0;0;707405;1717;34;0;0
FR;4;2021-07-17;9735;20;0;0;0;717140;1737;34;0;0
FR;4;2021-07-18;1354;4;0;0;0;718494;1741;34;0;0
FR;4;2021-07-19;12978;28;1;0;0;731472;1769;35;0;0
FR;4;2021-07-20;17330;26;1;0;0;748802;1795;36;0;0
FR;4;2021-07-21;15604;33;0;0;0;764406;1828;36;0;0
FR;4;2021-07-22;18237;44;2;0;0;782643;1872;38;0;0
FR;4;2021-07-23;20404;57;7;0;0;803047;1929;45;0;0
FR;4;2021-07-24;9282;32;0;0;0;812329;1961;45;0;0
FR;4;2021-07-25;1350;8;0;0;0;813679;1969;45;0;0
FR;4;2021-07-26;11030;20;0;0;0;824709;1989;45;0;0
FR;4;2021-07-27;14661;35;3;0;0;839370;2024;48;0;0
FR;4;2021-07-28;12921;26;2;0;0;852291;2050;50;0;0
FR;4;2021-07-29;14079;54;4;0;0;866370;2104;54;0;0
FR;4;2021-07-30;15478;45;2;0;0;881848;2149;56;0;0
FR;4;2021-07-31;6830;14;2;0;0;888678;2163;58;0;0
FR;4;2021-08-01;904;1;0;0;0;889582;2164;58;0;0
FR;4;2021-08-02;7902;29;0;0;0;897484;2193;58;0;0
FR;4;2021-08-03;10788;32;2;0;0;908272;2225;60;0;0
FR;4;2021-08-04;9730;29;0;0;0;918002;2254;60;0;0
FR;4;2021-08-05;9812;41;0;0;0;927814;2295;60;0;0
FR;4;2021-08-06;10181;30;3;0;0;937995;2325;63;0;0
FR;4;2021-08-07;5088;30;1;0;0;943083;2355;64;0;0
FR;4;2021-08-08;1216;13;0;0;0;944299;2368;64;0;0
FR;4;2021-08-09;6334;31;0;0;0;950633;2399;64;0;0
FR;4;2021-08-10;8741;18;0;0;0;959374;2417;64;0;0
FR;4;2021-08-11;7929;33;4;0;0;967303;2450;68;0;0
FR;4;2021-08-12;8579;29;1;0;0;975882;2479;69;0;0
FR;4;2021-08-13;7545;24;0;1;0;983427;2503;69;1;0
FR;4;2021-08-14;3784;20;0;0;0;987211;2523;69;1;0
FR;4;2021-08-15;769;5;0;0;0;987980;2528;69;1;0
FR;4;2021-08-16;4003;16;0;0;0;991983;2544;69;1;0
FR;4;2021-08-17;5615;16;1;0;0;997598;2560;70;1;0
FR;4;2021-08-18;5161;34;0;0;0;1002759;2594;70;1;0
FR;4;2021-08-19;5473;34;3;0;0;1008232;2628;73;1;0
FR;4;2021-08-20;5208;23;1;0;0;1013440;2651;74;1;0
FR;4;2021-08-21;2307;21;1;0;0;1015747;2672;75;1;0
FR;4;2021-08-22;401;2;0;0;0;1016148;2674;75;1;0
FR;4;2021-08-23;2923;19;1;0;0;1019071;2693;76;1;0
FR;4;2021-08-24;3744;15;0;0;0;1022815;2708;76;1;0
FR;4;2021-08-25;3538;25;0;0;0;1026353;2733;76;1;0
FR;4;2021-08-26;3700;20;2;0;0;1030053;2753;78;1;0
FR;4;2021-08-27;3605;31;2;0;0;1033658;2784;80;1;0
FR;4;2021-08-28;1722;9;1;0;0;1035380;2793;81;1;0
FR;4;2021-08-29;387;7;1;0;0;1035767;2800;82;1;0
FR;4;2021-08-30;2008;24;0;0;14;1037775;2824;82;1;14
FR;4;2021-08-31;2479;20;0;0;13;1040254;2844;82;1;27
FR;4;2021-09-01;2077;38;1;0;21;1042331;2882;83;1;48
FR;4;2021-09-02;2301;31;4;0;18;1044632;2913;87;1;66
FR;4;2021-09-03;2356;44;5;0;32;1046988;2957;92;1;98
FR;4;2021-09-04;1374;17;0;0;7;1048362;2974;92;1;105
FR;4;2021-09-05;429;2;0;0;2;1048791;2976;92;1;107
FR;4;2021-09-06;1706;62;0;0;23;1050497;3038;92;1;130
FR;4;2021-09-07;1672;18;1;0;9;1052169;3056;93;1;139
FR;4;2021-09-08;1279;27;3;1;20;1053448;3083;96;2;159
FR;4;2021-09-09;1387;23;2;0;9;1054835;3106;98;2;168
FR;4;2021-09-10;1516;31;2;0;23;1056351;3137;100;2;191
FR;4;2021-09-11;737;11;0;0;3;1057088;3148;100;2;194
FR;4;2021-09-12;168;4;0;0;2;1057256;3152;100;2;196
FR;4;2021-09-13;1315;22;1;0;16;1058571;3174;101;2;212
FR;4;2021-09-14;1497;9;2;0;6;1060068;3183;103;2;218
FR;4;2021-09-15;1091;27;1;0;24;1061159;3210;104;2;242
FR;4;2021-09-16;1095;22;2;0;15;1062254;3232;106;2;257
FR;4;2021-09-17;891;21;1;0;12;1063145;3253;107;2;269
FR;4;2021-09-18;462;6;1;0;5;1063607;3259;108;2;274
FR;4;2021-09-19;182;3;0;0;2;1063789;3262;108;2;276
FR;4;2021-09-20;443;18;0;0;12;1064232;3280;108;2;288
FR;4;2021-09-21;423;11;0;0;7;1064655;3291;108;2;295
FR;4;2021-09-22;372;19;2;0;13;1065027;3310;110;2;308
FR;4;2021-09-23;477;16;1;0;15;1065504;3326;111;2;323
FR;4;2021-09-24;409;13;2;0;9;1065913;3339;113;2;332
FR;4;2021-09-25;281;9;1;0;4;1066194;3348;114;2;336
FR;4;2021-09-26;73;2;0;0;1;1066267;3350;114;2;337
FR;4;2021-09-27;261;10;1;0;8;1066528;3360;115;2;345
FR;4;2021-09-28;315;8;0;0;8;1066843;3368;115;2;353
FR;4;2021-09-29;372;19;1;0;13;1067215;3387;116;2;366
FR;4;2021-09-30;359;40;0;0;21;1067574;3427;116;2;387
FR;4;2021-10-01;407;49;0;0;43;1067981;3476;116;2;430
FR;4;2021-10-02;195;22;1;0;13;1068176;3498;117;2;443
FR;4;2021-10-03;84;1;0;0;0;1068260;3499;117;2;443
FR;4;2021-10-04;354;19;1;0;15;1068614;3518;118;2;458
FR;4;2021-10-05;275;19;2;0;15;1068889;3537;120;2;473
FR;4;2021-10-06;243;21;1;0;17;1069132;3558;121;2;490
FR;4;2021-10-07;254;25;2;0;13;1069386;3583;123;2;503
FR;4;2021-10-08;352;23;2;0;19;1069738;3606;125;2;522
FR;4;2021-10-09;192;6;6;0;7;1069930;3612;131;2;529
FR;4;2021-10-10;95;3;2;0;3;1070025;3615;133;2;532
FR;4;2021-10-11;246;15;1;0;14;1070271;3630;134;2;546
FR;4;2021-10-12;203;14;0;0;13;1070474;3644;134;2;559
FR;4;2021-10-13;218;27;1;0;24;1070692;3671;135;2;583
FR;4;2021-10-14;306;22;4;0;16;1070998;3693;139;2;599
FR;4;2021-10-15;322;24;5;0;25;1071320;3717;144;2;624
FR;4;2021-10-16;165;6;2;0;6;1071485;3723;146;2;630
FR;4;2021-10-17;70;2;0;0;1;1071555;3725;146;2;631
FR;4;2021-10-18;278;16;1;0;12;1071833;3741;147;2;643
FR;4;2021-10-19;209;14;2;0;15;1072042;3755;149;2;658
FR;4;2021-10-20;224;27;4;0;15;1072266;3782;153;2;673
FR;4;2021-10-21;234;17;0;0;13;1072500;3799;153;2;686
FR;4;2021-10-22;210;26;2;0;21;1072710;3825;155;2;707
FR;4;2021-10-23;115;16;1;0;15;1072825;3841;156;2;722
FR;4;2021-10-24;38;4;0;0;1;1072863;3845;156;2;723
FR;4;2021-10-25;209;7;2;0;9;1073072;3852;158;2;732
FR;4;2021-10-26;196;14;0;0;12;1073268;3866;158;2;744
FR;4;2021-10-27;190;11;4;0;11;1073458;3877;162;2;755
FR;4;2021-10-28;182;18;4;0;21;1073640;3895;166;2;776
FR;4;2021-10-29;220;15;2;0;13;1073860;3910;168;2;789
FR;4;2021-10-30;102;2;1;0;2;1073962;3912;169;2;791
FR;4;2021-10-31;56;3;2;0;3;1074018;3915;171;2;794
FR;4;2021-11-01;75;27;4;0;24;1074093;3942;175;2;818
FR;4;2021-11-02;153;20;2;0;21;1074246;3962;177;2;839
FR;4;2021-11-03;127;20;8;1;18;1074373;3982;185;3;857
FR;4;2021-11-04;175;13;1;0;10;1074548;3995;186;3;867
FR;4;2021-11-05;126;17;1;0;16;1074674;4012;187;3;883
FR;4;2021-11-06;77;6;1;0;6;1074751;4018;188;3;889
FR;4;2021-11-07;76;2;2;0;4;1074827;4020;190;3;893
FR;4;2021-11-08;158;20;1;0;20;1074985;4040;191;3;913
FR;4;2021-11-09;151;14;3;0;16;1075136;4054;194;3;929
FR;4;2021-11-10;114;28;6;0;30;1075250;4082;200;3;959
FR;4;2021-11-11;84;10;0;0;10;1075334;4092;200;3;969
FR;4;2021-11-12;97;18;2;0;17;1075431;4110;202;3;986
FR;4;2021-11-13;73;15;2;0;14;1075504;4125;204;3;1000
FR;4;2021-11-14;53;5;3;0;7;1075557;4130;207;3;1007
FR;4;2021-11-15;97;26;2;0;24;1075654;4156;209;3;1031
FR;4;2021-11-16;99;12;2;0;14;1075753;4168;211;3;1045
FR;4;2021-11-17;115;29;4;0;29;1075868;4197;215;3;1074
FR;4;2021-11-18;99;34;12;0;41;1075967;4231;227;3;1115
FR;4;2021-11-19;78;19;3;0;20;1076045;4250;230;3;1135
FR;4;2021-11-20;75;7;1;0;7;1076120;4257;231;3;1142
FR;4;2021-11-21;61;7;2;0;9;1076181;4264;233;3;1151
FR;4;2021-11-22;101;27;6;0;29;1076282;4291;239;3;1180
FR;4;2021-11-23;73;29;5;0;26;1076355;4320;244;3;1206
FR;4;2021-11-24;85;23;9;0;22;1076440;4343;253;3;1228
FR;4;2021-11-25;84;28;14;0;30;1076524;4371;267;3;1258
FR;4;2021-11-26;80;43;12;0;45;1076604;4414;279;3;1303
FR;4;2021-11-27;35;22;16;0;24;1076639;4436;295;3;1327
FR;4;2021-11-28;48;8;0;0;7;1076687;4444;295;3;1334
FR;4;2021-11-29;83;31;14;0;38;1076770;4475;309;3;1372
FR;4;2021-11-30;72;36;12;0;40;1076842;4511;321;3;1412
FR;4;2021-12-01;77;59;19;0;66;1076919;4570;340;3;1478
FR;4;2021-12-02;97;47;19;0;52;1077016;4617;359;3;1530
FR;4;2021-12-03;98;36;15;0;44;1077114;4653;374;3;1574
FR;4;2021-12-04;69;31;18;0;44;1077183;4684;392;3;1618
FR;4;2021-12-05;60;5;1;0;6;1077243;4689;393;3;1624
FR;4;2021-12-06;96;45;20;0;59;1077339;4734;413;3;1683
FR;4;2021-12-07;77;33;9;0;33;1077416;4767;422;3;1716
FR;4;2021-12-08;66;29;16;0;34;1077482;4796;438;3;1750
FR;4;2021-12-09;59;32;10;0;38;1077541;4828;448;3;1788
FR;4;2021-12-10;60;62;21;0;66;1077601;4890;469;3;1854
FR;4;2021-12-11;24;33;7;0;33;1077625;4923;476;3;1887
FR;4;2021-12-12;23;10;3;0;13;1077648;4933;479;3;1900
FR;4;2021-12-13;68;39;13;0;48;1077716;4972;492;3;1948
FR;4;2021-12-14;56;43;15;0;52;1077772;5015;507;3;2000
FR;4;2021-12-15;58;63;28;0;83;1077830;5078;535;3;2083
FR;4;2021-12-16;30;44;18;0;56;1077860;5122;553;3;2139
FR;4;2021-12-17;38;55;12;0;60;1077898;5177;565;3;2199
FR;4;2021-12-18;48;29;2;0;30;1077946;5206;567;3;2229
FR;4;2021-12-19;15;4;1;0;4;1077961;5210;568;3;2233
FR;4;2021-12-20;35;38;11;0;42;1077996;5248;579;3;2275
FR;4;2021-12-21;25;30;15;0;36;1078021;5278;594;3;2311
FR;4;2021-12-22;35;35;10;0;36;1078056;5313;604;3;2347
FR;4;2021-12-23;39;43;8;0;47;1078095;5356;612;3;2394
FR;4;2021-12-24;23;25;10;0;29;1078118;5381;622;3;2423
FR;4;2021-12-25;6;3;3;0;4;1078124;5384;625;3;2427
FR;4;2021-12-26;4;3;1;0;2;1078128;5387;626;3;2429
FR;4;2021-12-27;26;42;8;0;43;1078154;5429;634;3;2472
FR;4;2021-12-28;24;28;8;0;29;1078178;5457;642;3;2501
FR;4;2021-12-29;48;24;10;0;28;1078226;5481;652;3;2529
FR;4;2021-12-30;39;16;12;0;19;1078265;5497;664;3;2548
FR;4;2021-12-31;18;5;8;0;10;1078283;5502;672;3;2558
FR;4;2022-01-01;5;4;4;0;6;1078288;5506;676;3;2564
FR;4;2022-01-02;40;4;14;0;17;1078328;5510;690;3;2581
FR;4;2022-01-03;37;52;20;1;57;1078365;5562;710;4;2638
FR;4;2022-01-04;28;26;12;0;28;1078393;5588;722;4;2666
FR;4;2022-01-05;46;19;16;0;20;1078439;5607;738;4;2686
FR;4;2022-01-06;43;20;21;0;33;1078482;5627;759;4;2719
FR;4;2022-01-07;24;19;15;0;19;1078506;5646;774;4;2738
FR;4;2022-01-08;8;5;9;0;11;1078514;5651;783;4;2749
FR;4;2022-01-09;17;2;1;0;2;1078531;5653;784;4;2751
FR;4;2022-01-10;39;22;16;0;33;1078570;5675;800;4;2784
FR;4;2022-01-11;23;30;14;0;34;1078593;5705;814;4;2818
FR;4;2022-01-12;30;18;12;0;19;1078623;5723;826;4;2837
FR;4;2022-01-13;48;18;27;0;35;1078671;5741;853;4;2872
FR;4;2022-01-14;21;28;13;0;31;1078692;5769;866;4;2903
FR;4;2022-01-15;10;6;7;0;11;1078702;5775;873;4;2914
FR;4;2022-01-16;9;9;11;0;19;1078711;5784;884;4;2933
FR;4;2022-01-17;23;17;11;0;22;1078734;5801;895;4;2955
FR;4;2022-01-18;15;13;7;0;17;1078749;5814;902;4;2972
FR;4;2022-01-19;28;22;9;0;29;1078777;5836;911;4;3001
FR;4;2022-01-20;29;33;11;0;36;1078806;5869;922;4;3037
FR;4;2022-01-21;9;12;18;1;15;1078815;5881;940;5;3052
FR;4;2022-01-22;30;9;2;0;9;1078845;5890;942;5;3061
FR;4;2022-01-23;6;2;4;0;6;1078851;5892;946;5;3067
FR;4;2022-01-24;14;21;8;0;27;1078865;5913;954;5;3094
FR;4;2022-01-25;20;30;8;1;34;1078885;5943;962;6;3128
FR;4;2022-01-26;18;15;6;1;16;1078903;5958;968;7;3144
FR;4;2022-01-27;19;18;5;0;21;1078922;5976;973;7;3165
FR;4;2022-01-28;12;23;7;0;25;1078934;5999;980;7;3190
FR;4;2022-01-29;15;6;4;0;9;1078949;6005;984;7;3199
FR;4;2022-01-30;16;2;0;0;2;1078965;6007;984;7;3201
FR;4;2022-01-31;19;27;6;0;29;1078984;6034;990;7;3230
FR;4;2022-02-01;9;19;11;0;19;1078993;6053;1001;7;3249
FR;4;2022-02-02;16;11;10;2;16;1079009;6064;1011;9;3265
FR;4;2022-02-03;12;21;9;0;24;1079021;6085;1020;9;3289
FR;4;2022-02-04;6;5;7;0;9;1079027;6090;1027;9;3298
FR;4;2022-02-05;6;14;1;0;13;1079033;6104;1028;9;3311
FR;4;2022-02-06;5;2;1;0;2;1079038;6106;1029;9;3313
FR;4;2022-02-07;11;19;6;0;19;1079049;6125;1035;9;3332
FR;4;2022-02-08;14;18;12;1;19;1079063;6143;1047;10;3351
FR;4;2022-02-09;14;10;7;0;13;1079077;6153;1054;10;3364
FR;4;2022-02-10;18;23;9;0;24;1079095;6176;1063;10;3388
FR;4;2022-02-11;17;14;8;0;19;1079112;6190;1071;10;3407
FR;4;2022-02-12;23;7;1;0;6;1079135;6197;1072;10;3413
FR;4;2022-02-13;7;3;3;0;6;1079142;6200;1075;10;3419
FR;4;2022-02-14;18;10;7;0;13;1079160;6210;1082;10;3432
FR;4;2022-02-15;16;7;1;0;7;1079176;6217;1083;10;3439
FR;4;2022-02-16;11;9;10;0;15;1079187;6226;1093;10;3454
FR;4;2022-02-17;10;4;4;0;6;1079197;6230;1097;10;3460
FR;4;2022-02-18;17;13;6;0;17;1079214;6243;1103;10;3477
FR;4;2022-02-19;16;2;2;0;4;1079230;6245;1105;10;3481
FR;4;2022-02-20;7;2;0;0;1;1079237;6247;1105;10;3482
FR;4;2022-02-21;22;3;2;0;3;1079259;6250;1107;10;3485
FR;4;2022-02-22;8;4;8;0;8;1079267;6254;1115;10;3493
FR;4;2022-02-23;16;6;8;0;8;1079283;6260;1123;10;3501
FR;4;2022-02-24;8;3;2;0;3;1079291;6263;1125;10;3504
FR;4;2022-02-25;15;5;7;0;6;1079306;6268;1132;10;3510
FR;4;2022-02-26;26;3;0;0;3;1079332;6271;1132;10;3513
FR;4;2022-02-27;9;0;1;0;1;1079341;6271;1133;10;3514
FR;4;2022-02-28;14;3;2;0;3;1079355;6274;1135;10;3517
FR;4;2022-03-01;6;2;7;0;3;1079361;6276;1142;10;3520
FR;4;2022-03-02;9;2;3;0;4;1079370;6278;1145;10;3524
FR;4;2022-03-03;14;5;1;0;4;1079384;6283;1146;10;3528
FR;4;2022-03-04;6;6;2;1;5;1079390;6289;1148;11;3533
FR;4;2022-03-05;8;2;0;0;2;1079398;6291;1148;11;3535
FR;4;2022-03-06;4;0;1;0;1;1079402;6291;1149;11;3536
FR;4;2022-03-07;9;4;1;0;3;1079411;6295;1150;11;3539
FR;4;2022-03-08;13;2;0;0;2;1079424;6297;1150;11;3541
FR;4;2022-03-09;7;3;2;0;4;1079431;6300;1152;11;3545
FR;4;2022-03-10;5;1;5;0;2;1079436;6301;1157;11;3547
FR;4;2022-03-11;7;2;5;0;1;1079443;6303;1162;11;3548
FR;4;2022-03-12;9;2;0;0;0;1079452;6305;1162;11;3548
FR;4;2022-03-13;5;0;1;0;1;1079457;6305;1163;11;3549
FR;4;2022-03-14;4;1;0;0;1;1079461;6306;1163;11;3550
FR;4;2022-03-15;5;3;1;0;1;1079466;6309;1164;11;3551
FR;4;2022-03-16;6;3;3;0;3;1079472;6312;1167;11;3554
FR;4;2022-03-17;1;4;1;0;5;1079473;6316;1168;11;3559
FR;4;2022-03-18;7;2;0;0;2;1079480;6318;1168;11;3561
FR;4;2022-03-19;1;1;0;0;1;1079481;6319;1168;11;3562
FR;4;2022-03-20;2;0;1;0;0;1079483;6319;1169;11;3562
FR;4;2022-03-21;5;3;0;0;3;1079488;6322;1169;11;3565
FR;4;2022-03-22;2;2;0;0;2;1079490;6324;1169;11;3567
FR;4;2022-03-23;6;3;3;0;5;1079496;6327;1172;11;3572
FR;4;2022-03-24;2;4;3;1;5;1079498;6331;1175;12;3577
FR;4;2022-03-25;3;1;2;0;1;1079501;6332;1177;12;3578
FR;4;2022-03-26;5;5;0;0;5;1079506;6337;1177;12;3583
FR;4;2022-03-27;0;0;1;0;0;1079506;6337;1178;12;3583
FR;4;2022-03-28;4;1;1;0;1;1079510;6338;1179;12;3584
FR;4;2022-03-29;7;0;4;1;0;1079517;6338;1183;13;3584
FR;4;2022-03-30;1;4;0;0;4;1079518;6342;1183;13;3588
FR;4;2022-03-31;1;3;1;1;3;1079519;6345;1184;14;3591
FR;4;2022-04-01;13;3;5;0;6;1079532;6348;1189;14;3597
FR;4;2022-04-02;4;4;0;0;3;1079536;6352;1189;14;3600
FR;4;2022-04-03;0;0;0;0;0;1079536;6352;1189;14;3600
FR;4;2022-04-04;3;3;4;0;3;1079539;6355;1193;14;3603
FR;4;2022-04-05;3;4;1;1;2;1079542;6359;1194;15;3605
FR;4;2022-04-06;3;0;0;0;0;1079545;6359;1194;15;3605
FR;4;2022-04-07;3;2;1;2;3;1079548;6361;1195;17;3608
FR;4;2022-04-08;4;1;1;0;1;1079552;6362;1196;17;3609
FR;4;2022-04-09;0;0;1;1;1;1079552;6362;1197;18;3610
FR;4;2022-04-10;1;2;0;0;2;1079553;6364;1197;18;3612
FR;4;2022-04-11;2;2;4;0;4;1079555;6366;1201;18;3616
FR;4;2022-04-12;2;0;3;0;1;1079557;6366;1204;18;3617
FR;4;2022-04-13;2;6;1;0;7;1079559;6372;1205;18;3624
FR;4;2022-04-14;3;2;0;1;2;1079562;6374;1205;19;3626
FR;4;2022-04-15;0;7;1;0;8;1079562;6381;1206;19;3634
FR;4;2022-04-16;0;0;0;0;0;1079562;6381;1206;19;3634
FR;4;2022-04-17;1;0;0;0;0;1079563;6381;1206;19;3634
FR;4;2022-04-18;1;2;4;0;2;1079564;6383;1210;19;3636
FR;4;2022-04-19;1;0;1;0;0;1079565;6383;1211;19;3636
FR;4;2022-04-20;12;4;1;0;2;1079577;6387;1212;19;3638
FR;4;2022-04-21;5;2;0;0;2;1079582;6389;1212;19;3640
FR;4;2022-04-22;1;0;1;0;0;1079583;6389;1213;19;3640
FR;4;2022-04-23;1;3;1;0;4;1079584;6392;1214;19;3644
FR;4;2022-04-24;0;2;0;0;2;1079584;6394;1214;19;3646
FR;4;2022-04-25;2;4;2;0;6;1079586;6398;1216;19;3652
FR;4;2022-04-26;2;4;1;0;4;1079588;6402;1217;19;3656
FR;4;2022-04-27;3;0;0;0;0;1079591;6402;1217;19;3656
FR;4;2022-04-28;2;3;5;0;4;1079593;6405;1222;19;3660
FR;4;2022-04-29;2;2;0;0;1;1079595;6407;1222;19;3661
FR;4;2022-04-30;0;1;1;0;2;1079595;6408;1223;19;3663
FR;4;2022-05-01;0;0;0;0;0;1079595;6408;1223;19;3663
FR;4;2022-05-02;2;4;2;0;4;1079597;6412;1225;19;3667
FR;4;2022-05-03;0;3;1;0;3;1079597;6415;1226;19;3670
FR;4;2022-05-04;3;1;0;0;1;1079600;6416;1226;19;3671
FR;4;2022-05-05;2;1;1;0;1;1079602;6417;1227;19;3672
FR;4;2022-05-06;2;0;0;0;0;1079604;6417;1227;19;3672
FR;4;2022-05-07;0;0;0;0;0;1079604;6417;1227;19;3672
FR;4;2022-05-08;1;1;0;0;1;1079605;6418;1227;19;3673
FR;4;2022-05-09;2;0;0;0;0;1079607;6418;1227;19;3673
FR;4;2022-05-10;0;1;0;2;3;1079607;6419;1227;21;3676
FR;4;2022-05-11;2;0;0;0;0;1079609;6419;1227;21;3676
FR;4;2022-05-12;5;0;0;1;0;1079614;6419;1227;22;3676
FR;4;2022-05-13;0;0;0;0;0;1079614;6419;1227;22;3676
FR;4;2022-05-14;0;1;0;0;1;1079614;6420;1227;22;3677
FR;4;2022-05-15;0;0;0;0;0;1079614;6420;1227;22;3677
FR;4;2022-05-16;3;0;0;0;0;1079617;6420;1227;22;3677
FR;4;2022-05-17;2;0;0;0;0;1079619;6420;1227;22;3677
FR;4;2022-05-18;0;0;0;0;0;1079619;6420;1227;22;3677
FR;5;2020-12-27;0;0;0;0;0;0;0;0;0;0
FR;5;2020-12-28;0;0;0;0;0;0;0;0;0;0
FR;5;2020-12-29;0;0;0;0;0;0;0;0;0;0
FR;5;2020-12-30;0;0;0;0;0;0;0;0;0;0
FR;5;2020-12-31;0;0;0;0;0;0;0;0;0;0
FR;5;2021-01-01;0;0;0;0;0;0;0;0;0;0
FR;5;2021-01-02;0;0;0;0;0;0;0;0;0;0
FR;5;2021-01-03;0;0;0;0;0;0;0;0;0;0
FR;5;2021-01-04;0;0;0;0;0;0;0;0;0;0
FR;5;2021-01-05;0;0;0;0;0;0;0;0;0;0
FR;5;2021-01-06;0;0;0;0;0;0;0;0;0;0
FR;5;2021-01-07;0;0;0;0;0;0;0;0;0;0
FR;5;2021-01-08;0;0;0;0;0;0;0;0;0;0
FR;5;2021-01-09;0;0;0;0;0;0;0;0;0;0
FR;5;2021-01-10;0;0;0;0;0;0;0;0;0;0
FR;5;2021-01-11;0;0;0;0;0;0;0;0;0;0
FR;5;2021-01-12;0;0;0;0;0;0;0;0;0;0
FR;5;2021-01-13;0;0;0;0;0;0;0;0;0;0
FR;5;2021-01-14;0;0;0;0;0;0;0;0;0;0
FR;5;2021-01-15;0;0;0;0;0;0;0;0;0;0
FR;5;2021-01-16;0;0;0;0;0;0;0;0;0;0
FR;5;2021-01-17;0;0;0;0;0;0;0;0;0;0
FR;5;2021-01-18;0;0;0;0;0;0;0;0;0;0
FR;5;2021-01-19;0;0;0;0;0;0;0;0;0;0
FR;5;2021-01-20;0;0;0;0;0;0;0;0;0;0
FR;5;2021-01-21;0;0;0;0;0;0;0;0;0;0
FR;5;2021-01-22;0;0;0;0;0;0;0;0;0;0
FR;5;2021-01-23;0;0;0;0;0;0;0;0;0;0
FR;5;2021-01-24;0;0;0;0;0;0;0;0;0;0
FR;5;2021-01-25;0;0;0;0;0;0;0;0;0;0
FR;5;2021-01-26;0;0;0;0;0;0;0;0;0;0
FR;5;2021-01-27;0;0;0;0;0;0;0;0;0;0
FR;5;2021-01-28;0;0;0;0;0;0;0;0;0;0
FR;5;2021-01-29;0;0;0;0;0;0;0;0;0;0
FR;5;2021-01-30;0;0;0;0;0;0;0;0;0;0
FR;5;2021-01-31;0;0;0;0;0;0;0;0;0;0
FR;5;2021-02-01;0;0;0;0;0;0;0;0;0;0
FR;5;2021-02-02;0;0;0;0;0;0;0;0;0;0
FR;5;2021-02-03;0;0;0;0;0;0;0;0;0;0
FR;5;2021-02-04;0;0;0;0;0;0;0;0;0;0
FR;5;2021-02-05;0;0;0;0;0;0;0;0;0;0
FR;5;2021-02-06;0;0;0;0;0;0;0;0;0;0
FR;5;2021-02-07;0;0;0;0;0;0;0;0;0;0
FR;5;2021-02-08;0;0;0;0;0;0;0;0;0;0
FR;5;2021-02-09;0;0;0;0;0;0;0;0;0;0
FR;5;2021-02-10;0;0;0;0;0;0;0;0;0;0
FR;5;2021-02-11;0;0;0;0;0;0;0;0;0;0
FR;5;2021-02-12;0;0;0;0;0;0;0;0;0;0
FR;5;2021-02-13;0;0;0;0;0;0;0;0;0;0
FR;5;2021-02-14;0;0;0;0;0;0;0;0;0;0
FR;5;2021-02-15;0;0;0;0;0;0;0;0;0;0
FR;5;2021-02-16;0;0;0;0;0;0;0;0;0;0
FR;5;2021-02-17;0;0;0;0;0;0;0;0;0;0
FR;5;2021-02-18;0;0;0;0;0;0;0;0;0;0
FR;5;2021-02-19;0;0;0;0;0;0;0;0;0;0
FR;5;2021-02-20;0;0;0;0;0;0;0;0;0;0
FR;5;2021-02-21;0;0;0;0;0;0;0;0;0;0
FR;5;2021-02-22;0;0;0;0;0;0;0;0;0;0
FR;5;2021-02-23;0;0;0;0;0;0;0;0;0;0
FR;5;2021-02-24;0;0;0;0;0;0;0;0;0;0
FR;5;2021-02-25;0;0;0;0;0;0;0;0;0;0
FR;5;2021-02-26;0;0;0;0;0;0;0;0;0;0
FR;5;2021-02-27;0;0;0;0;0;0;0;0;0;0
FR;5;2021-02-28;0;0;0;0;0;0;0;0;0;0
FR;5;2021-03-01;0;0;0;0;0;0;0;0;0;0
FR;5;2021-03-02;0;0;0;0;0;0;0;0;0;0
FR;5;2021-03-03;0;0;0;0;0;0;0;0;0;0
FR;5;2021-03-04;0;0;0;0;0;0;0;0;0;0
FR;5;2021-03-05;0;0;0;0;0;0;0;0;0;0
FR;5;2021-03-06;0;0;0;0;0;0;0;0;0;0
FR;5;2021-03-07;0;0;0;0;0;0;0;0;0;0
FR;5;2021-03-08;0;0;0;0;0;0;0;0;0;0
FR;5;2021-03-09;0;0;0;0;0;0;0;0;0;0
FR;5;2021-03-10;0;0;0;0;0;0;0;0;0;0
FR;5;2021-03-11;0;0;0;0;0;0;0;0;0;0
FR;5;2021-03-12;0;0;0;0;0;0;0;0;0;0
FR;5;2021-03-13;0;0;0;0;0;0;0;0;0;0
FR;5;2021-03-14;0;0;0;0;0;0;0;0;0;0
FR;5;2021-03-15;0;0;0;0;0;0;0;0;0;0
FR;5;2021-03-16;0;0;0;0;0;0;0;0;0;0
FR;5;2021-03-17;0;0;0;0;0;0;0;0;0;0
FR;5;2021-03-18;0;0;0;0;0;0;0;0;0;0
FR;5;2021-03-19;0;0;0;0;0;0;0;0;0;0
FR;5;2021-03-20;0;0;0;0;0;0;0;0;0;0
FR;5;2021-03-21;0;0;0;0;0;0;0;0;0;0
FR;5;2021-03-22;0;0;0;0;0;0;0;0;0;0
FR;5;2021-03-23;0;0;0;0;0;0;0;0;0;0
FR;5;2021-03-24;0;0;0;0;0;0;0;0;0;0
FR;5;2021-03-25;0;0;0;0;0;0;0;0;0;0
FR;5;2021-03-26;0;0;0;0;0;0;0;0;0;0
FR;5;2021-03-27;0;0;0;0;0;0;0;0;0;0
FR;5;2021-03-28;0;0;0;0;0;0;0;0;0;0
FR;5;2021-03-29;0;0;0;0;0;0;0;0;0;0
FR;5;2021-03-30;0;0;0;0;0;0;0;0;0;0
FR;5;2021-03-31;0;0;0;0;0;0;0;0;0;0
FR;5;2021-04-01;0;0;0;0;0;0;0;0;0;0
FR;5;2021-04-02;0;0;0;0;0;0;0;0;0;0
FR;5;2021-04-03;0;0;0;0;0;0;0;0;0;0
FR;5;2021-04-04;0;0;0;0;0;0;0;0;0;0
FR;5;2021-04-05;0;0;0;0;0;0;0;0;0;0
FR;5;2021-04-06;0;0;0;0;0;0;0;0;0;0
FR;5;2021-04-07;0;0;0;0;0;0;0;0;0;0
FR;5;2021-04-08;0;0;0;0;0;0;0;0;0;0
FR;5;2021-04-09;0;0;0;0;0;0;0;0;0;0
FR;5;2021-04-10;0;0;0;0;0;0;0;0;0;0
FR;5;2021-04-11;0;0;0;0;0;0;0;0;0;0
FR;5;2021-04-12;0;0;0;0;0;0;0;0;0;0
FR;5;2021-04-13;0;0;0;0;0;0;0;0;0;0
FR;5;2021-04-14;0;0;0;0;0;0;0;0;0;0
FR;5;2021-04-15;0;0;0;0;0;0;0;0;0;0
FR;5;2021-04-16;0;0;0;0;0;0;0;0;0;0
FR;5;2021-04-17;0;0;0;0;0;0;0;0;0;0
FR;5;2021-04-18;0;0;0;0;0;0;0;0;0;0
FR;5;2021-04-19;0;0;0;0;0;0;0;0;0;0
FR;5;2021-04-20;0;0;0;0;0;0;0;0;0;0
FR;5;2021-04-21;0;0;0;0;0;0;0;0;0;0
FR;5;2021-04-22;0;0;0;0;0;0;0;0;0;0
FR;5;2021-04-23;0;0;0;0;0;0;0;0;0;0
FR;5;2021-04-24;0;0;0;0;0;0;0;0;0;0
FR;5;2021-04-25;0;0;0;0;0;0;0;0;0;0
FR;5;2021-04-26;0;0;0;0;0;0;0;0;0;0
FR;5;2021-04-27;0;0;0;0;0;0;0;0;0;0
FR;5;2021-04-28;0;0;0;0;0;0;0;0;0;0
FR;5;2021-04-29;0;0;0;0;0;0;0;0;0;0
FR;5;2021-04-30;0;0;0;0;0;0;0;0;0;0
FR;5;2021-05-01;0;0;0;0;0;0;0;0;0;0
FR;5;2021-05-02;0;0;0;0;0;0;0;0;0;0
FR;5;2021-05-03;0;0;0;0;0;0;0;0;0;0
FR;5;2021-05-04;0;0;0;0;0;0;0;0;0;0
FR;5;2021-05-05;0;0;0;0;0;0;0;0;0;0
FR;5;2021-05-06;0;0;0;0;0;0;0;0;0;0
FR;5;2021-05-07;0;0;0;0;0;0;0;0;0;0
FR;5;2021-05-08;0;0;0;0;0;0;0;0;0;0
FR;5;2021-05-09;0;0;0;0;0;0;0;0;0;0
FR;5;2021-05-10;0;0;0;0;0;0;0;0;0;0
FR;5;2021-05-11;0;0;0;0;0;0;0;0;0;0
FR;5;2021-05-12;0;0;0;0;0;0;0;0;0;0
FR;5;2021-05-13;0;0;0;0;0;0;0;0;0;0
FR;5;2021-05-14;0;0;0;0;0;0;0;0;0;0
FR;5;2021-05-15;0;0;0;0;0;0;0;0;0;0
FR;5;2021-05-16;0;0;0;0;0;0;0;0;0;0
FR;5;2021-05-17;0;0;0;0;0;0;0;0;0;0
FR;5;2021-05-18;0;0;0;0;0;0;0;0;0;0
FR;5;2021-05-19;0;0;0;0;0;0;0;0;0;0
FR;5;2021-05-20;0;0;0;0;0;0;0;0;0;0
FR;5;2021-05-21;0;0;0;0;0;0;0;0;0;0
FR;5;2021-05-22;0;0;0;0;0;0;0;0;0;0
FR;5;2021-05-23;0;0;0;0;0;0;0;0;0;0
FR;5;2021-05-24;0;0;0;0;0;0;0;0;0;0
FR;5;2021-05-25;0;0;0;0;0;0;0;0;0;0
FR;5;2021-05-26;0;0;0;0;0;0;0;0;0;0
FR;5;2021-05-27;0;0;0;0;0;0;0;0;0;0
FR;5;2021-05-28;0;0;0;0;0;0;0;0;0;0
FR;5;2021-05-29;0;0;0;0;0;0;0;0;0;0
FR;5;2021-05-30;0;0;0;0;0;0;0;0;0;0
FR;5;2021-05-31;0;0;0;0;0;0;0;0;0;0
FR;5;2021-06-01;0;0;0;0;0;0;0;0;0;0
FR;5;2021-06-02;0;0;0;0;0;0;0;0;0;0
FR;5;2021-06-03;0;0;0;0;0;0;0;0;0;0
FR;5;2021-06-04;0;0;0;0;0;0;0;0;0;0
FR;5;2021-06-05;0;0;0;0;0;0;0;0;0;0
FR;5;2021-06-06;0;0;0;0;0;0;0;0;0;0
FR;5;2021-06-07;0;0;0;0;0;0;0;0;0;0
FR;5;2021-06-08;0;0;0;0;0;0;0;0;0;0
FR;5;2021-06-09;0;0;0;0;0;0;0;0;0;0
FR;5;2021-06-10;0;0;0;0;0;0;0;0;0;0
FR;5;2021-06-11;0;0;0;0;0;0;0;0;0;0
FR;5;2021-06-12;0;0;0;0;0;0;0;0;0;0
FR;5;2021-06-13;0;0;0;0;0;0;0;0;0;0
FR;5;2021-06-14;0;0;0;0;0;0;0;0;0;0
FR;5;2021-06-15;0;0;0;0;0;0;0;0;0;0
FR;5;2021-06-16;0;0;0;0;0;0;0;0;0;0
FR;5;2021-06-17;0;0;0;0;0;0;0;0;0;0
FR;5;2021-06-18;0;0;0;0;0;0;0;0;0;0
FR;5;2021-06-19;0;0;0;0;0;0;0;0;0;0
FR;5;2021-06-20;0;0;0;0;0;0;0;0;0;0
FR;5;2021-06-21;0;0;0;0;0;0;0;0;0;0
FR;5;2021-06-22;0;0;0;0;0;0;0;0;0;0
FR;5;2021-06-23;0;0;0;0;0;0;0;0;0;0
FR;5;2021-06-24;0;0;0;0;0;0;0;0;0;0
FR;5;2021-06-25;0;0;0;0;0;0;0;0;0;0
FR;5;2021-06-26;0;0;0;0;0;0;0;0;0;0
FR;5;2021-06-27;0;0;0;0;0;0;0;0;0;0
FR;5;2021-06-28;0;0;0;0;0;0;0;0;0;0
FR;5;2021-06-29;0;0;0;0;0;0;0;0;0;0
FR;5;2021-06-30;0;0;0;0;0;0;0;0;0;0
FR;5;2021-07-01;0;0;0;0;0;0;0;0;0;0
FR;5;2021-07-02;0;0;0;0;0;0;0;0;0;0
FR;5;2021-07-03;0;0;0;0;0;0;0;0;0;0
FR;5;2021-07-04;0;0;0;0;0;0;0;0;0;0
FR;5;2021-07-05;0;0;0;0;0;0;0;0;0;0
FR;5;2021-07-06;0;0;0;0;0;0;0;0;0;0
FR;5;2021-07-07;0;0;0;0;0;0;0;0;0;0
FR;5;2021-07-08;0;0;0;0;0;0;0;0;0;0
FR;5;2021-07-09;0;0;0;0;0;0;0;0;0;0
FR;5;2021-07-10;0;0;0;0;0;0;0;0;0;0
FR;5;2021-07-11;0;0;0;0;0;0;0;0;0;0
FR;5;2021-07-12;0;0;0;0;0;0;0;0;0;0
FR;5;2021-07-13;0;0;0;0;0;0;0;0;0;0
FR;5;2021-07-14;0;0;0;0;0;0;0;0;0;0
FR;5;2021-07-15;0;0;0;0;0;0;0;0;0;0
FR;5;2021-07-16;0;0;0;0;0;0;0;0;0;0
FR;5;2021-07-17;0;0;0;0;0;0;0;0;0;0
FR;5;2021-07-18;0;0;0;0;0;0;0;0;0;0
FR;5;2021-07-19;0;0;0;0;0;0;0;0;0;0
FR;5;2021-07-20;0;0;0;0;0;0;0;0;0;0
FR;5;2021-07-21;0;0;0;0;0;0;0;0;0;0
FR;5;2021-07-22;0;0;0;0;0;0;0;0;0;0
FR;5;2021-07-23;0;0;0;0;0;0;0;0;0;0
FR;5;2021-07-24;0;0;0;0;0;0;0;0;0;0
FR;5;2021-07-25;0;0;0;0;0;0;0;0;0;0
FR;5;2021-07-26;0;0;0;0;0;0;0;0;0;0
FR;5;2021-07-27;0;0;0;0;0;0;0;0;0;0
FR;5;2021-07-28;0;0;0;0;0;0;0;0;0;0
FR;5;2021-07-29;0;0;0;0;0;0;0;0;0;0
FR;5;2021-07-30;0;0;0;0;0;0;0;0;0;0
FR;5;2021-07-31;0;0;0;0;0;0;0;0;0;0
FR;5;2021-08-01;0;0;0;0;0;0;0;0;0;0
FR;5;2021-08-02;0;0;0;0;0;0;0;0;0;0
FR;5;2021-08-03;0;0;0;0;0;0;0;0;0;0
FR;5;2021-08-04;0;0;0;0;0;0;0;0;0;0
FR;5;2021-08-05;0;0;0;0;0;0;0;0;0;0
FR;5;2021-08-06;0;0;0;0;0;0;0;0;0;0
FR;5;2021-08-07;0;0;0;0;0;0;0;0;0;0
FR;5;2021-08-08;0;0;0;0;0;0;0;0;0;0
FR;5;2021-08-09;0;0;0;0;0;0;0;0;0;0
FR;5;2021-08-10;0;0;0;0;0;0;0;0;0;0
FR;5;2021-08-11;0;0;0;0;0;0;0;0;0;0
FR;5;2021-08-12;0;0;0;0;0;0;0;0;0;0
FR;5;2021-08-13;0;0;0;0;0;0;0;0;0;0
FR;5;2021-08-14;0;0;0;0;0;0;0;0;0;0
FR;5;2021-08-15;0;0;0;0;0;0;0;0;0;0
FR;5;2021-08-16;0;0;0;0;0;0;0;0;0;0
FR;5;2021-08-17;0;0;0;0;0;0;0;0;0;0
FR;5;2021-08-18;0;0;0;0;0;0;0;0;0;0
FR;5;2021-08-19;0;0;0;0;0;0;0;0;0;0
FR;5;2021-08-20;0;0;0;0;0;0;0;0;0;0
FR;5;2021-08-21;0;0;0;0;0;0;0;0;0;0
FR;5;2021-08-22;0;0;0;0;0;0;0;0;0;0
FR;5;2021-08-23;0;0;0;0;0;0;0;0;0;0
FR;5;2021-08-24;0;0;0;0;0;0;0;0;0;0
FR;5;2021-08-25;0;0;0;0;0;0;0;0;0;0
FR;5;2021-08-26;0;0;0;0;0;0;0;0;0;0
FR;5;2021-08-27;0;0;0;0;0;0;0;0;0;0
FR;5;2021-08-28;0;0;0;0;0;0;0;0;0;0
FR;5;2021-08-29;0;0;0;0;0;0;0;0;0;0
FR;5;2021-08-30;0;0;0;0;0;0;0;0;0;0
FR;5;2021-08-31;0;0;0;0;0;0;0;0;0;0
FR;5;2021-09-01;0;0;0;0;0;0;0;0;0;0
FR;5;2021-09-02;0;0;0;0;0;0;0;0;0;0
FR;5;2021-09-03;0;0;0;0;0;0;0;0;0;0
FR;5;2021-09-04;0;0;0;0;0;0;0;0;0;0
FR;5;2021-09-05;0;0;0;0;0;0;0;0;0;0
FR;5;2021-09-06;0;0;0;0;0;0;0;0;0;0
FR;5;2021-09-07;0;0;0;0;0;0;0;0;0;0
FR;5;2021-09-08;0;0;0;0;0;0;0;0;0;0
FR;5;2021-09-09;0;0;0;0;0;0;0;0;0;0
FR;5;2021-09-10;0;0;0;0;0;0;0;0;0;0
FR;5;2021-09-11;0;0;0;0;0;0;0;0;0;0
FR;5;2021-09-12;0;0;0;0;0;0;0;0;0;0
FR;5;2021-09-13;0;0;0;0;0;0;0;0;0;0
FR;5;2021-09-14;0;0;0;0;0;0;0;0;0;0
FR;5;2021-09-15;0;0;0;0;0;0;0;0;0;0
FR;5;2021-09-16;0;0;0;0;0;0;0;0;0;0
FR;5;2021-09-17;0;0;0;0;0;0;0;0;0;0
FR;5;2021-09-18;0;0;0;0;0;0;0;0;0;0
FR;5;2021-09-19;0;0;0;0;0;0;0;0;0;0
FR;5;2021-09-20;0;0;0;0;0;0;0;0;0;0
FR;5;2021-09-21;0;0;0;0;0;0;0;0;0;0
FR;5;2021-09-22;0;0;0;0;0;0;0;0;0;0
FR;5;2021-09-23;0;0;0;0;0;0;0;0;0;0
FR;5;2021-09-24;0;0;0;0;0;0;0;0;0;0
FR;5;2021-09-25;0;0;0;0;0;0;0;0;0;0
FR;5;2021-09-26;0;0;0;0;0;0;0;0;0;0
FR;5;2021-09-27;0;0;0;0;0;0;0;0;0;0
FR;5;2021-09-28;0;0;0;0;0;0;0;0;0;0
FR;5;2021-09-29;0;0;0;0;0;0;0;0;0;0
FR;5;2021-09-30;0;0;0;0;0;0;0;0;0;0
FR;5;2021-10-01;0;0;0;0;0;0;0;0;0;0
FR;5;2021-10-02;0;0;0;0;0;0;0;0;0;0
FR;5;2021-10-03;0;0;0;0;0;0;0;0;0;0
FR;5;2021-10-04;0;0;0;0;0;0;0;0;0;0
FR;5;2021-10-05;0;0;0;0;0;0;0;0;0;0
FR;5;2021-10-06;0;0;0;0;0;0;0;0;0;0
FR;5;2021-10-07;0;0;0;0;0;0;0;0;0;0
FR;5;2021-10-08;0;0;0;0;0;0;0;0;0;0
FR;5;2021-10-09;0;0;0;0;0;0;0;0;0;0
FR;5;2021-10-10;0;0;0;0;0;0;0;0;0;0
FR;5;2021-10-11;0;0;0;0;0;0;0;0;0;0
FR;5;2021-10-12;0;0;0;0;0;0;0;0;0;0
FR;5;2021-10-13;0;0;0;0;0;0;0;0;0;0
FR;5;2021-10-14;0;0;0;0;0;0;0;0;0;0
FR;5;2021-10-15;0;0;0;0;0;0;0;0;0;0
FR;5;2021-10-16;0;0;0;0;0;0;0;0;0;0
FR;5;2021-10-17;0;0;0;0;0;0;0;0;0;0
FR;5;2021-10-18;0;0;0;0;0;0;0;0;0;0
FR;5;2021-10-19;0;0;0;0;0;0;0;0;0;0
FR;5;2021-10-20;0;0;0;0;0;0;0;0;0;0
FR;5;2021-10-21;0;0;0;0;0;0;0;0;0;0
FR;5;2021-10-22;0;0;0;0;0;0;0;0;0;0
FR;5;2021-10-23;0;0;0;0;0;0;0;0;0;0
FR;5;2021-10-24;0;0;0;0;0;0;0;0;0;0
FR;5;2021-10-25;0;0;0;0;0;0;0;0;0;0
FR;5;2021-10-26;0;0;0;0;0;0;0;0;0;0
FR;5;2021-10-27;0;0;0;0;0;0;0;0;0;0
FR;5;2021-10-28;0;0;0;0;0;0;0;0;0;0
FR;5;2021-10-29;0;0;0;0;0;0;0;0;0;0
FR;5;2021-10-30;0;0;0;0;0;0;0;0;0;0
FR;5;2021-10-31;0;0;0;0;0;0;0;0;0;0
FR;5;2021-11-01;0;0;0;0;0;0;0;0;0;0
FR;5;2021-11-02;0;0;0;0;0;0;0;0;0;0
FR;5;2021-11-03;0;0;0;0;0;0;0;0;0;0
FR;5;2021-11-04;0;0;0;0;0;0;0;0;0;0
FR;5;2021-11-05;0;0;0;0;0;0;0;0;0;0
FR;5;2021-11-06;0;0;0;0;0;0;0;0;0;0
FR;5;2021-11-07;0;0;0;0;0;0;0;0;0;0
FR;5;2021-11-08;0;0;0;0;0;0;0;0;0;0
FR;5;2021-11-09;0;0;0;0;0;0;0;0;0;0
FR;5;2021-11-10;0;0;0;0;0;0;0;0;0;0
FR;5;2021-11-11;0;0;0;0;0;0;0;0;0;0
FR;5;2021-11-12;0;0;0;0;0;0;0;0;0;0
FR;5;2021-11-13;0;0;0;0;0;0;0;0;0;0
FR;5;2021-11-14;0;0;0;0;0;0;0;0;0;0
FR;5;2021-11-15;0;0;0;0;0;0;0;0;0;0
FR;5;2021-11-16;0;0;0;0;0;0;0;0;0;0
FR;5;2021-11-17;0;0;0;0;0;0;0;0;0;0
FR;5;2021-11-18;0;0;0;0;0;0;0;0;0;0
FR;5;2021-11-19;0;0;0;0;0;0;0;0;0;0
FR;5;2021-11-20;0;0;0;0;0;0;0;0;0;0
FR;5;2021-11-21;0;0;0;0;0;0;0;0;0;0
FR;5;2021-11-22;0;0;0;0;0;0;0;0;0;0
FR;5;2021-11-23;0;0;0;0;0;0;0;0;0;0
FR;5;2021-11-24;0;0;0;0;0;0;0;0;0;0
FR;5;2021-11-25;0;0;0;0;0;0;0;0;0;0
FR;5;2021-11-26;0;0;0;0;0;0;0;0;0;0
FR;5;2021-11-27;0;0;0;0;0;0;0;0;0;0
FR;5;2021-11-28;0;0;0;0;0;0;0;0;0;0
FR;5;2021-11-29;0;0;0;0;0;0;0;0;0;0
FR;5;2021-11-30;0;0;0;0;0;0;0;0;0;0
FR;5;2021-12-01;0;0;0;0;0;0;0;0;0;0
FR;5;2021-12-02;0;0;0;0;0;0;0;0;0;0
FR;5;2021-12-03;0;0;0;0;0;0;0;0;0;0
FR;5;2021-12-04;0;0;0;0;0;0;0;0;0;0
FR;5;2021-12-05;0;0;0;0;0;0;0;0;0;0
FR;5;2021-12-06;0;0;0;0;0;0;0;0;0;0
FR;5;2021-12-07;0;0;0;0;0;0;0;0;0;0
FR;5;2021-12-08;0;0;0;0;0;0;0;0;0;0
FR;5;2021-12-09;0;0;0;0;0;0;0;0;0;0
FR;5;2021-12-10;0;0;0;0;0;0;0;0;0;0
FR;5;2021-12-11;0;0;0;0;0;0;0;0;0;0
FR;5;2021-12-12;0;0;0;0;0;0;0;0;0;0
FR;5;2021-12-13;0;0;0;0;0;0;0;0;0;0
FR;5;2021-12-14;29;45;77;0;88;29;45;77;0;88
FR;5;2021-12-15;196;44;37;0;49;225;89;114;0;137
FR;5;2021-12-16;180;21;44;0;48;405;110;158;0;185
FR;5;2021-12-17;310;16;72;0;74;715;126;230;0;259
FR;5;2021-12-18;764;24;22;0;29;1479;150;252;0;288
FR;5;2021-12-19;586;15;15;0;17;2065;165;267;0;305
FR;5;2021-12-20;1223;31;35;0;38;3288;196;302;0;343
FR;5;2021-12-21;1535;22;54;1;60;4823;218;356;1;403
FR;5;2021-12-22;4069;40;37;0;46;8892;258;393;1;449
FR;5;2021-12-23;3042;16;21;0;25;11934;274;414;1;474
FR;5;2021-12-24;759;18;9;0;15;12693;292;423;1;489
FR;5;2021-12-25;61;5;1;0;2;12754;297;424;1;491
FR;5;2021-12-26;623;6;3;0;4;13377;303;427;1;495
FR;5;2021-12-27;4080;25;21;0;23;17457;328;448;1;518
FR;5;2021-12-28;5202;23;41;1;43;22659;351;489;2;561
FR;5;2021-12-29;8104;34;65;2;68;30763;385;554;4;629
FR;5;2021-12-30;5172;18;33;0;39;35935;403;587;4;668
FR;5;2021-12-31;1553;8;10;0;11;37488;411;597;4;679
FR;5;2022-01-01;185;2;2;0;3;37673;413;599;4;682
FR;5;2022-01-02;1489;1;1;0;1;39162;414;600;4;683
FR;5;2022-01-03;3058;36;33;0;32;42220;450;633;4;715
FR;5;2022-01-04;3034;39;33;0;42;45254;489;666;4;757
FR;5;2022-01-05;19323;203;97;1;108;64577;692;763;5;865
FR;5;2022-01-06;3742;133;122;0;142;68319;825;885;5;1007
FR;5;2022-01-07;5007;200;48;2;56;73326;1025;933;7;1063
FR;5;2022-01-08;13654;514;45;0;52;86980;1539;978;7;1115
FR;5;2022-01-09;5755;399;15;0;20;92735;1938;993;7;1135
FR;5;2022-01-10;3453;326;25;0;29;96188;2264;1018;7;1164
FR;5;2022-01-11;3668;284;38;0;41;99856;2548;1056;7;1205
FR;5;2022-01-12;22653;3003;90;0;113;122509;5551;1146;7;1318
FR;5;2022-01-13;4035;622;30;0;32;126544;6173;1176;7;1350
FR;5;2022-01-14;4843;581;44;0;51;131387;6754;1220;7;1401
FR;5;2022-01-15;14681;1746;38;3;49;146068;8500;1258;10;1450
FR;5;2022-01-16;4727;666;3;0;5;150795;9166;1261;10;1455
FR;5;2022-01-17;2293;715;26;0;29;153088;9881;1287;10;1484
FR;5;2022-01-18;2430;870;30;0;40;155518;10751;1317;10;1524
FR;5;2022-01-19;18481;6422;74;2;142;173999;17173;1391;12;1666
FR;5;2022-01-20;1920;1067;25;0;34;175919;18240;1416;12;1700
FR;5;2022-01-21;3076;1371;47;1;59;178995;19611;1463;13;1759
FR;5;2022-01-22;10721;3454;33;1;43;189716;23065;1496;14;1802
FR;5;2022-01-23;2629;1415;5;0;9;192345;24480;1501;14;1811
FR;5;2022-01-24;1159;1340;19;0;23;193504;25820;1520;14;1834
FR;5;2022-01-25;1219;1548;19;2;29;194723;27368;1539;16;1863
FR;5;2022-01-26;10751;12024;50;1;89;205474;39392;1589;17;1952
FR;5;2022-01-27;1291;1693;10;0;17;206765;41085;1599;17;1969
FR;5;2022-01-28;1695;3347;16;0;19;208460;44432;1615;17;1988
FR;5;2022-01-29;6237;8040;68;0;96;214697;52472;1683;17;2084
FR;5;2022-01-30;1509;2950;5;0;18;216206;55422;1688;17;2102
FR;5;2022-01-31;588;1773;23;0;24;216794;57195;1711;17;2126
FR;5;2022-02-01;712;1702;10;0;15;217506;58897;1721;17;2141
FR;5;2022-02-02;6957;15654;52;0;94;224463;74551;1773;17;2235
FR;5;2022-02-03;488;1690;14;0;13;224951;76241;1787;17;2248
FR;5;2022-02-04;941;3001;19;0;31;225892;79242;1806;17;2279
FR;5;2022-02-05;3532;8916;23;0;37;229424;88158;1829;17;2316
FR;5;2022-02-06;737;2397;10;0;19;230161;90555;1839;17;2335
FR;5;2022-02-07;883;1595;22;0;24;231044;92150;1861;17;2359
FR;5;2022-02-08;722;1285;18;0;20;231766;93435;1879;17;2379
FR;5;2022-02-09;4535;12876;44;0;76;236301;106311;1923;17;2455
FR;5;2022-02-10;646;1058;14;0;15;236947;107369;1937;17;2470
FR;5;2022-02-11;793;2026;16;0;21;237740;109395;1953;17;2491
FR;5;2022-02-12;2285;6811;33;0;53;240025;116206;1986;17;2544
FR;5;2022-02-13;465;1540;8;0;8;240490;117746;1994;17;2552
FR;5;2022-02-14;678;1288;10;0;13;241168;119034;2004;17;2565
FR;5;2022-02-15;482;885;9;0;14;241650;119919;2013;17;2579
FR;5;2022-02-16;2978;9123;41;1;58;244628;129042;2054;18;2637
FR;5;2022-02-17;435;805;6;0;7;245063;129847;2060;18;2644
FR;5;2022-02-18;650;1407;13;0;17;245713;131254;2073;18;2661
FR;5;2022-02-19;1371;4314;16;0;28;247084;135568;2089;18;2689
FR;5;2022-02-20;247;879;6;0;8;247331;136447;2095;18;2697
FR;5;2022-02-21;221;607;2;0;4;247552;137054;2097;18;2701
FR;5;2022-02-22;259;545;17;0;17;247811;137599;2114;18;2718
FR;5;2022-02-23;1907;6923;22;1;42;249718;144522;2136;19;2760
FR;5;2022-02-24;182;374;5;1;6;249900;144896;2141;20;2766
FR;5;2022-02-25;335;949;13;0;12;250235;145845;2154;20;2778
FR;5;2022-02-26;972;3067;10;0;14;251207;148912;2164;20;2792
FR;5;2022-02-27;147;506;0;0;3;251354;149418;2164;20;2795
FR;5;2022-02-28;161;369;1;0;1;251515;149787;2165;20;2796
FR;5;2022-03-01;128;279;6;0;7;251643;150066;2171;20;2803
FR;5;2022-03-02;1240;4150;28;3;40;252883;154216;2199;23;2843
FR;5;2022-03-03;121;250;6;0;9;253004;154466;2205;23;2852
FR;5;2022-03-04;193;488;13;0;14;253197;154954;2218;23;2866
FR;5;2022-03-05;676;1990;8;0;16;253873;156944;2226;23;2882
FR;5;2022-03-06;108;260;0;0;0;253981;157204;2226;23;2882
FR;5;2022-03-07;70;228;5;0;3;254051;157432;2231;23;2885
FR;5;2022-03-08;46;130;7;1;7;254097;157562;2238;24;2892
FR;5;2022-03-09;909;3076;23;0;35;255006;160638;2261;24;2927
FR;5;2022-03-10;82;200;8;0;11;255088;160838;2269;24;2938
FR;5;2022-03-11;147;369;13;1;15;255235;161207;2282;25;2953
FR;5;2022-03-12;758;1613;13;1;30;255993;162820;2295;26;2983
FR;5;2022-03-13;76;100;0;0;0;256069;162920;2295;26;2983
FR;5;2022-03-14;67;118;7;1;7;256136;163038;2302;27;2990
FR;5;2022-03-15;83;99;3;0;6;256219;163137;2305;27;2996
FR;5;2022-03-16;884;1822;15;3;34;257103;164959;2320;30;3030
FR;5;2022-03-17;66;123;8;4;10;257169;165082;2328;34;3040
FR;5;2022-03-18;172;318;13;4;18;257341;165400;2341;38;3058
FR;5;2022-03-19;749;1162;12;5;33;258090;166562;2353;43;3091
FR;5;2022-03-20;45;93;1;0;1;258135;166655;2354;43;3092
FR;5;2022-03-21;71;120;10;6;15;258206;166775;2364;49;3107
FR;5;2022-03-22;56;119;8;8;9;258262;166894;2372;57;3116
FR;5;2022-03-23;803;1460;14;8;36;259065;168354;2386;65;3152
FR;5;2022-03-24;68;93;8;7;7;259133;168447;2394;72;3159
FR;5;2022-03-25;222;289;14;8;18;259355;168736;2408;80;3177
FR;5;2022-03-26;706;853;12;5;26;260061;169589;2420;85;3203
FR;5;2022-03-27;74;78;0;0;3;260135;169667;2420;85;3206
FR;5;2022-03-28;81;91;1;2;3;260216;169758;2421;87;3209
FR;5;2022-03-29;71;82;10;4;12;260287;169840;2431;91;3221
FR;5;2022-03-30;820;1115;16;13;29;261107;170955;2447;104;3250
FR;5;2022-03-31;102;124;1;4;6;261209;171079;2448;108;3256
FR;5;2022-04-01;107;86;7;12;11;261316;171165;2455;120;3267
FR;5;2022-04-02;329;348;3;3;14;261645;171513;2458;123;3281
FR;5;2022-04-03;54;59;1;0;1;261699;171572;2459;123;3282
FR;5;2022-04-04;36;57;4;1;8;261735;171629;2463;124;3290
FR;5;2022-04-05;51;60;6;7;9;261786;171689;2469;131;3299
FR;5;2022-04-06;421;439;7;15;16;262207;172128;2476;146;3315
FR;5;2022-04-07;45;68;5;7;7;262252;172196;2481;153;3322
FR;5;2022-04-08;130;110;12;14;15;262382;172306;2493;167;3337
FR;5;2022-04-09;309;321;2;5;16;262691;172627;2495;172;3353
FR;5;2022-04-10;43;31;2;0;2;262734;172658;2497;172;3355
FR;5;2022-04-11;50;60;3;2;4;262784;172718;2500;174;3359
FR;5;2022-04-12;57;54;3;3;5;262841;172772;2503;177;3364
FR;5;2022-04-13;382;413;3;8;16;263223;173185;2506;185;3380
FR;5;2022-04-14;47;48;5;5;9;263270;173233;2511;190;3389
FR;5;2022-04-15;91;107;3;5;4;263361;173340;2514;195;3393
FR;5;2022-04-16;188;183;2;1;13;263549;173523;2516;196;3406
FR;5;2022-04-17;12;10;1;0;1;263561;173533;2517;196;3407
FR;5;2022-04-18;8;9;2;0;2;263569;173542;2519;196;3409
FR;5;2022-04-19;72;70;6;1;6;263641;173612;2525;197;3415
FR;5;2022-04-20;359;349;9;6;12;264000;173961;2534;203;3427
FR;5;2022-04-21;42;64;9;10;12;264042;174025;2543;213;3439
FR;5;2022-04-22;113;96;5;4;5;264155;174121;2548;217;3444
FR;5;2022-04-23;209;192;3;2;10;264364;174313;2551;219;3454
FR;5;2022-04-24;37;35;0;0;3;264401;174348;2551;219;3457
FR;5;2022-04-25;67;65;1;1;4;264468;174413;2552;220;3461
FR;5;2022-04-26;60;61;2;1;5;264528;174474;2554;221;3466
FR;5;2022-04-27;332;316;2;7;14;264860;174790;2556;228;3480
FR;5;2022-04-28;74;54;4;5;8;264934;174844;2560;233;3488
FR;5;2022-04-29;117;79;5;18;12;265051;174923;2565;251;3500
FR;5;2022-04-30;182;115;1;1;10;265233;175038;2566;252;3510
FR;5;2022-05-01;10;7;0;0;0;265243;175045;2566;252;3510
FR;5;2022-05-02;46;27;4;5;2;265289;175072;2570;257;3512
FR;5;2022-05-03;83;55;2;5;11;265372;175127;2572;262;3523
FR;5;2022-05-04;276;204;1;2;7;265648;175331;2573;264;3530
FR;5;2022-05-05;62;32;2;4;4;265710;175363;2575;268;3534
FR;5;2022-05-06;103;64;2;3;5;265813;175427;2577;271;3539
FR;5;2022-05-07;170;115;3;10;13;265983;175542;2580;281;3552
FR;5;2022-05-08;7;8;0;0;2;265990;175550;2580;281;3554
FR;5;2022-05-09;44;31;15;3;16;266034;175581;2595;284;3570
FR;5;2022-05-10;54;47;2;4;4;266088;175628;2597;288;3574
FR;5;2022-05-11;324;235;12;7;21;266412;175863;2609;295;3595
FR;5;2022-05-12;46;34;1;3;2;266458;175897;2610;298;3597
FR;5;2022-05-13;108;82;2;8;8;266566;175979;2612;306;3605
FR;5;2022-05-14;203;129;0;1;8;266769;176108;2612;307;3613
FR;5;2022-05-15;22;7;2;0;1;266791;176115;2614;307;3614
FR;5;2022-05-16;48;31;2;4;4;266839;176146;2616;311;3618
FR;5;2022-05-17;72;40;5;0;2;266911;176186;2621;311;3620
FR;5;2022-05-18;288;212;4;4;8;267199;176398;2625;315;3628
FR;6;2020-12-27;0;0;0;0;0;0;0;0;0;0
FR;6;2020-12-28;0;0;0;0;0;0;0;0;0;0
FR;6;2020-12-29;0;0;0;0;0;0;0;0;0;0
FR;6;2020-12-30;0;0;0;0;0;0;0;0;0;0
FR;6;2020-12-31;0;0;0;0;0;0;0;0;0;0
FR;6;2021-01-01;0;0;0;0;0;0;0;0;0;0
FR;6;2021-01-02;0;0;0;0;0;0;0;0;0;0
FR;6;2021-01-03;0;0;0;0;0;0;0;0;0;0
FR;6;2021-01-04;0;0;0;0;0;0;0;0;0;0
FR;6;2021-01-05;0;0;0;0;0;0;0;0;0;0
FR;6;2021-01-06;0;0;0;0;0;0;0;0;0;0
FR;6;2021-01-07;0;0;0;0;0;0;0;0;0;0
FR;6;2021-01-08;0;0;0;0;0;0;0;0;0;0
FR;6;2021-01-09;0;0;0;0;0;0;0;0;0;0
FR;6;2021-01-10;0;0;0;0;0;0;0;0;0;0
FR;6;2021-01-11;0;0;0;0;0;0;0;0;0;0
FR;6;2021-01-12;0;0;0;0;0;0;0;0;0;0
FR;6;2021-01-13;0;0;0;0;0;0;0;0;0;0
FR;6;2021-01-14;0;0;0;0;0;0;0;0;0;0
FR;6;2021-01-15;0;0;0;0;0;0;0;0;0;0
FR;6;2021-01-16;0;0;0;0;0;0;0;0;0;0
FR;6;2021-01-17;0;0;0;0;0;0;0;0;0;0
FR;6;2021-01-18;0;0;0;0;0;0;0;0;0;0
FR;6;2021-01-19;0;0;0;0;0;0;0;0;0;0
FR;6;2021-01-20;0;0;0;0;0;0;0;0;0;0
FR;6;2021-01-21;0;0;0;0;0;0;0;0;0;0
FR;6;2021-01-22;0;0;0;0;0;0;0;0;0;0
FR;6;2021-01-23;0;0;0;0;0;0;0;0;0;0
FR;6;2021-01-24;0;0;0;0;0;0;0;0;0;0
FR;6;2021-01-25;0;0;0;0;0;0;0;0;0;0
FR;6;2021-01-26;0;0;0;0;0;0;0;0;0;0
FR;6;2021-01-27;0;0;0;0;0;0;0;0;0;0
FR;6;2021-01-28;0;0;0;0;0;0;0;0;0;0
FR;6;2021-01-29;0;0;0;0;0;0;0;0;0;0
FR;6;2021-01-30;0;0;0;0;0;0;0;0;0;0
FR;6;2021-01-31;0;0;0;0;0;0;0;0;0;0
FR;6;2021-02-01;0;0;0;0;0;0;0;0;0;0
FR;6;2021-02-02;0;0;0;0;0;0;0;0;0;0
FR;6;2021-02-03;0;0;0;0;0;0;0;0;0;0
FR;6;2021-02-04;0;0;0;0;0;0;0;0;0;0
FR;6;2021-02-05;0;0;0;0;0;0;0;0;0;0
FR;6;2021-02-06;0;0;0;0;0;0;0;0;0;0
FR;6;2021-02-07;0;0;0;0;0;0;0;0;0;0
FR;6;2021-02-08;0;0;0;0;0;0;0;0;0;0
FR;6;2021-02-09;0;0;0;0;0;0;0;0;0;0
FR;6;2021-02-10;0;0;0;0;0;0;0;0;0;0
FR;6;2021-02-11;0;0;0;0;0;0;0;0;0;0
FR;6;2021-02-12;0;0;0;0;0;0;0;0;0;0
FR;6;2021-02-13;0;0;0;0;0;0;0;0;0;0
FR;6;2021-02-14;0;0;0;0;0;0;0;0;0;0
FR;6;2021-02-15;0;0;0;0;0;0;0;0;0;0
FR;6;2021-02-16;0;0;0;0;0;0;0;0;0;0
FR;6;2021-02-17;0;0;0;0;0;0;0;0;0;0
FR;6;2021-02-18;0;0;0;0;0;0;0;0;0;0
FR;6;2021-02-19;0;0;0;0;0;0;0;0;0;0
FR;6;2021-02-20;0;0;0;0;0;0;0;0;0;0
FR;6;2021-02-21;0;0;0;0;0;0;0;0;0;0
FR;6;2021-02-22;0;0;0;0;0;0;0;0;0;0
FR;6;2021-02-23;0;0;0;0;0;0;0;0;0;0
FR;6;2021-02-24;0;0;0;0;0;0;0;0;0;0
FR;6;2021-02-25;0;0;0;0;0;0;0;0;0;0
FR;6;2021-02-26;0;0;0;0;0;0;0;0;0;0
FR;6;2021-02-27;0;0;0;0;0;0;0;0;0;0
FR;6;2021-02-28;0;0;0;0;0;0;0;0;0;0
FR;6;2021-03-01;0;0;0;0;0;0;0;0;0;0
FR;6;2021-03-02;0;0;0;0;0;0;0;0;0;0
FR;6;2021-03-03;0;0;0;0;0;0;0;0;0;0
FR;6;2021-03-04;0;0;0;0;0;0;0;0;0;0
FR;6;2021-03-05;0;0;0;0;0;0;0;0;0;0
FR;6;2021-03-06;0;0;0;0;0;0;0;0;0;0
FR;6;2021-03-07;0;0;0;0;0;0;0;0;0;0
FR;6;2021-03-08;0;0;0;0;0;0;0;0;0;0
FR;6;2021-03-09;0;0;0;0;0;0;0;0;0;0
FR;6;2021-03-10;0;0;0;0;0;0;0;0;0;0
FR;6;2021-03-11;0;0;0;0;0;0;0;0;0;0
FR;6;2021-03-12;0;0;0;0;0;0;0;0;0;0
FR;6;2021-03-13;0;0;0;0;0;0;0;0;0;0
FR;6;2021-03-14;0;0;0;0;0;0;0;0;0;0
FR;6;2021-03-15;0;0;0;0;0;0;0;0;0;0
FR;6;2021-03-16;0;0;0;0;0;0;0;0;0;0
FR;6;2021-03-17;0;0;0;0;0;0;0;0;0;0
FR;6;2021-03-18;0;0;0;0;0;0;0;0;0;0
FR;6;2021-03-19;0;0;0;0;0;0;0;0;0;0
FR;6;2021-03-20;0;0;0;0;0;0;0;0;0;0
FR;6;2021-03-21;0;0;0;0;0;0;0;0;0;0
FR;6;2021-03-22;0;0;0;0;0;0;0;0;0;0
FR;6;2021-03-23;0;0;0;0;0;0;0;0;0;0
FR;6;2021-03-24;0;0;0;0;0;0;0;0;0;0
FR;6;2021-03-25;0;0;0;0;0;0;0;0;0;0
FR;6;2021-03-26;0;0;0;0;0;0;0;0;0;0
FR;6;2021-03-27;0;0;0;0;0;0;0;0;0;0
FR;6;2021-03-28;0;0;0;0;0;0;0;0;0;0
FR;6;2021-03-29;0;0;0;0;0;0;0;0;0;0
FR;6;2021-03-30;0;0;0;0;0;0;0;0;0;0
FR;6;2021-03-31;0;0;0;0;0;0;0;0;0;0
FR;6;2021-04-01;0;0;0;0;0;0;0;0;0;0
FR;6;2021-04-02;0;0;0;0;0;0;0;0;0;0
FR;6;2021-04-03;0;0;0;0;0;0;0;0;0;0
FR;6;2021-04-04;0;0;0;0;0;0;0;0;0;0
FR;6;2021-04-05;0;0;0;0;0;0;0;0;0;0
FR;6;2021-04-06;0;0;0;0;0;0;0;0;0;0
FR;6;2021-04-07;0;0;0;0;0;0;0;0;0;0
FR;6;2021-04-08;0;0;0;0;0;0;0;0;0;0
FR;6;2021-04-09;0;0;0;0;0;0;0;0;0;0
FR;6;2021-04-10;0;0;0;0;0;0;0;0;0;0
FR;6;2021-04-11;0;0;0;0;0;0;0;0;0;0
FR;6;2021-04-12;0;0;0;0;0;0;0;0;0;0
FR;6;2021-04-13;0;0;0;0;0;0;0;0;0;0
FR;6;2021-04-14;0;0;0;0;0;0;0;0;0;0
FR;6;2021-04-15;0;0;0;0;0;0;0;0;0;0
FR;6;2021-04-16;0;0;0;0;0;0;0;0;0;0
FR;6;2021-04-17;0;0;0;0;0;0;0;0;0;0
FR;6;2021-04-18;0;0;0;0;0;0;0;0;0;0
FR;6;2021-04-19;0;0;0;0;0;0;0;0;0;0
FR;6;2021-04-20;0;0;0;0;0;0;0;0;0;0
FR;6;2021-04-21;0;0;0;0;0;0;0;0;0;0
FR;6;2021-04-22;0;0;0;0;0;0;0;0;0;0
FR;6;2021-04-23;0;0;0;0;0;0;0;0;0;0
FR;6;2021-04-24;0;0;0;0;0;0;0;0;0;0
FR;6;2021-04-25;0;0;0;0;0;0;0;0;0;0
FR;6;2021-04-26;0;0;0;0;0;0;0;0;0;0
FR;6;2021-04-27;0;0;0;0;0;0;0;0;0;0
FR;6;2021-04-28;0;0;0;0;0;0;0;0;0;0
FR;6;2021-04-29;0;0;0;0;0;0;0;0;0;0
FR;6;2021-04-30;0;0;0;0;0;0;0;0;0;0
FR;6;2021-05-01;0;0;0;0;0;0;0;0;0;0
FR;6;2021-05-02;0;0;0;0;0;0;0;0;0;0
FR;6;2021-05-03;0;0;0;0;0;0;0;0;0;0
FR;6;2021-05-04;0;0;0;0;0;0;0;0;0;0
FR;6;2021-05-05;0;0;0;0;0;0;0;0;0;0
FR;6;2021-05-06;0;0;0;0;0;0;0;0;0;0
FR;6;2021-05-07;0;0;0;0;0;0;0;0;0;0
FR;6;2021-05-08;0;0;0;0;0;0;0;0;0;0
FR;6;2021-05-09;0;0;0;0;0;0;0;0;0;0
FR;6;2021-05-10;0;0;0;0;0;0;0;0;0;0
FR;6;2021-05-11;0;0;0;0;0;0;0;0;0;0
FR;6;2021-05-12;0;0;0;0;0;0;0;0;0;0
FR;6;2021-05-13;0;0;0;0;0;0;0;0;0;0
FR;6;2021-05-14;0;0;0;0;0;0;0;0;0;0
FR;6;2021-05-15;0;0;0;0;0;0;0;0;0;0
FR;6;2021-05-16;0;0;0;0;0;0;0;0;0;0
FR;6;2021-05-17;0;0;0;0;0;0;0;0;0;0
FR;6;2021-05-18;0;0;0;0;0;0;0;0;0;0
FR;6;2021-05-19;0;0;0;0;0;0;0;0;0;0
FR;6;2021-05-20;0;0;0;0;0;0;0;0;0;0
FR;6;2021-05-21;0;0;0;0;0;0;0;0;0;0
FR;6;2021-05-22;0;0;0;0;0;0;0;0;0;0
FR;6;2021-05-23;0;0;0;0;0;0;0;0;0;0
FR;6;2021-05-24;0;0;0;0;0;0;0;0;0;0
FR;6;2021-05-25;0;0;0;0;0;0;0;0;0;0
FR;6;2021-05-26;0;0;0;0;0;0;0;0;0;0
FR;6;2021-05-27;0;0;0;0;0;0;0;0;0;0
FR;6;2021-05-28;0;0;0;0;0;0;0;0;0;0
FR;6;2021-05-29;0;0;0;0;0;0;0;0;0;0
FR;6;2021-05-30;0;0;0;0;0;0;0;0;0;0
FR;6;2021-05-31;0;0;0;0;0;0;0;0;0;0
FR;6;2021-06-01;0;0;0;0;0;0;0;0;0;0
FR;6;2021-06-02;0;0;0;0;0;0;0;0;0;0
FR;6;2021-06-03;0;0;0;0;0;0;0;0;0;0
FR;6;2021-06-04;0;0;0;0;0;0;0;0;0;0
FR;6;2021-06-05;0;0;0;0;0;0;0;0;0;0
FR;6;2021-06-06;0;0;0;0;0;0;0;0;0;0
FR;6;2021-06-07;0;0;0;0;0;0;0;0;0;0
FR;6;2021-06-08;0;0;0;0;0;0;0;0;0;0
FR;6;2021-06-09;0;0;0;0;0;0;0;0;0;0
FR;6;2021-06-10;0;0;0;0;0;0;0;0;0;0
FR;6;2021-06-11;0;0;0;0;0;0;0;0;0;0
FR;6;2021-06-12;0;0;0;0;0;0;0;0;0;0
FR;6;2021-06-13;0;0;0;0;0;0;0;0;0;0
FR;6;2021-06-14;0;0;0;0;0;0;0;0;0;0
FR;6;2021-06-15;0;0;0;0;0;0;0;0;0;0
FR;6;2021-06-16;0;0;0;0;0;0;0;0;0;0
FR;6;2021-06-17;0;0;0;0;0;0;0;0;0;0
FR;6;2021-06-18;0;0;0;0;0;0;0;0;0;0
FR;6;2021-06-19;0;0;0;0;0;0;0;0;0;0
FR;6;2021-06-20;0;0;0;0;0;0;0;0;0;0
FR;6;2021-06-21;0;0;0;0;0;0;0;0;0;0
FR;6;2021-06-22;0;0;0;0;0;0;0;0;0;0
FR;6;2021-06-23;0;0;0;0;0;0;0;0;0;0
FR;6;2021-06-24;0;0;0;0;0;0;0;0;0;0
FR;6;2021-06-25;0;0;0;0;0;0;0;0;0;0
FR;6;2021-06-26;0;0;0;0;0;0;0;0;0;0
FR;6;2021-06-27;0;0;0;0;0;0;0;0;0;0
FR;6;2021-06-28;0;0;0;0;0;0;0;0;0;0
FR;6;2021-06-29;0;0;0;0;0;0;0;0;0;0
FR;6;2021-06-30;0;0;0;0;0;0;0;0;0;0
FR;6;2021-07-01;0;0;0;0;0;0;0;0;0;0
FR;6;2021-07-02;0;0;0;0;0;0;0;0;0;0
FR;6;2021-07-03;0;0;0;0;0;0;0;0;0;0
FR;6;2021-07-04;0;0;0;0;0;0;0;0;0;0
FR;6;2021-07-05;0;0;0;0;0;0;0;0;0;0
FR;6;2021-07-06;0;0;0;0;0;0;0;0;0;0
FR;6;2021-07-07;0;0;0;0;0;0;0;0;0;0
FR;6;2021-07-08;0;0;0;0;0;0;0;0;0;0
FR;6;2021-07-09;0;0;0;0;0;0;0;0;0;0
FR;6;2021-07-10;0;0;0;0;0;0;0;0;0;0
FR;6;2021-07-11;0;0;0;0;0;0;0;0;0;0
FR;6;2021-07-12;0;0;0;0;0;0;0;0;0;0
FR;6;2021-07-13;0;0;0;0;0;0;0;0;0;0
FR;6;2021-07-14;0;0;0;0;0;0;0;0;0;0
FR;6;2021-07-15;0;0;0;0;0;0;0;0;0;0
FR;6;2021-07-16;0;0;0;0;0;0;0;0;0;0
FR;6;2021-07-17;0;0;0;0;0;0;0;0;0;0
FR;6;2021-07-18;0;0;0;0;0;0;0;0;0;0
FR;6;2021-07-19;0;0;0;0;0;0;0;0;0;0
FR;6;2021-07-20;0;0;0;0;0;0;0;0;0;0
FR;6;2021-07-21;0;0;0;0;0;0;0;0;0;0
FR;6;2021-07-22;0;0;0;0;0;0;0;0;0;0
FR;6;2021-07-23;0;0;0;0;0;0;0;0;0;0
FR;6;2021-07-24;0;0;0;0;0;0;0;0;0;0
FR;6;2021-07-25;0;0;0;0;0;0;0;0;0;0
FR;6;2021-07-26;0;0;0;0;0;0;0;0;0;0
FR;6;2021-07-27;0;0;0;0;0;0;0;0;0;0
FR;6;2021-07-28;0;0;0;0;0;0;0;0;0;0
FR;6;2021-07-29;0;0;0;0;0;0;0;0;0;0
FR;6;2021-07-30;0;0;0;0;0;0;0;0;0;0
FR;6;2021-07-31;0;0;0;0;0;0;0;0;0;0
FR;6;2021-08-01;0;0;0;0;0;0;0;0;0;0
FR;6;2021-08-02;0;0;0;0;0;0;0;0;0;0
FR;6;2021-08-03;0;0;0;0;0;0;0;0;0;0
FR;6;2021-08-04;0;0;0;0;0;0;0;0;0;0
FR;6;2021-08-05;0;0;0;0;0;0;0;0;0;0
FR;6;2021-08-06;0;0;0;0;0;0;0;0;0;0
FR;6;2021-08-07;0;0;0;0;0;0;0;0;0;0
FR;6;2021-08-08;0;0;0;0;0;0;0;0;0;0
FR;6;2021-08-09;0;0;0;0;0;0;0;0;0;0
FR;6;2021-08-10;0;0;0;0;0;0;0;0;0;0
FR;6;2021-08-11;0;0;0;0;0;0;0;0;0;0
FR;6;2021-08-12;0;0;0;0;0;0;0;0;0;0
FR;6;2021-08-13;0;0;0;0;0;0;0;0;0;0
FR;6;2021-08-14;0;0;0;0;0;0;0;0;0;0
FR;6;2021-08-15;0;0;0;0;0;0;0;0;0;0
FR;6;2021-08-16;0;0;0;0;0;0;0;0;0;0
FR;6;2021-08-17;0;0;0;0;0;0;0;0;0;0
FR;6;2021-08-18;0;0;0;0;0;0;0;0;0;0
FR;6;2021-08-19;0;0;0;0;0;0;0;0;0;0
FR;6;2021-08-20;0;0;0;0;0;0;0;0;0;0
FR;6;2021-08-21;0;0;0;0;0;0;0;0;0;0
FR;6;2021-08-22;0;0;0;0;0;0;0;0;0;0
FR;6;2021-08-23;0;0;0;0;0;0;0;0;0;0
FR;6;2021-08-24;0;0;0;0;0;0;0;0;0;0
FR;6;2021-08-25;0;0;0;0;0;0;0;0;0;0
FR;6;2021-08-26;0;0;0;0;0;0;0;0;0;0
FR;6;2021-08-27;0;0;0;0;0;0;0;0;0;0
FR;6;2021-08-28;0;0;0;0;0;0;0;0;0;0
FR;6;2021-08-29;0;0;0;0;0;0;0;0;0;0
FR;6;2021-08-30;0;0;0;0;0;0;0;0;0;0
FR;6;2021-08-31;0;0;0;0;0;0;0;0;0;0
FR;6;2021-09-01;0;0;0;0;0;0;0;0;0;0
FR;6;2021-09-02;0;0;0;0;0;0;0;0;0;0
FR;6;2021-09-03;0;0;0;0;0;0;0;0;0;0
FR;6;2021-09-04;0;0;0;0;0;0;0;0;0;0
FR;6;2021-09-05;0;0;0;0;0;0;0;0;0;0
FR;6;2021-09-06;0;0;0;0;0;0;0;0;0;0
FR;6;2021-09-07;0;0;0;0;0;0;0;0;0;0
FR;6;2021-09-08;0;0;0;0;0;0;0;0;0;0
FR;6;2021-09-09;0;0;0;0;0;0;0;0;0;0
FR;6;2021-09-10;0;0;0;0;0;0;0;0;0;0
FR;6;2021-09-11;0;0;0;0;0;0;0;0;0;0
FR;6;2021-09-12;0;0;0;0;0;0;0;0;0;0
FR;6;2021-09-13;0;0;0;0;0;0;0;0;0;0
FR;6;2021-09-14;0;0;0;0;0;0;0;0;0;0
FR;6;2021-09-15;0;0;0;0;0;0;0;0;0;0
FR;6;2021-09-16;0;0;0;0;0;0;0;0;0;0
FR;6;2021-09-17;0;0;0;0;0;0;0;0;0;0
FR;6;2021-09-18;0;0;0;0;0;0;0;0;0;0
FR;6;2021-09-19;0;0;0;0;0;0;0;0;0;0
FR;6;2021-09-20;0;0;0;0;0;0;0;0;0;0
FR;6;2021-09-21;0;0;0;0;0;0;0;0;0;0
FR;6;2021-09-22;0;0;0;0;0;0;0;0;0;0
FR;6;2021-09-23;0;0;0;0;0;0;0;0;0;0
FR;6;2021-09-24;0;0;0;0;0;0;0;0;0;0
FR;6;2021-09-25;0;0;0;0;0;0;0;0;0;0
FR;6;2021-09-26;0;0;0;0;0;0;0;0;0;0
FR;6;2021-09-27;0;0;0;0;0;0;0;0;0;0
FR;6;2021-09-28;0;0;0;0;0;0;0;0;0;0
FR;6;2021-09-29;0;0;0;0;0;0;0;0;0;0
FR;6;2021-09-30;0;0;0;0;0;0;0;0;0;0
FR;6;2021-10-01;0;0;0;0;0;0;0;0;0;0
FR;6;2021-10-02;0;0;0;0;0;0;0;0;0;0
FR;6;2021-10-03;0;0;0;0;0;0;0;0;0;0
FR;6;2021-10-04;0;0;0;0;0;0;0;0;0;0
FR;6;2021-10-05;0;0;0;0;0;0;0;0;0;0
FR;6;2021-10-06;0;0;0;0;0;0;0;0;0;0
FR;6;2021-10-07;0;0;0;0;0;0;0;0;0;0
FR;6;2021-10-08;0;0;0;0;0;0;0;0;0;0
FR;6;2021-10-09;0;0;0;0;0;0;0;0;0;0
FR;6;2021-10-10;0;0;0;0;0;0;0;0;0;0
FR;6;2021-10-11;0;0;0;0;0;0;0;0;0;0
FR;6;2021-10-12;0;0;0;0;0;0;0;0;0;0
FR;6;2021-10-13;0;0;0;0;0;0;0;0;0;0
FR;6;2021-10-14;0;0;0;0;0;0;0;0;0;0
FR;6;2021-10-15;0;0;0;0;0;0;0;0;0;0
FR;6;2021-10-16;0;0;0;0;0;0;0;0;0;0
FR;6;2021-10-17;0;0;0;0;0;0;0;0;0;0
FR;6;2021-10-18;0;0;0;0;0;0;0;0;0;0
FR;6;2021-10-19;0;0;0;0;0;0;0;0;0;0
FR;6;2021-10-20;0;0;0;0;0;0;0;0;0;0
FR;6;2021-10-21;0;0;0;0;0;0;0;0;0;0
FR;6;2021-10-22;0;0;0;0;0;0;0;0;0;0
FR;6;2021-10-23;0;0;0;0;0;0;0;0;0;0
FR;6;2021-10-24;0;0;0;0;0;0;0;0;0;0
FR;6;2021-10-25;0;0;0;0;0;0;0;0;0;0
FR;6;2021-10-26;0;0;0;0;0;0;0;0;0;0
FR;6;2021-10-27;0;0;0;0;0;0;0;0;0;0
FR;6;2021-10-28;0;0;0;0;0;0;0;0;0;0
FR;6;2021-10-29;0;0;0;0;0;0;0;0;0;0
FR;6;2021-10-30;0;0;0;0;0;0;0;0;0;0
FR;6;2021-10-31;0;0;0;0;0;0;0;0;0;0
FR;6;2021-11-01;0;0;0;0;0;0;0;0;0;0
FR;6;2021-11-02;0;0;0;0;0;0;0;0;0;0
FR;6;2021-11-03;0;0;0;0;0;0;0;0;0;0
FR;6;2021-11-04;0;0;0;0;0;0;0;0;0;0
FR;6;2021-11-05;0;0;0;0;0;0;0;0;0;0
FR;6;2021-11-06;0;0;0;0;0;0;0;0;0;0
FR;6;2021-11-07;0;0;0;0;0;0;0;0;0;0
FR;6;2021-11-08;0;0;0;0;0;0;0;0;0;0
FR;6;2021-11-09;0;0;0;0;0;0;0;0;0;0
FR;6;2021-11-10;0;0;0;0;0;0;0;0;0;0
FR;6;2021-11-11;0;0;0;0;0;0;0;0;0;0
FR;6;2021-11-12;0;0;0;0;0;0;0;0;0;0
FR;6;2021-11-13;0;0;0;0;0;0;0;0;0;0
FR;6;2021-11-14;0;0;0;0;0;0;0;0;0;0
FR;6;2021-11-15;0;0;0;0;0;0;0;0;0;0
FR;6;2021-11-16;0;0;0;0;0;0;0;0;0;0
FR;6;2021-11-17;0;0;0;0;0;0;0;0;0;0
FR;6;2021-11-18;0;0;0;0;0;0;0;0;0;0
FR;6;2021-11-19;0;0;0;0;0;0;0;0;0;0
FR;6;2021-11-20;0;0;0;0;0;0;0;0;0;0
FR;6;2021-11-21;0;0;0;0;0;0;0;0;0;0
FR;6;2021-11-22;0;0;0;0;0;0;0;0;0;0
FR;6;2021-11-23;0;0;0;0;0;0;0;0;0;0
FR;6;2021-11-24;0;0;0;0;0;0;0;0;0;0
FR;6;2021-11-25;0;0;0;0;0;0;0;0;0;0
FR;6;2021-11-26;0;0;0;0;0;0;0;0;0;0
FR;6;2021-11-27;0;0;0;0;0;0;0;0;0;0
FR;6;2021-11-28;0;0;0;0;0;0;0;0;0;0
FR;6;2021-11-29;0;0;0;0;0;0;0;0;0;0
FR;6;2021-11-30;0;0;0;0;0;0;0;0;0;0
FR;6;2021-12-01;0;0;0;0;0;0;0;0;0;0
FR;6;2021-12-02;0;0;0;0;0;0;0;0;0;0
FR;6;2021-12-03;0;0;0;0;0;0;0;0;0;0
FR;6;2021-12-04;0;0;0;0;0;0;0;0;0;0
FR;6;2021-12-05;0;0;0;0;0;0;0;0;0;0
FR;6;2021-12-06;0;0;0;0;0;0;0;0;0;0
FR;6;2021-12-07;0;0;0;0;0;0;0;0;0;0
FR;6;2021-12-08;0;0;0;0;0;0;0;0;0;0
FR;6;2021-12-09;0;0;0;0;0;0;0;0;0;0
FR;6;2021-12-10;0;0;0;0;0;0;0;0;0;0
FR;6;2021-12-11;0;0;0;0;0;0;0;0;0;0
FR;6;2021-12-12;0;0;0;0;0;0;0;0;0;0
FR;6;2021-12-13;0;0;0;0;0;0;0;0;0;0
FR;6;2021-12-14;0;0;0;0;0;0;0;0;0;0
FR;6;2021-12-15;0;0;0;0;0;0;0;0;0;0
FR;6;2021-12-16;0;0;0;0;0;0;0;0;0;0
FR;6;2021-12-17;0;0;0;0;0;0;0;0;0;0
FR;6;2021-12-18;0;0;0;0;0;0;0;0;0;0
FR;6;2021-12-19;0;0;0;0;0;0;0;0;0;0
FR;6;2021-12-20;0;0;0;0;0;0;0;0;0;0
FR;6;2021-12-21;0;0;0;0;0;0;0;0;0;0
FR;6;2021-12-22;0;0;0;0;0;0;0;0;0;0
FR;6;2021-12-23;0;0;0;0;0;0;0;0;0;0
FR;6;2021-12-24;0;0;0;0;0;0;0;0;0;0
FR;6;2021-12-25;0;0;0;0;0;0;0;0;0;0
FR;6;2021-12-26;0;0;0;0;0;0;0;0;0;0
FR;6;2021-12-27;0;0;0;0;0;0;0;0;0;0
FR;6;2021-12-28;0;0;0;0;0;0;0;0;0;0
FR;6;2021-12-29;0;0;0;0;0;0;0;0;0;0
FR;6;2021-12-30;0;0;0;0;0;0;0;0;0;0
FR;6;2021-12-31;0;0;0;0;0;0;0;0;0;0
FR;6;2022-01-01;0;0;0;0;0;0;0;0;0;0
FR;6;2022-01-02;0;0;0;0;0;0;0;0;0;0
FR;6;2022-01-03;0;0;0;0;0;0;0;0;0;0
FR;6;2022-01-04;0;0;0;0;0;0;0;0;0;0
FR;6;2022-01-05;0;0;0;0;0;0;0;0;0;0
FR;6;2022-01-06;0;0;0;0;0;0;0;0;0;0
FR;6;2022-01-07;0;0;0;0;0;0;0;0;0;0
FR;6;2022-01-08;0;0;0;0;0;0;0;0;0;0
FR;6;2022-01-09;0;0;0;0;0;0;0;0;0;0
FR;6;2022-01-10;0;0;0;0;0;0;0;0;0;0
FR;6;2022-01-11;0;0;0;0;0;0;0;0;0;0
FR;6;2022-01-12;0;0;0;0;0;0;0;0;0;0
FR;6;2022-01-13;0;0;0;0;0;0;0;0;0;0
FR;6;2022-01-14;0;0;0;0;0;0;0;0;0;0
FR;6;2022-01-15;0;0;0;0;0;0;0;0;0;0
FR;6;2022-01-16;0;0;0;0;0;0;0;0;0;0
FR;6;2022-01-17;0;0;0;0;0;0;0;0;0;0
FR;6;2022-01-18;0;0;0;0;0;0;0;0;0;0
FR;6;2022-01-19;0;0;0;0;0;0;0;0;0;0
FR;6;2022-01-20;0;0;0;0;0;0;0;0;0;0
FR;6;2022-01-21;0;0;0;0;0;0;0;0;0;0
FR;6;2022-01-22;0;0;0;0;0;0;0;0;0;0
FR;6;2022-01-23;0;0;0;0;0;0;0;0;0;0
FR;6;2022-01-24;0;0;0;0;0;0;0;0;0;0
FR;6;2022-01-25;0;0;0;0;0;0;0;0;0;0
FR;6;2022-01-26;0;0;0;0;0;0;0;0;0;0
FR;6;2022-01-27;0;0;0;0;0;0;0;0;0;0
FR;6;2022-01-28;0;0;0;0;0;0;0;0;0;0
FR;6;2022-01-29;0;0;0;0;0;0;0;0;0;0
FR;6;2022-01-30;0;0;0;0;0;0;0;0;0;0
FR;6;2022-01-31;0;0;0;0;0;0;0;0;0;0
FR;6;2022-02-01;0;0;0;0;0;0;0;0;0;0
FR;6;2022-02-02;0;0;0;0;0;0;0;0;0;0
FR;6;2022-02-03;0;0;0;0;0;0;0;0;0;0
FR;6;2022-02-04;0;0;0;0;0;0;0;0;0;0
FR;6;2022-02-05;0;0;0;0;0;0;0;0;0;0
FR;6;2022-02-06;0;0;0;0;0;0;0;0;0;0
FR;6;2022-02-07;0;0;0;0;0;0;0;0;0;0
FR;6;2022-02-08;0;0;0;0;0;0;0;0;0;0
FR;6;2022-02-09;0;0;0;0;0;0;0;0;0;0
FR;6;2022-02-10;0;0;0;0;0;0;0;0;0;0
FR;6;2022-02-11;0;0;0;0;0;0;0;0;0;0
FR;6;2022-02-12;0;0;0;0;0;0;0;0;0;0
FR;6;2022-02-13;0;0;0;0;0;0;0;0;0;0
FR;6;2022-02-14;0;0;0;0;0;0;0;0;0;0
FR;6;2022-02-15;0;0;0;0;0;0;0;0;0;0
FR;6;2022-02-16;0;0;0;0;0;0;0;0;0;0
FR;6;2022-02-17;0;0;0;0;0;0;0;0;0;0
FR;6;2022-02-18;0;0;0;0;0;0;0;0;0;0
FR;6;2022-02-19;0;0;0;0;0;0;0;0;0;0
FR;6;2022-02-20;0;0;0;0;0;0;0;0;0;0
FR;6;2022-02-21;0;0;0;0;0;0;0;0;0;0
FR;6;2022-02-22;0;0;0;0;0;0;0;0;0;0
FR;6;2022-02-23;0;0;0;0;0;0;0;0;0;0
FR;6;2022-02-24;0;0;0;0;0;0;0;0;0;0
FR;6;2022-02-25;0;0;0;0;0;0;0;0;0;0
FR;6;2022-02-26;1;0;0;0;0;1;0;0;0;0
FR;6;2022-02-27;0;0;0;0;0;1;0;0;0;0
FR;6;2022-02-28;0;0;0;0;0;1;0;0;0;0
FR;6;2022-03-01;3;0;0;0;0;4;0;0;0;0
FR;6;2022-03-02;97;9;2;0;7;101;9;2;0;7
FR;6;2022-03-03;0;0;0;0;0;101;9;2;0;7
FR;6;2022-03-04;91;4;0;0;4;192;13;2;0;11
FR;6;2022-03-05;391;23;2;0;14;583;36;4;0;25
FR;6;2022-03-06;7;1;0;0;0;590;37;4;0;25
FR;6;2022-03-07;337;19;0;0;13;927;56;4;0;38
FR;6;2022-03-08;230;14;0;0;5;1157;70;4;0;43
FR;6;2022-03-09;519;29;2;0;21;1676;99;6;0;64
FR;6;2022-03-10;207;18;0;1;12;1883;117;6;1;76
FR;6;2022-03-11;328;21;6;0;21;2211;138;12;1;97
FR;6;2022-03-12;518;25;1;0;20;2729;163;13;1;117
FR;6;2022-03-13;40;2;0;0;1;2769;165;13;1;118
FR;6;2022-03-14;201;4;2;0;3;2970;169;15;1;121
FR;6;2022-03-15;112;11;2;0;9;3082;180;17;1;130
FR;6;2022-03-16;310;17;1;1;14;3392;197;18;2;144
FR;6;2022-03-17;117;6;1;2;4;3509;203;19;4;148
FR;6;2022-03-18;214;11;0;0;6;3723;214;19;4;154
FR;6;2022-03-19;307;19;2;0;9;4030;233;21;4;163
FR;6;2022-03-20;15;5;0;0;1;4045;238;21;4;164
FR;6;2022-03-21;132;23;1;0;4;4177;261;22;4;168
FR;6;2022-03-22;97;15;0;0;4;4274;276;22;4;172
FR;6;2022-03-23;226;108;3;0;14;4500;384;25;4;186
FR;6;2022-03-24;99;15;1;3;4;4599;399;26;7;190
FR;6;2022-03-25;203;141;2;1;15;4802;540;28;8;205
FR;6;2022-03-26;332;295;7;1;19;5134;835;35;9;224
FR;6;2022-03-27;32;30;1;0;1;5166;865;36;9;225
FR;6;2022-03-28;200;208;8;1;17;5366;1073;44;10;242
FR;6;2022-03-29;126;189;12;2;12;5492;1262;56;12;254
FR;6;2022-03-30;305;476;10;2;22;5797;1738;66;14;276
FR;6;2022-03-31;124;140;9;0;13;5921;1878;75;14;289
FR;6;2022-04-01;194;150;11;2;23;6115;2028;86;16;312
FR;6;2022-04-02;205;241;9;1;13;6320;2269;95;17;325
FR;6;2022-04-03;17;21;0;0;1;6337;2290;95;17;326
FR;6;2022-04-04;130;114;6;1;9;6467;2404;101;18;335
FR;6;2022-04-05;145;88;15;1;11;6612;2492;116;19;346
FR;6;2022-04-06;203;245;22;26;27;6815;2737;138;45;373
FR;6;2022-04-07;127;96;15;5;17;6942;2833;153;50;390
FR;6;2022-04-08;199;170;16;3;17;7141;3003;169;53;407
FR;6;2022-04-09;145;139;6;12;13;7286;3142;175;65;420
FR;6;2022-04-10;10;20;3;0;1;7296;3162;178;65;421
FR;6;2022-04-11;101;106;4;0;5;7397;3268;182;65;426
FR;6;2022-04-12;135;75;5;8;10;7532;3343;187;73;436
FR;6;2022-04-13;160;175;7;5;13;7692;3518;194;78;449
FR;6;2022-04-14;100;103;5;10;8;7792;3621;199;88;457
FR;6;2022-04-15;160;148;11;7;19;7952;3769;210;95;476
FR;6;2022-04-16;127;132;5;0;14;8079;3901;215;95;490
FR;6;2022-04-17;8;9;4;0;4;8087;3910;219;95;494
FR;6;2022-04-18;8;15;3;0;4;8095;3925;222;95;498
FR;6;2022-04-19;97;112;4;3;3;8192;4037;226;98;501
FR;6;2022-04-20;172;227;8;7;15;8364;4264;234;105;516
FR;6;2022-04-21;111;93;8;4;11;8475;4357;242;109;527
FR;6;2022-04-22;136;160;13;12;13;8611;4517;255;121;540
FR;6;2022-04-23;104;129;1;1;7;8715;4646;256;122;547
FR;6;2022-04-24;5;21;1;0;0;8720;4667;257;122;547
FR;6;2022-04-25;90;128;3;8;11;8810;4795;260;130;558
FR;6;2022-04-26;101;128;18;2;16;8911;4923;278;132;574
FR;6;2022-04-27;196;159;21;1;27;9107;5082;299;133;601
FR;6;2022-04-28;108;87;6;1;8;9215;5169;305;134;609
FR;6;2022-04-29;186;168;16;2;20;9401;5337;321;136;629
FR;6;2022-04-30;131;125;7;1;24;9532;5462;328;137;653
FR;6;2022-05-01;7;6;0;0;0;9539;5468;328;137;653
FR;6;2022-05-02;94;65;3;4;3;9633;5533;331;141;656
FR;6;2022-05-03;136;91;11;2;7;9769;5624;342;143;663
FR;6;2022-05-04;165;118;25;12;29;9934;5742;367;155;692
FR;6;2022-05-05;101;70;8;3;12;10035;5812;375;158;704
FR;6;2022-05-06;150;110;10;9;16;10185;5922;385;167;720
FR;6;2022-05-07;138;93;13;3;23;10323;6015;398;170;743
FR;6;2022-05-08;20;8;6;5;7;10343;6023;404;175;750
FR;6;2022-05-09;83;70;9;7;13;10426;6093;413;182;763
FR;6;2022-05-10;109;80;15;7;12;10535;6173;428;189;775
FR;6;2022-05-11;130;120;11;14;20;10665;6293;439;203;795
FR;6;2022-05-12;105;75;6;5;13;10770;6368;445;208;808
FR;6;2022-05-13;154;95;17;21;20;10924;6463;462;229;828
FR;6;2022-05-14;81;59;6;7;15;11005;6522;468;236;843
FR;6;2022-05-15;12;7;1;0;1;11017;6529;469;236;844
FR;6;2022-05-16;63;52;7;2;12;11080;6581;476;238;856
FR;6;2022-05-17;122;74;4;7;10;11202;6655;480;245;866
FR;6;2022-05-18;129;115;6;1;13;11331;6770;486;246;879
FR;0;2020-12-27;601;0;0;0;0;601;0;0;0;0
FR;0;2020-12-28;663;1;0;0;0;1264;1;0;0;0
FR;0;2020-12-29;371;0;0;0;0;1635;1;0;0;0
FR;0;2020-12-30;437;0;0;0;0;2072;1;0;0;0
FR;0;2020-12-31;413;0;0;0;0;2485;1;0;0;0
FR;0;2021-01-01;1135;1;0;0;0;3620;2;0;0;0
FR;0;2021-01-02;356;3;0;0;0;3976;5;0;0;0
FR;0;2021-01-03;398;0;0;0;0;4374;5;0;0;0
FR;0;2021-01-04;2086;2;0;0;0;6460;7;0;0;0
FR;0;2021-01-05;7547;2;0;0;0;14007;9;0;0;0
FR;0;2021-01-06;12410;10;0;0;0;26417;19;0;0;0
FR;0;2021-01-07;29445;9;0;0;0;55862;28;0;0;0
FR;0;2021-01-08;37121;9;0;0;0;92983;37;0;0;0
FR;0;2021-01-09;11209;4;0;0;0;104192;41;0;0;0
FR;0;2021-01-10;5996;3;0;0;0;110188;44;0;0;0
FR;0;2021-01-11;39922;16;0;0;0;150110;60;0;0;0
FR;0;2021-01-12;62119;15;0;0;0;212229;75;0;0;0
FR;0;2021-01-13;65096;28;0;0;0;277325;103;0;0;0
FR;0;2021-01-14;83124;69;0;0;0;360449;172;0;0;0
FR;0;2021-01-15;68985;26;0;0;0;429434;198;0;0;0
FR;0;2021-01-16;20208;70;0;0;0;449642;268;0;0;0
FR;0;2021-01-17;10976;46;0;0;0;460618;314;0;0;0
FR;0;2021-01-18;85873;165;0;0;0;546491;479;0;0;0
FR;0;2021-01-19;130569;170;0;0;0;677060;649;0;0;0
FR;0;2021-01-20;137522;170;0;0;0;814582;819;0;0;0
FR;0;2021-01-21;158368;168;0;0;0;972950;987;0;0;0
FR;0;2021-01-22;121036;199;0;0;0;1093986;1186;0;0;0
FR;0;2021-01-23;38464;63;0;0;0;1132450;1249;0;0;0
FR;0;2021-01-24;9740;69;0;0;0;1142190;1318;0;0;0
FR;0;2021-01-25;78216;1263;0;0;0;1220406;2581;0;0;0
FR;0;2021-01-26;100358;3277;1;0;0;1320764;5858;1;0;0
FR;0;2021-01-27;107222;5887;0;0;0;1427986;11745;1;0;0
FR;0;2021-01-28;124322;14922;0;0;0;1552308;26667;1;0;0
FR;0;2021-01-29;92169;17693;0;0;0;1644477;44360;1;0;0
FR;0;2021-01-30;29110;4258;0;0;0;1673587;48618;1;0;0
FR;0;2021-01-31;5225;1731;0;0;0;1678812;50349;1;0;0
FR;0;2021-02-01;53103;21505;0;0;0;1731915;71854;1;0;0
FR;0;2021-02-02;72273;35630;0;0;0;1804188;107484;1;0;0
FR;0;2021-02-03;72284;37877;0;0;0;1876472;145361;1;0;0
FR;0;2021-02-04;82046;51373;0;0;0;1958518;196734;1;0;0
FR;0;2021-02-05;68216;46039;0;0;0;2026734;242773;1;0;0
FR;0;2021-02-06;23114;10759;0;0;0;2049848;253532;1;0;0
FR;0;2021-02-07;5181;5256;0;0;0;2055029;258788;1;0;0
FR;0;2021-02-08;46815;46833;0;0;0;2101844;305621;1;0;0
FR;0;2021-02-09;65990;74178;0;0;0;2167834;379799;1;0;0
FR;0;2021-02-10;70980;79009;0;0;0;2238814;458808;1;0;0
FR;0;2021-02-11;87234;100985;0;0;0;2326048;559793;1;0;0
FR;0;2021-02-12;79286;74850;0;0;0;2405334;634643;1;0;0
FR;0;2021-02-13;22351;19502;0;0;0;2427685;654145;1;0;0
FR;0;2021-02-14;5070;7174;0;0;0;2432755;661319;1;0;0
FR;0;2021-02-15;38068;76602;0;0;0;2470823;737921;1;0;0
FR;0;2021-02-16;50361;100525;0;0;0;2521184;838446;1;0;0
FR;0;2021-02-17;50494;104569;1;0;0;2571678;943015;2;0;0
FR;0;2021-02-18;69755;120169;0;0;0;2641433;1063184;2;0;0
FR;0;2021-02-19;65047;90987;1;0;0;2706480;1154171;3;0;0
FR;0;2021-02-20;18573;28575;0;0;0;2725053;1182746;3;0;0
FR;0;2021-02-21;3314;6317;0;0;0;2728367;1189063;3;0;0
FR;0;2021-02-22;37476;73126;2;0;0;2765843;1262189;5;0;0
FR;0;2021-02-23;53758;84430;1;0;0;2819601;1346619;6;0;0
FR;0;2021-02-24;59977;81624;1;0;0;2879578;1428243;7;0;0
FR;0;2021-02-25;100541;91390;1;0;0;2980119;1519633;8;0;0
FR;0;2021-02-26;113422;70743;1;0;0;3093541;1590376;9;0;0
FR;0;2021-02-27;52091;22128;0;0;0;3145632;1612504;9;0;0
FR;0;2021-02-28;6190;4294;1;0;0;3151822;1616798;10;0;0
FR;0;2021-03-01;65826;53278;1;0;0;3217648;1670076;11;0;0
FR;0;2021-03-02;101345;66558;2;0;0;3318993;1736634;13;0;0
FR;0;2021-03-03;116459;65517;0;0;0;3435452;1802151;13;0;0
FR;0;2021-03-04;163579;70111;3;0;0;3599031;1872262;16;0;0
FR;0;2021-03-05;200880;63141;3;0;0;3799911;1935403;19;0;0
FR;0;2021-03-06;207920;17735;3;0;0;4007831;1953138;22;0;0
FR;0;2021-03-07;121250;5011;1;0;0;4129081;1958149;23;0;0
FR;0;2021-03-08;107110;50404;2;0;0;4236191;2008553;25;0;0
FR;0;2021-03-09;172409;56527;2;0;0;4408600;2065080;27;0;0
FR;0;2021-03-10;178931;57128;5;0;0;4587531;2122208;32;0;0
FR;0;2021-03-11;242820;63394;2;0;0;4830351;2185602;34;0;0
FR;0;2021-03-12;294769;53412;1;0;0;5125120;2239014;35;0;0
FR;0;2021-03-13;231369;15314;1;0;0;5356489;2254328;36;0;0
FR;0;2021-03-14;63334;3327;1;0;0;5419823;2257655;37;0;0
FR;0;2021-03-15;158598;32190;3;0;0;5578421;2289845;40;0;0
FR;0;2021-03-16;141537;39151;6;0;0;5719958;2328996;46;0;0
FR;0;2021-03-17;150440;38212;4;0;0;5870398;2367208;50;0;0
FR;0;2021-03-18;167776;44555;5;0;0;6038174;2411763;55;0;0
FR;0;2021-03-19;229959;37177;2;0;0;6268133;2448940;57;0;0
FR;0;2021-03-20;166639;11599;1;0;0;6434772;2460539;58;0;0
FR;0;2021-03-21;49917;2523;1;0;0;6484689;2463062;59;0;0
FR;0;2021-03-22;169992;34002;2;0;0;6654681;2497064;61;0;0
FR;0;2021-03-23;250329;42387;1;0;0;6905010;2539451;62;0;0
FR;0;2021-03-24;256846;43720;0;0;0;7161856;2583171;62;0;0
FR;0;2021-03-25;341744;44855;5;0;0;7503600;2628026;67;0;0
FR;0;2021-03-26;358741;41821;4;1;0;7862341;2669847;71;1;0
FR;0;2021-03-27;195237;16705;1;0;0;8057578;2686552;72;1;0
FR;0;2021-03-28;59321;3989;3;0;0;8116899;2690541;75;1;0
FR;0;2021-03-29;202926;54035;4;0;0;8319825;2744576;79;1;0
FR;0;2021-03-30;285405;69645;4;0;0;8605230;2814221;83;1;0
FR;0;2021-03-31;262960;73204;4;0;0;8868190;2887425;87;1;0
FR;0;2021-04-01;315380;89115;12;0;0;9183570;2976540;99;1;0
FR;0;2021-04-02;281272;92720;7;0;0;9464842;3069260;106;1;0
FR;0;2021-04-03;141046;61903;5;0;0;9605888;3131163;111;1;0
FR;0;2021-04-04;46448;18730;2;0;0;9652336;3149893;113;1;0
FR;0;2021-04-05;63304;10820;11;0;0;9715640;3160713;124;1;0
FR;0;2021-04-06;217139;109129;17;0;0;9932779;3269842;141;1;0
FR;0;2021-04-07;260184;115394;17;0;0;10192963;3385236;158;1;0
FR;0;2021-04-08;337731;121651;14;0;0;10530694;3506887;172;1;0
FR;0;2021-04-09;410076;116284;49;0;0;10940770;3623171;221;1;0
FR;0;2021-04-10;212578;82613;15;0;0;11153348;3705784;236;1;0
FR;0;2021-04-11;56121;34439;7;0;0;11209469;3740223;243;1;0
FR;0;2021-04-12;236994;115209;45;0;0;11446463;3855432;288;1;0
FR;0;2021-04-13;309415;144544;98;1;0;11755878;3999976;386;2;0
FR;0;2021-04-14;294430;139288;213;0;0;12050308;4139264;599;2;0
FR;0;2021-04-15;337002;148312;338;0;0;12387310;4287576;937;2;0
FR;0;2021-04-16;339221;145864;352;0;0;12726531;4433440;1289;2;0
FR;0;2021-04-17;188619;90050;108;0;0;12915150;4523490;1397;2;0
FR;0;2021-04-18;51600;35371;47;0;0;12966750;4558861;1444;2;0
FR;0;2021-04-19;205637;138210;454;0;0;13172387;4697071;1898;2;0
FR;0;2021-04-20;254339;170752;568;0;0;13426726;4867823;2466;2;0
FR;0;2021-04-21;253174;169039;834;0;0;13679900;5036862;3300;2;0
FR;0;2021-04-22;287482;188609;818;0;0;13967382;5225471;4118;2;0
FR;0;2021-04-23;297925;183377;747;0;0;14265307;5408848;4865;2;0
FR;0;2021-04-24;190407;111541;251;0;0;14455714;5520389;5116;2;0
FR;0;2021-04-25;69536;38778;51;0;0;14525250;5559167;5167;2;0
FR;0;2021-04-26;220888;156212;560;0;0;14746138;5715379;5727;2;0
FR;0;2021-04-27;284543;187323;939;0;0;15030681;5902702;6666;2;0
FR;0;2021-04-28;299430;183141;1422;1;1;15330111;6085843;8088;3;1
FR;0;2021-04-29;357050;196403;1276;0;0;15687161;6282246;9364;3;1
FR;0;2021-04-30;372128;184752;1119;1;0;16059289;6466998;10483;4;1
FR;0;2021-05-01;167594;52496;178;0;0;16226883;6519494;10661;4;1
FR;0;2021-05-02;91697;37766;83;0;0;16318580;6557260;10744;4;1
FR;0;2021-05-03;288848;168508;839;0;0;16607428;6725768;11583;4;1
FR;0;2021-05-04;315582;224332;1230;0;0;16923010;6950100;12813;4;1
FR;0;2021-05-05;327088;224681;1312;0;0;17250098;7174781;14125;4;1
FR;0;2021-05-06;379415;239334;1629;0;0;17629513;7414115;15754;4;1
FR;0;2021-05-07;372673;257234;1222;0;0;18002186;7671349;16976;4;1
FR;0;2021-05-08;222132;67281;297;0;0;18224318;7738630;17273;4;1
FR;0;2021-05-09;129682;46423;243;0;0;18354000;7785053;17516;4;1
FR;0;2021-05-10;313292;228697;1232;0;0;18667292;8013750;18748;4;1
FR;0;2021-05-11;403805;257789;1563;0;0;19071097;8271539;20311;4;1
FR;0;2021-05-12;434023;233030;1542;0;0;19505120;8504569;21853;4;1
FR;0;2021-05-13;338542;56931;430;0;0;19843662;8561500;22283;4;1
FR;0;2021-05-14;454049;167240;1122;0;0;20297711;8728740;23405;4;1
FR;0;2021-05-15;374914;94012;442;0;0;20672625;8822752;23847;4;1
FR;0;2021-05-16;202716;20792;168;0;0;20875341;8843544;24015;4;1
FR;0;2021-05-17;376053;148830;1549;0;0;21251394;8992374;25564;4;1
FR;0;2021-05-18;460051;153055;1986;0;0;21711445;9145429;27550;4;1
FR;0;2021-05-19;467287;144788;2455;0;0;22178732;9290217;30005;4;1
FR;0;2021-05-20;507392;160188;2331;0;0;22686124;9450405;32336;4;1
FR;0;2021-05-21;489551;174337;1987;0;0;23175675;9624742;34323;4;1
FR;0;2021-05-22;347137;79844;668;0;0;23522812;9704586;34991;4;1
FR;0;2021-05-23;161635;14403;246;0;0;23684447;9718989;35237;4;1
FR;0;2021-05-24;263128;33171;599;0;0;23947575;9752160;35836;4;1
FR;0;2021-05-25;400133;189105;2349;1;0;24347708;9941265;38185;5;1
FR;0;2021-05-26;413354;188367;2217;0;0;24761062;10129632;40402;5;1
FR;0;2021-05-27;449697;218518;2158;0;0;25210759;10348150;42560;5;1
FR;0;2021-05-28;429440;259383;1889;0;0;25640199;10607533;44449;5;1
FR;0;2021-05-29;298937;149319;583;0;0;25939136;10756852;45032;5;1
FR;0;2021-05-30;107094;32583;163;0;0;26046230;10789435;45195;5;1
FR;0;2021-05-31;357910;203379;1465;1;1;26404140;10992814;46660;6;2
FR;0;2021-06-01;430823;251267;1959;1;1;26834963;11244081;48619;7;3
FR;0;2021-06-02;419281;230807;1978;0;0;27254244;11474888;50597;7;3
FR;0;2021-06-03;464517;258379;1819;0;0;27718761;11733267;52416;7;3
FR;0;2021-06-04;455679;304703;1729;1;1;28174440;12037970;54145;8;4
FR;0;2021-06-05;304742;188949;651;0;0;28479182;12226919;54796;8;4
FR;0;2021-06-06;133236;49131;226;0;0;28612418;12276050;55022;8;4
FR;0;2021-06-07;338925;261945;1518;0;0;28951343;12537995;56540;8;4
FR;0;2021-06-08;393553;290952;1796;0;0;29344896;12828947;58336;8;4
FR;0;2021-06-09;384654;275484;1727;0;0;29729550;13104431;60063;8;4
FR;0;2021-06-10;403955;288921;1719;1;0;30133505;13393352;61782;9;4
FR;0;2021-06-11;386460;357244;1459;0;0;30519965;13750596;63241;9;4
FR;0;2021-06-12;283202;211282;490;0;0;30803167;13961878;63731;9;4
FR;0;2021-06-13;104828;73986;204;0;0;30907995;14035864;63935;9;4
FR;0;2021-06-14;240644;355596;1425;1;0;31148639;14391460;65360;10;4
FR;0;2021-06-15;307971;385632;1564;1;0;31456610;14777092;66924;11;4
FR;0;2021-06-16;313832;357721;1414;1;0;31770442;15134813;68338;12;4
FR;0;2021-06-17;317551;372428;1422;1;0;32087993;15507241;69760;13;4
FR;0;2021-06-18;321550;442425;1331;1;0;32409543;15949666;71091;14;4
FR;0;2021-06-19;224303;273779;448;0;0;32633846;16223445;71539;14;4
FR;0;2021-06-20;74366;102592;127;0;0;32708212;16326037;71666;14;4
FR;0;2021-06-21;195561;401871;1032;1;1;32903773;16727908;72698;15;5
FR;0;2021-06-22;222997;467396;1259;10;2;33126770;17195304;73957;25;7
FR;0;2021-06-23;233861;439906;1195;1;1;33360631;17635210;75152;26;8
FR;0;2021-06-24;241722;409578;1348;0;0;33602353;18044788;76500;26;8
FR;0;2021-06-25;227460;522214;1398;0;0;33829813;18567002;77898;26;8
FR;0;2021-06-26;153190;370691;585;1;0;33983003;18937693;78483;27;8
FR;0;2021-06-27;55861;156225;168;1;0;34038864;19093918;78651;28;8
FR;0;2021-06-28;154610;452890;1166;0;0;34193474;19546808;79817;28;8
FR;0;2021-06-29;182536;506772;2124;0;0;34376010;20053580;81941;28;8
FR;0;2021-06-30;203832;482322;2009;21;2;34579842;20535902;83950;49;10
FR;0;2021-07-01;231091;457811;2221;5;1;34810933;20993713;86171;54;11
FR;0;2021-07-02;228287;520213;2119;5;3;35039220;21513926;88290;59;14
FR;0;2021-07-03;141927;368738;909;3;1;35181147;21882664;89199;62;15
FR;0;2021-07-04;56688;141266;265;0;0;35237835;22023930;89464;62;15
FR;0;2021-07-05;168198;419319;1668;8;2;35406033;22443249;91132;70;17
FR;0;2021-07-06;196541;474804;1828;45;8;35602574;22918053;92960;115;25
FR;0;2021-07-07;212913;439302;1876;24;5;35815487;23357355;94836;139;30
FR;0;2021-07-08;231432;424161;2088;20;7;36046919;23781516;96924;159;37
FR;0;2021-07-09;228338;510647;2182;4;2;36275257;24292163;99106;163;39
FR;0;2021-07-10;148529;339860;982;1;1;36423786;24632023;100088;164;40
FR;0;2021-07-11;60138;110140;282;0;0;36483924;24742163;100370;164;40
FR;0;2021-07-12;168950;478212;1756;4;0;36652874;25220375;102126;168;40
FR;0;2021-07-13;287044;527440;2045;8;2;36939918;25747815;104171;176;42
FR;0;2021-07-14;180874;157745;433;0;0;37120792;25905560;104604;176;42
FR;0;2021-07-15;346851;502480;2097;1;0;37467643;26408040;106701;177;42
FR;0;2021-07-16;379895;495983;2021;3;1;37847538;26904023;108722;180;43
FR;0;2021-07-17;259648;319820;876;1;0;38107186;27223843;109598;181;43
FR;0;2021-07-18;109663;114803;310;0;0;38216849;27338646;109908;181;43
FR;0;2021-07-19;285306;425115;1627;3;0;38502155;27763761;111535;184;43
FR;0;2021-07-20;376711;452483;1721;0;0;38878866;28216244;113256;184;43
FR;0;2021-07-21;395618;407953;1549;4;2;39274484;28624197;114805;188;45
FR;0;2021-07-22;440869;388158;1713;4;2;39715353;29012355;116518;192;47
FR;0;2021-07-23;439789;423212;1880;4;2;40155142;29435567;118398;196;49
FR;0;2021-07-24;285177;269620;803;1;0;40440319;29705187;119201;197;49
FR;0;2021-07-25;121050;80063;226;0;0;40561369;29785250;119427;197;49
FR;0;2021-07-26;347237;323246;1614;3;2;40908606;30108496;121041;200;51
FR;0;2021-07-27;463877;320343;1696;4;2;41372483;30428839;122737;204;53
FR;0;2021-07-28;459286;290032;1634;4;2;41831769;30718871;124371;208;55
FR;0;2021-07-29;489676;276951;1794;2;1;42321445;30995822;126165;210;56
FR;0;2021-07-30;461623;302913;1935;5;2;42783068;31298735;128100;215;58
FR;0;2021-07-31;285338;185063;914;1;0;43068406;31483798;129014;216;58
FR;0;2021-08-01;111933;50011;252;0;0;43180339;31533809;129266;216;58
FR;0;2021-08-02;341202;234609;1598;2;0;43521541;31768418;130864;218;58
FR;0;2021-08-03;398387;245137;1716;2;1;43919928;32013555;132580;220;59
FR;0;2021-08-04;384608;210128;1590;6;3;44304536;32223683;134170;226;62
FR;0;2021-08-05;365971;228925;1709;0;0;44670507;32452608;135879;226;62
FR;0;2021-08-06;359540;271743;1833;4;1;45030047;32724351;137712;230;63
FR;0;2021-08-07;213032;178381;755;4;3;45243079;32902732;138467;234;66
FR;0;2021-08-08;74128;63250;270;0;0;45317207;32965982;138737;234;66
FR;0;2021-08-09;258570;259587;1540;4;3;45575777;33225569;140277;238;69
FR;0;2021-08-10;306586;278079;1655;2;1;45882363;33503648;141932;240;70
FR;0;2021-08-11;279512;260309;1440;5;1;46161875;33763957;143372;245;71
FR;0;2021-08-12;271363;278633;1659;3;1;46433238;34042590;145031;248;72
FR;0;2021-08-13;252028;277890;1589;3;2;46685266;34320480;146620;251;74
FR;0;2021-08-14;145271;197357;739;0;0;46830537;34517837;147359;251;74
FR;0;2021-08-15;39296;50108;215;1;0;46869833;34567945;147574;252;74
FR;0;2021-08-16;186033;318169;1539;0;0;47055866;34886114;149113;252;74
FR;0;2021-08-17;215551;336619;1633;7;1;47271417;35222733;150746;259;75
FR;0;2021-08-18;198915;324799;1594;7;4;47470332;35547532;152340;266;79
FR;0;2021-08-19;191873;325758;1633;1;0;47662205;35873290;153973;267;79
FR;0;2021-08-20;186334;366317;1810;3;2;47848539;36239607;155783;270;81
FR;0;2021-08-21;104746;238171;703;0;0;47953285;36477778;156486;270;81
FR;0;2021-08-22;31885;87199;253;1;1;47985170;36564977;156739;271;82
FR;0;2021-08-23;140881;357271;1558;3;2;48126051;36922248;158297;274;84
FR;0;2021-08-24;162397;376928;1844;5;1;48288448;37299176;160141;279;85
FR;0;2021-08-25;151057;350880;2028;8;3;48439505;37650056;162169;287;88
FR;0;2021-08-26;142729;342886;2553;10;1;48582234;37992942;164722;297;89
FR;0;2021-08-27;148360;388097;2789;11;4;48730594;38381039;167511;308;93
FR;0;2021-08-28;90595;249557;1405;0;0;48821189;38630596;168916;308;93
FR;0;2021-08-29;27304;83332;516;1;0;48848493;38713928;169432;309;93
FR;0;2021-08-30;117320;324910;4706;6;6028;48965813;39038838;174138;315;6121
FR;0;2021-08-31;128712;334679;10176;19;11882;49094525;39373517;184314;334;18003
FR;0;2021-09-01;135713;285694;22414;7;24306;49230238;39659211;206728;341;42309
FR;0;2021-09-02;112573;247288;26507;13;28851;49342811;39906499;233235;354;71160
FR;0;2021-09-03;118163;292725;29951;23;32959;49460974;40199224;263186;377;104119
FR;0;2021-09-04;89793;217731;12583;12;14069;49550767;40416955;275769;389;118188
FR;0;2021-09-05;21333;44868;4390;2;4729;49572100;40461823;280159;391;122917
FR;0;2021-09-06;75311;180829;31944;16;34241;49647411;40642652;312103;407;157158
FR;0;2021-09-07;80039;181261;33234;40;36091;49727450;40823913;345337;447;193249
FR;0;2021-09-08;89625;206215;29653;27;32453;49817075;41030128;374990;474;225702
FR;0;2021-09-09;76627;165397;33039;26;36516;49893702;41195525;408029;500;262218
FR;0;2021-09-10;95554;203693;35713;26;40496;49989256;41399218;443742;526;302714
FR;0;2021-09-11;66702;169217;12134;19;14305;50055958;41568435;455876;545;317019
FR;0;2021-09-12;12788;32081;2766;1;3159;50068746;41600516;458642;546;320178
FR;0;2021-09-13;64365;126390;41202;32;44042;50133111;41726906;499844;578;364220
FR;0;2021-09-14;73295;129121;56340;78;61992;50206406;41856027;556184;656;426212
FR;0;2021-09-15;76399;167866;55626;58;54771;50282805;42023893;611810;714;480983
FR;0;2021-09-16;63748;114556;60025;85;60009;50346553;42138449;671835;799;540992
FR;0;2021-09-17;74953;156844;53821;70;57221;50421506;42295293;725656;869;598213
FR;0;2021-09-18;48185;139599;15594;25;17283;50469691;42434892;741250;894;615496
FR;0;2021-09-19;7863;23714;2434;1;2621;50477554;42458606;743684;895;618117
FR;0;2021-09-20;44436;93938;50020;73;50250;50521990;42552544;793704;968;668367
FR;0;2021-09-21;45803;98461;62724;76;63355;50567793;42651005;856428;1044;731722
FR;0;2021-09-22;48580;142298;55330;83;55340;50616373;42793303;911758;1127;787062
FR;0;2021-09-23;43150;91988;62348;94;63460;50659523;42885291;974106;1221;850522
FR;0;2021-09-24;52189;133246;54522;110;59083;50711712;43018537;1028628;1331;909605
FR;0;2021-09-25;35191;115494;16263;37;18251;50746903;43134031;1044891;1368;927856
FR;0;2021-09-26;5524;17814;2264;5;2329;50752427;43151845;1047155;1373;930185
FR;0;2021-09-27;33917;76983;47168;96;48119;50786344;43228828;1094323;1469;978304
FR;0;2021-09-28;36444;75253;54926;88;56451;50822788;43304081;1149249;1557;1034755
FR;0;2021-09-29;44309;100840;53320;112;54803;50867097;43404921;1202569;1669;1089558
FR;0;2021-09-30;36265;72776;56996;95;59465;50903362;43477697;1259565;1764;1149023
FR;0;2021-10-01;61494;100832;57771;108;63676;50964856;43578529;1317336;1872;1212699
FR;0;2021-10-02;39410;78326;20947;38;23317;51004266;43656855;1338283;1910;1236016
FR;0;2021-10-03;5261;10540;2523;4;2539;51009527;43667395;1340806;1914;1238555
FR;0;2021-10-04;34926;58516;52607;84;54769;51044453;43725911;1393413;1998;1293324
FR;0;2021-10-05;33537;64349;60958;135;64908;51077990;43790260;1454371;2133;1358232
FR;0;2021-10-06;42399;79223;65684;113;68205;51120389;43869483;1520055;2246;1426437
FR;0;2021-10-07;30388;62118;65374;91;68651;51150777;43931601;1585429;2337;1495088
FR;0;2021-10-08;48715;91802;77713;110;84610;51199492;44023403;1663142;2447;1579698
FR;0;2021-10-09;33619;60865;31521;36;33851;51233111;44084268;1694663;2483;1613549
FR;0;2021-10-10;4586;7430;3186;9;3483;51237697;44091698;1697849;2492;1617032
FR;0;2021-10-11;30548;49906;61017;105;64021;51268245;44141604;1758866;2597;1681053
FR;0;2021-10-12;31314;54463;70560;139;75819;51299559;44196067;1829426;2736;1756872
FR;0;2021-10-13;39972;62780;74394;135;79239;51339531;44258847;1903820;2871;1836111
FR;0;2021-10-14;30217;52863;68719;116;73752;51369748;44311710;1972539;2987;1909863
FR;0;2021-10-15;44727;75242;93206;191;102888;51414475;44386952;2065745;3178;2012751
FR;0;2021-10-16;31267;44075;36681;44;39604;51445742;44431027;2102426;3222;2052355
FR;0;2021-10-17;3826;5278;3590;2;3691;51449568;44436305;2106016;3224;2056046
FR;0;2021-10-18;28246;42475;67467;133;71331;51477814;44478780;2173483;3357;2127377
FR;0;2021-10-19;27034;44361;76374;141;81600;51504848;44523141;2249857;3498;2208977
FR;0;2021-10-20;35190;52435;96901;180;101451;51540038;44575576;2346758;3678;2310428
FR;0;2021-10-21;25913;45205;83911;112;89097;51565951;44620781;2430669;3790;2399525
FR;0;2021-10-22;38180;62344;104861;199;112475;51604131;44683125;2535530;3989;2512000
FR;0;2021-10-23;26957;41223;45433;57;48594;51631088;44724348;2580963;4046;2560594
FR;0;2021-10-24;2912;4802;3679;6;3937;51634000;44729150;2584642;4052;2564531
FR;0;2021-10-25;25972;36336;82298;144;86593;51659972;44765486;2666940;4196;2651124
FR;0;2021-10-26;23680;35061;87202;166;92300;51683652;44800547;2754142;4362;2743424
FR;0;2021-10-27;30003;46404;108957;257;114603;51713655;44846951;2863099;4619;2858027
FR;0;2021-10-28;23374;34882;88654;153;94361;51737029;44881833;2951753;4772;2952388
FR;0;2021-10-29;31495;51322;117277;204;125233;51768524;44933155;3069030;4976;3077621
FR;0;2021-10-30;20520;33095;50322;77;53352;51789044;44966250;3119352;5053;3130973
FR;0;2021-10-31;2477;3766;3584;3;3867;51791521;44970016;3122936;5056;3134840
FR;0;2021-11-01;8189;4806;3198;3;3552;51799710;44974822;3126134;5059;3138392
FR;0;2021-11-02;25259;40084;93524;157;99457;51824969;45014906;3219658;5216;3237849
FR;0;2021-11-03;29742;47890;118834;218;125765;51854711;45062796;3338492;5434;3363614
FR;0;2021-11-04;23654;37495;107489;217;114311;51878365;45100291;3445981;5651;3477925
FR;0;2021-11-05;32259;52919;141581;233;151246;51910624;45153210;3587562;5884;3629171
FR;0;2021-11-06;21476;34568;64838;123;68220;51932100;45187778;3652400;6007;3697391
FR;0;2021-11-07;2377;4246;5171;6;5584;51934477;45192024;3657571;6013;3702975
FR;0;2021-11-08;20383;37834;127104;227;134149;51954860;45229858;3784675;6240;3837124
FR;0;2021-11-09;22118;44810;161605;341;172095;51976978;45274668;3946280;6581;4009219
FR;0;2021-11-10;31346;55054;186921;446;198660;52008324;45329722;4133201;7027;4207879
FR;0;2021-11-11;4289;6725;12921;28;13923;52012613;45336447;4146122;7055;4221802
FR;0;2021-11-12;28982;55156;183706;251;197253;52041595;45391603;4329828;7306;4419055
FR;0;2021-11-13;20286;32726;80673;118;86288;52061881;45424329;4410501;7424;4505343
FR;0;2021-11-14;2323;3949;7162;6;7877;52064204;45428278;4417663;7430;4513220
FR;0;2021-11-15;20283;38807;160770;312;171432;52084487;45467085;4578433;7742;4684652
FR;0;2021-11-16;23322;44041;200301;390;214858;52107809;45511126;4778734;8132;4899510
FR;0;2021-11-17;30334;50506;199771;407;212775;52138143;45561632;4978505;8539;5112285
FR;0;2021-11-18;23337;44935;191567;468;205387;52161480;45606567;5170072;9007;5317672
FR;0;2021-11-19;33546;61426;243117;548;262055;52195026;45667993;5413189;9555;5579727
FR;0;2021-11-20;25311;36771;102110;206;109656;52220337;45704764;5515299;9761;5689383
FR;0;2021-11-21;2622;4568;9640;18;10644;52222959;45709332;5524939;9779;5700027
FR;0;2021-11-22;22710;33339;180267;470;194732;52245669;45742671;5705206;10249;5894759
FR;0;2021-11-23;25544;45732;229288;547;247700;52271213;45788403;5934494;10796;6142459
FR;0;2021-11-24;31760;53800;224728;717;243107;52302973;45842203;6159222;11513;6385566
FR;0;2021-11-25;25381;49161;255805;740;277579;52328354;45891364;6415027;12253;6663145
FR;0;2021-11-26;33201;74743;379356;863;414489;52361555;45966107;6794383;13116;7077634
FR;0;2021-11-27;23292;49684;214835;389;236547;52384847;46015791;7009218;13505;7314181
FR;0;2021-11-28;3478;10592;56722;66;63329;52388325;46026383;7065940;13571;7377510
FR;0;2021-11-29;19384;54255;341364;863;371533;52407709;46080638;7407304;14434;7749043
FR;0;2021-11-30;24675;72185;457276;984;500624;52432384;46152823;7864580;15418;8249667
FR;0;2021-12-01;26812;75981;468963;1159;511165;52459196;46228804;8333543;16577;8760832
FR;0;2021-12-02;21959;71789;526974;1279;574686;52481155;46300593;8860517;17856;9335518
FR;0;2021-12-03;25455;92524;596232;1418;650958;52506610;46393117;9456749;19274;9986476
FR;0;2021-12-04;18285;60545;336151;690;369686;52524895;46453662;9792900;19964;10356162
FR;0;2021-12-05;4141;16269;95753;157;107048;52529036;46469931;9888653;20121;10463210
FR;0;2021-12-06;22434;73235;493007;1174;539809;52551470;46543166;10381660;21295;11003019
FR;0;2021-12-07;23299;91792;645229;1769;706129;52574769;46634958;11026889;23064;11709148
FR;0;2021-12-08;25324;92403;591416;1873;647306;52600093;46727361;11618305;24937;12356454
FR;0;2021-12-09;23989;94357;662915;2179;726171;52624082;46821718;12281220;27116;13082625
FR;0;2021-12-10;27623;111134;735908;2074;805973;52651705;46932852;13017128;29190;13888598
FR;0;2021-12-11;20216;76061;435106;986;480314;52671921;47008913;13452234;30176;14368912
FR;0;2021-12-12;5624;23283;142261;262;159223;52677545;47032196;13594495;30438;14528135
FR;0;2021-12-13;21046;91315;587502;1698;649185;52698591;47123511;14181997;32136;15177320
FR;0;2021-12-14;27531;118666;765350;2648;847349;52726122;47242177;14947347;34784;16024669
FR;0;2021-12-15;28178;114533;694158;2262;768894;52754300;47356710;15641505;37046;16793563
FR;0;2021-12-16;27923;116097;763845;2555;844252;52782223;47472807;16405350;39601;17637815
FR;0;2021-12-17;31529;128822;807709;2707;891975;52813752;47601629;17213059;42308;18529790
FR;0;2021-12-18;24913;81727;469898;1178;522141;52838665;47683356;17682957;43486;19051931
FR;0;2021-12-19;8740;28846;169347;378;191143;52847405;47712202;17852304;43864;19243074
FR;0;2021-12-20;31585;97553;591308;1787;658583;52878990;47809755;18443612;45651;19901657
FR;0;2021-12-21;39209;112383;682279;2391;759446;52918199;47922138;19125891;48042;20661103
FR;0;2021-12-22;39455;99674;575633;2167;642024;52957654;48021812;19701524;50209;21303127
FR;0;2021-12-23;33734;79759;440875;1653;494317;52991388;48101571;20142399;51862;21797444
FR;0;2021-12-24;10663;26052;110969;396;126629;53002051;48127623;20253368;52258;21924073
FR;0;2021-12-25;767;3500;7570;25;9030;53002818;48131123;20260938;52283;21933103
FR;0;2021-12-26;4696;11915;52072;141;60129;53007514;48143038;20313010;52424;21993232
FR;0;2021-12-27;30323;84116;453433;1366;509080;53037837;48227154;20766443;53790;22502312
FR;0;2021-12-28;38300;99068;564059;1767;632146;53076137;48326222;21330502;55557;23134458
FR;0;2021-12-29;39840;88466;501102;1686;560919;53115977;48414688;21831604;57243;23695377
FR;0;2021-12-30;35882;75038;420940;1519;471079;53151859;48489726;22252544;58762;24166456
FR;0;2021-12-31;12033;25209;116831;406;131619;53163892;48514935;22369375;59168;24298075
FR;0;2022-01-01;1303;3200;8496;36;9927;53165195;48518135;22377871;59204;24308002
FR;0;2022-01-02;6073;13009;58388;125;66929;53171268;48531144;22436259;59329;24374931
FR;0;2022-01-03;32508;89820;494669;1594;551467;53203776;48620964;22930928;60923;24926398
FR;0;2022-01-04;40819;110879;641253;2302;714196;53244595;48731843;23572181;63225;25640594
FR;0;2022-01-05;60293;103281;569032;1984;634043;53304888;48835124;24141213;65209;26274637
FR;0;2022-01-06;43912;110171;638869;2693;711310;53348800;48945295;24780082;67902;26985947
FR;0;2022-01-07;50537;123076;710894;2806;790322;53399337;49068371;25490976;70708;27776269
FR;0;2022-01-08;44950;80328;423770;1210;472839;53444287;49148699;25914746;71918;28249108
FR;0;2022-01-09;15597;26717;128539;300;145697;53459884;49175416;26043285;72218;28394805
FR;0;2022-01-10;34971;88108;469178;1810;522135;53494855;49263524;26512463;74028;28916940
FR;0;2022-01-11;41629;100088;548122;2307;608382;53536484;49363612;27060585;76335;29525322
FR;0;2022-01-12;60123;95509;452547;1964;504221;53596607;49459121;27513132;78299;30029543
FR;0;2022-01-13;37876;92274;487225;2083;540915;53634483;49551395;28000357;80382;30570458
FR;0;2022-01-14;42372;103269;568479;2285;628953;53676855;49654664;28568836;82667;31199411
FR;0;2022-01-15;39300;65809;340077;981;377533;53716155;49720473;28908913;83648;31576944
FR;0;2022-01-16;11381;19304;87380;215;99450;53727536;49739777;28996293;83863;31676394
FR;0;2022-01-17;24589;60088;320200;1380;354137;53752125;49799865;29316493;85243;32030531
FR;0;2022-01-18;28100;68460;360991;1799;397497;53780225;49868325;29677484;87042;32428028
FR;0;2022-01-19;43031;67037;281199;1448;311037;53823256;49935362;29958683;88490;32739065
FR;0;2022-01-20;23400;59421;298885;1740;328391;53846656;49994783;30257568;90230;33067456
FR;0;2022-01-21;27984;68762;366269;2084;401111;53874640;50063545;30623837;92314;33468567
FR;0;2022-01-22;27605;47846;218754;838;241742;53902245;50111391;30842591;93152;33710309
FR;0;2022-01-23;6701;13045;48644;171;55183;53908946;50124436;30891235;93323;33765492
FR;0;2022-01-24;16193;47153;217239;1136;239317;53925139;50171589;31108474;94459;34004809
FR;0;2022-01-25;18897;54142;242969;1547;267026;53944036;50225731;31351443;96006;34271835
FR;0;2022-01-26;28103;60122;209205;1296;229336;53972139;50285853;31560648;97302;34501171
FR;0;2022-01-27;16270;45845;207552;1270;225793;53988409;50331698;31768200;98572;34726964
FR;0;2022-01-28;21498;75723;289970;1573;321455;54009907;50407421;32058170;100145;35048419
FR;0;2022-01-29;18401;52835;184077;686;204565;54028308;50460256;32242247;100831;35252984
FR;0;2022-01-30;4466;14554;39125;124;45092;54032774;50474810;32281372;100955;35298076
FR;0;2022-01-31;11219;43833;148142;738;164780;54043993;50518643;32429514;101693;35462856
FR;0;2022-02-01;12790;48112;174051;1140;191354;54056783;50566755;32603565;102833;35654210
FR;0;2022-02-02;19957;65864;171449;1033;190116;54076740;50632619;32775014;103866;35844326
FR;0;2022-02-03;10935;44127;157480;984;173289;54087675;50676746;32932494;104850;36017615
FR;0;2022-02-04;14472;66424;239167;1262;264163;54102147;50743170;33171661;106112;36281778
FR;0;2022-02-05;12770;51451;153506;522;172332;54114917;50794621;33325167;106634;36454110
FR;0;2022-02-06;2706;12247;28869;99;33828;54117623;50806868;33354036;106733;36487938
FR;0;2022-02-07;9280;46646;156808;585;176313;54126903;50853514;33510844;107318;36664251
FR;0;2022-02-08;9586;42629;166551;867;184318;54136489;50896143;33677395;108185;36848569
FR;0;2022-02-09;14147;57766;172282;864;192950;54150636;50953909;33849677;109049;37041519
FR;0;2022-02-10;8253;38303;150144;876;166567;54158889;50992212;33999821;109925;37208086
FR;0;2022-02-11;10732;55425;218429;1097;242994;54169621;51047637;34218250;111022;37451080
FR;0;2022-02-12;8342;40869;134689;461;151702;54177963;51088506;34352939;111483;37602782
FR;0;2022-02-13;1892;8574;26547;82;30902;54179855;51097080;34379486;111565;37633684
FR;0;2022-02-14;6887;35083;148309;477;166299;54186742;51132163;34527795;112042;37799983
FR;0;2022-02-15;6850;35410;146890;750;162426;54193592;51167573;34674685;112792;37962409
FR;0;2022-02-16;9281;42545;132466;716;146639;54202873;51210118;34807151;113508;38109048
FR;0;2022-02-17;5363;23666;87239;584;94750;54208236;51233784;34894390;114092;38203798
FR;0;2022-02-18;6873;33210;119584;802;129234;54215109;51266994;35013974;114894;38333032
FR;0;2022-02-19;5340;24438;69999;370;77297;54220449;51291432;35083973;115264;38410329
FR;0;2022-02-20;1135;4616;12150;38;13922;54221584;51296048;35096123;115302;38424251
FR;0;2022-02-21;4018;17754;61910;351;67133;54225602;51313802;35158033;115653;38491384
FR;0;2022-02-22;4362;18461;60780;575;64404;54229964;51332263;35218813;116228;38555788
FR;0;2022-02-23;6507;27118;66456;591;71852;54236471;51359381;35285269;116819;38627640
FR;0;2022-02-24;3743;15136;50363;518;53171;54240214;51374517;35335632;117337;38680811
FR;0;2022-02-25;5194;23531;76268;803;79990;54245408;51398048;35411900;118140;38760801
FR;0;2022-02-26;3969;17627;47386;357;51450;54249377;51415675;35459286;118497;38812251
FR;0;2022-02-27;867;2984;8020;47;8931;54250244;51418659;35467306;118544;38821182
FR;0;2022-02-28;3065;12110;40436;353;42867;54253309;51430769;35507742;118897;38864049
FR;0;2022-03-01;3108;12201;44121;433;44756;54256417;51442970;35551863;119330;38908805
FR;0;2022-03-02;5067;17436;47075;436;48980;54261484;51460406;35598938;119766;38957785
FR;0;2022-03-03;2644;8858;29825;361;29918;54264128;51469264;35628763;120127;38987703
FR;0;2022-03-04;3175;12160;40251;649;39382;54267303;51481424;35669014;120776;39027085
FR;0;2022-03-05;2914;9207;24921;309;25071;54270217;51490631;35693935;121085;39052156
FR;0;2022-03-06;508;1377;3192;42;3429;54270725;51492008;35697127;121127;39055585
FR;0;2022-03-07;1929;5455;18391;313;17647;54272654;51497463;35715518;121440;39073232
FR;0;2022-03-08;1961;5875;19398;359;17856;54274615;51503338;35734916;121799;39091088
FR;0;2022-03-09;3445;10242;22140;403;21219;54278060;51513580;35757056;122202;39112307
FR;0;2022-03-10;1705;5145;16881;339;15670;54279765;51518725;35773937;122541;39127977
FR;0;2022-03-11;2340;7278;24457;538;22216;54282105;51526003;35798394;123079;39150193
FR;0;2022-03-12;2654;6709;17148;304;16497;54284759;51532712;35815542;123383;39166690
FR;0;2022-03-13;385;778;2302;144;2251;54285144;51533490;35817844;123527;39168941
FR;0;2022-03-14;1455;4119;14926;4403;13782;54286599;51537609;35832770;127930;39182723
FR;0;2022-03-15;1591;4343;16226;7549;14329;54288190;51541952;35848996;135479;39197052
FR;0;2022-03-16;2939;7011;19340;13128;17998;54291129;51548963;35868336;148607;39215050
FR;0;2022-03-17;1366;3679;13087;10835;11926;54292495;51552642;35881423;159442;39226976
FR;0;2022-03-18;2193;5495;19929;18273;18013;54294688;51558137;35901352;177715;39244989
FR;0;2022-03-19;2274;4666;13101;9395;12399;54296962;51562803;35914453;187110;39257388
FR;0;2022-03-20;291;705;1906;1065;1914;54297253;51563508;35916359;188175;39259302
FR;0;2022-03-21;1337;3119;12677;14927;11897;54298590;51566627;35929036;203102;39271199
FR;0;2022-03-22;1455;3563;13750;20516;12505;54300045;51570190;35942786;223618;39283704
FR;0;2022-03-23;2631;6056;17625;23129;17131;54302676;51576246;35960411;246747;39300835
FR;0;2022-03-24;1352;2907;11529;17569;10601;54304028;51579153;35971940;264316;39311436
FR;0;2022-03-25;2038;4797;18461;27736;16805;54306066;51583950;35990401;292052;39328241
FR;0;2022-03-26;2214;4233;12055;12651;11494;54308280;51588183;36002456;304703;39339735
FR;0;2022-03-27;352;680;1873;1474;1907;54308632;51588863;36004329;306177;39341642
FR;0;2022-03-28;1409;2909;11042;17449;10529;54310041;51591772;36015371;323626;39352171
FR;0;2022-03-29;1419;3219;12843;27528;11985;54311460;51594991;36028214;351154;39364156
FR;0;2022-03-30;2804;5356;15590;27343;14981;54314264;51600347;36043804;378497;39379137
FR;0;2022-03-31;1584;3126;12802;24847;12133;54315848;51603473;36056606;403344;39391270
FR;0;2022-04-01;2070;4256;19962;30799;18579;54317918;51607729;36076568;434143;39409849
FR;0;2022-04-02;1487;2603;9013;10096;8671;54319405;51610332;36085581;444239;39418520
FR;0;2022-04-03;270;495;1555;1168;1570;54319675;51610827;36087136;445407;39420090
FR;0;2022-04-04;1302;2508;12088;19029;11270;54320977;51613335;36099224;464436;39431360
FR;0;2022-04-05;1574;2903;14206;33964;13051;54322551;51616238;36113430;498400;39444411
FR;0;2022-04-06;2020;3603;13376;26270;12614;54324571;51619841;36126806;524670;39457025
FR;0;2022-04-07;1414;2835;13552;33497;12753;54325985;51622676;36140358;558167;39469778
FR;0;2022-04-08;2004;4055;19090;43536;17702;54327989;51626731;36159448;601703;39487480
FR;0;2022-04-09;1340;2646;9281;13533;8831;54329329;51629377;36168729;615236;39496311
FR;0;2022-04-10;269;547;1963;1991;1968;54329598;51629924;36170692;617227;39498279
FR;0;2022-04-11;1170;2437;11791;23621;11393;54330768;51632361;36182483;640848;39509672
FR;0;2022-04-12;1554;2755;13850;40416;13211;54332322;51635116;36196333;681264;39522883
FR;0;2022-04-13;1830;3387;13220;32647;12826;54334152;51638503;36209553;713911;39535709
FR;0;2022-04-14;1422;2642;13007;35855;12823;54335574;51641145;36222560;749766;39548532
FR;0;2022-04-15;1755;3254;15442;35136;14689;54337329;51644399;36238002;784902;39563221
FR;0;2022-04-16;1023;1809;6347;8508;6201;54338352;51646208;36244349;793410;39569422
FR;0;2022-04-17;182;315;988;1152;1026;54338534;51646523;36245337;794562;39570448
FR;0;2022-04-18;142;421;2715;1032;2730;54338676;51646944;36248052;795594;39573178
FR;0;2022-04-19;1455;2882;12784;29210;12247;54340131;51649826;36260836;824804;39585425
FR;0;2022-04-20;1877;3311;13095;28577;12759;54342008;51653137;36273931;853381;39598184
FR;0;2022-04-21;1463;2699;12364;34516;12393;54343471;51655836;36286295;887897;39610577
FR;0;2022-04-22;1799;3447;16346;37253;15704;54345270;51659283;36302641;925150;39626281
FR;0;2022-04-23;1101;2026;7342;10619;7190;54346371;51661309;36309983;935769;39633471
FR;0;2022-04-24;232;437;1461;1571;1395;54346603;51661746;36311444;937340;39634866
FR;0;2022-04-25;1229;2407;10555;20771;10361;54347832;51664153;36321999;958111;39645227
FR;0;2022-04-26;1539;2928;13524;38004;12956;54349371;51667081;36335523;996115;39658183
FR;0;2022-04-27;1875;2992;11378;30287;11400;54351246;51670073;36346901;1026402;39669583
FR;0;2022-04-28;1499;2605;12318;35457;12012;54352745;51672678;36359219;1061859;39681595
FR;0;2022-04-29;1922;3387;15250;36651;14590;54354667;51676065;36374469;1098510;39696185
FR;0;2022-04-30;1171;1783;6722;9609;6537;54355838;51677848;36381191;1108119;39702722
FR;0;2022-05-01;165;290;852;951;857;54356003;51678138;36382043;1109070;39703579
FR;0;2022-05-02;1118;2026;10033;17646;9835;54357121;51680164;36392076;1126716;39713414
FR;0;2022-05-03;1698;2827;12928;33883;12789;54358819;51682991;36405004;1160599;39726203
FR;0;2022-05-04;1773;2851;10768;24904;10870;54360592;51685842;36415772;1185503;39737073
FR;0;2022-05-05;1569;2541;11526;32514;11231;54362161;51688383;36427298;1218017;39748304
FR;0;2022-05-06;2011;3437;14634;36164;14128;54364172;51691820;36441932;1254181;39762432
FR;0;2022-05-07;1151;1714;6072;9521;6073;54365323;51693534;36448004;1263702;39768505
FR;0;2022-05-08;247;352;1021;1502;1081;54365570;51693886;36449025;1265204;39769586
FR;0;2022-05-09;1199;1997;8483;19569;8350;54366769;51695883;36457508;1284773;39777936
FR;0;2022-05-10;1585;2739;11991;37782;11620;54368354;51698622;36469499;1322555;39789556
FR;0;2022-05-11;1885;2592;9651;26876;9551;54370239;51701214;36479150;1349431;39799107
FR;0;2022-05-12;1464;2398;10489;34351;10087;54371703;51703612;36489639;1383782;39809194
FR;0;2022-05-13;1878;2971;12789;36636;12383;54373581;51706583;36502428;1420418;39821577
FR;0;2022-05-14;1094;1519;5378;10523;5242;54374675;51708102;36507806;1430941;39826819
FR;0;2022-05-15;253;378;1088;1379;1178;54374928;51708480;36508894;1432320;39827997
FR;0;2022-05-16;1087;1747;7089;19684;7090;54376015;51710227;36515983;1452004;39835087
FR;0;2022-05-17;1452;2324;10099;35479;9731;54377467;51712551;36526082;1487483;39844818
FR;0;2022-05-18;1623;2308;8076;24598;7983;54379090;51714859;36534158;1512081;39852801
