fra;vaccin;jour;n_dose1;n_dose2;n_cum_dose1;n_cum_dose2
FR;1;2020-12-27;20;0;20;0
FR;1;2020-12-28;69;0;89;0
FR;1;2020-12-29;108;0;197;0
FR;1;2020-12-30;120;0;317;0
FR;1;2020-12-31;85;0;402;0
FR;1;2021-01-01;67;0;469;0
FR;1;2021-01-02;79;0;548;0
FR;1;2021-01-03;89;0;637;0
FR;1;2021-01-04;1472;0;2109;0
FR;1;2021-01-05;5387;0;7496;0
FR;1;2021-01-06;11291;0;18787;0
FR;1;2021-01-07;28548;0;47335;0
FR;1;2021-01-08;36172;0;83507;0
FR;1;2021-01-09;10904;0;94411;0
FR;1;2021-01-10;5615;0;100026;0
FR;1;2021-01-11;38939;0;138965;0
FR;1;2021-01-12;60789;0;199754;0
FR;1;2021-01-13;63704;0;263458;0
FR;1;2021-01-14;79667;0;343125;0
FR;1;2021-01-15;67189;0;410314;0
FR;1;2021-01-16;19509;78;429823;78
FR;1;2021-01-17;10462;42;440285;120
FR;1;2021-01-18;81406;163;521691;283
FR;1;2021-01-19;123887;127;645578;410
FR;1;2021-01-20;130098;159;775676;569
FR;1;2021-01-21;150059;135;925735;704
FR;1;2021-01-22;113600;162;1039335;866
FR;1;2021-01-23;36037;50;1075372;916
FR;1;2021-01-24;9258;27;1084630;943
FR;1;2021-01-25;73124;1218;1157754;2161
FR;1;2021-01-26;95010;3110;1252764;5271
FR;1;2021-01-27;102147;5600;1354911;10871
FR;1;2021-01-28;118759;14361;1473670;25232
FR;1;2021-01-29;87757;17294;1561427;42526
FR;1;2021-01-30;27572;4225;1588999;46751
FR;1;2021-01-31;4866;1681;1593865;48432
FR;1;2021-02-01;48267;21134;1642132;69566
FR;1;2021-02-02;66302;34586;1708434;104152
FR;1;2021-02-03;65892;36984;1774326;141136
FR;1;2021-02-04;75741;50079;1850067;191215
FR;1;2021-02-05;62432;45342;1912499;236557
FR;1;2021-02-06;19043;10398;1931542;246955
FR;1;2021-02-07;3434;5046;1934976;252001
FR;1;2021-02-08;35767;45989;1970743;297990
FR;1;2021-02-09;49819;72406;2020562;370396
FR;1;2021-02-10;50860;76662;2071422;447058
FR;1;2021-02-11;62142;99107;2133564;546165
FR;1;2021-02-12;54824;74060;2188388;620225
FR;1;2021-02-13;15132;19274;2203520;639499
FR;1;2021-02-14;3420;7193;2206940;646692
FR;1;2021-02-15;23571;73445;2230511;720137
FR;1;2021-02-16;32113;96887;2262624;817024
FR;1;2021-02-17;34372;98586;2296996;915610
FR;1;2021-02-18;48069;113505;2345065;1029115
FR;1;2021-02-19;44410;86437;2389475;1115552
FR;1;2021-02-20;13020;26923;2402495;1142475
FR;1;2021-02-21;2116;6290;2404611;1148765
FR;1;2021-02-22;24027;69418;2428638;1218183
FR;1;2021-02-23;36655;80454;2465293;1298637
FR;1;2021-02-24;39352;77670;2504645;1376307
FR;1;2021-02-25;48887;88001;2553532;1464308
FR;1;2021-02-26;46076;67893;2599608;1532201
FR;1;2021-02-27;15174;20929;2614782;1553130
FR;1;2021-02-28;3229;4386;2618011;1557516
FR;1;2021-03-01;38697;49040;2656708;1606556
FR;1;2021-03-02;54666;61542;2711374;1668098
FR;1;2021-03-03;59451;60660;2770825;1728758
FR;1;2021-03-04;71061;64908;2841886;1793666
FR;1;2021-03-05;73097;59281;2914983;1852947
FR;1;2021-03-06;81318;16093;2996301;1869040
FR;1;2021-03-07;62965;5422;3059266;1874462
FR;1;2021-03-08;58685;42482;3117951;1916944
FR;1;2021-03-09;84358;48323;3202309;1965267
FR;1;2021-03-10;88933;48067;3291242;2013334
FR;1;2021-03-11;103168;53882;3394410;2067216
FR;1;2021-03-12;102104;45279;3496514;2112495
FR;1;2021-03-13;87498;12729;3584012;2125224
FR;1;2021-03-14;43630;3031;3627642;2128255
FR;1;2021-03-15;93734;29168;3721376;2157423
FR;1;2021-03-16;121829;34919;3843205;2192342
FR;1;2021-03-17;127349;34884;3970554;2227226
FR;1;2021-03-18;140721;39755;4111275;2266981
FR;1;2021-03-19;134126;32918;4245401;2299899
FR;1;2021-03-20;74890;10212;4320291;2310111
FR;1;2021-03-21;25768;2477;4346059;2312588
FR;1;2021-03-22;112844;31190;4458903;2343778
FR;1;2021-03-23;140728;38180;4599631;2381958
FR;1;2021-03-24;139790;38793;4739421;2420751
FR;1;2021-03-25;162585;39634;4902006;2460385
FR;1;2021-03-26;164049;37504;5066055;2497889
FR;1;2021-03-27;109798;15261;5175853;2513150
FR;1;2021-03-28;41718;3624;5217571;2516774
FR;1;2021-03-29;128218;49979;5345789;2566753
FR;1;2021-03-30;165417;63597;5511206;2630350
FR;1;2021-03-31;168591;66913;5679797;2697263
FR;1;2021-04-01;190881;79261;5870678;2776524
FR;1;2021-04-02;162117;84326;6032795;2860850
FR;1;2021-04-03;87084;58188;6119879;2919038
FR;1;2021-04-04;32299;17732;6152178;2936770
FR;1;2021-04-05;42397;10177;6194575;2946947
FR;1;2021-04-06;157136;100908;6351711;3047855
FR;1;2021-04-07;193807;108274;6545518;3156129
FR;1;2021-04-08;218283;112414;6763801;3268543
FR;1;2021-04-09;211003;107554;6974804;3376097
FR;1;2021-04-10;116055;73467;7090859;3449564
FR;1;2021-04-11;40119;30292;7130978;3479856
FR;1;2021-04-12;166182;103804;7297160;3583660
FR;1;2021-04-13;200629;128287;7497789;3711947
FR;1;2021-04-14;204932;122822;7702721;3834769
FR;1;2021-04-15;217666;126780;7920387;3961549
FR;1;2021-04-16;202940;125163;8123327;4086712
FR;1;2021-04-17;120649;67486;8243976;4154198
FR;1;2021-04-18;35190;20993;8279166;4175191
FR;1;2021-04-19;161327;121986;8440493;4297177
FR;1;2021-04-20;186207;148832;8626700;4446009
FR;1;2021-04-21;190692;146790;8817392;4592799
FR;1;2021-04-22;204991;162689;9022383;4755488
FR;1;2021-04-23;195102;157067;9217485;4912555
FR;1;2021-04-24;124241;95512;9341726;5008067
FR;1;2021-04-25;52453;30135;9394179;5038202
FR;1;2021-04-26;176715;138304;9570894;5176506
FR;1;2021-04-27;217583;162021;9788477;5338527
FR;1;2021-04-28;234409;155200;10022886;5493727
FR;1;2021-04-29;265750;160168;10288636;5653895
FR;1;2021-04-30;267658;148239;10556294;5802134
FR;1;2021-05-01;137255;40718;10693549;5842852
FR;1;2021-05-02;79886;28165;10773435;5871017
FR;1;2021-05-03;244949;146612;11018384;6017629
FR;1;2021-05-04;259464;186895;11277848;6204524
FR;1;2021-05-05;275951;184721;11553799;6389245
FR;1;2021-05-06;303021;183234;11856820;6572479
FR;1;2021-05-07;278513;196130;12135333;6768609
FR;1;2021-05-08;179496;48505;12314829;6817114
FR;1;2021-05-09;112274;36237;12427103;6853351
FR;1;2021-05-10;249130;194468;12676233;7047819
FR;1;2021-05-11;312159;211548;12988392;7259367
FR;1;2021-05-12;345720;186152;13334112;7445519
FR;1;2021-05-13;277117;47716;13611229;7493235
FR;1;2021-05-14;360378;128998;13971607;7622233
FR;1;2021-05-15;287233;66177;14258840;7688410
FR;1;2021-05-16;155192;15590;14414032;7704000
FR;1;2021-05-17;311032;116798;14725064;7820798
FR;1;2021-05-18;370148;111531;15095212;7932329
FR;1;2021-05-19;384802;103248;15480014;8035577
FR;1;2021-05-20;410127;96629;15890141;8132206
FR;1;2021-05-21;388503;97676;16278644;8229882
FR;1;2021-05-22;270108;42193;16548752;8272075
FR;1;2021-05-23;120549;11250;16669301;8283325
FR;1;2021-05-24;238164;26398;16907465;8309723
FR;1;2021-05-25;356613;132444;17264078;8442167
FR;1;2021-05-26;364917;128986;17628995;8571153
FR;1;2021-05-27;395128;121212;18024123;8692365
FR;1;2021-05-28;355869;145714;18379992;8838079
FR;1;2021-05-29;249553;81076;18629545;8919155
FR;1;2021-05-30;98552;22616;18728097;8941771
FR;1;2021-05-31;306548;148959;19034645;9090730
FR;1;2021-06-01;340309;166965;19374954;9257695
FR;2;2020-12-27;0;0;0;0
FR;2;2020-12-28;0;0;0;0
FR;2;2020-12-29;0;0;0;0
FR;2;2020-12-30;0;0;0;0
FR;2;2020-12-31;0;0;0;0
FR;2;2021-01-01;0;0;0;0
FR;2;2021-01-02;0;0;0;0
FR;2;2021-01-03;0;0;0;0
FR;2;2021-01-04;0;0;0;0
FR;2;2021-01-05;0;0;0;0
FR;2;2021-01-06;0;0;0;0
FR;2;2021-01-07;0;0;0;0
FR;2;2021-01-08;0;0;0;0
FR;2;2021-01-09;0;0;0;0
FR;2;2021-01-10;0;0;0;0
FR;2;2021-01-11;0;0;0;0
FR;2;2021-01-12;0;0;0;0
FR;2;2021-01-13;0;0;0;0
FR;2;2021-01-14;144;0;144;0
FR;2;2021-01-15;217;0;361;0
FR;2;2021-01-16;185;0;546;0
FR;2;2021-01-17;3;0;549;0
FR;2;2021-01-18;2906;0;3455;0
FR;2;2021-01-19;4508;0;7963;0
FR;2;2021-01-20;4921;0;12884;0
FR;2;2021-01-21;5122;0;18006;0
FR;2;2021-01-22;4877;0;22883;0
FR;2;2021-01-23;1735;0;24618;0
FR;2;2021-01-24;102;0;24720;0
FR;2;2021-01-25;3634;0;28354;0
FR;2;2021-01-26;3747;0;32101;0
FR;2;2021-01-27;3440;0;35541;0
FR;2;2021-01-28;3510;0;39051;0
FR;2;2021-01-29;3082;0;42133;0
FR;2;2021-01-30;1065;0;43198;0
FR;2;2021-01-31;0;0;43198;0
FR;2;2021-02-01;3255;0;46453;0
FR;2;2021-02-02;4303;0;50756;0
FR;2;2021-02-03;5030;0;55786;0
FR;2;2021-02-04;4730;3;60516;3
FR;2;2021-02-05;4610;6;65126;9
FR;2;2021-02-06;1930;3;67056;12
FR;2;2021-02-07;42;0;67098;12
FR;2;2021-02-08;7417;8;74515;20
FR;2;2021-02-09;8254;15;82769;35
FR;2;2021-02-10;9136;49;91905;84
FR;2;2021-02-11;10052;67;101957;151
FR;2;2021-02-12;9801;238;111758;389
FR;2;2021-02-13;3015;222;114773;611
FR;2;2021-02-14;296;0;115069;611
FR;2;2021-02-15;3357;3067;118426;3678
FR;2;2021-02-16;4899;3881;123325;7559
FR;2;2021-02-17;4101;4403;127426;11962
FR;2;2021-02-18;5229;5107;132655;17069
FR;2;2021-02-19;5156;4329;137811;21398
FR;2;2021-02-20;1763;1509;139574;22907
FR;2;2021-02-21;197;87;139771;22994
FR;2;2021-02-22;3514;3725;143285;26719
FR;2;2021-02-23;4836;3694;148121;30413
FR;2;2021-02-24;4745;3483;152866;33896
FR;2;2021-02-25;5292;3427;158158;37323
FR;2;2021-02-26;4193;3149;162351;40472
FR;2;2021-02-27;1502;1042;163853;41514
FR;2;2021-02-28;99;28;163952;41542
FR;2;2021-03-01;4957;3764;168909;45306
FR;2;2021-03-02;6302;4728;175211;50034
FR;2;2021-03-03;6241;4883;181452;54917
FR;2;2021-03-04;8070;3967;189522;58884
FR;2;2021-03-05;7767;4059;197289;62943
FR;2;2021-03-06;4620;1682;201909;64625
FR;2;2021-03-07;2284;29;204193;64654
FR;2;2021-03-08;3979;8309;208172;72963
FR;2;2021-03-09;7263;8430;215435;81393
FR;2;2021-03-10;6854;9113;222289;90506
FR;2;2021-03-11;9051;9209;231340;99715
FR;2;2021-03-12;7715;8174;239055;107889
FR;2;2021-03-13;9867;2510;248922;110399
FR;2;2021-03-14;4753;402;253675;110801
FR;2;2021-03-15;10633;3484;264308;114285
FR;2;2021-03-16;16439;4621;280747;118906
FR;2;2021-03-17;19908;3952;300655;122858
FR;2;2021-03-18;22944;4911;323599;127769
FR;2;2021-03-19;22882;4538;346481;132307
FR;2;2021-03-20;25141;1540;371622;133847
FR;2;2021-03-21;17470;147;389092;133994
FR;2;2021-03-22;17383;3080;406475;137074
FR;2;2021-03-23;22264;4183;428739;141257
FR;2;2021-03-24;23541;4989;452280;146246
FR;2;2021-03-25;26264;5020;478544;151266
FR;2;2021-03-26;26581;4260;505125;155526
FR;2;2021-03-27;15637;1309;520762;156835
FR;2;2021-03-28;10391;94;531153;156929
FR;2;2021-03-29;18630;4280;549783;161209
FR;2;2021-03-30;24163;6002;573946;167211
FR;2;2021-03-31;28089;5957;602035;173168
FR;2;2021-04-01;33927;8496;635962;181664
FR;2;2021-04-02;29427;7663;665389;189327
FR;2;2021-04-03;16724;3582;682113;192909
FR;2;2021-04-04;9156;918;691269;193827
FR;2;2021-04-05;12115;811;703384;194638
FR;2;2021-04-06;26670;6935;730054;201573
FR;2;2021-04-07;30579;7174;760633;208747
FR;2;2021-04-08;36480;8818;797113;217565
FR;2;2021-04-09;33349;8601;830462;226166
FR;2;2021-04-10;19437;8969;849899;235135
FR;2;2021-04-11;7813;4271;857712;239406
FR;2;2021-04-12;16790;11254;874502;250660
FR;2;2021-04-13;19062;16426;893564;267086
FR;2;2021-04-14;17646;16285;911210;283371
FR;2;2021-04-15;21821;20791;933031;304162
FR;2;2021-04-16;20345;20077;953376;324239
FR;2;2021-04-17;13039;22463;966415;346702
FR;2;2021-04-18;5781;14405;972196;361107
FR;2;2021-04-19;16464;16265;988660;377372
FR;2;2021-04-20;18959;21597;1007619;398969
FR;2;2021-04-21;19648;21667;1027267;420636
FR;2;2021-04-22;23293;24866;1050560;445502
FR;2;2021-04-23;24108;25375;1074668;470877
FR;2;2021-04-24;25017;15115;1099685;485992
FR;2;2021-04-25;9415;8590;1109100;494582
FR;2;2021-04-26;16665;17202;1125765;511784
FR;2;2021-04-27;18930;24311;1144695;536095
FR;2;2021-04-28;21532;26209;1166227;562304
FR;2;2021-04-29;24902;30139;1191129;592443
FR;2;2021-04-30;25082;27783;1216211;620226
FR;2;2021-05-01;14756;9863;1230967;630089
FR;2;2021-05-02;6480;9184;1237447;639273
FR;2;2021-05-03;19140;19328;1256587;658601
FR;2;2021-05-04;17906;29056;1274493;687657
FR;2;2021-05-05;17897;29416;1292390;717073
FR;2;2021-05-06;23110;35298;1315500;752371
FR;2;2021-05-07;23737;33255;1339237;785626
FR;2;2021-05-08;19918;9715;1359155;795341
FR;2;2021-05-09;12899;7894;1372054;803235
FR;2;2021-05-10;32182;22235;1404236;825470
FR;2;2021-05-11;42396;21079;1446632;846549
FR;2;2021-05-12;47757;19908;1494389;866457
FR;2;2021-05-13;50451;5772;1544840;872229
FR;2;2021-05-14;60418;12959;1605258;885188
FR;2;2021-05-15;65188;7154;1670446;892342
FR;2;2021-05-16;42936;2575;1713382;894917
FR;2;2021-05-17;44049;12599;1757431;907516
FR;2;2021-05-18;52735;12279;1810166;919795
FR;2;2021-05-19;55348;10653;1865514;930448
FR;2;2021-05-20;62392;10917;1927906;941365
FR;2;2021-05-21;62189;11732;1990095;953097
FR;2;2021-05-22;60713;4528;2050808;957625
FR;2;2021-05-23;36907;577;2087715;958202
FR;2;2021-05-24;16815;2033;2104530;960235
FR;2;2021-05-25;20415;12318;2124945;972553
FR;2;2021-05-26;18334;11709;2143279;984262
FR;2;2021-05-27;22333;11966;2165612;996228
FR;2;2021-05-28;28084;14987;2193696;1011215
FR;2;2021-05-29;29630;8188;2223326;1019403
FR;2;2021-05-30;4414;1810;2227740;1021213
FR;2;2021-05-31;27382;18760;2255122;1039973
FR;2;2021-06-01;42951;20075;2298073;1060048
FR;3;2020-12-27;0;0;0;0
FR;3;2020-12-28;0;0;0;0
FR;3;2020-12-29;0;0;0;0
FR;3;2020-12-30;0;0;0;0
FR;3;2020-12-31;0;0;0;0
FR;3;2021-01-01;0;0;0;0
FR;3;2021-01-02;0;0;0;0
FR;3;2021-01-03;0;0;0;0
FR;3;2021-01-04;0;0;0;0
FR;3;2021-01-05;0;0;0;0
FR;3;2021-01-06;0;0;0;0
FR;3;2021-01-07;0;0;0;0
FR;3;2021-01-08;0;0;0;0
FR;3;2021-01-09;0;0;0;0
FR;3;2021-01-10;0;0;0;0
FR;3;2021-01-11;0;0;0;0
FR;3;2021-01-12;0;0;0;0
FR;3;2021-01-13;0;0;0;0
FR;3;2021-01-14;0;0;0;0
FR;3;2021-01-15;0;0;0;0
FR;3;2021-01-16;0;0;0;0
FR;3;2021-01-17;0;0;0;0
FR;3;2021-01-18;0;0;0;0
FR;3;2021-01-19;0;0;0;0
FR;3;2021-01-20;0;0;0;0
FR;3;2021-01-21;0;0;0;0
FR;3;2021-01-22;0;0;0;0
FR;3;2021-01-23;0;0;0;0
FR;3;2021-01-24;0;0;0;0
FR;3;2021-01-25;0;0;0;0
FR;3;2021-01-26;0;0;0;0
FR;3;2021-01-27;0;0;0;0
FR;3;2021-01-28;0;0;0;0
FR;3;2021-01-29;0;0;0;0
FR;3;2021-01-30;0;0;0;0
FR;3;2021-01-31;0;0;0;0
FR;3;2021-02-01;0;0;0;0
FR;3;2021-02-02;0;0;0;0
FR;3;2021-02-03;0;0;0;0
FR;3;2021-02-04;0;0;0;0
FR;3;2021-02-05;0;0;0;0
FR;3;2021-02-06;313;0;313;0
FR;3;2021-02-07;1348;0;1661;0
FR;3;2021-02-08;2631;0;4292;0
FR;3;2021-02-09;6632;0;10924;0
FR;3;2021-02-10;9215;0;20139;0
FR;3;2021-02-11;13330;0;33469;0
FR;3;2021-02-12;13028;0;46497;0
FR;3;2021-02-13;3502;0;49999;0
FR;3;2021-02-14;864;0;50863;0
FR;3;2021-02-15;10104;0;60967;0
FR;3;2021-02-16;12160;0;73127;0
FR;3;2021-02-17;10811;0;83938;0
FR;3;2021-02-18;14532;0;98470;0
FR;3;2021-02-19;14078;0;112548;0
FR;3;2021-02-20;3173;0;115721;0
FR;3;2021-02-21;544;0;116265;0
FR;3;2021-02-22;8900;0;125165;0
FR;3;2021-02-23;11073;0;136238;0
FR;3;2021-02-24;13864;0;150102;0
FR;3;2021-02-25;44282;0;194384;0
FR;3;2021-02-26;61344;0;255728;0
FR;3;2021-02-27;34409;8;290137;8
FR;3;2021-02-28;2338;0;292475;8
FR;3;2021-03-01;19841;11;312316;19
FR;3;2021-03-02;38243;13;350559;32
FR;3;2021-03-03;47641;17;398200;49
FR;3;2021-03-04;80802;20;479002;69
FR;3;2021-03-05;116597;60;595599;129
FR;3;2021-03-06;118390;50;713989;179
FR;3;2021-03-07;54381;29;768370;208
FR;3;2021-03-08;41890;21;810260;229
FR;3;2021-03-09;77726;30;887986;259
FR;3;2021-03-10;79383;42;967369;301
FR;3;2021-03-11;126468;50;1093837;351
FR;3;2021-03-12;180410;70;1274247;421
FR;3;2021-03-13;130242;53;1404489;474
FR;3;2021-03-14;13667;4;1418156;478
FR;3;2021-03-15;51109;39;1469265;517
FR;3;2021-03-16;891;14;1470156;531
FR;3;2021-03-17;605;6;1470761;537
FR;3;2021-03-18;1165;4;1471926;541
FR;3;2021-03-19;69239;37;1541165;578
FR;3;2021-03-20;64249;35;1605414;613
FR;3;2021-03-21;5474;4;1610888;617
FR;3;2021-03-22;36620;33;1647508;650
FR;3;2021-03-23;83373;50;1730881;700
FR;3;2021-03-24;89578;91;1820459;791
FR;3;2021-03-25;148115;113;1968574;904
FR;3;2021-03-26;163495;156;2132069;1060
FR;3;2021-03-27;67272;88;2199341;1148
FR;3;2021-03-28;6166;19;2205507;1167
FR;3;2021-03-29;53306;61;2258813;1228
FR;3;2021-03-30;91989;88;2350802;1316
FR;3;2021-03-31;62309;82;2413111;1398
FR;3;2021-04-01;84589;104;2497700;1502
FR;3;2021-04-02;85660;148;2583360;1650
FR;3;2021-04-03;35175;109;2618535;1759
FR;3;2021-04-04;3373;16;2621908;1775
FR;3;2021-04-05;4211;21;2626119;1796
FR;3;2021-04-06;28856;76;2654975;1872
FR;3;2021-04-07;31494;61;2686469;1933
FR;3;2021-04-08;77435;236;2763904;2169
FR;3;2021-04-09;159730;412;2923634;2581
FR;3;2021-04-10;74402;332;2998036;2913
FR;3;2021-04-11;7014;44;3005050;2957
FR;3;2021-04-12;50505;197;3055555;3154
FR;3;2021-04-13;85016;315;3140571;3469
FR;3;2021-04-14;66484;342;3207055;3811
FR;3;2021-04-15;91624;369;3298679;4180
FR;3;2021-04-16;110971;573;3409650;4753
FR;3;2021-04-17;52187;336;3461837;5089
FR;3;2021-04-18;9427;35;3471264;5124
FR;3;2021-04-19;24405;238;3495669;5362
FR;3;2021-04-20;44793;398;3540462;5760
FR;3;2021-04-21;38010;458;3578472;6218
FR;3;2021-04-22;53627;793;3632099;7011
FR;3;2021-04-23;69406;1030;3701505;8041
FR;3;2021-04-24;36482;985;3737987;9026
FR;3;2021-04-25;5910;168;3743897;9194
FR;3;2021-04-26;19074;665;3762971;9859
FR;3;2021-04-27;33693;1246;3796664;11105
FR;3;2021-04-28;28252;1926;3824916;13031
FR;3;2021-04-29;44504;5959;3869420;18990
FR;3;2021-04-30;54532;8933;3923952;27923
FR;3;2021-05-01;9164;1968;3933116;29891
FR;3;2021-05-02;2791;501;3935907;30392
FR;3;2021-05-03;12487;3888;3948394;34280
FR;3;2021-05-04;22390;8456;3970784;42736
FR;3;2021-05-05;18019;10573;3988803;53309
FR;3;2021-05-06;33853;20906;4022656;74215
FR;3;2021-05-07;43309;28414;4065965;102629
FR;3;2021-05-08;6332;8913;4072297;111542
FR;3;2021-05-09;1561;2655;4073858;114197
FR;3;2021-05-10;14391;12564;4088249;126761
FR;3;2021-05-11;26350;25751;4114599;152512
FR;3;2021-05-12;16681;27476;4131280;179988
FR;3;2021-05-13;1997;3487;4133277;183475
FR;3;2021-05-14;14027;25749;4147304;209224
FR;3;2021-05-15;6898;20743;4154202;229967
FR;3;2021-05-16;810;2680;4155012;232647
FR;3;2021-05-17;7474;19923;4162486;252570
FR;3;2021-05-18;12872;29672;4175358;282242
FR;3;2021-05-19;8771;31890;4184129;314132
FR;3;2021-05-20;12220;53291;4196349;367423
FR;3;2021-05-21;12200;65642;4208549;433065
FR;3;2021-05-22;4636;33364;4213185;466429
FR;3;2021-05-23;529;2681;4213714;469110
FR;3;2021-05-24;573;4922;4214287;474032
FR;3;2021-05-25;4797;45457;4219084;519489
FR;3;2021-05-26;4533;51714;4223617;571203
FR;3;2021-05-27;5850;76518;4229467;647721
FR;3;2021-05-28;7045;99108;4236512;746829
FR;3;2021-05-29;3022;60286;4239534;807115
FR;3;2021-05-30;363;8243;4239897;815358
FR;3;2021-05-31;2015;35993;4241912;851351
FR;3;2021-06-01;2852;64820;4244764;916171
FR;4;2020-12-27;0;0;0;0
FR;4;2020-12-28;0;0;0;0
FR;4;2020-12-29;0;0;0;0
FR;4;2020-12-30;0;0;0;0
FR;4;2020-12-31;0;0;0;0
FR;4;2021-01-01;0;0;0;0
FR;4;2021-01-02;0;0;0;0
FR;4;2021-01-03;0;0;0;0
FR;4;2021-01-04;0;0;0;0
FR;4;2021-01-05;0;0;0;0
FR;4;2021-01-06;0;0;0;0
FR;4;2021-01-07;0;0;0;0
FR;4;2021-01-08;0;0;0;0
FR;4;2021-01-09;0;0;0;0
FR;4;2021-01-10;0;0;0;0
FR;4;2021-01-11;0;0;0;0
FR;4;2021-01-12;0;0;0;0
FR;4;2021-01-13;0;0;0;0
FR;4;2021-01-14;0;0;0;0
FR;4;2021-01-15;0;0;0;0
FR;4;2021-01-16;0;0;0;0
FR;4;2021-01-17;0;0;0;0
FR;4;2021-01-18;0;0;0;0
FR;4;2021-01-19;0;0;0;0
FR;4;2021-01-20;0;0;0;0
FR;4;2021-01-21;0;0;0;0
FR;4;2021-01-22;0;0;0;0
FR;4;2021-01-23;0;0;0;0
FR;4;2021-01-24;0;0;0;0
FR;4;2021-01-25;0;0;0;0
FR;4;2021-01-26;0;0;0;0
FR;4;2021-01-27;0;0;0;0
FR;4;2021-01-28;0;0;0;0
FR;4;2021-01-29;0;0;0;0
FR;4;2021-01-30;0;0;0;0
FR;4;2021-01-31;0;0;0;0
FR;4;2021-02-01;0;0;0;0
FR;4;2021-02-02;0;0;0;0
FR;4;2021-02-03;0;0;0;0
FR;4;2021-02-04;0;0;0;0
FR;4;2021-02-05;0;0;0;0
FR;4;2021-02-06;0;0;0;0
FR;4;2021-02-07;0;0;0;0
FR;4;2021-02-08;0;0;0;0
FR;4;2021-02-09;0;0;0;0
FR;4;2021-02-10;0;0;0;0
FR;4;2021-02-11;0;0;0;0
FR;4;2021-02-12;0;0;0;0
FR;4;2021-02-13;0;0;0;0
FR;4;2021-02-14;0;0;0;0
FR;4;2021-02-15;0;0;0;0
FR;4;2021-02-16;0;0;0;0
FR;4;2021-02-17;0;0;0;0
FR;4;2021-02-18;0;0;0;0
FR;4;2021-02-19;0;0;0;0
FR;4;2021-02-20;0;0;0;0
FR;4;2021-02-21;0;0;0;0
FR;4;2021-02-22;0;0;0;0
FR;4;2021-02-23;0;0;0;0
FR;4;2021-02-24;0;0;0;0
FR;4;2021-02-25;0;0;0;0
FR;4;2021-02-26;0;0;0;0
FR;4;2021-02-27;0;0;0;0
FR;4;2021-02-28;0;0;0;0
FR;4;2021-03-01;0;0;0;0
FR;4;2021-03-02;0;0;0;0
FR;4;2021-03-03;0;0;0;0
FR;4;2021-03-04;0;0;0;0
FR;4;2021-03-05;0;0;0;0
FR;4;2021-03-06;0;0;0;0
FR;4;2021-03-07;0;0;0;0
FR;4;2021-03-08;0;0;0;0
FR;4;2021-03-09;0;0;0;0
FR;4;2021-03-10;0;0;0;0
FR;4;2021-03-11;0;0;0;0
FR;4;2021-03-12;0;0;0;0
FR;4;2021-03-13;0;0;0;0
FR;4;2021-03-14;0;0;0;0
FR;4;2021-03-15;0;0;0;0
FR;4;2021-03-16;0;0;0;0
FR;4;2021-03-17;0;0;0;0
FR;4;2021-03-18;0;0;0;0
FR;4;2021-03-19;0;0;0;0
FR;4;2021-03-20;0;0;0;0
FR;4;2021-03-21;0;0;0;0
FR;4;2021-03-22;0;0;0;0
FR;4;2021-03-23;0;0;0;0
FR;4;2021-03-24;0;0;0;0
FR;4;2021-03-25;0;0;0;0
FR;4;2021-03-26;0;0;0;0
FR;4;2021-03-27;0;0;0;0
FR;4;2021-03-28;0;0;0;0
FR;4;2021-03-29;0;0;0;0
FR;4;2021-03-30;0;0;0;0
FR;4;2021-03-31;0;0;0;0
FR;4;2021-04-01;0;0;0;0
FR;4;2021-04-02;0;0;0;0
FR;4;2021-04-03;0;0;0;0
FR;4;2021-04-04;0;0;0;0
FR;4;2021-04-05;0;0;0;0
FR;4;2021-04-06;0;0;0;0
FR;4;2021-04-07;0;0;0;0
FR;4;2021-04-08;0;0;0;0
FR;4;2021-04-09;0;0;0;0
FR;4;2021-04-10;0;0;0;0
FR;4;2021-04-11;0;0;0;0
FR;4;2021-04-12;0;0;0;0
FR;4;2021-04-13;0;0;0;0
FR;4;2021-04-14;0;0;0;0
FR;4;2021-04-15;0;0;0;0
FR;4;2021-04-16;0;0;0;0
FR;4;2021-04-17;0;0;0;0
FR;4;2021-04-18;0;0;0;0
FR;4;2021-04-19;0;0;0;0
FR;4;2021-04-20;0;0;0;0
FR;4;2021-04-21;0;0;0;0
FR;4;2021-04-22;0;0;0;0
FR;4;2021-04-23;668;0;668;0
FR;4;2021-04-24;1553;0;2221;0
FR;4;2021-04-25;117;0;2338;0
FR;4;2021-04-26;2826;0;5164;0
FR;4;2021-04-27;9358;3;14522;3
FR;4;2021-04-28;9752;3;24274;6
FR;4;2021-04-29;15860;7;40134;13
FR;4;2021-04-30;19060;7;59194;20
FR;4;2021-05-01;1893;5;61087;25
FR;4;2021-05-02;438;0;61525;25
FR;4;2021-05-03;4911;1;66436;26
FR;4;2021-05-04;8243;8;74679;34
FR;4;2021-05-05;5996;7;80675;41
FR;4;2021-05-06;11251;11;91926;52
FR;4;2021-05-07;18889;8;110815;60
FR;4;2021-05-08;2248;4;113063;64
FR;4;2021-05-09;627;2;113690;66
FR;4;2021-05-10;7070;13;120760;79
FR;4;2021-05-11;14092;12;134852;91
FR;4;2021-05-12;9926;14;144778;105
FR;4;2021-05-13;1436;3;146214;108
FR;4;2021-05-14;7571;8;153785;116
FR;4;2021-05-15;3572;9;157357;125
FR;4;2021-05-16;348;1;157705;126
FR;4;2021-05-17;4224;3;161929;129
FR;4;2021-05-18;8438;10;170367;139
FR;4;2021-05-19;5491;5;175858;144
FR;4;2021-05-20;9155;7;185013;151
FR;4;2021-05-21;12477;26;197490;177
FR;4;2021-05-22;4900;13;202390;190
FR;4;2021-05-23;419;2;202809;192
FR;4;2021-05-24;921;3;203730;195
FR;4;2021-05-25;7322;16;211052;211
FR;4;2021-05-26;7472;12;218524;223
FR;4;2021-05-27;13988;34;232512;257
FR;4;2021-05-28;26011;73;258523;330
FR;4;2021-05-29;11000;17;269523;347
FR;4;2021-05-30;843;2;270366;349
FR;4;2021-05-31;12293;17;282659;366
FR;4;2021-06-01;19105;38;301764;404
FR;0;2020-12-27;20;0;20;0
FR;0;2020-12-28;69;0;89;0
FR;0;2020-12-29;108;0;197;0
FR;0;2020-12-30;120;0;317;0
FR;0;2020-12-31;85;0;402;0
FR;0;2021-01-01;67;0;469;0
FR;0;2021-01-02;79;0;548;0
FR;0;2021-01-03;89;0;637;0
FR;0;2021-01-04;1472;0;2109;0
FR;0;2021-01-05;5387;0;7496;0
FR;0;2021-01-06;11291;0;18787;0
FR;0;2021-01-07;28548;0;47335;0
FR;0;2021-01-08;36172;0;83507;0
FR;0;2021-01-09;10904;0;94411;0
FR;0;2021-01-10;5615;0;100026;0
FR;0;2021-01-11;38939;0;138965;0
FR;0;2021-01-12;60789;0;199754;0
FR;0;2021-01-13;63704;0;263458;0
FR;0;2021-01-14;79811;0;343269;0
FR;0;2021-01-15;67406;0;410675;0
FR;0;2021-01-16;19694;78;430369;78
FR;0;2021-01-17;10465;42;440834;120
FR;0;2021-01-18;84312;163;525146;283
FR;0;2021-01-19;128395;127;653541;410
FR;0;2021-01-20;135019;159;788560;569
FR;0;2021-01-21;155181;135;943741;704
FR;0;2021-01-22;118477;162;1062218;866
FR;0;2021-01-23;37772;50;1099990;916
FR;0;2021-01-24;9360;27;1109350;943
FR;0;2021-01-25;76758;1218;1186108;2161
FR;0;2021-01-26;98757;3110;1284865;5271
FR;0;2021-01-27;105587;5600;1390452;10871
FR;0;2021-01-28;122269;14361;1512721;25232
FR;0;2021-01-29;90839;17294;1603560;42526
FR;0;2021-01-30;28637;4225;1632197;46751
FR;0;2021-01-31;4866;1681;1637063;48432
FR;0;2021-02-01;51522;21134;1688585;69566
FR;0;2021-02-02;70605;34586;1759190;104152
FR;0;2021-02-03;70922;36984;1830112;141136
FR;0;2021-02-04;80471;50082;1910583;191218
FR;0;2021-02-05;67042;45348;1977625;236566
FR;0;2021-02-06;21286;10401;1998911;246967
FR;0;2021-02-07;4824;5046;2003735;252013
FR;0;2021-02-08;45815;45997;2049550;298010
FR;0;2021-02-09;64705;72421;2114255;370431
FR;0;2021-02-10;69211;76711;2183466;447142
FR;0;2021-02-11;85524;99174;2268990;546316
FR;0;2021-02-12;77653;74298;2346643;620614
FR;0;2021-02-13;21649;19496;2368292;640110
FR;0;2021-02-14;4580;7193;2372872;647303
FR;0;2021-02-15;37032;76512;2409904;723815
FR;0;2021-02-16;49172;100768;2459076;824583
FR;0;2021-02-17;49284;102989;2508360;927572
FR;0;2021-02-18;67830;118612;2576190;1046184
FR;0;2021-02-19;63644;90766;2639834;1136950
FR;0;2021-02-20;17956;28432;2657790;1165382
FR;0;2021-02-21;2857;6377;2660647;1171759
FR;0;2021-02-22;36441;73143;2697088;1244902
FR;0;2021-02-23;52564;84148;2749652;1329050
FR;0;2021-02-24;57961;81153;2807613;1410203
FR;0;2021-02-25;98461;91428;2906074;1501631
FR;0;2021-02-26;111613;71042;3017687;1572673
FR;0;2021-02-27;51085;21979;3068772;1594652
FR;0;2021-02-28;5666;4414;3074438;1599066
FR;0;2021-03-01;63495;52815;3137933;1651881
FR;0;2021-03-02;99211;66283;3237144;1718164
FR;0;2021-03-03;113333;65560;3350477;1783724
FR;0;2021-03-04;159933;68895;3510410;1852619
FR;0;2021-03-05;197461;63400;3707871;1916019
FR;0;2021-03-06;204328;17825;3912199;1933844
FR;0;2021-03-07;119630;5480;4031829;1939324
FR;0;2021-03-08;104554;50812;4136383;1990136
FR;0;2021-03-09;169347;56783;4305730;2046919
FR;0;2021-03-10;175170;57222;4480900;2104141
FR;0;2021-03-11;238687;63141;4719587;2167282
FR;0;2021-03-12;290229;53523;5009816;2220805
FR;0;2021-03-13;227607;15292;5237423;2236097
FR;0;2021-03-14;62050;3437;5299473;2239534
FR;0;2021-03-15;155476;32691;5454949;2272225
FR;0;2021-03-16;139159;39554;5594108;2311779
FR;0;2021-03-17;147862;38842;5741970;2350621
FR;0;2021-03-18;164830;44670;5906800;2395291
FR;0;2021-03-19;226247;37493;6133047;2432784
FR;0;2021-03-20;164280;11787;6297327;2444571
FR;0;2021-03-21;48712;2628;6346039;2447199
FR;0;2021-03-22;166847;34303;6512886;2481502
FR;0;2021-03-23;246365;42413;6759251;2523915
FR;0;2021-03-24;252909;43873;7012160;2567788
FR;0;2021-03-25;336964;44767;7349124;2612555
FR;0;2021-03-26;354125;41920;7703249;2654475
FR;0;2021-03-27;192707;16658;7895956;2671133
FR;0;2021-03-28;58275;3737;7954231;2674870
FR;0;2021-03-29;200154;54320;8154385;2729190
FR;0;2021-03-30;281569;69687;8435954;2798877
FR;0;2021-03-31;258989;72952;8694943;2871829
FR;0;2021-04-01;309397;87861;9004340;2959690
FR;0;2021-04-02;277204;92137;9281544;3051827
FR;0;2021-04-03;138983;61879;9420527;3113706
FR;0;2021-04-04;44828;18666;9465355;3132372
FR;0;2021-04-05;58723;11009;9524078;3143381
FR;0;2021-04-06;212662;107919;9736740;3251300
FR;0;2021-04-07;255880;115509;9992620;3366809
FR;0;2021-04-08;332198;121468;10324818;3488277
FR;0;2021-04-09;404082;116567;10728900;3604844
FR;0;2021-04-10;209894;82768;10938794;3687612
FR;0;2021-04-11;54946;34607;10993740;3722219
FR;0;2021-04-12;233477;115255;11227217;3837474
FR;0;2021-04-13;304707;145028;11531924;3982502
FR;0;2021-04-14;289062;139449;11820986;4121951
FR;0;2021-04-15;331111;147940;12152097;4269891
FR;0;2021-04-16;334256;145813;12486353;4415704
FR;0;2021-04-17;185875;90285;12672228;4505989
FR;0;2021-04-18;50398;35433;12722626;4541422
FR;0;2021-04-19;202196;138489;12924822;4679911
FR;0;2021-04-20;249959;170827;13174781;4850738
FR;0;2021-04-21;248350;168915;13423131;5019653
FR;0;2021-04-22;281911;188348;13705042;5208001
FR;0;2021-04-23;289284;183472;13994326;5391473
FR;0;2021-04-24;187293;111612;14181619;5503085
FR;0;2021-04-25;67895;38893;14249514;5541978
FR;0;2021-04-26;215280;156171;14464794;5698149
FR;0;2021-04-27;279564;187581;14744358;5885730
FR;0;2021-04-28;293945;183338;15038303;6069068
FR;0;2021-04-29;351016;196273;15389319;6265341
FR;0;2021-04-30;366332;184962;15755651;6450303
FR;0;2021-05-01;163068;52554;15918719;6502857
FR;0;2021-05-02;89595;37850;16008314;6540707
FR;0;2021-05-03;281487;169829;16289801;6710536
FR;0;2021-05-04;308003;224415;16597804;6934951
FR;0;2021-05-05;317863;224717;16915667;7159668
FR;0;2021-05-06;371235;239449;17286902;7399117
FR;0;2021-05-07;364448;257807;17651350;7656924
FR;0;2021-05-08;207994;67137;17859344;7724061
FR;0;2021-05-09;127361;46788;17986705;7770849
FR;0;2021-05-10;302773;229280;18289478;8000129
FR;0;2021-05-11;394997;258390;18684475;8258519
FR;0;2021-05-12;420084;233550;19104559;8492069
FR;0;2021-05-13;331001;56978;19435560;8549047
FR;0;2021-05-14;442394;167714;19877954;8716761
FR;0;2021-05-15;362891;94083;20240845;8810844
FR;0;2021-05-16;199286;20846;20440131;8831690
FR;0;2021-05-17;366779;149323;20806910;8981013
FR;0;2021-05-18;444193;153492;21251103;9134505
FR;0;2021-05-19;454412;145796;21705515;9280301
FR;0;2021-05-20;493894;160844;22199409;9441145
FR;0;2021-05-21;475369;175076;22674778;9616221
FR;0;2021-05-22;340357;80098;23015135;9696319
FR;0;2021-05-23;158404;14510;23173539;9710829
FR;0;2021-05-24;256473;33356;23430012;9744185
FR;0;2021-05-25;389147;190235;23819159;9934420
FR;0;2021-05-26;395256;192421;24214415;10126841
FR;0;2021-05-27;437299;209730;24651714;10336571
FR;0;2021-05-28;417009;259882;25068723;10596453
FR;0;2021-05-29;293205;149567;25361928;10746020
FR;0;2021-05-30;104172;32671;25466100;10778691
FR;0;2021-05-31;348238;203729;25814338;10982420
FR;0;2021-06-01;405217;251898;26219555;11234318
