fra;vaccin;jour;n_dose1;n_dose2;n_cum_dose1;n_cum_dose2
FR;1;2020-12-27;20;0;20;0
FR;1;2020-12-28;69;0;89;0
FR;1;2020-12-29;108;0;197;0
FR;1;2020-12-30;121;0;318;0
FR;1;2020-12-31;85;0;403;0
FR;1;2021-01-01;68;0;471;0
FR;1;2021-01-02;88;0;559;0
FR;1;2021-01-03;90;0;649;0
FR;1;2021-01-04;1478;0;2127;0
FR;1;2021-01-05;5395;0;7522;0
FR;1;2021-01-06;11297;0;18819;0
FR;1;2021-01-07;28559;0;47378;0
FR;1;2021-01-08;36235;0;83613;0
FR;1;2021-01-09;10922;0;94535;0
FR;1;2021-01-10;5620;0;100155;0
FR;1;2021-01-11;38989;0;139144;0
FR;1;2021-01-12;60865;0;200009;0
FR;1;2021-01-13;63761;0;263770;0
FR;1;2021-01-14;79720;0;343490;0
FR;1;2021-01-15;67273;0;410763;0
FR;1;2021-01-16;19525;78;430288;78
FR;1;2021-01-17;10466;42;440754;120
FR;1;2021-01-18;81471;163;522225;283
FR;1;2021-01-19;123934;127;646159;410
FR;1;2021-01-20;130250;159;776409;569
FR;1;2021-01-21;150258;135;926667;704
FR;1;2021-01-22;113746;162;1040413;866
FR;1;2021-01-23;36075;50;1076488;916
FR;1;2021-01-24;9263;27;1085751;943
FR;1;2021-01-25;73200;1218;1158951;2161
FR;1;2021-01-26;95066;3110;1254017;5271
FR;1;2021-01-27;102226;5597;1356243;10868
FR;1;2021-01-28;118837;14360;1475080;25228
FR;1;2021-01-29;87802;17292;1562882;42520
FR;1;2021-01-30;27582;4225;1590464;46745
FR;1;2021-01-31;4871;1679;1595335;48424
FR;1;2021-02-01;48331;21128;1643666;69552
FR;1;2021-02-02;66403;34568;1710069;104120
FR;1;2021-02-03;65963;36960;1776032;141080
FR;1;2021-02-04;75858;50057;1851890;191137
FR;1;2021-02-05;62502;45335;1914392;236472
FR;1;2021-02-06;19087;10396;1933479;246868
FR;1;2021-02-07;3433;5041;1936912;251909
FR;1;2021-02-08;35831;45985;1972743;297894
FR;1;2021-02-09;50013;72392;2022756;370286
FR;1;2021-02-10;50878;76646;2073634;446932
FR;1;2021-02-11;62233;99077;2135867;546009
FR;1;2021-02-12;54850;74038;2190717;620047
FR;1;2021-02-13;15137;19270;2205854;639317
FR;1;2021-02-14;3422;7190;2209276;646507
FR;1;2021-02-15;23576;73440;2232852;719947
FR;1;2021-02-16;32122;96865;2264974;816812
FR;1;2021-02-17;34380;98568;2299354;915380
FR;1;2021-02-18;48147;113474;2347501;1028854
FR;1;2021-02-19;44432;86413;2391933;1115267
FR;1;2021-02-20;13021;26920;2404954;1142187
FR;1;2021-02-21;2118;6287;2407072;1148474
FR;1;2021-02-22;24048;69415;2431120;1217889
FR;1;2021-02-23;36678;80365;2467798;1298254
FR;1;2021-02-24;39378;77662;2507176;1375916
FR;1;2021-02-25;48918;87994;2556094;1463910
FR;1;2021-02-26;46103;67888;2602197;1531798
FR;1;2021-02-27;15179;20931;2617376;1552729
FR;1;2021-02-28;3233;4386;2620609;1557115
FR;1;2021-03-01;38739;49030;2659348;1606145
FR;1;2021-03-02;54721;61505;2714069;1667650
FR;1;2021-03-03;59561;60651;2773630;1728301
FR;1;2021-03-04;71211;64894;2844841;1793195
FR;1;2021-03-05;73223;59273;2918064;1852468
FR;1;2021-03-06;81412;16093;2999476;1868561
FR;1;2021-03-07;62988;5424;3062464;1873985
FR;1;2021-03-08;58821;42477;3121285;1916462
FR;1;2021-03-09;84413;48318;3205698;1964780
FR;1;2021-03-10;89032;48067;3294730;2012847
FR;1;2021-03-11;103286;53861;3398016;2066708
FR;1;2021-03-12;102158;45268;3500174;2111976
FR;1;2021-03-13;87529;12720;3587703;2124696
FR;1;2021-03-14;43636;3031;3631339;2127727
FR;1;2021-03-15;93800;29151;3725139;2156878
FR;1;2021-03-16;121883;34906;3847022;2191784
FR;1;2021-03-17;127463;34868;3974485;2226652
FR;1;2021-03-18;140847;39750;4115332;2266402
FR;1;2021-03-19;134218;32913;4249550;2299315
FR;1;2021-03-20;74904;10212;4324454;2309527
FR;1;2021-03-21;25770;2477;4350224;2312004
FR;1;2021-03-22;112913;31190;4463137;2343194
FR;1;2021-03-23;140829;38173;4603966;2381367
FR;1;2021-03-24;139840;38790;4743806;2420157
FR;1;2021-03-25;162649;39619;4906455;2459776
FR;1;2021-03-26;164149;37495;5070604;2497271
FR;1;2021-03-27;109828;15256;5180432;2512527
FR;1;2021-03-28;41723;3624;5222155;2516151
FR;1;2021-03-29;128272;49969;5350427;2566120
FR;1;2021-03-30;165534;63596;5515961;2629716
FR;1;2021-03-31;168773;66913;5684734;2696629
FR;1;2021-04-01;191149;79253;5875883;2775882
FR;1;2021-04-02;162218;84318;6038101;2860200
FR;1;2021-04-03;87105;58185;6125206;2918385
FR;1;2021-04-04;32323;17732;6157529;2936117
FR;1;2021-04-05;42421;10177;6199950;2946294
FR;1;2021-04-06;157617;100888;6357567;3047182
FR;1;2021-04-07;194038;108270;6551605;3155452
FR;1;2021-04-08;218574;112406;6770179;3267858
FR;1;2021-04-09;211282;107518;6981461;3375376
FR;1;2021-04-10;116063;73463;7097524;3448839
FR;1;2021-04-11;40123;30288;7137647;3479127
FR;1;2021-04-12;166307;103796;7303954;3582923
FR;1;2021-04-13;200741;128258;7504695;3711181
FR;1;2021-04-14;205104;122820;7709799;3834001
FR;1;2021-04-15;217958;126760;7927757;3960761
FR;1;2021-04-16;203123;125149;8130880;4085910
FR;1;2021-04-17;120693;67480;8251573;4153390
FR;1;2021-04-18;35199;20993;8286772;4174383
FR;1;2021-04-19;161505;121928;8448277;4296311
FR;1;2021-04-20;186520;148797;8634797;4445108
FR;1;2021-04-21;191220;146751;8826017;4591859
FR;1;2021-04-22;205582;162650;9031599;4754509
FR;1;2021-04-23;195949;156935;9227548;4911444
FR;1;2021-04-24;124811;95509;9352359;5006953
FR;1;2021-04-25;52859;30140;9405218;5037093
FR;1;2021-04-26;178916;138281;9584134;5175374
FR;1;2021-04-27;218304;162006;9802438;5337380
FR;1;2021-04-28;234929;155135;10037367;5492515
FR;1;2021-04-29;266319;160094;10303686;5652609
FR;1;2021-04-30;267891;148175;10571577;5800784
FR;1;2021-05-01;137346;40719;10708923;5841503
FR;1;2021-05-02;80122;28163;10789045;5869666
FR;1;2021-05-03;245626;146546;11034671;6016212
FR;1;2021-05-04;260388;186874;11295059;6203086
FR;1;2021-05-05;276720;184601;11571779;6387687
FR;1;2021-05-06;303714;183072;11875493;6570759
FR;1;2021-05-07;279023;195762;12154516;6766521
FR;1;2021-05-08;180451;48334;12334967;6814855
FR;1;2021-05-09;112372;36234;12447339;6851089
FR;1;2021-05-10;250030;194293;12697369;7045382
FR;1;2021-05-11;312576;211454;13009945;7256836
FR;1;2021-05-12;346527;185958;13356472;7442794
FR;1;2021-05-13;277158;47682;13633630;7490476
FR;1;2021-05-14;360624;128938;13994254;7619414
FR;1;2021-05-15;290169;66173;14284423;7685587
FR;1;2021-05-16;155206;15588;14439629;7701175
FR;1;2021-05-17;312454;116747;14752083;7817922
FR;1;2021-05-18;371824;111414;15123907;7929336
FR;1;2021-05-19;385900;103010;15509807;8032346
FR;1;2021-05-20;410612;96414;15920419;8128760
FR;1;2021-05-21;389310;97509;16309729;8226269
FR;1;2021-05-22;270631;42184;16580360;8268453
FR;1;2021-05-23;120564;11247;16700924;8279700
FR;1;2021-05-24;238313;26380;16939237;8306080
FR;1;2021-05-25;357742;132071;17296979;8438151
FR;1;2021-05-26;366601;125830;17663580;8563981
FR;1;2021-05-27;395970;128419;18059550;8692400
FR;1;2021-05-28;356475;145714;18416025;8838114
FR;1;2021-05-29;249695;81075;18665720;8919189
FR;1;2021-05-30;98671;22616;18764391;8941805
FR;1;2021-05-31;307825;148956;19072216;9090761
FR;1;2021-06-01;344442;166963;19416658;9257724
FR;1;2021-06-02;344849;153482;19761507;9411206
FR;1;2021-06-03;376188;147919;20137695;9559125
FR;1;2021-06-04;348888;175814;20486583;9734939
FR;1;2021-06-05;251739;112883;20738322;9847822
FR;1;2021-06-06;122575;37572;20860897;9885394
FR;1;2021-06-07;287588;208371;21148485;10093765
FR;2;2020-12-27;0;0;0;0
FR;2;2020-12-28;0;0;0;0
FR;2;2020-12-29;0;0;0;0
FR;2;2020-12-30;0;0;0;0
FR;2;2020-12-31;0;0;0;0
FR;2;2021-01-01;0;0;0;0
FR;2;2021-01-02;0;0;0;0
FR;2;2021-01-03;0;0;0;0
FR;2;2021-01-04;0;0;0;0
FR;2;2021-01-05;0;0;0;0
FR;2;2021-01-06;0;0;0;0
FR;2;2021-01-07;0;0;0;0
FR;2;2021-01-08;0;0;0;0
FR;2;2021-01-09;0;0;0;0
FR;2;2021-01-10;0;0;0;0
FR;2;2021-01-11;0;0;0;0
FR;2;2021-01-12;0;0;0;0
FR;2;2021-01-13;0;0;0;0
FR;2;2021-01-14;147;0;147;0
FR;2;2021-01-15;217;0;364;0
FR;2;2021-01-16;185;0;549;0
FR;2;2021-01-17;3;0;552;0
FR;2;2021-01-18;2909;0;3461;0
FR;2;2021-01-19;4510;0;7971;0
FR;2;2021-01-20;4921;0;12892;0
FR;2;2021-01-21;5126;0;18018;0
FR;2;2021-01-22;4880;0;22898;0
FR;2;2021-01-23;1735;0;24633;0
FR;2;2021-01-24;102;0;24735;0
FR;2;2021-01-25;3634;0;28369;0
FR;2;2021-01-26;3747;0;32116;0
FR;2;2021-01-27;3440;0;35556;0
FR;2;2021-01-28;3513;0;39069;0
FR;2;2021-01-29;3082;0;42151;0
FR;2;2021-01-30;1065;0;43216;0
FR;2;2021-01-31;0;0;43216;0
FR;2;2021-02-01;3259;0;46475;0
FR;2;2021-02-02;4305;0;50780;0
FR;2;2021-02-03;5031;0;55811;0
FR;2;2021-02-04;4734;3;60545;3
FR;2;2021-02-05;4618;6;65163;9
FR;2;2021-02-06;1930;3;67093;12
FR;2;2021-02-07;42;0;67135;12
FR;2;2021-02-08;7425;8;74560;20
FR;2;2021-02-09;8256;15;82816;35
FR;2;2021-02-10;9136;49;91952;84
FR;2;2021-02-11;10052;67;102004;151
FR;2;2021-02-12;9814;238;111818;389
FR;2;2021-02-13;3015;222;114833;611
FR;2;2021-02-14;296;0;115129;611
FR;2;2021-02-15;3358;3067;118487;3678
FR;2;2021-02-16;4907;3881;123394;7559
FR;2;2021-02-17;4104;4403;127498;11962
FR;2;2021-02-18;5229;5089;132727;17051
FR;2;2021-02-19;5211;4323;137938;21374
FR;2;2021-02-20;1764;1509;139702;22883
FR;2;2021-02-21;197;86;139899;22969
FR;2;2021-02-22;3514;3723;143413;26692
FR;2;2021-02-23;4836;3693;148249;30385
FR;2;2021-02-24;4746;3468;152995;33853
FR;2;2021-02-25;5292;3426;158287;37279
FR;2;2021-02-26;4193;3125;162480;40404
FR;2;2021-02-27;1502;1042;163982;41446
FR;2;2021-02-28;99;28;164081;41474
FR;2;2021-03-01;4957;3764;169038;45238
FR;2;2021-03-02;6308;4728;175346;49966
FR;2;2021-03-03;6244;4883;181590;54849
FR;2;2021-03-04;8071;3967;189661;58816
FR;2;2021-03-05;7769;4060;197430;62876
FR;2;2021-03-06;4621;1682;202051;64558
FR;2;2021-03-07;2283;29;204334;64587
FR;2;2021-03-08;3969;8310;208303;72897
FR;2;2021-03-09;7263;8429;215566;81326
FR;2;2021-03-10;6861;9109;222427;90435
FR;2;2021-03-11;9052;9208;231479;99643
FR;2;2021-03-12;7717;8170;239196;107813
FR;2;2021-03-13;9869;2511;249065;110324
FR;2;2021-03-14;4753;402;253818;110726
FR;2;2021-03-15;10636;3484;264454;114210
FR;2;2021-03-16;16453;4621;280907;118831
FR;2;2021-03-17;19911;3952;300818;122783
FR;2;2021-03-18;22951;4910;323769;127693
FR;2;2021-03-19;22882;4537;346651;132230
FR;2;2021-03-20;25143;1540;371794;133770
FR;2;2021-03-21;17470;147;389264;133917
FR;2;2021-03-22;17389;3078;406653;136995
FR;2;2021-03-23;22267;4183;428920;141178
FR;2;2021-03-24;23545;4988;452465;146166
FR;2;2021-03-25;26272;5020;478737;151186
FR;2;2021-03-26;26581;4260;505318;155446
FR;2;2021-03-27;15638;1309;520956;156755
FR;2;2021-03-28;10390;94;531346;156849
FR;2;2021-03-29;18642;4281;549988;161130
FR;2;2021-03-30;24166;6002;574154;167132
FR;2;2021-03-31;28096;5956;602250;173088
FR;2;2021-04-01;33965;8495;636215;181583
FR;2;2021-04-02;29501;7661;665716;189244
FR;2;2021-04-03;16727;3582;682443;192826
FR;2;2021-04-04;9160;918;691603;193744
FR;2;2021-04-05;12120;811;703723;194555
FR;2;2021-04-06;26729;6933;730452;201488
FR;2;2021-04-07;30583;7173;761035;208661
FR;2;2021-04-08;36486;8817;797521;217478
FR;2;2021-04-09;33380;8602;830901;226080
FR;2;2021-04-10;19444;8968;850345;235048
FR;2;2021-04-11;7814;4271;858159;239319
FR;2;2021-04-12;16799;11254;874958;250573
FR;2;2021-04-13;19091;16426;894049;266999
FR;2;2021-04-14;17652;16284;911701;283283
FR;2;2021-04-15;21824;20757;933525;304040
FR;2;2021-04-16;20356;20073;953881;324113
FR;2;2021-04-17;13046;22462;966927;346575
FR;2;2021-04-18;5782;14405;972709;360980
FR;2;2021-04-19;16477;16262;989186;377242
FR;2;2021-04-20;18973;21595;1008159;398837
FR;2;2021-04-21;19679;21665;1027838;420502
FR;2;2021-04-22;23410;24861;1051248;445363
FR;2;2021-04-23;24203;25351;1075451;470714
FR;2;2021-04-24;25097;15111;1100548;485825
FR;2;2021-04-25;9489;8589;1110037;494414
FR;2;2021-04-26;16869;17195;1126906;511609
FR;2;2021-04-27;18958;24308;1145864;535917
FR;2;2021-04-28;21575;26189;1167439;562106
FR;2;2021-04-29;25083;30136;1192522;592242
FR;2;2021-04-30;25113;27783;1217635;620025
FR;2;2021-05-01;14763;9863;1232398;629888
FR;2;2021-05-02;6483;9184;1238881;639072
FR;2;2021-05-03;19455;19327;1258336;658399
FR;2;2021-05-04;17938;29056;1276274;687455
FR;2;2021-05-05;17912;29416;1294186;716871
FR;2;2021-05-06;23152;35293;1317338;752164
FR;2;2021-05-07;24751;33242;1342089;785406
FR;2;2021-05-08;20150;9703;1362239;795109
FR;2;2021-05-09;12902;7894;1375141;803003
FR;2;2021-05-10;32210;22222;1407351;825225
FR;2;2021-05-11;42825;21077;1450176;846302
FR;2;2021-05-12;48727;19907;1498903;866209
FR;2;2021-05-13;50458;5770;1549361;871979
FR;2;2021-05-14;60427;12955;1609788;884934
FR;2;2021-05-15;65194;7154;1674982;892088
FR;2;2021-05-16;42939;2575;1717921;894663
FR;2;2021-05-17;44052;12592;1761973;907255
FR;2;2021-05-18;53319;12254;1815292;919509
FR;2;2021-05-19;55738;10635;1871030;930144
FR;2;2021-05-20;62416;10897;1933446;941041
FR;2;2021-05-21;62369;11685;1995815;952726
FR;2;2021-05-22;60725;4528;2056540;957254
FR;2;2021-05-23;36908;577;2093448;957831
FR;2;2021-05-24;16817;2033;2110265;959864
FR;2;2021-05-25;20448;12241;2130713;972105
FR;2;2021-05-26;18970;11468;2149683;983573
FR;2;2021-05-27;22364;12667;2172047;996240
FR;2;2021-05-28;28160;14987;2200207;1011227
FR;2;2021-05-29;29760;8190;2229967;1019417
FR;2;2021-05-30;4448;1810;2234415;1021227
FR;2;2021-05-31;27555;18760;2261970;1039987
FR;2;2021-06-01;43889;20078;2305859;1060065
FR;2;2021-06-02;36120;19317;2341979;1079382
FR;2;2021-06-03;49883;23405;2391862;1102787
FR;2;2021-06-04;63767;24103;2455629;1126890
FR;2;2021-06-05;33502;24056;2489131;1150946
FR;2;2021-06-06;4660;6206;2493791;1157152
FR;2;2021-06-07;26807;23110;2520598;1180262
FR;3;2020-12-27;0;0;0;0
FR;3;2020-12-28;0;0;0;0
FR;3;2020-12-29;0;0;0;0
FR;3;2020-12-30;0;0;0;0
FR;3;2020-12-31;0;0;0;0
FR;3;2021-01-01;0;0;0;0
FR;3;2021-01-02;0;0;0;0
FR;3;2021-01-03;0;0;0;0
FR;3;2021-01-04;0;0;0;0
FR;3;2021-01-05;0;0;0;0
FR;3;2021-01-06;0;0;0;0
FR;3;2021-01-07;0;0;0;0
FR;3;2021-01-08;0;0;0;0
FR;3;2021-01-09;0;0;0;0
FR;3;2021-01-10;0;0;0;0
FR;3;2021-01-11;0;0;0;0
FR;3;2021-01-12;0;0;0;0
FR;3;2021-01-13;0;0;0;0
FR;3;2021-01-14;0;0;0;0
FR;3;2021-01-15;0;0;0;0
FR;3;2021-01-16;0;0;0;0
FR;3;2021-01-17;0;0;0;0
FR;3;2021-01-18;0;0;0;0
FR;3;2021-01-19;0;0;0;0
FR;3;2021-01-20;0;0;0;0
FR;3;2021-01-21;0;0;0;0
FR;3;2021-01-22;0;0;0;0
FR;3;2021-01-23;0;0;0;0
FR;3;2021-01-24;0;0;0;0
FR;3;2021-01-25;0;0;0;0
FR;3;2021-01-26;0;0;0;0
FR;3;2021-01-27;0;0;0;0
FR;3;2021-01-28;0;0;0;0
FR;3;2021-01-29;0;0;0;0
FR;3;2021-01-30;0;0;0;0
FR;3;2021-01-31;0;0;0;0
FR;3;2021-02-01;0;0;0;0
FR;3;2021-02-02;0;0;0;0
FR;3;2021-02-03;0;0;0;0
FR;3;2021-02-04;0;0;0;0
FR;3;2021-02-05;0;0;0;0
FR;3;2021-02-06;318;0;318;0
FR;3;2021-02-07;1348;0;1666;0
FR;3;2021-02-08;2633;0;4299;0
FR;3;2021-02-09;6638;0;10937;0
FR;3;2021-02-10;9225;0;20162;0
FR;3;2021-02-11;13346;0;33508;0
FR;3;2021-02-12;13036;0;46544;0
FR;3;2021-02-13;3510;0;50054;0
FR;3;2021-02-14;865;0;50919;0
FR;3;2021-02-15;10107;0;61026;0
FR;3;2021-02-16;12164;0;73190;0
FR;3;2021-02-17;10813;0;84003;0
FR;3;2021-02-18;14548;0;98551;0
FR;3;2021-02-19;14111;0;112662;0
FR;3;2021-02-20;3175;0;115837;0
FR;3;2021-02-21;544;0;116381;0
FR;3;2021-02-22;8907;0;125288;0
FR;3;2021-02-23;11099;0;136387;0
FR;3;2021-02-24;13880;0;150267;0
FR;3;2021-02-25;44326;0;194593;0
FR;3;2021-02-26;61380;0;255973;0
FR;3;2021-02-27;34441;7;290414;7
FR;3;2021-02-28;2343;0;292757;7
FR;3;2021-03-01;19893;10;312650;17
FR;3;2021-03-02;38309;13;350959;30
FR;3;2021-03-03;47777;17;398736;47
FR;3;2021-03-04;81047;20;479783;67
FR;3;2021-03-05;116840;60;596623;127
FR;3;2021-03-06;118816;49;715439;176
FR;3;2021-03-07;54445;28;769884;204
FR;3;2021-03-08;42013;21;811897;225
FR;3;2021-03-09;77913;31;889810;256
FR;3;2021-03-10;79726;39;969536;295
FR;3;2021-03-11;127034;49;1096570;344
FR;3;2021-03-12;181063;68;1277633;412
FR;3;2021-03-13;130832;53;1408465;465
FR;3;2021-03-14;13732;4;1422197;469
FR;3;2021-03-15;51318;38;1473515;507
FR;3;2021-03-16;909;14;1474424;521
FR;3;2021-03-17;626;6;1475050;527
FR;3;2021-03-18;1185;4;1476235;531
FR;3;2021-03-19;69413;36;1545648;567
FR;3;2021-03-20;64409;35;1610057;602
FR;3;2021-03-21;5487;4;1615544;606
FR;3;2021-03-22;36736;32;1652280;638
FR;3;2021-03-23;83455;50;1735735;688
FR;3;2021-03-24;89740;91;1825475;779
FR;3;2021-03-25;148387;115;1973862;894
FR;3;2021-03-26;163765;156;2137627;1050
FR;3;2021-03-27;67400;88;2205027;1138
FR;3;2021-03-28;6201;19;2211228;1157
FR;3;2021-03-29;53380;60;2264608;1217
FR;3;2021-03-30;92066;88;2356674;1305
FR;3;2021-03-31;62451;82;2419125;1387
FR;3;2021-04-01;84791;104;2503916;1491
FR;3;2021-04-02;85820;148;2589736;1639
FR;3;2021-04-03;35230;109;2624966;1748
FR;3;2021-04-04;3380;15;2628346;1763
FR;3;2021-04-05;4222;21;2632568;1784
FR;3;2021-04-06;28897;76;2661465;1860
FR;3;2021-04-07;31515;60;2692980;1920
FR;3;2021-04-08;77488;235;2770468;2155
FR;3;2021-04-09;159825;410;2930293;2565
FR;3;2021-04-10;74488;332;3004781;2897
FR;3;2021-04-11;7020;44;3011801;2941
FR;3;2021-04-12;50558;197;3062359;3138
FR;3;2021-04-13;85059;314;3147418;3452
FR;3;2021-04-14;66521;341;3213939;3793
FR;3;2021-04-15;91672;369;3305611;4162
FR;3;2021-04-16;111036;573;3416647;4735
FR;3;2021-04-17;52229;336;3468876;5071
FR;3;2021-04-18;9430;34;3478306;5105
FR;3;2021-04-19;24440;238;3502746;5343
FR;3;2021-04-20;44822;398;3547568;5741
FR;3;2021-04-21;38019;457;3585587;6198
FR;3;2021-04-22;53680;791;3639267;6989
FR;3;2021-04-23;69442;1021;3708709;8010
FR;3;2021-04-24;36503;985;3745212;8995
FR;3;2021-04-25;5915;158;3751127;9153
FR;3;2021-04-26;19084;664;3770211;9817
FR;3;2021-04-27;33703;1245;3803914;11062
FR;3;2021-04-28;28263;1926;3832177;12988
FR;3;2021-04-29;44539;5956;3876716;18944
FR;3;2021-04-30;54543;8932;3931259;27876
FR;3;2021-05-01;9172;1967;3940431;29843
FR;3;2021-05-02;2796;500;3943227;30343
FR;3;2021-05-03;12495;3881;3955722;34224
FR;3;2021-05-04;22411;8456;3978133;42680
FR;3;2021-05-05;18037;10573;3996170;53253
FR;3;2021-05-06;33865;20905;4030035;74158
FR;3;2021-05-07;43344;28410;4073379;102568
FR;3;2021-05-08;6344;8905;4079723;111473
FR;3;2021-05-09;1562;2655;4081285;114128
FR;3;2021-05-10;14402;12560;4095687;126688
FR;3;2021-05-11;26358;25739;4122045;152427
FR;3;2021-05-12;16695;27453;4138740;179880
FR;3;2021-05-13;1998;3480;4140738;183360
FR;3;2021-05-14;14035;25743;4154773;209103
FR;3;2021-05-15;6903;20734;4161676;229837
FR;3;2021-05-16;810;2680;4162486;232517
FR;3;2021-05-17;7492;19914;4169978;252431
FR;3;2021-05-18;12878;29636;4182856;282067
FR;3;2021-05-19;8784;31864;4191640;313931
FR;3;2021-05-20;12233;53223;4203873;367154
FR;3;2021-05-21;12217;65542;4216090;432696
FR;3;2021-05-22;4639;33300;4220729;465996
FR;3;2021-05-23;534;2665;4221263;468661
FR;3;2021-05-24;575;4920;4221838;473581
FR;3;2021-05-25;4813;45190;4226651;518771
FR;3;2021-05-26;4540;51054;4231191;569825
FR;3;2021-05-27;5889;77849;4237080;647674
FR;3;2021-05-28;7085;99108;4244165;746782
FR;3;2021-05-29;3051;60285;4247216;807067
FR;3;2021-05-30;369;8243;4247585;815310
FR;3;2021-05-31;2046;35996;4249631;851306
FR;3;2021-06-01;2945;64819;4252576;916125
FR;3;2021-06-02;2343;58360;4254919;974485
FR;3;2021-06-03;3132;87590;4258051;1062075
FR;3;2021-06-04;3771;105132;4261822;1167207
FR;3;2021-06-05;1729;52242;4263551;1219449
FR;3;2021-06-06;250;5400;4263801;1224849
FR;3;2021-06-07;1055;31177;4264856;1256026
FR;4;2020-12-27;0;0;0;0
FR;4;2020-12-28;0;0;0;0
FR;4;2020-12-29;0;0;0;0
FR;4;2020-12-30;0;0;0;0
FR;4;2020-12-31;0;0;0;0
FR;4;2021-01-01;0;0;0;0
FR;4;2021-01-02;0;0;0;0
FR;4;2021-01-03;0;0;0;0
FR;4;2021-01-04;0;0;0;0
FR;4;2021-01-05;0;0;0;0
FR;4;2021-01-06;0;0;0;0
FR;4;2021-01-07;0;0;0;0
FR;4;2021-01-08;0;0;0;0
FR;4;2021-01-09;0;0;0;0
FR;4;2021-01-10;0;0;0;0
FR;4;2021-01-11;0;0;0;0
FR;4;2021-01-12;0;0;0;0
FR;4;2021-01-13;0;0;0;0
FR;4;2021-01-14;0;0;0;0
FR;4;2021-01-15;0;0;0;0
FR;4;2021-01-16;0;0;0;0
FR;4;2021-01-17;0;0;0;0
FR;4;2021-01-18;0;0;0;0
FR;4;2021-01-19;0;0;0;0
FR;4;2021-01-20;0;0;0;0
FR;4;2021-01-21;0;0;0;0
FR;4;2021-01-22;0;0;0;0
FR;4;2021-01-23;0;0;0;0
FR;4;2021-01-24;0;0;0;0
FR;4;2021-01-25;0;0;0;0
FR;4;2021-01-26;0;0;0;0
FR;4;2021-01-27;0;0;0;0
FR;4;2021-01-28;0;0;0;0
FR;4;2021-01-29;0;0;0;0
FR;4;2021-01-30;0;0;0;0
FR;4;2021-01-31;0;0;0;0
FR;4;2021-02-01;0;0;0;0
FR;4;2021-02-02;0;0;0;0
FR;4;2021-02-03;0;0;0;0
FR;4;2021-02-04;0;0;0;0
FR;4;2021-02-05;0;0;0;0
FR;4;2021-02-06;0;0;0;0
FR;4;2021-02-07;0;0;0;0
FR;4;2021-02-08;0;0;0;0
FR;4;2021-02-09;0;0;0;0
FR;4;2021-02-10;0;0;0;0
FR;4;2021-02-11;0;0;0;0
FR;4;2021-02-12;0;0;0;0
FR;4;2021-02-13;0;0;0;0
FR;4;2021-02-14;0;0;0;0
FR;4;2021-02-15;0;0;0;0
FR;4;2021-02-16;0;0;0;0
FR;4;2021-02-17;0;0;0;0
FR;4;2021-02-18;0;0;0;0
FR;4;2021-02-19;0;0;0;0
FR;4;2021-02-20;0;0;0;0
FR;4;2021-02-21;0;0;0;0
FR;4;2021-02-22;0;0;0;0
FR;4;2021-02-23;0;0;0;0
FR;4;2021-02-24;0;0;0;0
FR;4;2021-02-25;0;0;0;0
FR;4;2021-02-26;0;0;0;0
FR;4;2021-02-27;0;0;0;0
FR;4;2021-02-28;0;0;0;0
FR;4;2021-03-01;0;0;0;0
FR;4;2021-03-02;0;0;0;0
FR;4;2021-03-03;0;0;0;0
FR;4;2021-03-04;0;0;0;0
FR;4;2021-03-05;0;0;0;0
FR;4;2021-03-06;0;0;0;0
FR;4;2021-03-07;0;0;0;0
FR;4;2021-03-08;0;0;0;0
FR;4;2021-03-09;0;0;0;0
FR;4;2021-03-10;0;0;0;0
FR;4;2021-03-11;0;0;0;0
FR;4;2021-03-12;0;0;0;0
FR;4;2021-03-13;0;0;0;0
FR;4;2021-03-14;0;0;0;0
FR;4;2021-03-15;0;0;0;0
FR;4;2021-03-16;0;0;0;0
FR;4;2021-03-17;0;0;0;0
FR;4;2021-03-18;0;0;0;0
FR;4;2021-03-19;0;0;0;0
FR;4;2021-03-20;0;0;0;0
FR;4;2021-03-21;0;0;0;0
FR;4;2021-03-22;0;0;0;0
FR;4;2021-03-23;0;0;0;0
FR;4;2021-03-24;0;0;0;0
FR;4;2021-03-25;0;0;0;0
FR;4;2021-03-26;0;0;0;0
FR;4;2021-03-27;0;0;0;0
FR;4;2021-03-28;0;0;0;0
FR;4;2021-03-29;0;0;0;0
FR;4;2021-03-30;0;0;0;0
FR;4;2021-03-31;0;0;0;0
FR;4;2021-04-01;0;0;0;0
FR;4;2021-04-02;0;0;0;0
FR;4;2021-04-03;0;0;0;0
FR;4;2021-04-04;0;0;0;0
FR;4;2021-04-05;0;0;0;0
FR;4;2021-04-06;0;0;0;0
FR;4;2021-04-07;0;0;0;0
FR;4;2021-04-08;0;0;0;0
FR;4;2021-04-09;0;0;0;0
FR;4;2021-04-10;0;0;0;0
FR;4;2021-04-11;0;0;0;0
FR;4;2021-04-12;0;0;0;0
FR;4;2021-04-13;0;0;0;0
FR;4;2021-04-14;0;0;0;0
FR;4;2021-04-15;0;0;0;0
FR;4;2021-04-16;0;0;0;0
FR;4;2021-04-17;0;0;0;0
FR;4;2021-04-18;0;0;0;0
FR;4;2021-04-19;0;0;0;0
FR;4;2021-04-20;0;0;0;0
FR;4;2021-04-21;0;0;0;0
FR;4;2021-04-22;0;0;0;0
FR;4;2021-04-23;745;0;745;0
FR;4;2021-04-24;1552;0;2297;0
FR;4;2021-04-25;117;0;2414;0
FR;4;2021-04-26;2828;0;5242;0
FR;4;2021-04-27;9361;3;14603;3
FR;4;2021-04-28;9755;3;24358;6
FR;4;2021-04-29;15871;7;40229;13
FR;4;2021-04-30;19066;7;59295;20
FR;4;2021-05-01;1894;5;61189;25
FR;4;2021-05-02;440;0;61629;25
FR;4;2021-05-03;4924;1;66553;26
FR;4;2021-05-04;8245;8;74798;34
FR;4;2021-05-05;5997;7;80795;41
FR;4;2021-05-06;11251;11;92046;52
FR;4;2021-05-07;18899;8;110945;60
FR;4;2021-05-08;2252;4;113197;64
FR;4;2021-05-09;629;2;113826;66
FR;4;2021-05-10;7082;13;120908;79
FR;4;2021-05-11;14098;12;135006;91
FR;4;2021-05-12;9938;14;144944;105
FR;4;2021-05-13;1440;3;146384;108
FR;4;2021-05-14;7574;8;153958;116
FR;4;2021-05-15;3575;9;157533;125
FR;4;2021-05-16;352;1;157885;126
FR;4;2021-05-17;4244;2;162129;128
FR;4;2021-05-18;8549;10;170678;138
FR;4;2021-05-19;5504;5;176182;143
FR;4;2021-05-20;9170;7;185352;150
FR;4;2021-05-21;12500;25;197852;175
FR;4;2021-05-22;4920;13;202772;188
FR;4;2021-05-23;419;2;203191;190
FR;4;2021-05-24;932;3;204123;193
FR;4;2021-05-25;7370;16;211493;209
FR;4;2021-05-26;7519;12;219012;221
FR;4;2021-05-27;14040;34;233052;255
FR;4;2021-05-28;26174;74;259226;329
FR;4;2021-05-29;11085;18;270311;347
FR;4;2021-05-30;859;2;271170;349
FR;4;2021-05-31;12388;19;283558;368
FR;4;2021-06-01;19691;40;303249;408
FR;4;2021-06-02;14075;33;317324;441
FR;4;2021-06-03;18969;23;336293;464
FR;4;2021-06-04;21777;45;358070;509
FR;4;2021-06-05;9172;27;367242;536
FR;4;2021-06-06;869;0;368111;536
FR;4;2021-06-07;8521;15;376632;551
FR;0;2020-12-27;20;0;20;0
FR;0;2020-12-28;69;0;89;0
FR;0;2020-12-29;108;0;197;0
FR;0;2020-12-30;121;0;318;0
FR;0;2020-12-31;85;0;403;0
FR;0;2021-01-01;68;0;471;0
FR;0;2021-01-02;88;0;559;0
FR;0;2021-01-03;90;0;649;0
FR;0;2021-01-04;1478;0;2127;0
FR;0;2021-01-05;5395;0;7522;0
FR;0;2021-01-06;11297;0;18819;0
FR;0;2021-01-07;28559;0;47378;0
FR;0;2021-01-08;36235;0;83613;0
FR;0;2021-01-09;10922;0;94535;0
FR;0;2021-01-10;5620;0;100155;0
FR;0;2021-01-11;38989;0;139144;0
FR;0;2021-01-12;60865;0;200009;0
FR;0;2021-01-13;63761;0;263770;0
FR;0;2021-01-14;79867;0;343637;0
FR;0;2021-01-15;67490;0;411127;0
FR;0;2021-01-16;19710;78;430837;78
FR;0;2021-01-17;10469;42;441306;120
FR;0;2021-01-18;84380;163;525686;283
FR;0;2021-01-19;128444;127;654130;410
FR;0;2021-01-20;135171;159;789301;569
FR;0;2021-01-21;155384;135;944685;704
FR;0;2021-01-22;118626;162;1063311;866
FR;0;2021-01-23;37810;50;1101121;916
FR;0;2021-01-24;9365;27;1110486;943
FR;0;2021-01-25;76834;1218;1187320;2161
FR;0;2021-01-26;98813;3110;1286133;5271
FR;0;2021-01-27;105666;5597;1391799;10868
FR;0;2021-01-28;122350;14360;1514149;25228
FR;0;2021-01-29;90884;17292;1605033;42520
FR;0;2021-01-30;28647;4225;1633680;46745
FR;0;2021-01-31;4871;1679;1638551;48424
FR;0;2021-02-01;51590;21128;1690141;69552
FR;0;2021-02-02;70708;34568;1760849;104120
FR;0;2021-02-03;70994;36960;1831843;141080
FR;0;2021-02-04;80592;50060;1912435;191140
FR;0;2021-02-05;67120;45341;1979555;236481
FR;0;2021-02-06;21335;10399;2000890;246880
FR;0;2021-02-07;4823;5041;2005713;251921
FR;0;2021-02-08;45889;45993;2051602;297914
FR;0;2021-02-09;64907;72407;2116509;370321
FR;0;2021-02-10;69239;76695;2185748;447016
FR;0;2021-02-11;85631;99144;2271379;546160
FR;0;2021-02-12;77700;74276;2349079;620436
FR;0;2021-02-13;21662;19492;2370741;639928
FR;0;2021-02-14;4583;7190;2375324;647118
FR;0;2021-02-15;37041;76507;2412365;723625
FR;0;2021-02-16;49193;100746;2461558;824371
FR;0;2021-02-17;49297;102971;2510855;927342
FR;0;2021-02-18;67924;118563;2578779;1045905
FR;0;2021-02-19;63754;90736;2642533;1136641
FR;0;2021-02-20;17960;28429;2660493;1165070
FR;0;2021-02-21;2859;6373;2663352;1171443
FR;0;2021-02-22;36469;73138;2699821;1244581
FR;0;2021-02-23;52613;84058;2752434;1328639
FR;0;2021-02-24;58004;81130;2810438;1409769
FR;0;2021-02-25;98536;91420;2908974;1501189
FR;0;2021-02-26;111676;71013;3020650;1572202
FR;0;2021-02-27;51122;21980;3071772;1594182
FR;0;2021-02-28;5675;4414;3077447;1598596
FR;0;2021-03-01;63589;52804;3141036;1651400
FR;0;2021-03-02;99338;66246;3240374;1717646
FR;0;2021-03-03;113582;65551;3353956;1783197
FR;0;2021-03-04;160329;68881;3514285;1852078
FR;0;2021-03-05;197832;63393;3712117;1915471
FR;0;2021-03-06;204849;17824;3916966;1933295
FR;0;2021-03-07;119716;5481;4036682;1938776
FR;0;2021-03-08;104803;50808;4141485;1989584
FR;0;2021-03-09;169589;56778;4311074;2046362
FR;0;2021-03-10;175619;57215;4486693;2103577
FR;0;2021-03-11;239372;63118;4726065;2166695
FR;0;2021-03-12;290938;53506;5017003;2220201
FR;0;2021-03-13;228230;15284;5245233;2235485
FR;0;2021-03-14;62121;3437;5307354;2238922
FR;0;2021-03-15;155754;32673;5463108;2271595
FR;0;2021-03-16;139245;39541;5602353;2311136
FR;0;2021-03-17;148000;38826;5750353;2349962
FR;0;2021-03-18;164983;44664;5915336;2394626
FR;0;2021-03-19;226513;37486;6141849;2432112
FR;0;2021-03-20;164456;11787;6306305;2443899
FR;0;2021-03-21;48727;2628;6355032;2446527
FR;0;2021-03-22;167038;34300;6522070;2480827
FR;0;2021-03-23;246551;42406;6768621;2523233
FR;0;2021-03-24;253125;43869;7021746;2567102
FR;0;2021-03-25;337308;44754;7359054;2611856
FR;0;2021-03-26;354495;41911;7713549;2653767
FR;0;2021-03-27;192866;16653;7906415;2670420
FR;0;2021-03-28;58314;3737;7964729;2674157
FR;0;2021-03-29;200294;54310;8165023;2728467
FR;0;2021-03-30;281766;69686;8446789;2798153
FR;0;2021-03-31;259320;72951;8706109;2871104
FR;0;2021-04-01;309905;87852;9016014;2958956
FR;0;2021-04-02;277539;92127;9293553;3051083
FR;0;2021-04-03;139062;61876;9432615;3112959
FR;0;2021-04-04;44863;18665;9477478;3131624
FR;0;2021-04-05;58763;11009;9536241;3142633
FR;0;2021-04-06;213243;107897;9749484;3250530
FR;0;2021-04-07;256136;115503;10005620;3366033
FR;0;2021-04-08;332548;121458;10338168;3487491
FR;0;2021-04-09;404487;116530;10742655;3604021
FR;0;2021-04-10;209995;82763;10952650;3686784
FR;0;2021-04-11;54957;34603;11007607;3721387
FR;0;2021-04-12;233664;115247;11241271;3836634
FR;0;2021-04-13;304891;144998;11546162;3981632
FR;0;2021-04-14;289277;139445;11835439;4121077
FR;0;2021-04-15;331454;147886;12166893;4268963
FR;0;2021-04-16;334515;145795;12501408;4414758
FR;0;2021-04-17;185968;90278;12687376;4505036
FR;0;2021-04-18;50411;35432;12737787;4540468
FR;0;2021-04-19;202422;138428;12940209;4678896
FR;0;2021-04-20;250315;170790;13190524;4849686
FR;0;2021-04-21;248918;168873;13439442;5018559
FR;0;2021-04-22;282672;188302;13722114;5206861
FR;0;2021-04-23;290339;183307;14012453;5390168
FR;0;2021-04-24;187963;111605;14200416;5501773
FR;0;2021-04-25;68380;38887;14268796;5540660
FR;0;2021-04-26;217697;156140;14486493;5696800
FR;0;2021-04-27;280326;187562;14766819;5884362
FR;0;2021-04-28;294522;183253;15061341;6067615
FR;0;2021-04-29;351812;196193;15413153;6263808
FR;0;2021-04-30;366613;184897;15779766;6448705
FR;0;2021-05-01;163175;52554;15942941;6501259
FR;0;2021-05-02;89841;37847;16032782;6539106
FR;0;2021-05-03;282500;169755;16315282;6708861
FR;0;2021-05-04;308982;224394;16624264;6933255
FR;0;2021-05-05;318666;224597;16942930;7157852
FR;0;2021-05-06;371982;239281;17314912;7397133
FR;0;2021-05-07;366017;257422;17680929;7654555
FR;0;2021-05-08;209197;66946;17890126;7721501
FR;0;2021-05-09;127465;46785;18017591;7768286
FR;0;2021-05-10;303724;229088;18321315;7997374
FR;0;2021-05-11;395857;258282;18717172;8255656
FR;0;2021-05-12;421887;233332;19139059;8488988
FR;0;2021-05-13;331054;56935;19470113;8545923
FR;0;2021-05-14;442660;167644;19912773;8713567
FR;0;2021-05-15;365841;94070;20278614;8807637
FR;0;2021-05-16;199307;20844;20477921;8828481
FR;0;2021-05-17;368242;149255;20846163;8977736
FR;0;2021-05-18;446570;153314;21292733;9131050
FR;0;2021-05-19;455926;145514;21748659;9276564
FR;0;2021-05-20;494431;160541;22243090;9437105
FR;0;2021-05-21;476396;174761;22719486;9611866
FR;0;2021-05-22;340915;80025;23060401;9691891
FR;0;2021-05-23;158425;14491;23218826;9706382
FR;0;2021-05-24;256637;33336;23475463;9739718
FR;0;2021-05-25;390373;189518;23865836;9929236
FR;0;2021-05-26;397630;188364;24263466;10117600
FR;0;2021-05-27;438263;218969;24701729;10336569
FR;0;2021-05-28;417894;259883;25119623;10596452
FR;0;2021-05-29;293591;149568;25413214;10746020
FR;0;2021-05-30;104347;32671;25517561;10778691
FR;0;2021-05-31;349814;203731;25867375;10982422
FR;0;2021-06-01;410967;251900;26278342;11234322
FR;0;2021-06-02;397387;231192;26675729;11465514
FR;0;2021-06-03;448172;258937;27123901;11724451
FR;0;2021-06-04;438203;305094;27562104;12029545
FR;0;2021-06-05;296142;189208;27858246;12218753
FR;0;2021-06-06;128354;49178;27986600;12267931
FR;0;2021-06-07;323971;262673;28310571;12530604
