fra;vaccin;jour;n_dose1;n_dose2;n_cum_dose1;n_cum_dose2
FR;1;2020-12-27;20;0;20;0
FR;1;2020-12-28;71;0;91;0
FR;1;2020-12-29;108;0;199;0
FR;1;2020-12-30;123;0;322;0
FR;1;2020-12-31;88;0;410;0
FR;1;2021-01-01;75;0;485;0
FR;1;2021-01-02;90;0;575;0
FR;1;2021-01-03;92;0;667;0
FR;1;2021-01-04;1481;0;2148;0
FR;1;2021-01-05;5420;0;7568;0
FR;1;2021-01-06;11328;0;18896;0
FR;1;2021-01-07;28671;0;47567;0
FR;1;2021-01-08;36333;0;83900;0
FR;1;2021-01-09;10950;0;94850;0
FR;1;2021-01-10;5648;0;100498;0
FR;1;2021-01-11;39151;0;139649;0
FR;1;2021-01-12;61070;0;200719;0
FR;1;2021-01-13;63975;0;264694;0
FR;1;2021-01-14;79956;0;344650;0
FR;1;2021-01-15;67429;0;412079;0
FR;1;2021-01-16;19583;87;431662;87
FR;1;2021-01-17;10481;42;442143;129
FR;1;2021-01-18;81635;164;523778;293
FR;1;2021-01-19;124156;128;647934;421
FR;1;2021-01-20;130523;160;778457;581
FR;1;2021-01-21;150542;141;928999;722
FR;1;2021-01-22;114075;163;1043074;885
FR;1;2021-01-23;36156;52;1079230;937
FR;1;2021-01-24;9275;28;1088505;965
FR;1;2021-01-25;73331;1219;1161836;2184
FR;1;2021-01-26;95211;3113;1257047;5297
FR;1;2021-01-27;102348;5598;1359395;10895
FR;1;2021-01-28;119039;14361;1478434;25256
FR;1;2021-01-29;87933;17293;1566367;42549
FR;1;2021-01-30;27641;4225;1594008;46774
FR;1;2021-01-31;4881;1679;1598889;48453
FR;1;2021-02-01;48390;21128;1647279;69581
FR;1;2021-02-02;66468;34568;1713747;104149
FR;1;2021-02-03;66052;36961;1779799;141110
FR;1;2021-02-04;75976;50059;1855775;191169
FR;1;2021-02-05;62618;45336;1918393;236505
FR;1;2021-02-06;19096;10396;1937489;246901
FR;1;2021-02-07;3435;5041;1940924;251942
FR;1;2021-02-08;35892;45986;1976816;297928
FR;1;2021-02-09;49983;72393;2026799;370321
FR;1;2021-02-10;50983;76646;2077782;446967
FR;1;2021-02-11;62339;99077;2140121;546044
FR;1;2021-02-12;55001;74039;2195122;620083
FR;1;2021-02-13;15189;19270;2210311;639353
FR;1;2021-02-14;3433;7190;2213744;646543
FR;1;2021-02-15;23608;73440;2237352;719983
FR;1;2021-02-16;32159;96865;2269511;816848
FR;1;2021-02-17;34460;98569;2303971;915417
FR;1;2021-02-18;48306;113473;2352277;1028890
FR;1;2021-02-19;44559;86414;2396836;1115304
FR;1;2021-02-20;13079;26920;2409915;1142224
FR;1;2021-02-21;2121;6287;2412036;1148511
FR;1;2021-02-22;24137;69415;2436173;1217926
FR;1;2021-02-23;36761;80366;2472934;1298292
FR;1;2021-02-24;39506;77662;2512440;1375954
FR;1;2021-02-25;49153;87994;2561593;1463948
FR;1;2021-02-26;46250;67888;2607843;1531836
FR;1;2021-02-27;15252;20931;2623095;1552767
FR;1;2021-02-28;3236;4386;2626331;1557153
FR;1;2021-03-01;38815;49031;2665146;1606184
FR;1;2021-03-02;54792;61506;2719938;1667690
FR;1;2021-03-03;59703;60652;2779641;1728342
FR;1;2021-03-04;71408;64895;2851049;1793237
FR;1;2021-03-05;73342;59275;2924391;1852512
FR;1;2021-03-06;81486;16094;3005877;1868606
FR;1;2021-03-07;63009;5424;3068886;1874030
FR;1;2021-03-08;58950;42480;3127836;1916510
FR;1;2021-03-09;84611;48318;3212447;1964828
FR;1;2021-03-10;89227;48068;3301674;2012896
FR;1;2021-03-11;103448;53865;3405122;2066761
FR;1;2021-03-12;102367;45269;3507489;2112030
FR;1;2021-03-13;87913;12721;3595402;2124751
FR;1;2021-03-14;43756;3031;3639158;2127782
FR;1;2021-03-15;94064;29153;3733222;2156935
FR;1;2021-03-16;122146;34908;3855368;2191843
FR;1;2021-03-17;127769;34869;3983137;2226712
FR;1;2021-03-18;141237;39756;4124374;2266468
FR;1;2021-03-19;134534;32914;4258908;2299382
FR;1;2021-03-20;75094;10212;4334002;2309594
FR;1;2021-03-21;25785;2477;4359787;2312071
FR;1;2021-03-22;113123;31191;4472910;2343262
FR;1;2021-03-23;141212;38175;4614122;2381437
FR;1;2021-03-24;140113;38791;4754235;2420228
FR;1;2021-03-25;163073;39620;4917308;2459848
FR;1;2021-03-26;164541;37500;5081849;2497348
FR;1;2021-03-27;109994;15260;5191843;2512608
FR;1;2021-03-28;41744;3624;5233587;2516232
FR;1;2021-03-29;128504;49970;5362091;2566202
FR;1;2021-03-30;165866;63598;5527957;2629800
FR;1;2021-03-31;169126;66916;5697083;2696716
FR;1;2021-04-01;191559;79256;5888642;2775972
FR;1;2021-04-02;162572;84318;6051214;2860290
FR;1;2021-04-03;87223;58188;6138437;2918478
FR;1;2021-04-04;32355;17733;6170792;2936211
FR;1;2021-04-05;42445;10178;6213237;2946389
FR;1;2021-04-06;157928;100891;6371165;3047280
FR;1;2021-04-07;194455;108272;6565620;3155552
FR;1;2021-04-08;219054;112406;6784674;3267958
FR;1;2021-04-09;211875;107520;6996549;3375478
FR;1;2021-04-10;116007;73465;7112556;3448943
FR;1;2021-04-11;40053;30288;7152609;3479231
FR;1;2021-04-12;166665;103798;7319274;3583029
FR;1;2021-04-13;201371;128263;7520645;3711292
FR;1;2021-04-14;205708;122820;7726353;3834112
FR;1;2021-04-15;218474;126766;7944827;3960878
FR;1;2021-04-16;204019;125155;8148846;4086033
FR;1;2021-04-17;121022;67490;8269868;4153523
FR;1;2021-04-18;35241;20997;8305109;4174520
FR;1;2021-04-19;161953;121934;8467062;4296454
FR;1;2021-04-20;187222;148803;8654284;4445257
FR;1;2021-04-21;191703;146761;8845987;4592018
FR;1;2021-04-22;206477;162651;9052464;4754669
FR;1;2021-04-23;196817;156941;9249281;4911610
FR;1;2021-04-24;125049;95520;9374330;5007130
FR;1;2021-04-25;52893;30144;9427223;5037274
FR;1;2021-04-26;179317;138282;9606540;5175556
FR;1;2021-04-27;219160;162011;9825700;5337567
FR;1;2021-04-28;236192;155141;10061892;5492708
FR;1;2021-04-29;267691;160093;10329583;5652801
FR;1;2021-04-30;269420;148181;10599003;5800982
FR;1;2021-05-01;138365;40718;10737368;5841700
FR;1;2021-05-02;80458;28166;10817826;5869866
FR;1;2021-05-03;247361;146549;11065187;6016415
FR;1;2021-05-04;262706;186878;11327893;6203293
FR;1;2021-05-05;279355;184602;11607248;6387895
FR;1;2021-05-06;305785;183073;11913033;6570968
FR;1;2021-05-07;280963;195759;12193996;6766727
FR;1;2021-05-08;189182;48341;12383178;6815068
FR;1;2021-05-09;113141;36234;12496319;6851302
FR;1;2021-05-10;253475;194293;12749794;7045595
FR;1;2021-05-11;315180;211459;13064974;7257054
FR;1;2021-05-12;351696;185959;13416670;7443013
FR;1;2021-05-13;279315;47676;13695985;7490689
FR;1;2021-05-14;366145;128940;14062130;7619629
FR;1;2021-05-15;293694;66173;14355824;7685802
FR;1;2021-05-16;156231;15588;14512055;7701390
FR;1;2021-05-17;315020;116747;14827075;7818137
FR;1;2021-05-18;375609;111413;15202684;7929550
FR;1;2021-05-19;389470;103009;15592154;8032559
FR;1;2021-05-20;414212;96415;16006366;8128974
FR;1;2021-05-21;393126;97510;16399492;8226484
FR;1;2021-05-22;272084;42185;16671576;8268669
FR;1;2021-05-23;121342;11247;16792918;8279916
FR;1;2021-05-24;239737;26380;17032655;8306296
FR;1;2021-05-25;359406;132081;17392061;8438377
FR;1;2021-05-26;371490;125827;17763551;8564204
FR;1;2021-05-27;399819;128416;18163370;8692620
FR;1;2021-05-28;360163;145712;18523533;8838332
FR;1;2021-05-29;250758;81075;18774291;8919407
FR;1;2021-05-30;99177;22615;18873468;8942022
FR;1;2021-05-31;309533;148953;19183001;9090975
FR;1;2021-06-01;346526;166966;19529527;9257941
FR;1;2021-06-02;348481;153481;19878008;9411422
FR;1;2021-06-03;378757;147921;20256765;9559343
FR;1;2021-06-04;351775;175815;20608540;9735158
FR;1;2021-06-05;253294;112882;20861834;9848040
FR;1;2021-06-06;123346;37572;20985180;9885612
FR;1;2021-06-07;291245;208366;21276425;10093978
FR;1;2021-06-08;320201;221261;21596626;10315239
FR;1;2021-06-09;326560;212840;21923186;10528079
FR;1;2021-06-10;328986;202527;22252172;10730606
FR;1;2021-06-11;302701;235689;22554873;10966295
FR;1;2021-06-12;238508;150979;22793381;11117274
FR;1;2021-06-13;97486;61133;22890867;11178407
FR;1;2021-06-14;198356;289338;23089223;11467745
FR;1;2021-06-15;245144;282753;23334367;11750498
FR;1;2021-06-16;264338;270778;23598705;12021276
FR;1;2021-06-17;259585;244698;23858290;12265974
FR;1;2021-06-18;249574;296339;24107864;12562313
FR;1;2021-06-19;188829;209828;24296693;12772141
FR;1;2021-06-20;67317;89251;24364010;12861392
FR;1;2021-06-21;164522;320347;24528532;13181739
FR;1;2021-06-22;177924;347998;24706456;13529737
FR;1;2021-06-23;195707;339764;24902163;13869501
FR;1;2021-06-24;193312;282096;25095475;14151597
FR;1;2021-06-25;173081;372298;25268556;14523895
FR;1;2021-06-26;127167;278658;25395723;14802553
FR;1;2021-06-27;50678;123116;25446401;14925669
FR;2;2020-12-27;0;0;0;0
FR;2;2020-12-28;0;0;0;0
FR;2;2020-12-29;0;0;0;0
FR;2;2020-12-30;0;0;0;0
FR;2;2020-12-31;0;0;0;0
FR;2;2021-01-01;0;0;0;0
FR;2;2021-01-02;0;0;0;0
FR;2;2021-01-03;0;0;0;0
FR;2;2021-01-04;0;0;0;0
FR;2;2021-01-05;0;0;0;0
FR;2;2021-01-06;0;0;0;0
FR;2;2021-01-07;0;0;0;0
FR;2;2021-01-08;0;0;0;0
FR;2;2021-01-09;0;0;0;0
FR;2;2021-01-10;0;0;0;0
FR;2;2021-01-11;0;0;0;0
FR;2;2021-01-12;0;0;0;0
FR;2;2021-01-13;0;0;0;0
FR;2;2021-01-14;152;0;152;0
FR;2;2021-01-15;218;0;370;0
FR;2;2021-01-16;186;0;556;0
FR;2;2021-01-17;3;0;559;0
FR;2;2021-01-18;2915;0;3474;0
FR;2;2021-01-19;4519;0;7993;0
FR;2;2021-01-20;4922;0;12915;0
FR;2;2021-01-21;5128;0;18043;0
FR;2;2021-01-22;4882;0;22925;0
FR;2;2021-01-23;1734;0;24659;0
FR;2;2021-01-24;102;0;24761;0
FR;2;2021-01-25;3636;0;28397;0
FR;2;2021-01-26;3752;0;32149;0
FR;2;2021-01-27;3443;0;35592;0
FR;2;2021-01-28;3514;0;39106;0
FR;2;2021-01-29;3083;0;42189;0
FR;2;2021-01-30;1064;0;43253;0
FR;2;2021-01-31;0;0;43253;0
FR;2;2021-02-01;3260;0;46513;0
FR;2;2021-02-02;4309;0;50822;0
FR;2;2021-02-03;5032;0;55854;0
FR;2;2021-02-04;4735;4;60589;4
FR;2;2021-02-05;4621;6;65210;10
FR;2;2021-02-06;1932;3;67142;13
FR;2;2021-02-07;42;0;67184;13
FR;2;2021-02-08;7428;8;74612;21
FR;2;2021-02-09;8258;16;82870;37
FR;2;2021-02-10;9142;49;92012;86
FR;2;2021-02-11;10060;67;102072;153
FR;2;2021-02-12;9815;238;111887;391
FR;2;2021-02-13;3017;222;114904;613
FR;2;2021-02-14;296;0;115200;613
FR;2;2021-02-15;3359;3067;118559;3680
FR;2;2021-02-16;4910;3881;123469;7561
FR;2;2021-02-17;4107;4403;127576;11964
FR;2;2021-02-18;5242;5089;132818;17053
FR;2;2021-02-19;5215;4323;138033;21376
FR;2;2021-02-20;1764;1509;139797;22885
FR;2;2021-02-21;199;86;139996;22971
FR;2;2021-02-22;3532;3723;143528;26694
FR;2;2021-02-23;4837;3693;148365;30387
FR;2;2021-02-24;4772;3468;153137;33855
FR;2;2021-02-25;5293;3426;158430;37281
FR;2;2021-02-26;4198;3125;162628;40406
FR;2;2021-02-27;1503;1042;164131;41448
FR;2;2021-02-28;100;28;164231;41476
FR;2;2021-03-01;4964;3764;169195;45240
FR;2;2021-03-02;6311;4727;175506;49967
FR;2;2021-03-03;6247;4883;181753;54850
FR;2;2021-03-04;8075;3967;189828;58817
FR;2;2021-03-05;7771;4060;197599;62877
FR;2;2021-03-06;4621;1682;202220;64559
FR;2;2021-03-07;2284;29;204504;64588
FR;2;2021-03-08;3977;8311;208481;72899
FR;2;2021-03-09;7271;8429;215752;81328
FR;2;2021-03-10;6863;9109;222615;90437
FR;2;2021-03-11;9091;9209;231706;99646
FR;2;2021-03-12;7723;8171;239429;107817
FR;2;2021-03-13;9873;2511;249302;110328
FR;2;2021-03-14;4755;402;254057;110730
FR;2;2021-03-15;10653;3484;264710;114214
FR;2;2021-03-16;16459;4621;281169;118835
FR;2;2021-03-17;19904;3952;301073;122787
FR;2;2021-03-18;22963;4910;324036;127697
FR;2;2021-03-19;22891;4538;346927;132235
FR;2;2021-03-20;25155;1540;372082;133775
FR;2;2021-03-21;17476;147;389558;133922
FR;2;2021-03-22;17407;3078;406965;137000
FR;2;2021-03-23;22273;4183;429238;141183
FR;2;2021-03-24;23558;4988;452796;146171
FR;2;2021-03-25;26286;5022;479082;151193
FR;2;2021-03-26;26595;4262;505677;155455
FR;2;2021-03-27;15640;1309;521317;156764
FR;2;2021-03-28;10397;94;531714;156858
FR;2;2021-03-29;18660;4281;550374;161139
FR;2;2021-03-30;24181;6002;574555;167141
FR;2;2021-03-31;28136;5958;602691;173099
FR;2;2021-04-01;33990;8496;636681;181595
FR;2;2021-04-02;29562;7662;666243;189257
FR;2;2021-04-03;16733;3582;682976;192839
FR;2;2021-04-04;9161;918;692137;193757
FR;2;2021-04-05;12125;811;704262;194568
FR;2;2021-04-06;26770;6933;731032;201501
FR;2;2021-04-07;30596;7174;761628;208675
FR;2;2021-04-08;36504;8818;798132;217493
FR;2;2021-04-09;33400;8602;831532;226095
FR;2;2021-04-10;19457;8969;850989;235064
FR;2;2021-04-11;7819;4272;858808;239336
FR;2;2021-04-12;16812;11254;875620;250590
FR;2;2021-04-13;19118;16426;894738;267016
FR;2;2021-04-14;17678;16285;912416;283301
FR;2;2021-04-15;21865;20757;934281;304058
FR;2;2021-04-16;20402;20073;954683;324131
FR;2;2021-04-17;13060;22462;967743;346593
FR;2;2021-04-18;5788;14405;973531;360998
FR;2;2021-04-19;16488;16263;990019;377261
FR;2;2021-04-20;18998;21595;1009017;398856
FR;2;2021-04-21;19833;21665;1028850;420521
FR;2;2021-04-22;23420;24863;1052270;445384
FR;2;2021-04-23;24221;25352;1076491;470736
FR;2;2021-04-24;25108;15111;1101599;485847
FR;2;2021-04-25;9499;8589;1111098;494436
FR;2;2021-04-26;16913;17196;1128011;511632
FR;2;2021-04-27;19025;24307;1147036;535939
FR;2;2021-04-28;22054;26188;1169090;562127
FR;2;2021-04-29;25211;30137;1194301;592264
FR;2;2021-04-30;25341;27782;1219642;620046
FR;2;2021-05-01;14799;9863;1234441;629909
FR;2;2021-05-02;6525;9184;1240966;639093
FR;2;2021-05-03;19656;19328;1260622;658421
FR;2;2021-05-04;18054;29057;1278676;687478
FR;2;2021-05-05;18004;29413;1296680;716891
FR;2;2021-05-06;23240;35291;1319920;752182
FR;2;2021-05-07;24884;33246;1344804;785428
FR;2;2021-05-08;21024;9705;1365828;795133
FR;2;2021-05-09;13033;7894;1378861;803027
FR;2;2021-05-10;32552;22221;1411413;825248
FR;2;2021-05-11;43179;21078;1454592;846326
FR;2;2021-05-12;49378;19907;1503970;866233
FR;2;2021-05-13;50794;5771;1554764;872004
FR;2;2021-05-14;60866;12956;1615630;884960
FR;2;2021-05-15;65476;7154;1681106;892114
FR;2;2021-05-16;43244;2576;1724350;894690
FR;2;2021-05-17;44208;12592;1768558;907282
FR;2;2021-05-18;53605;12256;1822163;919538
FR;2;2021-05-19;56334;10634;1878497;930172
FR;2;2021-05-20;62539;10900;1941036;941072
FR;2;2021-05-21;63364;11686;2004400;952758
FR;2;2021-05-22;60830;4527;2065230;957285
FR;2;2021-05-23;36991;577;2102221;957862
FR;2;2021-05-24;16854;2033;2119075;959895
FR;2;2021-05-25;20567;12244;2139642;972139
FR;2;2021-05-26;19111;11471;2158753;983610
FR;2;2021-05-27;22459;12672;2181212;996282
FR;2;2021-05-28;28800;14991;2210012;1011273
FR;2;2021-05-29;30004;8190;2240016;1019463
FR;2;2021-05-30;4477;1811;2244493;1021274
FR;2;2021-05-31;28088;18761;2272581;1040035
FR;2;2021-06-01;44510;20076;2317091;1060111
FR;2;2021-06-02;36520;19318;2353611;1079429
FR;2;2021-06-03;50326;23405;2403937;1102834
FR;2;2021-06-04;64443;24106;2468380;1126940
FR;2;2021-06-05;33854;24052;2502234;1150992
FR;2;2021-06-06;4730;6206;2506964;1157198
FR;2;2021-06-07;27516;23111;2534480;1180309
FR;2;2021-06-08;45344;22966;2579824;1203275
FR;2;2021-06-09;33513;20924;2613337;1224199
FR;2;2021-06-10;41405;19163;2654742;1243362
FR;2;2021-06-11;54259;25257;2709001;1268619
FR;2;2021-06-12;29926;19822;2738927;1288441
FR;2;2021-06-13;3113;9190;2742040;1297631
FR;2;2021-06-14;24640;24199;2766680;1321830
FR;2;2021-06-15;38191;22900;2804871;1344730
FR;2;2021-06-16;29486;21552;2834357;1366282
FR;2;2021-06-17;36109;25909;2870466;1392191
FR;2;2021-06-18;45849;28800;2916315;1420991
FR;2;2021-06-19;24036;24926;2940351;1445917
FR;2;2021-06-20;2593;10074;2942944;1455991
FR;2;2021-06-21;16770;42784;2959714;1498775
FR;2;2021-06-22;27629;49646;2987343;1548421
FR;2;2021-06-23;21064;49669;3008407;1598090
FR;2;2021-06-24;27472;50333;3035879;1648423
FR;2;2021-06-25;31764;60449;3067643;1708872
FR;2;2021-06-26;15596;59500;3083239;1768372
FR;2;2021-06-27;2347;29375;3085586;1797747
FR;3;2020-12-27;0;0;0;0
FR;3;2020-12-28;0;0;0;0
FR;3;2020-12-29;0;0;0;0
FR;3;2020-12-30;0;0;0;0
FR;3;2020-12-31;0;0;0;0
FR;3;2021-01-01;0;0;0;0
FR;3;2021-01-02;0;0;0;0
FR;3;2021-01-03;0;0;0;0
FR;3;2021-01-04;0;0;0;0
FR;3;2021-01-05;0;0;0;0
FR;3;2021-01-06;0;0;0;0
FR;3;2021-01-07;0;0;0;0
FR;3;2021-01-08;0;0;0;0
FR;3;2021-01-09;0;0;0;0
FR;3;2021-01-10;0;0;0;0
FR;3;2021-01-11;0;0;0;0
FR;3;2021-01-12;0;0;0;0
FR;3;2021-01-13;0;0;0;0
FR;3;2021-01-14;0;0;0;0
FR;3;2021-01-15;0;0;0;0
FR;3;2021-01-16;0;0;0;0
FR;3;2021-01-17;0;0;0;0
FR;3;2021-01-18;0;0;0;0
FR;3;2021-01-19;0;0;0;0
FR;3;2021-01-20;0;0;0;0
FR;3;2021-01-21;0;0;0;0
FR;3;2021-01-22;0;0;0;0
FR;3;2021-01-23;0;0;0;0
FR;3;2021-01-24;0;0;0;0
FR;3;2021-01-25;0;0;0;0
FR;3;2021-01-26;0;0;0;0
FR;3;2021-01-27;0;0;0;0
FR;3;2021-01-28;0;0;0;0
FR;3;2021-01-29;0;0;0;0
FR;3;2021-01-30;0;0;0;0
FR;3;2021-01-31;0;0;0;0
FR;3;2021-02-01;0;0;0;0
FR;3;2021-02-02;0;0;0;0
FR;3;2021-02-03;0;0;0;0
FR;3;2021-02-04;0;0;0;0
FR;3;2021-02-05;0;0;0;0
FR;3;2021-02-06;336;0;336;0
FR;3;2021-02-07;1348;0;1684;0
FR;3;2021-02-08;2635;0;4319;0
FR;3;2021-02-09;6649;0;10968;0
FR;3;2021-02-10;9250;0;20218;0
FR;3;2021-02-11;13372;0;33590;0
FR;3;2021-02-12;13068;0;46658;0
FR;3;2021-02-13;3520;0;50178;0
FR;3;2021-02-14;870;0;51048;0
FR;3;2021-02-15;10140;0;61188;0
FR;3;2021-02-16;12189;0;73377;0
FR;3;2021-02-17;10827;0;84204;0
FR;3;2021-02-18;14596;0;98800;0
FR;3;2021-02-19;14140;0;112940;0
FR;3;2021-02-20;3184;0;116124;0
FR;3;2021-02-21;548;0;116672;0
FR;3;2021-02-22;8930;0;125602;0
FR;3;2021-02-23;11127;0;136729;0
FR;3;2021-02-24;13926;0;150655;0
FR;3;2021-02-25;44472;0;195127;0
FR;3;2021-02-26;61484;0;256611;0
FR;3;2021-02-27;34521;8;291132;8
FR;3;2021-02-28;2354;0;293486;8
FR;3;2021-03-01;19968;9;313454;17
FR;3;2021-03-02;38381;14;351835;31
FR;3;2021-03-03;48019;17;399854;48
FR;3;2021-03-04;81387;22;481241;70
FR;3;2021-03-05;117271;60;598512;130
FR;3;2021-03-06;119562;51;718074;181
FR;3;2021-03-07;54693;28;772767;209
FR;3;2021-03-08;42217;20;814984;229
FR;3;2021-03-09;78209;31;893193;260
FR;3;2021-03-10;80054;38;973247;298
FR;3;2021-03-11;127465;47;1100712;345
FR;3;2021-03-12;181608;70;1282320;415
FR;3;2021-03-13;131301;56;1413621;471
FR;3;2021-03-14;13832;4;1427453;475
FR;3;2021-03-15;51586;37;1479039;512
FR;3;2021-03-16;945;13;1479984;525
FR;3;2021-03-17;682;6;1480666;531
FR;3;2021-03-18;1235;4;1481901;535
FR;3;2021-03-19;69846;36;1551747;571
FR;3;2021-03-20;64742;37;1616489;608
FR;3;2021-03-21;5540;4;1622029;612
FR;3;2021-03-22;37000;32;1659029;644
FR;3;2021-03-23;83922;50;1742951;694
FR;3;2021-03-24;90293;92;1833244;786
FR;3;2021-03-25;149267;114;1982511;900
FR;3;2021-03-26;164675;155;2147186;1055
FR;3;2021-03-27;67917;90;2215103;1145
FR;3;2021-03-28;6268;19;2221371;1164
FR;3;2021-03-29;53684;60;2275055;1224
FR;3;2021-03-30;92581;88;2367636;1312
FR;3;2021-03-31;62940;82;2430576;1394
FR;3;2021-04-01;85404;103;2515980;1497
FR;3;2021-04-02;86335;147;2602315;1644
FR;3;2021-04-03;35498;109;2637813;1753
FR;3;2021-04-04;3421;15;2641234;1768
FR;3;2021-04-05;4276;21;2645510;1789
FR;3;2021-04-06;29173;76;2674683;1865
FR;3;2021-04-07;31724;60;2706407;1925
FR;3;2021-04-08;78003;234;2784410;2159
FR;3;2021-04-09;160639;409;2945049;2568
FR;3;2021-04-10;74964;331;3020013;2899
FR;3;2021-04-11;7078;44;3027091;2943
FR;3;2021-04-12;50799;196;3077890;3139
FR;3;2021-04-13;85411;314;3163301;3453
FR;3;2021-04-14;66888;341;3230189;3794
FR;3;2021-04-15;92056;368;3322245;4162
FR;3;2021-04-16;111447;571;3433692;4733
FR;3;2021-04-17;52567;327;3486259;5060
FR;3;2021-04-18;9453;32;3495712;5092
FR;3;2021-04-19;24556;234;3520268;5326
FR;3;2021-04-20;44930;394;3565198;5720
FR;3;2021-04-21;38183;450;3603381;6170
FR;3;2021-04-22;53860;791;3657241;6961
FR;3;2021-04-23;69635;1018;3726876;7979
FR;3;2021-04-24;36592;975;3763468;8954
FR;3;2021-04-25;5926;154;3769394;9108
FR;3;2021-04-26;19140;662;3788534;9770
FR;3;2021-04-27;33760;1246;3822294;11016
FR;3;2021-04-28;28317;1926;3850611;12942
FR;3;2021-04-29;44623;5956;3895234;18898
FR;3;2021-04-30;54654;8932;3949888;27830
FR;3;2021-05-01;9188;1968;3959076;29798
FR;3;2021-05-02;2803;499;3961879;30297
FR;3;2021-05-03;12546;3881;3974425;34178
FR;3;2021-05-04;22485;8453;3996910;42631
FR;3;2021-05-05;18068;10575;4014978;53206
FR;3;2021-05-06;33902;20907;4048880;74113
FR;3;2021-05-07;43420;28409;4092300;102522
FR;3;2021-05-08;6373;8896;4098673;111418
FR;3;2021-05-09;1566;2655;4100239;114073
FR;3;2021-05-10;14443;12566;4114682;126639
FR;3;2021-05-11;26433;25735;4141115;152374
FR;3;2021-05-12;16740;27452;4157855;179826
FR;3;2021-05-13;2003;3486;4159858;183312
FR;3;2021-05-14;14083;25742;4173941;209054
FR;3;2021-05-15;6919;20734;4180860;229788
FR;3;2021-05-16;812;2679;4181672;232467
FR;3;2021-05-17;7515;19914;4189187;252381
FR;3;2021-05-18;12916;29635;4202103;282016
FR;3;2021-05-19;8818;31866;4210921;313882
FR;3;2021-05-20;12295;53220;4223216;367102
FR;3;2021-05-21;12274;65540;4235490;432642
FR;3;2021-05-22;4678;33300;4240168;465942
FR;3;2021-05-23;538;2665;4240706;468607
FR;3;2021-05-24;586;4920;4241292;473527
FR;3;2021-05-25;4967;45177;4246259;518704
FR;3;2021-05-26;4580;51054;4250839;569758
FR;3;2021-05-27;5949;77847;4256788;647605
FR;3;2021-05-28;7155;99107;4263943;746712
FR;3;2021-05-29;3074;60285;4267017;806997
FR;3;2021-05-30;382;8243;4267399;815240
FR;3;2021-05-31;2065;35999;4269464;851239
FR;3;2021-06-01;2973;64818;4272437;916057
FR;3;2021-06-02;2373;58360;4274810;974417
FR;3;2021-06-03;3182;87589;4277992;1062006
FR;3;2021-06-04;3851;105128;4281843;1167134
FR;3;2021-06-05;1776;52247;4283619;1219381
FR;3;2021-06-06;262;5400;4283881;1224781
FR;3;2021-06-07;1100;31183;4284981;1255964
FR;3;2021-06-08;1723;47286;4286704;1303250
FR;3;2021-06-09;1435;42397;4288139;1345647
FR;3;2021-06-10;1840;68013;4289979;1413660
FR;3;2021-06-11;2208;96812;4292187;1510472
FR;3;2021-06-12;1005;40842;4293192;1551314
FR;3;2021-06-13;138;3823;4293330;1555137
FR;3;2021-06-14;749;42671;4294079;1597808
FR;3;2021-06-15;1175;80708;4295254;1678516
FR;3;2021-06-16;1043;65788;4296297;1744304
FR;3;2021-06-17;1441;101860;4297738;1846164
FR;3;2021-06-18;1712;117939;4299450;1964103
FR;3;2021-06-19;699;39409;4300149;2003512
FR;3;2021-06-20;76;3384;4300225;2006896
FR;3;2021-06-21;557;39294;4300782;2046190
FR;3;2021-06-22;894;70028;4301676;2116218
FR;3;2021-06-23;754;50857;4302430;2167075
FR;3;2021-06-24;1140;77227;4303570;2244302
FR;3;2021-06-25;1218;89985;4304788;2334287
FR;3;2021-06-26;508;33140;4305296;2367427
FR;3;2021-06-27;90;4029;4305386;2371456
FR;4;2020-12-27;0;0;0;0
FR;4;2020-12-28;0;0;0;0
FR;4;2020-12-29;0;0;0;0
FR;4;2020-12-30;0;0;0;0
FR;4;2020-12-31;0;0;0;0
FR;4;2021-01-01;0;0;0;0
FR;4;2021-01-02;0;0;0;0
FR;4;2021-01-03;0;0;0;0
FR;4;2021-01-04;0;0;0;0
FR;4;2021-01-05;0;0;0;0
FR;4;2021-01-06;0;0;0;0
FR;4;2021-01-07;0;0;0;0
FR;4;2021-01-08;0;0;0;0
FR;4;2021-01-09;0;0;0;0
FR;4;2021-01-10;0;0;0;0
FR;4;2021-01-11;0;0;0;0
FR;4;2021-01-12;0;0;0;0
FR;4;2021-01-13;0;0;0;0
FR;4;2021-01-14;0;0;0;0
FR;4;2021-01-15;0;0;0;0
FR;4;2021-01-16;0;0;0;0
FR;4;2021-01-17;0;0;0;0
FR;4;2021-01-18;0;0;0;0
FR;4;2021-01-19;0;0;0;0
FR;4;2021-01-20;0;0;0;0
FR;4;2021-01-21;0;0;0;0
FR;4;2021-01-22;0;0;0;0
FR;4;2021-01-23;0;0;0;0
FR;4;2021-01-24;0;0;0;0
FR;4;2021-01-25;0;0;0;0
FR;4;2021-01-26;0;0;0;0
FR;4;2021-01-27;0;0;0;0
FR;4;2021-01-28;0;0;0;0
FR;4;2021-01-29;0;0;0;0
FR;4;2021-01-30;0;0;0;0
FR;4;2021-01-31;0;0;0;0
FR;4;2021-02-01;0;0;0;0
FR;4;2021-02-02;0;0;0;0
FR;4;2021-02-03;0;0;0;0
FR;4;2021-02-04;0;0;0;0
FR;4;2021-02-05;0;0;0;0
FR;4;2021-02-06;0;0;0;0
FR;4;2021-02-07;0;0;0;0
FR;4;2021-02-08;0;0;0;0
FR;4;2021-02-09;0;0;0;0
FR;4;2021-02-10;0;0;0;0
FR;4;2021-02-11;0;0;0;0
FR;4;2021-02-12;0;0;0;0
FR;4;2021-02-13;0;0;0;0
FR;4;2021-02-14;0;0;0;0
FR;4;2021-02-15;0;0;0;0
FR;4;2021-02-16;0;0;0;0
FR;4;2021-02-17;0;0;0;0
FR;4;2021-02-18;0;0;0;0
FR;4;2021-02-19;0;0;0;0
FR;4;2021-02-20;0;0;0;0
FR;4;2021-02-21;0;0;0;0
FR;4;2021-02-22;0;0;0;0
FR;4;2021-02-23;0;0;0;0
FR;4;2021-02-24;0;0;0;0
FR;4;2021-02-25;0;0;0;0
FR;4;2021-02-26;0;0;0;0
FR;4;2021-02-27;0;0;0;0
FR;4;2021-02-28;0;0;0;0
FR;4;2021-03-01;0;0;0;0
FR;4;2021-03-02;0;0;0;0
FR;4;2021-03-03;0;0;0;0
FR;4;2021-03-04;0;0;0;0
FR;4;2021-03-05;0;0;0;0
FR;4;2021-03-06;0;0;0;0
FR;4;2021-03-07;0;0;0;0
FR;4;2021-03-08;0;0;0;0
FR;4;2021-03-09;0;0;0;0
FR;4;2021-03-10;0;0;0;0
FR;4;2021-03-11;0;0;0;0
FR;4;2021-03-12;0;0;0;0
FR;4;2021-03-13;0;0;0;0
FR;4;2021-03-14;0;0;0;0
FR;4;2021-03-15;0;0;0;0
FR;4;2021-03-16;0;0;0;0
FR;4;2021-03-17;0;0;0;0
FR;4;2021-03-18;0;0;0;0
FR;4;2021-03-19;0;0;0;0
FR;4;2021-03-20;0;0;0;0
FR;4;2021-03-21;0;0;0;0
FR;4;2021-03-22;0;0;0;0
FR;4;2021-03-23;0;0;0;0
FR;4;2021-03-24;0;0;0;0
FR;4;2021-03-25;0;0;0;0
FR;4;2021-03-26;0;0;0;0
FR;4;2021-03-27;0;0;0;0
FR;4;2021-03-28;0;0;0;0
FR;4;2021-03-29;0;0;0;0
FR;4;2021-03-30;0;0;0;0
FR;4;2021-03-31;0;0;0;0
FR;4;2021-04-01;0;0;0;0
FR;4;2021-04-02;0;0;0;0
FR;4;2021-04-03;0;0;0;0
FR;4;2021-04-04;0;0;0;0
FR;4;2021-04-05;0;0;0;0
FR;4;2021-04-06;0;0;0;0
FR;4;2021-04-07;0;0;0;0
FR;4;2021-04-08;0;0;0;0
FR;4;2021-04-09;0;1;0;1
FR;4;2021-04-10;0;0;0;1
FR;4;2021-04-11;0;0;0;1
FR;4;2021-04-12;0;0;0;1
FR;4;2021-04-13;0;0;0;1
FR;4;2021-04-14;0;0;0;1
FR;4;2021-04-15;0;0;0;1
FR;4;2021-04-16;0;0;0;1
FR;4;2021-04-17;0;0;0;1
FR;4;2021-04-18;0;0;0;1
FR;4;2021-04-19;0;0;0;1
FR;4;2021-04-20;0;0;0;1
FR;4;2021-04-21;0;0;0;1
FR;4;2021-04-22;0;0;0;1
FR;4;2021-04-23;826;0;826;1
FR;4;2021-04-24;1552;0;2378;1
FR;4;2021-04-25;117;0;2495;1
FR;4;2021-04-26;2832;0;5327;1
FR;4;2021-04-27;9389;4;14716;5
FR;4;2021-04-28;9783;3;24499;8
FR;4;2021-04-29;15893;7;40392;15
FR;4;2021-04-30;19087;7;59479;22
FR;4;2021-05-01;1901;5;61380;27
FR;4;2021-05-02;440;0;61820;27
FR;4;2021-05-03;4928;1;66748;28
FR;4;2021-05-04;8251;8;74999;36
FR;4;2021-05-05;6010;7;81009;43
FR;4;2021-05-06;11260;11;92269;54
FR;4;2021-05-07;18913;8;111182;62
FR;4;2021-05-08;2260;6;113442;68
FR;4;2021-05-09;630;2;114072;70
FR;4;2021-05-10;7098;8;121170;78
FR;4;2021-05-11;14129;12;135299;90
FR;4;2021-05-12;9968;14;145267;104
FR;4;2021-05-13;1445;2;146712;106
FR;4;2021-05-14;7598;8;154310;114
FR;4;2021-05-15;3594;9;157904;123
FR;4;2021-05-16;359;1;158263;124
FR;4;2021-05-17;4352;2;162615;126
FR;4;2021-05-18;8591;10;171206;136
FR;4;2021-05-19;5519;5;176725;141
FR;4;2021-05-20;9230;6;185955;147
FR;4;2021-05-21;12527;27;198482;174
FR;4;2021-05-22;4929;13;203411;187
FR;4;2021-05-23;426;2;203837;189
FR;4;2021-05-24;941;3;204778;192
FR;4;2021-05-25;7400;16;212178;208
FR;4;2021-05-26;7558;12;219736;220
FR;4;2021-05-27;14106;34;233842;254
FR;4;2021-05-28;26266;77;260108;331
FR;4;2021-05-29;11145;20;271253;351
FR;4;2021-05-30;859;2;272112;353
FR;4;2021-05-31;12440;19;284552;372
FR;4;2021-06-01;19830;40;304382;412
FR;4;2021-06-02;14218;33;318600;445
FR;4;2021-06-03;19161;22;337761;467
FR;4;2021-06-04;22119;45;359880;512
FR;4;2021-06-05;9487;27;369367;539
FR;4;2021-06-06;919;0;370286;539
FR;4;2021-06-07;8917;15;379203;554
FR;4;2021-06-08;14295;26;393498;580
FR;4;2021-06-09;11904;24;405402;604
FR;4;2021-06-10;15011;25;420413;629
FR;4;2021-06-11;16613;51;437026;680
FR;4;2021-06-12;7220;26;444246;706
FR;4;2021-06-13;830;8;445076;714
FR;4;2021-06-14;6411;22;451487;736
FR;4;2021-06-15;10604;32;462091;768
FR;4;2021-06-16;8605;13;470696;781
FR;4;2021-06-17;10566;27;481262;808
FR;4;2021-06-18;12048;39;493310;847
FR;4;2021-06-19;5357;25;498667;872
FR;4;2021-06-20;585;2;499252;874
FR;4;2021-06-21;4789;8;504041;882
FR;4;2021-06-22;7580;18;511621;900
FR;4;2021-06-23;6748;27;518369;927
FR;4;2021-06-24;8261;28;526630;955
FR;4;2021-06-25;9512;34;536142;989
FR;4;2021-06-26;4385;14;540527;1003
FR;4;2021-06-27;529;2;541056;1005
FR;0;2020-12-27;20;0;20;0
FR;0;2020-12-28;71;0;91;0
FR;0;2020-12-29;108;0;199;0
FR;0;2020-12-30;123;0;322;0
FR;0;2020-12-31;88;0;410;0
FR;0;2021-01-01;75;0;485;0
FR;0;2021-01-02;90;0;575;0
FR;0;2021-01-03;92;0;667;0
FR;0;2021-01-04;1481;0;2148;0
FR;0;2021-01-05;5420;0;7568;0
FR;0;2021-01-06;11328;0;18896;0
FR;0;2021-01-07;28671;0;47567;0
FR;0;2021-01-08;36333;0;83900;0
FR;0;2021-01-09;10950;0;94850;0
FR;0;2021-01-10;5648;0;100498;0
FR;0;2021-01-11;39151;0;139649;0
FR;0;2021-01-12;61070;0;200719;0
FR;0;2021-01-13;63975;0;264694;0
FR;0;2021-01-14;80108;0;344802;0
FR;0;2021-01-15;67647;0;412449;0
FR;0;2021-01-16;19769;87;432218;87
FR;0;2021-01-17;10484;42;442702;129
FR;0;2021-01-18;84550;164;527252;293
FR;0;2021-01-19;128675;128;655927;421
FR;0;2021-01-20;135445;160;791372;581
FR;0;2021-01-21;155670;141;947042;722
FR;0;2021-01-22;118957;163;1065999;885
FR;0;2021-01-23;37890;52;1103889;937
FR;0;2021-01-24;9377;28;1113266;965
FR;0;2021-01-25;76967;1219;1190233;2184
FR;0;2021-01-26;98963;3113;1289196;5297
FR;0;2021-01-27;105791;5598;1394987;10895
FR;0;2021-01-28;122553;14361;1517540;25256
FR;0;2021-01-29;91016;17293;1608556;42549
FR;0;2021-01-30;28705;4225;1637261;46774
FR;0;2021-01-31;4881;1679;1642142;48453
FR;0;2021-02-01;51650;21128;1693792;69581
FR;0;2021-02-02;70777;34568;1764569;104149
FR;0;2021-02-03;71084;36961;1835653;141110
FR;0;2021-02-04;80711;50063;1916364;191173
FR;0;2021-02-05;67239;45342;1983603;236515
FR;0;2021-02-06;21364;10399;2004967;246914
FR;0;2021-02-07;4825;5041;2009792;251955
FR;0;2021-02-08;45955;45994;2055747;297949
FR;0;2021-02-09;64890;72409;2120637;370358
FR;0;2021-02-10;69375;76695;2190012;447053
FR;0;2021-02-11;85771;99144;2275783;546197
FR;0;2021-02-12;77884;74277;2353667;620474
FR;0;2021-02-13;21726;19492;2375393;639966
FR;0;2021-02-14;4599;7190;2379992;647156
FR;0;2021-02-15;37107;76507;2417099;723663
FR;0;2021-02-16;49258;100746;2466357;824409
FR;0;2021-02-17;49394;102972;2515751;927381
FR;0;2021-02-18;68144;118562;2583895;1045943
FR;0;2021-02-19;63914;90737;2647809;1136680
FR;0;2021-02-20;18027;28429;2665836;1165109
FR;0;2021-02-21;2868;6373;2668704;1171482
FR;0;2021-02-22;36599;73138;2705303;1244620
FR;0;2021-02-23;52725;84059;2758028;1328679
FR;0;2021-02-24;58204;81130;2816232;1409809
FR;0;2021-02-25;98918;91420;2915150;1501229
FR;0;2021-02-26;111932;71013;3027082;1572242
FR;0;2021-02-27;51276;21981;3078358;1594223
FR;0;2021-02-28;5690;4414;3084048;1598637
FR;0;2021-03-01;63747;52804;3147795;1651441
FR;0;2021-03-02;99484;66247;3247279;1717688
FR;0;2021-03-03;113969;65552;3361248;1783240
FR;0;2021-03-04;160870;68884;3522118;1852124
FR;0;2021-03-05;198384;63395;3720502;1915519
FR;0;2021-03-06;205669;17827;3926171;1933346
FR;0;2021-03-07;119986;5481;4046157;1938827
FR;0;2021-03-08;105144;50811;4151301;1989638
FR;0;2021-03-09;170091;56778;4321392;2046416
FR;0;2021-03-10;176144;57215;4497536;2103631
FR;0;2021-03-11;240004;63121;4737540;2166752
FR;0;2021-03-12;291698;53510;5029238;2220262
FR;0;2021-03-13;229087;15288;5258325;2235550
FR;0;2021-03-14;62343;3437;5320668;2238987
FR;0;2021-03-15;156303;32674;5476971;2271661
FR;0;2021-03-16;139550;39542;5616521;2311203
FR;0;2021-03-17;148355;38827;5764876;2350030
FR;0;2021-03-18;165435;44670;5930311;2394700
FR;0;2021-03-19;227271;37488;6157582;2432188
FR;0;2021-03-20;164991;11789;6322573;2443977
FR;0;2021-03-21;48801;2628;6371374;2446605
FR;0;2021-03-22;167530;34301;6538904;2480906
FR;0;2021-03-23;247407;42408;6786311;2523314
FR;0;2021-03-24;253964;43871;7040275;2567185
FR;0;2021-03-25;338626;44756;7378901;2611941
FR;0;2021-03-26;355811;41917;7734712;2653858
FR;0;2021-03-27;193551;16659;7928263;2670517
FR;0;2021-03-28;58409;3737;7986672;2674254
FR;0;2021-03-29;200848;54311;8187520;2728565
FR;0;2021-03-30;282628;69688;8470148;2798253
FR;0;2021-03-31;260202;72956;8730350;2871209
FR;0;2021-04-01;310953;87855;9041303;2959064
FR;0;2021-04-02;278469;92127;9319772;3051191
FR;0;2021-04-03;139454;61879;9459226;3113070
FR;0;2021-04-04;44937;18666;9504163;3131736
FR;0;2021-04-05;58846;11010;9563009;3142746
FR;0;2021-04-06;213871;107900;9776880;3250646
FR;0;2021-04-07;256775;115506;10033655;3366152
FR;0;2021-04-08;333561;121458;10367216;3487610
FR;0;2021-04-09;405914;116532;10773130;3604142
FR;0;2021-04-10;210428;82765;10983558;3686907
FR;0;2021-04-11;54950;34604;11038508;3721511
FR;0;2021-04-12;234276;115248;11272784;3836759
FR;0;2021-04-13;305900;145003;11578684;3981762
FR;0;2021-04-14;290274;139446;11868958;4121208
FR;0;2021-04-15;332395;147891;12201353;4269099
FR;0;2021-04-16;335868;145799;12537221;4414898
FR;0;2021-04-17;186649;90279;12723870;4505177
FR;0;2021-04-18;50482;35434;12774352;4540611
FR;0;2021-04-19;202997;138431;12977349;4679042
FR;0;2021-04-20;251150;170792;13228499;4849834
FR;0;2021-04-21;249719;168876;13478218;5018710
FR;0;2021-04-22;283757;188305;13761975;5207015
FR;0;2021-04-23;291499;183311;14053474;5390326
FR;0;2021-04-24;188301;111606;14241775;5501932
FR;0;2021-04-25;68435;38887;14310210;5540819
FR;0;2021-04-26;218202;156140;14528412;5696959
FR;0;2021-04-27;281334;187568;14809746;5884527
FR;0;2021-04-28;296346;183258;15106092;6067785
FR;0;2021-04-29;353418;196193;15459510;6263978
FR;0;2021-04-30;368502;184902;15828012;6448880
FR;0;2021-05-01;164253;52554;15992265;6501434
FR;0;2021-05-02;90226;37849;16082491;6539283
FR;0;2021-05-03;284491;169759;16366982;6709042
FR;0;2021-05-04;311496;224396;16678478;6933438
FR;0;2021-05-05;321437;224597;16999915;7158035
FR;0;2021-05-06;374187;239282;17374102;7397317
FR;0;2021-05-07;368180;257422;17742282;7654739
FR;0;2021-05-08;218839;66948;17961121;7721687
FR;0;2021-05-09;128370;46785;18089491;7768472
FR;0;2021-05-10;307568;229088;18397059;7997560
FR;0;2021-05-11;398921;258284;18795980;8255844
FR;0;2021-05-12;427782;233332;19223762;8489176
FR;0;2021-05-13;333557;56935;19557319;8546111
FR;0;2021-05-14;448692;167646;20006011;8713757
FR;0;2021-05-15;369683;94070;20375694;8807827
FR;0;2021-05-16;200646;20844;20576340;8828671
FR;0;2021-05-17;371095;149255;20947435;8977926
FR;0;2021-05-18;450721;153314;21398156;9131240
FR;0;2021-05-19;460141;145514;21858297;9276754
FR;0;2021-05-20;498276;160541;22356573;9437295
FR;0;2021-05-21;481291;174763;22837864;9612058
FR;0;2021-05-22;342521;80025;23180385;9692083
FR;0;2021-05-23;159297;14491;23339682;9706574
FR;0;2021-05-24;258118;33336;23597800;9739910
FR;0;2021-05-25;392340;189518;23990140;9929428
FR;0;2021-05-26;402739;188364;24392879;10117792
FR;0;2021-05-27;442333;218969;24835212;10336761
FR;0;2021-05-28;422384;259887;25257596;10596648
FR;0;2021-05-29;294981;149570;25552577;10746218
FR;0;2021-05-30;104895;32671;25657472;10778889
FR;0;2021-05-31;352126;203732;26009598;10982621
FR;0;2021-06-01;413839;251900;26423437;11234521
FR;0;2021-06-02;401592;231192;26825029;11465713
FR;0;2021-06-03;451426;258937;27276455;11724650
FR;0;2021-06-04;442188;305094;27718643;12029744
FR;0;2021-06-05;298411;189208;28017054;12218952
FR;0;2021-06-06;129257;49178;28146311;12268130
FR;0;2021-06-07;328778;262675;28475089;12530805
FR;0;2021-06-08;381563;291539;28856652;12822344
FR;0;2021-06-09;373412;276185;29230064;13098529
FR;0;2021-06-10;387242;289728;29617306;13388257
FR;0;2021-06-11;375781;357809;29993087;13746066
FR;0;2021-06-12;276659;211669;30269746;13957735
FR;0;2021-06-13;101567;74154;30371313;14031889
FR;0;2021-06-14;230156;356230;30601469;14388119
FR;0;2021-06-15;295114;386393;30896583;14774512
FR;0;2021-06-16;303472;358131;31200055;15132643
FR;0;2021-06-17;307701;372494;31507756;15505137
FR;0;2021-06-18;309183;443117;31816939;15948254
FR;0;2021-06-19;218921;274188;32035860;16222442
FR;0;2021-06-20;70571;102711;32106431;16325153
FR;0;2021-06-21;186638;402433;32293069;16727586
FR;0;2021-06-22;214027;467690;32507096;17195276
FR;0;2021-06-23;224273;440317;32731369;17635593
FR;0;2021-06-24;230185;409684;32961554;18045277
FR;0;2021-06-25;215575;522766;33177129;18568043
FR;0;2021-06-26;147656;371312;33324785;18939355
FR;0;2021-06-27;53644;156522;33378429;19095877
