fra;vaccin;jour;n_dose1;n_dose2;n_dose3;n_dose4;n_complet;n_rappel;n_2_rappel;n_rappel_biv;n_3_rappel;n_cum_dose1;n_cum_dose2;n_cum_dose3;n_cum_dose4;n_cum_complet;n_cum_rappel;n_cum_2_rappel;n_cum_rappel_biv;n_cum_3_rappel
FR;1;2020-12-27;616;0;0;0;55;0;0;0;0;616;0;0;0;55;0;0;0;0
FR;1;2020-12-28;710;1;0;0;44;0;0;0;0;1326;1;0;0;99;0;0;0;0
FR;1;2020-12-29;389;0;0;0;19;0;0;0;0;1715;1;0;0;118;0;0;0;0
FR;1;2020-12-30;456;0;0;0;20;0;0;0;0;2171;1;0;0;138;0;0;0;0
FR;1;2020-12-31;451;1;0;0;21;0;0;0;0;2622;2;0;0;159;0;0;0;0
FR;1;2021-01-01;1199;2;0;0;66;0;0;0;0;3821;4;0;0;225;0;0;0;0
FR;1;2021-01-02;370;4;0;0;29;0;0;0;0;4191;8;0;0;254;0;0;0;0
FR;1;2021-01-03;419;0;0;0;23;0;0;0;0;4610;8;0;0;277;0;0;0;0
FR;1;2021-01-04;2152;5;0;0;51;0;0;0;0;6762;13;0;0;328;0;0;0;0
FR;1;2021-01-05;7794;6;0;0;128;0;0;0;0;14556;19;0;0;456;0;0;0;0
FR;1;2021-01-06;12491;23;0;0;128;0;0;0;0;27047;42;0;0;584;0;0;0;0
FR;1;2021-01-07;29480;24;0;0;159;0;0;0;0;56527;66;0;0;743;0;0;0;0
FR;1;2021-01-08;37170;36;0;0;205;0;0;0;0;93697;102;0;0;948;0;0;0;0
FR;1;2021-01-09;11221;9;0;0;77;0;0;0;0;104918;111;0;0;1025;0;0;0;0
FR;1;2021-01-10;6017;8;0;0;28;0;0;0;0;110935;119;0;0;1053;0;0;0;0
FR;1;2021-01-11;39956;39;0;0;232;0;0;0;0;150891;158;0;0;1285;0;0;0;0
FR;1;2021-01-12;62165;31;0;0;299;0;0;0;0;213056;189;0;0;1584;0;0;0;0
FR;1;2021-01-13;65150;62;0;0;433;0;0;0;0;278206;251;0;0;2017;0;0;0;0
FR;1;2021-01-14;81473;263;0;0;958;0;0;0;0;359679;514;0;0;2975;0;0;0;0
FR;1;2021-01-15;68641;103;1;0;527;0;0;0;0;428320;617;1;0;3502;0;0;0;0
FR;1;2021-01-16;19903;73;0;0;171;0;0;0;0;448223;690;1;0;3673;0;0;0;0
FR;1;2021-01-17;10909;54;0;0;130;0;0;0;0;459132;744;1;0;3803;0;0;0;0
FR;1;2021-01-18;82849;176;0;0;587;0;0;0;0;541981;920;1;0;4390;0;0;0;0
FR;1;2021-01-19;125934;209;0;0;837;0;0;0;0;667915;1129;1;0;5227;0;0;0;0
FR;1;2021-01-20;132440;191;0;0;779;0;0;0;0;800355;1320;1;0;6006;0;0;0;0
FR;1;2021-01-21;153089;196;0;0;896;0;0;0;0;953444;1516;1;0;6902;0;0;0;0
FR;1;2021-01-22;115971;240;0;0;776;0;0;0;0;1069415;1756;1;0;7678;0;0;0;0
FR;1;2021-01-23;36619;84;0;0;207;0;0;0;0;1106034;1840;1;0;7885;0;0;0;0
FR;1;2021-01-24;9589;129;0;0;188;0;0;0;0;1115623;1969;1;0;8073;0;0;0;0
FR;1;2021-01-25;74443;1454;0;0;1771;0;0;0;0;1190066;3423;1;0;9844;0;0;0;0
FR;1;2021-01-26;96471;3706;1;0;4147;0;0;0;0;1286537;7129;2;0;13991;0;0;0;0
FR;1;2021-01-27;103660;6442;0;0;7126;0;0;0;0;1390197;13571;2;0;21117;0;0;0;0
FR;1;2021-01-28;120627;16418;0;0;17205;0;0;0;0;1510824;29989;2;0;38322;0;0;0;0
FR;1;2021-01-29;88904;18797;0;0;19338;0;0;0;0;1599728;48786;2;0;57660;0;0;0;0
FR;1;2021-01-30;27995;4538;0;0;4662;0;0;0;0;1627723;53324;2;0;62322;0;0;0;0
FR;1;2021-01-31;5194;1898;0;0;1936;0;0;0;0;1632917;55222;2;0;64258;0;0;0;0
FR;1;2021-02-01;49753;23049;0;0;23292;0;0;0;0;1682670;78271;2;0;87550;0;0;0;0
FR;1;2021-02-02;67839;38220;0;0;38678;0;0;0;0;1750509;116491;2;0;126228;0;0;0;0
FR;1;2021-02-03;67106;40292;0;0;40727;0;0;0;0;1817615;156783;2;0;166955;0;0;0;0
FR;1;2021-02-04;77159;55134;0;0;55704;0;0;0;0;1894774;211917;2;0;222659;0;0;0;0
FR;1;2021-02-05;63435;48239;0;0;48644;0;0;0;0;1958209;260156;2;0;271303;0;0;0;0
FR;1;2021-02-06;19428;11421;0;0;11528;0;0;0;0;1977637;271577;2;0;282831;0;0;0;0
FR;1;2021-02-07;3669;6072;0;0;6099;0;0;0;0;1981306;277649;2;0;288930;0;0;0;0
FR;1;2021-02-08;36508;48790;0;0;49044;0;0;0;0;2017814;326439;2;0;337974;0;0;0;0
FR;1;2021-02-09;50830;78448;0;0;78975;0;0;0;0;2068644;404887;2;0;416949;0;0;0;0
FR;1;2021-02-10;52088;83483;0;0;83967;0;0;0;0;2120732;488370;2;0;500916;0;0;0;0
FR;1;2021-02-11;63397;105597;0;0;106507;0;0;0;0;2184129;593967;2;0;607423;0;0;0;0
FR;1;2021-02-12;55889;75802;0;0;76488;0;0;0;0;2240018;669769;2;0;683911;0;0;0;0
FR;1;2021-02-13;15470;19308;0;0;19420;0;0;0;0;2255488;689077;2;0;703331;0;0;0;0
FR;1;2021-02-14;3747;7312;0;0;7378;0;0;0;0;2259235;696389;2;0;710709;0;0;0;0
FR;1;2021-02-15;24175;73669;0;0;73928;0;0;0;0;2283410;770058;2;0;784637;0;0;0;0
FR;1;2021-02-16;32788;95521;0;0;95936;0;0;0;0;2316198;865579;2;0;880573;0;0;0;0
FR;1;2021-02-17;35142;102378;20;0;103037;0;0;0;0;2351340;967957;22;0;983610;0;0;0;0
FR;1;2021-02-18;49466;118606;0;0;119603;0;0;0;0;2400806;1086563;22;0;1103213;0;0;0;0
FR;1;2021-02-19;45400;87834;1;0;88778;0;0;0;0;2446206;1174397;23;0;1191991;0;0;0;0
FR;1;2021-02-20;13398;27027;0;0;27203;0;0;0;0;2459604;1201424;23;0;1219194;0;0;0;0
FR;1;2021-02-21;2471;5942;0;0;6010;0;0;0;0;2462075;1207366;23;0;1225204;0;0;0;0
FR;1;2021-02-22;24726;69391;2;0;69692;0;0;0;0;2486801;1276757;25;0;1294896;0;0;0;0
FR;1;2021-02-23;37441;81550;1;0;82255;0;0;0;0;2524242;1358307;26;0;1377151;0;0;0;0
FR;1;2021-02-24;40717;79378;1;0;80078;0;0;0;0;2564959;1437685;27;0;1457229;0;0;0;0
FR;1;2021-02-25;50177;87702;1;0;88801;0;0;0;0;2615136;1525387;28;0;1546030;0;0;0;0
FR;1;2021-02-26;47235;67555;1;0;68444;0;0;0;0;2662371;1592942;29;0;1614474;0;0;0;0
FR;1;2021-02-27;15691;21359;1;0;21572;0;0;0;0;2678062;1614301;30;0;1636046;0;0;0;0
FR;1;2021-02-28;3566;4092;2;0;4165;0;0;0;0;2681628;1618393;32;0;1640211;0;0;0;0
FR;1;2021-03-01;40232;50296;1;0;51034;0;0;0;0;2721860;1668689;33;0;1691245;0;0;0;0
FR;1;2021-03-02;55997;62429;3;0;63609;0;0;0;0;2777857;1731118;36;0;1754854;0;0;0;0
FR;1;2021-03-03;61273;60500;0;0;61941;0;0;0;0;2839130;1791618;36;0;1816795;0;0;0;0
FR;1;2021-03-04;73023;68405;3;0;70624;0;0;0;0;2912153;1860023;39;0;1887419;0;0;0;0
FR;1;2021-03-05;74787;58606;3;0;60507;0;0;0;0;2986940;1918629;42;0;1947926;0;0;0;0
FR;1;2021-03-06;82476;15731;2;0;17440;0;0;0;0;3069416;1934360;44;0;1965366;0;0;0;0
FR;1;2021-03-07;63734;3914;1;0;5459;0;0;0;0;3133150;1938274;45;0;1970825;0;0;0;0
FR;1;2021-03-08;60200;41127;2;0;42415;0;0;0;0;3193350;1979401;47;0;2013240;0;0;0;0
FR;1;2021-03-09;86016;47359;1;0;49364;0;0;0;0;3279366;2026760;48;0;2062604;0;0;0;0
FR;1;2021-03-10;90951;47744;5;0;50018;0;0;0;0;3370317;2074504;53;0;2112622;0;0;0;0
FR;1;2021-03-11;105108;54606;1;0;57682;0;0;0;0;3475425;2129110;54;0;2170304;0;0;0;0
FR;1;2021-03-12;104169;44886;1;0;47884;0;0;0;0;3579594;2173996;55;0;2218188;0;0;0;0
FR;1;2021-03-13;89226;12578;1;0;14796;0;0;0;0;3668820;2186574;56;0;2232984;0;0;0;0
FR;1;2021-03-14;44463;2646;1;0;3979;0;0;0;0;3713283;2189220;57;0;2236963;0;0;0;0
FR;1;2021-03-15;95538;27933;3;0;30285;0;0;0;0;3808821;2217153;60;0;2267248;0;0;0;0
FR;1;2021-03-16;123608;34028;5;0;37576;0;0;0;0;3932429;2251181;65;0;2304824;0;0;0;0
FR;1;2021-03-17;129327;33512;4;0;37568;0;0;0;0;4061756;2284693;69;0;2342392;0;0;0;0
FR;1;2021-03-18;142921;39153;5;0;43831;0;0;0;0;4204677;2323846;74;0;2386223;0;0;0;0
FR;1;2021-03-19;136282;32010;2;0;36604;0;0;0;0;4340959;2355856;76;0;2422827;0;0;0;0
FR;1;2021-03-20;76028;9745;1;0;11962;0;0;0;0;4416987;2365601;77;0;2434789;0;0;0;0
FR;1;2021-03-21;26523;1967;1;0;2957;0;0;0;0;4443510;2367568;78;0;2437746;0;0;0;0
FR;1;2021-03-22;114783;30209;2;0;34042;0;0;0;0;4558293;2397777;80;0;2471788;0;0;0;0
FR;1;2021-03-23;143065;37994;1;0;42785;0;0;0;0;4701358;2435771;81;0;2514573;0;0;0;0
FR;1;2021-03-24;142031;38402;0;0;43276;0;0;0;0;4843389;2474173;81;0;2557849;0;0;0;0
FR;1;2021-03-25;165045;39883;4;0;46044;0;0;0;0;5008434;2514056;85;0;2603893;0;0;0;0
FR;1;2021-03-26;166426;37410;5;1;44031;0;0;0;0;5174860;2551466;90;1;2647924;0;0;0;0
FR;1;2021-03-27;110909;15481;1;0;19492;0;0;0;0;5285769;2566947;91;1;2667416;0;0;0;0
FR;1;2021-03-28;42317;4431;3;0;5986;0;0;0;0;5328086;2571378;94;1;2673402;0;0;0;0
FR;1;2021-03-29;129853;48967;4;0;53635;0;0;0;0;5457939;2620345;98;1;2727037;0;0;0;0
FR;1;2021-03-30;167768;63836;5;0;70849;0;0;0;0;5625707;2684181;103;1;2797886;0;0;0;0
FR;1;2021-03-31;170974;68022;4;0;75547;0;0;0;0;5796681;2752203;107;1;2873433;0;0;0;0
FR;1;2021-04-01;194890;84129;10;0;93639;0;0;0;0;5991571;2836332;117;1;2967072;0;0;0;0
FR;1;2021-04-02;164477;86902;7;0;94727;0;0;0;0;6156048;2923234;124;1;3061799;0;0;0;0
FR;1;2021-04-03;88262;58223;6;0;61772;0;0;0;0;6244310;2981457;130;1;3123571;0;0;0;0
FR;1;2021-04-04;33666;17734;0;0;19235;0;0;0;0;6277976;2999191;130;1;3142806;0;0;0;0
FR;1;2021-04-05;46433;9565;11;0;11442;0;0;0;0;6324409;3008756;141;1;3154248;0;0;0;0
FR;1;2021-04-06;160354;105686;17;0;112179;0;0;0;0;6484763;3114442;158;1;3266427;0;0;0;0
FR;1;2021-04-07;197044;108100;16;0;116940;0;0;0;0;6681807;3222542;174;1;3383367;0;0;0;0
FR;1;2021-04-08;222196;114357;14;0;125720;0;0;0;0;6904003;3336899;188;1;3509087;0;0;0;0
FR;1;2021-04-09;214625;108037;22;0;118937;0;0;0;0;7118628;3444936;210;1;3628024;0;0;0;0
FR;1;2021-04-10;117212;73243;14;0;78393;0;0;0;0;7235840;3518179;224;1;3706417;0;0;0;0
FR;1;2021-04-11;40903;29892;6;0;31796;0;0;0;0;7276743;3548071;230;1;3738213;0;0;0;0
FR;1;2021-04-12;168509;104585;46;0;111836;0;0;0;0;7445252;3652656;276;1;3850049;0;0;0;0
FR;1;2021-04-13;203857;127752;97;1;137100;0;0;0;0;7649109;3780408;373;2;3987149;0;0;0;0
FR;1;2021-04-14;208691;123038;208;0;133270;0;0;0;0;7857800;3903446;581;2;4120419;0;0;0;0
FR;1;2021-04-15;221751;128253;313;0;139303;0;0;0;0;8079551;4031699;894;2;4259722;0;0;0;0
FR;1;2021-04-16;206110;125774;309;0;135445;0;0;0;0;8285661;4157473;1203;2;4395167;0;0;0;0
FR;1;2021-04-17;122112;67118;103;0;72181;0;0;0;0;8407773;4224591;1306;2;4467348;0;0;0;0
FR;1;2021-04-18;35982;21015;42;0;22723;0;0;0;0;8443755;4245606;1348;2;4490071;0;0;0;0
FR;1;2021-04-19;163784;121619;433;0;129170;0;0;0;0;8607539;4367225;1781;2;4619241;0;0;0;0
FR;1;2021-04-20;189492;149802;531;0;158932;0;0;0;0;8797031;4517027;2312;2;4778173;0;0;0;0
FR;1;2021-04-21;194064;147783;761;0;157312;0;0;0;0;8991095;4664810;3073;2;4935485;0;0;0;0
FR;1;2021-04-22;209088;164624;779;0;175855;0;0;0;0;9200183;4829434;3852;2;5111340;0;0;0;0
FR;1;2021-04-23;198999;158150;671;0;169176;0;0;0;0;9399182;4987584;4523;2;5280516;0;0;0;0
FR;1;2021-04-24;126355;95889;148;0;101959;0;0;0;0;9525537;5083473;4671;2;5382475;0;0;0;0
FR;1;2021-04-25;53642;30084;46;0;32841;0;0;0;0;9579179;5113557;4717;2;5415316;0;0;0;0
FR;1;2021-04-26;181174;140330;543;0;149049;0;0;0;0;9760353;5253887;5260;2;5564365;0;0;0;0
FR;1;2021-04-27;221406;162637;901;0;174012;0;0;0;0;9981759;5416524;6161;2;5738377;0;0;0;0
FR;1;2021-04-28;238374;156221;1314;1;168904;1;0;0;0;10220133;5572745;7475;3;5907281;1;0;0;0
FR;1;2021-04-29;270354;161696;1211;0;177302;0;0;0;0;10490487;5734441;8686;3;6084583;1;0;0;0
FR;1;2021-04-30;272030;149049;1074;0;165148;0;0;0;0;10762517;5883490;9760;3;6249731;1;0;0;0
FR;1;2021-05-01;141180;40615;173;0;48643;0;0;0;0;10903697;5924105;9933;3;6298374;1;0;0;0
FR;1;2021-05-02;81564;28243;81;0;32999;0;0;0;0;10985261;5952348;10014;3;6331373;1;0;0;0
FR;1;2021-05-03;250829;142040;803;0;155734;0;0;0;0;11236090;6094388;10817;3;6487107;1;0;0;0
FR;1;2021-05-04;265939;188055;1204;0;203627;0;0;0;0;11502029;6282443;12021;3;6690734;1;0;0;0
FR;1;2021-05-05;283977;186328;1268;0;202991;0;0;0;0;11786006;6468771;13289;3;6893725;1;0;0;0
FR;1;2021-05-06;310084;184608;1502;0;204359;0;0;0;0;12096090;6653379;14791;3;7098084;1;0;0;0
FR;1;2021-05-07;284151;196767;1128;0;214583;0;0;0;0;12380241;6850146;15919;3;7312667;1;0;0;0
FR;1;2021-05-08;191687;51630;285;0;63013;0;0;0;0;12571928;6901776;16204;3;7375680;1;0;0;0
FR;1;2021-05-09;114076;34209;236;0;41381;0;0;0;0;12686004;6935985;16440;3;7417061;1;0;0;0
FR;1;2021-05-10;258240;195103;1188;0;211096;0;0;0;0;12944244;7131088;17628;3;7628157;1;0;0;0
FR;1;2021-05-11;318946;211267;1465;0;231506;0;0;0;0;13263190;7342355;19093;3;7859663;1;0;0;0
FR;1;2021-05-12;356713;186096;1402;0;208402;0;0;0;0;13619903;7528451;20495;3;8068065;1;0;0;0
FR;1;2021-05-13;283474;47324;401;0;64246;0;0;0;0;13903377;7575775;20896;3;8132311;1;0;0;0
FR;1;2021-05-14;370544;128528;998;0;151948;0;0;0;0;14273921;7704303;21894;3;8284259;1;0;0;0
FR;1;2021-05-15;298130;66209;404;0;84916;0;0;0;0;14572051;7770512;22298;3;8369175;1;0;0;0
FR;1;2021-05-16;157797;15471;158;0;26039;0;0;0;0;14729848;7785983;22456;3;8395214;1;0;0;0
FR;1;2021-05-17;318962;116204;1441;0;138167;0;0;0;0;15048810;7902187;23897;3;8533381;1;0;0;0
FR;1;2021-05-18;383395;111694;1801;0;137643;0;0;0;0;15432205;8013881;25698;3;8671024;1;0;0;0
FR;1;2021-05-19;395327;101588;2185;0;128523;0;0;0;0;15827532;8115469;27883;3;8799547;1;0;0;0
FR;1;2021-05-20;421862;95615;2049;0;125078;0;0;0;0;16249394;8211084;29932;3;8924625;1;0;0;0
FR;1;2021-05-21;399844;97456;1765;0;125853;0;0;0;0;16649238;8308540;31697;3;9050478;1;0;0;0
FR;1;2021-05-22;275713;41925;604;0;60948;0;0;0;0;16924951;8350465;32301;3;9111426;1;0;0;0
FR;1;2021-05-23;123034;10969;224;0;20572;0;0;0;0;17047985;8361434;32525;3;9131998;1;0;0;0
FR;1;2021-05-24;244028;26268;569;0;43793;0;0;0;0;17292013;8387702;33094;3;9175791;1;0;0;0
FR;1;2021-05-25;366248;131457;2115;1;158389;0;0;0;0;17658261;8519159;35209;4;9334180;1;0;0;0
FR;1;2021-05-26;380865;127553;1996;0;155877;0;0;0;0;18039126;8646712;37205;4;9490057;1;0;0;0
FR;1;2021-05-27;406209;128370;1978;0;158848;0;0;0;0;18445335;8775082;39183;4;9648905;1;0;0;0
FR;1;2021-05-28;366081;145711;1702;0;174273;0;0;0;0;18811416;8920793;40885;4;9823178;1;0;0;0
FR;1;2021-05-29;253851;81137;527;0;100334;0;0;0;0;19065267;9001930;41412;4;9923512;1;0;0;0
FR;1;2021-05-30;100983;22601;158;0;30834;0;0;0;0;19166250;9024531;41570;4;9954346;1;0;0;0
FR;1;2021-05-31;314351;149249;1287;1;172506;1;0;0;0;19480601;9173780;42857;5;10126852;2;0;0;0
FR;1;2021-06-01;361718;166427;1733;1;194131;1;0;0;0;19842319;9340207;44590;6;10320983;3;0;0;0
FR;1;2021-06-02;365450;154543;1798;0;184085;0;0;0;0;20207769;9494750;46388;6;10505068;3;0;0;0
FR;1;2021-06-03;391507;147435;1654;0;178407;0;0;0;0;20599276;9642185;48042;6;10683475;3;0;0;0
FR;1;2021-06-04;364148;175901;1496;1;205192;1;0;0;0;20963424;9818086;49538;7;10888667;4;0;0;0
FR;1;2021-06-05;258534;112822;597;0;133183;0;0;0;0;21221958;9930908;50135;7;11021850;4;0;0;0
FR;1;2021-06-06;126834;37555;216;0;48192;0;0;0;0;21348792;9968463;50351;7;11070042;4;0;0;0
FR;1;2021-06-07;301133;207764;1368;0;233040;0;0;0;0;21649925;10176227;51719;7;11303082;4;0;0;0
FR;1;2021-06-08;330916;221018;1645;0;248978;0;0;0;0;21980841;10397245;53364;7;11552060;4;0;0;0
FR;1;2021-06-09;336664;210941;1614;0;239698;0;0;0;0;22317505;10608186;54978;7;11791758;4;0;0;0
FR;1;2021-06-10;343949;199497;1615;0;229242;0;0;0;0;22661454;10807683;56593;7;12021000;4;0;0;0
FR;1;2021-06-11;311947;234702;1300;1;262614;0;0;0;0;22973401;11042385;57893;8;12283614;4;0;0;0
FR;1;2021-06-12;244101;150610;438;0;172218;0;0;0;0;23217502;11192995;58331;8;12455832;4;0;0;0
FR;1;2021-06-13;100383;61036;188;0;70698;0;0;0;0;23317885;11254031;58519;8;12526530;4;0;0;0
FR;1;2021-06-14;207885;287568;1320;1;307379;0;0;0;0;23525770;11541599;59839;9;12833909;4;0;0;0
FR;1;2021-06-15;256915;281113;1400;1;304961;0;0;0;0;23782685;11822712;61239;10;13138870;4;0;0;0
FR;1;2021-06-16;273687;270712;1264;1;296152;0;0;0;0;24056372;12093424;62503;11;13435022;4;0;0;0
FR;1;2021-06-17;268260;245100;1241;1;271172;0;0;0;0;24324632;12338524;63744;12;13706194;4;0;0;0
FR;1;2021-06-18;260626;295192;1156;2;321018;0;0;0;0;24585258;12633716;64900;14;14027212;4;0;0;0
FR;1;2021-06-19;193469;209608;388;0;228269;0;0;0;0;24778727;12843324;65288;14;14255481;4;0;0;0
FR;1;2021-06-20;69724;89029;122;0;96867;0;0;0;0;24848451;12932353;65410;14;14352348;4;0;0;0
FR;1;2021-06-21;172400;319785;934;1;338495;1;0;0;0;25020851;13252138;66344;15;14690843;5;0;0;0
FR;1;2021-06-22;185899;348088;1102;10;369157;1;0;0;0;25206750;13600226;67446;25;15060000;6;0;0;0
FR;1;2021-06-23;204245;339660;1050;0;363560;0;0;0;0;25410995;13939886;68496;25;15423560;6;0;0;0
FR;1;2021-06-24;203557;282109;1176;0;306855;0;0;0;0;25614552;14221995;69672;25;15730415;6;0;0;0
FR;1;2021-06-25;182687;371702;1200;0;395710;0;0;0;0;25797239;14593697;70872;25;16126125;6;0;0;0
FR;1;2021-06-26;131415;278612;506;0;295987;0;0;0;0;25928654;14872309;71378;25;16422112;6;0;0;0
FR;1;2021-06-27;52422;122845;146;0;130382;0;0;0;0;25981076;14995154;71524;25;16552494;6;0;0;0
FR;1;2021-06-28;136682;368243;1066;0;386844;0;0;0;0;26117758;15363397;72590;25;16939338;6;0;0;0
FR;1;2021-06-29;154930;391183;1849;0;412274;0;0;0;0;26272688;15754580;74439;25;17351612;6;0;0;0
FR;1;2021-06-30;180077;381967;1668;4;406564;2;0;0;0;26452765;16136547;76107;29;17758176;8;0;0;0
FR;1;2021-07-01;201593;332530;1890;5;360598;0;0;0;0;26654358;16469077;77997;34;18118774;8;0;0;0
FR;1;2021-07-02;193889;367288;1765;5;395482;2;0;0;0;26848247;16836365;79762;39;18514256;10;0;0;0
FR;1;2021-07-03;124485;280409;704;3;299514;1;0;0;0;26972732;17116774;80466;42;18813770;11;0;0;0
FR;1;2021-07-04;53970;113732;244;0;122138;0;0;0;0;27026702;17230506;80710;42;18935908;11;0;0;0
FR;1;2021-07-05;153987;355763;1500;8;379101;0;0;0;0;27180689;17586269;82210;50;19315009;11;0;0;0
FR;1;2021-07-06;173534;382277;1603;45;408164;8;0;0;0;27354223;17968546;83813;95;19723173;19;0;0;0
FR;1;2021-07-07;190875;362304;1659;25;390647;2;0;0;0;27545098;18330850;85472;120;20113820;21;0;0;0
FR;1;2021-07-08;201595;322964;1827;20;353608;2;0;0;0;27746693;18653814;87299;140;20467428;23;0;0;0
FR;1;2021-07-09;189996;387759;1854;3;418158;1;0;0;0;27936689;19041573;89153;143;20885586;24;0;0;0
FR;1;2021-07-10;129968;281185;818;1;302612;0;0;0;0;28066657;19322758;89971;144;21188198;24;0;0;0
FR;1;2021-07-11;57688;102528;263;0;112405;0;0;0;0;28124345;19425286;90234;144;21300603;24;0;0;0
FR;1;2021-07-12;149932;416806;1588;4;442792;0;0;0;0;28274277;19842092;91822;148;21743395;24;0;0;0
FR;1;2021-07-13;234313;438997;1808;8;476172;0;0;0;0;28508590;20281089;93630;156;22219567;24;0;0;0
FR;1;2021-07-14;171932;151300;418;0;176928;0;0;0;0;28680522;20432389;94048;156;22396495;24;0;0;0
FR;1;2021-07-15;279707;424131;1859;1;467100;0;0;0;0;28960229;20856520;95907;157;22863595;24;0;0;0
FR;1;2021-07-16;290447;400514;1711;3;445148;1;0;0;0;29250676;21257034;97618;160;23308743;25;0;0;0
FR;1;2021-07-17;217362;281971;755;1;315433;0;0;0;0;29468038;21539005;98373;161;23624176;25;0;0;0
FR;1;2021-07-18;102032;107205;288;0;123092;0;0;0;0;29570070;21646210;98661;161;23747268;25;0;0;0
FR;1;2021-07-19;238250;378359;1498;3;414395;0;0;0;0;29808320;22024569;100159;164;24161663;25;0;0;0
FR;1;2021-07-20;305778;379724;1471;0;425543;0;0;0;0;30114098;22404293;101630;164;24587206;25;0;0;0
FR;1;2021-07-21;333315;352690;1413;4;404054;1;0;0;0;30447413;22756983;103043;168;24991260;26;0;0;0
FR;1;2021-07-22;364709;318525;1502;3;374928;1;0;0;0;30812122;23075508;104545;171;25366188;27;0;0;0
FR;1;2021-07-23;349411;342720;1589;4;398255;1;0;0;0;31161533;23418228;106134;175;25764443;28;0;0;0
FR;1;2021-07-24;238968;240734;697;1;278062;0;0;0;0;31400501;23658962;106831;176;26042505;28;0;0;0
FR;1;2021-07-25;112813;76013;223;0;93706;0;0;0;0;31513314;23734975;107054;176;26136211;28;0;0;0
FR;1;2021-07-26;299151;289258;1495;2;334966;1;0;0;0;31812465;24024233;108549;178;26471177;29;0;0;0
FR;1;2021-07-27;385873;267859;1460;4;324823;1;0;0;0;32198338;24292092;110009;182;26796000;30;0;0;0
FR;1;2021-07-28;390231;250920;1463;4;307204;1;0;0;0;32588569;24543012;111472;186;27103204;31;0;0;0
FR;1;2021-07-29;406162;227575;1541;2;284263;0;0;0;0;32994731;24770587;113013;188;27387467;31;0;0;0
FR;1;2021-07-30;370762;246476;1639;4;298303;1;0;0;0;33365493;25017063;114652;192;27685770;32;0;0;0
FR;1;2021-07-31;243396;165091;794;1;199410;0;0;0;0;33608889;25182154;115446;193;27885180;32;0;0;0
FR;1;2021-08-01;105617;47204;237;0;61196;0;0;0;0;33714506;25229358;115683;193;27946376;32;0;0;0
FR;1;2021-08-02;297440;212828;1480;2;250605;0;0;0;0;34011946;25442186;117163;195;28196981;32;0;0;0
FR;1;2021-08-03;331357;208671;1557;2;250633;1;0;0;0;34343303;25650857;118720;197;28447614;33;0;0;0
FR;1;2021-08-04;328059;183822;1440;5;223969;3;0;0;0;34671362;25834679;120160;202;28671583;36;0;0;0
FR;1;2021-08-05;301299;193081;1483;0;229373;0;0;0;0;34972661;26027760;121643;202;28900956;36;0;0;0
FR;1;2021-08-06;291006;224079;1560;3;261358;0;0;0;0;35263667;26251839;123203;205;29162314;36;0;0;0
FR;1;2021-08-07;182686;158758;655;5;181661;1;0;0;0;35446353;26410597;123858;210;29343975;37;0;0;0
FR;1;2021-08-08;68897;59100;253;0;67627;0;0;0;0;35515250;26469697;124111;210;29411602;37;0;0;0
FR;1;2021-08-09;222801;235140;1446;4;263842;2;0;0;0;35738051;26704837;125557;214;29675444;39;0;0;0
FR;1;2021-08-10;252764;239820;1492;2;271648;0;0;0;0;35990815;26944657;127049;216;29947092;39;0;0;0
FR;1;2021-08-11;236257;231717;1272;5;261226;0;0;0;0;36227072;27176374;128321;221;30208318;39;0;0;0
FR;1;2021-08-12;220806;239711;1492;3;267797;0;0;0;0;36447878;27416085;129813;224;30476115;39;0;0;0
FR;1;2021-08-13;201733;238486;1361;2;264022;2;0;0;0;36649611;27654571;131174;226;30740137;41;0;0;0
FR;1;2021-08-14;122877;174034;645;0;189536;0;0;0;0;36772488;27828605;131819;226;30929673;41;0;0;0
FR;1;2021-08-15;34711;46113;201;1;50330;0;0;0;0;36807199;27874718;132020;227;30980003;41;0;0;0
FR;1;2021-08-16;156967;289321;1424;0;309889;0;0;0;0;36964166;28164039;133444;227;31289892;41;0;0;0
FR;1;2021-08-17;171626;290948;1422;5;313348;0;0;0;0;37135792;28454987;134866;232;31603240;41;0;0;0
FR;1;2021-08-18;161452;286672;1394;6;307298;3;0;0;0;37297244;28741659;136260;238;31910538;44;0;0;0
FR;1;2021-08-19;148963;277410;1405;1;297250;0;0;0;0;37446207;29019069;137665;239;32207788;44;0;0;0
FR;1;2021-08-20;140535;308906;1535;2;328135;2;0;0;0;37586742;29327975;139200;241;32535923;46;0;0;0
FR;1;2021-08-21;84288;213211;589;0;224529;0;0;0;0;37671030;29541186;139789;241;32760452;46;0;0;0
FR;1;2021-08-22;28585;82695;233;0;86699;0;0;0;0;37699615;29623881;140022;241;32847151;46;0;0;0
FR;1;2021-08-23;118674;320940;1422;2;337669;0;0;0;0;37818289;29944821;141444;243;33184820;46;0;0;0
FR;1;2021-08-24;126689;319599;1604;5;337411;0;0;0;0;37944978;30264420;143048;248;33522231;46;0;0;0
FR;1;2021-08-25;121548;306409;1783;8;323580;2;0;0;0;38066526;30570829;144831;256;33845811;48;0;0;0
FR;1;2021-08-26;106649;286080;2165;10;302376;0;0;0;0;38173175;30856909;146996;266;34148187;48;0;0;0
FR;1;2021-08-27;107659;321586;2303;9;338839;1;0;0;0;38280834;31178495;149299;275;34487026;49;0;0;0
FR;1;2021-08-28;71030;220701;1102;0;231221;0;0;0;0;38351864;31399196;150401;275;34718247;49;0;0;0
FR;1;2021-08-29;24156;78209;469;1;82099;0;0;0;0;38376020;31477405;150870;276;34800346;49;0;0;0
FR;1;2021-08-30;96904;286268;4315;6;299752;4968;0;0;0;38472924;31763673;155185;282;35100098;5017;0;0;0
FR;1;2021-08-31;98136;276230;9295;15;289898;10061;2;0;0;38571060;32039903;164480;297;35389996;15078;2;0;0
FR;1;2021-09-01;112366;245287;21122;8;257668;22158;1;0;0;38683426;32285190;185602;305;35647664;37236;3;0;0
FR;1;2021-09-02;86758;197904;24536;18;208300;25517;0;0;0;38770184;32483094;210138;323;35855964;62753;3;0;0
FR;1;2021-09-03;82434;227477;26958;21;238915;28038;0;0;0;38852618;32710571;237096;344;36094879;90791;3;0;0
FR;1;2021-09-04;71632;189720;11141;11;199299;11712;7;0;0;38924250;32900291;248237;355;36294178;102503;10;0;0
FR;1;2021-09-05;18614;41142;4126;2;43849;4275;0;0;0;38942864;32941433;252363;357;36338027;106778;10;0;0
FR;1;2021-09-06;59825;151364;30182;15;158892;31207;2;0;0;39002689;33092797;282545;372;36496919;137985;12;0;0
FR;1;2021-09-07;57400;139622;30215;30;146741;31253;2;0;0;39060089;33232419;312760;402;36643660;169238;14;0;0
FR;1;2021-09-08;72358;173795;26926;22;182264;27967;4;0;0;39132447;33406214;339686;424;36825924;197205;18;0;0
FR;1;2021-09-09;54514;124426;28638;24;131184;29745;5;0;0;39186961;33530640;368324;448;36957108;226950;23;0;0
FR;1;2021-09-10;66225;152067;30452;24;161152;31693;5;0;0;39253186;33682707;398776;472;37118260;258643;28;0;0
FR;1;2021-09-11;52689;146638;9731;14;154126;10356;0;0;0;39305875;33829345;408507;486;37272386;268999;28;0;0
FR;1;2021-09-12;10800;29268;2491;1;30966;2661;2;0;0;39316675;33858613;410998;487;37303352;271660;30;0;0
FR;1;2021-09-13;51520;104393;38767;31;110927;40097;16;0;0;39368195;33963006;449765;518;37414279;311757;46;0;0
FR;1;2021-09-14;53343;96009;51293;67;102368;53294;42;0;0;39421538;34059015;501058;585;37516647;365051;88;0;0
FR;1;2021-09-15;60592;139227;50499;55;146395;47072;67;0;0;39482130;34198242;551557;640;37663042;412123;155;0;0
FR;1;2021-09-16;46646;81362;53354;70;86256;49612;60;0;0;39528776;34279604;604911;710;37749298;461735;215;0;0
FR;1;2021-09-17;53227;109328;45085;61;115662;42718;61;0;0;39582003;34388932;649996;771;37864960;504453;276;0;0
FR;1;2021-09-18;37887;118499;11797;19;124081;11280;19;0;0;39619890;34507431;661793;790;37989041;515733;295;0;0
FR;1;2021-09-19;6531;21022;2045;1;22126;1985;1;0;0;39626421;34528453;663838;791;38011167;517718;296;0;0
FR;1;2021-09-20;36543;74844;46230;65;78564;44197;30;0;0;39662964;34603297;710068;856;38089731;561915;326;0;0
FR;1;2021-09-21;34209;68099;56270;72;71134;52747;76;0;0;39697173;34671396;766338;928;38160865;614662;402;0;0
FR;1;2021-09-22;38851;118607;49884;76;123026;46936;39;0;0;39736024;34790003;816222;1004;38283891;661598;441;0;0
FR;1;2021-09-23;32043;62891;54515;85;65794;50921;76;0;0;39768067;34852894;870737;1089;38349685;712519;517;0;0
FR;1;2021-09-24;36804;90017;43678;89;94375;41959;57;0;0;39804871;34942911;914415;1178;38444060;754478;574;0;0
FR;1;2021-09-25;27655;96714;12308;27;101064;12190;19;0;0;39832526;35039625;926723;1205;38545124;766668;593;0;0
FR;1;2021-09-26;4390;15201;1777;5;16066;1699;4;0;0;39836916;35054826;928500;1210;38561190;768367;597;0;0
FR;1;2021-09-27;27356;60208;42930;89;63438;41661;78;0;1;39864272;35115034;971430;1299;38624628;810028;675;0;1
FR;1;2021-09-28;26913;49418;47207;76;52034;44494;40;0;0;39891185;35164452;1018637;1375;38676662;854522;715;0;1
FR;1;2021-09-29;35927;80253;47297;88;84639;45624;33;0;0;39927112;35244705;1065934;1463;38761301;900146;748;0;1
FR;1;2021-09-30;26077;46901;47530;80;49258;45480;52;0;0;39953189;35291606;1113464;1543;38810559;945626;800;0;1
FR;1;2021-10-01;47306;66913;44909;83;70794;44633;14;0;0;40000495;35358519;1158373;1626;38881353;990259;814;0;1
FR;1;2021-10-02;32385;62415;16114;32;67223;16325;6;0;0;40032880;35420934;1174487;1658;38948576;1006584;820;0;1
FR;1;2021-10-03;4343;8563;2043;3;9312;2038;4;0;0;40037223;35429497;1176530;1661;38957888;1008622;824;0;1
FR;1;2021-10-04;28986;44425;47117;79;46837;46986;31;0;0;40066209;35473922;1223647;1740;39004725;1055608;855;0;1
FR;1;2021-10-05;24576;41640;49895;116;43136;49353;46;0;0;40090785;35515562;1273542;1856;39047861;1104961;901;0;1
FR;1;2021-10-06;34660;61394;57511;101;64501;57267;24;0;0;40125445;35576956;1331053;1957;39112362;1162228;925;0;1
FR;1;2021-10-07;21084;39911;53056;74;41089;52002;32;0;0;40146529;35616867;1384109;2031;39153451;1214230;957;0;1
FR;1;2021-10-08;35672;59644;60412;83;62870;61169;28;0;0;40182201;35676511;1444521;2114;39216321;1275399;985;0;1
FR;1;2021-10-09;27466;48025;25498;29;52491;26028;10;0;0;40209667;35724536;1470019;2143;39268812;1301427;995;0;1
FR;1;2021-10-10;3727;5811;2759;7;6289;2865;1;0;0;40213394;35730347;1472778;2150;39275101;1304292;996;0;1
FR;1;2021-10-11;24859;38210;54590;88;40294;55272;43;0;0;40238253;35768557;1527368;2238;39315395;1359564;1039;0;1
FR;1;2021-10-12;23387;36580;58078;128;37078;59241;18;0;0;40261640;35805137;1585446;2366;39352473;1418805;1057;0;1
FR;1;2021-10-13;32975;47839;64177;125;50643;65703;22;0;1;40294615;35852976;1649623;2491;39403116;1484508;1079;0;2
FR;1;2021-10-14;21715;34774;53776;103;35680;54373;21;0;0;40316330;35887750;1703399;2594;39438796;1538881;1100;0;2
FR;1;2021-10-15;32757;48765;72340;165;50457;75037;22;0;0;40349087;35936515;1775739;2759;39489253;1613918;1122;0;2
FR;1;2021-10-16;26014;35282;34874;45;38297;36432;13;0;0;40375101;35971797;1810613;2804;39527550;1650350;1135;0;2
FR;1;2021-10-17;3161;4054;3418;2;4497;3319;3;0;0;40378262;35975851;1814031;2806;39532047;1653669;1138;0;2
FR;1;2021-10-18;24353;34880;66854;132;34917;69740;27;0;0;40402615;36010731;1880885;2938;39566964;1723409;1165;0;2
FR;1;2021-10-19;20724;35571;75678;135;33221;79610;40;0;0;40423339;36046302;1956563;3073;39600185;1803019;1205;0;2
FR;1;2021-10-20;29918;44204;96191;178;43278;99882;45;0;0;40453257;36090506;2052754;3251;39643463;1902901;1250;0;2
FR;1;2021-10-21;19807;35053;83202;107;31763;87065;29;0;0;40473064;36125559;2135956;3358;39675226;1989966;1279;0;2
FR;1;2021-10-22;29756;47758;103757;196;44556;109722;58;0;0;40502820;36173317;2239713;3554;39719782;2099688;1337;0;2
FR;1;2021-10-23;23055;35142;44876;57;36130;47385;11;0;0;40525875;36208459;2284589;3611;39755912;2147073;1348;0;2
FR;1;2021-10-24;2407;3841;3585;6;4041;3718;1;0;0;40528282;36212300;2288174;3617;39759953;2150791;1349;0;2
FR;1;2021-10-25;22504;30718;82031;143;29600;85840;36;0;0;40550786;36243018;2370205;3760;39789553;2236631;1385;0;2
FR;1;2021-10-26;19368;27643;86127;162;24736;90357;30;0;0;40570154;36270661;2456332;3922;39814289;2326988;1415;0;2
FR;1;2021-10-27;26223;39609;107828;252;37300;112743;45;0;0;40596377;36310270;2564160;4174;39851589;2439731;1460;0;2
FR;1;2021-10-28;18804;27109;86970;150;23482;91739;34;0;0;40615181;36337379;2651130;4324;39875071;2531470;1494;0;2
FR;1;2021-10-29;25936;40253;114845;202;35486;121684;49;0;0;40641117;36377632;2765975;4526;39910557;2653154;1543;0;2
FR;1;2021-10-30;17714;28718;49373;74;28302;51970;18;0;0;40658831;36406350;2815348;4600;39938859;2705124;1561;0;2
FR;1;2021-10-31;2088;3169;3452;2;3215;3686;2;0;0;40660919;36409519;2818800;4602;39942074;2708810;1563;0;2
FR;1;2021-11-01;8027;4274;3037;3;4357;3295;6;0;0;40668946;36413793;2821837;4605;39946431;2712105;1569;0;2
FR;1;2021-11-02;22918;33218;92416;156;29172;97870;39;0;1;40691864;36447011;2914253;4761;39975603;2809975;1608;0;3
FR;1;2021-11-03;26639;41548;117526;219;36996;123910;56;0;0;40718503;36488559;3031779;4980;40012599;2933885;1664;0;3
FR;1;2021-11-04;19630;30288;105827;213;24183;111971;42;0;0;40738133;36518847;3137606;5193;40036782;3045856;1706;0;3
FR;1;2021-11-05;27035;42300;138800;230;34180;147490;47;0;0;40765168;36561147;3276406;5423;40070962;3193346;1753;0;3
FR;1;2021-11-06;18864;29807;63501;123;27605;66521;24;0;0;40784032;36590954;3339907;5546;40098567;3259867;1777;0;3
FR;1;2021-11-07;1835;3267;4985;6;3024;5302;5;0;0;40785867;36594221;3344892;5552;40101591;3265169;1782;0;3
FR;1;2021-11-08;17882;32250;126022;224;25390;132662;47;0;0;40803749;36626471;3470914;5776;40126981;3397831;1829;0;3
FR;1;2021-11-09;19521;37608;159334;334;26129;169157;63;0;0;40823270;36664079;3630248;6110;40153110;3566988;1892;0;3
FR;1;2021-11-10;28895;49047;181931;441;39012;192548;82;0;0;40852165;36713126;3812179;6551;40192122;3759536;1974;0;3
FR;1;2021-11-11;4192;5930;12240;26;5107;13030;14;0;0;40856357;36719056;3824419;6577;40197229;3772566;1988;0;3
FR;1;2021-11-12;26028;46819;174848;244;35282;186550;76;0;0;40882385;36765875;3999267;6821;40232511;3959116;2064;0;3
FR;1;2021-11-13;18736;29144;76847;111;25370;81792;40;0;0;40901121;36795019;4076114;6932;40257881;4040908;2104;0;3
FR;1;2021-11-14;2051;3240;6828;5;2796;7358;6;0;0;40903172;36798259;4082942;6937;40260677;4048266;2110;0;3
FR;1;2021-11-15;18798;34705;156449;306;24613;166286;59;0;0;40921970;36832964;4239391;7243;40285290;4214552;2169;0;3
FR;1;2021-11-16;21369;37810;192164;380;23315;205082;99;0;1;40943339;36870774;4431555;7623;40308605;4419634;2268;0;4
FR;1;2021-11-17;28675;45550;193256;398;33020;205082;92;0;0;40972014;36916324;4624811;8021;40341625;4624716;2360;0;4
FR;1;2021-11-18;21149;39595;182546;459;25134;194673;85;0;0;40993163;36955919;4807357;8480;40366759;4819389;2445;0;4
FR;1;2021-11-19;30894;53318;230287;532;34811;246784;134;0;0;41024057;37009237;5037644;9012;40401570;5066173;2579;0;4
FR;1;2021-11-20;23776;33216;97003;202;26735;103656;40;0;0;41047833;37042453;5134647;9214;40428305;5169829;2619;0;4
FR;1;2021-11-21;2342;3909;9134;19;2957;9940;16;0;0;41050175;37046362;5143781;9233;40431262;5179769;2635;0;4
FR;1;2021-11-22;21426;30328;175932;467;16944;189482;79;0;0;41071601;37076690;5319713;9700;40448206;5369251;2714;0;4
FR;1;2021-11-23;24033;40969;221266;540;21318;238019;77;0;0;41095634;37117659;5540979;10240;40469524;5607270;2791;0;4
FR;1;2021-11-24;30298;49640;217403;701;31960;234585;67;0;0;41125932;37167299;5758382;10941;40501484;5841855;2858;0;4
FR;1;2021-11-25;23732;44044;244528;718;22070;264229;101;0;0;41149664;37211343;6002910;11659;40523554;6106084;2959;0;4
FR;1;2021-11-26;30618;66638;356843;836;33238;388631;154;0;0;41180282;37277981;6359753;12495;40556792;6494715;3113;0;4
FR;1;2021-11-27;21960;45262;202667;372;26149;222698;112;0;0;41202242;37323243;6562420;12867;40582941;6717413;3225;0;4
FR;1;2021-11-28;3180;9543;54804;63;3468;61016;37;0;0;41205422;37332786;6617224;12930;40586409;6778429;3262;0;4
FR;1;2021-11-29;17905;49470;326438;841;20782;354582;150;0;0;41223327;37382256;6943662;13771;40607191;7133011;3412;0;4
FR;1;2021-11-30;22790;64816;431197;952;23792;470847;266;0;0;41246117;37447072;7374859;14723;40630983;7603858;3678;0;4
FR;1;2021-12-01;25365;69037;442956;1131;28429;481822;271;0;0;41271482;37516109;7817815;15854;40659412;8085680;3949;0;4
FR;1;2021-12-02;20094;64294;489465;1230;18431;532970;274;0;0;41291576;37580403;8307280;17084;40677843;8618650;4223;0;4
FR;1;2021-12-03;22912;82297;542843;1310;30268;591859;308;0;0;41314488;37662700;8850123;18394;40708111;9210509;4531;0;4
FR;1;2021-12-04;16416;53778;299138;654;23203;328999;180;0;0;41330904;37716478;9149261;19048;40731314;9539508;4711;0;4
FR;1;2021-12-05;3635;13773;81549;143;4193;91048;85;0;0;41334539;37730251;9230810;19191;40735507;9630556;4796;0;4
FR;1;2021-12-06;25847;62420;415526;1066;22059;455255;358;0;0;41360386;37792671;9646336;20257;40757566;10085811;5154;0;4
FR;1;2021-12-07;20020;75452;523085;1536;24270;572745;372;0;0;41380406;37868123;10169421;21793;40781836;10658556;5526;0;4
FR;1;2021-12-08;21719;75490;458639;1545;30647;502297;377;0;0;41402125;37943613;10628060;23338;40812483;11160853;5903;0;4
FR;1;2021-12-09;19473;73925;493115;1624;24309;541128;398;0;0;41421598;38017538;11121175;24962;40836792;11701981;6301;0;4
FR;1;2021-12-10;23330;87515;547476;1585;32412;600119;392;0;1;41444928;38105053;11668651;26547;40869204;12302100;6693;0;5
FR;1;2021-12-11;16533;59085;302772;751;25944;335505;278;0;0;41461461;38164138;11971423;27298;40895148;12637605;6971;0;5
FR;1;2021-12-12;4398;15878;83241;179;5243;94049;96;0;0;41465859;38180016;12054664;27477;40900391;12731654;7067;0;5
FR;1;2021-12-13;15761;63389;367088;1094;23898;406370;236;0;0;41481620;38243405;12421752;28571;40924289;13138024;7303;0;5
FR;1;2021-12-14;20870;80104;464907;1749;28630;515366;507;0;1;41502490;38323509;12886659;30320;40952919;13653390;7810;0;6
FR;1;2021-12-15;21629;77284;409188;1309;33000;453258;311;0;1;41524119;38400793;13295847;31629;40985919;14106648;8121;0;7
FR;1;2021-12-16;20069;77047;452015;1577;27919;500753;324;0;0;41544188;38477840;13747862;33206;41013838;14607401;8445;0;7
FR;1;2021-12-17;22628;86367;480032;1737;34637;531057;372;0;0;41566816;38564207;14227894;34943;41048475;15138458;8817;0;7
FR;1;2021-12-18;17610;54546;257663;731;24681;288530;232;0;0;41584426;38618753;14485557;35674;41073156;15426988;9049;0;7
FR;1;2021-12-19;5563;16906;79205;194;5920;90676;117;0;0;41589989;38635659;14564762;35868;41079076;15517664;9166;0;7
FR;1;2021-12-20;20957;62864;316308;1082;26482;355340;286;0;0;41610946;38698523;14881070;36950;41105558;15873004;9452;0;7
FR;1;2021-12-21;26344;72856;372822;1422;30551;418150;338;0;0;41637290;38771379;15253892;38372;41136109;16291154;9790;0;7
FR;1;2021-12-22;24989;65638;310706;1217;29569;349629;361;0;1;41662279;38837017;15564598;39589;41165678;16640783;10151;0;8
FR;1;2021-12-23;21280;52102;241543;958;23338;273074;362;0;0;41683559;38889119;15806141;40547;41189016;16913857;10513;0;8
FR;1;2021-12-24;7130;18267;67172;258;9242;77064;154;0;1;41690689;38907386;15873313;40805;41198258;16990921;10667;0;9
FR;1;2021-12-25;510;2864;5595;15;1797;6539;55;0;0;41691199;38910250;15878908;40820;41200055;16997460;10722;0;9
FR;1;2021-12-26;2751;7565;26961;71;3489;31471;100;0;0;41693950;38917815;15905869;40891;41203544;17028931;10822;0;9
FR;1;2021-12-27;18312;53456;235148;705;25447;265807;365;0;0;41712262;38971271;16141017;41596;41228991;17294738;11187;0;9
FR;1;2021-12-28;23302;61879;292071;1026;26988;330246;595;0;1;41735564;39033150;16433088;42622;41255979;17624984;11782;0;10
FR;1;2021-12-29;22218;55368;255050;921;25252;288246;645;0;1;41757782;39088518;16688138;43543;41281231;17913230;12427;0;11
FR;1;2021-12-30;21240;46407;212185;858;22443;239635;718;0;0;41779022;39134925;16900323;44401;41303674;18152865;13145;0;11
FR;1;2021-12-31;7468;16535;61882;229;8712;70417;347;0;0;41786490;39151460;16962205;44630;41312386;18223282;13492;0;11
FR;1;2022-01-01;1173;2489;5668;30;1543;6577;73;0;0;41787663;39153949;16967873;44660;41313929;18229859;13565;0;11
FR;1;2022-01-02;3096;8073;28896;50;3672;33536;190;0;0;41790759;39162022;16996769;44710;41317601;18263395;13755;0;11
FR;1;2022-01-03;27019;54160;228289;790;27528;257749;964;0;1;41817778;39216182;17225058;45500;41345129;18521144;14719;0;12
FR;1;2022-01-04;26374;64968;299328;1241;29772;337373;1367;0;2;41844152;39281150;17524386;46741;41374901;18858517;16086;0;14
FR;1;2022-01-05;30572;64237;274938;1099;32506;310316;1264;0;0;41874724;39345387;17799324;47840;41407407;19168833;17350;0;14
FR;1;2022-01-06;26862;66197;306957;1404;29270;346633;1568;0;1;41901586;39411584;18106281;49244;41436677;19515466;18918;0;15
FR;1;2022-01-07;31584;74957;349881;1538;34383;394009;1822;0;1;41933170;39486541;18456162;50782;41471060;19909475;20740;0;16
FR;1;2022-01-08;23391;51357;222512;698;25570;251139;913;0;1;41956561;39537898;18678674;51480;41496630;20160614;21653;0;17
FR;1;2022-01-09;7091;17130;66036;163;8165;76142;335;0;0;41963652;39555028;18744710;51643;41504795;20236756;21988;0;17
FR;1;2022-01-10;21815;60570;236838;957;32913;267627;1258;0;1;41985467;39615598;18981548;52600;41537708;20504383;23246;0;18
FR;1;2022-01-11;26787;63429;282348;1281;31188;317865;1838;0;1;42012254;39679027;19263896;53881;41568896;20822248;25084;0;19
FR;1;2022-01-12;28969;62476;246306;1106;35041;278095;1686;0;3;42041223;39741503;19510202;54987;41603937;21100343;26770;0;22
FR;1;2022-01-13;24791;60152;262845;1253;30023;296165;1993;0;4;42066014;39801655;19773047;56240;41633960;21396508;28763;0;26
FR;1;2022-01-14;27972;66681;314057;1366;32103;351308;2475;0;1;42093986;39868336;20087104;57606;41666063;21747816;31238;0;27
FR;1;2022-01-15;19371;44409;199333;619;22462;223870;1363;0;1;42113357;39912745;20286437;58225;41688525;21971686;32601;0;28
FR;1;2022-01-16;5161;12953;51537;135;6018;59557;338;0;0;42118518;39925698;20337974;58360;41694543;22031243;32939;0;28
FR;1;2022-01-17;16883;39658;184868;783;20108;206845;1690;0;2;42135401;39965356;20522842;59143;41714651;22238088;34629;0;30
FR;1;2022-01-18;19460;45957;212464;1154;22982;237066;2456;0;1;42154861;40011313;20735306;60297;41737633;22475154;37085;0;31
FR;1;2022-01-19;20314;43936;176151;898;25463;197206;1977;0;4;42175175;40055249;20911457;61195;41763096;22672360;39062;0;35
FR;1;2022-01-20;16853;40568;183727;1147;20814;204772;2517;0;2;42192028;40095817;21095184;62342;41783910;22877132;41579;0;37
FR;1;2022-01-21;19924;47002;228984;1405;23881;253361;3106;0;1;42211952;40142819;21324168;63747;41807791;23130493;44685;0;38
FR;1;2022-01-22;13845;33330;144509;579;18431;161398;1404;0;2;42225797;40176149;21468677;64326;41826222;23291891;46089;0;40
FR;1;2022-01-23;3379;8762;33439;132;4575;38324;352;0;1;42229176;40184911;21502116;64458;41830797;23330215;46441;0;41
FR;1;2022-01-24;11817;32967;142244;718;17787;158281;2105;0;1;42240993;40217878;21644360;65176;41848584;23488496;48546;0;42
FR;1;2022-01-25;14217;38160;163436;1049;20283;181572;3181;0;1;42255210;40256038;21807796;66225;41868867;23670068;51727;0;43
FR;1;2022-01-26;14865;37722;150273;934;22633;166402;2516;0;1;42270075;40293760;21958069;67159;41891500;23836470;54243;0;44
FR;1;2022-01-27;12341;33336;143472;896;18496;158051;3230;0;3;42282416;40327096;22101541;68055;41909996;23994521;57473;0;47
FR;1;2022-01-28;16331;56907;198337;1144;32662;222397;4007;0;3;42298747;40384003;22299878;69199;41942658;24216918;61480;0;50
FR;1;2022-01-29;10270;35466;135216;525;19612;151540;1879;0;1;42309017;40419469;22435094;69724;41962270;24368458;63359;0;51
FR;1;2022-01-30;2485;9253;29688;86;4826;34449;434;0;1;42311502;40428722;22464782;69810;41967096;24402907;63793;0;52
FR;1;2022-01-31;8759;32461;104354;533;19470;117343;2340;0;3;42320261;40461183;22569136;70343;41986566;24520250;66133;0;55
FR;1;2022-02-01;11010;36444;127095;866;20630;141216;4320;0;1;42331271;40497627;22696231;71209;42007196;24661466;70453;0;56
FR;1;2022-02-02;12169;41572;130371;783;25262;145818;3773;0;9;42343440;40539199;22826602;71992;42032458;24807284;74226;0;65
FR;1;2022-02-03;9520;34054;117034;785;19122;130333;4284;0;4;42352960;40573253;22943636;72777;42051580;24937617;78510;0;69
FR;1;2022-02-04;11544;49691;172589;968;26983;192724;5479;0;5;42364504;40622944;23116225;73745;42078563;25130341;83989;0;74
FR;1;2022-02-05;8000;33921;117593;391;18170;133023;2414;0;3;42372504;40656865;23233818;74136;42096733;25263364;86403;0;77
FR;1;2022-02-06;1706;7995;22754;86;3873;26905;444;0;0;42374210;40664860;23256572;74222;42100606;25290269;86847;0;77
FR;1;2022-02-07;7368;35386;119114;460;18173;134970;3398;0;4;42381578;40700246;23375686;74682;42118779;25425239;90245;0;81
FR;1;2022-02-08;7772;31960;125676;696;14892;140666;4301;0;5;42389350;40732206;23501362;75378;42133671;25565905;94546;0;86
FR;1;2022-02-09;8741;36529;135267;702;17930;152510;3884;0;7;42398091;40768735;23636629;76080;42151601;25718415;98430;0;93
FR;1;2022-02-10;7032;30146;116383;677;13911;130171;4445;0;1;42405123;40798881;23753012;76757;42165512;25848586;102875;0;94
FR;1;2022-02-11;8662;41569;165150;878;18383;185374;5430;0;3;42413785;40840450;23918162;77635;42183895;26033960;108305;0;97
FR;1;2022-02-12;5346;27617;106715;379;12540;120900;2396;0;2;42419131;40868067;24024877;78014;42196435;26154860;110701;0;99
FR;1;2022-02-13;1269;5721;21721;66;2188;25339;402;0;3;42420400;40873788;24046598;78080;42198623;26180199;111103;0;102
FR;1;2022-02-14;5462;27230;118095;395;10644;133123;3385;0;4;42425862;40901018;24164693;78475;42209267;26313322;114488;0;106
FR;1;2022-02-15;5797;28872;118941;611;12221;132572;4883;0;1;42431659;40929890;24283634;79086;42221488;26445894;119371;0;107
FR;1;2022-02-16;5763;28497;110429;597;13764;123059;4153;0;3;42437422;40958387;24394063;79683;42235252;26568953;123524;0;110
FR;1;2022-02-17;4617;19749;73156;489;10129;80263;3999;0;3;42442039;40978136;24467219;80172;42245381;26649216;127523;0;113
FR;1;2022-02-18;5615;26805;99209;673;14177;108171;5519;0;2;42447654;41004941;24566428;80845;42259558;26757387;133042;0;115
FR;1;2022-02-19;3552;17178;59479;305;9571;66060;2267;0;0;42451206;41022119;24625907;81150;42269129;26823447;135309;0;115
FR;1;2022-02-20;794;3258;10706;36;1651;12333;360;0;1;42452000;41025377;24636613;81186;42270780;26835780;135669;0;116
FR;1;2022-02-21;3430;14599;52830;286;7919;57678;3126;0;2;42455430;41039976;24689443;81472;42278699;26893458;138795;0;118
FR;1;2022-02-22;3804;15550;51919;500;9047;55657;4070;0;1;42459234;41055526;24741362;81972;42287746;26949115;142865;0;119
FR;1;2022-02-23;4235;17828;57487;510;10748;62589;3568;0;3;42463469;41073354;24798849;82482;42298494;27011704;146433;0;122
FR;1;2022-02-24;3345;13146;43620;436;7841;46410;3658;0;2;42466814;41086500;24842469;82918;42306335;27058114;150091;0;124
FR;1;2022-02-25;4478;20133;64928;697;12250;68799;5768;0;4;42471292;41106633;24907397;83615;42318585;27126913;155859;0;128
FR;1;2022-02-26;2698;12806;41371;310;7653;45124;2494;0;2;42473990;41119439;24948768;83925;42326238;27172037;158353;0;130
FR;1;2022-02-27;644;2192;7131;42;1207;7994;433;0;0;42474634;41121631;24955899;83967;42327445;27180031;158786;0;130
FR;1;2022-02-28;2614;10502;34968;306;6082;37395;3123;0;0;42477248;41132133;24990867;84273;42333527;27217426;161909;0;130
FR;1;2022-03-01;3592;10762;38706;391;6364;39662;4548;0;4;42480840;41142895;25029573;84664;42339891;27257088;166457;0;134
FR;1;2022-03-02;3685;12287;41871;399;7554;43941;4111;0;1;42484525;41155182;25071444;85063;42347445;27301029;170568;0;135
FR;1;2022-03-03;2464;7994;26185;329;5249;26523;3380;0;1;42486989;41163176;25097629;85392;42352694;27327552;173948;0;136
FR;1;2022-03-04;2691;10553;35468;594;6985;34962;5280;0;3;42489680;41173729;25133097;85986;42359679;27362514;179228;0;139
FR;1;2022-03-05;1823;6370;21972;280;4208;22370;2572;0;1;42491503;41180099;25155069;86266;42363887;27384884;181800;0;140
FR;1;2022-03-06;360;959;2918;38;605;3121;327;0;0;42491863;41181058;25157987;86304;42364492;27388005;182127;0;140
FR;1;2022-03-07;1923;4724;16442;245;3046;15909;2832;0;4;42493786;41185782;25174429;86549;42367538;27403914;184959;0;144
FR;1;2022-03-08;1719;5261;17172;309;3672;16001;3471;0;3;42495505;41191043;25191601;86858;42371210;27419915;188430;0;147
FR;1;2022-03-09;1988;6749;19821;371;4824;19179;3424;0;4;42497493;41197792;25211422;87229;42376034;27439094;191854;0;151
FR;1;2022-03-10;1416;5023;15302;309;3675;14340;2944;0;2;42498909;41202815;25226724;87538;42379709;27453434;194798;0;153
FR;1;2022-03-11;1761;6416;21717;487;4450;19873;4737;0;1;42500670;41209231;25248441;88025;42384159;27473307;199535;0;154
FR;1;2022-03-12;1264;4651;15367;281;3092;14915;2687;0;2;42501934;41213882;25263808;88306;42387251;27488222;202222;0;156
FR;1;2022-03-13;258;614;2119;120;416;2065;469;0;0;42502192;41214496;25265927;88426;42387667;27490287;202691;0;156
FR;1;2022-03-14;1160;3682;13408;3882;2297;12529;6342;0;8;42503352;41218178;25279335;92308;42389964;27502816;209033;0;164
FR;1;2022-03-15;1409;5736;14665;6865;4320;13262;9847;0;8;42504761;41223914;25294000;99173;42394284;27516078;218880;0;172
FR;1;2022-03-16;1700;5092;17402;11522;3603;16465;14128;0;6;42506461;41229006;25311402;110695;42397887;27532543;233008;0;178
FR;1;2022-03-17;1182;3442;11734;9648;2367;10829;11732;0;8;42507643;41232448;25323136;120343;42400254;27543372;244740;0;186
FR;1;2022-03-18;1725;4931;17980;16508;3324;16419;19722;0;14;42509368;41237379;25341116;136851;42403578;27559791;264462;0;200
FR;1;2022-03-19;1126;3302;11891;8460;2277;11362;10142;0;6;42510494;41240681;25353007;145311;42405855;27571153;274604;0;206
FR;1;2022-03-20;225;562;1726;1015;364;1761;1224;0;2;42510719;41241243;25354733;146326;42406219;27572914;275828;0;208
FR;1;2022-03-21;1088;2768;11506;13462;1787;10857;15142;0;10;42511807;41244011;25366239;159788;42408006;27583771;290970;0;218
FR;1;2022-03-22;1282;3216;12265;18716;2156;11254;20619;0;5;42513089;41247227;25378504;178504;42410162;27595025;311589;0;223
FR;1;2022-03-23;1516;4365;16037;20112;2961;15718;21884;0;34;42514605;41251592;25394541;198616;42413123;27610743;333473;0;257
FR;1;2022-03-24;1121;2754;10405;16060;1910;9666;17565;0;15;42515726;41254346;25404946;214676;42415033;27620409;351038;0;272
FR;1;2022-03-25;1540;4364;16758;25315;2882;15409;27960;0;23;42517266;41258710;25421704;239991;42417915;27635818;378998;0;295
FR;1;2022-03-26;1110;3018;10856;11452;2065;10518;12864;0;20;42518376;41261728;25432560;251443;42419980;27646336;391862;0;315
FR;1;2022-03-27;237;546;1751;1383;334;1804;1594;0;1;42518613;41262274;25434311;252826;42420314;27648140;393456;0;316
FR;1;2022-03-28;1086;2490;9981;15885;1558;9602;17230;0;10;42519699;41264764;25444292;268711;42421872;27657742;410686;0;326
FR;1;2022-03-29;1140;2754;11562;25112;1602;10926;26509;0;30;42520839;41267518;25455854;293823;42423474;27668668;437195;0;356
FR;1;2022-03-30;1632;3680;14176;24233;2454;13716;25897;0;19;42522471;41271198;25470030;318056;42425928;27682384;463092;0;375
FR;1;2022-03-31;1281;3033;11702;22704;2061;11215;24025;0;40;42523752;41274231;25481732;340760;42427989;27693599;487117;0;415
FR;1;2022-04-01;2243;4025;18492;28533;2482;17362;30805;0;54;42525995;41278256;25500224;369293;42430471;27710961;517922;0;469
FR;1;2022-04-02;911;1894;8197;9240;1106;7960;10233;0;28;42526906;41280150;25508421;378533;42431577;27718921;528155;0;497
FR;1;2022-04-03;207;382;1433;1058;219;1435;1249;0;1;42527113;41280532;25509854;379591;42431796;27720356;529404;0;498
FR;1;2022-04-04;4273;2608;11386;17683;1696;10777;18903;0;30;42531386;41283140;25521240;397274;42433492;27731133;548307;0;528
FR;1;2022-04-05;2262;2725;13008;31222;1708;12034;32603;0;68;42533648;41285865;25534248;428496;42435200;27743167;580910;0;596
FR;1;2022-04-06;1893;3018;12208;23984;1926;11645;25281;0;62;42535541;41288883;25546456;452480;42437126;27754812;606191;0;658
FR;1;2022-04-07;1694;2754;12361;31122;1651;11830;32196;0;68;42537235;41291637;25558817;483602;42438777;27766642;638387;0;726
FR;1;2022-04-08;1847;3714;17571;40649;2100;16501;42702;0;76;42539082;41295351;25576388;524251;42440877;27783143;681089;0;802
FR;1;2022-04-09;828;2000;8406;12504;1079;8106;13502;0;26;42539910;41297351;25584794;536755;42441956;27791249;694591;0;828
FR;1;2022-04-10;202;655;1837;1855;420;1883;2075;0;6;42540112;41298006;25586631;538610;42442376;27793132;696666;0;834
FR;1;2022-04-11;1108;2269;10973;22373;1322;10687;23481;0;68;42541220;41300275;25597604;560983;42443698;27803819;720147;0;902
FR;1;2022-04-12;1352;2680;12828;38148;1594;12316;38900;0;119;42542572;41302955;25610432;599131;42445292;27816135;759047;0;1021
FR;1;2022-04-13;1284;2895;12279;30627;1790;12010;31399;0;85;42543856;41305850;25622711;629758;42447082;27828145;790446;0;1106
FR;1;2022-04-14;1240;2629;12119;33661;1632;12133;34098;0;87;42545096;41308479;25634830;663419;42448714;27840278;824544;0;1193
FR;1;2022-04-15;1512;3350;14408;33269;2165;13814;34671;0;107;42546608;41311829;25649238;696688;42450879;27854092;859215;0;1300
FR;1;2022-04-16;663;1410;5845;8003;767;5777;8757;0;31;42547271;41313239;25655083;704691;42451646;27859869;867972;0;1331
FR;1;2022-04-17;157;290;930;1121;177;975;1171;0;7;42547428;41313529;25656013;705812;42451823;27860844;869143;0;1338
FR;1;2022-04-18;170;499;2636;1002;313;2660;1187;0;5;42547598;41314028;25658649;706814;42452136;27863504;870330;0;1343
FR;1;2022-04-19;1260;2610;11788;27936;1501;11519;28791;0;69;42548858;41316638;25670437;734750;42453637;27875023;899121;0;1412
FR;1;2022-04-20;1360;2676;12179;26886;1679;12031;27711;0;82;42550218;41319314;25682616;761636;42455316;27887054;926832;0;1494
FR;1;2022-04-21;1245;2466;11554;33286;1515;11785;33624;0;107;42551463;41321780;25694170;794922;42456831;27898839;960456;0;1601
FR;1;2022-04-22;1527;3094;15220;35528;1927;14803;36720;0;121;42552990;41324874;25709390;830450;42458758;27913642;997176;0;1722
FR;1;2022-04-23;767;1591;6738;9894;928;6644;10578;0;30;42553757;41326465;25716128;840344;42459686;27920286;1007754;0;1752
FR;1;2022-04-24;195;378;1376;1524;242;1329;1749;0;7;42553952;41326843;25717504;841868;42459928;27921615;1009503;0;1759
FR;1;2022-04-25;1042;2133;9858;19736;1255;9758;20558;0;64;42554994;41328976;25727362;861604;42461183;27931373;1030061;0;1823
FR;1;2022-04-26;1351;2627;12608;36640;1608;12207;37228;0;163;42556345;41331603;25739970;898244;42462791;27943580;1067289;0;1986
FR;1;2022-04-27;1331;2411;10654;29292;1471;10790;29677;0;123;42557676;41334014;25750624;927536;42464262;27954370;1096966;0;2109
FR;1;2022-04-28;1285;2423;11565;34331;1530;11406;34481;0;127;42558961;41336437;25762189;961867;42465792;27965776;1131447;0;2236
FR;1;2022-04-29;1616;4296;14407;35563;3169;13860;36852;0;153;42560577;41340733;25776596;997430;42468961;27979636;1168299;0;2389
FR;1;2022-04-30;841;4335;6448;9173;3762;6292;9974;0;35;42561418;41345068;25783044;1006603;42472723;27985928;1178273;0;2424
FR;1;2022-05-01;179;288;832;951;190;826;1080;0;5;42561597;41345356;25783876;1007554;42472913;27986754;1179353;0;2429
FR;1;2022-05-02;2098;2628;10383;16956;1783;10308;17637;0;64;42563695;41347984;25794259;1024510;42474696;27997062;1196990;0;2493
FR;1;2022-05-03;1689;2880;12712;32916;1764;12604;33715;0;149;42565384;41350864;25806971;1057426;42476460;28009666;1230705;0;2642
FR;1;2022-05-04;1384;2751;11235;23826;1696;11396;24366;0;96;42566768;41353615;25818206;1081252;42478156;28021062;1255071;0;2738
FR;1;2022-05-05;1501;2739;12201;31862;1723;12124;32410;0;170;42568269;41356354;25830407;1113114;42479879;28033186;1287481;0;2908
FR;1;2022-05-06;1823;3243;14245;34952;1920;13830;36213;0;166;42570092;41359597;25844652;1148066;42481799;28047016;1323694;0;3074
FR;1;2022-05-07;860;1473;5979;9097;878;6013;9731;0;44;42570952;41361070;25850631;1157163;42482677;28053029;1333425;0;3118
FR;1;2022-05-08;190;329;1062;1472;221;1124;1548;0;8;42571142;41361399;25851693;1158635;42482898;28054153;1334973;0;3126
FR;1;2022-05-09;1168;2020;9249;19262;1160;9164;20034;0;93;42572310;41363419;25860942;1177897;42484058;28063317;1355007;0;3219
FR;1;2022-05-10;1513;3050;12616;37145;1961;12215;38043;0;177;42573823;41366469;25873558;1215042;42486019;28075532;1393050;0;3396
FR;1;2022-05-11;1440;2480;9913;26042;1698;9860;26560;0;138;42575263;41368949;25883471;1241084;42487717;28085392;1419610;0;3534
FR;1;2022-05-12;1326;2458;10530;33654;1550;10230;34300;0;188;42576589;41371407;25894001;1274738;42489267;28095622;1453910;0;3722
FR;1;2022-05-13;1620;2808;12770;35855;1688;12418;36950;0;149;42578209;41374215;25906771;1310593;42490955;28108040;1490860;0;3871
FR;1;2022-05-14;783;1330;5481;10217;816;5365;10732;0;52;42578992;41375545;25912252;1320810;42491771;28113405;1501592;0;3923
FR;1;2022-05-15;223;422;1182;1352;246;1252;1497;0;5;42579215;41375967;25913434;1322162;42492017;28114657;1503089;0;3928
FR;1;2022-05-16;972;1786;8082;20138;1005;8146;20550;0;117;42580187;41377753;25921516;1342300;42493022;28122803;1523639;0;4045
FR;1;2022-05-17;1297;2303;11126;36187;1387;10730;36973;0;172;42581484;41380056;25932642;1378487;42494409;28133533;1560612;0;4217
FR;1;2022-05-18;1313;2137;9042;25730;1369;8991;26290;0;99;42582797;41382193;25941684;1404217;42495778;28142524;1586902;0;4316
FR;1;2022-05-19;1207;2404;9856;34005;1415;9951;34208;0;150;42584004;41384597;25951540;1438222;42497193;28152475;1621110;0;4466
FR;1;2022-05-20;1563;2757;12533;37655;1721;12113;38516;0;151;42585567;41387354;25964073;1475877;42498914;28164588;1659626;0;4617
FR;1;2022-05-21;775;1387;5247;9374;880;5164;9944;0;37;42586342;41388741;25969320;1485251;42499794;28169752;1669570;0;4654
FR;1;2022-05-22;194;292;954;1398;204;953;1521;0;10;42586536;41389033;25970274;1486649;42499998;28170705;1671091;0;4664
FR;1;2022-05-23;971;1891;8372;19439;1179;8348;20056;0;79;42587507;41390924;25978646;1506088;42501177;28179053;1691147;0;4743
FR;1;2022-05-24;1289;2448;10728;37252;1440;10598;37825;0;173;42588796;41393372;25989374;1543340;42502617;28189651;1728972;0;4916
FR;1;2022-05-25;1272;2302;8793;23694;1427;8957;24056;0;111;42590068;41395674;25998167;1567034;42504044;28198608;1753028;0;5027
FR;1;2022-05-26;175;385;1585;1155;261;1580;1288;0;24;42590243;41396059;25999752;1568189;42504305;28200188;1754316;0;5051
FR;1;2022-05-27;1120;2192;8790;20457;1377;8538;21410;0;84;42591363;41398251;26008542;1588646;42505682;28208726;1775726;0;5135
FR;1;2022-05-28;486;1059;3692;6543;627;3729;6930;0;37;42591849;41399310;26012234;1595189;42506309;28212455;1782656;0;5172
FR;1;2022-05-29;121;257;708;896;149;719;1005;0;4;42591970;41399567;26012942;1596085;42506458;28213174;1783661;0;5176
FR;1;2022-05-30;832;1745;6559;18536;1046;6592;18990;0;85;42592802;41401312;26019501;1614621;42507504;28219766;1802651;0;5261
FR;1;2022-05-31;1266;2241;9248;34376;1372;9118;34976;0;159;42594068;41403553;26028749;1648997;42508876;28228884;1837627;0;5420
FR;1;2022-06-01;1336;2605;10439;23460;1752;10302;24307;0;116;42595404;41406158;26039188;1672457;42510628;28239186;1861934;0;5536
FR;1;2022-06-02;1228;2309;10671;34153;1450;10249;34986;0;162;42596632;41408467;26049859;1706610;42512078;28249435;1896920;0;5698
FR;1;2022-06-03;1447;2749;12735;37113;1740;12156;38289;0;157;42598079;41411216;26062594;1743723;42513818;28261591;1935209;0;5855
FR;1;2022-06-04;686;1263;4750;8678;760;4826;9168;0;62;42598765;41412479;26067344;1752401;42514578;28266417;1944377;0;5917
FR;1;2022-06-05;134;293;811;1049;151;835;1154;0;3;42598899;41412772;26068155;1753450;42514729;28267252;1945531;0;5920
FR;1;2022-06-06;848;1196;2028;1252;1020;2047;1427;0;9;42599747;41413968;26070183;1754702;42515749;28269299;1946958;0;5929
FR;1;2022-06-07;1264;2343;9186;34057;1440;8846;35156;0;143;42601011;41416311;26079369;1788759;42517189;28278145;1982114;0;6072
FR;1;2022-06-08;1140;2239;8682;27615;1402;8566;28486;0;107;42602151;41418550;26088051;1816374;42518591;28286711;2010600;0;6179
FR;1;2022-06-09;1076;2152;9988;37576;1283;9673;38343;0;148;42603227;41420702;26098039;1853950;42519874;28296384;2048943;0;6327
FR;1;2022-06-10;1337;2862;12425;43134;1825;12016;44363;0;200;42604564;41423564;26110464;1897084;42521699;28308400;2093306;0;6527
FR;1;2022-06-11;661;1451;5136;11085;798;5185;11614;0;50;42605225;41425015;26115600;1908169;42522497;28313585;2104920;0;6577
FR;1;2022-06-12;158;377;1019;1687;189;1077;1788;0;11;42605383;41425392;26116619;1909856;42522686;28314662;2106708;0;6588
FR;1;2022-06-13;951;1841;7015;22226;1136;6872;23067;0;84;42606334;41427233;26123634;1932082;42523822;28321534;2129775;0;6672
FR;1;2022-06-14;1117;2234;9841;42852;1312;9247;43943;0;186;42607451;41429467;26133475;1974934;42525134;28330781;2173718;0;6858
FR;1;2022-06-15;1095;2012;8788;29395;1363;8476;29943;0;169;42608546;41431479;26142263;2004329;42526497;28339257;2203661;0;7027
FR;1;2022-06-16;959;1840;9404;38510;1061;8882;39417;0;188;42609505;41433319;26151667;2042839;42527558;28348139;2243078;0;7215
FR;1;2022-06-17;1229;2568;11916;44864;1483;11382;46004;0;224;42610734;41435887;26163583;2087703;42529041;28359521;2289082;0;7439
FR;1;2022-06-18;564;1277;4320;10544;717;4258;11087;0;62;42611298;41437164;26167903;2098247;42529758;28363779;2300169;0;7501
FR;1;2022-06-19;137;325;1003;1543;173;1082;1609;0;12;42611435;41437489;26168906;2099790;42529931;28364861;2301778;0;7513
FR;1;2022-06-20;861;1710;8493;25050;1009;8157;25911;0;146;42612296;41439199;26177399;2124840;42530940;28373018;2327689;0;7659
FR;1;2022-06-21;1104;2140;9765;47760;1254;8856;49105;0;241;42613400;41441339;26187164;2172600;42532194;28381874;2376794;0;7900
FR;1;2022-06-22;1046;2074;8442;37162;1302;7963;38022;0;231;42614446;41443413;26195606;2209762;42533496;28389837;2414816;0;8131
FR;1;2022-06-23;1054;2182;10126;52819;1211;9409;53828;0;290;42615500;41445595;26205732;2262581;42534707;28399246;2468644;0;8421
FR;1;2022-06-24;1256;2720;12917;65968;1487;11702;67640;0;367;42616756;41448315;26218649;2328549;42536194;28410948;2536284;0;8788
FR;1;2022-06-25;685;1506;5930;18924;792;5712;19723;0;163;42617441;41449821;26224579;2347473;42536986;28416660;2556007;0;8951
FR;1;2022-06-26;167;406;1817;3494;191;1713;3730;0;34;42617608;41450227;26226396;2350967;42537177;28418373;2559737;0;8985
FR;1;2022-06-27;945;1777;9901;45979;943;9127;47114;0;300;42618553;41452004;26236297;2396946;42538120;28427500;2606851;0;9285
FR;1;2022-06-28;1216;2576;13844;86590;1382;12406;88277;0;569;42619769;41454580;26250141;2483536;42539502;28439906;2695128;0;9854
FR;1;2022-06-29;1243;2297;11483;67405;1261;10550;68450;0;487;42621012;41456877;26261624;2550941;42540763;28450456;2763578;0;10341
FR;1;2022-06-30;1291;2487;13518;89968;1438;11829;91769;0;645;42622303;41459364;26275142;2640909;42542201;28462285;2855347;0;10986
FR;1;2022-07-01;1659;3483;20317;109201;1992;17974;111597;0;859;42623962;41462847;26295459;2750110;42544193;28480259;2966944;0;11845
FR;1;2022-07-02;770;1527;8025;33776;751;7254;34802;0;315;42624732;41464374;26303484;2783886;42544944;28487513;3001746;0;12160
FR;1;2022-07-03;230;480;1943;6119;257;1759;6445;0;71;42624962;41464854;26305427;2790005;42545201;28489272;3008191;0;12231
FR;1;2022-07-04;1681;3178;13935;75421;2063;12362;77310;0;589;42626643;41468032;26319362;2865426;42547264;28501634;3085501;0;12820
FR;1;2022-07-05;1507;2858;17696;126387;1512;15153;128500;0;1060;42628150;41470890;26337058;2991813;42548776;28516787;3214001;0;13880
FR;1;2022-07-06;1379;2407;14890;93749;1386;12914;95185;0;815;42629529;41473297;26351948;3085562;42550162;28529701;3309186;0;14695
FR;1;2022-07-07;1444;2538;16940;119493;1406;14010;121588;0;1074;42630973;41475835;26368888;3205055;42551568;28543711;3430774;0;15769
FR;1;2022-07-08;1534;2823;19612;130008;1541;15975;132812;0;1220;42632507;41478658;26388500;3335063;42553109;28559686;3563586;0;16989
FR;1;2022-07-09;663;1281;7311;36022;699;6354;36809;0;392;42633170;41479939;26395811;3371085;42553808;28566040;3600395;0;17381
FR;1;2022-07-10;245;657;2240;6689;412;2032;7068;0;89;42633415;41480596;26398051;3377774;42554220;28568072;3607463;0;17470
FR;1;2022-07-11;1242;2245;14320;84458;1180;11942;86568;0;734;42634657;41482841;26412371;3462232;42555400;28580014;3694031;0;18204
FR;1;2022-07-12;1605;2806;19465;137424;1442;15905;139914;0;1485;42636262;41485647;26431836;3599656;42556842;28595919;3833945;0;19689
FR;1;2022-07-13;1462;2442;14791;89837;1319;12644;91522;0;1002;42637724;41488089;26446627;3689493;42558161;28608563;3925467;0;20691
FR;1;2022-07-14;163;351;1866;5290;196;1775;5437;0;74;42637887;41488440;26448493;3694783;42558357;28610338;3930904;0;20765
FR;1;2022-07-15;1266;2319;14364;80599;1206;12007;82603;0;960;42639153;41490759;26462857;3775382;42559563;28622345;4013507;0;21725
FR;1;2022-07-16;514;1064;5640;23949;556;4893;24590;0;302;42639667;41491823;26468497;3799331;42560119;28627238;4038097;0;22027
FR;1;2022-07-17;163;369;1656;4464;193;1501;4727;0;60;42639830;41492192;26470153;3803795;42560312;28628739;4042824;0;22087
FR;1;2022-07-18;975;2037;11302;59282;1148;9572;61006;0;715;42640805;41494229;26481455;3863077;42561460;28638311;4103830;0;22802
FR;1;2022-07-19;1235;2132;14695;99429;1196;11727;101426;0;1386;42642040;41496361;26496150;3962506;42562656;28650038;4205256;0;24188
FR;1;2022-07-20;1185;2007;12376;74374;1173;10287;75859;0;964;42643225;41498368;26508526;4036880;42563829;28660325;4281115;0;25152
FR;1;2022-07-21;1138;1955;12418;84547;1189;9994;85912;0;1211;42644363;41500323;26520944;4121427;42565018;28670319;4367027;0;26363
FR;1;2022-07-22;1274;2246;14111;85964;1260;11433;87689;0;1264;42645637;41502569;26535055;4207391;42566278;28681752;4454716;0;27627
FR;1;2022-07-23;549;1093;5238;21296;634;4611;21842;0;373;42646186;41503662;26540293;4228687;42566912;28686363;4476558;0;28000
FR;1;2022-07-24;149;306;1328;3700;153;1169;3925;0;65;42646335;41503968;26541621;4232387;42567065;28687532;4480483;0;28065
FR;1;2022-07-25;891;1634;9076;46124;984;7526;47497;0;680;42647226;41505602;26550697;4278511;42568049;28695058;4527980;0;28745
FR;1;2022-07-26;1136;1964;12682;81968;1120;10336;83583;0;1198;42648362;41507566;26563379;4360479;42569169;28705394;4611563;0;29943
FR;1;2022-07-27;1021;1730;9760;58521;1047;8138;59702;0;874;42649383;41509296;26573139;4419000;42570216;28713532;4671265;0;30817
FR;1;2022-07-28;983;1706;9857;61925;1114;7856;63149;0;967;42650366;41511002;26582996;4480925;42571330;28721388;4734414;0;31784
FR;1;2022-07-29;1112;1845;10461;62991;1171;8385;64305;0;1066;42651478;41512847;26593457;4543916;42572501;28729773;4798719;0;32850
FR;1;2022-07-30;395;727;3349;14491;442;2850;14851;0;279;42651873;41513574;26596806;4558407;42572943;28732623;4813570;0;33129
FR;1;2022-07-31;141;264;900;2335;159;766;2477;0;47;42652014;41513838;26597706;4560742;42573102;28733389;4816047;0;33176
FR;1;2022-08-01;885;1474;7259;28968;1088;6121;29961;0;519;42652899;41515312;26604965;4589710;42574190;28739510;4846008;0;33695
FR;1;2022-08-02;931;1486;8239;54049;1001;6634;54688;0;1091;42653830;41516798;26613204;4643759;42575191;28746144;4900696;0;34786
FR;1;2022-08-03;738;1108;6157;37046;753;4939;37776;0;645;42654568;41517906;26619361;4680805;42575944;28751083;4938472;0;35431
FR;1;2022-08-04;651;1081;6264;41453;697;5058;42008;0;850;42655219;41518987;26625625;4722258;42576641;28756141;4980480;0;36281
FR;1;2022-08-05;745;1198;6766;43085;809;5436;43708;0;933;42655964;41520185;26632391;4765343;42577450;28761577;5024188;0;37214
FR;1;2022-08-06;277;465;1993;9000;305;1674;9192;0;218;42656241;41520650;26634384;4774343;42577755;28763251;5033380;0;37432
FR;1;2022-08-07;89;148;520;1558;104;436;1631;0;35;42656330;41520798;26634904;4775901;42577859;28763687;5035011;0;37467
FR;1;2022-08-08;603;1078;3807;21229;833;3141;21627;0;457;42656933;41521876;26638711;4797130;42578692;28766828;5056638;0;37924
FR;1;2022-08-09;669;1056;5683;38481;747;4558;38967;0;794;42657602;41522932;26644394;4835611;42579439;28771386;5095605;0;38718
FR;1;2022-08-10;571;1186;4435;26915;887;3636;27228;0;601;42658173;41524118;26648829;4862526;42580326;28775022;5122833;0;39319
FR;1;2022-08-11;566;920;4315;28212;632;3589;28540;0;634;42658739;41525038;26653144;4890738;42580958;28778611;5151373;0;39953
FR;1;2022-08-12;732;1044;4554;27171;720;3762;27583;0;668;42659471;41526082;26657698;4917909;42581678;28782373;5178956;0;40621
FR;1;2022-08-13;325;371;1248;5111;263;1066;5282;0;116;42659796;41526453;26658946;4923020;42581941;28783439;5184238;0;40737
FR;1;2022-08-14;67;115;277;871;96;236;941;0;24;42659863;41526568;26659223;4923891;42582037;28783675;5185179;0;40761
FR;1;2022-08-15;112;216;574;542;185;535;593;0;16;42659975;41526784;26659797;4924433;42582222;28784210;5185772;0;40777
FR;1;2022-08-16;551;953;3792;21491;712;3221;21692;0;582;42660526;41527737;26663589;4945924;42582934;28787431;5207464;0;41359
FR;1;2022-08-17;548;915;3769;22152;682;3195;22390;0;579;42661074;41528652;26667358;4968076;42583616;28790626;5229854;0;41938
FR;1;2022-08-18;562;899;3942;25455;700;3141;25677;0;630;42661636;41529551;26671300;4993531;42584316;28793767;5255531;0;42568
FR;1;2022-08-19;538;1050;4369;26547;749;3601;26855;0;732;42662174;41530601;26675669;5020078;42585065;28797368;5282386;0;43300
FR;1;2022-08-20;251;422;1290;5371;322;1107;5524;0;138;42662425;41531023;26676959;5025449;42585387;28798475;5287910;0;43438
FR;1;2022-08-21;84;112;287;990;77;253;1013;0;27;42662509;41531135;26677246;5026439;42585464;28798728;5288923;0;43465
FR;1;2022-08-22;511;900;3142;14956;674;2714;15232;0;411;42663020;41532035;26680388;5041395;42586138;28801442;5304155;0;43876
FR;1;2022-08-23;656;1064;4155;28323;748;3486;28405;0;830;42663676;41533099;26684543;5069718;42586886;28804928;5332560;0;44706
FR;1;2022-08-24;569;839;3405;19069;661;2774;19254;0;587;42664245;41533938;26687948;5088787;42587547;28807702;5351814;0;45293
FR;1;2022-08-25;565;937;3832;22919;654;3215;23148;0;655;42664810;41534875;26691780;5111706;42588201;28810917;5374962;0;45948
FR;1;2022-08-26;754;1137;4350;25157;810;3568;25532;0;745;42665564;41536012;26696130;5136863;42589011;28814485;5400494;0;46693
FR;1;2022-08-27;223;432;1324;5308;277;1191;5362;0;192;42665787;41536444;26697454;5142171;42589288;28815676;5405856;0;46885
FR;1;2022-08-28;113;147;298;900;106;280;949;0;33;42665900;41536591;26697752;5143071;42589394;28815956;5406805;0;46918
FR;1;2022-08-29;507;861;2979;14272;638;2519;14582;0;409;42666407;41537452;26700731;5157343;42590032;28818475;5421387;0;47327
FR;1;2022-08-30;746;1111;4626;27721;788;3776;28042;0;793;42667153;41538563;26705357;5185064;42590820;28822251;5449429;0;48120
FR;1;2022-08-31;587;835;3114;17243;614;2624;17505;0;483;42667740;41539398;26708471;5202307;42591434;28824875;5466934;0;48603
FR;1;2022-09-01;705;927;4333;21897;653;3693;22150;0;587;42668445;41540325;26712804;5224204;42592087;28828568;5489084;0;49190
FR;1;2022-09-02;895;1063;4887;27868;762;4084;28156;0;882;42669340;41541388;26717691;5252072;42592849;28832652;5517240;0;50072
FR;1;2022-09-03;322;511;1834;5876;349;1596;6105;0;174;42669662;41541899;26719525;5257948;42593198;28834248;5523345;0;50246
FR;1;2022-09-04;110;137;341;845;73;334;915;0;21;42669772;41542036;26719866;5258793;42593271;28834582;5524260;0;50267
FR;1;2022-09-05;731;873;3051;15698;697;2557;15982;0;499;42670503;41542909;26722917;5274491;42593968;28837139;5540242;0;50766
FR;1;2022-09-06;850;965;4572;31064;612;3712;31285;0;1002;42671353;41543874;26727489;5305555;42594580;28840851;5571527;0;51768
FR;1;2022-09-07;608;708;2921;16444;469;2426;16582;0;550;42671961;41544582;26730410;5321999;42595049;28843277;5588109;0;52318
FR;1;2022-09-08;585;796;3701;24224;543;3041;24305;0;796;42672546;41545378;26734111;5346223;42595592;28846318;5612414;0;53114
FR;1;2022-09-09;783;993;4307;26897;635;3597;27078;0;903;42673329;41546371;26738418;5373120;42596227;28849915;5639492;0;54017
FR;1;2022-09-10;351;579;1680;5590;410;1480;5782;0;203;42673680;41546950;26740098;5378710;42596637;28851395;5645274;0;54220
FR;1;2022-09-11;106;120;313;646;82;293;703;0;17;42673786;41547070;26740411;5379356;42596719;28851688;5645977;0;54237
FR;1;2022-09-12;485;605;2617;12955;426;2234;13235;0;462;42674271;41547675;26743028;5392311;42597145;28853922;5659212;0;54699
FR;1;2022-09-13;650;831;3872;25850;542;3385;25721;0;834;42674921;41548506;26746900;5418161;42597687;28857307;5684933;0;55533
FR;1;2022-09-14;626;724;2881;15702;508;2412;15938;0;537;42675547;41549230;26749781;5433863;42598195;28859719;5700871;0;56070
FR;1;2022-09-15;532;778;3345;23093;550;2851;23157;0;679;42676079;41550008;26753126;5456956;42598745;28862570;5724028;0;56749
FR;1;2022-09-16;726;947;4021;25351;630;3393;25550;0;891;42676805;41550955;26757147;5482307;42599375;28865963;5749578;0;57640
FR;1;2022-09-17;303;428;1397;5979;300;1222;6087;0;227;42677108;41551383;26758544;5488286;42599675;28867185;5755665;0;57867
FR;1;2022-09-18;99;126;310;924;103;278;980;0;34;42677207;41551509;26758854;5489210;42599778;28867463;5756645;0;57901
FR;1;2022-09-19;400;577;2142;12864;379;1837;13018;0;414;42677607;41552086;26760996;5502074;42600157;28869300;5769663;0;58315
FR;1;2022-09-20;564;841;3670;25830;589;3067;25870;0;854;42678171;41552927;26764666;5527904;42600746;28872367;5795533;0;59169
FR;1;2022-09-21;485;691;2628;15863;491;2256;15827;0;561;42678656;41553618;26767294;5543767;42601237;28874623;5811360;0;59730
FR;1;2022-09-22;549;778;3297;22998;517;2706;23176;0;745;42679205;41554396;26770591;5566765;42601754;28877329;5834536;0;60475
FR;1;2022-09-23;767;946;4353;28164;681;3634;28327;0;981;42679972;41555342;26774944;5594929;42602435;28880963;5862863;0;61456
FR;1;2022-09-24;356;540;1591;6706;379;1374;6880;0;300;42680328;41555882;26776535;5601635;42602814;28882337;5869743;0;61756
FR;1;2022-09-25;81;157;321;1072;111;293;1110;0;32;42680409;41556039;26776856;5602707;42602925;28882630;5870853;0;61788
FR;1;2022-09-26;383;654;2183;13078;432;1935;13172;0;412;42680792;41556693;26779039;5615785;42603357;28884565;5884025;0;62200
FR;1;2022-09-27;545;768;3458;25025;542;2794;25223;0;906;42681337;41557461;26782497;5640810;42603899;28887359;5909248;0;63106
FR;1;2022-09-28;525;720;2448;14971;507;2217;15060;0;597;42681862;41558181;26784945;5655781;42604406;28889576;5924308;0;63703
FR;1;2022-09-29;504;699;3003;20371;488;2527;20387;0;767;42682366;41558880;26787948;5676152;42604894;28892103;5944695;0;64470
FR;1;2022-09-30;694;996;3778;24429;705;3161;24678;0;970;42683060;41559876;26791726;5700581;42605599;28895264;5969373;0;65440
FR;1;2022-10-01;352;643;1905;5507;479;1659;5733;0;273;42683412;41560519;26793631;5706088;42606078;28896923;5975106;0;65713
FR;1;2022-10-02;56;120;204;568;82;204;589;0;29;42683468;41560639;26793835;5706656;42606160;28897127;5975695;0;65742
FR;1;2022-10-03;575;880;2226;10042;725;1986;10210;0;489;42684043;41561519;26796061;5716698;42606885;28899113;5985905;0;66231
FR;1;2022-10-04;683;738;2930;18922;507;2481;19010;0;1086;42684726;41562257;26798991;5735620;42607392;28901594;6004915;0;67317
FR;1;2022-10-05;487;727;2099;11114;501;1872;11243;0;723;42685213;41562984;26801090;5746734;42607893;28903466;6016158;0;68040
FR;1;2022-10-06;452;643;2498;15778;465;2063;15959;0;1063;42685665;41563627;26803588;5762512;42608358;28905529;6032117;0;69103
FR;1;2022-10-07;559;773;2694;16069;571;2311;16092;0;1164;42686224;41564400;26806282;5778581;42608929;28907840;6048209;0;70267
FR;1;2022-10-08;242;315;888;3171;248;776;3276;0;292;42686466;41564715;26807170;5781752;42609177;28908616;6051485;0;70559
FR;1;2022-10-09;76;93;151;461;83;135;487;0;51;42686542;41564808;26807321;5782213;42609260;28908751;6051972;0;70610
FR;1;2022-10-10;315;577;1324;4999;484;1240;5096;0;463;42686857;41565385;26808645;5787212;42609744;28909991;6057068;0;71073
FR;1;2022-10-11;339;457;1316;8086;343;1198;8187;0;758;42687196;41565842;26809961;5795298;42610087;28911189;6065255;0;71831
FR;1;2022-10-12;347;481;1078;5223;367;1076;5240;0;521;42687543;41566323;26811039;5800521;42610454;28912265;6070495;0;72352
FR;1;2022-10-13;338;450;1079;6099;360;936;6146;0;629;42687881;41566773;26812118;5806620;42610814;28913201;6076641;0;72981
FR;1;2022-10-14;413;554;1176;6712;468;1050;6781;0;676;42688294;41567327;26813294;5813332;42611282;28914251;6083422;0;73657
FR;1;2022-10-15;212;349;532;1860;301;515;1868;0;226;42688506;41567676;26813826;5815192;42611583;28914766;6085290;0;73883
FR;1;2022-10-16;47;68;111;296;49;118;315;0;48;42688553;41567744;26813937;5815488;42611632;28914884;6085605;0;73931
FR;1;2022-10-17;237;336;742;2653;268;698;2698;0;366;42688790;41568080;26814679;5818141;42611900;28915582;6088303;0;74297
FR;1;2022-10-18;266;319;956;4596;257;833;4700;0;866;42689056;41568399;26815635;5822737;42612157;28916415;6093003;0;75163
FR;1;2022-10-19;286;406;698;3187;339;667;3166;0;503;42689342;41568805;26816333;5825924;42612496;28917082;6096169;0;75666
FR;1;2022-10-20;289;357;903;4369;304;795;4404;0;771;42689631;41569162;26817236;5830293;42612800;28917877;6100573;0;76437
FR;1;2022-10-21;304;421;847;3807;372;743;3879;0;675;42689935;41569583;26818083;5834100;42613172;28918620;6104452;0;77112
FR;1;2022-10-22;135;184;306;1253;163;300;1218;0;210;42690070;41569767;26818389;5835353;42613335;28918920;6105670;0;77322
FR;1;2022-10-23;34;43;65;197;41;59;213;0;25;42690104;41569810;26818454;5835550;42613376;28918979;6105883;0;77347
FR;1;2022-10-24;273;237;479;1603;205;476;1660;0;306;42690377;41570047;26818933;5837153;42613581;28919455;6107543;0;77653
FR;1;2022-10-25;223;258;528;2651;227;449;2707;0;487;42690600;41570305;26819461;5839804;42613808;28919904;6110250;0;78140
FR;1;2022-10-26;236;251;394;1958;240;371;1965;0;439;42690836;41570556;26819855;5841762;42614048;28920275;6112215;0;78579
FR;1;2022-10-27;260;235;490;2167;207;509;2151;0;518;42691096;41570791;26820345;5843929;42614255;28920784;6114366;0;79097
FR;1;2022-10-28;313;336;534;2335;316;471;2402;0;478;42691409;41571127;26820879;5846264;42614571;28921255;6116768;0;79575
FR;1;2022-10-29;99;159;176;717;129;210;709;0;203;42691508;41571286;26821055;5846981;42614700;28921465;6117477;0;79778
FR;1;2022-10-30;38;51;62;184;43;56;189;0;38;42691546;41571337;26821117;5847165;42614743;28921521;6117666;0;79816
FR;1;2022-10-31;135;189;295;796;168;273;863;0;143;42691681;41571526;26821412;5847961;42614911;28921794;6118529;0;79959
FR;1;2022-11-01;77;135;768;115;117;768;134;0;19;42691758;41571661;26822180;5848076;42615028;28922562;6118663;0;79978
FR;1;2022-11-02;269;246;531;985;242;497;1048;0;356;42692027;41571907;26822711;5849061;42615270;28923059;6119711;0;80334
FR;1;2022-11-03;272;238;442;1380;223;404;1418;0;377;42692299;41572145;26823153;5850441;42615493;28923463;6121129;0;80711
FR;1;2022-11-04;233;262;424;1597;242;401;1637;0;438;42692532;41572407;26823577;5852038;42615735;28923864;6122766;0;81149
FR;1;2022-11-05;100;147;273;503;136;255;525;0;111;42692632;41572554;26823850;5852541;42615871;28924119;6123291;0;81260
FR;1;2022-11-06;36;49;32;131;48;35;129;0;33;42692668;41572603;26823882;5852672;42615919;28924154;6123420;0;81293
FR;1;2022-11-07;225;287;326;899;275;319;944;0;212;42692893;41572890;26824208;5853571;42616194;28924473;6124364;0;81505
FR;1;2022-11-08;240;267;472;1709;255;417;1738;0;524;42693133;41573157;26824680;5855280;42616449;28924890;6126102;0;82029
FR;1;2022-11-09;197;257;337;1104;247;303;1141;0;477;42693330;41573414;26825017;5856384;42616696;28925193;6127243;0;82506
FR;1;2022-11-10;216;394;437;1681;386;445;1670;0;605;42693546;41573808;26825454;5858065;42617082;28925638;6128913;0;83111
FR;1;2022-11-11;34;48;105;101;45;92;115;0;44;42693580;41573856;26825559;5858166;42617127;28925730;6129028;0;83155
FR;1;2022-11-12;95;152;257;375;138;257;390;0;101;42693675;41574008;26825816;5858541;42617265;28925987;6129418;0;83256
FR;1;2022-11-13;27;57;28;64;54;31;66;0;26;42693702;41574065;26825844;5858605;42617319;28926018;6129484;0;83282
FR;1;2022-11-14;175;184;271;768;172;275;838;0;235;42693877;41574249;26826115;5859373;42617491;28926293;6130322;0;83517
FR;1;2022-11-15;228;405;394;1300;404;372;1338;0;436;42694105;41574654;26826509;5860673;42617895;28926665;6131660;0;83953
FR;1;2022-11-16;197;273;336;983;267;350;1017;0;359;42694302;41574927;26826845;5861656;42618162;28927015;6132677;0;84312
FR;1;2022-11-17;171;212;297;1207;206;273;1211;0;387;42694473;41575139;26827142;5862863;42618368;28927288;6133888;0;84699
FR;1;2022-11-18;231;269;394;1315;261;383;1349;0;411;42694704;41575408;26827536;5864178;42618629;28927671;6135237;0;85110
FR;1;2022-11-19;120;115;249;441;114;214;474;0;102;42694824;41575523;26827785;5864619;42618743;28927885;6135711;0;85212
FR;1;2022-11-20;35;129;32;66;125;34;74;0;28;42694859;41575652;26827817;5864685;42618868;28927919;6135785;0;85240
FR;1;2022-11-21;174;173;271;641;146;288;678;0;211;42695033;41575825;26828088;5865326;42619014;28928207;6136463;0;85451
FR;1;2022-11-22;157;169;417;1160;152;398;1185;0;409;42695190;41575994;26828505;5866486;42619166;28928605;6137648;0;85860
FR;1;2022-11-23;179;186;246;763;171;247;786;0;241;42695369;41576180;26828751;5867249;42619337;28928852;6138434;0;86101
FR;1;2022-11-24;138;171;288;1213;151;301;1216;0;442;42695507;41576351;26829039;5868462;42619488;28929153;6139650;0;86543
FR;1;2022-11-25;210;249;429;1159;235;418;1191;0;392;42695717;41576600;26829468;5869621;42619723;28929571;6140841;0;86935
FR;1;2022-11-26;90;109;113;323;101;125;311;0;118;42695807;41576709;26829581;5869944;42619824;28929696;6141152;0;87053
FR;1;2022-11-27;18;38;22;72;25;34;78;0;49;42695825;41576747;26829603;5870016;42619849;28929730;6141230;0;87102
FR;1;2022-11-28;211;147;209;665;154;205;709;0;332;42696036;41576894;26829812;5870681;42620003;28929935;6141939;0;87434
FR;1;2022-11-29;172;145;269;1107;130;251;1119;0;458;42696208;41577039;26830081;5871788;42620133;28930186;6143058;0;87892
FR;1;2022-11-30;161;211;235;940;197;238;962;0;325;42696369;41577250;26830316;5872728;42620330;28930424;6144020;0;88217
FR;1;2022-12-01;183;162;716;1097;150;681;1146;0;379;42696552;41577412;26831032;5873825;42620480;28931105;6145166;0;88596
FR;1;2022-12-02;201;199;517;1187;194;513;1236;0;471;42696753;41577611;26831549;5875012;42620674;28931618;6146402;0;89067
FR;1;2022-12-03;102;112;263;532;100;240;530;0;180;42696855;41577723;26831812;5875544;42620774;28931858;6146932;0;89247
FR;1;2022-12-04;27;28;19;138;25;20;129;0;58;42696882;41577751;26831831;5875682;42620799;28931878;6147061;0;89305
FR;1;2022-12-05;148;171;308;868;167;303;902;0;318;42697030;41577922;26832139;5876550;42620966;28932181;6147963;0;89623
FR;1;2022-12-06;156;176;276;1449;162;281;1455;0;739;42697186;41578098;26832415;5877999;42621128;28932462;6149418;0;90362
FR;1;2022-12-07;155;173;256;1187;182;236;1203;0;576;42697341;41578271;26832671;5879186;42621310;28932698;6150621;0;90938
FR;1;2022-12-08;131;145;302;1757;137;259;1798;0;765;42697472;41578416;26832973;5880943;42621447;28932957;6152419;0;91703
FR;1;2022-12-09;202;197;357;1815;170;365;1836;0;721;42697674;41578613;26833330;5882758;42621617;28933322;6154255;0;92424
FR;1;2022-12-10;117;153;341;856;140;324;877;0;292;42697791;41578766;26833671;5883614;42621757;28933646;6155132;0;92716
FR;1;2022-12-11;32;30;32;219;27;30;201;0;62;42697823;41578796;26833703;5883833;42621784;28933676;6155333;0;92778
FR;1;2022-12-12;130;108;297;1101;105;284;1113;0;459;42697953;41578904;26834000;5884934;42621889;28933960;6156446;0;93237
FR;1;2022-12-13;126;134;293;1307;108;268;1321;0;618;42698079;41579038;26834293;5886241;42621997;28934228;6157767;0;93855
FR;1;2022-12-14;105;160;256;867;154;235;892;0;372;42698184;41579198;26834549;5887108;42622151;28934463;6158659;0;94227
FR;1;2022-12-15;139;183;457;1492;170;427;1518;0;691;42698323;41579381;26835006;5888600;42622321;28934890;6160177;0;94918
FR;1;2022-12-16;206;217;569;1344;220;553;1367;0;623;42698529;41579598;26835575;5889944;42622541;28935443;6161544;0;95541
FR;1;2022-12-17;88;93;224;468;82;219;476;0;204;42698617;41579691;26835799;5890412;42622623;28935662;6162020;0;95745
FR;1;2022-12-18;17;22;29;112;19;31;108;0;37;42698634;41579713;26835828;5890524;42622642;28935693;6162128;0;95782
FR;1;2022-12-19;151;132;251;791;140;221;835;0;382;42698785;41579845;26836079;5891315;42622782;28935914;6162963;0;96164
FR;1;2022-12-20;149;163;355;906;150;349;912;0;428;42698934;41580008;26836434;5892221;42622932;28936263;6163875;0;96592
FR;1;2022-12-21;139;112;218;638;122;183;647;0;388;42699073;41580120;26836652;5892859;42623054;28936446;6164522;0;96980
FR;1;2022-12-22;148;111;165;552;121;150;543;0;329;42699221;41580231;26836817;5893411;42623175;28936596;6165065;0;97309
FR;1;2022-12-23;130;157;458;419;141;448;426;0;182;42699351;41580388;26837275;5893830;42623316;28937044;6165491;0;97491
FR;1;2022-12-24;30;27;34;56;29;33;63;0;21;42699381;41580415;26837309;5893886;42623345;28937077;6165554;0;97512
FR;1;2022-12-25;4;11;20;12;12;14;15;0;11;42699385;41580426;26837329;5893898;42623357;28937091;6165569;0;97523
FR;1;2022-12-26;94;90;248;251;89;253;257;0;93;42699479;41580516;26837577;5894149;42623446;28937344;6165826;0;97616
FR;1;2022-12-27;117;160;311;387;151;317;402;0;180;42699596;41580676;26837888;5894536;42623597;28937661;6166228;0;97796
FR;1;2022-12-28;107;147;203;270;133;206;281;0;126;42699703;41580823;26838091;5894806;42623730;28937867;6166509;0;97922
FR;1;2022-12-29;105;109;154;282;109;153;303;0;114;42699808;41580932;26838245;5895088;42623839;28938020;6166812;0;98036
FR;1;2022-12-30;127;123;89;258;115;94;268;0;143;42699935;41581055;26838334;5895346;42623954;28938114;6167080;0;98179
FR;1;2022-12-31;38;35;28;79;40;25;79;0;25;42699973;41581090;26838362;5895425;42623994;28938139;6167159;0;98204
FR;1;2023-01-01;6;13;61;22;12;58;27;0;10;42699979;41581103;26838423;5895447;42624006;28938197;6167186;0;98214
FR;1;2023-01-02;597;155;678;169;163;658;194;0;64;42700576;41581258;26839101;5895616;42624169;28938855;6167380;0;98278
FR;1;2023-01-03;165;109;373;207;108;366;215;0;146;42700741;41581367;26839474;5895823;42624277;28939221;6167595;0;98424
FR;1;2023-01-04;96;99;249;198;100;250;208;0;193;42700837;41581466;26839723;5896021;42624377;28939471;6167803;0;98617
FR;1;2023-01-05;147;132;179;337;142;179;339;0;206;42700984;41581598;26839902;5896358;42624519;28939650;6168142;0;98823
FR;1;2023-01-06;200;144;226;325;147;212;350;0;230;42701184;41581742;26840128;5896683;42624666;28939862;6168492;0;99053
FR;1;2023-01-07;107;89;175;147;92;158;164;0;93;42701291;41581831;26840303;5896830;42624758;28940020;6168656;0;99146
FR;1;2023-01-08;27;19;31;59;18;26;64;0;24;42701318;41581850;26840334;5896889;42624776;28940046;6168720;0;99170
FR;1;2023-01-09;140;129;136;135;125;144;153;0;115;42701458;41581979;26840470;5897024;42624901;28940190;6168873;0;99285
FR;1;2023-01-10;119;140;284;277;137;291;278;0;192;42701577;41582119;26840754;5897301;42625038;28940481;6169151;0;99477
FR;1;2023-01-11;107;111;92;209;120;95;222;0;96;42701684;41582230;26840846;5897510;42625158;28940576;6169373;0;99573
FR;1;2023-01-12;136;123;214;243;118;214;268;0;166;42701820;41582353;26841060;5897753;42625276;28940790;6169641;0;99739
FR;1;2023-01-13;255;169;174;286;167;173;306;0;189;42702075;41582522;26841234;5898039;42625443;28940963;6169947;0;99928
FR;1;2023-01-14;89;64;162;104;66;172;103;0;62;42702164;41582586;26841396;5898143;42625509;28941135;6170050;0;99990
FR;1;2023-01-15;23;37;31;42;34;31;46;0;30;42702187;41582623;26841427;5898185;42625543;28941166;6170096;0;100020
FR;1;2023-01-16;113;104;310;155;98;314;133;0;101;42702300;41582727;26841737;5898340;42625641;28941480;6170229;0;100121
FR;1;2023-01-17;114;103;167;216;102;164;243;0;128;42702414;41582830;26841904;5898556;42625743;28941644;6170472;0;100249
FR;1;2023-01-18;99;90;97;143;89;92;184;0;121;42702513;41582920;26842001;5898699;42625832;28941736;6170656;0;100370
FR;1;2023-01-19;112;78;105;134;76;117;134;0;136;42702625;41582998;26842106;5898833;42625908;28941853;6170790;0;100506
FR;1;2023-01-20;170;150;168;278;151;196;267;0;204;42702795;41583148;26842274;5899111;42626059;28942049;6171057;0;100710
FR;1;2023-01-21;58;71;91;85;71;102;75;0;35;42702853;41583219;26842365;5899196;42626130;28942151;6171132;0;100745
FR;1;2023-01-22;10;9;14;21;7;9;26;0;14;42702863;41583228;26842379;5899217;42626137;28942160;6171158;0;100759
FR;1;2023-01-23;88;85;108;100;88;100;119;0;85;42702951;41583313;26842487;5899317;42626225;28942260;6171277;0;100844
FR;1;2023-01-24;122;76;73;122;89;70;131;0;183;42703073;41583389;26842560;5899439;42626314;28942330;6171408;0;101027
FR;1;2023-01-25;98;118;78;108;119;78;124;0;107;42703171;41583507;26842638;5899547;42626433;28942408;6171532;0;101134
FR;1;2023-01-26;104;105;63;152;94;68;173;0;108;42703275;41583612;26842701;5899699;42626527;28942476;6171705;0;101242
FR;1;2023-01-27;172;593;105;137;608;123;137;0;200;42703447;41584205;26842806;5899836;42627135;28942599;6171842;0;101442
FR;1;2023-01-28;73;74;56;40;76;53;48;0;28;42703520;41584279;26842862;5899876;42627211;28942652;6171890;0;101470
FR;1;2023-01-29;12;22;33;10;20;31;16;0;12;42703532;41584301;26842895;5899886;42627231;28942683;6171906;0;101482
FR;1;2023-01-30;144;108;64;72;110;70;80;0;51;42703676;41584409;26842959;5899958;42627341;28942753;6171986;0;101533
FR;1;2023-01-31;122;87;66;137;76;69;149;0;143;42703798;41584496;26843025;5900095;42627417;28942822;6172135;0;101676
FR;1;2023-02-01;122;148;345;106;146;338;134;0;77;42703920;41584644;26843370;5900201;42627563;28943160;6172269;0;101753
FR;1;2023-02-02;88;101;91;106;95;99;108;0;99;42704008;41584745;26843461;5900307;42627658;28943259;6172377;0;101852
FR;1;2023-02-03;156;148;133;98;148;139;104;0;97;42704164;41584893;26843594;5900405;42627806;28943398;6172481;0;101949
FR;1;2023-02-04;50;78;72;46;85;74;47;0;24;42704214;41584971;26843666;5900451;42627891;28943472;6172528;0;101973
FR;1;2023-02-05;6;8;19;6;7;22;7;0;8;42704220;41584979;26843685;5900457;42627898;28943494;6172535;0;101981
FR;1;2023-02-06;96;80;114;77;86;117;81;0;89;42704316;41585059;26843799;5900534;42627984;28943611;6172616;0;102070
FR;1;2023-02-07;92;76;97;77;77;91;97;0;115;42704408;41585135;26843896;5900611;42628061;28943702;6172713;0;102185
FR;1;2023-02-08;83;93;64;30;92;68;35;0;51;42704491;41585228;26843960;5900641;42628153;28943770;6172748;0;102236
FR;1;2023-02-09;65;65;83;59;75;82;67;0;79;42704556;41585293;26844043;5900700;42628228;28943852;6172815;0;102315
FR;1;2023-02-10;142;131;57;72;134;69;73;0;117;42704698;41585424;26844100;5900772;42628362;28943921;6172888;0;102432
FR;1;2023-02-11;45;53;78;25;50;87;27;0;11;42704743;41585477;26844178;5900797;42628412;28944008;6172915;0;102443
FR;1;2023-02-12;11;9;10;8;13;10;9;0;9;42704754;41585486;26844188;5900805;42628425;28944018;6172924;0;102452
FR;1;2023-02-13;91;119;47;42;120;54;34;0;31;42704845;41585605;26844235;5900847;42628545;28944072;6172958;0;102483
FR;1;2023-02-14;69;73;73;50;72;77;47;0;77;42704914;41585678;26844308;5900897;42628617;28944149;6173005;0;102560
FR;1;2023-02-15;76;103;77;52;111;83;60;0;81;42704990;41585781;26844385;5900949;42628728;28944232;6173065;0;102641
FR;1;2023-02-16;60;75;114;83;63;123;86;0;73;42705050;41585856;26844499;5901032;42628791;28944355;6173151;0;102714
FR;1;2023-02-17;105;125;172;61;130;176;70;0;47;42705155;41585981;26844671;5901093;42628921;28944531;6173221;0;102761
FR;1;2023-02-18;44;57;147;41;57;153;43;0;9;42705199;41586038;26844818;5901134;42628978;28944684;6173264;0;102770
FR;1;2023-02-19;14;0;6;4;2;5;4;0;5;42705213;41586038;26844824;5901138;42628980;28944689;6173268;0;102775
FR;1;2023-02-20;77;73;51;28;77;56;32;0;16;42705290;41586111;26844875;5901166;42629057;28944745;6173300;0;102791
FR;1;2023-02-21;62;74;54;49;78;57;47;0;38;42705352;41586185;26844929;5901215;42629135;28944802;6173347;0;102829
FR;1;2023-02-22;65;77;32;18;78;36;18;0;22;42705417;41586262;26844961;5901233;42629213;28944838;6173365;0;102851
FR;1;2023-02-23;52;79;48;36;77;58;31;0;54;42705469;41586341;26845009;5901269;42629290;28944896;6173396;0;102905
FR;1;2023-02-24;95;111;48;33;112;56;34;0;38;42705564;41586452;26845057;5901302;42629402;28944952;6173430;0;102943
FR;1;2023-02-25;42;49;69;22;56;69;24;0;26;42705606;41586501;26845126;5901324;42629458;28945021;6173454;0;102969
FR;1;2023-02-26;2;4;1;2;2;3;1;0;3;42705608;41586505;26845127;5901326;42629460;28945024;6173455;0;102972
FR;1;2023-02-27;91;77;62;35;77;70;32;0;21;42705699;41586582;26845189;5901361;42629537;28945094;6173487;0;102993
FR;1;2023-02-28;87;72;35;50;68;45;52;0;33;42705786;41586654;26845224;5901411;42629605;28945139;6173539;0;103026
FR;1;2023-03-01;73;90;242;52;88;234;69;0;42;42705859;41586744;26845466;5901463;42629693;28945373;6173608;0;103068
FR;1;2023-03-02;65;64;91;55;65;87;67;0;117;42705924;41586808;26845557;5901518;42629758;28945460;6173675;0;103185
FR;1;2023-03-03;106;108;72;53;107;70;57;0;47;42706030;41586916;26845629;5901571;42629865;28945530;6173732;0;103232
FR;1;2023-03-04;51;46;70;26;43;71;31;0;15;42706081;41586962;26845699;5901597;42629908;28945601;6173763;0;103247
FR;1;2023-03-05;4;2;5;0;3;5;1;0;0;42706085;41586964;26845704;5901597;42629911;28945606;6173764;0;103247
FR;1;2023-03-06;86;57;79;17;63;85;23;0;14;42706171;41587021;26845783;5901614;42629974;28945691;6173787;0;103261
FR;1;2023-03-07;53;71;47;40;68;45;50;0;71;42706224;41587092;26845830;5901654;42630042;28945736;6173837;0;103332
FR;1;2023-03-08;47;65;32;16;68;34;22;0;6;42706271;41587157;26845862;5901670;42630110;28945770;6173859;0;103338
FR;1;2023-03-09;37;55;45;22;49;50;31;0;30;42706308;41587212;26845907;5901692;42630159;28945820;6173890;0;103368
FR;1;2023-03-10;93;97;85;41;97;89;46;0;25;42706401;41587309;26845992;5901733;42630256;28945909;6173936;0;103393
FR;1;2023-03-11;47;39;51;9;33;57;13;0;6;42706448;41587348;26846043;5901742;42630289;28945966;6173949;0;103399
FR;1;2023-03-12;2;10;7;0;12;6;1;0;0;42706450;41587358;26846050;5901742;42630301;28945972;6173950;0;103399
FR;1;2023-03-13;48;67;39;15;63;46;14;0;19;42706498;41587425;26846089;5901757;42630364;28946018;6173964;0;103418
FR;1;2023-03-14;68;48;55;21;52;59;23;0;31;42706566;41587473;26846144;5901778;42630416;28946077;6173987;0;103449
FR;1;2023-03-15;40;70;74;60;69;77;67;0;47;42706606;41587543;26846218;5901838;42630485;28946154;6174054;0;103496
FR;1;2023-03-16;55;49;88;24;53;87;28;0;20;42706661;41587592;26846306;5901862;42630538;28946241;6174082;0;103516
FR;1;2023-03-17;109;89;101;37;103;104;41;0;35;42706770;41587681;26846407;5901899;42630641;28946345;6174123;0;103551
FR;1;2023-03-18;34;33;144;10;28;148;15;0;5;42706804;41587714;26846551;5901909;42630669;28946493;6174138;0;103556
FR;1;2023-03-19;11;4;2;2;5;2;3;0;0;42706815;41587718;26846553;5901911;42630674;28946495;6174141;0;103556
FR;1;2023-03-20;44;59;49;29;49;58;33;0;24;42706859;41587777;26846602;5901940;42630723;28946553;6174174;0;103580
FR;1;2023-03-21;73;61;42;11;66;45;16;0;26;42706932;41587838;26846644;5901951;42630789;28946598;6174190;0;103606
FR;1;2023-03-22;58;54;37;31;54;51;26;0;13;42706990;41587892;26846681;5901982;42630843;28946649;6174216;0;103619
FR;1;2023-03-23;58;47;37;23;48;41;25;0;47;42707048;41587939;26846718;5902005;42630891;28946690;6174241;0;103666
FR;1;2023-03-24;77;103;190;29;106;196;35;0;23;42707125;41588042;26846908;5902034;42630997;28946886;6174276;0;103689
FR;1;2023-03-25;47;51;48;11;48;52;15;0;5;42707172;41588093;26846956;5902045;42631045;28946938;6174291;0;103694
FR;1;2023-03-26;2;3;9;0;0;10;2;0;2;42707174;41588096;26846965;5902045;42631045;28946948;6174293;0;103696
FR;1;2023-03-27;104;58;68;11;61;71;15;0;22;42707278;41588154;26847033;5902056;42631106;28947019;6174308;0;103718
FR;1;2023-03-28;48;38;23;21;41;25;21;0;31;42707326;41588192;26847056;5902077;42631147;28947044;6174329;0;103749
FR;1;2023-03-29;55;46;31;28;45;38;25;0;14;42707381;41588238;26847087;5902105;42631192;28947082;6174354;0;103763
FR;1;2023-03-30;56;42;58;19;45;57;26;0;30;42707437;41588280;26847145;5902124;42631237;28947139;6174380;0;103793
FR;1;2023-03-31;66;84;28;16;82;34;13;0;35;42707503;41588364;26847173;5902140;42631319;28947173;6174393;0;103828
FR;1;2023-04-01;29;53;127;10;50;129;17;0;10;42707532;41588417;26847300;5902150;42631369;28947302;6174410;0;103838
FR;1;2023-04-02;1;1;8;0;1;7;1;0;0;42707533;41588418;26847308;5902150;42631370;28947309;6174411;0;103838
FR;1;2023-04-03;91;50;147;28;45;149;34;0;19;42707624;41588468;26847455;5902178;42631415;28947458;6174445;0;103857
FR;1;2023-04-04;40;51;40;11;43;47;12;0;25;42707664;41588519;26847495;5902189;42631458;28947505;6174457;0;103882
FR;1;2023-04-05;25;41;33;19;38;27;27;0;14;42707689;41588560;26847528;5902208;42631496;28947532;6174484;0;103896
FR;1;2023-04-06;43;45;33;11;42;35;16;0;15;42707732;41588605;26847561;5902219;42631538;28947567;6174500;0;103911
FR;1;2023-04-07;48;63;33;17;63;37;16;0;13;42707780;41588668;26847594;5902236;42631601;28947604;6174516;0;103924
FR;1;2023-04-08;25;32;11;13;25;18;13;0;13;42707805;41588700;26847605;5902249;42631626;28947622;6174529;0;103937
FR;1;2023-04-09;5;2;0;2;1;1;2;0;1;42707810;41588702;26847605;5902251;42631627;28947623;6174531;0;103938
FR;1;2023-04-10;5;15;22;1;15;24;1;0;1;42707815;41588717;26847627;5902252;42631642;28947647;6174532;0;103939
FR;1;2023-04-11;40;52;22;12;51;21;14;0;17;42707855;41588769;26847649;5902264;42631693;28947668;6174546;0;103956
FR;1;2023-04-12;36;35;36;19;33;41;22;0;24;42707891;41588804;26847685;5902283;42631726;28947709;6174568;0;103980
FR;1;2023-04-13;36;38;20;16;39;25;14;0;26;42707927;41588842;26847705;5902299;42631765;28947734;6174582;0;104006
FR;1;2023-04-14;59;69;131;15;78;125;22;0;17;42707986;41588911;26847836;5902314;42631843;28947859;6174604;0;104023
FR;1;2023-04-15;28;28;36;10;28;39;12;0;2;42708014;41588939;26847872;5902324;42631871;28947898;6174616;0;104025
FR;1;2023-04-16;3;2;0;0;2;0;0;0;0;42708017;41588941;26847872;5902324;42631873;28947898;6174616;0;104025
FR;1;2023-04-17;37;38;59;16;41;64;15;0;11;42708054;41588979;26847931;5902340;42631914;28947962;6174631;0;104036
FR;1;2023-04-18;37;40;27;7;35;41;12;0;24;42708091;41589019;26847958;5902347;42631949;28948003;6174643;0;104060
FR;1;2023-04-19;36;57;13;8;57;14;10;0;14;42708127;41589076;26847971;5902355;42632006;28948017;6174653;0;104074
FR;1;2023-04-20;27;40;39;16;41;40;17;0;15;42708154;41589116;26848010;5902371;42632047;28948057;6174670;0;104089
FR;1;2023-04-21;46;63;116;17;60;118;21;0;18;42708200;41589179;26848126;5902388;42632107;28948175;6174691;0;104107
FR;1;2023-04-22;19;23;34;9;20;39;9;0;4;42708219;41589202;26848160;5902397;42632127;28948214;6174700;0;104111
FR;1;2023-04-23;0;1;2;1;1;2;1;0;0;42708219;41589203;26848162;5902398;42632128;28948216;6174701;0;104111
FR;1;2023-04-24;57;39;29;5;37;33;6;0;8;42708276;41589242;26848191;5902403;42632165;28948249;6174707;0;104119
FR;1;2023-04-25;31;34;22;16;30;23;20;0;15;42708307;41589276;26848213;5902419;42632195;28948272;6174727;0;104134
FR;1;2023-04-26;31;24;9;6;24;14;8;0;8;42708338;41589300;26848222;5902425;42632219;28948286;6174735;0;104142
FR;1;2023-04-27;32;35;31;25;30;36;28;0;12;42708370;41589335;26848253;5902450;42632249;28948322;6174763;0;104154
FR;1;2023-04-28;69;53;22;14;47;28;20;0;11;42708439;41589388;26848275;5902464;42632296;28948350;6174783;0;104165
FR;1;2023-04-29;19;19;14;7;18;12;11;0;9;42708458;41589407;26848289;5902471;42632314;28948362;6174794;0;104174
FR;1;2023-04-30;6;0;0;1;0;0;1;0;0;42708464;41589407;26848289;5902472;42632314;28948362;6174795;0;104174
FR;1;2023-05-01;0;12;29;1;12;29;1;0;0;42708464;41589419;26848318;5902473;42632326;28948391;6174796;0;104174
FR;1;2023-05-02;94;54;131;12;58;126;24;0;19;42708558;41589473;26848449;5902485;42632384;28948517;6174820;0;104193
FR;1;2023-05-03;51;29;41;5;25;45;7;0;9;42708609;41589502;26848490;5902490;42632409;28948562;6174827;0;104202
FR;1;2023-05-04;19;33;63;26;33;82;35;0;18;42708628;41589535;26848553;5902516;42632442;28948644;6174862;0;104220
FR;1;2023-05-05;27;31;20;3;32;16;7;0;8;42708655;41589566;26848573;5902519;42632474;28948660;6174869;0;104228
FR;1;2023-05-06;11;7;6;3;8;7;4;0;7;42708666;41589573;26848579;5902522;42632482;28948667;6174873;0;104235
FR;1;2023-05-07;2;2;4;4;2;3;2;0;1;42708668;41589575;26848583;5902526;42632484;28948670;6174875;0;104236
FR;1;2023-05-08;7;3;4;1;3;4;1;0;0;42708675;41589578;26848587;5902527;42632487;28948674;6174876;0;104236
FR;1;2023-05-09;14;16;11;3;14;11;6;0;9;42708689;41589594;26848598;5902530;42632501;28948685;6174882;0;104245
FR;1;2023-05-10;19;18;6;11;18;8;8;0;1;42708708;41589612;26848604;5902541;42632519;28948693;6174890;0;104246
FR;1;2023-05-11;13;18;6;9;18;7;8;0;21;42708721;41589630;26848610;5902550;42632537;28948700;6174898;0;104267
FR;1;2023-05-12;16;42;25;15;39;30;18;0;11;42708737;41589672;26848635;5902565;42632576;28948730;6174916;0;104278
FR;1;2023-05-13;12;20;7;2;21;7;2;0;2;42708749;41589692;26848642;5902567;42632597;28948737;6174918;0;104280
FR;1;2023-05-14;12;1;1;0;1;1;0;0;0;42708761;41589693;26848643;5902567;42632598;28948738;6174918;0;104280
FR;1;2023-05-15;17;18;35;4;17;35;6;0;9;42708778;41589711;26848678;5902571;42632615;28948773;6174924;0;104289
FR;1;2023-05-16;17;25;17;30;22;17;35;0;49;42708795;41589736;26848695;5902601;42632637;28948790;6174959;0;104338
FR;1;2023-05-17;21;46;4;6;46;5;6;0;15;42708816;41589782;26848699;5902607;42632683;28948795;6174965;0;104353
FR;1;2023-05-18;0;3;1;0;3;1;0;0;1;42708816;41589785;26848700;5902607;42632686;28948796;6174965;0;104354
FR;1;2023-05-19;13;24;54;11;21;59;13;0;15;42708829;41589809;26848754;5902618;42632707;28948855;6174978;0;104369
FR;1;2023-05-20;6;7;9;5;6;8;8;0;6;42708835;41589816;26848763;5902623;42632713;28948863;6174986;0;104375
FR;1;2023-05-21;6;0;0;0;0;0;0;0;1;42708841;41589816;26848763;5902623;42632713;28948863;6174986;0;104376
FR;1;2023-05-22;41;16;30;6;16;30;7;0;7;42708882;41589832;26848793;5902629;42632729;28948893;6174993;0;104383
FR;1;2023-05-23;7;19;3;6;19;4;6;0;13;42708889;41589851;26848796;5902635;42632748;28948897;6174999;0;104396
FR;1;2023-05-24;14;19;7;16;19;7;18;0;29;42708903;41589870;26848803;5902651;42632767;28948904;6175017;0;104425
FR;1;2023-05-25;14;11;4;5;9;6;7;0;26;42708917;41589881;26848807;5902656;42632776;28948910;6175024;0;104451
FR;1;2023-05-26;25;19;13;8;17;15;10;0;10;42708942;41589900;26848820;5902664;42632793;28948925;6175034;0;104461
FR;1;2023-05-27;5;14;1;3;13;2;4;0;4;42708947;41589914;26848821;5902667;42632806;28948927;6175038;0;104465
FR;1;2023-05-28;1;2;1;0;2;1;0;0;0;42708948;41589916;26848822;5902667;42632808;28948928;6175038;0;104465
FR;1;2023-05-29;0;0;0;0;0;0;0;0;0;42708948;41589916;26848822;5902667;42632808;28948928;6175038;0;104465
FR;1;2023-05-30;40;16;14;24;18;16;27;0;32;42708988;41589932;26848836;5902691;42632826;28948944;6175065;0;104497
FR;1;2023-05-31;19;29;8;11;21;12;17;0;27;42709007;41589961;26848844;5902702;42632847;28948956;6175082;0;104524
FR;1;2023-06-01;10;20;21;12;15;24;12;0;19;42709017;41589981;26848865;5902714;42632862;28948980;6175094;0;104543
FR;1;2023-06-02;12;21;4;1;17;10;2;0;13;42709029;41590002;26848869;5902715;42632879;28948990;6175096;0;104556
FR;1;2023-06-03;4;7;1;2;7;2;2;0;0;42709033;41590009;26848870;5902717;42632886;28948992;6175098;0;104556
FR;1;2023-06-04;0;12;0;0;12;0;0;0;0;42709033;41590021;26848870;5902717;42632898;28948992;6175098;0;104556
FR;1;2023-06-05;50;16;6;5;15;7;7;0;8;42709083;41590037;26848876;5902722;42632913;28948999;6175105;0;104564
FR;1;2023-06-06;18;18;5;4;16;6;8;0;10;42709101;41590055;26848881;5902726;42632929;28949005;6175113;0;104574
FR;1;2023-06-07;14;10;2;3;9;2;4;0;5;42709115;41590065;26848883;5902729;42632938;28949007;6175117;0;104579
FR;1;2023-06-08;13;4;4;2;3;7;6;0;37;42709128;41590069;26848887;5902731;42632941;28949014;6175123;0;104616
FR;1;2023-06-09;17;32;8;13;30;9;13;0;32;42709145;41590101;26848895;5902744;42632971;28949023;6175136;0;104648
FR;1;2023-06-10;9;4;8;0;2;8;2;0;1;42709154;41590105;26848903;5902744;42632973;28949031;6175138;0;104649
FR;1;2023-06-11;0;0;0;0;0;0;0;0;0;42709154;41590105;26848903;5902744;42632973;28949031;6175138;0;104649
FR;1;2023-06-12;5;8;2;1;8;2;2;0;9;42709159;41590113;26848905;5902745;42632981;28949033;6175140;0;104658
FR;2;2020-12-27;0;0;0;0;0;0;0;0;0;0;0;0;0;0;0;0;0;0
FR;2;2020-12-28;0;0;0;0;0;0;0;0;0;0;0;0;0;0;0;0;0;0
FR;2;2020-12-29;0;0;0;0;0;0;0;0;0;0;0;0;0;0;0;0;0;0
FR;2;2020-12-30;0;0;0;0;0;0;0;0;0;0;0;0;0;0;0;0;0;0
FR;2;2020-12-31;0;0;0;0;0;0;0;0;0;0;0;0;0;0;0;0;0;0
FR;2;2021-01-01;0;0;0;0;0;0;0;0;0;0;0;0;0;0;0;0;0;0
FR;2;2021-01-02;0;0;0;0;0;0;0;0;0;0;0;0;0;0;0;0;0;0
FR;2;2021-01-03;0;0;0;0;0;0;0;0;0;0;0;0;0;0;0;0;0;0
FR;2;2021-01-04;0;0;0;0;0;0;0;0;0;0;0;0;0;0;0;0;0;0
FR;2;2021-01-05;0;0;0;0;0;0;0;0;0;0;0;0;0;0;0;0;0;0
FR;2;2021-01-06;0;0;0;0;0;0;0;0;0;0;0;0;0;0;0;0;0;0
FR;2;2021-01-07;0;0;0;0;0;0;0;0;0;0;0;0;0;0;0;0;0;0
FR;2;2021-01-08;0;0;0;0;0;0;0;0;0;0;0;0;0;0;0;0;0;0
FR;2;2021-01-09;0;0;0;0;0;0;0;0;0;0;0;0;0;0;0;0;0;0
FR;2;2021-01-10;0;0;0;0;0;0;0;0;0;0;0;0;0;0;0;0;0;0
FR;2;2021-01-11;0;0;0;0;0;0;0;0;0;0;0;0;0;0;0;0;0;0
FR;2;2021-01-12;0;0;0;0;0;0;0;0;0;0;0;0;0;0;0;0;0;0
FR;2;2021-01-13;0;0;0;0;0;0;0;0;0;0;0;0;0;0;0;0;0;0
FR;2;2021-01-14;1636;0;0;0;213;0;0;0;0;1636;0;0;0;213;0;0;0;0
FR;2;2021-01-15;398;0;0;0;28;0;0;0;0;2034;0;0;0;241;0;0;0;0
FR;2;2021-01-16;316;0;0;0;12;0;0;0;0;2350;0;0;0;253;0;0;0;0
FR;2;2021-01-17;84;0;0;0;7;0;0;0;0;2434;0;0;0;260;0;0;0;0
FR;2;2021-01-18;3075;3;0;0;27;0;0;0;0;5509;3;0;0;287;0;0;0;0
FR;2;2021-01-19;4681;2;0;0;31;0;0;0;0;10190;5;0;0;318;0;0;0;0
FR;2;2021-01-20;5138;6;0;0;58;0;0;0;0;15328;11;0;0;376;0;0;0;0
FR;2;2021-01-21;5346;9;0;0;55;0;0;0;0;20674;20;0;0;431;0;0;0;0
FR;2;2021-01-22;5119;19;0;0;70;0;0;0;0;25793;39;0;0;501;0;0;0;0
FR;2;2021-01-23;1875;2;0;0;16;0;0;0;0;27668;41;0;0;517;0;0;0;0
FR;2;2021-01-24;163;2;0;0;8;0;0;0;0;27831;43;0;0;525;0;0;0;0
FR;2;2021-01-25;3814;4;0;0;37;0;0;0;0;31645;47;0;0;562;0;0;0;0
FR;2;2021-01-26;3930;6;0;0;42;0;0;0;0;35575;53;0;0;604;0;0;0;0
FR;2;2021-01-27;3606;4;0;0;36;0;0;0;0;39181;57;0;0;640;0;0;0;0
FR;2;2021-01-28;3757;9;0;0;44;0;0;0;0;42938;66;0;0;684;0;0;0;0
FR;2;2021-01-29;3300;6;0;0;42;0;0;0;0;46238;72;0;0;726;0;0;0;0
FR;2;2021-01-30;1133;3;0;0;16;0;0;0;0;47371;75;0;0;742;0;0;0;0
FR;2;2021-01-31;47;2;0;0;9;0;0;0;0;47418;77;0;0;751;0;0;0;0
FR;2;2021-02-01;3408;13;0;0;44;0;0;0;0;50826;90;0;0;795;0;0;0;0
FR;2;2021-02-02;4498;19;0;0;53;0;0;0;0;55324;109;0;0;848;0;0;0;0
FR;2;2021-02-03;5223;12;0;0;83;0;0;0;0;60547;121;0;0;931;0;0;0;0
FR;2;2021-02-04;4941;11;0;0;36;0;0;0;0;65488;132;0;0;967;0;0;0;0
FR;2;2021-02-05;4817;17;0;0;50;0;0;0;0;70305;149;0;0;1017;0;0;0;0
FR;2;2021-02-06;2047;15;0;0;41;0;0;0;0;72352;164;0;0;1058;0;0;0;0
FR;2;2021-02-07;103;6;0;0;20;0;0;0;0;72455;170;0;0;1078;0;0;0;0
FR;2;2021-02-08;7559;27;0;0;86;0;0;0;0;80014;197;0;0;1164;0;0;0;0
FR;2;2021-02-09;8435;31;0;0;100;0;0;0;0;88449;228;0;0;1264;0;0;0;0
FR;2;2021-02-10;9349;63;0;0;183;0;0;0;0;97798;291;0;0;1447;0;0;0;0
FR;2;2021-02-11;10292;132;0;0;256;0;0;0;0;108090;423;0;0;1703;0;0;0;0
FR;2;2021-02-12;10059;276;0;0;430;0;0;0;0;118149;699;0;0;2133;0;0;0;0
FR;2;2021-02-13;3121;223;0;0;261;0;0;0;0;121270;922;0;0;2394;0;0;0;0
FR;2;2021-02-14;358;11;0;0;21;0;0;0;0;121628;933;0;0;2415;0;0;0;0
FR;2;2021-02-15;3460;3129;0;0;3176;0;0;0;0;125088;4062;0;0;5591;0;0;0;0
FR;2;2021-02-16;5076;4164;0;0;4237;0;0;0;0;130164;8226;0;0;9828;0;0;0;0
FR;2;2021-02-17;4259;4555;0;0;4632;0;0;0;0;134423;12781;0;0;14460;0;0;0;0
FR;2;2021-02-18;5406;5179;0;0;5249;0;0;0;0;139829;17960;0;0;19709;0;0;0;0
FR;2;2021-02-19;5329;4491;0;0;4592;0;0;0;0;145158;22451;0;0;24301;0;0;0;0
FR;2;2021-02-20;1872;1520;0;0;1537;0;0;0;0;147030;23971;0;0;25838;0;0;0;0
FR;2;2021-02-21;244;96;0;0;98;0;0;0;0;147274;24067;0;0;25936;0;0;0;0
FR;2;2021-02-22;3614;3782;0;0;3844;0;0;0;0;150888;27849;0;0;29780;0;0;0;0
FR;2;2021-02-23;4956;3741;0;0;3805;0;0;0;0;155844;31590;0;0;33585;0;0;0;0
FR;2;2021-02-24;5017;3558;0;0;3611;0;0;0;0;160861;35148;0;0;37196;0;0;0;0
FR;2;2021-02-25;5501;3495;0;0;3585;0;0;0;0;166362;38643;0;0;40781;0;0;0;0
FR;2;2021-02-26;4368;3179;0;0;3253;0;0;0;0;170730;41822;0;0;44034;0;0;0;0
FR;2;2021-02-27;1629;1067;0;0;1086;0;0;0;0;172359;42889;0;0;45120;0;0;0;0
FR;2;2021-02-28;179;17;0;0;28;0;0;0;0;172538;42906;0;0;45148;0;0;0;0
FR;2;2021-03-01;5193;3763;0;0;3852;0;0;0;0;177731;46669;0;0;49000;0;0;0;0
FR;2;2021-03-02;6542;4728;0;0;4829;0;0;0;0;184273;51397;0;0;53829;0;0;0;0
FR;2;2021-03-03;6544;4955;0;0;5096;0;0;0;0;190817;56352;0;0;58925;0;0;0;0
FR;2;2021-03-04;8412;4210;0;0;4396;0;0;0;0;199229;60562;0;0;63321;0;0;0;0
FR;2;2021-03-05;8037;4054;0;0;4237;0;0;0;0;207266;64616;0;0;67558;0;0;0;0
FR;2;2021-03-06;4791;1683;0;0;1783;0;0;0;0;212057;66299;0;0;69341;0;0;0;0
FR;2;2021-03-07;2373;32;0;0;76;0;0;0;0;214430;66331;0;0;69417;0;0;0;0
FR;2;2021-03-08;4166;8392;0;0;8549;0;0;0;0;218596;74723;0;0;77966;0;0;0;0
FR;2;2021-03-09;7494;8610;1;0;8869;0;0;0;0;226090;83333;1;0;86835;0;0;0;0
FR;2;2021-03-10;7108;9246;0;0;9473;0;0;0;0;233198;92579;1;0;96308;0;0;0;0
FR;2;2021-03-11;9379;9365;1;0;9686;0;0;0;0;242577;101944;2;0;105994;0;0;0;0
FR;2;2021-03-12;7989;8368;0;0;8671;0;0;0;0;250566;110312;2;0;114665;0;0;0;0
FR;2;2021-03-13;10058;2593;0;0;2914;0;0;0;0;260624;112905;2;0;117579;0;0;0;0
FR;2;2021-03-14;4841;380;0;0;539;0;0;0;0;265465;113285;2;0;118118;0;0;0;0
FR;2;2021-03-15;10919;3476;0;0;3765;0;0;0;0;276384;116761;2;0;121883;0;0;0;0
FR;2;2021-03-16;16770;4733;1;0;5283;0;0;0;0;293154;121494;3;0;127166;0;0;0;0
FR;2;2021-03-17;20242;3998;0;0;4672;0;0;0;0;313396;125492;3;0;131838;0;0;0;0
FR;2;2021-03-18;23375;5128;0;0;5957;0;0;0;0;336771;130620;3;0;137795;0;0;0;0
FR;2;2021-03-19;23316;4680;0;0;5443;0;0;0;0;360087;135300;3;0;143238;0;0;0;0
FR;2;2021-03-20;25452;1588;0;0;2345;0;0;0;0;385539;136888;3;0;145583;0;0;0;0
FR;2;2021-03-21;17675;153;0;0;731;0;0;0;0;403214;137041;3;0;146314;0;0;0;0
FR;2;2021-03-22;17791;3275;0;0;3944;0;0;0;0;421005;140316;3;0;150258;0;0;0;0
FR;2;2021-03-23;22707;4288;0;0;5143;0;0;0;0;443712;144604;3;0;155401;0;0;0;0
FR;2;2021-03-24;23966;5100;0;0;5937;0;0;0;0;467678;149704;3;0;161338;0;0;0;0
FR;2;2021-03-25;26762;5259;1;0;6456;0;0;0;0;494440;154963;4;0;167794;0;0;0;0
FR;2;2021-03-26;26992;4236;0;0;5382;0;0;0;0;521432;159199;4;0;173176;0;0;0;0
FR;2;2021-03-27;15923;1369;0;0;1899;0;0;0;0;537355;160568;4;0;175075;0;0;0;0
FR;2;2021-03-28;10563;135;0;0;427;0;0;0;0;547918;160703;4;0;175502;0;0;0;0
FR;2;2021-03-29;19004;4349;0;0;5049;0;0;0;0;566922;165052;4;0;180551;0;0;0;0
FR;2;2021-03-30;24597;6105;0;0;7045;0;0;0;0;591519;171157;4;0;187596;0;0;0;0
FR;2;2021-03-31;28562;5931;0;0;7224;0;0;0;0;620081;177088;4;0;194820;0;0;0;0
FR;2;2021-04-01;34560;8576;1;0;10269;0;0;0;0;654641;185664;5;0;205089;0;0;0;0
FR;2;2021-04-02;29992;7736;0;0;9165;0;0;0;0;684633;193400;5;0;214254;0;0;0;0
FR;2;2021-04-03;16959;4263;0;0;4945;0;0;0;0;701592;197663;5;0;219199;0;0;0;0
FR;2;2021-04-04;9309;1269;2;0;1677;0;0;0;0;710901;198932;7;0;220876;0;0;0;0
FR;2;2021-04-05;12448;797;0;0;1381;0;0;0;0;723349;199729;7;0;222257;0;0;0;0
FR;2;2021-04-06;27159;7359;0;0;8751;0;0;0;0;750508;207088;7;0;231008;0;0;0;0
FR;2;2021-04-07;30931;7070;1;0;8646;0;0;0;0;781439;214158;8;0;239654;0;0;0;0
FR;2;2021-04-08;36896;8592;1;0;10517;0;0;0;0;818335;222750;9;0;250171;0;0;0;0
FR;2;2021-04-09;33856;8391;28;0;10176;0;0;0;0;852191;231141;37;0;260347;0;0;0;0
FR;2;2021-04-10;19689;9270;1;0;10182;0;0;0;0;871880;240411;38;0;270529;0;0;0;0
FR;2;2021-04-11;7943;4240;1;0;4603;0;0;0;0;879823;244651;39;0;275132;0;0;0;0
FR;2;2021-04-12;17137;11028;0;0;11870;0;0;0;0;896960;255679;39;0;287002;0;0;0;0
FR;2;2021-04-13;19465;16034;1;0;17102;0;0;0;0;916425;271713;40;0;304104;0;0;0;0
FR;2;2021-04-14;18071;16446;7;0;17542;0;0;0;0;934496;288159;47;0;321646;0;0;0;0
FR;2;2021-04-15;22208;21892;27;0;23346;0;0;0;0;956704;310051;74;0;344992;0;0;0;0
FR;2;2021-04-16;20721;20640;45;0;21913;0;0;0;0;977425;330691;119;0;366905;0;0;0;0
FR;2;2021-04-17;13258;22496;5;0;23227;0;0;0;0;990683;353187;124;0;390132;0;0;0;0
FR;2;2021-04-18;5911;14397;6;0;14737;0;0;0;0;996594;367584;130;0;404869;0;0;0;0
FR;2;2021-04-19;16850;16394;24;0;17197;0;0;0;0;1013444;383978;154;0;422066;0;0;0;0
FR;2;2021-04-20;19328;21807;38;0;22868;0;0;0;0;1032772;405785;192;0;444934;0;0;0;0
FR;2;2021-04-21;20294;21902;76;0;23052;0;0;0;0;1053066;427687;268;0;467986;0;0;0;0
FR;2;2021-04-22;23824;24958;41;0;26371;0;0;0;0;1076890;452645;309;0;494357;0;0;0;0
FR;2;2021-04-23;24534;25501;76;0;27013;0;0;0;0;1101424;478146;385;0;521370;0;0;0;0
FR;2;2021-04-24;25305;15068;104;0;16506;0;0;0;0;1126729;493214;489;0;537876;0;0;0;0
FR;2;2021-04-25;9598;8623;5;0;9184;0;0;0;0;1136327;501837;494;0;547060;0;0;0;0
FR;2;2021-04-26;17169;17679;21;0;18565;0;0;0;0;1153496;519516;515;0;565625;0;0;0;0
FR;2;2021-04-27;19246;24101;40;0;25285;0;0;0;0;1172742;543617;555;0;590910;0;0;0;0
FR;2;2021-04-28;22343;26459;113;0;27860;0;0;0;0;1195085;570076;668;0;618770;0;0;0;0
FR;2;2021-04-29;25477;30500;70;0;32190;0;0;0;0;1220562;600576;738;0;650960;0;0;0;0
FR;2;2021-04-30;25542;27977;49;1;29627;0;0;0;0;1246104;628553;787;1;680587;0;0;0;0
FR;2;2021-05-01;14988;9853;6;0;10654;0;0;0;0;1261092;638406;793;1;691241;0;0;0;0
FR;2;2021-05-02;6642;9160;2;0;9506;0;0;0;0;1267734;647566;795;1;700747;0;0;0;0
FR;2;2021-05-03;20026;19127;40;0;20334;0;0;0;0;1287760;666693;835;1;721081;0;0;0;0
FR;2;2021-05-04;18288;29202;33;0;30348;0;0;0;0;1306048;695895;868;1;751429;0;0;0;0
FR;2;2021-05-05;18385;29524;48;0;30822;0;0;0;0;1324433;725419;916;1;782251;0;0;0;0
FR;2;2021-05-06;23553;35413;132;0;36986;0;0;0;0;1347986;760832;1048;1;819237;0;0;0;0
FR;2;2021-05-07;25349;33240;97;0;35099;0;0;0;0;1373335;794072;1145;1;854336;0;0;0;0
FR;2;2021-05-08;21343;10701;15;0;11788;0;0;0;0;1394678;804773;1160;1;866124;0;0;0;0
FR;2;2021-05-09;13170;7609;7;0;8284;0;0;0;0;1407848;812382;1167;1;874408;0;0;0;0
FR;2;2021-05-10;32949;21717;50;0;23574;0;0;0;0;1440797;834099;1217;1;897982;0;0;0;0
FR;2;2021-05-11;43616;20904;101;0;23529;0;0;0;0;1484413;855003;1318;1;921511;0;0;0;0
FR;2;2021-05-12;50070;19637;143;0;22517;0;0;0;0;1534483;874640;1461;1;944028;0;0;0;0
FR;2;2021-05-13;51301;5597;31;0;8465;0;0;0;0;1585784;880237;1492;1;952493;0;0;0;0
FR;2;2021-05-14;61361;12884;132;0;16538;0;0;0;0;1647145;893121;1624;1;969031;0;0;0;0
FR;2;2021-05-15;65938;7100;40;0;10650;0;0;0;0;1713083;900221;1664;1;979681;0;0;0;0
FR;2;2021-05-16;43588;2573;10;0;4944;0;0;0;0;1756671;902794;1674;1;984625;0;0;0;0
FR;2;2021-05-17;44756;12447;114;0;15354;0;0;0;0;1801427;915241;1788;1;999979;0;0;0;0
FR;2;2021-05-18;54650;12289;190;0;15972;0;0;0;0;1856077;927530;1978;1;1015951;0;0;0;0
FR;2;2021-05-19;57180;10460;281;0;14500;0;0;0;0;1913257;937990;2259;1;1030451;0;0;0;0
FR;2;2021-05-20;63452;10804;288;0;14899;0;0;0;0;1976709;948794;2547;1;1045350;0;0;0;0
FR;2;2021-05-21;64306;11602;230;0;16027;0;0;0;0;2041015;960396;2777;1;1061377;0;0;0;0
FR;2;2021-05-22;61488;4530;65;0;8500;0;0;0;0;2102503;964926;2842;1;1069877;0;0;0;0
FR;2;2021-05-23;37537;575;22;0;2912;0;0;0;0;2140040;965501;2864;1;1072789;0;0;0;0
FR;2;2021-05-24;17248;2052;35;0;3259;0;0;0;0;2157288;967553;2899;1;1076048;0;0;0;0
FR;2;2021-05-25;21121;12253;241;0;13854;0;0;0;0;2178409;979806;3140;1;1089902;0;0;0;0
FR;2;2021-05-26;19946;11539;230;0;13069;0;0;0;0;2198355;991345;3370;1;1102971;0;0;0;0
FR;2;2021-05-27;23001;12663;182;0;14399;0;0;0;0;2221356;1004008;3552;1;1117370;0;0;0;0
FR;2;2021-05-28;29398;15044;190;0;17224;0;0;0;0;2250754;1019052;3742;1;1134594;0;0;0;0
FR;2;2021-05-29;30425;8196;58;0;10104;0;0;0;0;2281179;1027248;3800;1;1144698;0;0;0;0
FR;2;2021-05-30;4648;1819;6;0;2154;0;0;0;0;2285827;1029067;3806;1;1146852;0;0;0;0
FR;2;2021-05-31;28590;18741;184;0;20820;0;0;0;0;2314417;1047808;3990;1;1167672;0;0;0;0
FR;2;2021-06-01;45745;19916;225;0;23152;0;0;0;0;2360162;1067724;4215;1;1190824;0;0;0;0
FR;2;2021-06-02;37483;19311;182;0;22317;0;0;0;0;2397645;1087035;4397;1;1213141;0;0;0;0
FR;2;2021-06-03;51284;23117;161;0;26971;0;0;0;0;2448929;1110152;4558;1;1240112;0;0;0;0
FR;2;2021-06-04;65519;24093;217;0;29058;0;0;0;0;2514448;1134245;4775;1;1269170;0;0;0;0
FR;2;2021-06-05;34607;24109;52;0;26964;0;0;0;0;2549055;1158354;4827;1;1296134;0;0;0;0
FR;2;2021-06-06;4958;6194;10;0;6613;0;0;0;0;2554013;1164548;4837;1;1302747;0;0;0;0
FR;2;2021-06-07;28177;23017;150;0;25433;0;0;0;0;2582190;1187565;4987;1;1328180;0;0;0;0
FR;2;2021-06-08;46379;22943;143;0;26909;0;0;0;0;2628569;1210508;5130;1;1355089;0;0;0;0
FR;2;2021-06-09;34298;20999;107;0;24131;0;0;0;0;2662867;1231507;5237;1;1379220;0;0;0;0
FR;2;2021-06-10;42644;19082;96;1;23004;0;0;0;0;2705511;1250589;5333;2;1402224;0;0;0;0
FR;2;2021-06-11;55306;25133;134;0;30232;0;0;0;0;2760817;1275722;5467;2;1432456;0;0;0;0
FR;2;2021-06-12;30567;19801;53;0;22654;0;0;0;0;2791384;1295523;5520;2;1455110;0;0;0;0
FR;2;2021-06-13;3333;9197;13;0;9586;0;0;0;0;2794717;1304720;5533;2;1464696;0;0;0;0
FR;2;2021-06-14;25304;24119;92;0;26699;0;0;0;0;2820021;1328839;5625;2;1491395;0;0;0;0
FR;2;2021-06-15;39049;22819;154;0;26567;0;0;0;0;2859070;1351658;5779;2;1517962;0;0;0;0
FR;2;2021-06-16;30169;21370;135;0;24523;0;0;0;0;2889239;1373028;5914;2;1542485;0;0;0;0
FR;2;2021-06-17;36913;25737;150;0;29599;0;0;0;0;2926152;1398765;6064;2;1572084;0;0;0;0
FR;2;2021-06-18;46860;28884;123;0;33587;0;0;0;0;2973012;1427649;6187;2;1605671;0;0;0;0
FR;2;2021-06-19;24527;24940;39;0;27714;0;0;0;0;2997539;1452589;6226;2;1633385;0;0;0;0
FR;2;2021-06-20;3745;10058;9;0;10557;0;0;0;0;3001284;1462647;6235;2;1643942;0;0;0;0
FR;2;2021-06-21;17538;42862;88;0;44874;0;0;0;0;3018822;1505509;6323;2;1688816;0;0;0;0
FR;2;2021-06-22;28367;49617;110;0;53046;0;0;0;0;3047189;1555126;6433;2;1741862;0;0;0;0
FR;2;2021-06-23;21790;49613;107;1;52462;1;0;0;0;3068979;1604739;6540;3;1794324;1;0;0;0
FR;2;2021-06-24;28381;50318;134;0;54049;0;0;0;0;3097360;1655057;6674;3;1848373;1;0;0;0
FR;2;2021-06-25;33402;60489;129;0;64878;0;0;0;0;3130762;1715546;6803;3;1913251;1;0;0;0
FR;2;2021-06-26;16396;59357;54;1;61749;0;0;0;0;3147158;1774903;6857;4;1975000;1;0;0;0
FR;2;2021-06-27;2566;29316;22;1;29898;0;0;0;0;3149724;1804219;6879;5;2004898;1;0;0;0
FR;2;2021-06-28;12641;54341;84;0;56317;0;0;0;0;3162365;1858560;6963;5;2061215;1;0;0;0
FR;2;2021-06-29;19857;60001;178;0;62944;0;0;0;0;3182222;1918561;7141;5;2124159;1;0;0;0
FR;2;2021-06-30;16337;58036;253;17;60720;0;0;0;0;3198559;1976597;7394;22;2184879;1;0;0;0
FR;2;2021-07-01;20497;59874;228;0;63202;0;0;0;0;3219056;2036471;7622;22;2248081;1;0;0;0
FR;2;2021-07-02;24083;62161;184;0;66375;0;0;0;0;3243139;2098632;7806;22;2314456;1;0;0;0
FR;2;2021-07-03;12123;57146;153;0;59485;0;0;0;0;3255262;2155778;7959;22;2373941;1;0;0;0
FR;2;2021-07-04;1961;23303;18;0;23870;0;0;0;0;3257223;2179081;7977;22;2397811;1;0;0;0
FR;2;2021-07-05;9179;29257;106;0;30893;0;0;0;0;3266402;2208338;8083;22;2428704;1;0;0;0
FR;2;2021-07-06;14584;36278;135;0;38957;0;0;0;0;3280986;2244616;8218;22;2467661;1;0;0;0
FR;2;2021-07-07;14421;33664;140;0;36417;0;0;0;0;3295407;2278280;8358;22;2504078;1;0;0;0
FR;2;2021-07-08;19723;40326;162;0;43983;0;0;0;0;3315130;2318606;8520;22;2548061;1;0;0;0
FR;2;2021-07-09;27105;54334;202;1;59484;0;0;0;0;3342235;2372940;8722;23;2607545;1;0;0;0
FR;2;2021-07-10;13389;33708;107;0;36392;0;0;0;0;3355624;2406648;8829;23;2643937;1;0;0;0
FR;2;2021-07-11;1811;4344;16;0;4771;0;0;0;0;3357435;2410992;8845;23;2648708;1;0;0;0
FR;2;2021-07-12;12971;37263;119;0;39918;0;0;0;0;3370406;2448255;8964;23;2688626;1;0;0;0
FR;2;2021-07-13;37120;53146;152;0;60280;0;0;0;0;3407526;2501401;9116;23;2748906;1;0;0;0
FR;2;2021-07-14;6628;3540;15;0;4887;0;0;0;0;3414154;2504941;9131;23;2753793;1;0;0;0
FR;2;2021-07-15;47244;47014;156;0;55210;0;0;0;0;3461398;2551955;9287;23;2809003;1;0;0;0
FR;2;2021-07-16;64320;55754;188;0;66737;0;0;0;0;3525718;2607709;9475;23;2875740;1;0;0;0
FR;2;2021-07-17;31603;23918;96;0;29375;0;0;0;0;3557321;2631627;9571;23;2905115;1;0;0;0
FR;2;2021-07-18;6090;4807;19;0;5952;0;0;0;0;3563411;2636434;9590;23;2911067;1;0;0;0
FR;2;2021-07-19;33007;28599;94;0;34212;0;0;0;0;3596418;2665033;9684;23;2945279;1;0;0;0
FR;2;2021-07-20;51999;44522;155;0;53157;0;0;0;0;3648417;2709555;9839;23;2998436;1;0;0;0
FR;2;2021-07-21;45257;34626;93;0;42128;0;0;0;0;3693674;2744181;9932;23;3040564;1;0;0;0
FR;2;2021-07-22;56280;41082;128;1;50355;0;0;0;0;3749954;2785263;10060;24;3090919;1;0;0;0
FR;2;2021-07-23;68305;48967;170;0;60256;0;0;0;0;3818259;2834230;10230;24;3151175;1;0;0;0
FR;2;2021-07-24;36178;21614;82;0;27472;0;0;0;0;3854437;2855844;10312;24;3178647;1;0;0;0
FR;2;2021-07-25;6751;2608;10;0;3866;0;0;0;0;3861188;2858452;10322;24;3182513;1;0;0;0
FR;2;2021-07-26;36320;22336;91;1;27839;0;0;0;0;3897508;2880788;10413;25;3210352;1;0;0;0
FR;2;2021-07-27;62392;34563;180;0;43711;0;0;0;0;3959900;2915351;10593;25;3254063;1;0;0;0
FR;2;2021-07-28;55326;26425;132;0;34511;0;0;0;0;4015226;2941776;10725;25;3288574;1;0;0;0
FR;2;2021-07-29;68481;32795;189;0;42476;0;0;0;0;4083707;2974571;10914;25;3331050;1;0;0;0
FR;2;2021-07-30;74468;37816;222;1;48606;0;0;0;0;4158175;3012387;11136;26;3379656;1;0;0;0
FR;2;2021-07-31;34778;16207;105;0;21406;0;0;0;0;4192953;3028594;11241;26;3401062;1;0;0;0
FR;2;2021-08-01;5416;2260;19;0;3123;0;0;0;0;4198369;3030854;11260;26;3404185;1;0;0;0
FR;2;2021-08-02;35899;16150;101;0;21053;0;0;0;0;4234268;3047004;11361;26;3425238;1;0;0;0
FR;2;2021-08-03;55988;28261;143;0;35464;0;0;0;0;4290256;3075265;11504;26;3460702;1;0;0;0
FR;2;2021-08-04;46638;20828;128;1;26936;0;0;0;0;4336894;3096093;11632;27;3487638;1;0;0;0
FR;2;2021-08-05;54642;31562;215;0;38738;0;0;0;0;4391536;3127655;11847;27;3526376;1;0;0;0
FR;2;2021-08-06;58099;42399;242;1;50227;0;0;0;0;4449635;3170054;12089;28;3576603;1;0;0;0
FR;2;2021-08-07;25152;17627;89;0;21317;0;0;0;0;4474787;3187681;12178;28;3597920;1;0;0;0
FR;2;2021-08-08;3840;3653;21;0;4311;0;0;0;0;4478627;3191334;12199;28;3602231;1;0;0;0
FR;2;2021-08-09;29308;21023;92;0;24849;0;0;0;0;4507935;3212357;12291;28;3627080;1;0;0;0
FR;2;2021-08-10;45014;33467;155;0;39228;0;0;0;0;4552949;3245824;12446;28;3666308;1;0;0;0
FR;2;2021-08-11;35277;25145;151;0;29744;0;0;0;0;4588226;3270969;12597;28;3696052;1;0;0;0
FR;2;2021-08-12;41905;35692;163;0;41229;0;0;0;0;4630131;3306661;12760;28;3737281;1;0;0;0
FR;2;2021-08-13;42608;37354;218;0;43041;0;0;0;0;4672739;3344015;12978;28;3780322;1;0;0;0
FR;2;2021-08-14;18524;22130;94;0;24761;0;0;0;0;4691263;3366145;13072;28;3805083;1;0;0;0
FR;2;2021-08-15;3865;3796;17;0;4382;0;0;0;0;4695128;3369941;13089;28;3809465;1;0;0;0
FR;2;2021-08-16;25095;27124;111;0;30447;0;0;0;0;4720223;3397065;13200;28;3839912;1;0;0;0
FR;2;2021-08-17;38270;43396;207;2;48380;0;0;0;0;4758493;3440461;13407;30;3888292;1;0;0;0
FR;2;2021-08-18;32254;36351;195;1;40692;0;0;0;0;4790747;3476812;13602;31;3928984;1;0;0;0
FR;2;2021-08-19;37436;46575;224;0;51775;0;0;0;0;4828183;3523387;13826;31;3980759;1;0;0;0
FR;2;2021-08-20;40568;55648;271;1;61573;0;0;0;0;4868751;3579035;14097;32;4042332;1;0;0;0
FR;2;2021-08-21;18122;24321;117;0;27113;0;0;0;0;4886873;3603356;14214;32;4069445;1;0;0;0
FR;2;2021-08-22;2909;4320;22;1;4852;1;0;0;0;4889782;3607676;14236;33;4074297;2;0;0;0
FR;2;2021-08-23;19250;35149;131;1;38039;0;0;0;0;4909032;3642825;14367;34;4112336;2;0;0;0
FR;2;2021-08-24;31952;56036;236;0;60693;0;0;0;0;4940984;3698861;14603;34;4173029;2;0;0;0
FR;2;2021-08-25;25934;43456;251;0;47405;0;0;0;0;4966918;3742317;14854;34;4220434;2;0;0;0
FR;2;2021-08-26;32362;55849;388;0;60587;0;0;0;0;4999280;3798166;15242;34;4281021;2;0;0;0
FR;2;2021-08-27;37003;65679;477;2;71403;0;0;0;0;5036283;3863845;15719;36;4352424;2;0;0;0
FR;2;2021-08-28;17819;28556;300;0;31616;0;0;0;0;5054102;3892401;16019;36;4384040;2;0;0;0
FR;2;2021-08-29;2656;5012;47;0;5623;0;0;0;0;5056758;3897413;16066;36;4389663;2;0;0;0
FR;2;2021-08-30;18418;37728;399;0;40147;756;0;0;0;5075176;3935141;16465;36;4429810;758;0;0;0
FR;2;2021-08-31;28077;57516;887;4;60947;1558;0;0;0;5103253;3992657;17352;40;4490757;2316;0;0;0
FR;2;2021-09-01;21595;39876;1309;0;42254;2129;0;0;0;5124848;4032533;18661;40;4533011;4445;0;0;0
FR;2;2021-09-02;25486;48668;1963;2;50943;3369;0;0;0;5150334;4081201;20624;42;4583954;7814;0;0;0
FR;2;2021-09-03;33414;64575;2988;3;67538;4886;1;0;0;5183748;4145776;23612;45;4651492;12700;1;0;0
FR;2;2021-09-04;16833;27764;1443;1;29554;2386;0;0;0;5200581;4173540;25055;46;4681046;15086;1;0;0
FR;2;2021-09-05;2265;3585;266;0;3941;412;0;0;0;5202846;4177125;25321;46;4684987;15498;1;0;0
FR;2;2021-09-06;14045;28693;1771;1;29758;2945;0;0;0;5216891;4205818;27092;47;4714745;18443;1;0;0
FR;2;2021-09-07;21111;41110;3022;13;42261;4945;0;0;0;5238002;4246928;30114;60;4757006;23388;1;0;0
FR;2;2021-09-08;17248;31922;2735;6;32738;4499;0;0;0;5255250;4278850;32849;66;4789744;27887;1;0;0
FR;2;2021-09-09;20982;40485;4437;3;41229;6842;0;0;0;5276232;4319335;37286;69;4830973;34729;1;0;0
FR;2;2021-09-10;28203;51317;5286;4;51885;8979;1;0;0;5304435;4370652;42572;73;4882858;43708;2;0;0
FR;2;2021-09-11;13655;22461;2405;5;23133;3990;0;0;0;5318090;4393113;44977;78;4905991;47698;2;0;0
FR;2;2021-09-12;1824;2770;292;0;2964;509;0;0;0;5319914;4395883;45269;78;4908955;48207;2;0;0
FR;2;2021-09-13;11659;21442;2474;4;21701;4053;0;0;0;5331573;4417325;47743;82;4930656;52260;2;0;0
FR;2;2021-09-14;18579;32719;5092;13;31679;9054;2;0;0;5350152;4450044;52835;95;4962335;61314;4;0;0
FR;2;2021-09-15;14917;28226;5168;3;26925;7749;9;0;0;5365069;4478270;58003;98;4989260;69063;13;0;0
FR;2;2021-09-16;16079;32799;6737;12;30180;10541;4;0;0;5381148;4511069;64740;110;5019440;79604;17;0;0
FR;2;2021-09-17;20916;47179;8782;10;42825;14631;6;0;0;5402064;4558248;73522;120;5062265;94235;23;0;0
FR;2;2021-09-18;9856;20959;3804;6;19595;6034;1;0;0;5411920;4579207;77326;126;5081860;100269;24;0;0
FR;2;2021-09-19;1166;2590;396;0;2533;631;0;0;0;5413086;4581797;77722;126;5084393;100900;24;0;0
FR;2;2021-09-20;7503;18702;3856;7;17025;6135;4;0;0;5420589;4600499;81578;133;5101418;107035;28;0;0
FR;2;2021-09-21;11215;29983;6495;5;26536;10744;3;0;0;5431804;4630482;88073;138;5127954;117779;31;0;0
FR;2;2021-09-22;9415;23545;5490;6;21193;8526;8;0;0;5441219;4654027;93563;144;5149147;126305;39;0;0
FR;2;2021-09-23;10730;28906;7881;10;24732;12647;10;0;0;5451949;4682933;101444;154;5173879;138952;49;0;0
FR;2;2021-09-24;15075;42947;10878;18;37281;17246;21;0;0;5467024;4725880;112322;172;5211160;156198;70;0;0
FR;2;2021-09-25;7258;18798;3965;9;17151;6120;3;0;0;5474282;4744678;116287;181;5228311;162318;73;0;0
FR;2;2021-09-26;1080;2543;495;0;2489;630;1;0;0;5475362;4747221;116782;181;5230800;162948;74;0;0
FR;2;2021-09-27;6311;16400;4287;8;14792;6533;2;0;0;5481673;4763621;121069;189;5245592;169481;76;0;0
FR;2;2021-09-28;9243;25573;7770;14;21719;12089;7;0;0;5490916;4789194;128839;203;5267311;181570;83;0;0
FR;2;2021-09-29;8081;20198;6067;25;17606;9259;8;0;0;5498997;4809392;134906;228;5284917;190829;91;0;0
FR;2;2021-09-30;9865;25838;9509;16;21639;14099;6;0;0;5508862;4835230;144415;244;5306556;204928;97;0;0
FR;2;2021-10-01;13979;35736;12921;25;30046;19328;9;0;0;5522841;4870966;157336;269;5336602;224256;106;0;0
FR;2;2021-10-02;6875;15933;4850;7;14226;7047;6;0;0;5529716;4886899;162186;276;5350828;231303;112;0;0
FR;2;2021-10-03;841;1908;492;1;1839;502;0;0;0;5530557;4888807;162678;277;5352667;231805;112;0;0
FR;2;2021-10-04;5826;13900;5516;5;12135;7854;6;0;0;5536383;4902707;168194;282;5364802;239659;118;0;0
FR;2;2021-10-05;9058;22573;11125;19;18533;15741;1;0;0;5545441;4925280;179319;301;5383335;255400;119;0;0
FR;2;2021-10-06;7785;17747;8243;11;15274;11090;4;0;0;5553226;4943027;187562;312;5398609;266490;123;0;0
FR;2;2021-10-07;9204;22215;12386;14;18008;16878;6;0;0;5562430;4965242;199948;326;5416617;283368;129;0;0
FR;2;2021-10-08;13432;32143;17349;28;26517;23609;11;0;0;5575862;4997385;217297;354;5443134;306977;140;0;0
FR;2;2021-10-09;6000;12847;6044;6;11381;7897;7;0;0;5581862;5010232;223341;360;5454515;314874;147;0;0
FR;2;2021-10-10;885;1592;436;2;1535;604;1;0;0;5582747;5011824;223777;362;5456050;315478;148;0;0
FR;2;2021-10-11;5607;11544;6455;17;9932;8829;3;0;0;5588354;5023368;230232;379;5465982;324307;151;0;0
FR;2;2021-10-12;8031;17790;12551;13;13921;16790;9;0;0;5596385;5041158;242783;392;5479903;341097;160;0;0
FR;2;2021-10-13;6947;14870;10256;12;11811;13663;7;0;0;5603332;5056028;253039;404;5491714;354760;167;0;0
FR;2;2021-10-14;8314;17941;14996;13;13556;19479;10;0;0;5611646;5073969;268035;417;5505270;374239;177;0;0
FR;2;2021-10-15;11856;26309;20902;26;19411;27981;4;0;0;5623502;5100278;288937;443;5524681;402220;181;0;0
FR;2;2021-10-16;5141;8729;1819;0;8172;3206;2;0;0;5628643;5109007;290756;443;5532853;405426;183;0;0
FR;2;2021-10-17;654;1150;185;0;1083;354;1;0;0;5629297;5110157;290941;443;5533936;405780;184;0;0
FR;2;2021-10-18;4564;7335;665;2;7242;1629;0;0;0;5633861;5117492;291606;445;5541178;407409;184;0;0
FR;2;2021-10-19;6239;9849;732;5;9656;2030;5;0;0;5640100;5127341;292338;450;5550834;409439;189;0;0
FR;2;2021-10-20;5170;8051;759;3;8173;1675;0;0;0;5645270;5135392;293097;453;5559007;411114;189;0;0
FR;2;2021-10-21;6090;9982;780;5;9840;2104;1;0;0;5651360;5145374;293877;458;5568847;413218;190;0;0
FR;2;2021-10-22;8452;14602;1151;4;14478;2891;2;0;0;5659812;5159976;295028;462;5583325;416109;192;0;0
FR;2;2021-10-23;3845;5993;587;0;6125;1235;3;0;0;5663657;5165969;295615;462;5589450;417344;195;0;0
FR;2;2021-10-24;494;882;101;0;900;204;0;0;0;5664151;5166851;295716;462;5590350;417548;195;0;0
FR;2;2021-10-25;3360;5342;307;1;5518;825;2;0;0;5667511;5172193;296023;463;5595868;418373;197;0;0
FR;2;2021-10-26;4177;7237;1134;4;7126;2023;5;0;0;5671688;5179430;297157;467;5602994;420396;202;0;0
FR;2;2021-10-27;3677;6585;1194;5;6447;1989;1;0;0;5675365;5186015;298351;472;5609441;422385;203;0;0
FR;2;2021-10-28;4597;7687;1737;3;7415;2746;1;0;0;5679962;5193702;300088;475;5616856;425131;204;0;0
FR;2;2021-10-29;5414;11082;2438;4;10692;3684;3;0;0;5685376;5204784;302526;479;5627548;428815;207;0;0
FR;2;2021-10-30;2749;4456;976;1;4451;1448;2;0;0;5688125;5209240;303502;480;5631999;430263;209;0;0
FR;2;2021-10-31;364;535;140;1;544;191;1;0;0;5688489;5209775;303642;481;5632543;430454;210;0;0
FR;2;2021-11-01;430;546;181;0;563;267;1;0;0;5688919;5210321;303823;481;5633106;430721;211;0;0
FR;2;2021-11-02;3294;6760;1184;0;6800;1771;5;0;0;5692213;5217081;305007;481;5639906;432492;216;0;0
FR;2;2021-11-03;3340;6227;1389;2;6311;1971;2;0;0;5695553;5223308;306396;483;5646217;434463;218;0;0
FR;2;2021-11-04;3987;7069;1769;4;7109;2495;3;0;0;5699540;5230377;308165;487;5653326;436958;221;0;0
FR;2;2021-11-05;5235;10502;2869;5;10215;3957;6;0;0;5704775;5240879;311034;492;5663541;440915;227;0;0
FR;2;2021-11-06;2597;4684;1407;0;4641;1824;2;0;0;5707372;5245563;312441;492;5668182;442739;229;0;0
FR;2;2021-11-07;506;862;221;0;869;291;2;0;0;5707878;5246425;312662;492;5669051;443030;231;0;0
FR;2;2021-11-08;2578;5348;1207;3;5268;1678;3;0;0;5710456;5251773;313869;495;5674319;444708;234;0;0
FR;2;2021-11-09;2749;6907;2402;5;6442;3181;2;0;0;5713205;5258680;316271;500;5680761;447889;236;0;0
FR;2;2021-11-10;2590;5668;5118;6;4761;6294;7;0;0;5715795;5264348;321389;506;5685522;454183;243;0;0
FR;2;2021-11-11;446;754;755;2;647;938;3;0;0;5716241;5265102;322144;508;5686169;455121;246;0;0
FR;2;2021-11-12;2953;8087;8982;8;6196;10932;9;0;0;5719194;5273189;331126;516;5692365;466053;255;0;0
FR;2;2021-11-13;1539;3374;3872;7;2722;4538;4;0;0;5720733;5276563;334998;523;5695087;470591;259;0;0
FR;2;2021-11-14;258;585;351;1;486;480;3;0;0;5720991;5277148;335349;524;5695573;471071;262;0;0
FR;2;2021-11-15;1621;3654;4449;8;2908;5329;16;0;0;5722612;5280802;339798;532;5698481;476400;278;0;0
FR;2;2021-11-16;2185;5875;8314;14;4152;10083;16;0;0;5724797;5286677;348112;546;5702633;486483;294;0;0
FR;2;2021-11-17;1740;4523;6634;8;3168;7852;5;0;0;5726537;5291200;354746;554;5705801;494335;299;0;0
FR;2;2021-11-18;2192;5920;9188;10;4018;11018;8;0;0;5728729;5297120;363934;564;5709819;505353;307;0;0
FR;2;2021-11-19;2701;7752;12981;19;4832;15480;12;0;0;5731430;5304872;376915;583;5714651;520833;319;0;0
FR;2;2021-11-20;1566;3333;5185;5;2351;6098;3;0;0;5732996;5308205;382100;588;5717002;526931;322;0;0
FR;2;2021-11-21;251;504;543;0;393;656;3;0;0;5733247;5308709;382643;588;5717395;527587;325;0;0
FR;2;2021-11-22;1278;2570;4485;5;1673;5397;9;0;0;5734525;5311279;387128;593;5719068;532984;334;0;0
FR;2;2021-11-23;1617;4277;8207;9;2536;9923;6;0;0;5736142;5315556;395335;602;5721604;542907;340;0;0
FR;2;2021-11-24;1421;3747;7486;14;2246;8736;9;0;0;5737563;5319303;402821;616;5723850;551643;349;0;0
FR;2;2021-11-25;1814;4863;11474;21;2682;13668;6;0;0;5739377;5324166;414295;637;5726532;565311;355;0;0
FR;2;2021-11-26;2541;7735;22676;31;3812;26091;14;0;0;5741918;5331901;436971;668;5730344;591402;369;0;0
FR;2;2021-11-27;1498;4145;12278;19;2127;14042;13;0;0;5743416;5336046;449249;687;5732471;605444;382;0;0
FR;2;2021-11-28;292;835;1976;3;478;2303;5;0;0;5743708;5336881;451225;690;5732949;607747;387;0;0
FR;2;2021-11-29;1449;4348;15099;23;2009;17269;25;0;0;5745157;5341229;466324;713;5734958;625016;412;0;0
FR;2;2021-11-30;1913;6658;26252;36;2640;30014;22;0;0;5747070;5347887;492576;749;5737598;655030;434;0;0
FR;2;2021-12-01;1918;6006;26211;31;2477;29519;20;0;0;5748988;5353893;518787;780;5740075;684549;454;0;0
FR;2;2021-12-02;1916;6780;37736;52;2112;41995;32;0;0;5750904;5360673;556523;832;5742187;726544;486;0;0
FR;2;2021-12-03;2558;10069;53644;111;3592;59391;31;0;0;5753462;5370742;610167;943;5745779;785935;517;0;0
FR;2;2021-12-04;1850;6275;37132;38;2185;40820;16;0;0;5755312;5377017;647299;981;5747964;826755;533;0;0
FR;2;2021-12-05;458;2242;14265;14;533;15990;7;0;0;5755770;5379259;661564;995;5748497;842745;540;0;0
FR;2;2021-12-06;2486;9844;77735;109;2697;84785;25;0;0;5758256;5389103;739299;1104;5751194;927530;565;0;0
FR;2;2021-12-07;3458;15288;122475;238;3742;133797;40;0;0;5761714;5404391;861774;1342;5754936;1061327;605;0;0
FR;2;2021-12-08;3725;15967;133225;330;3844;145413;54;0;0;5765439;5420358;994999;1672;5758780;1206740;659;0;0
FR;2;2021-12-09;4547;19625;170241;554;4165;185639;61;0;0;5769986;5439983;1165240;2226;5762945;1392379;720;0;0
FR;2;2021-12-10;4676;22806;188699;490;5011;206189;69;0;0;5774662;5462789;1353939;2716;5767956;1598568;789;0;0
FR;2;2021-12-11;3687;16621;132469;239;3663;144937;60;0;0;5778349;5479410;1486408;2955;5771619;1743505;849;0;0
FR;2;2021-12-12;1256;7119;59116;83;1016;65169;12;0;0;5779605;5486529;1545524;3038;5772635;1808674;861;0;0
FR;2;2021-12-13;5529;26811;220733;605;5223;243029;159;0;0;5785134;5513340;1766257;3643;5777858;2051703;1020;0;0
FR;2;2021-12-14;7019;37458;300806;909;6136;332278;190;0;0;5792153;5550798;2067063;4552;5783994;2383981;1210;0;0
FR;2;2021-12-15;6555;36215;285263;958;5866;315902;186;0;0;5798708;5587013;2352326;5510;5789860;2699883;1396;0;0
FR;2;2021-12-16;7764;37923;312180;982;6564;343823;186;0;0;5806472;5624936;2664506;6492;5796424;3043706;1582;0;0
FR;2;2021-12-17;8680;41187;327911;976;8020;360987;232;0;0;5815152;5666123;2992417;7468;5804444;3404693;1814;0;0
FR;2;2021-12-18;6515;26527;212374;448;4904;233673;120;0;0;5821667;5692650;3204791;7916;5809348;3638366;1934;0;0
FR;2;2021-12-19;2603;11403;90226;182;1655;100356;26;0;0;5824270;5704053;3295017;8098;5811003;3738722;1960;0;0
FR;2;2021-12-20;9548;33514;275258;707;6586;303402;209;0;0;5833818;5737567;3570275;8805;5817589;4042124;2169;0;0
FR;2;2021-12-21;11568;38269;309663;968;7368;341439;262;0;0;5845386;5775836;3879938;9773;5824957;4383563;2431;0;0
FR;2;2021-12-22;10461;32776;265147;952;6442;292503;316;0;1;5855847;5808612;4145085;10725;5831399;4676066;2747;0;1
FR;2;2021-12-23;9426;26620;199534;701;5874;221294;225;0;0;5865273;5835232;4344619;11426;5837273;4897360;2972;0;1
FR;2;2021-12-24;2783;7465;43866;140;2036;49560;78;0;0;5868056;5842697;4388485;11566;5839309;4946920;3050;0;1
FR;2;2021-12-25;201;669;2003;10;209;2476;15;0;0;5868257;5843366;4390488;11576;5839518;4949396;3065;0;1
FR;2;2021-12-26;1320;4215;25162;71;1052;28694;70;0;0;5869577;5847581;4415650;11647;5840570;4978090;3135;0;1
FR;2;2021-12-27;8076;29929;218437;659;6624;243388;294;0;0;5877653;5877510;4634087;12306;5847194;5221478;3429;0;1
FR;2;2021-12-28;9832;36287;272117;742;6982;302015;957;0;1;5887485;5913797;4906204;13048;5854176;5523493;4386;0;2
FR;2;2021-12-29;9498;32219;246151;765;6402;272697;1088;0;0;5896983;5946016;5152355;13813;5860578;5796190;5474;0;2
FR;2;2021-12-30;9464;28089;208839;663;5970;231478;1155;0;0;5906447;5974105;5361194;14476;5866548;6027668;6629;0;2
FR;2;2021-12-31;3011;8340;54991;176;2169;61233;392;0;0;5909458;5982445;5416185;14652;5868717;6088901;7021;0;2
FR;2;2022-01-01;231;693;2858;7;207;3353;29;0;0;5909689;5983138;5419043;14659;5868924;6092254;7050;0;2
FR;2;2022-01-02;1503;4860;29524;76;1167;33418;217;0;0;5911192;5987998;5448567;14735;5870091;6125672;7267;0;2
FR;2;2022-01-03;9606;35395;266544;806;8498;293920;1672;0;0;5920798;6023393;5715111;15541;5878589;6419592;8939;0;2
FR;2;2022-01-04;12857;45401;342102;1068;9970;377042;2458;0;1;5933655;6068794;6057213;16609;5888559;6796634;11397;0;3
FR;2;2022-01-05;11273;38627;294222;885;8635;323856;2155;0;2;5944928;6107421;6351435;17494;5897194;7120490;13552;0;5
FR;2;2022-01-06;13653;43487;331956;1298;9932;364765;2978;0;1;5958581;6150908;6683391;18792;5907126;7485255;16530;0;6
FR;2;2022-01-07;14224;47607;361123;1271;11232;396464;3159;0;0;5972805;6198515;7044514;20063;5918358;7881719;19689;0;6
FR;2;2022-01-08;7946;28137;201276;515;7209;221703;1531;0;2;5980751;6226652;7245790;20578;5925567;8103422;21220;0;8
FR;2;2022-01-09;2749;8945;62531;137;2068;69497;493;0;0;5983500;6235597;7308321;20715;5927635;8172919;21713;0;8
FR;2;2022-01-10;10100;31907;232509;859;8901;255085;2460;0;0;5993600;6267504;7540830;21574;5936536;8428004;24173;0;8
FR;2;2022-01-11;11465;36235;265948;1030;10055;290653;3380;0;1;6005065;6303739;7806778;22604;5946591;8718657;27553;0;9
FR;2;2022-01-12;8767;29787;206335;863;8717;226176;2798;0;5;6013832;6333526;8013113;23467;5955308;8944833;30351;0;14
FR;2;2022-01-13;9387;31335;224510;831;9037;244857;3463;0;4;6023219;6364861;8237623;24298;5964345;9189690;33814;0;18
FR;2;2022-01-14;9746;35573;254551;920;9840;277655;3979;0;1;6032965;6400434;8492174;25218;5974185;9467345;37793;0;19
FR;2;2022-01-15;5361;19443;140788;363;5322;153648;1929;0;0;6038326;6419877;8632962;25581;5979507;9620993;39722;0;19
FR;2;2022-01-16;1512;5457;35892;81;1619;39818;424;0;0;6039838;6425334;8668854;25662;5981126;9660811;40146;0;19
FR;2;2022-01-17;5546;19264;135421;601;6600;147263;2264;0;2;6045384;6444598;8804275;26263;5987726;9808074;42410;0;21
FR;2;2022-01-18;6422;21480;148647;648;7519;160471;3311;0;0;6051806;6466078;8952922;26911;5995245;9968545;45721;0;21
FR;2;2022-01-19;4398;16304;105112;552;6206;113701;2411;0;1;6056204;6482382;9058034;27463;6001451;10082246;48132;0;22
FR;2;2022-01-20;4873;17571;115304;603;7067;123694;3111;0;2;6061077;6499953;9173338;28066;6008518;10205940;51243;0;24
FR;2;2022-01-21;5198;20041;137357;679;7170;147775;3455;0;1;6066275;6519994;9310695;28745;6015688;10353715;54698;0;25
FR;2;2022-01-22;3033;10956;74265;260;3956;80339;1428;0;0;6069308;6530950;9384960;29005;6019644;10434054;56126;0;25
FR;2;2022-01-23;724;2707;15243;41;1055;16826;238;0;0;6070032;6533657;9400203;29046;6020699;10450880;56364;0;25
FR;2;2022-01-24;3292;12793;75084;431;5843;81019;1994;0;2;6073324;6546450;9475287;29477;6026542;10531899;58358;0;27
FR;2;2022-01-25;3575;14404;79638;496;6650;85463;2879;0;4;6076899;6560854;9554925;29973;6033192;10617362;61237;0;31
FR;2;2022-01-26;2515;10702;58987;363;5331;63036;1958;0;1;6079414;6571556;9613912;30336;6038523;10680398;63195;0;32
FR;2;2022-01-27;2684;11386;64185;391;5738;67972;2462;0;1;6082098;6582942;9678097;30727;6044261;10748370;65657;0;33
FR;2;2022-01-28;3551;18257;91730;430;8611;98907;3399;0;1;6085649;6601199;9769827;31157;6052872;10847277;69056;0;34
FR;2;2022-01-29;1896;9234;48856;164;4170;52929;1374;0;1;6087545;6610433;9818683;31321;6057042;10900206;70430;0;35
FR;2;2022-01-30;464;2206;9457;38;1049;10584;203;0;0;6088009;6612639;9828140;31359;6058091;10910790;70633;0;35
FR;2;2022-01-31;1891;9551;43834;209;4709;47322;1885;0;2;6089900;6622190;9871974;31568;6062800;10958112;72518;0;37
FR;2;2022-02-01;1917;10019;47030;279;4797;50078;2707;0;0;6091817;6632209;9919004;31847;6067597;11008190;75225;0;37
FR;2;2022-02-02;1614;8970;41124;250;4190;44147;2189;0;1;6093431;6641179;9960128;32097;6071787;11052337;77414;0;38
FR;2;2022-02-03;1732;8929;40526;205;4368;42911;2640;0;2;6095163;6650108;10000654;32302;6076155;11095248;80054;0;40
FR;2;2022-02-04;2151;15167;66648;299;7379;71317;3670;0;1;6097314;6665275;10067302;32601;6083534;11166565;83724;0;41
FR;2;2022-02-05;1360;8517;35948;132;4214;39220;1369;0;0;6098674;6673792;10103250;32733;6087748;11205785;85093;0;41
FR;2;2022-02-06;275;1761;6130;17;842;6899;218;0;0;6098949;6675553;10109380;32750;6088590;11212684;85311;0;41
FR;2;2022-02-07;1352;9543;37760;134;4535;41288;1888;0;2;6100301;6685096;10147140;32884;6093125;11253972;87199;0;43
FR;2;2022-02-08;1300;9833;40956;173;4646;43750;2741;0;1;6101601;6694929;10188096;33057;6097771;11297722;89940;0;44
FR;2;2022-02-09;1160;8841;37040;174;3804;40465;1901;0;2;6102761;6703770;10225136;33231;6101575;11338187;91841;0;46
FR;2;2022-02-10;1030;8001;33837;204;3605;36511;2051;0;1;6103791;6711771;10258973;33435;6105180;11374698;93892;0;47
FR;2;2022-02-11;1391;12088;53348;223;5283;57702;2888;0;0;6105182;6723859;10312321;33658;6110463;11432400;96780;0;47
FR;2;2022-02-12;753;6535;27989;86;2792;30808;1113;0;2;6105935;6730394;10340310;33744;6113255;11463208;97893;0;49
FR;2;2022-02-13;200;1340;4836;20;562;5577;141;0;0;6106135;6731734;10345146;33764;6113817;11468785;98034;0;49
FR;2;2022-02-14;836;6732;30274;92;2599;33233;1399;0;1;6106971;6738466;10375420;33856;6116416;11502018;99433;0;50
FR;2;2022-02-15;773;6473;28051;140;2801;29994;1965;0;2;6107744;6744939;10403471;33996;6119217;11532012;101398;0;52
FR;2;2022-02-16;657;5362;22069;124;2528;23634;1569;0;3;6108401;6750301;10425540;34120;6121745;11555646;102967;0;55
FR;2;2022-02-17;518;3786;14153;98;2131;14618;1406;0;2;6108919;6754087;10439693;34218;6123876;11570264;104373;0;57
FR;2;2022-02-18;723;5369;20443;134;3041;21130;1895;0;0;6109642;6759456;10460136;34352;6126917;11591394;106268;0;57
FR;2;2022-02-19;431;3061;10533;66;1699;11247;753;0;2;6110073;6762517;10470669;34418;6128616;11602641;107021;0;59
FR;2;2022-02-20;102;520;1463;3;314;1613;100;0;0;6110175;6763037;10472132;34421;6128930;11604254;107121;0;59
FR;2;2022-02-21;423;2685;9122;65;1569;9499;930;0;0;6110598;6765722;10481254;34486;6130499;11613753;108051;0;59
FR;2;2022-02-22;393;2568;8894;77;1622;8797;1180;0;0;6110991;6768290;10490148;34563;6132121;11622550;109231;0;59
FR;2;2022-02-23;432;2605;8992;82;1522;9269;1022;0;0;6111423;6770895;10499140;34645;6133643;11631819;110253;0;59
FR;2;2022-02-24;314;2039;6805;82;1251;6835;870;0;0;6111737;6772934;10505945;34727;6134894;11638654;111123;0;59
FR;2;2022-02-25;456;3210;11424;107;1979;11287;1560;0;3;6112193;6776144;10517369;34834;6136873;11649941;112683;0;62
FR;2;2022-02-26;297;1892;6038;49;1161;6345;587;0;1;6112490;6778036;10523407;34883;6138034;11656286;113270;0;63
FR;2;2022-02-27;76;313;908;5;214;951;98;0;0;6112566;6778349;10524315;34888;6138248;11657237;113368;0;63
FR;2;2022-02-28;332;1689;5525;53;1088;5531;733;0;0;6112898;6780038;10529840;34941;6139336;11662768;114101;0;63
FR;2;2022-03-01;279;1569;5484;46;952;5201;964;0;2;6113177;6781607;10535324;34987;6140288;11667969;115065;0;65
FR;2;2022-03-02;298;1446;5248;46;878;5092;816;0;1;6113475;6783053;10540572;35033;6141166;11673061;115881;0;66
FR;2;2022-03-03;226;1112;3709;42;721;3486;668;0;1;6113701;6784165;10544281;35075;6141887;11676547;116549;0;67
FR;2;2022-03-04;243;1469;4860;74;983;4506;950;0;1;6113944;6785634;10549141;35149;6142870;11681053;117499;0;68
FR;2;2022-03-05;174;906;2980;34;613;2724;561;0;0;6114118;6786540;10552121;35183;6143483;11683777;118060;0;68
FR;2;2022-03-06;42;190;280;5;110;322;52;0;0;6114160;6786730;10552401;35188;6143593;11684099;118112;0;68
FR;2;2022-03-07;157;659;1990;70;491;1780;472;0;0;6114317;6787389;10554391;35258;6144084;11685879;118584;0;68
FR;2;2022-03-08;144;670;2273;53;461;1908;619;0;0;6114461;6788059;10556664;35311;6144545;11687787;119203;0;68
FR;2;2022-03-09;156;709;2351;37;473;2052;617;0;0;6114617;6788768;10559015;35348;6145018;11689839;119820;0;68
FR;2;2022-03-10;123;603;1696;35;446;1471;456;0;1;6114740;6789371;10560711;35383;6145464;11691310;120276;0;69
FR;2;2022-03-11;172;757;2770;57;505;2369;737;0;1;6114912;6790128;10563481;35440;6145969;11693679;121013;0;70
FR;2;2022-03-12;149;485;1787;27;331;1557;450;0;0;6115061;6790613;10565268;35467;6146300;11695236;121463;0;70
FR;2;2022-03-13;25;75;203;30;45;204;69;0;0;6115086;6790688;10565471;35497;6146345;11695440;121532;0;70
FR;2;2022-03-14;129;470;1572;529;333;1301;951;0;0;6115215;6791158;10567043;36026;6146678;11696741;122483;0;70
FR;2;2022-03-15;139;441;1713;691;333;1333;1186;0;1;6115354;6791599;10568756;36717;6147011;11698074;123669;0;71
FR;2;2022-03-16;142;476;2013;1616;331;1593;2160;0;2;6115496;6792075;10570769;38333;6147342;11699667;125829;0;73
FR;2;2022-03-17;95;413;1412;1192;273;1148;1576;0;1;6115591;6792488;10572181;39525;6147615;11700815;127405;0;74
FR;2;2022-03-18;147;496;2026;1795;335;1669;2313;0;1;6115738;6792984;10574207;41320;6147950;11702484;129718;0;75
FR;2;2022-03-19;108;321;1210;941;219;1015;1259;0;0;6115846;6793305;10575417;42261;6148169;11703499;130977;0;75
FR;2;2022-03-20;13;77;191;59;39;168;115;0;0;6115859;6793382;10575608;42320;6148208;11703667;131092;0;75
FR;2;2022-03-21;98;307;1218;1483;181;1081;1760;0;1;6115957;6793689;10576826;43803;6148389;11704748;132852;0;76
FR;2;2022-03-22;118;391;1533;1830;244;1294;2219;0;0;6116075;6794080;10578359;45633;6148633;11706042;135071;0;76
FR;2;2022-03-23;137;362;1684;3032;232;1475;3374;0;6;6116212;6794442;10580043;48665;6148865;11707517;138445;0;82
FR;2;2022-03-24;117;293;1183;1548;186;1001;1814;0;8;6116329;6794735;10581226;50213;6149051;11708518;140259;0;90
FR;2;2022-03-25;119;361;1807;2451;238;1477;2837;0;8;6116448;6795096;10583033;52664;6149289;11709995;143096;0;98
FR;2;2022-03-26;79;247;1205;1222;138;953;1531;0;5;6116527;6795343;10584238;53886;6149427;11710948;144627;0;103
FR;2;2022-03-27;19;36;154;100;19;133;144;0;0;6116546;6795379;10584392;53986;6149446;11711081;144771;0;103
FR;2;2022-03-28;94;290;1140;1602;189;996;1835;0;6;6116640;6795669;10585532;55588;6149635;11712077;146606;0;109
FR;2;2022-03-29;108;258;1325;2467;167;1105;2760;0;4;6116748;6795927;10586857;58055;6149802;11713182;149366;0;113
FR;2;2022-03-30;91;313;1489;3187;164;1320;3424;0;2;6116839;6796240;10588346;61242;6149966;11714502;152790;0;115
FR;2;2022-03-31;104;284;1277;2332;171;1092;2616;0;3;6116943;6796524;10589623;63574;6150137;11715594;155406;0;118
FR;2;2022-04-01;123;324;1568;2349;164;1323;2667;0;7;6117066;6796848;10591191;65923;6150301;11716917;158073;0;125
FR;2;2022-04-02;81;161;845;891;83;737;1052;0;1;6117147;6797009;10592036;66814;6150384;11717654;159125;0;126
FR;2;2022-04-03;16;53;128;113;27;142;133;0;1;6117163;6797062;10592164;66927;6150411;11717796;159258;0;127
FR;2;2022-04-04;114;249;990;1447;151;799;1693;0;5;6117277;6797311;10593154;68374;6150562;11718595;160951;0;132
FR;2;2022-04-05;143;302;1322;2921;162;1150;3150;0;17;6117420;6797613;10594476;71295;6150724;11719745;164101;0;149
FR;2;2022-04-06;89;261;1308;2522;129;1131;2687;0;10;6117509;6797874;10595784;73817;6150853;11720876;166788;0;159
FR;2;2022-04-07;120;230;1303;2682;141;1042;2958;0;8;6117629;6798104;10597087;76499;6150994;11721918;169746;0;167
FR;2;2022-04-08;126;346;1636;3351;182;1328;3642;0;12;6117755;6798450;10598723;79850;6151176;11723246;173388;0;179
FR;2;2022-04-09;90;219;900;1046;144;732;1288;0;4;6117845;6798669;10599623;80896;6151320;11723978;174676;0;183
FR;2;2022-04-10;37;49;143;162;46;119;200;0;1;6117882;6798718;10599766;81058;6151366;11724097;174876;0;184
FR;2;2022-04-11;88;196;892;1560;122;782;1718;0;6;6117970;6798914;10600658;82618;6151488;11724879;176594;0;190
FR;2;2022-04-12;176;273;1183;2770;175;1062;2903;0;8;6118146;6799187;10601841;85388;6151663;11725941;179497;0;198
FR;2;2022-04-13;147;232;1125;2477;111;989;2671;0;11;6118293;6799419;10602966;87865;6151774;11726930;182168;0;209
FR;2;2022-04-14;116;227;1085;2677;114;919;2911;0;18;6118409;6799646;10604051;90542;6151888;11727849;185079;0;227
FR;2;2022-04-15;114;261;1221;2304;131;1078;2544;0;7;6118523;6799907;10605272;92846;6152019;11728927;187623;0;234
FR;2;2022-04-16;67;108;548;549;68;459;675;0;9;6118590;6800015;10605820;93395;6152087;11729386;188298;0;243
FR;2;2022-04-17;15;28;57;53;17;53;71;0;0;6118605;6800043;10605877;93448;6152104;11729439;188369;0;243
FR;2;2022-04-18;12;35;121;70;18;116;95;0;0;6118617;6800078;10605998;93518;6152122;11729555;188464;0;243
FR;2;2022-04-19;112;237;1120;1750;149;951;1934;0;9;6118729;6800315;10607118;95268;6152271;11730506;190398;0;252
FR;2;2022-04-20;95;243;1111;2172;127;935;2366;0;14;6118824;6800558;10608229;97440;6152398;11731441;192764;0;266
FR;2;2022-04-21;111;233;983;1912;125;838;2141;0;10;6118935;6800791;10609212;99352;6152523;11732279;194905;0;276
FR;2;2022-04-22;100;276;1243;2102;141;1024;2440;0;11;6119035;6801067;10610455;101454;6152664;11733303;197345;0;287
FR;2;2022-04-23;67;156;645;762;107;574;862;0;8;6119102;6801223;10611100;102216;6152771;11733877;198207;0;295
FR;2;2022-04-24;12;30;101;68;12;79;100;0;0;6119114;6801253;10611201;102284;6152783;11733956;198307;0;295
FR;2;2022-04-25;104;204;822;1329;103;711;1528;0;15;6119218;6801457;10612023;103613;6152886;11734667;199835;0;310
FR;2;2022-04-26;110;184;1041;2022;118;879;2219;0;18;6119328;6801641;10613064;105635;6153004;11735546;202054;0;328
FR;2;2022-04-27;98;181;860;1787;122;764;1809;0;7;6119426;6801822;10613924;107422;6153126;11736310;203863;0;335
FR;2;2022-04-28;93;214;949;1931;128;842;2087;0;12;6119519;6802036;10614873;109353;6153254;11737152;205950;0;347
FR;2;2022-04-29;81;282;1133;1697;131;1044;1876;0;11;6119600;6802318;10616006;111050;6153385;11738196;207826;0;358
FR;2;2022-04-30;66;127;471;540;80;430;628;0;9;6119666;6802445;10616477;111590;6153465;11738626;208454;0;367
FR;2;2022-05-01;24;24;84;49;20;85;61;0;1;6119690;6802469;10616561;111639;6153485;11738711;208515;0;368
FR;2;2022-05-02;115;232;764;1217;141;662;1375;0;5;6119805;6802701;10617325;112856;6153626;11739373;209890;0;373
FR;2;2022-05-03;153;233;999;1781;155;938;1895;0;14;6119958;6802934;10618324;114637;6153781;11740311;211785;0;387
FR;2;2022-05-04;90;226;926;1811;116;869;1822;0;13;6120048;6803160;10619250;116448;6153897;11741180;213607;0;400
FR;2;2022-05-05;127;198;857;1732;147;774;1848;0;10;6120175;6803358;10620107;118180;6154044;11741954;215455;0;410
FR;2;2022-05-06;133;246;1101;1855;139;1017;2052;0;16;6120308;6803604;10621208;120035;6154183;11742971;217507;0;426
FR;2;2022-05-07;40;99;470;504;61;406;593;0;4;6120348;6803703;10621678;120539;6154244;11743377;218100;0;430
FR;2;2022-05-08;48;54;107;71;41;102;101;0;0;6120396;6803757;10621785;120610;6154285;11743479;218201;0;430
FR;2;2022-05-09;101;174;654;986;103;604;1130;0;9;6120497;6803931;10622439;121596;6154388;11744083;219331;0;439
FR;2;2022-05-10;121;252;938;1841;155;893;1965;0;23;6120618;6804183;10623377;123437;6154543;11744976;221296;0;462
FR;2;2022-05-11;103;179;816;1879;117;795;1868;0;8;6120721;6804362;10624193;125316;6154660;11745771;223164;0;470
FR;2;2022-05-12;111;174;845;2096;116;803;2213;0;21;6120832;6804536;10625038;127412;6154776;11746574;225377;0;491
FR;2;2022-05-13;100;236;969;2097;122;900;2273;0;13;6120932;6804772;10626007;129509;6154898;11747474;227650;0;504
FR;2;2022-05-14;76;124;451;553;93;411;632;0;6;6121008;6804896;10626458;130062;6154991;11747885;228282;0;510
FR;2;2022-05-15;24;39;94;88;20;108;95;0;1;6121032;6804935;10626552;130150;6155011;11747993;228377;0;511
FR;2;2022-05-16;102;171;601;925;116;537;1037;0;11;6121134;6805106;10627153;131075;6155127;11748530;229414;0;522
FR;2;2022-05-17;95;184;690;1687;119;658;1739;0;8;6121229;6805290;10627843;132762;6155246;11749188;231153;0;530
FR;2;2022-05-18;80;181;643;1431;97;648;1486;0;10;6121309;6805471;10628486;134193;6155343;11749836;232639;0;540
FR;2;2022-05-19;73;161;710;1830;81;752;1816;0;12;6121382;6805632;10629196;136023;6155424;11750588;234455;0;552
FR;2;2022-05-20;107;181;874;1701;111;779;1849;0;17;6121489;6805813;10630070;137724;6155535;11751367;236304;0;569
FR;2;2022-05-21;48;96;398;517;71;339;581;0;8;6121537;6805909;10630468;138241;6155606;11751706;236885;0;577
FR;2;2022-05-22;8;23;69;37;18;57;56;0;0;6121545;6805932;10630537;138278;6155624;11751763;236941;0;577
FR;2;2022-05-23;86;133;498;931;100;469;967;0;7;6121631;6806065;10631035;139209;6155724;11752232;237908;0;584
FR;2;2022-05-24;87;164;627;1626;103;615;1680;0;17;6121718;6806229;10631662;140835;6155827;11752847;239588;0;601
FR;2;2022-05-25;72;146;539;1149;90;494;1260;0;5;6121790;6806375;10632201;141984;6155917;11753341;240848;0;606
FR;2;2022-05-26;12;31;77;45;13;85;56;0;1;6121802;6806406;10632278;142029;6155930;11753426;240904;0;607
FR;2;2022-05-27;44;124;456;818;68;438;893;0;9;6121846;6806530;10632734;142847;6155998;11753864;241797;0;616
FR;2;2022-05-28;28;60;221;244;29;221;266;0;1;6121874;6806590;10632955;143091;6156027;11754085;242063;0;617
FR;2;2022-05-29;13;34;43;25;22;51;28;0;0;6121887;6806624;10632998;143116;6156049;11754136;242091;0;617
FR;2;2022-05-30;65;109;425;755;60;410;806;0;6;6121952;6806733;10633423;143871;6156109;11754546;242897;0;623
FR;2;2022-05-31;76;135;564;1278;92;511;1304;0;12;6122028;6806868;10633987;145149;6156201;11755057;244201;0;635
FR;2;2022-06-01;59;160;564;1075;86;543;1170;0;6;6122087;6807028;10634551;146224;6156287;11755600;245371;0;641
FR;2;2022-06-02;92;178;627;1450;109;593;1557;0;12;6122179;6807206;10635178;147674;6156396;11756193;246928;0;653
FR;2;2022-06-03;71;157;668;1605;96;595;1694;0;19;6122250;6807363;10635846;149279;6156492;11756788;248622;0;672
FR;2;2022-06-04;69;93;283;434;66;269;476;0;11;6122319;6807456;10636129;149713;6156558;11757057;249098;0;683
FR;2;2022-06-05;12;17;63;58;16;47;75;0;1;6122331;6807473;10636192;149771;6156574;11757104;249173;0;684
FR;2;2022-06-06;12;41;93;76;30;92;81;0;4;6122343;6807514;10636285;149847;6156604;11757196;249254;0;688
FR;2;2022-06-07;99;222;667;1535;154;577;1661;0;10;6122442;6807736;10636952;151382;6156758;11757773;250915;0;698
FR;2;2022-06-08;70;119;477;1166;76;411;1262;0;5;6122512;6807855;10637429;152548;6156834;11758184;252177;0;703
FR;2;2022-06-09;93;167;613;1923;108;571;1927;0;18;6122605;6808022;10638042;154471;6156942;11758755;254104;0;721
FR;2;2022-06-10;93;168;651;1683;107;623;1774;0;23;6122698;6808190;10638693;156154;6157049;11759378;255878;0;744
FR;2;2022-06-11;44;85;287;529;42;258;583;0;5;6122742;6808275;10638980;156683;6157091;11759636;256461;0;749
FR;2;2022-06-12;18;38;58;78;27;60;78;0;0;6122760;6808313;10639038;156761;6157118;11759696;256539;0;749
FR;2;2022-06-13;39;121;395;953;63;379;1021;0;6;6122799;6808434;10639433;157714;6157181;11760075;257560;0;755
FR;2;2022-06-14;68;157;599;2088;101;537;2189;0;14;6122867;6808591;10640032;159802;6157282;11760612;259749;0;769
FR;2;2022-06-15;78;104;522;1504;84;444;1641;0;10;6122945;6808695;10640554;161306;6157366;11761056;261390;0;779
FR;2;2022-06-16;128;128;497;1411;124;424;1526;0;12;6123073;6808823;10641051;162717;6157490;11761480;262916;0;791
FR;2;2022-06-17;73;138;589;1817;88;516;1921;0;16;6123146;6808961;10641640;164534;6157578;11761996;264837;0;807
FR;2;2022-06-18;76;93;224;579;81;196;630;0;4;6123222;6809054;10641864;165113;6157659;11762192;265467;0;811
FR;2;2022-06-19;11;17;53;71;7;41;90;0;2;6123233;6809071;10641917;165184;6157666;11762233;265557;0;813
FR;2;2022-06-20;62;125;401;1028;72;392;1105;0;10;6123295;6809196;10642318;166212;6157738;11762625;266662;0;823
FR;2;2022-06-21;108;116;526;2127;105;455;2164;0;22;6123403;6809312;10642844;168339;6157843;11763080;268826;0;845
FR;2;2022-06-22;39;110;462;1889;57;415;1971;0;25;6123442;6809422;10643306;170228;6157900;11763495;270797;0;870
FR;2;2022-06-23;58;109;537;2282;68;452;2400;0;30;6123500;6809531;10643843;172510;6157968;11763947;273197;0;900
FR;2;2022-06-24;66;122;709;3199;65;571;3339;0;38;6123566;6809653;10644552;175709;6158033;11764518;276536;0;938
FR;2;2022-06-25;30;90;298;988;55;254;1041;0;13;6123596;6809743;10644850;176697;6158088;11764772;277577;0;951
FR;2;2022-06-26;30;27;131;194;29;97;236;0;5;6123626;6809770;10644981;176891;6158117;11764869;277813;0;956
FR;2;2022-06-27;79;137;582;2490;94;483;2623;0;39;6123705;6809907;10645563;179381;6158211;11765352;280436;0;995
FR;2;2022-06-28;110;140;812;4817;81;650;4894;0;54;6123815;6810047;10646375;184198;6158292;11766002;285330;0;1049
FR;2;2022-06-29;73;150;776;4436;80;637;4532;0;56;6123888;6810197;10647151;188634;6158372;11766639;289862;0;1105
FR;2;2022-06-30;72;133;834;5177;71;619;5398;0;79;6123960;6810330;10647985;193811;6158443;11767258;295260;0;1184
FR;2;2022-07-01;113;161;1152;6692;95;853;6944;0;92;6124073;6810491;10649137;200503;6158538;11768111;302204;0;1276
FR;2;2022-07-02;69;132;474;1977;82;392;2068;0;27;6124142;6810623;10649611;202480;6158620;11768503;304272;0;1303
FR;2;2022-07-03;23;30;147;334;21;131;357;0;8;6124165;6810653;10649758;202814;6158641;11768634;304629;0;1311
FR;2;2022-07-04;122;184;776;3785;113;612;3971;0;49;6124287;6810837;10650534;206599;6158754;11769246;308600;0;1360
FR;2;2022-07-05;119;188;1121;6818;121;829;6999;0;85;6124406;6811025;10651655;213417;6158875;11770075;315599;0;1445
FR;2;2022-07-06;93;152;951;5807;95;698;5933;0;84;6124499;6811177;10652606;219224;6158970;11770773;321532;0;1529
FR;2;2022-07-07;81;185;1021;6501;116;752;6732;0;101;6124580;6811362;10653627;225725;6159086;11771525;328264;0;1630
FR;2;2022-07-08;65;122;1095;7044;51;758;7235;0;123;6124645;6811484;10654722;232769;6159137;11772283;335499;0;1753
FR;2;2022-07-09;34;62;417;1869;31;299;1919;0;33;6124679;6811546;10655139;234638;6159168;11772582;337418;0;1786
FR;2;2022-07-10;7;17;97;315;8;83;327;0;5;6124686;6811563;10655236;234953;6159176;11772665;337745;0;1791
FR;2;2022-07-11;68;121;683;3826;76;541;3901;0;67;6124754;6811684;10655919;238779;6159252;11773206;341646;0;1858
FR;2;2022-07-12;102;180;1054;6517;107;809;6725;0;119;6124856;6811864;10656973;245296;6159359;11774015;348371;0;1977
FR;2;2022-07-13;65;128;879;4665;76;591;4831;0;78;6124921;6811992;10657852;249961;6159435;11774606;353202;0;2055
FR;2;2022-07-14;6;13;89;250;8;60;269;0;8;6124927;6812005;10657941;250211;6159443;11774666;353471;0;2063
FR;2;2022-07-15;61;129;739;3795;53;560;3961;0;75;6124988;6812134;10658680;254006;6159496;11775226;357432;0;2138
FR;2;2022-07-16;28;54;289;1031;30;242;1077;0;25;6125016;6812188;10658969;255037;6159526;11775468;358509;0;2163
FR;2;2022-07-17;5;12;78;201;6;67;207;0;6;6125021;6812200;10659047;255238;6159532;11775535;358716;0;2169
FR;2;2022-07-18;57;103;514;2510;61;385;2648;0;59;6125078;6812303;10659561;257748;6159593;11775920;361364;0;2228
FR;2;2022-07-19;66;133;770;4258;72;555;4447;0;72;6125144;6812436;10660331;262006;6159665;11776475;365811;0;2300
FR;2;2022-07-20;59;117;582;3179;68;430;3278;0;87;6125203;6812553;10660913;265185;6159733;11776905;369089;0;2387
FR;2;2022-07-21;60;110;673;3680;73;487;3797;0;105;6125263;6812663;10661586;268865;6159806;11777392;372886;0;2492
FR;2;2022-07-22;51;100;700;3550;48;507;3701;0;80;6125314;6812763;10662286;272415;6159854;11777899;376587;0;2572
FR;2;2022-07-23;38;97;290;1175;51;229;1228;0;37;6125352;6812860;10662576;273590;6159905;11778128;377815;0;2609
FR;2;2022-07-24;14;24;69;201;19;68;203;0;7;6125366;6812884;10662645;273791;6159924;11778196;378018;0;2616
FR;2;2022-07-25;50;71;405;1938;60;300;2000;0;56;6125416;6812955;10663050;275729;6159984;11778496;380018;0;2672
FR;2;2022-07-26;57;133;606;3423;67;476;3496;0;113;6125473;6813088;10663656;279152;6160051;11778972;383514;0;2785
FR;2;2022-07-27;42;81;457;2782;50;361;2801;0;89;6125515;6813169;10664113;281934;6160101;11779333;386315;0;2874
FR;2;2022-07-28;29;75;450;2487;37;356;2491;0;78;6125544;6813244;10664563;284421;6160138;11779689;388806;0;2952
FR;2;2022-07-29;68;88;535;2857;63;347;2978;0;73;6125612;6813332;10665098;287278;6160201;11780036;391784;0;3025
FR;2;2022-07-30;22;39;163;776;32;110;796;0;24;6125634;6813371;10665261;288054;6160233;11780146;392580;0;3049
FR;2;2022-07-31;6;13;27;104;12;21;110;0;2;6125640;6813384;10665288;288158;6160245;11780167;392690;0;3051
FR;2;2022-08-01;38;107;323;1262;74;260;1344;0;29;6125678;6813491;10665611;289420;6160319;11780427;394034;0;3080
FR;2;2022-08-02;49;75;325;2061;50;247;2097;0;78;6125727;6813566;10665936;291481;6160369;11780674;396131;0;3158
FR;2;2022-08-03;29;53;260;1611;25;188;1617;0;57;6125756;6813619;10666196;293092;6160394;11780862;397748;0;3215
FR;2;2022-08-04;40;65;306;1692;39;240;1701;0;66;6125796;6813684;10666502;294784;6160433;11781102;399449;0;3281
FR;2;2022-08-05;33;94;328;1881;67;236;1912;0;60;6125829;6813778;10666830;296665;6160500;11781338;401361;0;3341
FR;2;2022-08-06;22;41;106;365;29;82;372;0;10;6125851;6813819;10666936;297030;6160529;11781420;401733;0;3351
FR;2;2022-08-07;7;8;15;69;5;16;71;0;3;6125858;6813827;10666951;297099;6160534;11781436;401804;0;3354
FR;2;2022-08-08;19;35;220;877;22;148;915;0;33;6125877;6813862;10667171;297976;6160556;11781584;402719;0;3387
FR;2;2022-08-09;30;52;279;1474;42;238;1470;0;50;6125907;6813914;10667450;299450;6160598;11781822;404189;0;3437
FR;2;2022-08-10;17;22;213;1134;19;150;1155;0;46;6125924;6813936;10667663;300584;6160617;11781972;405344;0;3483
FR;2;2022-08-11;21;41;174;1038;26;117;1047;0;40;6125945;6813977;10667837;301622;6160643;11782089;406391;0;3523
FR;2;2022-08-12;36;51;184;1046;38;141;1069;0;35;6125981;6814028;10668021;302668;6160681;11782230;407460;0;3558
FR;2;2022-08-13;11;19;47;149;15;53;137;0;5;6125992;6814047;10668068;302817;6160696;11782283;407597;0;3563
FR;2;2022-08-14;1;2;12;52;1;11;54;0;1;6125993;6814049;10668080;302869;6160697;11782294;407651;0;3564
FR;2;2022-08-15;0;5;32;22;2;21;21;0;3;6125993;6814054;10668112;302891;6160699;11782315;407672;0;3567
FR;2;2022-08-16;27;33;144;681;34;120;678;0;33;6126020;6814087;10668256;303572;6160733;11782435;408350;0;3600
FR;2;2022-08-17;18;27;109;738;18;88;744;0;34;6126038;6814114;10668365;304310;6160751;11782523;409094;0;3634
FR;2;2022-08-18;14;30;160;836;14;107;852;0;42;6126052;6814144;10668525;305146;6160765;11782630;409946;0;3676
FR;2;2022-08-19;8;38;118;706;31;88;706;0;33;6126060;6814182;10668643;305852;6160796;11782718;410652;0;3709
FR;2;2022-08-20;6;26;61;197;16;52;201;0;8;6126066;6814208;10668704;306049;6160812;11782770;410853;0;3717
FR;2;2022-08-21;4;14;15;19;6;13;31;0;0;6126070;6814222;10668719;306068;6160818;11782783;410884;0;3717
FR;2;2022-08-22;11;25;116;395;17;73;451;0;13;6126081;6814247;10668835;306463;6160835;11782856;411335;0;3730
FR;2;2022-08-23;12;42;134;671;23;112;679;0;38;6126093;6814289;10668969;307134;6160858;11782968;412014;0;3768
FR;2;2022-08-24;11;28;87;466;21;80;472;0;18;6126104;6814317;10669056;307600;6160879;11783048;412486;0;3786
FR;2;2022-08-25;8;32;109;481;16;69;516;0;17;6126112;6814349;10669165;308081;6160895;11783117;413002;0;3803
FR;2;2022-08-26;16;46;117;720;36;91;713;0;32;6126128;6814395;10669282;308801;6160931;11783208;413715;0;3835
FR;2;2022-08-27;10;19;47;158;16;42;166;0;2;6126138;6814414;10669329;308959;6160947;11783250;413881;0;3837
FR;2;2022-08-28;1;5;5;15;1;7;16;0;1;6126139;6814419;10669334;308974;6160948;11783257;413897;0;3838
FR;2;2022-08-29;24;43;94;400;29;88;396;0;24;6126163;6814462;10669428;309374;6160977;11783345;414293;0;3862
FR;2;2022-08-30;31;54;154;791;34;119;798;0;29;6126194;6814516;10669582;310165;6161011;11783464;415091;0;3891
FR;2;2022-08-31;19;37;85;392;24;79;393;0;25;6126213;6814553;10669667;310557;6161035;11783543;415484;0;3916
FR;2;2022-09-01;19;43;139;600;25;122;609;0;36;6126232;6814596;10669806;311157;6161060;11783665;416093;0;3952
FR;2;2022-09-02;34;57;147;744;34;160;748;0;32;6126266;6814653;10669953;311901;6161094;11783825;416841;0;3984
FR;2;2022-09-03;17;20;83;205;11;67;213;0;7;6126283;6814673;10670036;312106;6161105;11783892;417054;0;3991
FR;2;2022-09-04;8;5;9;31;2;10;30;0;3;6126291;6814678;10670045;312137;6161107;11783902;417084;0;3994
FR;2;2022-09-05;29;32;126;367;24;98;397;0;24;6126320;6814710;10670171;312504;6161131;11784000;417481;0;4018
FR;2;2022-09-06;44;63;158;762;43;153;768;0;36;6126364;6814773;10670329;313266;6161174;11784153;418249;0;4054
FR;2;2022-09-07;21;22;76;375;18;51;387;0;23;6126385;6814795;10670405;313641;6161192;11784204;418636;0;4077
FR;2;2022-09-08;31;58;109;636;41;100;646;0;22;6126416;6814853;10670514;314277;6161233;11784304;419282;0;4099
FR;2;2022-09-09;18;24;126;754;21;74;747;0;48;6126434;6814877;10670640;315031;6161254;11784378;420029;0;4147
FR;2;2022-09-10;14;25;57;117;17;48;131;0;4;6126448;6814902;10670697;315148;6161271;11784426;420160;0;4151
FR;2;2022-09-11;12;5;11;11;3;13;13;0;0;6126460;6814907;10670708;315159;6161274;11784439;420173;0;4151
FR;2;2022-09-12;20;31;70;340;26;56;352;0;16;6126480;6814938;10670778;315499;6161300;11784495;420525;0;4167
FR;2;2022-09-13;15;34;125;670;13;99;674;0;40;6126495;6814972;10670903;316169;6161313;11784594;421199;0;4207
FR;2;2022-09-14;19;23;81;480;20;60;478;0;36;6126514;6814995;10670984;316649;6161333;11784654;421677;0;4243
FR;2;2022-09-15;23;45;126;486;27;102;493;0;47;6126537;6815040;10671110;317135;6161360;11784756;422170;0;4290
FR;2;2022-09-16;22;31;124;563;17;89;585;0;39;6126559;6815071;10671234;317698;6161377;11784845;422755;0;4329
FR;2;2022-09-17;6;20;56;160;15;52;147;0;14;6126565;6815091;10671290;317858;6161392;11784897;422902;0;4343
FR;2;2022-09-18;4;7;13;37;6;10;37;0;3;6126569;6815098;10671303;317895;6161398;11784907;422939;0;4346
FR;2;2022-09-19;26;24;114;353;16;87;381;0;22;6126595;6815122;10671417;318248;6161414;11784994;423320;0;4368
FR;2;2022-09-20;29;27;117;624;21;84;639;0;38;6126624;6815149;10671534;318872;6161435;11785078;423959;0;4406
FR;2;2022-09-21;15;30;100;393;15;78;418;0;23;6126639;6815179;10671634;319265;6161450;11785156;424377;0;4429
FR;2;2022-09-22;19;39;124;581;18;95;619;0;28;6126658;6815218;10671758;319846;6161468;11785251;424996;0;4457
FR;2;2022-09-23;21;38;135;556;22;111;571;0;40;6126679;6815256;10671893;320402;6161490;11785362;425567;0;4497
FR;2;2022-09-24;10;8;52;190;8;37;201;0;7;6126689;6815264;10671945;320592;6161498;11785399;425768;0;4504
FR;2;2022-09-25;9;11;15;29;11;12;33;0;5;6126698;6815275;10671960;320621;6161509;11785411;425801;0;4509
FR;2;2022-09-26;22;41;116;447;27;79;458;0;20;6126720;6815316;10672076;321068;6161536;11785490;426259;0;4529
FR;2;2022-09-27;30;46;162;906;35;108;861;0;52;6126750;6815362;10672238;321974;6161571;11785598;427120;0;4581
FR;2;2022-09-28;15;31;93;421;18;74;439;0;23;6126765;6815393;10672331;322395;6161589;11785672;427559;0;4604
FR;2;2022-09-29;26;48;115;618;23;110;630;0;33;6126791;6815441;10672446;323013;6161612;11785782;428189;0;4637
FR;2;2022-09-30;25;44;111;520;45;84;533;0;31;6126816;6815485;10672557;323533;6161657;11785866;428722;0;4668
FR;2;2022-10-01;11;20;51;128;20;36;129;0;8;6126827;6815505;10672608;323661;6161677;11785902;428851;0;4676
FR;2;2022-10-02;0;5;8;21;4;5;25;0;2;6126827;6815510;10672616;323682;6161681;11785907;428876;0;4678
FR;2;2022-10-03;22;35;85;291;30;69;306;0;22;6126849;6815545;10672701;323973;6161711;11785976;429182;0;4700
FR;2;2022-10-04;17;21;106;601;19;71;620;0;46;6126866;6815566;10672807;324574;6161730;11786047;429802;0;4746
FR;2;2022-10-05;20;31;75;491;26;67;488;0;54;6126886;6815597;10672882;325065;6161756;11786114;430290;0;4800
FR;2;2022-10-06;30;23;74;442;17;71;428;0;65;6126916;6815620;10672956;325507;6161773;11786185;430718;0;4865
FR;2;2022-10-07;21;30;86;499;27;66;503;0;42;6126937;6815650;10673042;326006;6161800;11786251;431221;0;4907
FR;2;2022-10-08;12;8;24;114;3;25;108;0;12;6126949;6815658;10673066;326120;6161803;11786276;431329;0;4919
FR;2;2022-10-09;1;8;15;17;6;11;22;0;5;6126950;6815666;10673081;326137;6161809;11786287;431351;0;4924
FR;2;2022-10-10;18;27;47;223;25;49;218;0;21;6126968;6815693;10673128;326360;6161834;11786336;431569;0;4945
FR;2;2022-10-11;16;15;48;253;11;39;241;0;52;6126984;6815708;10673176;326613;6161845;11786375;431810;0;4997
FR;2;2022-10-12;9;20;52;290;16;36;305;0;56;6126993;6815728;10673228;326903;6161861;11786411;432115;0;5053
FR;2;2022-10-13;11;14;48;271;9;48;261;0;26;6127004;6815742;10673276;327174;6161870;11786459;432376;0;5079
FR;2;2022-10-14;13;30;36;230;18;40;231;0;29;6127017;6815772;10673312;327404;6161888;11786499;432607;0;5108
FR;2;2022-10-15;4;13;22;111;7;17;113;0;15;6127021;6815785;10673334;327515;6161895;11786516;432720;0;5123
FR;2;2022-10-16;0;7;4;11;6;7;8;0;1;6127021;6815792;10673338;327526;6161901;11786523;432728;0;5124
FR;2;2022-10-17;15;19;31;121;18;26;131;0;29;6127036;6815811;10673369;327647;6161919;11786549;432859;0;5153
FR;2;2022-10-18;13;12;68;185;6;34;247;0;46;6127049;6815823;10673437;327832;6161925;11786583;433106;0;5199
FR;2;2022-10-19;8;17;39;184;12;31;223;0;52;6127057;6815840;10673476;328016;6161937;11786614;433329;0;5251
FR;2;2022-10-20;11;29;41;200;15;40;196;0;52;6127068;6815869;10673517;328216;6161952;11786654;433525;0;5303
FR;2;2022-10-21;6;16;60;233;7;53;222;0;31;6127074;6815885;10673577;328449;6161959;11786707;433747;0;5334
FR;2;2022-10-22;8;7;25;102;2;23;103;0;20;6127082;6815892;10673602;328551;6161961;11786730;433850;0;5354
FR;2;2022-10-23;0;3;1;5;3;0;6;0;2;6127082;6815895;10673603;328556;6161964;11786730;433856;0;5356
FR;2;2022-10-24;12;12;16;110;12;16;113;0;20;6127094;6815907;10673619;328666;6161976;11786746;433969;0;5376
FR;2;2022-10-25;12;7;23;138;6;15;145;0;51;6127106;6815914;10673642;328804;6161982;11786761;434114;0;5427
FR;2;2022-10-26;4;3;17;90;2;11;96;0;27;6127110;6815917;10673659;328894;6161984;11786772;434210;0;5454
FR;2;2022-10-27;7;10;18;88;10;20;71;0;27;6127117;6815927;10673677;328982;6161994;11786792;434281;0;5481
FR;2;2022-10-28;5;3;15;91;3;7;92;0;27;6127122;6815930;10673692;329073;6161997;11786799;434373;0;5508
FR;2;2022-10-29;7;8;18;33;6;14;37;0;8;6127129;6815938;10673710;329106;6162003;11786813;434410;0;5516
FR;2;2022-10-30;3;7;5;8;5;2;5;0;1;6127132;6815945;10673715;329114;6162008;11786815;434415;0;5517
FR;2;2022-10-31;2;8;6;49;6;10;48;0;11;6127134;6815953;10673721;329163;6162014;11786825;434463;0;5528
FR;2;2022-11-01;0;6;8;1;5;6;4;0;0;6127134;6815959;10673729;329164;6162019;11786831;434467;0;5528
FR;2;2022-11-02;6;5;12;44;5;12;45;0;11;6127140;6815964;10673741;329208;6162024;11786843;434512;0;5539
FR;2;2022-11-03;6;7;16;77;6;10;75;0;18;6127146;6815971;10673757;329285;6162030;11786853;434587;0;5557
FR;2;2022-11-04;7;12;15;85;10;14;93;0;10;6127153;6815983;10673772;329370;6162040;11786867;434680;0;5567
FR;2;2022-11-05;0;11;13;38;6;17;35;0;6;6127153;6815994;10673785;329408;6162046;11786884;434715;0;5573
FR;2;2022-11-06;0;2;2;1;0;4;0;0;2;6127153;6815996;10673787;329409;6162046;11786888;434715;0;5575
FR;2;2022-11-07;13;8;15;67;6;14;66;0;20;6127166;6816004;10673802;329476;6162052;11786902;434781;0;5595
FR;2;2022-11-08;14;8;18;58;6;14;65;0;27;6127180;6816012;10673820;329534;6162058;11786916;434846;0;5622
FR;2;2022-11-09;4;5;17;56;2;17;50;0;28;6127184;6816017;10673837;329590;6162060;11786933;434896;0;5650
FR;2;2022-11-10;7;10;17;74;7;14;76;0;14;6127191;6816027;10673854;329664;6162067;11786947;434972;0;5664
FR;2;2022-11-11;0;3;9;3;0;10;4;0;0;6127191;6816030;10673863;329667;6162067;11786957;434976;0;5664
FR;2;2022-11-12;2;5;7;19;4;7;19;0;4;6127193;6816035;10673870;329686;6162071;11786964;434995;0;5668
FR;2;2022-11-13;3;2;4;2;1;5;1;0;0;6127196;6816037;10673874;329688;6162072;11786969;434996;0;5668
FR;2;2022-11-14;7;6;13;29;3;10;33;0;7;6127203;6816043;10673887;329717;6162075;11786979;435029;0;5675
FR;2;2022-11-15;8;15;15;35;16;18;32;0;7;6127211;6816058;10673902;329752;6162091;11786997;435061;0;5682
FR;2;2022-11-16;3;6;4;45;6;4;46;0;18;6127214;6816064;10673906;329797;6162097;11787001;435107;0;5700
FR;2;2022-11-17;2;6;12;56;5;9;55;0;22;6127216;6816070;10673918;329853;6162102;11787010;435162;0;5722
FR;2;2022-11-18;3;4;7;41;4;6;44;0;10;6127219;6816074;10673925;329894;6162106;11787016;435206;0;5732
FR;2;2022-11-19;3;3;2;25;3;3;18;0;5;6127222;6816077;10673927;329919;6162109;11787019;435224;0;5737
FR;2;2022-11-20;0;2;6;9;2;6;10;0;26;6127222;6816079;10673933;329928;6162111;11787025;435234;0;5763
FR;2;2022-11-21;6;10;9;31;7;8;34;0;22;6127228;6816089;10673942;329959;6162118;11787033;435268;0;5785
FR;2;2022-11-22;8;8;20;65;6;21;70;0;71;6127236;6816097;10673962;330024;6162124;11787054;435338;0;5856
FR;2;2022-11-23;7;6;8;68;3;5;73;0;8;6127243;6816103;10673970;330092;6162127;11787059;435411;0;5864
FR;2;2022-11-24;2;2;11;51;2;7;58;0;10;6127245;6816105;10673981;330143;6162129;11787066;435469;0;5874
FR;2;2022-11-25;11;8;14;25;11;14;26;0;8;6127256;6816113;10673995;330168;6162140;11787080;435495;0;5882
FR;2;2022-11-26;1;5;4;8;4;7;6;0;0;6127257;6816118;10673999;330176;6162144;11787087;435501;0;5882
FR;2;2022-11-27;2;2;12;2;0;11;4;0;1;6127259;6816120;10674011;330178;6162144;11787098;435505;0;5883
FR;2;2022-11-28;0;2;8;35;1;6;37;0;5;6127259;6816122;10674019;330213;6162145;11787104;435542;0;5888
FR;2;2022-11-29;1;1;10;24;0;4;30;0;8;6127260;6816123;10674029;330237;6162145;11787108;435572;0;5896
FR;2;2022-11-30;2;2;10;47;1;11;44;0;21;6127262;6816125;10674039;330284;6162146;11787119;435616;0;5917
FR;2;2022-12-01;2;12;6;63;9;13;55;0;24;6127264;6816137;10674045;330347;6162155;11787132;435671;0;5941
FR;2;2022-12-02;1;2;12;51;2;10;51;0;27;6127265;6816139;10674057;330398;6162157;11787142;435722;0;5968
FR;2;2022-12-03;1;4;8;19;2;8;18;0;10;6127266;6816143;10674065;330417;6162159;11787150;435740;0;5978
FR;2;2022-12-04;0;0;0;4;0;0;4;0;2;6127266;6816143;10674065;330421;6162159;11787150;435744;0;5980
FR;2;2022-12-05;3;5;8;51;8;4;45;0;16;6127269;6816148;10674073;330472;6162167;11787154;435789;0;5996
FR;2;2022-12-06;3;5;14;45;4;6;48;0;17;6127272;6816153;10674087;330517;6162171;11787160;435837;0;6013
FR;2;2022-12-07;1;5;9;42;3;8;44;0;11;6127273;6816158;10674096;330559;6162174;11787168;435881;0;6024
FR;2;2022-12-08;0;2;11;44;0;6;49;0;16;6127273;6816160;10674107;330603;6162174;11787174;435930;0;6040
FR;2;2022-12-09;0;1;13;52;0;9;57;0;17;6127273;6816161;10674120;330655;6162174;11787183;435987;0;6057
FR;2;2022-12-10;0;3;15;50;1;6;52;0;9;6127273;6816164;10674135;330705;6162175;11787189;436039;0;6066
FR;2;2022-12-11;0;0;2;2;0;2;1;0;3;6127273;6816164;10674137;330707;6162175;11787191;436040;0;6069
FR;2;2022-12-12;1;0;6;37;0;6;36;0;11;6127274;6816164;10674143;330744;6162175;11787197;436076;0;6080
FR;2;2022-12-13;0;3;2;37;2;1;37;0;14;6127274;6816167;10674145;330781;6162177;11787198;436113;0;6094
FR;2;2022-12-14;0;5;8;26;5;3;31;0;14;6127274;6816172;10674153;330807;6162182;11787201;436144;0;6108
FR;2;2022-12-15;0;5;12;43;5;9;44;0;17;6127274;6816177;10674165;330850;6162187;11787210;436188;0;6125
FR;2;2022-12-16;2;4;27;56;3;20;62;0;16;6127276;6816181;10674192;330906;6162190;11787230;436250;0;6141
FR;2;2022-12-17;1;4;10;44;3;6;39;0;5;6127277;6816185;10674202;330950;6162193;11787236;436289;0;6146
FR;2;2022-12-18;1;0;0;0;0;0;0;0;1;6127278;6816185;10674202;330950;6162193;11787236;436289;0;6147
FR;2;2022-12-19;6;5;4;31;6;5;24;0;24;6127284;6816190;10674206;330981;6162199;11787241;436313;0;6171
FR;2;2022-12-20;0;4;6;37;2;7;38;0;24;6127284;6816194;10674212;331018;6162201;11787248;436351;0;6195
FR;2;2022-12-21;0;1;4;13;1;4;13;0;8;6127284;6816195;10674216;331031;6162202;11787252;436364;0;6203
FR;2;2022-12-22;0;5;17;32;2;6;45;0;10;6127284;6816200;10674233;331063;6162204;11787258;436409;0;6213
FR;2;2022-12-23;1;5;15;18;3;12;22;0;4;6127285;6816205;10674248;331081;6162207;11787270;436431;0;6217
FR;2;2022-12-24;0;0;1;1;0;1;1;0;0;6127285;6816205;10674249;331082;6162207;11787271;436432;0;6217
FR;2;2022-12-25;0;1;1;3;0;1;4;0;0;6127285;6816206;10674250;331085;6162207;11787272;436436;0;6217
FR;2;2022-12-26;0;0;7;11;0;5;11;0;3;6127285;6816206;10674257;331096;6162207;11787277;436447;0;6220
FR;2;2022-12-27;0;1;7;5;1;5;7;0;4;6127285;6816207;10674264;331101;6162208;11787282;436454;0;6224
FR;2;2022-12-28;0;2;4;13;2;3;14;0;5;6127285;6816209;10674268;331114;6162210;11787285;436468;0;6229
FR;2;2022-12-29;1;2;4;18;1;5;18;0;7;6127286;6816211;10674272;331132;6162211;11787290;436486;0;6236
FR;2;2022-12-30;1;0;2;8;0;2;7;0;1;6127287;6816211;10674274;331140;6162211;11787292;436493;0;6237
FR;2;2022-12-31;0;0;1;2;0;1;2;0;1;6127287;6816211;10674275;331142;6162211;11787293;436495;0;6238
FR;2;2023-01-01;0;0;0;0;0;0;0;0;0;6127287;6816211;10674275;331142;6162211;11787293;436495;0;6238
FR;2;2023-01-02;5;4;9;21;3;7;23;0;2;6127292;6816215;10674284;331163;6162214;11787300;436518;0;6240
FR;2;2023-01-03;1;0;6;13;0;7;11;0;6;6127293;6816215;10674290;331176;6162214;11787307;436529;0;6246
FR;2;2023-01-04;1;4;9;13;5;7;13;0;6;6127294;6816219;10674299;331189;6162219;11787314;436542;0;6252
FR;2;2023-01-05;0;2;7;6;2;4;7;0;3;6127294;6816221;10674306;331195;6162221;11787318;436549;0;6255
FR;2;2023-01-06;1;0;9;9;0;4;13;0;9;6127295;6816221;10674315;331204;6162221;11787322;436562;0;6264
FR;2;2023-01-07;0;0;4;10;0;4;8;0;5;6127295;6816221;10674319;331214;6162221;11787326;436570;0;6269
FR;2;2023-01-08;0;0;3;3;0;3;3;0;2;6127295;6816221;10674322;331217;6162221;11787329;436573;0;6271
FR;2;2023-01-09;0;2;8;9;2;3;13;0;5;6127295;6816223;10674330;331226;6162223;11787332;436586;0;6276
FR;2;2023-01-10;0;5;4;8;4;3;10;0;6;6127295;6816228;10674334;331234;6162227;11787335;436596;0;6282
FR;2;2023-01-11;3;0;4;7;0;3;9;0;3;6127298;6816228;10674338;331241;6162227;11787338;436605;0;6285
FR;2;2023-01-12;1;1;9;13;1;7;10;0;11;6127299;6816229;10674347;331254;6162228;11787345;436615;0;6296
FR;2;2023-01-13;0;1;5;7;1;3;10;0;3;6127299;6816230;10674352;331261;6162229;11787348;436625;0;6299
FR;2;2023-01-14;0;1;2;6;0;3;6;0;1;6127299;6816231;10674354;331267;6162229;11787351;436631;0;6300
FR;2;2023-01-15;0;0;0;0;0;0;0;0;0;6127299;6816231;10674354;331267;6162229;11787351;436631;0;6300
FR;2;2023-01-16;1;1;5;6;2;2;7;0;1;6127300;6816232;10674359;331273;6162231;11787353;436638;0;6301
FR;2;2023-01-17;1;0;5;4;0;5;3;0;0;6127301;6816232;10674364;331277;6162231;11787358;436641;0;6301
FR;2;2023-01-18;0;0;3;2;0;3;2;0;0;6127301;6816232;10674367;331279;6162231;11787361;436643;0;6301
FR;2;2023-01-19;0;0;1;6;0;1;6;0;6;6127301;6816232;10674368;331285;6162231;11787362;436649;0;6307
FR;2;2023-01-20;0;0;1;8;0;1;8;0;4;6127301;6816232;10674369;331293;6162231;11787363;436657;0;6311
FR;2;2023-01-21;0;0;0;3;0;0;0;0;0;6127301;6816232;10674369;331296;6162231;11787363;436657;0;6311
FR;2;2023-01-22;0;0;0;0;0;0;0;0;0;6127301;6816232;10674369;331296;6162231;11787363;436657;0;6311
FR;2;2023-01-23;0;0;3;3;0;2;3;0;1;6127301;6816232;10674372;331299;6162231;11787365;436660;0;6312
FR;2;2023-01-24;1;3;1;6;3;0;7;0;4;6127302;6816235;10674373;331305;6162234;11787365;436667;0;6316
FR;2;2023-01-25;1;0;0;6;0;0;6;0;0;6127303;6816235;10674373;331311;6162234;11787365;436673;0;6316
FR;2;2023-01-26;1;0;3;7;0;1;9;0;3;6127304;6816235;10674376;331318;6162234;11787366;436682;0;6319
FR;2;2023-01-27;0;2;3;3;1;2;3;0;2;6127304;6816237;10674379;331321;6162235;11787368;436685;0;6321
FR;2;2023-01-28;0;0;0;1;0;0;1;0;0;6127304;6816237;10674379;331322;6162235;11787368;436686;0;6321
FR;2;2023-01-29;0;0;1;0;0;0;1;0;0;6127304;6816237;10674380;331322;6162235;11787368;436687;0;6321
FR;2;2023-01-30;0;1;2;3;1;1;4;0;1;6127304;6816238;10674382;331325;6162236;11787369;436691;0;6322
FR;2;2023-01-31;1;0;3;2;0;2;3;0;0;6127305;6816238;10674385;331327;6162236;11787371;436694;0;6322
FR;2;2023-02-01;0;3;2;0;2;3;0;0;0;6127305;6816241;10674387;331327;6162238;11787374;436694;0;6322
FR;2;2023-02-02;0;2;3;4;1;4;6;0;4;6127305;6816243;10674390;331331;6162239;11787378;436700;0;6326
FR;2;2023-02-03;0;2;1;12;2;0;11;0;9;6127305;6816245;10674391;331343;6162241;11787378;436711;0;6335
FR;2;2023-02-04;0;1;1;0;0;2;0;0;0;6127305;6816246;10674392;331343;6162241;11787380;436711;0;6335
FR;2;2023-02-05;0;0;0;0;0;0;0;0;0;6127305;6816246;10674392;331343;6162241;11787380;436711;0;6335
FR;2;2023-02-06;0;4;2;2;3;3;2;0;0;6127305;6816250;10674394;331345;6162244;11787383;436713;0;6335
FR;2;2023-02-07;2;1;0;0;0;1;0;0;1;6127307;6816251;10674394;331345;6162244;11787384;436713;0;6336
FR;2;2023-02-08;0;0;3;2;0;2;4;0;1;6127307;6816251;10674397;331347;6162244;11787386;436717;0;6337
FR;2;2023-02-09;0;0;1;4;0;2;3;0;3;6127307;6816251;10674398;331351;6162244;11787388;436720;0;6340
FR;2;2023-02-10;0;0;1;3;0;1;2;0;6;6127307;6816251;10674399;331354;6162244;11787389;436722;0;6346
FR;2;2023-02-11;2;2;1;1;0;2;2;0;0;6127309;6816253;10674400;331355;6162244;11787391;436724;0;6346
FR;2;2023-02-12;0;0;0;0;0;0;0;0;0;6127309;6816253;10674400;331355;6162244;11787391;436724;0;6346
FR;2;2023-02-13;3;0;1;5;0;0;5;0;1;6127312;6816253;10674401;331360;6162244;11787391;436729;0;6347
FR;2;2023-02-14;1;2;1;1;2;0;2;0;0;6127313;6816255;10674402;331361;6162246;11787391;436731;0;6347
FR;2;2023-02-15;3;0;1;1;0;1;1;0;0;6127316;6816255;10674403;331362;6162246;11787392;436732;0;6347
FR;2;2023-02-16;3;1;1;1;1;1;1;0;2;6127319;6816256;10674404;331363;6162247;11787393;436733;0;6349
FR;2;2023-02-17;0;0;1;4;0;1;3;0;4;6127319;6816256;10674405;331367;6162247;11787394;436736;0;6353
FR;2;2023-02-18;0;0;5;1;0;5;0;0;1;6127319;6816256;10674410;331368;6162247;11787399;436736;0;6354
FR;2;2023-02-19;0;1;0;0;1;0;0;0;0;6127319;6816257;10674410;331368;6162248;11787399;436736;0;6354
FR;2;2023-02-20;1;0;0;1;0;0;1;0;2;6127320;6816257;10674410;331369;6162248;11787399;436737;0;6356
FR;2;2023-02-21;0;0;0;1;0;0;1;0;2;6127320;6816257;10674410;331370;6162248;11787399;436738;0;6358
FR;2;2023-02-22;1;0;0;3;0;0;3;0;0;6127321;6816257;10674410;331373;6162248;11787399;436741;0;6358
FR;2;2023-02-23;0;0;0;1;0;0;1;0;3;6127321;6816257;10674410;331374;6162248;11787399;436742;0;6361
FR;2;2023-02-24;1;0;1;2;0;0;3;0;0;6127322;6816257;10674411;331376;6162248;11787399;436745;0;6361
FR;2;2023-02-25;0;0;1;2;0;1;2;0;0;6127322;6816257;10674412;331378;6162248;11787400;436747;0;6361
FR;2;2023-02-26;0;0;0;0;0;0;0;0;0;6127322;6816257;10674412;331378;6162248;11787400;436747;0;6361
FR;2;2023-02-27;1;0;1;1;1;1;1;0;0;6127323;6816257;10674413;331379;6162249;11787401;436748;0;6361
FR;2;2023-02-28;1;0;0;0;0;0;0;0;2;6127324;6816257;10674413;331379;6162249;11787401;436748;0;6363
FR;2;2023-03-01;0;2;3;2;1;3;1;0;1;6127324;6816259;10674416;331381;6162250;11787404;436749;0;6364
FR;2;2023-03-02;0;2;2;1;2;1;1;0;1;6127324;6816261;10674418;331382;6162252;11787405;436750;0;6365
FR;2;2023-03-03;1;0;3;1;0;3;1;0;0;6127325;6816261;10674421;331383;6162252;11787408;436751;0;6365
FR;2;2023-03-04;0;0;1;0;0;1;0;0;0;6127325;6816261;10674422;331383;6162252;11787409;436751;0;6365
FR;2;2023-03-05;0;0;0;0;0;0;0;0;0;6127325;6816261;10674422;331383;6162252;11787409;436751;0;6365
FR;2;2023-03-06;0;0;2;1;0;1;2;0;2;6127325;6816261;10674424;331384;6162252;11787410;436753;0;6367
FR;2;2023-03-07;0;1;2;1;1;2;1;0;1;6127325;6816262;10674426;331385;6162253;11787412;436754;0;6368
FR;2;2023-03-08;0;0;0;0;0;0;0;0;2;6127325;6816262;10674426;331385;6162253;11787412;436754;0;6370
FR;2;2023-03-09;0;0;1;1;0;0;2;0;0;6127325;6816262;10674427;331386;6162253;11787412;436756;0;6370
FR;2;2023-03-10;0;0;1;0;0;1;0;0;0;6127325;6816262;10674428;331386;6162253;11787413;436756;0;6370
FR;2;2023-03-11;0;0;4;1;0;3;2;0;0;6127325;6816262;10674432;331387;6162253;11787416;436758;0;6370
FR;2;2023-03-12;0;0;0;0;0;0;0;0;0;6127325;6816262;10674432;331387;6162253;11787416;436758;0;6370
FR;2;2023-03-13;0;0;1;3;0;1;3;0;0;6127325;6816262;10674433;331390;6162253;11787417;436761;0;6370
FR;2;2023-03-14;1;0;0;0;0;0;0;0;0;6127326;6816262;10674433;331390;6162253;11787417;436761;0;6370
FR;2;2023-03-15;0;2;0;3;2;0;3;0;0;6127326;6816264;10674433;331393;6162255;11787417;436764;0;6370
FR;2;2023-03-16;0;2;0;0;1;1;1;0;0;6127326;6816266;10674433;331393;6162256;11787418;436765;0;6370
FR;2;2023-03-17;0;0;1;1;0;1;0;0;0;6127326;6816266;10674434;331394;6162256;11787419;436765;0;6370
FR;2;2023-03-18;0;0;7;0;0;7;0;0;1;6127326;6816266;10674441;331394;6162256;11787426;436765;0;6371
FR;2;2023-03-19;0;0;0;0;0;0;0;0;0;6127326;6816266;10674441;331394;6162256;11787426;436765;0;6371
FR;2;2023-03-20;0;0;1;0;0;1;0;0;0;6127326;6816266;10674442;331394;6162256;11787427;436765;0;6371
FR;2;2023-03-21;0;0;1;2;0;1;2;0;1;6127326;6816266;10674443;331396;6162256;11787428;436767;0;6372
FR;2;2023-03-22;0;0;0;0;0;0;0;0;1;6127326;6816266;10674443;331396;6162256;11787428;436767;0;6373
FR;2;2023-03-23;0;1;0;0;1;0;0;0;1;6127326;6816267;10674443;331396;6162257;11787428;436767;0;6374
FR;2;2023-03-24;0;1;0;2;1;0;2;0;2;6127326;6816268;10674443;331398;6162258;11787428;436769;0;6376
FR;2;2023-03-25;0;0;1;2;0;1;2;0;0;6127326;6816268;10674444;331400;6162258;11787429;436771;0;6376
FR;2;2023-03-26;0;2;1;0;2;1;0;0;0;6127326;6816270;10674445;331400;6162260;11787430;436771;0;6376
FR;2;2023-03-27;0;2;2;0;2;2;0;0;1;6127326;6816272;10674447;331400;6162262;11787432;436771;0;6377
FR;2;2023-03-28;0;0;0;0;0;0;0;0;1;6127326;6816272;10674447;331400;6162262;11787432;436771;0;6378
FR;2;2023-03-29;0;0;0;2;0;0;2;0;0;6127326;6816272;10674447;331402;6162262;11787432;436773;0;6378
FR;2;2023-03-30;0;0;0;0;0;0;0;0;0;6127326;6816272;10674447;331402;6162262;11787432;436773;0;6378
FR;2;2023-03-31;0;1;0;1;1;0;1;0;0;6127326;6816273;10674447;331403;6162263;11787432;436774;0;6378
FR;2;2023-04-01;0;0;1;0;0;0;1;0;0;6127326;6816273;10674448;331403;6162263;11787432;436775;0;6378
FR;2;2023-04-02;0;0;0;0;0;0;0;0;0;6127326;6816273;10674448;331403;6162263;11787432;436775;0;6378
FR;2;2023-04-03;0;1;2;2;1;2;2;0;1;6127326;6816274;10674450;331405;6162264;11787434;436777;0;6379
FR;2;2023-04-04;0;0;0;2;0;0;2;0;0;6127326;6816274;10674450;331407;6162264;11787434;436779;0;6379
FR;2;2023-04-05;0;0;1;0;0;1;0;0;0;6127326;6816274;10674451;331407;6162264;11787435;436779;0;6379
FR;2;2023-04-06;0;1;0;0;1;0;0;0;0;6127326;6816275;10674451;331407;6162265;11787435;436779;0;6379
FR;2;2023-04-07;0;0;0;1;0;0;1;0;0;6127326;6816275;10674451;331408;6162265;11787435;436780;0;6379
FR;2;2023-04-08;0;0;0;0;0;0;0;0;0;6127326;6816275;10674451;331408;6162265;11787435;436780;0;6379
FR;2;2023-04-09;0;0;1;0;0;1;0;0;0;6127326;6816275;10674452;331408;6162265;11787436;436780;0;6379
FR;2;2023-04-10;0;2;0;0;1;1;0;0;0;6127326;6816277;10674452;331408;6162266;11787437;436780;0;6379
FR;2;2023-04-11;0;0;0;0;0;0;0;0;1;6127326;6816277;10674452;331408;6162266;11787437;436780;0;6380
FR;2;2023-04-12;0;0;0;0;0;0;0;0;0;6127326;6816277;10674452;331408;6162266;11787437;436780;0;6380
FR;2;2023-04-13;0;0;2;1;0;2;0;0;0;6127326;6816277;10674454;331409;6162266;11787439;436780;0;6380
FR;2;2023-04-14;0;1;0;1;1;0;1;0;0;6127326;6816278;10674454;331410;6162267;11787439;436781;0;6380
FR;2;2023-04-15;0;0;0;0;0;0;0;0;0;6127326;6816278;10674454;331410;6162267;11787439;436781;0;6380
FR;2;2023-04-16;0;0;0;0;0;0;0;0;0;6127326;6816278;10674454;331410;6162267;11787439;436781;0;6380
FR;2;2023-04-17;1;1;0;0;2;0;0;0;0;6127327;6816279;10674454;331410;6162269;11787439;436781;0;6380
FR;2;2023-04-18;0;0;1;2;0;1;2;0;0;6127327;6816279;10674455;331412;6162269;11787440;436783;0;6380
FR;2;2023-04-19;0;0;0;0;0;0;2;0;0;6127327;6816279;10674455;331412;6162269;11787440;436785;0;6380
FR;2;2023-04-20;0;0;1;1;0;1;1;0;0;6127327;6816279;10674456;331413;6162269;11787441;436786;0;6380
FR;2;2023-04-21;0;0;1;0;0;1;0;0;0;6127327;6816279;10674457;331413;6162269;11787442;436786;0;6380
FR;2;2023-04-22;0;0;2;2;0;1;1;0;2;6127327;6816279;10674459;331415;6162269;11787443;436787;0;6382
FR;2;2023-04-23;0;0;0;0;0;0;0;0;0;6127327;6816279;10674459;331415;6162269;11787443;436787;0;6382
FR;2;2023-04-24;0;0;1;0;0;0;1;0;0;6127327;6816279;10674460;331415;6162269;11787443;436788;0;6382
FR;2;2023-04-25;0;0;0;0;0;0;0;0;0;6127327;6816279;10674460;331415;6162269;11787443;436788;0;6382
FR;2;2023-04-26;0;1;0;0;0;1;0;0;0;6127327;6816280;10674460;331415;6162269;11787444;436788;0;6382
FR;2;2023-04-27;0;0;0;0;0;0;0;0;1;6127327;6816280;10674460;331415;6162269;11787444;436788;0;6383
FR;2;2023-04-28;0;0;0;0;0;0;0;0;2;6127327;6816280;10674460;331415;6162269;11787444;436788;0;6385
FR;2;2023-04-29;0;0;0;1;0;0;1;0;0;6127327;6816280;10674460;331416;6162269;11787444;436789;0;6385
FR;2;2023-04-30;0;0;0;0;0;0;0;0;0;6127327;6816280;10674460;331416;6162269;11787444;436789;0;6385
FR;2;2023-05-01;0;1;0;0;1;0;0;0;0;6127327;6816281;10674460;331416;6162270;11787444;436789;0;6385
FR;2;2023-05-02;0;0;4;1;0;4;1;0;2;6127327;6816281;10674464;331417;6162270;11787448;436790;0;6387
FR;2;2023-05-03;0;1;0;0;0;1;0;0;0;6127327;6816282;10674464;331417;6162270;11787449;436790;0;6387
FR;2;2023-05-04;0;0;0;1;0;0;1;0;0;6127327;6816282;10674464;331418;6162270;11787449;436791;0;6387
FR;2;2023-05-05;0;1;1;1;1;1;1;0;0;6127327;6816283;10674465;331419;6162271;11787450;436792;0;6387
FR;2;2023-05-06;0;0;0;0;0;0;0;0;0;6127327;6816283;10674465;331419;6162271;11787450;436792;0;6387
FR;2;2023-05-07;0;0;0;0;0;0;0;0;0;6127327;6816283;10674465;331419;6162271;11787450;436792;0;6387
FR;2;2023-05-08;0;0;0;0;0;0;0;0;0;6127327;6816283;10674465;331419;6162271;11787450;436792;0;6387
FR;2;2023-05-09;0;1;0;0;0;1;0;0;0;6127327;6816284;10674465;331419;6162271;11787451;436792;0;6387
FR;2;2023-05-10;0;0;0;0;0;0;0;0;2;6127327;6816284;10674465;331419;6162271;11787451;436792;0;6389
FR;2;2023-05-11;0;0;0;0;0;0;0;0;1;6127327;6816284;10674465;331419;6162271;11787451;436792;0;6390
FR;2;2023-05-12;0;0;0;0;0;0;0;0;0;6127327;6816284;10674465;331419;6162271;11787451;436792;0;6390
FR;2;2023-05-13;0;0;0;0;0;0;0;0;0;6127327;6816284;10674465;331419;6162271;11787451;436792;0;6390
FR;2;2023-05-14;0;0;0;0;0;0;0;0;0;6127327;6816284;10674465;331419;6162271;11787451;436792;0;6390
FR;2;2023-05-15;0;0;1;0;0;1;0;0;0;6127327;6816284;10674466;331419;6162271;11787452;436792;0;6390
FR;2;2023-05-16;0;0;0;0;0;0;0;0;0;6127327;6816284;10674466;331419;6162271;11787452;436792;0;6390
FR;2;2023-05-17;0;0;0;0;0;0;0;0;0;6127327;6816284;10674466;331419;6162271;11787452;436792;0;6390
FR;2;2023-05-18;0;0;0;1;0;0;1;0;0;6127327;6816284;10674466;331420;6162271;11787452;436793;0;6390
FR;2;2023-05-19;0;0;0;0;0;0;0;0;0;6127327;6816284;10674466;331420;6162271;11787452;436793;0;6390
FR;2;2023-05-20;0;0;0;0;0;0;0;0;0;6127327;6816284;10674466;331420;6162271;11787452;436793;0;6390
FR;2;2023-05-21;0;0;0;0;0;0;0;0;0;6127327;6816284;10674466;331420;6162271;11787452;436793;0;6390
FR;2;2023-05-22;0;0;0;1;0;0;1;0;0;6127327;6816284;10674466;331421;6162271;11787452;436794;0;6390
FR;2;2023-05-23;0;0;0;0;0;0;0;0;1;6127327;6816284;10674466;331421;6162271;11787452;436794;0;6391
FR;2;2023-05-24;0;0;0;0;0;0;0;0;0;6127327;6816284;10674466;331421;6162271;11787452;436794;0;6391
FR;2;2023-05-25;0;0;0;0;0;0;1;0;0;6127327;6816284;10674466;331421;6162271;11787452;436795;0;6391
FR;2;2023-05-26;0;1;0;1;1;0;1;0;1;6127327;6816285;10674466;331422;6162272;11787452;436796;0;6392
FR;2;2023-05-27;0;0;2;0;0;2;0;0;0;6127327;6816285;10674468;331422;6162272;11787454;436796;0;6392
FR;2;2023-05-28;0;0;0;0;0;0;0;0;0;6127327;6816285;10674468;331422;6162272;11787454;436796;0;6392
FR;2;2023-05-29;0;0;0;0;0;0;0;0;0;6127327;6816285;10674468;331422;6162272;11787454;436796;0;6392
FR;2;2023-05-30;0;0;0;0;0;0;0;0;0;6127327;6816285;10674468;331422;6162272;11787454;436796;0;6392
FR;2;2023-05-31;0;0;0;0;0;0;0;0;0;6127327;6816285;10674468;331422;6162272;11787454;436796;0;6392
FR;2;2023-06-01;0;0;1;0;0;0;1;0;0;6127327;6816285;10674469;331422;6162272;11787454;436797;0;6392
FR;2;2023-06-02;0;0;0;0;0;0;2;0;0;6127327;6816285;10674469;331422;6162272;11787454;436799;0;6392
FR;2;2023-06-03;0;0;1;0;0;0;1;0;0;6127327;6816285;10674470;331422;6162272;11787454;436800;0;6392
FR;2;2023-06-04;0;0;0;0;0;0;0;0;0;6127327;6816285;10674470;331422;6162272;11787454;436800;0;6392
FR;2;2023-06-05;0;0;0;0;0;0;0;0;0;6127327;6816285;10674470;331422;6162272;11787454;436800;0;6392
FR;2;2023-06-06;0;0;1;0;0;0;0;0;0;6127327;6816285;10674471;331422;6162272;11787454;436800;0;6392
FR;2;2023-06-07;0;0;0;0;0;0;0;0;0;6127327;6816285;10674471;331422;6162272;11787454;436800;0;6392
FR;2;2023-06-08;0;0;0;0;0;0;0;0;0;6127327;6816285;10674471;331422;6162272;11787454;436800;0;6392
FR;2;2023-06-09;0;0;0;0;0;0;0;0;0;6127327;6816285;10674471;331422;6162272;11787454;436800;0;6392
FR;2;2023-06-10;0;0;0;0;0;0;0;0;0;6127327;6816285;10674471;331422;6162272;11787454;436800;0;6392
FR;2;2023-06-11;0;0;0;0;0;0;0;0;0;6127327;6816285;10674471;331422;6162272;11787454;436800;0;6392
FR;2;2023-06-12;0;0;1;0;0;1;0;0;0;6127327;6816285;10674472;331422;6162272;11787455;436800;0;6392
FR;3;2020-12-27;0;0;0;0;0;0;0;0;0;0;0;0;0;0;0;0;0;0
FR;3;2020-12-28;0;0;0;0;0;0;0;0;0;0;0;0;0;0;0;0;0;0
FR;3;2020-12-29;0;0;0;0;0;0;0;0;0;0;0;0;0;0;0;0;0;0
FR;3;2020-12-30;0;0;0;0;0;0;0;0;0;0;0;0;0;0;0;0;0;0
FR;3;2020-12-31;0;0;0;0;0;0;0;0;0;0;0;0;0;0;0;0;0;0
FR;3;2021-01-01;0;0;0;0;0;0;0;0;0;0;0;0;0;0;0;0;0;0
FR;3;2021-01-02;0;0;0;0;0;0;0;0;0;0;0;0;0;0;0;0;0;0
FR;3;2021-01-03;0;0;0;0;0;0;0;0;0;0;0;0;0;0;0;0;0;0
FR;3;2021-01-04;0;0;0;0;0;0;0;0;0;0;0;0;0;0;0;0;0;0
FR;3;2021-01-05;0;0;0;0;0;0;0;0;0;0;0;0;0;0;0;0;0;0
FR;3;2021-01-06;0;0;0;0;0;0;0;0;0;0;0;0;0;0;0;0;0;0
FR;3;2021-01-07;0;0;0;0;0;0;0;0;0;0;0;0;0;0;0;0;0;0
FR;3;2021-01-08;0;0;0;0;0;0;0;0;0;0;0;0;0;0;0;0;0;0
FR;3;2021-01-09;0;0;0;0;0;0;0;0;0;0;0;0;0;0;0;0;0;0
FR;3;2021-01-10;0;0;0;0;0;0;0;0;0;0;0;0;0;0;0;0;0;0
FR;3;2021-01-11;0;0;0;0;0;0;0;0;0;0;0;0;0;0;0;0;0;0
FR;3;2021-01-12;0;0;0;0;0;0;0;0;0;0;0;0;0;0;0;0;0;0
FR;3;2021-01-13;0;0;0;0;0;0;0;0;0;0;0;0;0;0;0;0;0;0
FR;3;2021-01-14;0;0;0;0;0;0;0;0;0;0;0;0;0;0;0;0;0;0
FR;3;2021-01-15;0;0;0;0;0;0;0;0;0;0;0;0;0;0;0;0;0;0
FR;3;2021-01-16;0;0;0;0;0;0;0;0;0;0;0;0;0;0;0;0;0;0
FR;3;2021-01-17;0;0;0;0;0;0;0;0;0;0;0;0;0;0;0;0;0;0
FR;3;2021-01-18;0;0;0;0;0;0;0;0;0;0;0;0;0;0;0;0;0;0
FR;3;2021-01-19;0;0;0;0;0;0;0;0;0;0;0;0;0;0;0;0;0;0
FR;3;2021-01-20;0;0;0;0;0;0;0;0;0;0;0;0;0;0;0;0;0;0
FR;3;2021-01-21;0;0;0;0;0;0;0;0;0;0;0;0;0;0;0;0;0;0
FR;3;2021-01-22;0;0;0;0;0;0;0;0;0;0;0;0;0;0;0;0;0;0
FR;3;2021-01-23;0;0;0;0;0;0;0;0;0;0;0;0;0;0;0;0;0;0
FR;3;2021-01-24;0;0;0;0;0;0;0;0;0;0;0;0;0;0;0;0;0;0
FR;3;2021-01-25;0;0;0;0;0;0;0;0;0;0;0;0;0;0;0;0;0;0
FR;3;2021-01-26;0;0;0;0;0;0;0;0;0;0;0;0;0;0;0;0;0;0
FR;3;2021-01-27;0;0;0;0;0;0;0;0;0;0;0;0;0;0;0;0;0;0
FR;3;2021-01-28;0;0;0;0;0;0;0;0;0;0;0;0;0;0;0;0;0;0
FR;3;2021-01-29;0;0;0;0;0;0;0;0;0;0;0;0;0;0;0;0;0;0
FR;3;2021-01-30;0;0;0;0;0;0;0;0;0;0;0;0;0;0;0;0;0;0
FR;3;2021-01-31;0;0;0;0;0;0;0;0;0;0;0;0;0;0;0;0;0;0
FR;3;2021-02-01;0;0;0;0;0;0;0;0;0;0;0;0;0;0;0;0;0;0
FR;3;2021-02-02;0;0;0;0;0;0;0;0;0;0;0;0;0;0;0;0;0;0
FR;3;2021-02-03;0;0;0;0;0;0;0;0;0;0;0;0;0;0;0;0;0;0
FR;3;2021-02-04;0;0;0;0;0;0;0;0;0;0;0;0;0;0;0;0;0;0
FR;3;2021-02-05;0;0;0;0;0;0;0;0;0;0;0;0;0;0;0;0;0;0
FR;3;2021-02-06;1474;0;0;0;105;0;0;0;0;1474;0;0;0;105;0;0;0;0
FR;3;2021-02-07;1423;2;0;0;87;0;0;0;0;2897;2;0;0;192;0;0;0;0
FR;3;2021-02-08;2790;1;0;0;177;0;0;0;0;5687;3;0;0;369;0;0;0;0
FR;3;2021-02-09;6786;0;0;0;502;0;0;0;0;12473;3;0;0;871;0;0;0;0
FR;3;2021-02-10;9612;0;0;0;695;0;0;0;0;22085;3;0;0;1566;0;0;0;0
FR;3;2021-02-11;13620;4;0;0;919;0;0;0;0;35705;7;0;0;2485;0;0;0;0
FR;3;2021-02-12;13410;0;0;0;907;0;0;0;0;49115;7;0;0;3392;0;0;0;0
FR;3;2021-02-13;3800;1;0;0;218;0;0;0;0;52915;8;0;0;3610;0;0;0;0
FR;3;2021-02-14;975;1;0;0;53;0;0;0;0;53890;9;0;0;3663;0;0;0;0
FR;3;2021-02-15;10497;2;0;0;719;0;0;0;0;64387;11;0;0;4382;0;0;0;0
FR;3;2021-02-16;12556;5;0;0;871;0;0;0;0;76943;16;0;0;5253;0;0;0;0
FR;3;2021-02-17;11159;1;0;0;717;0;0;0;0;88102;17;0;0;5970;0;0;0;0
FR;3;2021-02-18;14943;2;0;0;985;0;0;0;0;103045;19;0;0;6955;0;0;0;0
FR;3;2021-02-19;14364;1;0;0;846;0;0;0;0;117409;20;0;0;7801;0;0;0;0
FR;3;2021-02-20;3332;0;0;0;178;0;0;0;0;120741;20;0;0;7979;0;0;0;0
FR;3;2021-02-21;620;0;0;0;35;0;0;0;0;121361;20;0;0;8014;0;0;0;0
FR;3;2021-02-22;9171;1;0;0;654;0;0;0;0;130532;21;0;0;8668;0;0;0;0
FR;3;2021-02-23;11406;6;0;0;761;0;0;0;0;141938;27;0;0;9429;0;0;0;0
FR;3;2021-02-24;14305;1;0;0;829;0;0;0;0;156243;28;0;0;10258;0;0;0;0
FR;3;2021-02-25;44935;3;0;0;1814;0;0;0;0;201178;31;0;0;12072;0;0;0;0
FR;3;2021-02-26;61889;13;0;0;2201;0;0;0;0;263067;44;0;0;14273;0;0;0;0
FR;3;2021-02-27;34811;14;0;0;1028;0;0;0;0;297878;58;0;0;15301;0;0;0;0
FR;3;2021-02-28;2464;0;0;0;114;0;0;0;0;300342;58;0;0;15415;0;0;0;0
FR;3;2021-03-01;20521;21;0;0;1067;0;0;0;0;320863;79;0;0;16482;0;0;0;0
FR;3;2021-03-02;38878;25;0;0;1790;0;0;0;0;359741;104;0;0;18272;0;0;0;0
FR;3;2021-03-03;48750;18;0;0;2130;0;0;0;0;408491;122;0;0;20402;0;0;0;0
FR;3;2021-03-04;82229;25;0;0;3194;0;0;0;0;490720;147;0;0;23596;0;0;0;0
FR;3;2021-03-05;118138;43;0;0;4693;0;0;0;0;608858;190;0;0;28289;0;0;0;0
FR;3;2021-03-06;120727;65;1;0;3559;0;0;0;0;729585;255;1;0;31848;0;0;0;0
FR;3;2021-03-07;55186;23;0;0;1729;0;0;0;0;784771;278;1;0;33577;0;0;0;0
FR;3;2021-03-08;42814;29;0;0;2074;0;0;0;0;827585;307;1;0;35651;0;0;0;0
FR;3;2021-03-09;78979;51;0;0;3288;0;0;0;0;906564;358;1;0;38939;0;0;0;0
FR;3;2021-03-10;80985;67;0;0;3243;0;0;0;0;987549;425;1;0;42182;0;0;0;0
FR;3;2021-03-11;128447;66;0;0;4766;0;0;0;0;1115996;491;1;0;46948;0;0;0;0
FR;3;2021-03-12;182718;122;0;0;6279;0;0;0;0;1298714;613;1;0;53227;0;0;0;0
FR;3;2021-03-13;132160;91;0;0;3530;0;0;0;0;1430874;704;1;0;56757;0;0;0;0
FR;3;2021-03-14;14061;6;0;0;550;0;0;0;0;1444935;710;1;0;57307;0;0;0;0
FR;3;2021-03-15;52243;82;0;0;2097;0;0;0;0;1497178;792;1;0;59404;0;0;0;0
FR;3;2021-03-16;1221;51;0;0;105;0;0;0;0;1498399;843;1;0;59509;0;0;0;0
FR;3;2021-03-17;950;56;0;0;95;0;0;0;0;1499349;899;1;0;59604;0;0;0;0
FR;3;2021-03-18;1577;42;0;0;102;0;0;0;0;1500926;941;1;0;59706;0;0;0;0
FR;3;2021-03-19;70458;56;0;0;2060;0;0;0;0;1571384;997;1;0;61766;0;0;0;0
FR;3;2021-03-20;65242;51;0;0;1702;0;0;0;0;1636626;1048;1;0;63468;0;0;0;0
FR;3;2021-03-21;5761;8;0;0;199;0;0;0;0;1642387;1056;1;0;63667;0;0;0;0
FR;3;2021-03-22;37511;50;0;0;1053;0;0;0;0;1679898;1106;1;0;64720;0;0;0;0
FR;3;2021-03-23;84670;87;0;0;2288;0;0;0;0;1764568;1193;1;0;67008;0;0;0;0
FR;3;2021-03-24;90956;99;0;0;2491;0;0;0;0;1855524;1292;1;0;69499;0;0;0;0
FR;3;2021-03-25;150068;149;0;0;3792;0;0;0;0;2005592;1441;1;0;73291;0;0;0;0
FR;3;2021-03-26;165432;157;0;0;4148;0;0;0;0;2171024;1598;1;0;77439;0;0;0;0
FR;3;2021-03-27;68465;101;0;0;2004;0;0;0;0;2239489;1699;1;0;79443;0;0;0;0
FR;3;2021-03-28;6481;20;0;0;238;0;0;0;0;2245970;1719;1;0;79681;0;0;0;0
FR;3;2021-03-29;54171;83;0;0;1480;0;0;0;0;2300141;1802;1;0;81161;0;0;0;0
FR;3;2021-03-30;93185;103;0;0;2564;0;0;0;0;2393326;1905;1;0;83725;0;0;0;0
FR;3;2021-03-31;63547;110;0;0;1964;0;0;0;0;2456873;2015;1;0;85689;0;0;0;0
FR;3;2021-04-01;86136;116;0;0;2496;0;0;0;0;2543009;2131;1;0;88185;0;0;0;0
FR;3;2021-04-02;86916;186;0;0;2766;0;0;0;0;2629925;2317;1;0;90951;0;0;0;0
FR;3;2021-04-03;35876;133;0;0;1164;0;0;0;0;2665801;2450;1;0;92115;0;0;0;0
FR;3;2021-04-04;3577;19;0;0;164;0;0;0;0;2669378;2469;1;0;92279;0;0;0;0
FR;3;2021-04-05;4492;40;0;0;236;0;0;0;0;2673870;2509;1;0;92515;0;0;0;0
FR;3;2021-04-06;29763;105;0;0;1091;0;0;0;0;2703633;2614;1;0;93606;0;0;0;0
FR;3;2021-04-07;32350;113;0;0;1052;0;0;0;0;2735983;2727;1;0;94658;0;0;0;0
FR;3;2021-04-08;78825;274;0;0;2619;0;0;0;0;2814808;3001;1;0;97277;0;0;0;0
FR;3;2021-04-09;161764;454;0;0;5180;0;0;0;0;2976572;3455;1;0;102457;0;0;0;0
FR;3;2021-04-10;75765;365;0;0;2697;0;0;0;0;3052337;3820;1;0;105154;0;0;0;0
FR;3;2021-04-11;7316;47;0;0;306;0;0;0;0;3059653;3867;1;0;105460;0;0;0;0
FR;3;2021-04-12;51484;219;0;0;1738;0;0;0;0;3111137;4086;1;0;107198;0;0;0;0
FR;3;2021-04-13;86236;364;0;0;2911;0;0;0;0;3197373;4450;1;0;110109;0;0;0;0
FR;3;2021-04-14;67847;377;0;0;2429;0;0;0;0;3265220;4827;1;0;112538;0;0;0;0
FR;3;2021-04-15;93246;404;0;0;3442;0;0;0;0;3358466;5231;1;0;115980;0;0;0;0
FR;3;2021-04-16;112532;628;0;0;4343;0;0;0;0;3470998;5859;1;0;120323;0;0;0;0
FR;3;2021-04-17;53319;371;1;0;2277;0;0;0;0;3524317;6230;2;0;122600;0;0;0;0
FR;3;2021-04-18;9752;49;0;0;423;0;0;0;0;3534069;6279;2;0;123023;0;0;0;0
FR;3;2021-04-19;25117;287;0;0;1093;0;0;0;0;3559186;6566;2;0;124116;0;0;0;0
FR;3;2021-04-20;45676;438;0;0;1908;0;0;0;0;3604862;7004;2;0;126024;0;0;0;0
FR;3;2021-04-21;38988;553;0;0;1897;0;0;0;0;3643850;7557;2;0;127921;0;0;0;0
FR;3;2021-04-22;54723;875;0;0;2827;0;0;0;0;3698573;8432;2;0;130748;0;0;0;0
FR;3;2021-04-23;70493;1095;0;0;3697;0;0;0;0;3769066;9527;2;0;134445;0;0;0;0
FR;3;2021-04-24;37253;1101;0;0;2490;0;0;0;0;3806319;10628;2;0;136935;0;0;0;0
FR;3;2021-04-25;6213;158;0;0;446;0;0;0;0;3812532;10786;2;0;137381;0;0;0;0
FR;3;2021-04-26;19792;701;0;0;1436;0;0;0;0;3832324;11487;2;0;138817;0;0;0;0
FR;3;2021-04-27;34486;1336;0;0;2594;0;0;0;0;3866810;12823;2;0;141411;0;0;0;0
FR;3;2021-04-28;28971;2047;0;0;3164;0;0;0;0;3895781;14870;2;0;144575;0;0;0;0
FR;3;2021-04-29;45394;6127;0;0;7946;0;0;0;0;3941175;20997;2;0;152521;0;0;0;0
FR;3;2021-04-30;55465;9118;1;0;11513;0;0;0;0;3996640;30115;3;0;164034;0;0;0;0
FR;3;2021-05-01;9518;2064;0;0;2495;0;0;0;0;4006158;32179;3;0;166529;0;0;0;0
FR;3;2021-05-02;3081;466;0;0;611;0;0;0;0;4009239;32645;3;0;167140;0;0;0;0
FR;3;2021-05-03;13067;3939;0;0;4506;0;0;0;0;4022306;36584;3;0;171646;0;0;0;0
FR;3;2021-05-04;23123;8375;0;0;9442;0;0;0;0;4045429;44959;3;0;181088;0;0;0;0
FR;3;2021-05-05;18768;10832;0;0;11770;0;0;0;0;4064197;55791;3;0;192858;0;0;0;0
FR;3;2021-05-06;34632;21265;0;0;22815;0;0;0;0;4098829;77056;3;0;215673;0;0;0;0
FR;3;2021-05-07;44211;28903;0;0;31206;0;0;0;0;4143040;105959;3;0;246879;0;0;0;0
FR;3;2021-05-08;6786;9190;0;0;9556;0;0;0;0;4149826;115149;3;0;256435;0;0;0;0
FR;3;2021-05-09;1797;2667;0;0;2768;0;0;0;0;4151623;117816;3;0;259203;0;0;0;0
FR;3;2021-05-10;15001;12917;0;0;13610;0;0;0;0;4166624;130733;3;0;272813;0;0;0;0
FR;3;2021-05-11;27100;26272;0;0;27545;0;0;0;0;4193724;157005;3;0;300358;0;0;0;0
FR;3;2021-05-12;17273;28147;0;0;29085;0;0;0;0;4210997;185152;3;0;329443;0;0;0;0
FR;3;2021-05-13;2285;3511;0;0;3632;0;0;0;0;4213282;188663;3;0;333075;0;0;0;0
FR;3;2021-05-14;14521;26084;0;0;26865;0;0;0;0;4227803;214747;3;0;359940;0;0;0;0
FR;3;2021-05-15;7233;21086;0;0;21516;0;0;0;0;4235036;235833;3;0;381456;0;0;0;0
FR;3;2021-05-16;977;2649;0;0;2695;0;0;0;0;4236013;238482;3;0;384151;0;0;0;0
FR;3;2021-05-17;7967;20224;0;0;20668;0;0;0;0;4243980;258706;3;0;404819;0;0;0;0
FR;3;2021-05-18;13418;30157;0;0;30920;0;0;0;0;4257398;288863;3;0;435739;0;0;0;0
FR;3;2021-05-19;9277;30526;0;0;31120;0;0;0;0;4266675;319389;3;0;466859;0;0;0;0
FR;3;2021-05-20;12809;53832;3;0;54758;0;0;0;0;4279484;373221;6;0;521617;0;0;0;0
FR;3;2021-05-21;12771;66186;2;0;67117;0;0;0;0;4292255;439407;8;0;588734;0;0;0;0
FR;3;2021-05-22;4967;33781;1;0;34164;0;0;0;0;4297222;473188;9;0;622898;0;0;0;0
FR;3;2021-05-23;651;2663;0;0;2695;0;0;0;0;4297873;475851;9;0;625593;0;0;0;0
FR;3;2021-05-24;885;4784;0;0;4828;0;0;0;0;4298758;480635;9;0;630421;0;0;0;0
FR;3;2021-05-25;5316;46738;1;0;47145;0;0;0;0;4304074;527373;10;0;677566;0;0;0;0
FR;3;2021-05-26;4982;52192;1;0;52666;0;0;0;0;4309056;579565;11;0;730232;0;0;0;0
FR;3;2021-05-27;6338;79066;3;0;79677;0;0;0;0;4315394;658631;14;0;809909;0;0;0;0
FR;3;2021-05-28;7546;100337;2;0;101143;0;0;0;0;4322940;758968;16;0;911052;0;0;0;0
FR;3;2021-05-29;3350;61184;1;0;61566;0;0;0;0;4326290;820152;17;0;972618;0;0;0;0
FR;3;2021-05-30;551;8078;0;0;8127;0;0;0;0;4326841;828230;17;0;980745;0;0;0;0
FR;3;2021-05-31;2442;35483;3;0;35749;0;0;0;0;4329283;863713;20;0;1016494;0;0;0;0
FR;3;2021-06-01;3418;64904;10;0;65356;0;0;0;0;4332701;928617;30;0;1081850;0;0;0;0
FR;3;2021-06-02;2735;58932;6;0;59267;0;0;0;0;4335436;987549;36;0;1141117;0;0;0;0
FR;3;2021-06-03;3496;87204;10;0;87743;0;0;0;0;4338932;1074753;46;0;1228860;0;0;0;0
FR;3;2021-06-04;4125;105866;22;0;106532;0;0;0;0;4343057;1180619;68;0;1335392;0;0;0;0
FR;3;2021-06-05;1983;52608;4;0;52926;0;0;0;0;4345040;1233227;72;0;1388318;0;0;0;0
FR;3;2021-06-06;511;5269;1;0;5317;0;0;0;0;4345551;1238496;73;0;1393635;0;0;0;0
FR;3;2021-06-07;1487;30717;11;0;30898;0;0;0;0;4347038;1269213;84;0;1424533;0;0;0;0
FR;3;2021-06-08;2066;47426;18;0;47773;0;0;0;0;4349104;1316639;102;0;1472306;0;0;0;0
FR;3;2021-06-09;1796;41806;13;0;42111;0;0;0;0;4350900;1358445;115;0;1514417;0;0;0;0
FR;3;2021-06-10;2261;67662;17;0;68060;0;0;0;0;4353161;1426107;132;0;1582477;0;0;0;0
FR;3;2021-06-11;2494;96639;34;0;97115;0;0;0;0;4355655;1522746;166;0;1679592;0;0;0;0
FR;3;2021-06-12;1179;40558;6;0;40790;0;0;0;0;4356834;1563304;172;0;1720382;0;0;0;0
FR;3;2021-06-13;283;3606;3;0;3641;0;0;0;0;4357117;1566910;175;0;1724023;0;0;0;0
FR;3;2021-06-14;1051;42315;17;0;42485;0;0;0;0;4358168;1609225;192;0;1766508;0;0;0;0
FR;3;2021-06-15;1379;80354;20;0;80659;0;0;0;0;4359547;1689579;212;0;1847167;0;0;0;0
FR;3;2021-06-16;1263;65504;20;0;65777;0;0;0;0;4360810;1755083;232;0;1912944;0;0;0;0
FR;3;2021-06-17;1667;102294;41;0;102680;0;0;0;0;4362477;1857377;273;0;2015624;0;0;0;0
FR;3;2021-06-18;1873;118469;63;0;118939;0;0;0;0;4364350;1975846;336;0;2134563;0;0;0;0
FR;3;2021-06-19;804;39455;22;0;39650;0;0;0;0;4365154;2015301;358;0;2174213;0;0;0;0
FR;3;2021-06-20;162;3194;0;0;3223;0;0;0;0;4365316;2018495;358;0;2177436;0;0;0;0
FR;3;2021-06-21;775;39091;16;0;39249;0;0;0;0;4366091;2057586;374;0;2216685;0;0;0;0
FR;3;2021-06-22;1065;70092;52;0;70363;0;0;0;0;4367156;2127678;426;0;2287048;0;0;0;0
FR;3;2021-06-23;946;50833;39;0;51105;0;0;0;0;4368102;2178511;465;0;2338153;0;0;0;0
FR;3;2021-06-24;1314;77299;48;0;77672;0;0;0;0;4369416;2255810;513;0;2415825;0;0;0;0
FR;3;2021-06-25;1410;90853;73;0;91287;0;0;0;0;4370826;2346663;586;0;2507112;0;0;0;0
FR;3;2021-06-26;631;33108;29;0;33300;0;0;0;0;4371457;2379771;615;0;2540412;0;0;0;0
FR;3;2021-06-27;168;3778;1;0;3802;0;0;0;0;4371625;2383549;616;0;2544214;0;0;0;0
FR;3;2021-06-28;655;29929;27;0;30123;0;0;0;0;4372280;2413478;643;0;2574337;0;0;0;0
FR;3;2021-06-29;856;56655;95;0;56899;0;0;0;0;4373136;2470133;738;0;2631236;0;0;0;0
FR;3;2021-06-30;905;45216;93;0;45484;0;0;0;0;4374041;2515349;831;0;2676720;0;0;0;0
FR;3;2021-07-01;1164;66130;108;0;66479;0;0;0;0;4375205;2581479;939;0;2743199;0;0;0;0
FR;3;2021-07-02;1305;90526;170;0;91009;0;0;0;0;4376510;2672005;1109;0;2834208;0;0;0;0
FR;3;2021-07-03;602;31185;51;0;31386;0;0;0;0;4377112;2703190;1160;0;2865594;0;0;0;0
FR;3;2021-07-04;144;3968;3;0;3998;0;0;0;0;4377256;2707158;1163;0;2869592;0;0;0;0
FR;3;2021-07-05;613;33604;60;0;33805;0;0;0;0;4377869;2740762;1223;0;2903397;0;0;0;0
FR;3;2021-07-06;965;55938;88;0;56249;0;0;0;0;4378834;2796700;1311;0;2959646;0;0;0;0
FR;3;2021-07-07;874;42967;80;0;43265;0;0;0;0;4379708;2839667;1391;0;3002911;0;0;0;0
FR;3;2021-07-08;1127;60811;99;0;61221;0;0;0;0;4380835;2900478;1490;0;3064132;0;0;0;0
FR;3;2021-07-09;1261;68941;128;0;69406;0;0;0;0;4382096;2969419;1618;0;3133538;0;0;0;0
FR;3;2021-07-10;644;25019;59;0;25217;0;0;0;0;4382740;2994438;1677;0;3158755;0;0;0;0
FR;3;2021-07-11;132;3173;4;0;3198;0;0;0;0;4382872;2997611;1681;0;3161953;0;0;0;0
FR;3;2021-07-12;662;23600;59;0;23813;0;0;0;0;4383534;3021211;1740;0;3185766;0;0;0;0
FR;3;2021-07-13;1648;34428;90;0;34918;0;0;0;0;4385182;3055639;1830;0;3220684;0;0;0;0
FR;3;2021-07-14;272;2475;2;0;2532;0;0;0;0;4385454;3058114;1832;0;3223216;0;0;0;0
FR;3;2021-07-15;1941;30414;85;0;30989;0;0;0;0;4387395;3088528;1917;0;3254205;0;0;0;0
FR;3;2021-07-16;2520;38621;122;0;39355;0;0;0;0;4389915;3127149;2039;0;3293560;0;0;0;0
FR;3;2021-07-17;1051;13723;26;0;14031;0;0;0;0;4390966;3140872;2065;0;3307591;0;0;0;0
FR;3;2021-07-18;266;2548;3;0;2596;0;0;0;0;4391232;3143420;2068;0;3310187;0;0;0;0
FR;3;2021-07-19;1280;16883;38;0;17251;0;0;0;0;4392512;3160303;2106;0;3327438;0;0;0;0
FR;3;2021-07-20;1823;26931;98;0;27472;0;0;0;0;4394335;3187234;2204;0;3354910;0;0;0;0
FR;3;2021-07-21;1652;19473;44;0;19978;0;0;0;0;4395987;3206707;2248;0;3374888;0;0;0;0
FR;3;2021-07-22;1856;27648;83;0;28213;0;0;0;0;4397843;3234355;2331;0;3403101;0;0;0;0
FR;3;2021-07-23;2217;30212;117;0;30949;0;0;0;0;4400060;3264567;2448;0;3434050;0;0;0;0
FR;3;2021-07-24;828;6926;25;0;7149;0;0;0;0;4400888;3271493;2473;0;3441199;0;0;0;0
FR;3;2021-07-25;210;1287;1;0;1342;0;0;0;0;4401098;3272780;2474;0;3442541;0;0;0;0
FR;3;2021-07-26;933;10509;28;0;10817;0;0;0;0;4402031;3283289;2502;0;3453358;0;0;0;0
FR;3;2021-07-27;1171;16802;56;0;17165;0;0;0;0;4403202;3300091;2558;0;3470523;0;0;0;0
FR;3;2021-07-28;989;11999;40;0;12311;0;0;0;0;4404191;3312090;2598;0;3482834;0;0;0;0
FR;3;2021-07-29;1127;15676;63;0;16089;0;0;0;0;4405318;3327766;2661;0;3498923;0;0;0;0
FR;3;2021-07-30;1130;17991;79;0;18366;0;0;0;0;4406448;3345757;2740;0;3517289;0;0;0;0
FR;3;2021-07-31;407;3711;15;0;3837;0;0;0;0;4406855;3349468;2755;0;3521126;0;0;0;0
FR;3;2021-08-01;117;443;1;0;465;0;0;0;0;4406972;3349911;2756;0;3521591;0;0;0;0
FR;3;2021-08-02;424;5016;22;0;5136;0;0;0;0;4407396;3354927;2778;0;3526727;0;0;0;0
FR;3;2021-08-03;498;7466;27;0;7599;0;0;0;0;4407894;3362393;2805;0;3534326;0;0;0;0
FR;3;2021-08-04;441;4831;26;0;4977;0;0;0;0;4408335;3367224;2831;0;3539303;0;0;0;0
FR;3;2021-08-05;433;3653;13;0;3763;0;0;0;0;4408768;3370877;2844;0;3543066;0;0;0;0
FR;3;2021-08-06;456;4699;30;0;4800;0;0;0;0;4409224;3375576;2874;0;3547866;0;0;0;0
FR;3;2021-08-07;214;1900;11;0;1946;0;0;0;0;4409438;3377476;2885;0;3549812;0;0;0;0
FR;3;2021-08-08;251;424;2;0;457;0;0;0;0;4409689;3377900;2887;0;3550269;0;0;0;0
FR;3;2021-08-09;320;2377;11;0;2447;0;0;0;0;4410009;3380277;2898;0;3552716;0;0;0;0
FR;3;2021-08-10;369;3735;15;0;3823;0;0;0;0;4410378;3384012;2913;0;3556539;0;0;0;0
FR;3;2021-08-11;291;2639;15;0;2699;0;0;0;0;4410669;3386651;2928;0;3559238;0;0;0;0
FR;3;2021-08-12;279;2563;13;0;2651;0;0;0;0;4410948;3389214;2941;0;3561889;0;0;0;0
FR;3;2021-08-13;279;2255;16;0;2341;0;0;0;0;4411227;3391469;2957;0;3564230;0;0;0;0
FR;3;2021-08-14;172;874;1;0;905;0;0;0;0;4411399;3392343;2958;0;3565135;0;0;0;0
FR;3;2021-08-15;56;174;0;0;183;0;0;0;0;4411455;3392517;2958;0;3565318;0;0;0;0
FR;3;2021-08-16;126;1002;8;0;1041;0;0;0;0;4411581;3393519;2966;0;3566359;0;0;0;0
FR;3;2021-08-17;191;1430;8;0;1471;0;0;0;0;4411772;3394949;2974;0;3567830;0;0;0;0
FR;3;2021-08-18;205;1309;10;0;1351;0;0;0;0;4411977;3396258;2984;0;3569181;0;0;0;0
FR;3;2021-08-19;165;1373;10;0;1420;0;0;0;0;4412142;3397631;2994;0;3570601;0;0;0;0
FR;3;2021-08-20;167;1595;16;0;1657;0;0;0;0;4412309;3399226;3010;0;3572258;0;0;0;0
FR;3;2021-08-21;94;576;2;0;591;0;0;0;0;4412403;3399802;3012;0;3572849;0;0;0;0
FR;3;2021-08-22;42;192;1;0;195;0;0;0;0;4412445;3399994;3013;0;3573044;0;0;0;0
FR;3;2021-08-23;141;886;7;0;931;0;0;0;0;4412586;3400880;3020;0;3573975;0;0;0;0
FR;3;2021-08-24;125;922;10;0;954;0;0;0;0;4412711;3401802;3030;0;3574929;0;0;0;0
FR;3;2021-08-25;137;821;3;0;850;0;0;0;0;4412848;3402623;3033;0;3575779;0;0;0;0
FR;3;2021-08-26;172;823;9;0;871;0;0;0;0;4413020;3403446;3042;0;3576650;0;0;0;0
FR;3;2021-08-27;178;937;9;0;989;0;0;0;0;4413198;3404383;3051;0;3577639;0;0;0;0
FR;3;2021-08-28;101;373;4;0;390;0;0;0;0;4413299;3404756;3055;0;3578029;0;0;0;0
FR;3;2021-08-29;128;129;1;0;162;0;0;0;0;4413427;3404885;3056;0;3578191;0;0;0;0
FR;3;2021-08-30;100;560;0;0;469;108;0;0;0;4413527;3405445;3056;0;3578660;108;0;0;0
FR;3;2021-08-31;134;682;7;0;587;134;0;0;0;4413661;3406127;3063;0;3579247;242;0;0;0
FR;3;2021-09-01;122;461;5;0;383;106;0;0;0;4413783;3406588;3068;0;3579630;348;0;0;0
FR;3;2021-09-02;100;595;22;0;531;105;0;0;0;4413883;3407183;3090;0;3580161;453;0;0;0
FR;3;2021-09-03;116;552;17;0;477;116;0;0;0;4413999;3407735;3107;0;3580638;569;0;0;0
FR;3;2021-09-04;55;295;3;0;256;50;0;0;0;4414054;3408030;3110;0;3580894;619;0;0;0
FR;3;2021-09-05;52;65;5;0;55;25;0;0;0;4414106;3408095;3115;0;3580949;644;0;0;0
FR;3;2021-09-06;118;367;4;0;261;130;0;0;0;4414224;3408462;3119;0;3581210;774;0;0;0
FR;3;2021-09-07;125;431;14;0;347;116;0;0;0;4414349;3408893;3133;0;3581557;890;0;0;0
FR;3;2021-09-08;122;344;2;0;274;87;0;0;0;4414471;3409237;3135;0;3581831;977;0;0;0
FR;3;2021-09-09;94;379;8;0;299;103;0;0;0;4414565;3409616;3143;0;3582130;1080;0;0;0
FR;3;2021-09-10;101;402;3;0;332;93;0;0;0;4414666;3410018;3146;0;3582462;1173;0;0;0
FR;3;2021-09-11;79;233;4;0;178;65;0;0;0;4414745;3410251;3150;0;3582640;1238;0;0;0
FR;3;2021-09-12;37;49;1;0;38;16;0;0;0;4414782;3410300;3151;0;3582678;1254;0;0;0
FR;3;2021-09-13;78;297;7;0;214;102;1;0;0;4414860;3410597;3158;0;3582892;1356;1;0;0
FR;3;2021-09-14;75;271;6;0;191;94;0;0;0;4414935;3410868;3164;0;3583083;1450;1;0;0
FR;3;2021-09-15;64;252;3;0;257;6;0;0;0;4414999;3411120;3167;0;3583340;1456;1;0;0
FR;3;2021-09-16;65;320;6;0;331;6;0;0;0;4415064;3411440;3173;0;3583671;1462;1;0;0
FR;3;2021-09-17;52;327;3;0;339;6;0;0;0;4415116;3411767;3176;0;3584010;1468;1;0;0
FR;3;2021-09-18;37;172;1;0;176;1;0;0;0;4415153;3411939;3177;0;3584186;1469;1;0;0
FR;3;2021-09-19;29;31;2;0;34;1;0;0;0;4415182;3411970;3179;0;3584220;1470;1;0;0
FR;3;2021-09-20;82;188;0;0;196;1;0;0;0;4415264;3412158;3179;0;3584416;1471;1;0;0
FR;3;2021-09-21;60;273;7;0;277;8;0;0;0;4415324;3412431;3186;0;3584693;1479;1;0;0
FR;3;2021-09-22;67;229;6;0;242;7;0;0;0;4415391;3412660;3192;0;3584935;1486;1;0;0
FR;3;2021-09-23;37;257;11;0;261;7;0;0;0;4415428;3412917;3203;0;3585196;1493;1;0;0
FR;3;2021-09-24;29;315;12;0;313;18;0;0;0;4415457;3413232;3215;0;3585509;1511;1;0;0
FR;3;2021-09-25;31;144;3;0;150;3;0;0;0;4415488;3413376;3218;0;3585659;1514;1;0;0
FR;3;2021-09-26;16;57;1;0;59;1;0;0;0;4415504;3413433;3219;0;3585718;1515;1;0;0
FR;3;2021-09-27;49;282;3;0;285;5;0;0;0;4415553;3413715;3222;0;3586003;1520;1;0;0
FR;3;2021-09-28;49;245;6;0;253;8;0;0;0;4415602;3413960;3228;0;3586256;1528;1;0;0
FR;3;2021-09-29;40;218;10;0;222;15;0;0;0;4415642;3414178;3238;0;3586478;1543;1;0;0
FR;3;2021-09-30;40;200;8;0;204;11;0;0;0;4415682;3414378;3246;0;3586682;1554;1;0;0
FR;3;2021-10-01;23;159;6;0;161;8;0;0;0;4415705;3414537;3252;0;3586843;1562;1;0;0
FR;3;2021-10-02;17;88;0;0;89;0;0;0;0;4415722;3414625;3252;0;3586932;1562;1;0;0
FR;3;2021-10-03;19;19;1;0;19;2;0;0;0;4415741;3414644;3253;0;3586951;1564;1;0;0
FR;3;2021-10-04;33;157;4;0;162;4;0;0;0;4415774;3414801;3257;0;3587113;1568;1;0;0
FR;3;2021-10-05;17;148;10;0;153;12;0;0;0;4415791;3414949;3267;0;3587266;1580;1;0;0
FR;3;2021-10-06;34;145;9;0;153;10;0;0;0;4415825;3415094;3276;0;3587419;1590;1;0;0
FR;3;2021-10-07;20;132;6;0;130;6;0;0;0;4415845;3415226;3282;0;3587549;1596;1;0;0
FR;3;2021-10-08;25;136;10;0;141;9;0;0;0;4415870;3415362;3292;0;3587690;1605;1;0;0
FR;3;2021-10-09;17;72;1;0;73;1;0;0;0;4415887;3415434;3293;0;3587763;1606;1;0;0
FR;3;2021-10-10;13;17;2;0;16;3;0;0;0;4415900;3415451;3295;0;3587779;1609;1;0;0
FR;3;2021-10-11;17;117;4;0;122;5;0;0;0;4415917;3415568;3299;0;3587901;1614;1;0;0
FR;3;2021-10-12;22;99;6;0;99;6;0;0;0;4415939;3415667;3305;0;3588000;1620;1;0;0
FR;3;2021-10-13;25;114;9;0;121;7;0;0;0;4415964;3415781;3314;0;3588121;1627;1;0;0
FR;3;2021-10-14;19;138;3;0;139;4;0;0;0;4415983;3415919;3317;0;3588260;1631;1;0;0
FR;3;2021-10-15;24;139;8;0;138;13;0;0;0;4416007;3416058;3325;0;3588398;1644;1;0;0
FR;3;2021-10-16;13;66;6;0;65;8;0;0;0;4416020;3416124;3331;0;3588463;1652;1;0;0
FR;3;2021-10-17;13;24;0;0;26;0;0;0;0;4416033;3416148;3331;0;3588489;1652;1;0;0
FR;3;2021-10-18;18;112;2;0;117;2;0;0;0;4416051;3416260;3333;0;3588606;1654;1;0;0
FR;3;2021-10-19;18;112;19;0;113;21;0;0;0;4416069;3416372;3352;0;3588719;1675;1;0;0
FR;3;2021-10-20;27;124;6;0;126;7;0;0;0;4416096;3416496;3358;0;3588845;1682;1;0;0
FR;3;2021-10-21;28;120;17;0;120;13;0;0;0;4416124;3416616;3375;0;3588965;1695;1;0;0
FR;3;2021-10-22;25;103;18;0;102;21;0;0;0;4416149;3416719;3393;0;3589067;1716;1;0;0
FR;3;2021-10-23;17;53;3;0;53;2;0;0;0;4416166;3416772;3396;0;3589120;1718;1;0;0
FR;3;2021-10-24;7;36;0;0;34;0;0;0;0;4416173;3416808;3396;0;3589154;1718;1;0;0
FR;3;2021-10-25;27;141;7;0;145;7;0;0;0;4416200;3416949;3403;0;3589299;1725;1;0;0
FR;3;2021-10-26;25;96;22;0;93;19;0;0;0;4416225;3417045;3425;0;3589392;1744;1;0;0
FR;3;2021-10-27;19;91;9;0;93;9;0;0;0;4416244;3417136;3434;0;3589485;1753;1;0;0
FR;3;2021-10-28;23;114;33;0;111;36;0;0;0;4416267;3417250;3467;0;3589596;1789;1;0;0
FR;3;2021-10-29;12;98;64;0;92;54;0;0;0;4416279;3417348;3531;0;3589688;1843;1;0;0
FR;3;2021-10-30;11;62;11;1;62;10;0;0;0;4416290;3417410;3542;1;3589750;1853;1;0;0
FR;3;2021-10-31;8;25;1;0;25;1;0;0;0;4416298;3417435;3543;1;3589775;1854;1;0;0
FR;3;2021-11-01;11;22;2;0;23;1;0;0;0;4416309;3417457;3545;1;3589798;1855;1;0;0
FR;3;2021-11-02;11;100;10;0;100;12;0;0;0;4416320;3417557;3555;1;3589898;1867;1;0;0
FR;3;2021-11-03;22;105;10;0;113;10;0;0;0;4416342;3417662;3565;1;3590011;1877;1;0;0
FR;3;2021-11-04;20;88;6;0;93;5;0;0;0;4416362;3417750;3571;1;3590104;1882;1;0;0
FR;3;2021-11-05;19;119;9;1;125;6;1;0;0;4416381;3417869;3580;2;3590229;1888;2;0;0
FR;3;2021-11-06;11;54;3;0;56;3;0;0;0;4416392;3417923;3583;2;3590285;1891;2;0;0
FR;3;2021-11-07;6;23;1;0;24;1;0;0;0;4416398;3417946;3584;2;3590309;1892;2;0;0
FR;3;2021-11-08;12;124;7;0;129;5;0;0;0;4416410;3418070;3591;2;3590438;1897;2;0;0
FR;3;2021-11-09;15;123;6;0;125;6;0;0;0;4416425;3418193;3597;2;3590563;1903;2;0;0
FR;3;2021-11-10;15;130;15;0;128;16;0;0;0;4416440;3418323;3612;2;3590691;1919;2;0;0
FR;3;2021-11-11;12;49;3;0;51;3;0;0;0;4416452;3418372;3615;2;3590742;1922;2;0;0
FR;3;2021-11-12;15;126;6;0;128;5;0;0;0;4416467;3418498;3621;2;3590870;1927;2;0;0
FR;3;2021-11-13;7;66;9;0;61;10;0;0;0;4416474;3418564;3630;2;3590931;1937;2;0;0
FR;3;2021-11-14;3;24;1;0;24;1;0;0;0;4416477;3418588;3631;2;3590955;1938;2;0;0
FR;3;2021-11-15;7;161;11;0;158;12;0;0;0;4416484;3418749;3642;2;3591113;1950;2;0;0
FR;3;2021-11-16;9;125;11;0;120;10;0;0;0;4416493;3418874;3653;2;3591233;1960;2;0;0
FR;3;2021-11-17;8;134;11;0;135;8;0;0;0;4416501;3419008;3664;2;3591368;1968;2;0;0
FR;3;2021-11-18;16;131;10;0;132;11;0;0;0;4416517;3419139;3674;2;3591500;1979;2;0;0
FR;3;2021-11-19;12;178;23;0;173;28;0;0;0;4416529;3419317;3697;2;3591673;2007;2;0;0
FR;3;2021-11-20;6;101;6;0;102;6;0;0;0;4416535;3419418;3703;2;3591775;2013;2;0;0
FR;3;2021-11-21;3;24;4;0;23;4;0;0;0;4416538;3419442;3707;2;3591798;2017;2;0;0
FR;3;2021-11-22;11;185;11;0;185;11;0;0;0;4416549;3419627;3718;2;3591983;2028;2;0;0
FR;3;2021-11-23;10;180;16;0;178;15;0;0;0;4416559;3419807;3734;2;3592161;2043;2;0;0
FR;3;2021-11-24;11;180;9;0;172;17;0;0;0;4416570;3419987;3743;2;3592333;2060;2;0;0
FR;3;2021-11-25;12;197;11;0;196;11;0;0;0;4416582;3420184;3754;2;3592529;2071;2;0;0
FR;3;2021-11-26;10;251;35;0;250;33;1;0;0;4416592;3420435;3789;2;3592779;2104;3;0;0
FR;3;2021-11-27;8;122;20;0;122;21;0;0;0;4416600;3420557;3809;2;3592901;2125;3;0;0
FR;3;2021-11-28;3;56;7;0;57;7;0;0;0;4416603;3420613;3816;2;3592958;2132;3;0;0
FR;3;2021-11-29;5;214;22;0;209;23;1;0;0;4416608;3420827;3838;2;3593167;2155;4;0;0
FR;3;2021-11-30;9;281;31;0;280;33;1;0;0;4416617;3421108;3869;2;3593447;2188;5;0;0
FR;3;2021-12-01;30;315;39;0;313;41;2;0;0;4416647;3421423;3908;2;3593760;2229;7;0;0
FR;3;2021-12-02;9;337;33;0;333;36;0;0;0;4416656;3421760;3941;2;3594093;2265;7;0;0
FR;3;2021-12-03;6;364;37;0;360;38;0;0;0;4416662;3422124;3978;2;3594453;2303;7;0;0
FR;3;2021-12-04;3;201;26;0;197;28;0;0;0;4416665;3422325;4004;2;3594650;2331;7;0;0
FR;3;2021-12-05;1;61;5;0;61;5;0;0;0;4416666;3422386;4009;2;3594711;2336;7;0;0
FR;3;2021-12-06;7;347;14;0;346;15;0;0;0;4416673;3422733;4023;2;3595057;2351;7;0;0
FR;3;2021-12-07;6;410;20;0;404;24;1;0;0;4416679;3423143;4043;2;3595461;2375;8;0;0
FR;3;2021-12-08;8;374;29;0;366;30;1;0;0;4416687;3423517;4072;2;3595827;2405;9;0;0
FR;3;2021-12-09;3;423;17;0;410;22;1;0;0;4416690;3423940;4089;2;3596237;2427;10;0;0
FR;3;2021-12-10;10;443;29;0;440;25;0;0;0;4416700;3424383;4118;2;3596677;2452;10;0;0
FR;3;2021-12-11;4;299;10;0;296;9;2;0;0;4416704;3424682;4128;2;3596973;2461;12;0;0
FR;3;2021-12-12;1;96;3;0;96;3;0;0;0;4416705;3424778;4131;2;3597069;2464;12;0;0
FR;3;2021-12-13;2;432;19;0;426;21;0;0;0;4416707;3425210;4150;2;3597495;2485;12;0;0
FR;3;2021-12-14;8;550;18;0;538;21;1;0;0;4416715;3425760;4168;2;3598033;2506;13;0;0
FR;3;2021-12-15;10;521;17;0;508;21;0;0;0;4416725;3426281;4185;2;3598541;2527;13;0;0
FR;3;2021-12-16;10;525;19;0;519;18;3;0;0;4416735;3426806;4204;2;3599060;2545;16;0;0
FR;3;2021-12-17;5;592;18;0;588;19;0;0;0;4416740;3427398;4222;2;3599648;2564;16;0;0
FR;3;2021-12-18;5;343;4;0;337;5;1;0;0;4416745;3427741;4226;2;3599985;2569;17;0;0
FR;3;2021-12-19;3;176;2;0;174;2;0;0;0;4416748;3427917;4228;2;3600159;2571;17;0;0
FR;3;2021-12-20;10;566;23;0;560;28;0;0;0;4416758;3428483;4251;2;3600719;2599;17;0;0
FR;3;2021-12-21;5;660;10;0;652;13;2;0;0;4416763;3429143;4261;2;3601371;2612;19;0;0
FR;3;2021-12-22;10;612;9;0;606;10;1;0;0;4416773;3429755;4270;2;3601977;2622;20;0;0
FR;3;2021-12-23;4;534;8;0;532;8;0;0;0;4416777;3430289;4278;2;3602509;2630;20;0;0
FR;3;2021-12-24;2;233;3;0;228;6;0;0;0;4416779;3430522;4281;2;3602737;2636;20;0;0
FR;3;2021-12-25;0;24;0;0;24;0;0;0;0;4416779;3430546;4281;2;3602761;2636;20;0;0
FR;3;2021-12-26;0;87;1;0;87;1;0;0;0;4416779;3430633;4282;2;3602848;2637;20;0;0
FR;3;2021-12-27;7;456;17;0;453;20;1;0;0;4416786;3431089;4299;2;3603301;2657;21;0;0
FR;3;2021-12-28;3;570;6;0;569;5;0;0;0;4416789;3431659;4305;2;3603870;2662;21;0;0
FR;3;2021-12-29;5;487;14;0;482;16;0;0;0;4416794;3432146;4319;2;3604352;2678;21;0;0
FR;3;2021-12-30;3;517;7;0;510;10;2;0;0;4416797;3432663;4326;2;3604862;2688;23;0;0
FR;3;2021-12-31;0;182;5;0;178;7;0;0;0;4416797;3432845;4331;2;3605040;2695;23;0;0
FR;3;2022-01-01;0;26;0;0;24;2;0;0;0;4416797;3432871;4331;2;3605064;2697;23;0;0
FR;3;2022-01-02;0;76;0;0;76;0;0;0;0;4416797;3432947;4331;2;3605140;2697;23;0;0
FR;3;2022-01-03;5;489;17;0;479;21;3;0;0;4416802;3433436;4348;2;3605619;2718;26;0;0
FR;3;2022-01-04;7;533;9;0;532;8;0;0;0;4416809;3433969;4357;2;3606151;2726;26;0;0
FR;3;2022-01-05;5;487;10;0;479;14;1;0;0;4416814;3434456;4367;2;3606630;2740;27;0;0
FR;3;2022-01-06;6;464;9;0;459;10;1;0;0;4416820;3434920;4376;2;3607089;2750;28;0;0
FR;3;2022-01-07;2;489;11;0;483;13;1;0;1;4416822;3435409;4387;2;3607572;2763;29;0;1
FR;3;2022-01-08;6;250;4;0;247;5;0;0;0;4416828;3435659;4391;2;3607819;2768;29;0;1
FR;3;2022-01-09;0;116;0;0;116;0;0;0;0;4416828;3435775;4391;2;3607935;2768;29;0;1
FR;3;2022-01-10;2;420;12;0;418;12;0;0;0;4416830;3436195;4403;2;3608353;2780;29;0;1
FR;3;2022-01-11;3;455;1;0;454;1;0;0;0;4416833;3436650;4404;2;3608807;2781;29;0;1
FR;3;2022-01-12;4;393;9;0;390;10;2;0;0;4416837;3437043;4413;2;3609197;2791;31;0;1
FR;3;2022-01-13;3;381;11;0;379;12;1;0;0;4416840;3437424;4424;2;3609576;2803;32;0;1
FR;3;2022-01-14;4;419;10;0;413;13;1;0;0;4416844;3437843;4434;2;3609989;2816;33;0;1
FR;3;2022-01-15;0;275;2;0;271;3;0;0;0;4416844;3438118;4436;2;3610260;2819;33;0;1
FR;3;2022-01-16;1;108;1;0;106;1;1;0;0;4416845;3438226;4437;2;3610366;2820;34;0;1
FR;3;2022-01-17;2;318;8;0;315;9;1;0;0;4416847;3438544;4445;2;3610681;2829;35;0;1
FR;3;2022-01-18;2;358;1;0;354;2;1;0;0;4416849;3438902;4446;2;3611035;2831;36;0;1
FR;3;2022-01-19;2;322;5;0;316;10;0;0;0;4416851;3439224;4451;2;3611351;2841;36;0;1
FR;3;2022-01-20;1;351;5;0;350;3;2;0;0;4416852;3439575;4456;2;3611701;2844;38;0;1
FR;3;2022-01-21;4;337;5;0;331;7;2;0;0;4416856;3439912;4461;2;3612032;2851;40;0;1
FR;3;2022-01-22;2;218;1;0;214;2;3;0;0;4416858;3440130;4462;2;3612246;2853;43;0;1
FR;3;2022-01-23;0;77;0;0;75;1;1;0;0;4416858;3440207;4462;2;3612321;2854;44;0;1
FR;3;2022-01-24;3;316;1;0;308;6;2;0;0;4416861;3440523;4463;2;3612629;2860;46;0;1
FR;3;2022-01-25;0;171;0;0;168;0;1;0;0;4416861;3440694;4463;2;3612797;2860;47;0;1
FR;3;2022-01-26;0;77;0;0;77;0;0;0;0;4416861;3440771;4463;2;3612874;2860;47;0;1
FR;3;2022-01-27;0;52;0;0;52;0;0;0;0;4416861;3440823;4463;2;3612926;2860;47;0;1
FR;3;2022-01-28;0;115;0;0;114;0;0;0;0;4416861;3440938;4463;2;3613040;2860;47;0;1
FR;3;2022-01-29;0;97;0;0;97;0;0;0;0;4416861;3441035;4463;2;3613137;2860;47;0;1
FR;3;2022-01-30;0;50;0;0;50;0;0;0;0;4416861;3441085;4463;2;3613187;2860;47;0;1
FR;3;2022-01-31;0;90;0;0;90;0;0;0;0;4416861;3441175;4463;2;3613277;2860;47;0;1
FR;3;2022-02-01;0;98;0;0;96;1;0;0;0;4416861;3441273;4463;2;3613373;2861;47;0;1
FR;3;2022-02-02;0;85;0;0;83;0;0;0;0;4416861;3441358;4463;2;3613456;2861;47;0;1
FR;3;2022-02-03;0;91;0;0;89;0;0;0;0;4416861;3441449;4463;2;3613545;2861;47;0;1
FR;3;2022-02-04;0;113;0;0;110;0;1;0;0;4416861;3441562;4463;2;3613655;2861;48;0;1
FR;3;2022-02-05;0;68;0;0;68;0;0;0;0;4416861;3441630;4463;2;3613723;2861;48;0;1
FR;3;2022-02-06;0;10;0;0;10;0;0;0;0;4416861;3441640;4463;2;3613733;2861;48;0;1
FR;3;2022-02-07;0;75;0;0;75;0;0;0;0;4416861;3441715;4463;2;3613808;2861;48;0;1
FR;3;2022-02-08;0;0;0;0;0;0;0;0;0;4416861;3441715;4463;2;3613808;2861;48;0;1
FR;3;2022-02-09;0;0;0;0;0;0;0;0;0;4416861;3441715;4463;2;3613808;2861;48;0;1
FR;3;2022-02-10;0;0;0;0;0;0;0;0;0;4416861;3441715;4463;2;3613808;2861;48;0;1
FR;3;2022-02-11;0;0;0;0;0;0;0;0;0;4416861;3441715;4463;2;3613808;2861;48;0;1
FR;3;2022-02-12;0;0;0;0;0;0;0;0;0;4416861;3441715;4463;2;3613808;2861;48;0;1
FR;3;2022-02-13;0;0;0;0;0;0;0;0;0;4416861;3441715;4463;2;3613808;2861;48;0;1
FR;3;2022-02-14;0;0;0;0;0;0;0;0;0;4416861;3441715;4463;2;3613808;2861;48;0;1
FR;3;2022-02-15;0;0;0;0;0;0;0;0;0;4416861;3441715;4463;2;3613808;2861;48;0;1
FR;3;2022-02-16;0;0;0;0;0;0;0;0;0;4416861;3441715;4463;2;3613808;2861;48;0;1
FR;3;2022-02-17;0;0;0;0;0;0;0;0;0;4416861;3441715;4463;2;3613808;2861;48;0;1
FR;3;2022-02-18;0;0;0;0;0;0;0;0;0;4416861;3441715;4463;2;3613808;2861;48;0;1
FR;3;2022-02-19;0;0;0;0;0;0;0;0;0;4416861;3441715;4463;2;3613808;2861;48;0;1
FR;3;2022-02-20;0;0;0;0;0;0;0;0;0;4416861;3441715;4463;2;3613808;2861;48;0;1
FR;3;2022-02-21;2;0;0;0;0;0;0;0;0;4416863;3441715;4463;2;3613808;2861;48;0;1
FR;3;2022-02-22;0;0;0;0;0;0;0;0;0;4416863;3441715;4463;2;3613808;2861;48;0;1
FR;3;2022-02-23;0;0;0;0;0;0;0;0;0;4416863;3441715;4463;2;3613808;2861;48;0;1
FR;3;2022-02-24;0;0;0;0;0;0;0;0;0;4416863;3441715;4463;2;3613808;2861;48;0;1
FR;3;2022-02-25;0;0;0;0;0;0;0;0;0;4416863;3441715;4463;2;3613808;2861;48;0;1
FR;3;2022-02-26;0;0;0;0;0;0;0;0;0;4416863;3441715;4463;2;3613808;2861;48;0;1
FR;3;2022-02-27;0;0;0;0;0;0;0;0;0;4416863;3441715;4463;2;3613808;2861;48;0;1
FR;3;2022-02-28;1;0;0;0;0;0;0;0;0;4416864;3441715;4463;2;3613808;2861;48;0;1
FR;3;2022-03-01;1;0;0;0;0;0;0;0;0;4416865;3441715;4463;2;3613808;2861;48;0;1
FR;3;2022-03-02;0;0;0;0;0;0;0;0;0;4416865;3441715;4463;2;3613808;2861;48;0;1
FR;3;2022-03-03;0;0;0;0;0;0;0;0;0;4416865;3441715;4463;2;3613808;2861;48;0;1
FR;3;2022-03-04;0;0;0;0;0;0;0;0;0;4416865;3441715;4463;2;3613808;2861;48;0;1
FR;3;2022-03-05;0;0;0;0;0;0;0;0;0;4416865;3441715;4463;2;3613808;2861;48;0;1
FR;3;2022-03-06;1;0;0;0;0;0;0;0;0;4416866;3441715;4463;2;3613808;2861;48;0;1
FR;3;2022-03-07;0;0;0;0;0;0;0;0;0;4416866;3441715;4463;2;3613808;2861;48;0;1
FR;3;2022-03-08;1;0;0;0;0;0;0;0;0;4416867;3441715;4463;2;3613808;2861;48;0;1
FR;3;2022-03-09;0;0;0;0;0;0;0;0;0;4416867;3441715;4463;2;3613808;2861;48;0;1
FR;3;2022-03-10;0;0;0;0;0;0;0;0;0;4416867;3441715;4463;2;3613808;2861;48;0;1
FR;3;2022-03-11;0;0;0;0;0;0;0;0;0;4416867;3441715;4463;2;3613808;2861;48;0;1
FR;3;2022-03-12;0;0;0;0;0;0;0;0;0;4416867;3441715;4463;2;3613808;2861;48;0;1
FR;3;2022-03-13;0;0;0;0;0;0;0;0;0;4416867;3441715;4463;2;3613808;2861;48;0;1
FR;3;2022-03-14;0;0;0;0;0;0;0;0;0;4416867;3441715;4463;2;3613808;2861;48;0;1
FR;3;2022-03-15;0;0;0;0;0;0;0;0;0;4416867;3441715;4463;2;3613808;2861;48;0;1
FR;3;2022-03-16;0;0;0;0;0;0;0;0;0;4416867;3441715;4463;2;3613808;2861;48;0;1
FR;3;2022-03-17;0;0;0;0;0;0;0;0;0;4416867;3441715;4463;2;3613808;2861;48;0;1
FR;3;2022-03-18;0;0;0;0;0;0;0;0;0;4416867;3441715;4463;2;3613808;2861;48;0;1
FR;3;2022-03-19;0;0;0;0;0;0;0;0;0;4416867;3441715;4463;2;3613808;2861;48;0;1
FR;3;2022-03-20;1;0;0;0;0;0;0;0;0;4416868;3441715;4463;2;3613808;2861;48;0;1
FR;3;2022-03-21;0;0;0;0;0;0;0;0;0;4416868;3441715;4463;2;3613808;2861;48;0;1
FR;3;2022-03-22;0;0;0;0;0;0;0;0;0;4416868;3441715;4463;2;3613808;2861;48;0;1
FR;3;2022-03-23;1;0;0;0;0;0;0;0;0;4416869;3441715;4463;2;3613808;2861;48;0;1
FR;3;2022-03-24;0;0;0;0;0;0;0;0;0;4416869;3441715;4463;2;3613808;2861;48;0;1
FR;3;2022-03-25;1;0;0;0;0;0;0;0;0;4416870;3441715;4463;2;3613808;2861;48;0;1
FR;3;2022-03-26;0;0;0;0;0;0;0;0;0;4416870;3441715;4463;2;3613808;2861;48;0;1
FR;3;2022-03-27;0;0;0;0;0;0;0;0;0;4416870;3441715;4463;2;3613808;2861;48;0;1
FR;3;2022-03-28;0;0;0;0;0;0;0;0;0;4416870;3441715;4463;2;3613808;2861;48;0;1
FR;3;2022-03-29;0;0;0;0;0;0;0;0;0;4416870;3441715;4463;2;3613808;2861;48;0;1
FR;3;2022-03-30;0;0;0;0;0;0;0;0;0;4416870;3441715;4463;2;3613808;2861;48;0;1
FR;3;2022-03-31;0;0;0;0;0;0;0;0;0;4416870;3441715;4463;2;3613808;2861;48;0;1
FR;3;2022-04-01;0;0;0;0;0;0;0;0;0;4416870;3441715;4463;2;3613808;2861;48;0;1
FR;3;2022-04-02;0;0;0;0;0;0;0;0;0;4416870;3441715;4463;2;3613808;2861;48;0;1
FR;3;2022-04-03;0;0;0;0;0;0;0;0;0;4416870;3441715;4463;2;3613808;2861;48;0;1
FR;3;2022-04-04;0;0;0;0;0;0;0;0;0;4416870;3441715;4463;2;3613808;2861;48;0;1
FR;3;2022-04-05;0;0;0;0;0;0;0;0;0;4416870;3441715;4463;2;3613808;2861;48;0;1
FR;3;2022-04-06;0;0;0;0;0;0;0;0;0;4416870;3441715;4463;2;3613808;2861;48;0;1
FR;3;2022-04-07;0;0;0;0;0;0;0;0;0;4416870;3441715;4463;2;3613808;2861;48;0;1
FR;3;2022-04-08;0;0;0;0;0;0;0;0;0;4416870;3441715;4463;2;3613808;2861;48;0;1
FR;3;2022-04-09;0;0;0;0;0;0;0;0;0;4416870;3441715;4463;2;3613808;2861;48;0;1
FR;3;2022-04-10;0;0;0;0;0;0;0;0;0;4416870;3441715;4463;2;3613808;2861;48;0;1
FR;3;2022-04-11;0;0;0;0;0;0;0;0;0;4416870;3441715;4463;2;3613808;2861;48;0;1
FR;3;2022-04-12;0;0;0;0;0;0;0;0;0;4416870;3441715;4463;2;3613808;2861;48;0;1
FR;3;2022-04-13;0;0;0;0;0;0;0;0;0;4416870;3441715;4463;2;3613808;2861;48;0;1
FR;3;2022-04-14;0;0;0;0;0;0;0;0;0;4416870;3441715;4463;2;3613808;2861;48;0;1
FR;3;2022-04-15;1;0;0;0;0;0;0;0;0;4416871;3441715;4463;2;3613808;2861;48;0;1
FR;3;2022-04-16;0;0;0;0;0;0;0;0;0;4416871;3441715;4463;2;3613808;2861;48;0;1
FR;3;2022-04-17;0;0;0;0;0;0;0;0;0;4416871;3441715;4463;2;3613808;2861;48;0;1
FR;3;2022-04-18;0;0;0;0;0;0;0;0;0;4416871;3441715;4463;2;3613808;2861;48;0;1
FR;3;2022-04-19;0;0;0;0;0;0;0;0;0;4416871;3441715;4463;2;3613808;2861;48;0;1
FR;3;2022-04-20;0;0;0;0;0;0;0;0;0;4416871;3441715;4463;2;3613808;2861;48;0;1
FR;3;2022-04-21;0;0;0;0;0;0;0;0;0;4416871;3441715;4463;2;3613808;2861;48;0;1
FR;3;2022-04-22;0;0;0;0;0;0;0;0;0;4416871;3441715;4463;2;3613808;2861;48;0;1
FR;3;2022-04-23;0;0;0;0;0;0;0;0;0;4416871;3441715;4463;2;3613808;2861;48;0;1
FR;3;2022-04-24;0;0;0;0;0;0;0;0;0;4416871;3441715;4463;2;3613808;2861;48;0;1
FR;3;2022-04-25;0;0;0;0;0;0;0;0;0;4416871;3441715;4463;2;3613808;2861;48;0;1
FR;3;2022-04-26;0;0;0;0;0;0;0;0;0;4416871;3441715;4463;2;3613808;2861;48;0;1
FR;3;2022-04-27;0;0;0;0;0;0;0;0;0;4416871;3441715;4463;2;3613808;2861;48;0;1
FR;3;2022-04-28;0;0;0;0;0;0;0;0;0;4416871;3441715;4463;2;3613808;2861;48;0;1
FR;3;2022-04-29;0;0;0;0;0;0;0;0;0;4416871;3441715;4463;2;3613808;2861;48;0;1
FR;3;2022-04-30;0;0;0;0;0;0;0;0;0;4416871;3441715;4463;2;3613808;2861;48;0;1
FR;3;2022-05-01;0;0;0;0;0;0;0;0;0;4416871;3441715;4463;2;3613808;2861;48;0;1
FR;3;2022-05-02;0;0;0;0;0;0;0;0;0;4416871;3441715;4463;2;3613808;2861;48;0;1
FR;3;2022-05-03;0;0;0;0;0;0;0;0;0;4416871;3441715;4463;2;3613808;2861;48;0;1
FR;3;2022-05-04;0;0;0;0;0;0;0;0;0;4416871;3441715;4463;2;3613808;2861;48;0;1
FR;3;2022-05-05;0;0;0;0;0;0;0;0;0;4416871;3441715;4463;2;3613808;2861;48;0;1
FR;3;2022-05-06;0;0;0;0;0;0;0;0;0;4416871;3441715;4463;2;3613808;2861;48;0;1
FR;3;2022-05-07;0;0;0;0;0;0;0;0;0;4416871;3441715;4463;2;3613808;2861;48;0;1
FR;3;2022-05-08;0;0;0;0;0;0;0;0;0;4416871;3441715;4463;2;3613808;2861;48;0;1
FR;3;2022-05-09;0;0;0;0;0;0;0;0;0;4416871;3441715;4463;2;3613808;2861;48;0;1
FR;3;2022-05-10;0;0;0;0;0;0;0;0;0;4416871;3441715;4463;2;3613808;2861;48;0;1
FR;3;2022-05-11;0;0;0;0;0;0;0;0;0;4416871;3441715;4463;2;3613808;2861;48;0;1
FR;3;2022-05-12;0;0;0;0;0;0;0;0;0;4416871;3441715;4463;2;3613808;2861;48;0;1
FR;3;2022-05-13;0;0;0;0;0;0;0;0;0;4416871;3441715;4463;2;3613808;2861;48;0;1
FR;3;2022-05-14;1;0;0;0;0;0;0;0;0;4416872;3441715;4463;2;3613808;2861;48;0;1
FR;3;2022-05-15;0;0;0;0;0;0;0;0;0;4416872;3441715;4463;2;3613808;2861;48;0;1
FR;3;2022-05-16;0;0;0;0;0;0;0;0;0;4416872;3441715;4463;2;3613808;2861;48;0;1
FR;3;2022-05-17;0;0;0;0;0;0;0;0;0;4416872;3441715;4463;2;3613808;2861;48;0;1
FR;3;2022-05-18;0;0;0;0;0;0;0;0;0;4416872;3441715;4463;2;3613808;2861;48;0;1
FR;3;2022-05-19;0;0;0;0;0;0;0;0;0;4416872;3441715;4463;2;3613808;2861;48;0;1
FR;3;2022-05-20;0;0;0;0;0;0;0;0;0;4416872;3441715;4463;2;3613808;2861;48;0;1
FR;3;2022-05-21;0;0;0;0;0;0;0;0;0;4416872;3441715;4463;2;3613808;2861;48;0;1
FR;3;2022-05-22;0;0;0;0;0;0;0;0;0;4416872;3441715;4463;2;3613808;2861;48;0;1
FR;3;2022-05-23;0;0;0;0;0;0;0;0;0;4416872;3441715;4463;2;3613808;2861;48;0;1
FR;3;2022-05-24;0;0;0;0;0;0;0;0;0;4416872;3441715;4463;2;3613808;2861;48;0;1
FR;3;2022-05-25;0;0;0;0;0;0;0;0;0;4416872;3441715;4463;2;3613808;2861;48;0;1
FR;3;2022-05-26;0;0;0;0;0;0;0;0;0;4416872;3441715;4463;2;3613808;2861;48;0;1
FR;3;2022-05-27;0;0;0;0;0;0;0;0;0;4416872;3441715;4463;2;3613808;2861;48;0;1
FR;3;2022-05-28;0;0;0;0;0;0;0;0;0;4416872;3441715;4463;2;3613808;2861;48;0;1
FR;3;2022-05-29;0;0;0;0;0;0;0;0;0;4416872;3441715;4463;2;3613808;2861;48;0;1
FR;3;2022-05-30;0;0;0;0;0;0;0;0;0;4416872;3441715;4463;2;3613808;2861;48;0;1
FR;3;2022-05-31;0;0;0;0;0;0;0;0;0;4416872;3441715;4463;2;3613808;2861;48;0;1
FR;3;2022-06-01;0;0;0;0;0;0;0;0;0;4416872;3441715;4463;2;3613808;2861;48;0;1
FR;3;2022-06-02;0;0;0;0;0;0;0;0;0;4416872;3441715;4463;2;3613808;2861;48;0;1
FR;3;2022-06-03;0;0;0;0;0;0;0;0;0;4416872;3441715;4463;2;3613808;2861;48;0;1
FR;3;2022-06-04;0;0;0;0;0;0;0;0;0;4416872;3441715;4463;2;3613808;2861;48;0;1
FR;3;2022-06-05;0;0;0;0;0;0;0;0;0;4416872;3441715;4463;2;3613808;2861;48;0;1
FR;3;2022-06-06;0;0;0;0;0;0;0;0;0;4416872;3441715;4463;2;3613808;2861;48;0;1
FR;3;2022-06-07;0;0;0;0;0;0;0;0;0;4416872;3441715;4463;2;3613808;2861;48;0;1
FR;3;2022-06-08;0;0;0;0;0;0;0;0;0;4416872;3441715;4463;2;3613808;2861;48;0;1
FR;3;2022-06-09;0;0;0;0;0;0;0;0;0;4416872;3441715;4463;2;3613808;2861;48;0;1
FR;3;2022-06-10;0;0;0;0;0;0;0;0;0;4416872;3441715;4463;2;3613808;2861;48;0;1
FR;3;2022-06-11;0;0;0;0;0;0;0;0;0;4416872;3441715;4463;2;3613808;2861;48;0;1
FR;3;2022-06-12;0;0;0;0;0;0;0;0;0;4416872;3441715;4463;2;3613808;2861;48;0;1
FR;3;2022-06-13;1;0;0;0;0;0;0;0;0;4416873;3441715;4463;2;3613808;2861;48;0;1
FR;3;2022-06-14;0;0;0;0;0;0;0;0;0;4416873;3441715;4463;2;3613808;2861;48;0;1
FR;3;2022-06-15;0;0;0;0;0;0;0;0;0;4416873;3441715;4463;2;3613808;2861;48;0;1
FR;3;2022-06-16;0;0;0;0;0;0;0;0;0;4416873;3441715;4463;2;3613808;2861;48;0;1
FR;3;2022-06-17;0;0;0;0;0;0;0;0;0;4416873;3441715;4463;2;3613808;2861;48;0;1
FR;3;2022-06-18;0;0;0;0;0;0;0;0;0;4416873;3441715;4463;2;3613808;2861;48;0;1
FR;3;2022-06-19;0;0;0;0;0;0;0;0;0;4416873;3441715;4463;2;3613808;2861;48;0;1
FR;3;2022-06-20;0;0;0;0;0;0;0;0;0;4416873;3441715;4463;2;3613808;2861;48;0;1
FR;3;2022-06-21;0;0;0;0;0;0;0;0;0;4416873;3441715;4463;2;3613808;2861;48;0;1
FR;3;2022-06-22;0;0;0;0;0;0;0;0;0;4416873;3441715;4463;2;3613808;2861;48;0;1
FR;3;2022-06-23;0;0;0;0;0;0;0;0;0;4416873;3441715;4463;2;3613808;2861;48;0;1
FR;3;2022-06-24;0;0;0;0;0;0;0;0;0;4416873;3441715;4463;2;3613808;2861;48;0;1
FR;3;2022-06-25;0;0;0;0;0;0;0;0;0;4416873;3441715;4463;2;3613808;2861;48;0;1
FR;3;2022-06-26;0;0;0;0;0;0;0;0;0;4416873;3441715;4463;2;3613808;2861;48;0;1
FR;3;2022-06-27;0;0;0;0;0;0;0;0;0;4416873;3441715;4463;2;3613808;2861;48;0;1
FR;3;2022-06-28;0;0;0;0;0;0;0;0;0;4416873;3441715;4463;2;3613808;2861;48;0;1
FR;3;2022-06-29;1;0;0;0;0;0;0;0;0;4416874;3441715;4463;2;3613808;2861;48;0;1
FR;3;2022-06-30;0;0;0;0;0;0;0;0;0;4416874;3441715;4463;2;3613808;2861;48;0;1
FR;3;2022-07-01;0;0;0;0;0;0;0;0;0;4416874;3441715;4463;2;3613808;2861;48;0;1
FR;3;2022-07-02;0;0;0;0;0;0;0;0;0;4416874;3441715;4463;2;3613808;2861;48;0;1
FR;3;2022-07-03;0;0;0;0;0;0;0;0;0;4416874;3441715;4463;2;3613808;2861;48;0;1
FR;3;2022-07-04;0;0;0;0;0;0;0;0;0;4416874;3441715;4463;2;3613808;2861;48;0;1
FR;3;2022-07-05;0;0;0;0;0;0;0;0;0;4416874;3441715;4463;2;3613808;2861;48;0;1
FR;3;2022-07-06;0;0;0;0;0;0;0;0;0;4416874;3441715;4463;2;3613808;2861;48;0;1
FR;3;2022-07-07;0;0;0;0;0;0;0;0;0;4416874;3441715;4463;2;3613808;2861;48;0;1
FR;3;2022-07-08;0;0;0;0;0;0;0;0;0;4416874;3441715;4463;2;3613808;2861;48;0;1
FR;3;2022-07-09;0;0;0;0;0;0;0;0;0;4416874;3441715;4463;2;3613808;2861;48;0;1
FR;3;2022-07-10;0;0;0;0;0;0;0;0;0;4416874;3441715;4463;2;3613808;2861;48;0;1
FR;3;2022-07-11;0;0;0;0;0;0;0;0;0;4416874;3441715;4463;2;3613808;2861;48;0;1
FR;3;2022-07-12;0;0;0;0;0;0;0;0;0;4416874;3441715;4463;2;3613808;2861;48;0;1
FR;3;2022-07-13;0;0;0;0;0;0;0;0;0;4416874;3441715;4463;2;3613808;2861;48;0;1
FR;3;2022-07-14;0;0;0;0;0;0;0;0;0;4416874;3441715;4463;2;3613808;2861;48;0;1
FR;3;2022-07-15;0;0;0;0;0;0;0;0;0;4416874;3441715;4463;2;3613808;2861;48;0;1
FR;3;2022-07-16;0;0;0;0;0;0;0;0;0;4416874;3441715;4463;2;3613808;2861;48;0;1
FR;3;2022-07-17;0;0;0;0;0;0;0;0;0;4416874;3441715;4463;2;3613808;2861;48;0;1
FR;3;2022-07-18;0;0;0;0;0;0;0;0;0;4416874;3441715;4463;2;3613808;2861;48;0;1
FR;3;2022-07-19;0;0;0;0;0;0;0;0;0;4416874;3441715;4463;2;3613808;2861;48;0;1
FR;3;2022-07-20;0;0;0;0;0;0;0;0;0;4416874;3441715;4463;2;3613808;2861;48;0;1
FR;3;2022-07-21;0;0;0;0;0;0;0;0;0;4416874;3441715;4463;2;3613808;2861;48;0;1
FR;3;2022-07-22;0;0;0;0;0;0;0;0;0;4416874;3441715;4463;2;3613808;2861;48;0;1
FR;3;2022-07-23;0;0;0;0;0;0;0;0;0;4416874;3441715;4463;2;3613808;2861;48;0;1
FR;3;2022-07-24;0;0;0;0;0;0;0;0;0;4416874;3441715;4463;2;3613808;2861;48;0;1
FR;3;2022-07-25;0;0;0;0;0;0;0;0;0;4416874;3441715;4463;2;3613808;2861;48;0;1
FR;3;2022-07-26;0;0;0;0;0;0;0;0;0;4416874;3441715;4463;2;3613808;2861;48;0;1
FR;3;2022-07-27;0;0;0;0;0;0;0;0;0;4416874;3441715;4463;2;3613808;2861;48;0;1
FR;3;2022-07-28;0;0;0;0;0;0;0;0;0;4416874;3441715;4463;2;3613808;2861;48;0;1
FR;3;2022-07-29;0;0;0;0;0;0;0;0;0;4416874;3441715;4463;2;3613808;2861;48;0;1
FR;3;2022-07-30;0;0;0;0;0;0;0;0;0;4416874;3441715;4463;2;3613808;2861;48;0;1
FR;3;2022-07-31;0;0;0;0;0;0;0;0;0;4416874;3441715;4463;2;3613808;2861;48;0;1
FR;3;2022-08-01;0;0;0;0;0;0;0;0;0;4416874;3441715;4463;2;3613808;2861;48;0;1
FR;3;2022-08-02;0;0;0;0;0;0;0;0;0;4416874;3441715;4463;2;3613808;2861;48;0;1
FR;3;2022-08-03;0;0;0;0;0;0;0;0;0;4416874;3441715;4463;2;3613808;2861;48;0;1
FR;3;2022-08-04;0;0;0;0;0;0;0;0;0;4416874;3441715;4463;2;3613808;2861;48;0;1
FR;3;2022-08-05;0;0;0;0;0;0;0;0;0;4416874;3441715;4463;2;3613808;2861;48;0;1
FR;3;2022-08-06;0;0;0;0;0;0;0;0;0;4416874;3441715;4463;2;3613808;2861;48;0;1
FR;3;2022-08-07;0;0;0;0;0;0;0;0;0;4416874;3441715;4463;2;3613808;2861;48;0;1
FR;3;2022-08-08;0;0;0;0;0;0;0;0;0;4416874;3441715;4463;2;3613808;2861;48;0;1
FR;3;2022-08-09;0;0;0;0;0;0;0;0;0;4416874;3441715;4463;2;3613808;2861;48;0;1
FR;3;2022-08-10;0;0;0;0;0;0;0;0;0;4416874;3441715;4463;2;3613808;2861;48;0;1
FR;3;2022-08-11;0;0;0;0;0;0;0;0;0;4416874;3441715;4463;2;3613808;2861;48;0;1
FR;3;2022-08-12;0;0;0;0;0;0;0;0;0;4416874;3441715;4463;2;3613808;2861;48;0;1
FR;3;2022-08-13;0;0;0;0;0;0;0;0;0;4416874;3441715;4463;2;3613808;2861;48;0;1
FR;3;2022-08-14;0;0;0;0;0;0;0;0;0;4416874;3441715;4463;2;3613808;2861;48;0;1
FR;3;2022-08-15;0;0;0;0;0;0;0;0;0;4416874;3441715;4463;2;3613808;2861;48;0;1
FR;3;2022-08-16;0;0;0;0;0;0;0;0;0;4416874;3441715;4463;2;3613808;2861;48;0;1
FR;3;2022-08-17;0;0;0;0;0;0;0;0;0;4416874;3441715;4463;2;3613808;2861;48;0;1
FR;3;2022-08-18;0;0;0;0;0;0;0;0;0;4416874;3441715;4463;2;3613808;2861;48;0;1
FR;3;2022-08-19;0;0;0;0;0;0;0;0;0;4416874;3441715;4463;2;3613808;2861;48;0;1
FR;3;2022-08-20;0;0;0;0;0;0;0;0;0;4416874;3441715;4463;2;3613808;2861;48;0;1
FR;3;2022-08-21;0;0;0;0;0;0;0;0;0;4416874;3441715;4463;2;3613808;2861;48;0;1
FR;3;2022-08-22;0;0;0;0;0;0;0;0;0;4416874;3441715;4463;2;3613808;2861;48;0;1
FR;3;2022-08-23;0;0;0;0;0;0;0;0;0;4416874;3441715;4463;2;3613808;2861;48;0;1
FR;3;2022-08-24;0;0;0;0;0;0;0;0;0;4416874;3441715;4463;2;3613808;2861;48;0;1
FR;3;2022-08-25;0;0;0;0;0;0;0;0;0;4416874;3441715;4463;2;3613808;2861;48;0;1
FR;3;2022-08-26;0;0;0;0;0;0;0;0;0;4416874;3441715;4463;2;3613808;2861;48;0;1
FR;3;2022-08-27;0;0;0;0;0;0;0;0;0;4416874;3441715;4463;2;3613808;2861;48;0;1
FR;3;2022-08-28;0;0;0;0;0;0;0;0;0;4416874;3441715;4463;2;3613808;2861;48;0;1
FR;3;2022-08-29;0;0;0;0;0;0;0;0;0;4416874;3441715;4463;2;3613808;2861;48;0;1
FR;3;2022-08-30;0;0;0;0;0;0;0;0;0;4416874;3441715;4463;2;3613808;2861;48;0;1
FR;3;2022-08-31;0;0;0;0;0;0;0;0;0;4416874;3441715;4463;2;3613808;2861;48;0;1
FR;3;2022-09-01;0;0;0;0;0;0;0;0;0;4416874;3441715;4463;2;3613808;2861;48;0;1
FR;3;2022-09-02;0;0;0;0;0;0;0;0;0;4416874;3441715;4463;2;3613808;2861;48;0;1
FR;3;2022-09-03;0;0;0;0;0;0;0;0;0;4416874;3441715;4463;2;3613808;2861;48;0;1
FR;3;2022-09-04;0;0;0;0;0;0;0;0;0;4416874;3441715;4463;2;3613808;2861;48;0;1
FR;3;2022-09-05;0;0;0;0;0;0;0;0;0;4416874;3441715;4463;2;3613808;2861;48;0;1
FR;3;2022-09-06;0;0;0;0;0;0;0;0;0;4416874;3441715;4463;2;3613808;2861;48;0;1
FR;3;2022-09-07;0;0;0;0;0;0;0;0;0;4416874;3441715;4463;2;3613808;2861;48;0;1
FR;3;2022-09-08;0;0;0;0;0;0;0;0;0;4416874;3441715;4463;2;3613808;2861;48;0;1
FR;3;2022-09-09;0;0;0;0;0;0;0;0;0;4416874;3441715;4463;2;3613808;2861;48;0;1
FR;3;2022-09-10;0;0;0;0;0;0;0;0;0;4416874;3441715;4463;2;3613808;2861;48;0;1
FR;3;2022-09-11;0;0;0;0;0;0;0;0;0;4416874;3441715;4463;2;3613808;2861;48;0;1
FR;3;2022-09-12;0;0;0;0;0;0;0;0;0;4416874;3441715;4463;2;3613808;2861;48;0;1
FR;3;2022-09-13;0;0;0;0;0;0;0;0;0;4416874;3441715;4463;2;3613808;2861;48;0;1
FR;3;2022-09-14;0;0;0;0;0;0;0;0;0;4416874;3441715;4463;2;3613808;2861;48;0;1
FR;3;2022-09-15;0;0;0;0;0;0;0;0;0;4416874;3441715;4463;2;3613808;2861;48;0;1
FR;3;2022-09-16;0;0;0;0;0;0;0;0;0;4416874;3441715;4463;2;3613808;2861;48;0;1
FR;3;2022-09-17;0;0;0;0;0;0;0;0;0;4416874;3441715;4463;2;3613808;2861;48;0;1
FR;3;2022-09-18;0;0;0;0;0;0;0;0;0;4416874;3441715;4463;2;3613808;2861;48;0;1
FR;3;2022-09-19;0;0;0;0;0;0;0;0;0;4416874;3441715;4463;2;3613808;2861;48;0;1
FR;3;2022-09-20;0;0;0;0;0;0;0;0;0;4416874;3441715;4463;2;3613808;2861;48;0;1
FR;3;2022-09-21;0;0;0;0;0;0;0;0;0;4416874;3441715;4463;2;3613808;2861;48;0;1
FR;3;2022-09-22;0;0;0;0;0;0;0;0;0;4416874;3441715;4463;2;3613808;2861;48;0;1
FR;3;2022-09-23;0;0;0;0;0;0;0;0;0;4416874;3441715;4463;2;3613808;2861;48;0;1
FR;3;2022-09-24;0;0;0;0;0;0;0;0;0;4416874;3441715;4463;2;3613808;2861;48;0;1
FR;3;2022-09-25;0;0;0;0;0;0;0;0;0;4416874;3441715;4463;2;3613808;2861;48;0;1
FR;3;2022-09-26;0;0;0;0;0;0;0;0;0;4416874;3441715;4463;2;3613808;2861;48;0;1
FR;3;2022-09-27;0;0;0;0;0;0;0;0;0;4416874;3441715;4463;2;3613808;2861;48;0;1
FR;3;2022-09-28;0;0;0;0;0;0;0;0;0;4416874;3441715;4463;2;3613808;2861;48;0;1
FR;3;2022-09-29;0;0;0;0;0;0;0;0;0;4416874;3441715;4463;2;3613808;2861;48;0;1
FR;3;2022-09-30;0;0;0;0;0;0;0;0;0;4416874;3441715;4463;2;3613808;2861;48;0;1
FR;3;2022-10-01;0;0;0;0;0;0;0;0;0;4416874;3441715;4463;2;3613808;2861;48;0;1
FR;3;2022-10-02;0;0;0;0;0;0;0;0;0;4416874;3441715;4463;2;3613808;2861;48;0;1
FR;3;2022-10-03;0;0;0;0;0;0;0;0;0;4416874;3441715;4463;2;3613808;2861;48;0;1
FR;3;2022-10-04;0;0;0;0;0;0;0;0;0;4416874;3441715;4463;2;3613808;2861;48;0;1
FR;3;2022-10-05;0;0;0;0;0;0;0;0;0;4416874;3441715;4463;2;3613808;2861;48;0;1
FR;3;2022-10-06;0;0;0;0;0;0;0;0;0;4416874;3441715;4463;2;3613808;2861;48;0;1
FR;3;2022-10-07;0;0;0;0;0;0;0;0;0;4416874;3441715;4463;2;3613808;2861;48;0;1
FR;3;2022-10-08;0;0;0;0;0;0;0;0;0;4416874;3441715;4463;2;3613808;2861;48;0;1
FR;3;2022-10-09;0;0;0;0;0;0;0;0;0;4416874;3441715;4463;2;3613808;2861;48;0;1
FR;3;2022-10-10;0;0;0;0;0;0;0;0;0;4416874;3441715;4463;2;3613808;2861;48;0;1
FR;3;2022-10-11;0;0;0;0;0;0;0;0;0;4416874;3441715;4463;2;3613808;2861;48;0;1
FR;3;2022-10-12;0;0;0;0;0;0;0;0;0;4416874;3441715;4463;2;3613808;2861;48;0;1
FR;3;2022-10-13;0;0;0;0;0;0;0;0;0;4416874;3441715;4463;2;3613808;2861;48;0;1
FR;3;2022-10-14;0;0;0;0;0;0;0;0;0;4416874;3441715;4463;2;3613808;2861;48;0;1
FR;3;2022-10-15;0;0;0;0;0;0;0;0;0;4416874;3441715;4463;2;3613808;2861;48;0;1
FR;3;2022-10-16;0;0;0;0;0;0;0;0;0;4416874;3441715;4463;2;3613808;2861;48;0;1
FR;3;2022-10-17;0;0;0;0;0;0;0;0;0;4416874;3441715;4463;2;3613808;2861;48;0;1
FR;3;2022-10-18;0;0;0;0;0;0;0;0;0;4416874;3441715;4463;2;3613808;2861;48;0;1
FR;3;2022-10-19;0;0;0;0;0;0;0;0;0;4416874;3441715;4463;2;3613808;2861;48;0;1
FR;3;2022-10-20;0;0;0;0;0;0;0;0;0;4416874;3441715;4463;2;3613808;2861;48;0;1
FR;3;2022-10-21;0;0;0;0;0;0;0;0;0;4416874;3441715;4463;2;3613808;2861;48;0;1
FR;3;2022-10-22;0;0;0;0;0;0;0;0;0;4416874;3441715;4463;2;3613808;2861;48;0;1
FR;3;2022-10-23;0;0;0;0;0;0;0;0;0;4416874;3441715;4463;2;3613808;2861;48;0;1
FR;3;2022-10-24;0;0;0;0;0;0;0;0;0;4416874;3441715;4463;2;3613808;2861;48;0;1
FR;3;2022-10-25;0;0;0;0;0;0;0;0;0;4416874;3441715;4463;2;3613808;2861;48;0;1
FR;3;2022-10-26;0;0;0;0;0;0;0;0;0;4416874;3441715;4463;2;3613808;2861;48;0;1
FR;3;2022-10-27;0;0;0;0;0;0;0;0;0;4416874;3441715;4463;2;3613808;2861;48;0;1
FR;3;2022-10-28;0;0;0;0;0;0;0;0;0;4416874;3441715;4463;2;3613808;2861;48;0;1
FR;3;2022-10-29;0;0;0;0;0;0;0;0;0;4416874;3441715;4463;2;3613808;2861;48;0;1
FR;3;2022-10-30;0;0;0;0;0;0;0;0;0;4416874;3441715;4463;2;3613808;2861;48;0;1
FR;3;2022-10-31;0;0;0;0;0;0;0;0;0;4416874;3441715;4463;2;3613808;2861;48;0;1
FR;3;2022-11-01;0;0;0;0;0;0;0;0;0;4416874;3441715;4463;2;3613808;2861;48;0;1
FR;3;2022-11-02;0;0;0;0;0;0;0;0;0;4416874;3441715;4463;2;3613808;2861;48;0;1
FR;3;2022-11-03;0;0;0;0;0;0;0;0;0;4416874;3441715;4463;2;3613808;2861;48;0;1
FR;3;2022-11-04;0;0;0;0;0;0;0;0;0;4416874;3441715;4463;2;3613808;2861;48;0;1
FR;3;2022-11-05;0;0;0;0;0;0;0;0;0;4416874;3441715;4463;2;3613808;2861;48;0;1
FR;3;2022-11-06;0;0;0;0;0;0;0;0;0;4416874;3441715;4463;2;3613808;2861;48;0;1
FR;3;2022-11-07;0;0;0;0;0;0;0;0;0;4416874;3441715;4463;2;3613808;2861;48;0;1
FR;3;2022-11-08;1;0;0;0;0;0;0;0;0;4416875;3441715;4463;2;3613808;2861;48;0;1
FR;3;2022-11-09;0;0;0;0;0;0;0;0;0;4416875;3441715;4463;2;3613808;2861;48;0;1
FR;3;2022-11-10;0;0;0;0;0;0;0;0;0;4416875;3441715;4463;2;3613808;2861;48;0;1
FR;3;2022-11-11;0;0;0;0;0;0;0;0;0;4416875;3441715;4463;2;3613808;2861;48;0;1
FR;3;2022-11-12;0;0;0;0;0;0;0;0;0;4416875;3441715;4463;2;3613808;2861;48;0;1
FR;3;2022-11-13;0;0;0;0;0;0;0;0;0;4416875;3441715;4463;2;3613808;2861;48;0;1
FR;3;2022-11-14;0;0;0;0;0;0;0;0;0;4416875;3441715;4463;2;3613808;2861;48;0;1
FR;3;2022-11-15;0;0;0;0;0;0;0;0;0;4416875;3441715;4463;2;3613808;2861;48;0;1
FR;3;2022-11-16;0;0;0;0;0;0;0;0;0;4416875;3441715;4463;2;3613808;2861;48;0;1
FR;3;2022-11-17;0;0;0;0;0;0;0;0;0;4416875;3441715;4463;2;3613808;2861;48;0;1
FR;3;2022-11-18;0;0;0;0;0;0;0;0;0;4416875;3441715;4463;2;3613808;2861;48;0;1
FR;3;2022-11-19;0;0;0;0;0;0;0;0;0;4416875;3441715;4463;2;3613808;2861;48;0;1
FR;3;2022-11-20;0;0;0;0;0;0;0;0;0;4416875;3441715;4463;2;3613808;2861;48;0;1
FR;3;2022-11-21;0;0;0;0;0;0;0;0;0;4416875;3441715;4463;2;3613808;2861;48;0;1
FR;3;2022-11-22;0;0;0;0;0;0;0;0;0;4416875;3441715;4463;2;3613808;2861;48;0;1
FR;3;2022-11-23;0;0;0;0;0;0;0;0;0;4416875;3441715;4463;2;3613808;2861;48;0;1
FR;3;2022-11-24;0;0;0;0;0;0;0;0;0;4416875;3441715;4463;2;3613808;2861;48;0;1
FR;3;2022-11-25;0;0;0;0;0;0;0;0;0;4416875;3441715;4463;2;3613808;2861;48;0;1
FR;3;2022-11-26;0;0;0;0;0;0;0;0;0;4416875;3441715;4463;2;3613808;2861;48;0;1
FR;3;2022-11-27;0;0;0;0;0;0;0;0;0;4416875;3441715;4463;2;3613808;2861;48;0;1
FR;3;2022-11-28;0;0;0;0;0;0;0;0;0;4416875;3441715;4463;2;3613808;2861;48;0;1
FR;3;2022-11-29;0;0;0;0;0;0;0;0;0;4416875;3441715;4463;2;3613808;2861;48;0;1
FR;3;2022-11-30;0;0;0;0;0;0;0;0;0;4416875;3441715;4463;2;3613808;2861;48;0;1
FR;3;2022-12-01;0;0;0;0;0;0;0;0;0;4416875;3441715;4463;2;3613808;2861;48;0;1
FR;3;2022-12-02;0;0;0;0;0;0;0;0;0;4416875;3441715;4463;2;3613808;2861;48;0;1
FR;3;2022-12-03;0;0;0;0;0;0;0;0;0;4416875;3441715;4463;2;3613808;2861;48;0;1
FR;3;2022-12-04;0;0;0;0;0;0;0;0;0;4416875;3441715;4463;2;3613808;2861;48;0;1
FR;3;2022-12-05;0;0;0;0;0;0;0;0;0;4416875;3441715;4463;2;3613808;2861;48;0;1
FR;3;2022-12-06;0;0;0;0;0;0;0;0;0;4416875;3441715;4463;2;3613808;2861;48;0;1
FR;3;2022-12-07;0;0;0;0;0;0;0;0;0;4416875;3441715;4463;2;3613808;2861;48;0;1
FR;3;2022-12-08;0;0;0;0;0;0;0;0;0;4416875;3441715;4463;2;3613808;2861;48;0;1
FR;3;2022-12-09;0;0;0;0;0;0;0;0;0;4416875;3441715;4463;2;3613808;2861;48;0;1
FR;3;2022-12-10;0;0;0;0;0;0;0;0;0;4416875;3441715;4463;2;3613808;2861;48;0;1
FR;3;2022-12-11;0;0;0;0;0;0;0;0;0;4416875;3441715;4463;2;3613808;2861;48;0;1
FR;3;2022-12-12;0;0;0;0;0;0;0;0;0;4416875;3441715;4463;2;3613808;2861;48;0;1
FR;3;2022-12-13;0;0;0;0;0;0;0;0;0;4416875;3441715;4463;2;3613808;2861;48;0;1
FR;3;2022-12-14;0;0;0;0;0;0;0;0;0;4416875;3441715;4463;2;3613808;2861;48;0;1
FR;3;2022-12-15;0;0;0;0;0;0;0;0;0;4416875;3441715;4463;2;3613808;2861;48;0;1
FR;3;2022-12-16;0;0;0;0;0;0;0;0;0;4416875;3441715;4463;2;3613808;2861;48;0;1
FR;3;2022-12-17;0;0;0;0;0;0;0;0;0;4416875;3441715;4463;2;3613808;2861;48;0;1
FR;3;2022-12-18;0;0;0;0;0;0;0;0;0;4416875;3441715;4463;2;3613808;2861;48;0;1
FR;3;2022-12-19;0;0;0;0;0;0;0;0;0;4416875;3441715;4463;2;3613808;2861;48;0;1
FR;3;2022-12-20;0;0;0;0;0;0;0;0;0;4416875;3441715;4463;2;3613808;2861;48;0;1
FR;3;2022-12-21;0;0;0;0;0;0;0;0;0;4416875;3441715;4463;2;3613808;2861;48;0;1
FR;3;2022-12-22;0;0;0;0;0;0;0;0;0;4416875;3441715;4463;2;3613808;2861;48;0;1
FR;3;2022-12-23;0;0;0;0;0;0;0;0;0;4416875;3441715;4463;2;3613808;2861;48;0;1
FR;3;2022-12-24;0;0;0;0;0;0;0;0;0;4416875;3441715;4463;2;3613808;2861;48;0;1
FR;3;2022-12-25;0;0;0;0;0;0;0;0;0;4416875;3441715;4463;2;3613808;2861;48;0;1
FR;3;2022-12-26;0;0;0;0;0;0;0;0;0;4416875;3441715;4463;2;3613808;2861;48;0;1
FR;3;2022-12-27;0;0;0;0;0;0;0;0;0;4416875;3441715;4463;2;3613808;2861;48;0;1
FR;3;2022-12-28;0;0;0;0;0;0;0;0;0;4416875;3441715;4463;2;3613808;2861;48;0;1
FR;3;2022-12-29;0;0;0;0;0;0;0;0;0;4416875;3441715;4463;2;3613808;2861;48;0;1
FR;3;2022-12-30;0;0;0;0;0;0;0;0;0;4416875;3441715;4463;2;3613808;2861;48;0;1
FR;3;2022-12-31;0;0;0;0;0;0;0;0;0;4416875;3441715;4463;2;3613808;2861;48;0;1
FR;3;2023-01-01;0;0;0;0;0;0;0;0;0;4416875;3441715;4463;2;3613808;2861;48;0;1
FR;3;2023-01-02;0;0;0;0;0;0;0;0;0;4416875;3441715;4463;2;3613808;2861;48;0;1
FR;3;2023-01-03;0;0;0;0;0;0;0;0;0;4416875;3441715;4463;2;3613808;2861;48;0;1
FR;3;2023-01-04;0;0;0;0;0;0;0;0;0;4416875;3441715;4463;2;3613808;2861;48;0;1
FR;3;2023-01-05;0;0;0;0;0;0;0;0;0;4416875;3441715;4463;2;3613808;2861;48;0;1
FR;3;2023-01-06;0;0;0;0;0;0;0;0;0;4416875;3441715;4463;2;3613808;2861;48;0;1
FR;3;2023-01-07;0;0;0;0;0;0;0;0;0;4416875;3441715;4463;2;3613808;2861;48;0;1
FR;3;2023-01-08;0;0;0;0;0;0;0;0;0;4416875;3441715;4463;2;3613808;2861;48;0;1
FR;3;2023-01-09;0;0;0;0;0;0;0;0;0;4416875;3441715;4463;2;3613808;2861;48;0;1
FR;3;2023-01-10;0;0;0;0;0;0;0;0;0;4416875;3441715;4463;2;3613808;2861;48;0;1
FR;3;2023-01-11;0;0;0;0;0;0;0;0;0;4416875;3441715;4463;2;3613808;2861;48;0;1
FR;3;2023-01-12;0;0;0;0;0;0;0;0;0;4416875;3441715;4463;2;3613808;2861;48;0;1
FR;3;2023-01-13;0;0;0;0;0;0;0;0;0;4416875;3441715;4463;2;3613808;2861;48;0;1
FR;3;2023-01-14;0;0;0;0;0;0;0;0;0;4416875;3441715;4463;2;3613808;2861;48;0;1
FR;3;2023-01-15;0;0;0;0;0;0;0;0;0;4416875;3441715;4463;2;3613808;2861;48;0;1
FR;3;2023-01-16;0;0;0;0;0;0;0;0;0;4416875;3441715;4463;2;3613808;2861;48;0;1
FR;3;2023-01-17;0;0;0;0;0;0;0;0;0;4416875;3441715;4463;2;3613808;2861;48;0;1
FR;3;2023-01-18;0;0;0;0;0;0;0;0;0;4416875;3441715;4463;2;3613808;2861;48;0;1
FR;3;2023-01-19;0;0;0;0;0;0;0;0;0;4416875;3441715;4463;2;3613808;2861;48;0;1
FR;3;2023-01-20;0;0;0;0;0;0;0;0;0;4416875;3441715;4463;2;3613808;2861;48;0;1
FR;3;2023-01-21;0;0;0;0;0;0;0;0;0;4416875;3441715;4463;2;3613808;2861;48;0;1
FR;3;2023-01-22;0;0;0;0;0;0;0;0;0;4416875;3441715;4463;2;3613808;2861;48;0;1
FR;3;2023-01-23;0;0;0;0;0;0;0;0;0;4416875;3441715;4463;2;3613808;2861;48;0;1
FR;3;2023-01-24;0;0;0;0;0;0;0;0;0;4416875;3441715;4463;2;3613808;2861;48;0;1
FR;3;2023-01-25;1;0;0;0;0;0;0;0;0;4416876;3441715;4463;2;3613808;2861;48;0;1
FR;3;2023-01-26;0;0;0;0;0;0;0;0;0;4416876;3441715;4463;2;3613808;2861;48;0;1
FR;3;2023-01-27;0;0;0;0;0;0;0;0;0;4416876;3441715;4463;2;3613808;2861;48;0;1
FR;3;2023-01-28;0;0;0;0;0;0;0;0;0;4416876;3441715;4463;2;3613808;2861;48;0;1
FR;3;2023-01-29;0;0;0;0;0;0;0;0;0;4416876;3441715;4463;2;3613808;2861;48;0;1
FR;3;2023-01-30;0;0;0;0;0;0;0;0;0;4416876;3441715;4463;2;3613808;2861;48;0;1
FR;3;2023-01-31;0;0;0;0;0;0;0;0;0;4416876;3441715;4463;2;3613808;2861;48;0;1
FR;3;2023-02-01;0;0;0;0;0;0;0;0;0;4416876;3441715;4463;2;3613808;2861;48;0;1
FR;3;2023-02-02;0;0;0;0;0;0;0;0;0;4416876;3441715;4463;2;3613808;2861;48;0;1
FR;3;2023-02-03;0;0;0;0;0;0;0;0;0;4416876;3441715;4463;2;3613808;2861;48;0;1
FR;3;2023-02-04;0;0;0;0;0;0;0;0;0;4416876;3441715;4463;2;3613808;2861;48;0;1
FR;3;2023-02-05;0;0;0;0;0;0;0;0;0;4416876;3441715;4463;2;3613808;2861;48;0;1
FR;3;2023-02-06;0;0;0;0;0;0;0;0;0;4416876;3441715;4463;2;3613808;2861;48;0;1
FR;3;2023-02-07;0;0;0;0;0;0;0;0;0;4416876;3441715;4463;2;3613808;2861;48;0;1
FR;3;2023-02-08;0;0;0;0;0;0;0;0;0;4416876;3441715;4463;2;3613808;2861;48;0;1
FR;3;2023-02-09;0;0;0;0;0;0;0;0;0;4416876;3441715;4463;2;3613808;2861;48;0;1
FR;3;2023-02-10;0;0;0;0;0;0;0;0;0;4416876;3441715;4463;2;3613808;2861;48;0;1
FR;3;2023-02-11;0;0;0;0;0;0;0;0;0;4416876;3441715;4463;2;3613808;2861;48;0;1
FR;3;2023-02-12;0;0;0;0;0;0;0;0;0;4416876;3441715;4463;2;3613808;2861;48;0;1
FR;3;2023-02-13;0;0;0;0;0;0;0;0;0;4416876;3441715;4463;2;3613808;2861;48;0;1
FR;3;2023-02-14;0;0;0;0;0;0;0;0;0;4416876;3441715;4463;2;3613808;2861;48;0;1
FR;3;2023-02-15;0;0;0;0;0;0;0;0;0;4416876;3441715;4463;2;3613808;2861;48;0;1
FR;3;2023-02-16;0;0;0;0;0;0;0;0;0;4416876;3441715;4463;2;3613808;2861;48;0;1
FR;3;2023-02-17;0;0;0;0;0;0;0;0;0;4416876;3441715;4463;2;3613808;2861;48;0;1
FR;3;2023-02-18;0;0;0;0;0;0;0;0;0;4416876;3441715;4463;2;3613808;2861;48;0;1
FR;3;2023-02-19;0;0;0;0;0;0;0;0;0;4416876;3441715;4463;2;3613808;2861;48;0;1
FR;3;2023-02-20;0;0;0;0;0;0;0;0;0;4416876;3441715;4463;2;3613808;2861;48;0;1
FR;3;2023-02-21;0;0;0;0;0;0;0;0;0;4416876;3441715;4463;2;3613808;2861;48;0;1
FR;3;2023-02-22;0;0;0;0;0;0;0;0;0;4416876;3441715;4463;2;3613808;2861;48;0;1
FR;3;2023-02-23;0;0;0;0;0;0;0;0;0;4416876;3441715;4463;2;3613808;2861;48;0;1
FR;3;2023-02-24;0;0;0;0;0;0;0;0;0;4416876;3441715;4463;2;3613808;2861;48;0;1
FR;3;2023-02-25;0;0;0;0;0;0;0;0;0;4416876;3441715;4463;2;3613808;2861;48;0;1
FR;3;2023-02-26;0;0;0;0;0;0;0;0;0;4416876;3441715;4463;2;3613808;2861;48;0;1
FR;3;2023-02-27;0;0;0;0;0;0;0;0;0;4416876;3441715;4463;2;3613808;2861;48;0;1
FR;3;2023-02-28;0;0;0;0;0;0;0;0;0;4416876;3441715;4463;2;3613808;2861;48;0;1
FR;3;2023-03-01;0;0;0;0;0;0;0;0;0;4416876;3441715;4463;2;3613808;2861;48;0;1
FR;3;2023-03-02;0;0;0;0;0;0;0;0;0;4416876;3441715;4463;2;3613808;2861;48;0;1
FR;3;2023-03-03;0;0;0;0;0;0;0;0;0;4416876;3441715;4463;2;3613808;2861;48;0;1
FR;3;2023-03-04;0;0;0;0;0;0;0;0;0;4416876;3441715;4463;2;3613808;2861;48;0;1
FR;3;2023-03-05;0;0;0;0;0;0;0;0;0;4416876;3441715;4463;2;3613808;2861;48;0;1
FR;3;2023-03-06;0;0;0;0;0;0;0;0;0;4416876;3441715;4463;2;3613808;2861;48;0;1
FR;3;2023-03-07;0;0;0;0;0;0;0;0;0;4416876;3441715;4463;2;3613808;2861;48;0;1
FR;3;2023-03-08;0;0;0;0;0;0;0;0;0;4416876;3441715;4463;2;3613808;2861;48;0;1
FR;3;2023-03-09;0;0;0;0;0;0;0;0;0;4416876;3441715;4463;2;3613808;2861;48;0;1
FR;3;2023-03-10;0;0;0;0;0;0;0;0;0;4416876;3441715;4463;2;3613808;2861;48;0;1
FR;3;2023-03-11;0;0;0;0;0;0;0;0;0;4416876;3441715;4463;2;3613808;2861;48;0;1
FR;3;2023-03-12;0;0;0;0;0;0;0;0;0;4416876;3441715;4463;2;3613808;2861;48;0;1
FR;3;2023-03-13;0;0;0;0;0;0;0;0;0;4416876;3441715;4463;2;3613808;2861;48;0;1
FR;3;2023-03-14;0;0;0;0;0;0;0;0;0;4416876;3441715;4463;2;3613808;2861;48;0;1
FR;3;2023-03-15;0;0;0;0;0;0;0;0;0;4416876;3441715;4463;2;3613808;2861;48;0;1
FR;3;2023-03-16;0;0;0;0;0;0;0;0;0;4416876;3441715;4463;2;3613808;2861;48;0;1
FR;3;2023-03-17;0;0;0;0;0;0;0;0;0;4416876;3441715;4463;2;3613808;2861;48;0;1
FR;3;2023-03-18;0;0;0;0;0;0;0;0;0;4416876;3441715;4463;2;3613808;2861;48;0;1
FR;3;2023-03-19;0;0;0;0;0;0;0;0;0;4416876;3441715;4463;2;3613808;2861;48;0;1
FR;3;2023-03-20;0;0;0;0;0;0;0;0;0;4416876;3441715;4463;2;3613808;2861;48;0;1
FR;3;2023-03-21;0;0;0;0;0;0;0;0;0;4416876;3441715;4463;2;3613808;2861;48;0;1
FR;3;2023-03-22;0;0;0;0;0;0;0;0;0;4416876;3441715;4463;2;3613808;2861;48;0;1
FR;3;2023-03-23;0;0;0;0;0;0;0;0;0;4416876;3441715;4463;2;3613808;2861;48;0;1
FR;3;2023-03-24;0;0;0;0;0;0;0;0;0;4416876;3441715;4463;2;3613808;2861;48;0;1
FR;3;2023-03-25;0;0;0;0;0;0;0;0;0;4416876;3441715;4463;2;3613808;2861;48;0;1
FR;3;2023-03-26;0;0;0;0;0;0;0;0;0;4416876;3441715;4463;2;3613808;2861;48;0;1
FR;3;2023-03-27;0;0;0;0;0;0;0;0;0;4416876;3441715;4463;2;3613808;2861;48;0;1
FR;3;2023-03-28;0;0;0;0;0;0;0;0;0;4416876;3441715;4463;2;3613808;2861;48;0;1
FR;3;2023-03-29;0;0;0;0;0;0;0;0;0;4416876;3441715;4463;2;3613808;2861;48;0;1
FR;3;2023-03-30;0;0;0;0;0;0;0;0;0;4416876;3441715;4463;2;3613808;2861;48;0;1
FR;3;2023-03-31;0;0;0;0;0;0;0;0;0;4416876;3441715;4463;2;3613808;2861;48;0;1
FR;3;2023-04-01;0;0;0;0;0;0;0;0;0;4416876;3441715;4463;2;3613808;2861;48;0;1
FR;3;2023-04-02;0;0;0;0;0;0;0;0;0;4416876;3441715;4463;2;3613808;2861;48;0;1
FR;3;2023-04-03;0;0;0;0;0;0;0;0;0;4416876;3441715;4463;2;3613808;2861;48;0;1
FR;3;2023-04-04;0;0;0;0;0;0;0;0;0;4416876;3441715;4463;2;3613808;2861;48;0;1
FR;3;2023-04-05;0;0;0;0;0;0;0;0;0;4416876;3441715;4463;2;3613808;2861;48;0;1
FR;3;2023-04-06;0;0;0;0;0;0;0;0;0;4416876;3441715;4463;2;3613808;2861;48;0;1
FR;3;2023-04-07;0;0;0;0;0;0;0;0;0;4416876;3441715;4463;2;3613808;2861;48;0;1
FR;3;2023-04-08;0;0;0;0;0;0;0;0;0;4416876;3441715;4463;2;3613808;2861;48;0;1
FR;3;2023-04-09;0;0;0;0;0;0;0;0;0;4416876;3441715;4463;2;3613808;2861;48;0;1
FR;3;2023-04-10;0;0;0;0;0;0;0;0;0;4416876;3441715;4463;2;3613808;2861;48;0;1
FR;3;2023-04-11;0;0;0;0;0;0;0;0;0;4416876;3441715;4463;2;3613808;2861;48;0;1
FR;3;2023-04-12;0;0;0;0;0;0;0;0;0;4416876;3441715;4463;2;3613808;2861;48;0;1
FR;3;2023-04-13;0;0;0;0;0;0;0;0;0;4416876;3441715;4463;2;3613808;2861;48;0;1
FR;3;2023-04-14;0;0;0;0;0;0;0;0;0;4416876;3441715;4463;2;3613808;2861;48;0;1
FR;3;2023-04-15;0;0;0;0;0;0;0;0;0;4416876;3441715;4463;2;3613808;2861;48;0;1
FR;3;2023-04-16;0;0;0;0;0;0;0;0;0;4416876;3441715;4463;2;3613808;2861;48;0;1
FR;3;2023-04-17;0;0;0;0;0;0;0;0;0;4416876;3441715;4463;2;3613808;2861;48;0;1
FR;3;2023-04-18;0;0;0;0;0;0;0;0;0;4416876;3441715;4463;2;3613808;2861;48;0;1
FR;3;2023-04-19;0;0;0;0;0;0;0;0;0;4416876;3441715;4463;2;3613808;2861;48;0;1
FR;3;2023-04-20;0;0;0;0;0;0;0;0;0;4416876;3441715;4463;2;3613808;2861;48;0;1
FR;3;2023-04-21;0;0;0;0;0;0;0;0;0;4416876;3441715;4463;2;3613808;2861;48;0;1
FR;3;2023-04-22;0;0;0;0;0;0;0;0;0;4416876;3441715;4463;2;3613808;2861;48;0;1
FR;3;2023-04-23;0;0;0;0;0;0;0;0;0;4416876;3441715;4463;2;3613808;2861;48;0;1
FR;3;2023-04-24;0;0;0;0;0;0;0;0;0;4416876;3441715;4463;2;3613808;2861;48;0;1
FR;3;2023-04-25;0;0;0;0;0;0;0;0;0;4416876;3441715;4463;2;3613808;2861;48;0;1
FR;3;2023-04-26;0;0;0;0;0;0;0;0;0;4416876;3441715;4463;2;3613808;2861;48;0;1
FR;3;2023-04-27;0;0;0;0;0;0;0;0;0;4416876;3441715;4463;2;3613808;2861;48;0;1
FR;3;2023-04-28;0;0;0;0;0;0;0;0;0;4416876;3441715;4463;2;3613808;2861;48;0;1
FR;3;2023-04-29;0;0;0;0;0;0;0;0;0;4416876;3441715;4463;2;3613808;2861;48;0;1
FR;3;2023-04-30;0;0;0;0;0;0;0;0;0;4416876;3441715;4463;2;3613808;2861;48;0;1
FR;3;2023-05-01;0;0;0;0;0;0;0;0;0;4416876;3441715;4463;2;3613808;2861;48;0;1
FR;3;2023-05-02;0;0;0;0;0;0;0;0;0;4416876;3441715;4463;2;3613808;2861;48;0;1
FR;3;2023-05-03;0;0;0;0;0;0;0;0;0;4416876;3441715;4463;2;3613808;2861;48;0;1
FR;3;2023-05-04;0;0;0;0;0;0;0;0;0;4416876;3441715;4463;2;3613808;2861;48;0;1
FR;3;2023-05-05;0;0;0;0;0;0;0;0;0;4416876;3441715;4463;2;3613808;2861;48;0;1
FR;3;2023-05-06;0;0;0;0;0;0;0;0;0;4416876;3441715;4463;2;3613808;2861;48;0;1
FR;3;2023-05-07;0;0;0;0;0;0;0;0;0;4416876;3441715;4463;2;3613808;2861;48;0;1
FR;3;2023-05-08;0;0;0;0;0;0;0;0;0;4416876;3441715;4463;2;3613808;2861;48;0;1
FR;3;2023-05-09;0;0;0;0;0;0;0;0;0;4416876;3441715;4463;2;3613808;2861;48;0;1
FR;3;2023-05-10;0;0;0;0;0;0;0;0;0;4416876;3441715;4463;2;3613808;2861;48;0;1
FR;3;2023-05-11;0;0;0;0;0;0;0;0;0;4416876;3441715;4463;2;3613808;2861;48;0;1
FR;3;2023-05-12;0;0;0;0;0;0;0;0;0;4416876;3441715;4463;2;3613808;2861;48;0;1
FR;3;2023-05-13;0;0;0;0;0;0;0;0;0;4416876;3441715;4463;2;3613808;2861;48;0;1
FR;3;2023-05-14;0;0;0;0;0;0;0;0;0;4416876;3441715;4463;2;3613808;2861;48;0;1
FR;3;2023-05-15;0;0;0;0;0;0;0;0;0;4416876;3441715;4463;2;3613808;2861;48;0;1
FR;3;2023-05-16;0;0;0;0;0;0;0;0;0;4416876;3441715;4463;2;3613808;2861;48;0;1
FR;3;2023-05-17;0;0;0;0;0;0;0;0;0;4416876;3441715;4463;2;3613808;2861;48;0;1
FR;3;2023-05-18;0;0;0;0;0;0;0;0;0;4416876;3441715;4463;2;3613808;2861;48;0;1
FR;3;2023-05-19;0;0;0;0;0;0;0;0;0;4416876;3441715;4463;2;3613808;2861;48;0;1
FR;3;2023-05-20;0;0;0;0;0;0;0;0;0;4416876;3441715;4463;2;3613808;2861;48;0;1
FR;3;2023-05-21;0;0;0;0;0;0;0;0;0;4416876;3441715;4463;2;3613808;2861;48;0;1
FR;3;2023-05-22;0;0;0;0;0;0;0;0;0;4416876;3441715;4463;2;3613808;2861;48;0;1
FR;3;2023-05-23;0;0;0;0;0;0;0;0;0;4416876;3441715;4463;2;3613808;2861;48;0;1
FR;3;2023-05-24;0;0;0;0;0;0;0;0;0;4416876;3441715;4463;2;3613808;2861;48;0;1
FR;3;2023-05-25;0;0;0;0;0;0;0;0;0;4416876;3441715;4463;2;3613808;2861;48;0;1
FR;3;2023-05-26;0;0;0;0;0;0;0;0;0;4416876;3441715;4463;2;3613808;2861;48;0;1
FR;3;2023-05-27;0;0;0;0;0;0;0;0;0;4416876;3441715;4463;2;3613808;2861;48;0;1
FR;3;2023-05-28;0;0;0;0;0;0;0;0;0;4416876;3441715;4463;2;3613808;2861;48;0;1
FR;3;2023-05-29;0;0;0;0;0;0;0;0;0;4416876;3441715;4463;2;3613808;2861;48;0;1
FR;3;2023-05-30;0;0;0;0;0;0;0;0;0;4416876;3441715;4463;2;3613808;2861;48;0;1
FR;3;2023-05-31;0;0;0;0;0;0;0;0;0;4416876;3441715;4463;2;3613808;2861;48;0;1
FR;3;2023-06-01;0;0;0;0;0;0;0;0;0;4416876;3441715;4463;2;3613808;2861;48;0;1
FR;3;2023-06-02;0;0;0;0;0;0;0;0;0;4416876;3441715;4463;2;3613808;2861;48;0;1
FR;3;2023-06-03;0;0;0;0;0;0;0;0;0;4416876;3441715;4463;2;3613808;2861;48;0;1
FR;3;2023-06-04;0;0;0;0;0;0;0;0;0;4416876;3441715;4463;2;3613808;2861;48;0;1
FR;3;2023-06-05;0;0;0;0;0;0;0;0;0;4416876;3441715;4463;2;3613808;2861;48;0;1
FR;3;2023-06-06;0;0;0;0;0;0;0;0;0;4416876;3441715;4463;2;3613808;2861;48;0;1
FR;3;2023-06-07;0;0;0;0;0;0;0;0;0;4416876;3441715;4463;2;3613808;2861;48;0;1
FR;3;2023-06-08;0;0;0;0;0;0;0;0;0;4416876;3441715;4463;2;3613808;2861;48;0;1
FR;3;2023-06-09;0;0;0;0;0;0;0;0;0;4416876;3441715;4463;2;3613808;2861;48;0;1
FR;3;2023-06-10;0;0;0;0;0;0;0;0;0;4416876;3441715;4463;2;3613808;2861;48;0;1
FR;3;2023-06-11;0;0;0;0;0;0;0;0;0;4416876;3441715;4463;2;3613808;2861;48;0;1
FR;3;2023-06-12;0;0;0;0;0;0;0;0;0;4416876;3441715;4463;2;3613808;2861;48;0;1
FR;4;2020-12-27;0;0;0;0;0;0;0;0;0;0;0;0;0;0;0;0;0;0
FR;4;2020-12-28;0;0;0;0;0;0;0;0;0;0;0;0;0;0;0;0;0;0
FR;4;2020-12-29;0;0;0;0;0;0;0;0;0;0;0;0;0;0;0;0;0;0
FR;4;2020-12-30;0;0;0;0;0;0;0;0;0;0;0;0;0;0;0;0;0;0
FR;4;2020-12-31;0;0;0;0;0;0;0;0;0;0;0;0;0;0;0;0;0;0
FR;4;2021-01-01;0;0;0;0;0;0;0;0;0;0;0;0;0;0;0;0;0;0
FR;4;2021-01-02;0;0;0;0;0;0;0;0;0;0;0;0;0;0;0;0;0;0
FR;4;2021-01-03;0;0;0;0;0;0;0;0;0;0;0;0;0;0;0;0;0;0
FR;4;2021-01-04;0;0;0;0;0;0;0;0;0;0;0;0;0;0;0;0;0;0
FR;4;2021-01-05;0;0;0;0;0;0;0;0;0;0;0;0;0;0;0;0;0;0
FR;4;2021-01-06;0;0;0;0;0;0;0;0;0;0;0;0;0;0;0;0;0;0
FR;4;2021-01-07;0;0;0;0;0;0;0;0;0;0;0;0;0;0;0;0;0;0
FR;4;2021-01-08;0;0;0;0;0;0;0;0;0;0;0;0;0;0;0;0;0;0
FR;4;2021-01-09;0;0;0;0;0;0;0;0;0;0;0;0;0;0;0;0;0;0
FR;4;2021-01-10;0;0;0;0;0;0;0;0;0;0;0;0;0;0;0;0;0;0
FR;4;2021-01-11;0;0;0;0;0;0;0;0;0;0;0;0;0;0;0;0;0;0
FR;4;2021-01-12;0;0;0;0;0;0;0;0;0;0;0;0;0;0;0;0;0;0
FR;4;2021-01-13;0;0;0;0;0;0;0;0;0;0;0;0;0;0;0;0;0;0
FR;4;2021-01-14;0;0;0;0;0;0;0;0;0;0;0;0;0;0;0;0;0;0
FR;4;2021-01-15;0;0;0;0;0;0;0;0;0;0;0;0;0;0;0;0;0;0
FR;4;2021-01-16;0;0;0;0;0;0;0;0;0;0;0;0;0;0;0;0;0;0
FR;4;2021-01-17;0;0;0;0;0;0;0;0;0;0;0;0;0;0;0;0;0;0
FR;4;2021-01-18;0;0;0;0;0;0;0;0;0;0;0;0;0;0;0;0;0;0
FR;4;2021-01-19;0;0;0;0;0;0;0;0;0;0;0;0;0;0;0;0;0;0
FR;4;2021-01-20;0;0;0;0;0;0;0;0;0;0;0;0;0;0;0;0;0;0
FR;4;2021-01-21;0;0;0;0;0;0;0;0;0;0;0;0;0;0;0;0;0;0
FR;4;2021-01-22;0;0;0;0;0;0;0;0;0;0;0;0;0;0;0;0;0;0
FR;4;2021-01-23;0;0;0;0;0;0;0;0;0;0;0;0;0;0;0;0;0;0
FR;4;2021-01-24;0;0;0;0;0;0;0;0;0;0;0;0;0;0;0;0;0;0
FR;4;2021-01-25;0;0;0;0;0;0;0;0;0;0;0;0;0;0;0;0;0;0
FR;4;2021-01-26;0;0;0;0;0;0;0;0;0;0;0;0;0;0;0;0;0;0
FR;4;2021-01-27;0;0;0;0;0;0;0;0;0;0;0;0;0;0;0;0;0;0
FR;4;2021-01-28;0;0;0;0;0;0;0;0;0;0;0;0;0;0;0;0;0;0
FR;4;2021-01-29;0;0;0;0;0;0;0;0;0;0;0;0;0;0;0;0;0;0
FR;4;2021-01-30;0;0;0;0;0;0;0;0;0;0;0;0;0;0;0;0;0;0
FR;4;2021-01-31;0;0;0;0;0;0;0;0;0;0;0;0;0;0;0;0;0;0
FR;4;2021-02-01;0;0;0;0;0;0;0;0;0;0;0;0;0;0;0;0;0;0
FR;4;2021-02-02;0;0;0;0;0;0;0;0;0;0;0;0;0;0;0;0;0;0
FR;4;2021-02-03;0;0;0;0;0;0;0;0;0;0;0;0;0;0;0;0;0;0
FR;4;2021-02-04;0;0;0;0;0;0;0;0;0;0;0;0;0;0;0;0;0;0
FR;4;2021-02-05;0;0;0;0;0;0;0;0;0;0;0;0;0;0;0;0;0;0
FR;4;2021-02-06;0;0;0;0;0;0;0;0;0;0;0;0;0;0;0;0;0;0
FR;4;2021-02-07;0;0;0;0;0;0;0;0;0;0;0;0;0;0;0;0;0;0
FR;4;2021-02-08;0;0;0;0;0;0;0;0;0;0;0;0;0;0;0;0;0;0
FR;4;2021-02-09;0;0;0;0;0;0;0;0;0;0;0;0;0;0;0;0;0;0
FR;4;2021-02-10;0;0;0;0;0;0;0;0;0;0;0;0;0;0;0;0;0;0
FR;4;2021-02-11;0;0;0;0;0;0;0;0;0;0;0;0;0;0;0;0;0;0
FR;4;2021-02-12;0;0;0;0;0;0;0;0;0;0;0;0;0;0;0;0;0;0
FR;4;2021-02-13;0;0;0;0;0;0;0;0;0;0;0;0;0;0;0;0;0;0
FR;4;2021-02-14;0;0;0;0;0;0;0;0;0;0;0;0;0;0;0;0;0;0
FR;4;2021-02-15;0;0;0;0;0;0;0;0;0;0;0;0;0;0;0;0;0;0
FR;4;2021-02-16;0;0;0;0;0;0;0;0;0;0;0;0;0;0;0;0;0;0
FR;4;2021-02-17;0;0;0;0;0;0;0;0;0;0;0;0;0;0;0;0;0;0
FR;4;2021-02-18;0;0;0;0;0;0;0;0;0;0;0;0;0;0;0;0;0;0
FR;4;2021-02-19;0;0;0;0;0;0;0;0;0;0;0;0;0;0;0;0;0;0
FR;4;2021-02-20;0;0;0;0;0;0;0;0;0;0;0;0;0;0;0;0;0;0
FR;4;2021-02-21;0;0;0;0;0;0;0;0;0;0;0;0;0;0;0;0;0;0
FR;4;2021-02-22;0;0;0;0;0;0;0;0;0;0;0;0;0;0;0;0;0;0
FR;4;2021-02-23;0;0;0;0;0;0;0;0;0;0;0;0;0;0;0;0;0;0
FR;4;2021-02-24;0;0;0;0;0;0;0;0;0;0;0;0;0;0;0;0;0;0
FR;4;2021-02-25;0;0;0;0;0;0;0;0;0;0;0;0;0;0;0;0;0;0
FR;4;2021-02-26;0;0;0;0;0;0;0;0;0;0;0;0;0;0;0;0;0;0
FR;4;2021-02-27;0;0;0;0;0;0;0;0;0;0;0;0;0;0;0;0;0;0
FR;4;2021-02-28;0;0;0;0;0;0;0;0;0;0;0;0;0;0;0;0;0;0
FR;4;2021-03-01;0;0;0;0;0;0;0;0;0;0;0;0;0;0;0;0;0;0
FR;4;2021-03-02;0;0;0;0;0;0;0;0;0;0;0;0;0;0;0;0;0;0
FR;4;2021-03-03;0;0;0;0;0;0;0;0;0;0;0;0;0;0;0;0;0;0
FR;4;2021-03-04;0;0;0;0;0;0;0;0;0;0;0;0;0;0;0;0;0;0
FR;4;2021-03-05;0;0;0;0;0;0;0;0;0;0;0;0;0;0;0;0;0;0
FR;4;2021-03-06;0;0;0;0;0;0;0;0;0;0;0;0;0;0;0;0;0;0
FR;4;2021-03-07;0;0;0;0;0;0;0;0;0;0;0;0;0;0;0;0;0;0
FR;4;2021-03-08;0;0;0;0;0;0;0;0;0;0;0;0;0;0;0;0;0;0
FR;4;2021-03-09;0;0;0;0;0;0;0;0;0;0;0;0;0;0;0;0;0;0
FR;4;2021-03-10;0;0;0;0;0;0;0;0;0;0;0;0;0;0;0;0;0;0
FR;4;2021-03-11;0;0;0;0;0;0;0;0;0;0;0;0;0;0;0;0;0;0
FR;4;2021-03-12;0;0;0;0;0;0;0;0;0;0;0;0;0;0;0;0;0;0
FR;4;2021-03-13;0;0;0;0;0;0;0;0;0;0;0;0;0;0;0;0;0;0
FR;4;2021-03-14;0;0;0;0;0;0;0;0;0;0;0;0;0;0;0;0;0;0
FR;4;2021-03-15;0;0;0;0;0;0;0;0;0;0;0;0;0;0;0;0;0;0
FR;4;2021-03-16;0;0;0;0;0;0;0;0;0;0;0;0;0;0;0;0;0;0
FR;4;2021-03-17;0;0;0;0;0;0;0;0;0;0;0;0;0;0;0;0;0;0
FR;4;2021-03-18;0;0;0;0;0;0;0;0;0;0;0;0;0;0;0;0;0;0
FR;4;2021-03-19;0;0;0;0;0;0;0;0;0;0;0;0;0;0;0;0;0;0
FR;4;2021-03-20;0;0;0;0;0;0;0;0;0;0;0;0;0;0;0;0;0;0
FR;4;2021-03-21;0;0;0;0;0;0;0;0;0;0;0;0;0;0;0;0;0;0
FR;4;2021-03-22;0;0;0;0;0;0;0;0;0;0;0;0;0;0;0;0;0;0
FR;4;2021-03-23;0;0;0;0;0;0;0;0;0;0;0;0;0;0;0;0;0;0
FR;4;2021-03-24;0;0;0;0;0;0;0;0;0;0;0;0;0;0;0;0;0;0
FR;4;2021-03-25;0;0;0;0;0;0;0;0;0;0;0;0;0;0;0;0;0;0
FR;4;2021-03-26;0;0;0;0;0;0;0;0;0;0;0;0;0;0;0;0;0;0
FR;4;2021-03-27;0;0;0;0;0;0;0;0;0;0;0;0;0;0;0;0;0;0
FR;4;2021-03-28;0;0;0;0;0;0;0;0;0;0;0;0;0;0;0;0;0;0
FR;4;2021-03-29;0;0;0;0;0;0;0;0;0;0;0;0;0;0;0;0;0;0
FR;4;2021-03-30;0;0;0;0;0;0;0;0;0;0;0;0;0;0;0;0;0;0
FR;4;2021-03-31;0;0;0;0;0;0;0;0;0;0;0;0;0;0;0;0;0;0
FR;4;2021-04-01;0;0;0;0;0;0;0;0;0;0;0;0;0;0;0;0;0;0
FR;4;2021-04-02;0;0;0;0;0;0;0;0;0;0;0;0;0;0;0;0;0;0
FR;4;2021-04-03;0;0;0;0;0;0;0;0;0;0;0;0;0;0;0;0;0;0
FR;4;2021-04-04;0;0;0;0;0;0;0;0;0;0;0;0;0;0;0;0;0;0
FR;4;2021-04-05;0;0;0;0;0;0;0;0;0;0;0;0;0;0;0;0;0;0
FR;4;2021-04-06;0;0;0;0;0;0;0;0;0;0;0;0;0;0;0;0;0;0
FR;4;2021-04-07;0;0;0;0;0;0;0;0;0;0;0;0;0;0;0;0;0;0
FR;4;2021-04-08;0;0;0;0;0;0;0;0;0;0;0;0;0;0;0;0;0;0
FR;4;2021-04-09;0;0;0;0;0;0;0;0;0;0;0;0;0;0;0;0;0;0
FR;4;2021-04-10;0;0;0;0;0;0;0;0;0;0;0;0;0;0;0;0;0;0
FR;4;2021-04-11;0;0;0;0;0;0;0;0;0;0;0;0;0;0;0;0;0;0
FR;4;2021-04-12;0;0;0;0;0;0;0;0;0;0;0;0;0;0;0;0;0;0
FR;4;2021-04-13;0;0;0;0;0;0;0;0;0;0;0;0;0;0;0;0;0;0
FR;4;2021-04-14;0;0;0;0;0;0;0;0;0;0;0;0;0;0;0;0;0;0
FR;4;2021-04-15;0;0;0;0;0;0;0;0;0;0;0;0;0;0;0;0;0;0
FR;4;2021-04-16;0;0;0;0;0;0;0;0;0;0;0;0;0;0;0;0;0;0
FR;4;2021-04-17;0;0;0;0;0;0;0;0;0;0;0;0;0;0;0;0;0;0
FR;4;2021-04-18;0;0;0;0;0;0;0;0;0;0;0;0;0;0;0;0;0;0
FR;4;2021-04-19;0;0;0;0;0;0;0;0;0;0;0;0;0;0;0;0;0;0
FR;4;2021-04-20;0;0;0;0;0;0;0;0;0;0;0;0;0;0;0;0;0;0
FR;4;2021-04-21;0;0;0;0;0;0;0;0;0;0;0;0;0;0;0;0;0;0
FR;4;2021-04-22;0;0;0;0;0;0;0;0;0;0;0;0;0;0;0;0;0;0
FR;4;2021-04-23;3660;0;0;0;3622;0;0;0;0;3660;0;0;0;3622;0;0;0;0
FR;4;2021-04-24;1570;1;0;0;1559;0;0;0;0;5230;1;0;0;5181;0;0;0;0
FR;4;2021-04-25;125;0;0;0;125;0;0;0;0;5355;1;0;0;5306;0;0;0;0
FR;4;2021-04-26;2872;1;0;0;2862;0;0;0;0;8227;2;0;0;8168;0;0;0;0
FR;4;2021-04-27;9520;3;0;0;9501;0;0;0;0;17747;5;0;0;17669;0;0;0;0
FR;4;2021-04-28;9910;6;0;0;9885;0;0;0;0;27657;11;0;0;27554;0;0;0;0
FR;4;2021-04-29;15995;8;0;0;15979;0;0;0;0;43652;19;0;0;43533;0;0;0;0
FR;4;2021-04-30;19234;10;0;0;19205;0;0;0;0;62886;29;0;0;62738;0;0;0;0
FR;4;2021-05-01;1994;6;0;0;1992;0;0;0;0;64880;35;0;0;64730;0;0;0;0
FR;4;2021-05-02;484;0;0;0;482;0;0;0;0;65364;35;0;0;65212;0;0;0;0
FR;4;2021-05-03;5066;2;0;0;5059;0;0;0;0;70430;37;0;0;70271;0;0;0;0
FR;4;2021-05-04;8411;11;0;0;8400;0;0;0;0;78841;48;0;0;78671;0;0;0;0
FR;4;2021-05-05;6193;7;0;0;6188;0;0;0;0;85034;55;0;0;84859;0;0;0;0
FR;4;2021-05-06;11388;11;0;0;11385;0;0;0;0;96422;66;0;0;96244;0;0;0;0
FR;4;2021-05-07;19126;9;0;0;19087;0;0;0;0;115548;75;0;0;115331;0;0;0;0
FR;4;2021-05-08;2376;7;0;0;2380;0;0;0;0;117924;82;0;0;117711;0;0;0;0
FR;4;2021-05-09;692;3;0;0;693;0;0;0;0;118616;85;0;0;118404;0;0;0;0
FR;4;2021-05-10;7246;5;1;0;7243;0;0;0;0;125862;90;1;0;125647;0;0;0;0
FR;4;2021-05-11;14325;13;0;0;14305;0;0;0;0;140187;103;1;0;139952;0;0;0;0
FR;4;2021-05-12;10176;15;0;0;10179;0;0;0;0;150363;118;1;0;150131;0;0;0;0
FR;4;2021-05-13;1584;4;0;0;1585;0;0;0;0;151947;122;1;0;151716;0;0;0;0
FR;4;2021-05-14;7768;7;0;0;7763;0;0;0;0;159715;129;1;0;159479;0;0;0;0
FR;4;2021-05-15;3721;8;1;0;3720;0;0;0;0;163436;137;2;0;163199;0;0;0;0
FR;4;2021-05-16;417;1;0;0;417;0;0;0;0;163853;138;2;0;163616;0;0;0;0
FR;4;2021-05-17;4485;8;0;0;4484;0;0;0;0;168338;146;2;0;168100;0;0;0;0
FR;4;2021-05-18;8769;10;0;0;8769;0;0;0;0;177107;156;2;0;176869;0;0;0;0
FR;4;2021-05-19;5699;7;0;0;5701;0;0;0;0;182806;163;2;0;182570;0;0;0;0
FR;4;2021-05-20;9487;8;0;0;9479;0;0;0;0;192293;171;2;0;192049;0;0;0;0
FR;4;2021-05-21;12816;30;0;0;12823;0;0;0;0;205109;201;2;0;204872;0;0;0;0
FR;4;2021-05-22;5063;15;0;0;5070;0;0;0;0;210172;216;2;0;209942;0;0;0;0
FR;4;2021-05-23;498;4;0;0;501;0;0;0;0;210670;220;2;0;210443;0;0;0;0
FR;4;2021-05-24;1062;7;0;0;1066;0;0;0;0;211732;227;2;0;211509;0;0;0;0
FR;4;2021-05-25;7637;16;0;0;7643;0;0;0;0;219369;243;2;0;219152;0;0;0;0
FR;4;2021-05-26;7731;16;0;0;7739;0;0;0;0;227100;259;2;0;226891;0;0;0;0
FR;4;2021-05-27;14340;35;0;0;14349;0;0;0;0;241440;294;2;0;241240;0;0;0;0
FR;4;2021-05-28;26593;82;1;0;26634;0;0;0;0;268033;376;3;0;267874;0;0;0;0
FR;4;2021-05-29;11385;19;0;0;11385;0;0;0;0;279418;395;3;0;279259;0;0;0;0
FR;4;2021-05-30;974;7;0;0;973;0;0;0;0;280392;402;3;0;280232;0;0;0;0
FR;4;2021-05-31;12701;21;0;0;12701;0;0;0;0;293093;423;3;0;292933;0;0;0;0
FR;4;2021-06-01;20283;48;1;0;20301;0;0;0;0;313376;471;4;0;313234;0;0;0;0
FR;4;2021-06-02;14526;33;0;0;14538;0;0;0;0;327902;504;4;0;327772;0;0;0;0
FR;4;2021-06-03;19436;24;1;0;19434;0;0;0;0;347338;528;5;0;347206;0;0;0;0
FR;4;2021-06-04;22520;48;0;0;22538;0;0;0;0;369858;576;5;0;369744;0;0;0;0
FR;4;2021-06-05;9717;32;0;0;9721;0;0;0;0;379575;608;5;0;379465;0;0;0;0
FR;4;2021-06-06;1041;2;0;0;1037;0;0;0;0;380616;610;5;0;380502;0;0;0;0
FR;4;2021-06-07;9230;19;0;0;9238;0;0;0;0;389846;629;5;0;389740;0;0;0;0
FR;4;2021-06-08;14613;32;0;0;14625;0;0;0;0;404459;661;5;0;404365;0;0;0;0
FR;4;2021-06-09;12218;25;0;0;12226;0;0;0;0;416677;686;5;0;416591;0;0;0;0
FR;4;2021-06-10;15408;30;0;0;15416;0;0;0;0;432085;716;5;0;432007;0;0;0;0
FR;4;2021-06-11;16990;57;0;0;17017;0;0;0;0;449075;773;5;0;449024;0;0;0;0
FR;4;2021-06-12;7453;27;0;0;7478;0;0;0;0;456528;800;5;0;456502;0;0;0;0
FR;4;2021-06-13;908;3;0;0;910;0;0;0;0;457436;803;5;0;457412;0;0;0;0
FR;4;2021-06-14;6652;27;0;0;6662;0;0;0;0;464088;830;5;0;464074;0;0;0;0
FR;4;2021-06-15;10896;39;0;0;10913;0;0;0;0;474984;869;5;0;474987;0;0;0;0
FR;4;2021-06-16;8909;17;0;0;8917;0;0;0;0;483893;886;5;0;483904;0;0;0;0
FR;4;2021-06-17;10903;36;0;0;10915;0;0;0;0;494796;922;5;0;494819;0;0;0;0
FR;4;2021-06-18;12427;45;0;0;12454;0;0;0;0;507223;967;5;0;507273;0;0;0;0
FR;4;2021-06-19;5568;25;0;0;5588;0;0;0;0;512791;992;5;0;512861;0;0;0;0
FR;4;2021-06-20;828;5;0;0;832;0;0;0;0;513619;997;5;0;513693;0;0;0;0
FR;4;2021-06-21;5107;21;0;0;5107;0;0;0;0;518726;1018;5;0;518800;0;0;0;0
FR;4;2021-06-22;7916;29;2;0;7934;0;0;0;0;526642;1047;7;0;526734;0;0;0;0
FR;4;2021-06-23;7106;43;2;0;7133;0;0;0;0;533748;1090;9;0;533867;0;0;0;0
FR;4;2021-06-24;8657;46;1;0;8689;0;0;0;0;542405;1136;10;0;542556;0;0;0;0
FR;4;2021-06-25;10179;41;2;0;10211;0;0;0;0;552584;1177;12;0;552767;0;0;0;0
FR;4;2021-06-26;4854;23;0;0;4871;0;0;0;0;557438;1200;12;0;557638;0;0;0;0
FR;4;2021-06-27;769;4;0;0;771;0;0;0;0;558207;1204;12;0;558409;0;0;0;0
FR;4;2021-06-28;4835;16;1;0;4844;0;0;0;0;563042;1220;13;0;563253;0;0;0;0
FR;4;2021-06-29;7110;28;2;0;7119;0;0;0;0;570152;1248;15;0;570372;0;0;0;0
FR;4;2021-06-30;6728;41;2;0;6756;0;0;0;0;576880;1289;17;0;577128;0;0;0;0
FR;4;2021-07-01;8213;42;0;0;8235;0;0;0;0;585093;1331;17;0;585363;0;0;0;0
FR;4;2021-07-02;9430;53;1;0;9470;0;0;0;0;594523;1384;18;0;594833;0;0;0;0
FR;4;2021-07-03;4848;20;0;0;4863;0;0;0;0;599371;1404;18;0;599696;0;0;0;0
FR;4;2021-07-04;690;5;0;0;692;0;0;0;0;600061;1409;18;0;600388;0;0;0;0
FR;4;2021-07-05;4775;19;2;0;4786;0;0;0;0;604836;1428;20;0;605174;0;0;0;0
FR;4;2021-07-06;7729;29;4;0;7742;0;0;0;0;612565;1457;24;0;612916;0;0;0;0
FR;4;2021-07-07;7088;34;2;0;7100;0;0;0;0;619653;1491;26;0;620016;0;0;0;0
FR;4;2021-07-08;9235;40;2;0;9258;0;0;0;0;628888;1531;28;0;629274;0;0;0;0
FR;4;2021-07-09;10282;34;1;0;10305;0;0;0;0;639170;1565;29;0;639579;0;0;0;0
FR;4;2021-07-10;4639;14;2;0;4646;0;0;0;0;643809;1579;31;0;644225;0;0;0;0
FR;4;2021-07-11;586;4;1;0;584;0;0;0;0;644395;1583;32;0;644809;0;0;0;0
FR;4;2021-07-12;5879;29;0;0;5901;0;0;0;0;650274;1612;32;0;650710;0;0;0;0
FR;4;2021-07-13;14231;29;0;0;14249;0;0;0;0;664505;1641;32;0;664959;0;0;0;0
FR;4;2021-07-14;2291;15;0;0;2291;0;0;0;0;666796;1656;32;0;667250;0;0;0;0
FR;4;2021-07-15;18239;37;0;0;18256;0;0;0;0;685035;1693;32;0;685506;0;0;0;0
FR;4;2021-07-16;22838;71;2;0;22888;0;0;0;0;707873;1764;34;0;708394;0;0;0;0
FR;4;2021-07-17;9741;20;0;0;9749;0;0;0;0;717614;1784;34;0;718143;0;0;0;0
FR;4;2021-07-18;1359;5;0;0;1362;0;0;0;0;718973;1789;34;0;719505;0;0;0;0
FR;4;2021-07-19;12991;30;1;0;13016;0;0;0;0;731964;1819;35;0;732521;0;0;0;0
FR;4;2021-07-20;17345;26;1;0;17361;0;0;0;0;749309;1845;36;0;749882;0;0;0;0
FR;4;2021-07-21;15623;33;0;0;15643;0;0;0;0;764932;1878;36;0;765525;0;0;0;0
FR;4;2021-07-22;18247;45;2;0;18271;0;0;0;0;783179;1923;38;0;783796;0;0;0;0
FR;4;2021-07-23;20420;57;7;0;20453;0;0;0;0;803599;1980;45;0;804249;0;0;0;0
FR;4;2021-07-24;9290;34;0;0;9305;0;0;0;0;812889;2014;45;0;813554;0;0;0;0
FR;4;2021-07-25;1356;11;0;0;1358;0;0;0;0;814245;2025;45;0;814912;0;0;0;0
FR;4;2021-07-26;11050;23;0;0;11057;0;0;0;0;825295;2048;45;0;825969;0;0;0;0
FR;4;2021-07-27;14688;35;3;0;14708;0;0;0;0;839983;2083;48;0;840677;0;0;0;0
FR;4;2021-07-28;12937;26;2;0;12954;0;0;0;0;852920;2109;50;0;853631;0;0;0;0
FR;4;2021-07-29;14098;54;4;0;14140;0;0;0;0;867018;2163;54;0;867771;0;0;0;0
FR;4;2021-07-30;15503;46;2;0;15533;0;0;0;0;882521;2209;56;0;883304;0;0;0;0
FR;4;2021-07-31;6845;14;2;0;6855;0;0;0;0;889366;2223;58;0;890159;0;0;0;0
FR;4;2021-08-01;906;1;0;0;901;0;0;0;0;890272;2224;58;0;891060;0;0;0;0
FR;4;2021-08-02;7918;31;0;0;7919;0;0;0;0;898190;2255;58;0;898979;0;0;0;0
FR;4;2021-08-03;10805;31;2;0;10801;0;0;0;0;908995;2286;60;0;909780;0;0;0;0
FR;4;2021-08-04;9749;29;0;0;9748;0;0;0;0;918744;2315;60;0;919528;0;0;0;0
FR;4;2021-08-05;9831;42;0;0;9837;0;0;0;0;928575;2357;60;0;929365;0;0;0;0
FR;4;2021-08-06;10201;30;3;0;10198;0;0;0;0;938776;2387;63;0;939563;0;0;0;0
FR;4;2021-08-07;5100;30;1;0;5116;0;0;0;0;943876;2417;64;0;944679;0;0;0;0
FR;4;2021-08-08;1225;13;0;0;1228;0;0;0;0;945101;2430;64;0;945907;0;0;0;0
FR;4;2021-08-09;6350;31;0;0;6343;0;0;0;0;951451;2461;64;0;952250;0;0;0;0
FR;4;2021-08-10;8753;18;0;0;8724;0;0;0;0;960204;2479;64;0;960974;0;0;0;0
FR;4;2021-08-11;7945;34;4;0;7934;0;0;0;0;968149;2513;68;0;968908;0;0;0;0
FR;4;2021-08-12;8585;31;1;0;8573;0;0;0;0;976734;2544;69;0;977481;0;0;0;0
FR;4;2021-08-13;7561;25;0;1;7548;0;0;0;0;984295;2569;69;1;985029;0;0;0;0
FR;4;2021-08-14;3793;20;0;0;3777;0;0;0;0;988088;2589;69;1;988806;0;0;0;0
FR;4;2021-08-15;771;5;0;0;773;0;0;0;0;988859;2594;69;1;989579;0;0;0;0
FR;4;2021-08-16;4010;17;0;0;4005;0;0;0;0;992869;2611;69;1;993584;0;0;0;0
FR;4;2021-08-17;5634;17;1;0;5624;0;0;0;0;998503;2628;70;1;999208;0;0;0;0
FR;4;2021-08-18;5172;37;0;0;5189;0;0;0;0;1003675;2665;70;1;1004397;0;0;0;0
FR;4;2021-08-19;5489;34;3;0;5503;0;0;0;0;1009164;2699;73;1;1009900;0;0;0;0
FR;4;2021-08-20;5225;25;1;0;5235;0;0;0;0;1014389;2724;74;1;1015135;0;0;0;0
FR;4;2021-08-21;2311;23;1;0;2328;0;0;0;0;1016700;2747;75;1;1017463;0;0;0;0
FR;4;2021-08-22;414;2;0;0;415;0;0;0;0;1017114;2749;75;1;1017878;0;0;0;0
FR;4;2021-08-23;2938;21;1;0;2946;0;0;0;0;1020052;2770;76;1;1020824;0;0;0;0
FR;4;2021-08-24;3758;16;0;0;3761;0;0;0;0;1023810;2786;76;1;1024585;0;0;0;0
FR;4;2021-08-25;3546;25;1;0;3562;0;0;0;0;1027356;2811;77;1;1028147;0;0;0;0
FR;4;2021-08-26;3716;21;2;0;3728;0;0;0;0;1031072;2832;79;1;1031875;0;0;0;0
FR;4;2021-08-27;3617;31;2;0;3635;0;0;0;0;1034689;2863;81;1;1035510;0;0;0;0
FR;4;2021-08-28;1732;10;1;0;1737;0;0;0;0;1036421;2873;82;1;1037247;0;0;0;0
FR;4;2021-08-29;385;7;1;0;389;0;0;0;0;1036806;2880;83;1;1037636;0;0;0;0
FR;4;2021-08-30;2010;25;0;0;2018;16;0;0;0;1038816;2905;83;1;1039654;16;0;0;0
FR;4;2021-08-31;2487;21;0;0;2494;14;0;0;0;1041303;2926;83;1;1042148;30;0;0;0
FR;4;2021-09-01;2085;38;1;0;2096;22;0;0;0;1043388;2964;84;1;1044244;52;0;0;0
FR;4;2021-09-02;2309;31;4;0;2322;18;0;0;0;1045697;2995;88;1;1046566;70;0;0;0
FR;4;2021-09-03;2366;44;5;0;2375;36;0;0;0;1048063;3039;93;1;1048941;106;0;0;0
FR;4;2021-09-04;1374;18;0;0;1381;9;0;0;0;1049437;3057;93;1;1050322;115;0;0;0
FR;4;2021-09-05;434;2;0;0;434;2;0;0;0;1049871;3059;93;1;1050756;117;0;0;0
FR;4;2021-09-06;1713;62;0;0;1750;24;0;0;0;1051584;3121;93;1;1052506;141;0;0;0
FR;4;2021-09-07;1681;18;0;0;1690;8;0;0;0;1053265;3139;93;1;1054196;149;0;0;0
FR;4;2021-09-08;1286;26;3;0;1291;19;0;0;0;1054551;3165;96;1;1055487;168;0;0;0
FR;4;2021-09-09;1394;23;2;0;1404;9;0;0;0;1055945;3188;98;1;1056891;177;0;0;0
FR;4;2021-09-10;1522;31;2;0;1526;23;1;0;0;1057467;3219;100;1;1058417;200;1;0;0
FR;4;2021-09-11;746;11;0;0;749;3;0;0;0;1058213;3230;100;1;1059166;203;1;0;0
FR;4;2021-09-12;169;5;0;0;170;4;0;0;0;1058382;3235;100;1;1059336;207;1;0;0
FR;4;2021-09-13;1325;22;1;0;1328;16;0;0;0;1059707;3257;101;1;1060664;223;1;0;0
FR;4;2021-09-14;1507;9;2;0;1509;7;0;0;0;1061214;3266;103;1;1062173;230;1;0;0
FR;4;2021-09-15;1095;28;1;0;1098;25;0;0;0;1062309;3294;104;1;1063271;255;1;0;0
FR;4;2021-09-16;1108;22;2;0;1112;15;0;0;0;1063417;3316;106;1;1064383;270;1;0;0
FR;4;2021-09-17;898;21;1;0;905;12;0;0;0;1064315;3337;107;1;1065288;282;1;0;0
FR;4;2021-09-18;464;7;1;0;465;6;0;0;0;1064779;3344;108;1;1065753;288;1;0;0
FR;4;2021-09-19;182;3;0;0;183;2;0;0;0;1064961;3347;108;1;1065936;290;1;0;0
FR;4;2021-09-20;452;19;0;0;458;13;0;0;0;1065413;3366;108;1;1066394;303;1;0;0
FR;4;2021-09-21;434;11;0;0;436;7;0;0;0;1065847;3377;108;1;1066830;310;1;0;0
FR;4;2021-09-22;377;19;4;0;384;15;0;0;0;1066224;3396;112;1;1067214;325;1;0;0
FR;4;2021-09-23;488;15;1;0;489;14;0;0;0;1066712;3411;113;1;1067703;339;1;0;0
FR;4;2021-09-24;416;13;2;0;420;9;0;0;0;1067128;3424;115;1;1068123;348;1;0;0
FR;4;2021-09-25;281;10;1;0;282;5;0;0;0;1067409;3434;116;1;1068405;353;1;0;0
FR;4;2021-09-26;75;2;0;0;76;1;0;0;0;1067484;3436;116;1;1068481;354;1;0;0
FR;4;2021-09-27;270;10;1;0;271;8;0;0;0;1067754;3446;117;1;1068752;362;1;0;0
FR;4;2021-09-28;319;8;0;0;319;8;0;0;0;1068073;3454;117;1;1069071;370;1;0;0
FR;4;2021-09-29;378;19;1;0;380;13;0;0;0;1068451;3473;118;1;1069451;383;1;0;0
FR;4;2021-09-30;367;41;0;0;381;22;0;0;0;1068818;3514;118;1;1069832;405;1;0;0
FR;4;2021-10-01;411;56;0;0;413;50;0;0;0;1069229;3570;118;1;1070245;455;1;0;0
FR;4;2021-10-02;196;23;1;0;198;14;0;0;0;1069425;3593;119;1;1070443;469;1;0;0
FR;4;2021-10-03;86;1;0;0;87;0;0;0;0;1069511;3594;119;1;1070530;469;1;0;0
FR;4;2021-10-04;363;20;1;0;367;16;0;0;0;1069874;3614;120;1;1070897;485;1;0;0
FR;4;2021-10-05;286;19;2;0;288;15;0;0;0;1070160;3633;122;1;1071185;500;1;0;0
FR;4;2021-10-06;249;23;1;0;254;18;0;0;0;1070409;3656;123;1;1071439;518;1;0;0
FR;4;2021-10-07;268;25;2;0;273;13;0;0;0;1070677;3681;125;1;1071712;531;1;0;0
FR;4;2021-10-08;357;24;2;0;360;20;0;0;0;1071034;3705;127;1;1072072;551;1;0;0
FR;4;2021-10-09;194;6;6;0;195;7;0;0;0;1071228;3711;133;1;1072267;558;1;0;0
FR;4;2021-10-10;97;3;2;0;99;3;0;0;0;1071325;3714;135;1;1072366;561;1;0;0
FR;4;2021-10-11;252;15;1;0;253;14;0;0;0;1071577;3729;136;1;1072619;575;1;0;0
FR;4;2021-10-12;211;14;0;0;211;13;0;0;0;1071788;3743;136;1;1072830;588;1;0;0
FR;4;2021-10-13;221;28;1;0;224;25;0;0;0;1072009;3771;137;1;1073054;613;1;0;0
FR;4;2021-10-14;316;21;4;0;320;15;0;0;0;1072325;3792;141;1;1073374;628;1;0;0
FR;4;2021-10-15;324;24;5;0;325;25;0;0;0;1072649;3816;146;1;1073699;653;1;0;0
FR;4;2021-10-16;167;6;2;0;167;6;0;0;0;1072816;3822;148;1;1073866;659;1;0;0
FR;4;2021-10-17;70;2;0;0;71;1;0;0;0;1072886;3824;148;1;1073937;660;1;0;0
FR;4;2021-10-18;282;16;1;0;284;13;0;0;0;1073168;3840;149;1;1074221;673;1;0;0
FR;4;2021-10-19;215;15;2;0;215;16;0;0;0;1073383;3855;151;1;1074436;689;1;0;0
FR;4;2021-10-20;232;27;4;0;235;15;0;0;0;1073615;3882;155;1;1074671;704;1;0;0
FR;4;2021-10-21;244;18;0;0;246;14;0;0;0;1073859;3900;155;1;1074917;718;1;0;0
FR;4;2021-10-22;217;25;2;0;219;20;1;0;0;1074076;3925;157;1;1075136;738;2;0;0
FR;4;2021-10-23;117;16;1;0;118;15;0;0;0;1074193;3941;158;1;1075254;753;2;0;0
FR;4;2021-10-24;39;4;0;0;39;1;0;0;0;1074232;3945;158;1;1075293;754;2;0;0
FR;4;2021-10-25;218;7;2;0;218;9;0;0;0;1074450;3952;160;1;1075511;763;2;0;0
FR;4;2021-10-26;200;14;0;0;202;12;0;0;0;1074650;3966;160;1;1075713;775;2;0;0
FR;4;2021-10-27;196;12;4;0;196;12;2;0;0;1074846;3978;164;1;1075909;787;4;0;0
FR;4;2021-10-28;187;18;5;0;187;22;0;0;0;1075033;3996;169;1;1076096;809;4;0;0
FR;4;2021-10-29;227;18;2;0;228;16;0;0;0;1075260;4014;171;1;1076324;825;4;0;0
FR;4;2021-10-30;104;2;1;0;105;2;0;0;0;1075364;4016;172;1;1076429;827;4;0;0
FR;4;2021-10-31;59;3;2;0;60;3;0;0;0;1075423;4019;174;1;1076489;830;4;0;0
FR;4;2021-11-01;76;27;4;0;77;24;3;0;0;1075499;4046;178;1;1076566;854;7;0;0
FR;4;2021-11-02;164;21;2;0;165;21;0;0;0;1075663;4067;180;1;1076731;875;7;0;0
FR;4;2021-11-03;133;21;8;1;134;19;6;0;0;1075796;4088;188;2;1076865;894;13;0;0
FR;4;2021-11-04;187;15;1;0;188;12;1;0;0;1075983;4103;189;2;1077053;906;14;0;0
FR;4;2021-11-05;131;17;1;0;132;16;0;0;0;1076114;4120;190;2;1077185;922;14;0;0
FR;4;2021-11-06;82;6;1;0;82;6;0;0;0;1076196;4126;191;2;1077267;928;14;0;0
FR;4;2021-11-07;83;2;2;0;83;4;0;0;0;1076279;4128;193;2;1077350;932;14;0;0
FR;4;2021-11-08;162;20;1;0;163;20;0;0;0;1076441;4148;194;2;1077513;952;14;0;0
FR;4;2021-11-09;159;14;3;0;159;16;0;0;0;1076600;4162;197;2;1077672;968;14;0;0
FR;4;2021-11-10;121;30;7;0;121;33;2;0;0;1076721;4192;204;2;1077793;1001;16;0;0
FR;4;2021-11-11;100;10;1;0;100;11;0;0;0;1076821;4202;205;2;1077893;1012;16;0;0
FR;4;2021-11-12;107;19;2;0;108;18;1;0;0;1076928;4221;207;2;1078001;1030;17;0;0
FR;4;2021-11-13;75;15;2;0;76;14;0;0;0;1077003;4236;209;2;1078077;1044;17;0;0
FR;4;2021-11-14;55;5;4;0;56;8;0;0;0;1077058;4241;213;2;1078133;1052;17;0;0
FR;4;2021-11-15;99;26;2;0;101;24;2;0;0;1077157;4267;215;2;1078234;1076;19;0;0
FR;4;2021-11-16;112;14;3;0;112;17;0;0;0;1077269;4281;218;2;1078346;1093;19;0;0
FR;4;2021-11-17;122;30;4;0;122;30;1;0;0;1077391;4311;222;2;1078468;1123;20;0;0
FR;4;2021-11-18;103;34;14;0;105;43;1;0;0;1077494;4345;236;2;1078573;1166;21;0;0
FR;4;2021-11-19;89;21;3;0;89;22;1;0;0;1077583;4366;239;2;1078662;1188;22;0;0
FR;4;2021-11-20;78;8;1;0;78;8;0;0;0;1077661;4374;240;2;1078740;1196;22;0;0
FR;4;2021-11-21;70;7;2;0;70;9;0;0;0;1077731;4381;242;2;1078810;1205;22;0;0
FR;4;2021-11-22;109;28;9;0;110;33;2;0;0;1077840;4409;251;2;1078920;1238;24;0;0
FR;4;2021-11-23;78;31;6;0;79;29;2;0;0;1077918;4440;257;2;1078999;1267;26;0;0
FR;4;2021-11-24;91;23;12;0;93;25;4;0;0;1078009;4463;269;2;1079092;1292;30;0;0
FR;4;2021-11-25;96;28;19;0;97;35;5;0;0;1078105;4491;288;2;1079189;1327;35;0;0
FR;4;2021-11-26;86;43;12;0;90;45;3;0;0;1078191;4534;300;2;1079279;1372;38;0;0
FR;4;2021-11-27;42;22;15;0;42;25;10;0;0;1078233;4556;315;2;1079321;1397;48;0;0
FR;4;2021-11-28;53;8;0;0;54;7;0;0;0;1078286;4564;315;2;1079375;1404;48;0;0
FR;4;2021-11-29;90;31;16;0;90;40;2;0;0;1078376;4595;331;2;1079465;1444;50;0;0
FR;4;2021-11-30;77;37;13;0;77;42;2;0;0;1078453;4632;344;2;1079542;1486;52;0;0
FR;4;2021-12-01;88;60;19;0;88;67;11;0;0;1078541;4692;363;2;1079630;1553;63;0;0
FR;4;2021-12-02;114;48;21;0;118;56;3;0;0;1078655;4740;384;2;1079748;1609;66;0;0
FR;4;2021-12-03;105;36;15;0;105;44;4;0;0;1078760;4776;399;2;1079853;1653;70;0;0
FR;4;2021-12-04;73;31;18;0;75;44;1;0;0;1078833;4807;417;2;1079928;1697;71;0;0
FR;4;2021-12-05;64;7;1;0;65;7;0;0;0;1078897;4814;418;2;1079993;1704;71;0;0
FR;4;2021-12-06;112;46;20;0;112;60;3;0;0;1079009;4860;438;2;1080105;1764;74;0;0
FR;4;2021-12-07;85;37;9;0;88;36;3;0;0;1079094;4897;447;2;1080193;1800;77;0;0
FR;4;2021-12-08;74;31;17;0;76;38;7;0;0;1079168;4928;464;2;1080269;1838;84;0;0
FR;4;2021-12-09;65;32;10;1;65;39;3;0;0;1079233;4960;474;3;1080334;1877;87;0;0
FR;4;2021-12-10;64;64;20;0;65;68;10;0;0;1079297;5024;494;3;1080399;1945;97;0;0
FR;4;2021-12-11;30;34;7;0;30;34;3;0;0;1079327;5058;501;3;1080429;1979;100;0;0
FR;4;2021-12-12;30;12;3;0;30;15;0;0;0;1079357;5070;504;3;1080459;1994;100;0;0
FR;4;2021-12-13;79;40;14;0;81;49;2;0;0;1079436;5110;518;3;1080540;2043;102;0;0
FR;4;2021-12-14;61;43;18;0;62;55;2;0;0;1079497;5153;536;3;1080602;2098;104;0;0
FR;4;2021-12-15;68;65;29;0;68;86;6;0;0;1079565;5218;565;3;1080670;2184;110;0;0
FR;4;2021-12-16;35;45;18;0;36;58;3;0;0;1079600;5263;583;3;1080706;2242;113;0;0
FR;4;2021-12-17;39;55;11;0;39;59;6;0;0;1079639;5318;594;3;1080745;2301;119;0;0
FR;4;2021-12-18;49;31;3;0;50;33;0;0;0;1079688;5349;597;3;1080795;2334;119;0;0
FR;4;2021-12-19;17;4;1;0;18;4;0;0;0;1079705;5353;598;3;1080813;2338;119;0;0
FR;4;2021-12-20;45;38;10;0;46;41;6;0;0;1079750;5391;608;3;1080859;2379;125;0;0
FR;4;2021-12-21;32;32;17;0;34;39;5;0;0;1079782;5423;625;3;1080893;2418;130;0;0
FR;4;2021-12-22;37;39;10;0;38;39;7;0;0;1079819;5462;635;3;1080931;2457;137;0;0
FR;4;2021-12-23;41;45;8;0;41;49;2;0;0;1079860;5507;643;3;1080972;2506;139;0;0
FR;4;2021-12-24;25;28;10;0;27;31;4;0;0;1079885;5535;653;3;1080999;2537;143;0;0
FR;4;2021-12-25;7;3;3;0;7;4;2;0;0;1079892;5538;656;3;1081006;2541;145;0;0
FR;4;2021-12-26;5;3;1;0;6;2;0;0;0;1079897;5541;657;3;1081012;2543;145;0;0
FR;4;2021-12-27;31;41;9;0;32;43;4;0;0;1079928;5582;666;3;1081044;2586;149;0;0
FR;4;2021-12-28;28;28;7;0;30;29;4;0;0;1079956;5610;673;3;1081074;2615;153;0;0
FR;4;2021-12-29;56;25;11;0;57;30;5;0;0;1080012;5635;684;3;1081131;2645;158;0;0
FR;4;2021-12-30;48;19;12;0;51;22;5;0;0;1080060;5654;696;3;1081182;2667;163;0;0
FR;4;2021-12-31;20;7;8;0;21;12;2;0;0;1080080;5661;704;3;1081203;2679;165;0;0
FR;4;2022-01-01;7;4;5;0;7;7;1;0;0;1080087;5665;709;3;1081210;2686;166;0;0
FR;4;2022-01-02;43;5;16;0;43;20;1;0;0;1080130;5670;725;3;1081253;2706;167;0;0
FR;4;2022-01-03;45;55;25;1;47;65;10;0;0;1080175;5725;750;4;1081300;2771;177;0;0
FR;4;2022-01-04;44;28;16;0;45;33;8;0;0;1080219;5753;766;4;1081345;2804;185;0;0
FR;4;2022-01-05;52;24;19;0;58;27;9;0;0;1080271;5777;785;4;1081403;2831;194;0;0
FR;4;2022-01-06;52;24;24;0;52;40;8;0;0;1080323;5801;809;4;1081455;2871;202;0;0
FR;4;2022-01-07;31;20;16;0;33;21;12;0;0;1080354;5821;825;4;1081488;2892;214;0;0
FR;4;2022-01-08;13;6;10;0;14;12;3;0;0;1080367;5827;835;4;1081502;2904;217;0;0
FR;4;2022-01-09;20;2;3;0;21;4;0;0;0;1080387;5829;838;4;1081523;2908;217;0;0
FR;4;2022-01-10;53;22;19;0;53;36;4;0;0;1080440;5851;857;4;1081576;2944;221;0;0
FR;4;2022-01-11;30;31;12;0;34;35;1;0;0;1080470;5882;869;4;1081610;2979;222;0;0
FR;4;2022-01-12;35;21;13;0;37;23;9;0;0;1080505;5903;882;4;1081647;3002;231;0;0
FR;4;2022-01-13;55;20;27;0;56;38;8;0;0;1080560;5923;909;4;1081703;3040;239;0;0
FR;4;2022-01-14;25;32;13;0;26;35;7;0;0;1080585;5955;922;4;1081729;3075;246;0;0
FR;4;2022-01-15;15;6;8;0;16;12;1;0;0;1080600;5961;930;4;1081745;3087;247;0;0
FR;4;2022-01-16;13;9;14;0;13;22;1;0;0;1080613;5970;944;4;1081758;3109;248;0;0
FR;4;2022-01-17;27;20;15;0;27;29;5;0;0;1080640;5990;959;4;1081785;3138;253;0;0
FR;4;2022-01-18;17;14;10;0;17;21;3;0;0;1080657;6004;969;4;1081802;3159;256;0;0
FR;4;2022-01-19;33;23;13;0;33;34;1;0;0;1080690;6027;982;4;1081835;3193;257;0;0
FR;4;2022-01-20;34;34;13;0;36;39;5;0;0;1080724;6061;995;4;1081871;3232;262;0;0
FR;4;2022-01-21;13;12;20;1;13;17;15;0;1;1080737;6073;1015;5;1081884;3249;277;0;1
FR;4;2022-01-22;30;13;3;0;30;14;2;0;0;1080767;6086;1018;5;1081914;3263;279;0;1
FR;4;2022-01-23;8;2;7;0;8;9;0;0;0;1080775;6088;1025;5;1081922;3272;279;0;1
FR;4;2022-01-24;14;21;9;0;15;28;1;0;0;1080789;6109;1034;5;1081937;3300;280;0;1
FR;4;2022-01-25;22;32;10;1;23;38;3;0;0;1080811;6141;1044;6;1081960;3338;283;0;1
FR;4;2022-01-26;20;17;9;1;21;21;4;0;0;1080831;6158;1053;7;1081981;3359;287;0;1
FR;4;2022-01-27;22;19;8;0;23;25;1;0;0;1080853;6177;1061;7;1082004;3384;288;0;1
FR;4;2022-01-28;14;23;8;0;15;26;4;0;0;1080867;6200;1069;7;1082019;3410;292;0;1
FR;4;2022-01-29;17;6;5;0;17;10;0;0;0;1080884;6206;1074;7;1082036;3420;292;0;1
FR;4;2022-01-30;19;3;2;0;19;5;0;0;0;1080903;6209;1076;7;1082055;3425;292;0;1
FR;4;2022-01-31;22;28;8;0;22;32;2;0;0;1080925;6237;1084;7;1082077;3457;294;0;1
FR;4;2022-02-01;13;24;13;0;15;25;9;0;0;1080938;6261;1097;7;1082092;3482;303;0;1
FR;4;2022-02-02;19;12;14;2;20;20;7;0;0;1080957;6273;1111;9;1082112;3502;310;0;1
FR;4;2022-02-03;16;24;11;0;18;29;4;0;0;1080973;6297;1122;9;1082130;3531;314;0;1
FR;4;2022-02-04;7;5;7;0;7;9;3;0;0;1080980;6302;1129;9;1082137;3540;317;0;1
FR;4;2022-02-05;7;14;1;0;8;13;1;0;0;1080987;6316;1130;9;1082145;3553;318;0;1
FR;4;2022-02-06;8;4;4;0;8;7;1;0;0;1080995;6320;1134;9;1082153;3560;319;0;1
FR;4;2022-02-07;15;20;8;0;17;20;6;0;0;1081010;6340;1142;9;1082170;3580;325;0;1
FR;4;2022-02-08;20;21;13;1;22;22;10;0;0;1081030;6361;1155;10;1082192;3602;335;0;1
FR;4;2022-02-09;18;12;9;0;19;17;2;0;0;1081048;6373;1164;10;1082211;3619;337;0;1
FR;4;2022-02-10;23;23;10;0;24;25;7;0;0;1081071;6396;1174;10;1082235;3644;344;0;1
FR;4;2022-02-11;18;15;8;0;18;20;3;0;0;1081089;6411;1182;10;1082253;3664;347;0;1
FR;4;2022-02-12;24;6;3;0;26;7;0;0;0;1081113;6417;1185;10;1082279;3671;347;0;1
FR;4;2022-02-13;7;3;3;0;7;6;0;0;0;1081120;6420;1188;10;1082286;3677;347;0;1
FR;4;2022-02-14;22;10;10;0;22;16;4;0;0;1081142;6430;1198;10;1082308;3693;351;0;1
FR;4;2022-02-15;18;7;2;0;18;8;0;0;0;1081160;6437;1200;10;1082326;3701;351;0;1
FR;4;2022-02-16;17;11;11;0;17;18;3;0;0;1081177;6448;1211;10;1082343;3719;354;0;1
FR;4;2022-02-17;11;4;5;0;11;7;2;0;0;1081188;6452;1216;10;1082354;3726;356;0;1
FR;4;2022-02-18;16;15;8;0;16;21;2;0;0;1081204;6467;1224;10;1082370;3747;358;0;1
FR;4;2022-02-19;16;4;2;0;17;5;0;0;0;1081220;6471;1226;10;1082387;3752;358;0;1
FR;4;2022-02-20;9;4;0;0;10;3;0;0;0;1081229;6475;1226;10;1082397;3755;358;0;1
FR;4;2022-02-21;24;5;4;0;24;7;2;0;0;1081253;6480;1230;10;1082421;3762;360;0;1
FR;4;2022-02-22;9;5;10;0;10;10;4;0;0;1081262;6485;1240;10;1082431;3772;364;0;1
FR;4;2022-02-23;17;6;10;0;17;10;5;0;0;1081279;6491;1250;10;1082448;3782;369;0;1
FR;4;2022-02-24;11;5;4;0;11;7;2;0;0;1081290;6496;1254;10;1082459;3789;371;0;1
FR;4;2022-02-25;17;5;7;0;17;6;6;0;0;1081307;6501;1261;10;1082476;3795;377;0;1
FR;4;2022-02-26;27;3;1;0;27;4;0;0;0;1081334;6504;1262;10;1082503;3799;377;0;1
FR;4;2022-02-27;9;0;1;0;9;1;0;0;0;1081343;6504;1263;10;1082512;3800;377;0;1
FR;4;2022-02-28;18;3;2;0;19;3;1;0;0;1081361;6507;1265;10;1082531;3803;378;0;1
FR;4;2022-03-01;8;4;7;0;8;5;5;0;0;1081369;6511;1272;10;1082539;3808;383;0;1
FR;4;2022-03-02;16;3;6;0;17;7;1;0;0;1081385;6514;1278;10;1082556;3815;384;0;1
FR;4;2022-03-03;19;5;3;0;19;6;1;0;0;1081404;6519;1281;10;1082575;3821;385;0;1
FR;4;2022-03-04;7;8;2;1;7;6;3;0;0;1081411;6527;1283;11;1082582;3827;388;0;1
FR;4;2022-03-05;9;2;0;0;9;2;0;0;0;1081420;6529;1283;11;1082591;3829;388;0;1
FR;4;2022-03-06;4;0;1;0;4;1;0;0;0;1081424;6529;1284;11;1082595;3830;388;0;1
FR;4;2022-03-07;11;6;2;0;11;5;2;0;0;1081435;6535;1286;11;1082606;3835;390;0;1
FR;4;2022-03-08;15;3;0;0;15;3;0;0;0;1081450;6538;1286;11;1082621;3838;390;0;1
FR;4;2022-03-09;9;7;2;0;11;7;0;0;0;1081459;6545;1288;11;1082632;3845;390;0;1
FR;4;2022-03-10;6;1;6;0;6;3;4;0;0;1081465;6546;1294;11;1082638;3848;394;0;1
FR;4;2022-03-11;10;4;5;0;12;2;5;0;0;1081475;6550;1299;11;1082650;3850;399;0;1
FR;4;2022-03-12;10;2;0;0;11;0;0;0;0;1081485;6552;1299;11;1082661;3850;399;0;1
FR;4;2022-03-13;6;2;1;0;7;2;0;0;0;1081491;6554;1300;11;1082668;3852;399;0;1
FR;4;2022-03-14;4;3;1;0;5;3;0;0;0;1081495;6557;1301;11;1082673;3855;399;0;1
FR;4;2022-03-15;8;8;3;0;10;7;2;0;0;1081503;6565;1304;11;1082683;3862;401;0;1
FR;4;2022-03-16;7;3;4;0;7;4;3;0;0;1081510;6568;1308;11;1082690;3866;404;0;1
FR;4;2022-03-17;4;4;1;0;4;5;0;0;0;1081514;6572;1309;11;1082694;3871;404;0;1
FR;4;2022-03-18;9;3;0;0;9;3;0;0;0;1081523;6575;1309;11;1082703;3874;404;0;1
FR;4;2022-03-19;1;1;1;0;1;2;0;0;0;1081524;6576;1310;11;1082704;3876;404;0;1
FR;4;2022-03-20;3;1;2;0;3;2;1;0;0;1081527;6577;1312;11;1082707;3878;405;0;1
FR;4;2022-03-21;6;4;1;0;6;5;0;0;0;1081533;6581;1313;11;1082713;3883;405;0;1
FR;4;2022-03-22;4;2;2;0;4;3;1;0;0;1081537;6583;1315;11;1082717;3886;406;0;1
FR;4;2022-03-23;6;4;5;0;6;8;1;0;0;1081543;6587;1320;11;1082723;3894;407;0;1
FR;4;2022-03-24;2;5;3;1;2;7;2;0;0;1081545;6592;1323;12;1082725;3901;409;0;1
FR;4;2022-03-25;4;1;2;0;4;1;2;0;0;1081549;6593;1325;12;1082729;3902;411;0;1
FR;4;2022-03-26;5;5;0;0;5;5;0;0;0;1081554;6598;1325;12;1082734;3907;411;0;1
FR;4;2022-03-27;1;0;3;0;1;2;1;0;0;1081555;6598;1328;12;1082735;3909;412;0;1
FR;4;2022-03-28;6;1;3;0;7;3;0;0;0;1081561;6599;1331;12;1082742;3912;412;0;1
FR;4;2022-03-29;9;0;4;1;9;0;2;0;0;1081570;6599;1335;13;1082751;3912;414;0;1
FR;4;2022-03-30;3;4;0;0;3;4;0;0;0;1081573;6603;1335;13;1082754;3916;414;0;1
FR;4;2022-03-31;5;3;2;1;5;4;1;0;0;1081578;6606;1337;14;1082759;3920;415;0;1
FR;4;2022-04-01;15;3;5;0;15;6;2;0;0;1081593;6609;1342;14;1082774;3926;417;0;1
FR;4;2022-04-02;4;4;0;0;5;3;0;0;0;1081597;6613;1342;14;1082779;3929;417;0;1
FR;4;2022-04-03;0;1;0;0;0;1;0;0;0;1081597;6614;1342;14;1082779;3930;417;0;1
FR;4;2022-04-04;4;4;4;0;5;5;2;0;0;1081601;6618;1346;14;1082784;3935;419;0;1
FR;4;2022-04-05;4;3;3;1;5;3;3;0;0;1081605;6621;1349;15;1082789;3938;422;0;1
FR;4;2022-04-06;6;1;0;0;6;1;0;0;0;1081611;6622;1349;15;1082795;3939;422;0;1
FR;4;2022-04-07;3;2;3;2;3;5;0;0;0;1081614;6624;1352;17;1082798;3944;422;0;1
FR;4;2022-04-08;4;2;1;0;4;2;1;0;0;1081618;6626;1353;17;1082802;3946;423;0;1
FR;4;2022-04-09;0;0;1;1;0;1;1;0;0;1081618;6626;1354;18;1082802;3947;424;0;1
FR;4;2022-04-10;2;2;0;0;2;2;0;0;0;1081620;6628;1354;18;1082804;3949;424;0;1
FR;4;2022-04-11;4;3;4;0;4;5;2;0;0;1081624;6631;1358;18;1082808;3954;426;0;1
FR;4;2022-04-12;6;1;4;0;6;2;3;0;0;1081630;6632;1362;18;1082814;3956;429;0;1
FR;4;2022-04-13;5;8;2;1;5;10;1;0;0;1081635;6640;1364;19;1082819;3966;430;0;1
FR;4;2022-04-14;6;4;2;1;7;5;1;0;0;1081641;6644;1366;20;1082826;3971;431;0;1
FR;4;2022-04-15;7;9;1;0;7;10;0;0;0;1081648;6653;1367;20;1082833;3981;431;0;1
FR;4;2022-04-16;1;0;0;0;1;0;0;0;0;1081649;6653;1367;20;1082834;3981;431;0;1
FR;4;2022-04-17;3;2;1;0;3;3;0;0;0;1081652;6655;1368;20;1082837;3984;431;0;1
FR;4;2022-04-18;2;2;6;0;2;4;4;0;0;1081654;6657;1374;20;1082839;3988;435;0;1
FR;4;2022-04-19;3;1;1;0;3;1;1;0;0;1081657;6658;1375;20;1082842;3989;436;0;1
FR;4;2022-04-20;15;4;1;1;16;3;1;0;0;1081672;6662;1376;21;1082858;3992;437;0;1
FR;4;2022-04-21;7;1;0;0;7;1;0;0;0;1081679;6663;1376;21;1082865;3993;437;0;1
FR;4;2022-04-22;1;1;2;0;1;2;1;0;0;1081680;6664;1378;21;1082866;3995;438;0;1
FR;4;2022-04-23;2;3;3;0;2;6;0;0;0;1081682;6667;1381;21;1082868;4001;438;0;1
FR;4;2022-04-24;0;3;0;0;0;3;0;0;0;1081682;6670;1381;21;1082868;4004;438;0;1
FR;4;2022-04-25;3;5;3;0;3;8;0;0;0;1081685;6675;1384;21;1082871;4012;438;0;1
FR;4;2022-04-26;5;6;1;0;5;6;1;0;0;1081690;6681;1385;21;1082876;4018;439;0;1
FR;4;2022-04-27;4;1;1;2;5;1;2;0;0;1081694;6682;1386;23;1082881;4019;441;0;1
FR;4;2022-04-28;3;5;5;1;3;7;4;0;0;1081697;6687;1391;24;1082884;4026;445;0;1
FR;4;2022-04-29;6;3;0;0;6;2;0;0;0;1081703;6690;1391;24;1082890;4028;445;0;1
FR;4;2022-04-30;2;1;1;0;2;2;0;0;0;1081705;6691;1392;24;1082892;4030;445;0;1
FR;4;2022-05-01;0;0;0;0;0;0;0;0;0;1081705;6691;1392;24;1082892;4030;445;0;1
FR;4;2022-05-02;5;16;6;0;5;19;3;0;0;1081710;6707;1398;24;1082897;4049;448;0;1
FR;4;2022-05-03;2;6;2;0;2;7;1;0;0;1081712;6713;1400;24;1082899;4056;449;0;1
FR;4;2022-05-04;7;4;1;0;7;4;1;0;0;1081719;6717;1401;24;1082906;4060;450;0;1
FR;4;2022-05-05;5;2;1;1;6;1;2;0;0;1081724;6719;1402;25;1082912;4061;452;0;1
FR;4;2022-05-06;5;3;1;0;6;2;1;0;0;1081729;6722;1403;25;1082918;4063;453;0;1
FR;4;2022-05-07;0;1;0;0;0;1;0;0;0;1081729;6723;1403;25;1082918;4064;453;0;1
FR;4;2022-05-08;1;1;0;0;1;1;0;0;0;1081730;6724;1403;25;1082919;4065;453;0;1
FR;4;2022-05-09;5;1;0;1;5;1;1;0;0;1081735;6725;1403;26;1082924;4066;454;0;1
FR;4;2022-05-10;3;1;0;2;3;3;0;0;0;1081738;6726;1403;28;1082927;4069;454;0;1
FR;4;2022-05-11;4;2;4;0;4;5;1;0;0;1081742;6728;1407;28;1082931;4074;455;0;1
FR;4;2022-05-12;7;4;2;1;7;5;1;0;1;1081749;6732;1409;29;1082938;4079;456;0;2
FR;4;2022-05-13;1;0;2;0;1;2;0;0;0;1081750;6732;1411;29;1082939;4081;456;0;2
FR;4;2022-05-14;0;2;0;0;0;2;0;0;0;1081750;6734;1411;29;1082939;4083;456;0;2
FR;4;2022-05-15;2;2;0;0;4;0;0;0;0;1081752;6736;1411;29;1082943;4083;456;0;2
FR;4;2022-05-16;5;2;2;0;5;2;2;0;0;1081757;6738;1413;29;1082948;4085;458;0;2
FR;4;2022-05-17;5;1;2;0;5;3;0;0;0;1081762;6739;1415;29;1082953;4088;458;0;2
FR;4;2022-05-18;3;6;0;0;3;6;0;0;0;1081765;6745;1415;29;1082956;4094;458;0;2
FR;4;2022-05-19;2;3;3;0;2;5;1;0;0;1081767;6748;1418;29;1082958;4099;459;0;2
FR;4;2022-05-20;5;2;3;0;5;2;3;0;0;1081772;6750;1421;29;1082963;4101;462;0;2
FR;4;2022-05-21;2;0;1;0;2;1;0;0;0;1081774;6750;1422;29;1082965;4102;462;0;2
FR;4;2022-05-22;0;0;1;0;0;1;0;0;0;1081774;6750;1423;29;1082965;4103;462;0;2
FR;4;2022-05-23;0;0;2;0;0;0;2;0;0;1081774;6750;1425;29;1082965;4103;464;0;2
FR;4;2022-05-24;2;4;1;0;2;5;0;0;0;1081776;6754;1426;29;1082967;4108;464;0;2
FR;4;2022-05-25;1;4;1;0;3;3;0;0;0;1081777;6758;1427;29;1082970;4111;464;0;2
FR;4;2022-05-26;5;0;1;0;5;1;0;0;0;1081782;6758;1428;29;1082975;4112;464;0;2
FR;4;2022-05-27;0;2;1;1;0;3;1;0;0;1081782;6760;1429;30;1082975;4115;465;0;2
FR;4;2022-05-28;1;0;0;0;1;0;0;0;0;1081783;6760;1429;30;1082976;4115;465;0;2
FR;4;2022-05-29;1;0;1;0;1;1;0;0;0;1081784;6760;1430;30;1082977;4116;465;0;2
FR;4;2022-05-30;3;4;2;0;3;5;1;0;0;1081787;6764;1432;30;1082980;4121;466;0;2
FR;4;2022-05-31;2;1;0;0;2;1;0;0;0;1081789;6765;1432;30;1082982;4122;466;0;2
FR;4;2022-06-01;5;11;7;0;5;15;3;0;0;1081794;6776;1439;30;1082987;4137;469;0;2
FR;4;2022-06-02;6;7;3;0;6;7;2;0;0;1081800;6783;1442;30;1082993;4144;471;0;2
FR;4;2022-06-03;2;6;4;1;2;7;4;0;0;1081802;6789;1446;31;1082995;4151;475;0;2
FR;4;2022-06-04;0;1;1;1;0;1;2;0;0;1081802;6790;1447;32;1082995;4152;477;0;2
FR;4;2022-06-05;1;0;0;0;1;0;0;0;0;1081803;6790;1447;32;1082996;4152;477;0;2
FR;4;2022-06-06;8;0;3;0;8;2;1;0;0;1081811;6790;1450;32;1083004;4154;478;0;2
FR;4;2022-06-07;7;2;0;1;7;2;1;0;0;1081818;6792;1450;33;1083011;4156;479;0;2
FR;4;2022-06-08;0;5;3;0;1;7;0;0;0;1081818;6797;1453;33;1083012;4163;479;0;2
FR;4;2022-06-09;1;2;0;0;2;1;0;0;0;1081819;6799;1453;33;1083014;4164;479;0;2
FR;4;2022-06-10;4;0;3;0;4;1;2;0;0;1081823;6799;1456;33;1083018;4165;481;0;2
FR;4;2022-06-11;1;0;0;0;1;0;0;0;0;1081824;6799;1456;33;1083019;4165;481;0;2
FR;4;2022-06-12;4;1;1;0;4;2;0;0;0;1081828;6800;1457;33;1083023;4167;481;0;2
FR;4;2022-06-13;6;2;3;0;7;2;1;0;0;1081834;6802;1460;33;1083030;4169;482;0;2
FR;4;2022-06-14;4;3;0;0;5;2;0;0;0;1081838;6805;1460;33;1083035;4171;482;0;2
FR;4;2022-06-15;10;3;4;0;10;3;4;0;0;1081848;6808;1464;33;1083045;4174;486;0;2
FR;4;2022-06-16;2;3;1;1;3;2;1;0;1;1081850;6811;1465;34;1083048;4176;487;0;3
FR;4;2022-06-17;6;1;0;0;6;1;0;0;0;1081856;6812;1465;34;1083054;4177;487;0;3
FR;4;2022-06-18;0;0;0;0;0;0;0;0;0;1081856;6812;1465;34;1083054;4177;487;0;3
FR;4;2022-06-19;3;0;0;0;3;0;0;0;0;1081859;6812;1465;34;1083057;4177;487;0;3
FR;4;2022-06-20;6;2;2;1;6;3;2;0;0;1081865;6814;1467;35;1083063;4180;489;0;3
FR;4;2022-06-21;5;2;4;1;6;4;2;0;0;1081870;6816;1471;36;1083069;4184;491;0;3
FR;4;2022-06-22;3;2;1;3;4;2;1;0;0;1081873;6818;1472;39;1083073;4186;492;0;3
FR;4;2022-06-23;3;3;3;0;3;5;1;0;0;1081876;6821;1475;39;1083076;4191;493;0;3
FR;4;2022-06-24;3;0;2;0;3;0;2;0;0;1081879;6821;1477;39;1083079;4191;495;0;3
FR;4;2022-06-25;3;0;1;1;3;1;1;0;0;1081882;6821;1478;40;1083082;4192;496;0;3
FR;4;2022-06-26;0;0;2;0;0;2;0;0;0;1081882;6821;1480;40;1083082;4194;496;0;3
FR;4;2022-06-27;2;2;1;3;2;3;3;0;0;1081884;6823;1481;43;1083084;4197;499;0;3
FR;4;2022-06-28;0;4;2;1;0;5;2;0;0;1081884;6827;1483;44;1083084;4202;501;0;3
FR;4;2022-06-29;1;2;0;0;1;2;0;0;0;1081885;6829;1483;44;1083085;4204;501;0;3
FR;4;2022-06-30;2;0;0;0;2;0;0;0;0;1081887;6829;1483;44;1083087;4204;501;0;3
FR;4;2022-07-01;3;4;8;0;3;4;8;0;0;1081890;6833;1491;44;1083090;4208;509;0;3
FR;4;2022-07-02;0;1;0;0;1;0;0;0;0;1081890;6834;1491;44;1083091;4208;509;0;3
FR;4;2022-07-03;0;0;0;0;0;0;0;0;0;1081890;6834;1491;44;1083091;4208;509;0;3
FR;4;2022-07-04;4;1;0;0;4;1;0;0;0;1081894;6835;1491;44;1083095;4209;509;0;3
FR;4;2022-07-05;4;1;3;0;4;3;1;0;0;1081898;6836;1494;44;1083099;4212;510;0;3
FR;4;2022-07-06;5;0;1;1;5;0;1;0;1;1081903;6836;1495;45;1083104;4212;511;0;4
FR;4;2022-07-07;2;1;2;1;2;1;3;0;0;1081905;6837;1497;46;1083106;4213;514;0;4
FR;4;2022-07-08;4;1;0;0;4;1;0;0;0;1081909;6838;1497;46;1083110;4214;514;0;4
FR;4;2022-07-09;2;2;1;0;2;3;0;0;0;1081911;6840;1498;46;1083112;4217;514;0;4
FR;4;2022-07-10;2;0;1;0;2;0;0;0;0;1081913;6840;1499;46;1083114;4217;514;0;4
FR;4;2022-07-11;3;0;2;0;3;0;1;0;0;1081916;6840;1501;46;1083117;4217;515;0;4
FR;4;2022-07-12;0;0;2;0;0;2;0;0;0;1081916;6840;1503;46;1083117;4219;515;0;4
FR;4;2022-07-13;4;2;3;1;4;2;4;0;0;1081920;6842;1506;47;1083121;4221;519;0;4
FR;4;2022-07-14;6;0;1;0;6;0;1;0;0;1081926;6842;1507;47;1083127;4221;520;0;4
FR;4;2022-07-15;11;2;0;0;11;2;0;0;0;1081937;6844;1507;47;1083138;4223;520;0;4
FR;4;2022-07-16;5;0;0;2;5;0;2;0;0;1081942;6844;1507;49;1083143;4223;522;0;4
FR;4;2022-07-17;1;0;1;1;1;0;2;0;0;1081943;6844;1508;50;1083144;4223;524;0;4
FR;4;2022-07-18;3;3;2;0;3;3;2;0;0;1081946;6847;1510;50;1083147;4226;526;0;4
FR;4;2022-07-19;5;0;1;0;5;1;0;0;0;1081951;6847;1511;50;1083152;4227;526;0;4
FR;4;2022-07-20;12;2;1;0;13;2;0;0;0;1081963;6849;1512;50;1083165;4229;526;0;4
FR;4;2022-07-21;2;3;1;0;2;3;1;0;0;1081965;6852;1513;50;1083167;4232;527;0;4
FR;4;2022-07-22;5;1;3;0;5;2;2;0;0;1081970;6853;1516;50;1083172;4234;529;0;4
FR;4;2022-07-23;1;2;0;0;1;1;0;0;0;1081971;6855;1516;50;1083173;4235;529;0;4
FR;4;2022-07-24;1;0;0;0;1;0;0;0;0;1081972;6855;1516;50;1083174;4235;529;0;4
FR;4;2022-07-25;7;0;2;1;7;2;1;0;0;1081979;6855;1518;51;1083181;4237;530;0;4
FR;4;2022-07-26;3;0;0;0;3;0;0;0;0;1081982;6855;1518;51;1083184;4237;530;0;4
FR;4;2022-07-27;3;1;0;0;3;0;0;0;0;1081985;6856;1518;51;1083187;4237;530;0;4
FR;4;2022-07-28;13;0;0;0;13;0;0;0;0;1081998;6856;1518;51;1083200;4237;530;0;4
FR;4;2022-07-29;3;0;2;0;3;1;1;0;0;1082001;6856;1520;51;1083203;4238;531;0;4
FR;4;2022-07-30;5;0;2;0;5;0;2;0;0;1082006;6856;1522;51;1083208;4238;533;0;4
FR;4;2022-07-31;0;0;0;0;0;0;0;0;0;1082006;6856;1522;51;1083208;4238;533;0;4
FR;4;2022-08-01;4;0;3;0;4;2;1;0;0;1082010;6856;1525;51;1083212;4240;534;0;4
FR;4;2022-08-02;7;0;0;0;7;0;0;0;0;1082017;6856;1525;51;1083219;4240;534;0;4
FR;4;2022-08-03;2;2;1;0;2;2;1;0;0;1082019;6858;1526;51;1083221;4242;535;0;4
FR;4;2022-08-04;5;2;0;1;5;2;1;0;0;1082024;6860;1526;52;1083226;4244;536;0;4
FR;4;2022-08-05;3;1;1;0;3;1;1;0;0;1082027;6861;1527;52;1083229;4245;537;0;4
FR;4;2022-08-06;2;0;0;0;2;0;0;0;0;1082029;6861;1527;52;1083231;4245;537;0;4
FR;4;2022-08-07;5;0;0;0;5;0;0;0;0;1082034;6861;1527;52;1083236;4245;537;0;4
FR;4;2022-08-08;2;0;1;1;2;1;1;0;0;1082036;6861;1528;53;1083238;4246;538;0;4
FR;4;2022-08-09;1;1;2;2;1;2;3;0;0;1082037;6862;1530;55;1083239;4248;541;0;4
FR;4;2022-08-10;6;1;1;0;7;1;0;0;0;1082043;6863;1531;55;1083246;4249;541;0;4
FR;4;2022-08-11;2;0;1;0;2;1;0;0;0;1082045;6863;1532;55;1083248;4250;541;0;4
FR;4;2022-08-12;4;0;1;0;4;0;1;0;0;1082049;6863;1533;55;1083252;4250;542;0;4
FR;4;2022-08-13;1;0;0;0;1;0;0;0;0;1082050;6863;1533;55;1083253;4250;542;0;4
FR;4;2022-08-14;1;0;0;0;1;0;0;0;0;1082051;6863;1533;55;1083254;4250;542;0;4
FR;4;2022-08-15;1;2;3;0;1;2;3;0;0;1082052;6865;1536;55;1083255;4252;545;0;4
FR;4;2022-08-16;0;0;1;0;0;1;0;0;0;1082052;6865;1537;55;1083255;4253;545;0;4
FR;4;2022-08-17;3;0;0;0;3;0;0;0;0;1082055;6865;1537;55;1083258;4253;545;0;4
FR;4;2022-08-18;6;0;0;0;6;0;0;0;0;1082061;6865;1537;55;1083264;4253;545;0;4
FR;4;2022-08-19;5;0;0;0;5;0;0;0;0;1082066;6865;1537;55;1083269;4253;545;0;4
FR;4;2022-08-20;3;1;0;0;4;0;0;0;0;1082069;6866;1537;55;1083273;4253;545;0;4
FR;4;2022-08-21;1;0;0;0;1;0;0;0;0;1082070;6866;1537;55;1083274;4253;545;0;4
FR;4;2022-08-22;3;9;0;0;3;9;0;0;0;1082073;6875;1537;55;1083277;4262;545;0;4
FR;4;2022-08-23;3;3;3;0;3;4;2;0;0;1082076;6878;1540;55;1083280;4266;547;0;4
FR;4;2022-08-24;6;0;0;1;6;0;1;0;0;1082082;6878;1540;56;1083286;4266;548;0;4
FR;4;2022-08-25;1;3;2;0;1;4;1;0;0;1082083;6881;1542;56;1083287;4270;549;0;4
FR;4;2022-08-26;6;0;0;1;6;0;1;0;0;1082089;6881;1542;57;1083293;4270;550;0;4
FR;4;2022-08-27;1;0;0;0;1;0;0;0;0;1082090;6881;1542;57;1083294;4270;550;0;4
FR;4;2022-08-28;0;1;0;0;0;0;0;0;0;1082090;6882;1542;57;1083294;4270;550;0;4
FR;4;2022-08-29;8;0;0;0;8;0;0;0;0;1082098;6882;1542;57;1083302;4270;550;0;4
FR;4;2022-08-30;5;1;0;0;5;1;0;0;0;1082103;6883;1542;57;1083307;4271;550;0;4
FR;4;2022-08-31;3;1;0;0;3;1;0;0;0;1082106;6884;1542;57;1083310;4272;550;0;4
FR;4;2022-09-01;4;8;2;0;5;7;2;0;0;1082110;6892;1544;57;1083315;4279;552;0;4
FR;4;2022-09-02;2;2;1;0;3;2;0;0;0;1082112;6894;1545;57;1083318;4281;552;0;4
FR;4;2022-09-03;3;0;0;0;3;0;0;0;0;1082115;6894;1545;57;1083321;4281;552;0;4
FR;4;2022-09-04;1;0;0;0;1;0;0;0;0;1082116;6894;1545;57;1083322;4281;552;0;4
FR;4;2022-09-05;4;2;0;0;4;2;0;0;0;1082120;6896;1545;57;1083326;4283;552;0;4
FR;4;2022-09-06;1;0;0;0;1;0;0;0;0;1082121;6896;1545;57;1083327;4283;552;0;4
FR;4;2022-09-07;2;0;1;1;2;1;1;0;0;1082123;6896;1546;58;1083329;4284;553;0;4
FR;4;2022-09-08;3;0;0;0;3;0;0;0;0;1082126;6896;1546;58;1083332;4284;553;0;4
FR;4;2022-09-09;2;2;0;0;2;2;0;0;0;1082128;6898;1546;58;1083334;4286;553;0;4
FR;4;2022-09-10;0;1;0;3;0;2;2;0;0;1082128;6899;1546;61;1083334;4288;555;0;4
FR;4;2022-09-11;2;0;0;0;2;0;0;0;0;1082130;6899;1546;61;1083336;4288;555;0;4
FR;4;2022-09-12;1;1;1;0;1;1;1;0;0;1082131;6900;1547;61;1083337;4289;556;0;4
FR;4;2022-09-13;1;0;0;0;1;0;0;0;0;1082132;6900;1547;61;1083338;4289;556;0;4
FR;4;2022-09-14;4;0;0;0;4;0;0;0;0;1082136;6900;1547;61;1083342;4289;556;0;4
FR;4;2022-09-15;4;0;0;0;4;0;0;0;0;1082140;6900;1547;61;1083346;4289;556;0;4
FR;4;2022-09-16;1;0;0;0;1;0;0;0;0;1082141;6900;1547;61;1083347;4289;556;0;4
FR;4;2022-09-17;2;0;0;0;2;0;0;0;0;1082143;6900;1547;61;1083349;4289;556;0;4
FR;4;2022-09-18;0;1;0;0;0;1;0;0;0;1082143;6901;1547;61;1083349;4290;556;0;4
FR;4;2022-09-19;4;0;2;0;4;2;0;0;0;1082147;6901;1549;61;1083353;4292;556;0;4
FR;4;2022-09-20;4;0;0;0;4;0;0;0;0;1082151;6901;1549;61;1083357;4292;556;0;4
FR;4;2022-09-21;2;1;0;0;2;1;0;0;0;1082153;6902;1549;61;1083359;4293;556;0;4
FR;4;2022-09-22;2;1;0;0;2;1;0;0;0;1082155;6903;1549;61;1083361;4294;556;0;4
FR;4;2022-09-23;2;3;0;0;3;2;0;0;0;1082157;6906;1549;61;1083364;4296;556;0;4
FR;4;2022-09-24;1;0;0;0;1;0;0;0;0;1082158;6906;1549;61;1083365;4296;556;0;4
FR;4;2022-09-25;0;0;0;0;0;0;0;0;0;1082158;6906;1549;61;1083365;4296;556;0;4
FR;4;2022-09-26;2;0;1;0;2;0;1;0;0;1082160;6906;1550;61;1083367;4296;557;0;4
FR;4;2022-09-27;1;0;1;1;1;0;2;0;0;1082161;6906;1551;62;1083368;4296;559;0;4
FR;4;2022-09-28;3;0;2;0;3;2;0;0;0;1082164;6906;1553;62;1083371;4298;559;0;4
FR;4;2022-09-29;5;0;1;1;5;1;1;0;0;1082169;6906;1554;63;1083376;4299;560;0;4
FR;4;2022-09-30;1;1;0;0;1;1;0;0;0;1082170;6907;1554;63;1083377;4300;560;0;4
FR;4;2022-10-01;1;1;0;0;2;0;0;0;0;1082171;6908;1554;63;1083379;4300;560;0;4
FR;4;2022-10-02;0;1;0;0;0;1;0;0;0;1082171;6909;1554;63;1083379;4301;560;0;4
FR;4;2022-10-03;2;3;1;1;3;3;1;0;0;1082173;6912;1555;64;1083382;4304;561;0;4
FR;4;2022-10-04;3;0;0;0;3;0;0;0;0;1082176;6912;1555;64;1083385;4304;561;0;4
FR;4;2022-10-05;0;1;0;0;0;1;0;0;0;1082176;6913;1555;64;1083385;4305;561;0;4
FR;4;2022-10-06;2;0;0;0;2;0;0;0;0;1082178;6913;1555;64;1083387;4305;561;0;4
FR;4;2022-10-07;3;1;1;0;3;1;1;0;0;1082181;6914;1556;64;1083390;4306;562;0;4
FR;4;2022-10-08;4;1;0;0;4;0;0;0;0;1082185;6915;1556;64;1083394;4306;562;0;4
FR;4;2022-10-09;0;0;0;0;0;0;0;0;0;1082185;6915;1556;64;1083394;4306;562;0;4
FR;4;2022-10-10;5;0;2;3;5;2;1;0;2;1082190;6915;1558;67;1083399;4308;563;0;6
FR;4;2022-10-11;2;2;0;0;2;1;0;0;0;1082192;6917;1558;67;1083401;4309;563;0;6
FR;4;2022-10-12;1;0;0;0;1;0;0;0;0;1082193;6917;1558;67;1083402;4309;563;0;6
FR;4;2022-10-13;5;0;0;0;5;0;0;0;0;1082198;6917;1558;67;1083407;4309;563;0;6
FR;4;2022-10-14;1;1;0;0;1;1;0;0;0;1082199;6918;1558;67;1083408;4310;563;0;6
FR;4;2022-10-15;1;2;0;0;1;2;0;0;0;1082200;6920;1558;67;1083409;4312;563;0;6
FR;4;2022-10-16;0;0;0;0;0;0;0;0;0;1082200;6920;1558;67;1083409;4312;563;0;6
FR;4;2022-10-17;3;0;1;0;3;1;0;0;0;1082203;6920;1559;67;1083412;4313;563;0;6
FR;4;2022-10-18;1;0;0;1;1;0;1;0;0;1082204;6920;1559;68;1083413;4313;564;0;6
FR;4;2022-10-19;1;0;0;2;1;0;2;0;3;1082205;6920;1559;70;1083414;4313;566;0;9
FR;4;2022-10-20;4;1;0;0;4;1;0;0;0;1082209;6921;1559;70;1083418;4314;566;0;9
FR;4;2022-10-21;3;1;0;0;3;1;0;0;0;1082212;6922;1559;70;1083421;4315;566;0;9
FR;4;2022-10-22;1;0;0;0;1;0;0;0;0;1082213;6922;1559;70;1083422;4315;566;0;9
FR;4;2022-10-23;0;0;0;0;0;0;0;0;0;1082213;6922;1559;70;1083422;4315;566;0;9
FR;4;2022-10-24;3;0;0;0;3;0;0;0;0;1082216;6922;1559;70;1083425;4315;566;0;9
FR;4;2022-10-25;4;0;0;0;4;0;0;0;0;1082220;6922;1559;70;1083429;4315;566;0;9
FR;4;2022-10-26;2;1;0;0;2;1;0;0;0;1082222;6923;1559;70;1083431;4316;566;0;9
FR;4;2022-10-27;3;1;1;0;3;0;1;0;0;1082225;6924;1560;70;1083434;4316;567;0;9
FR;4;2022-10-28;0;0;0;0;0;0;0;0;0;1082225;6924;1560;70;1083434;4316;567;0;9
FR;4;2022-10-29;1;0;0;3;1;0;3;0;3;1082226;6924;1560;73;1083435;4316;570;0;12
FR;4;2022-10-30;1;0;0;0;1;0;0;0;0;1082227;6924;1560;73;1083436;4316;570;0;12
FR;4;2022-10-31;1;0;0;0;1;0;0;0;0;1082228;6924;1560;73;1083437;4316;570;0;12
FR;4;2022-11-01;1;6;0;0;1;6;0;0;0;1082229;6930;1560;73;1083438;4322;570;0;12
FR;4;2022-11-02;0;0;2;2;0;1;3;0;0;1082229;6930;1562;75;1083438;4323;573;0;12
FR;4;2022-11-03;1;0;0;0;1;0;0;0;0;1082230;6930;1562;75;1083439;4323;573;0;12
FR;4;2022-11-04;4;1;0;0;4;0;0;0;0;1082234;6931;1562;75;1083443;4323;573;0;12
FR;4;2022-11-05;0;0;0;0;0;0;0;0;0;1082234;6931;1562;75;1083443;4323;573;0;12
FR;4;2022-11-06;2;0;0;0;2;0;0;0;0;1082236;6931;1562;75;1083445;4323;573;0;12
FR;4;2022-11-07;2;0;0;0;2;0;0;0;0;1082238;6931;1562;75;1083447;4323;573;0;12
FR;4;2022-11-08;7;0;0;0;7;0;0;0;0;1082245;6931;1562;75;1083454;4323;573;0;12
FR;4;2022-11-09;0;0;0;0;0;0;0;0;0;1082245;6931;1562;75;1083454;4323;573;0;12
FR;4;2022-11-10;2;0;1;0;2;1;0;0;0;1082247;6931;1563;75;1083456;4324;573;0;12
FR;4;2022-11-11;1;0;0;0;1;0;0;0;0;1082248;6931;1563;75;1083457;4324;573;0;12
FR;4;2022-11-12;3;1;0;0;3;1;0;0;0;1082251;6932;1563;75;1083460;4325;573;0;12
FR;4;2022-11-13;2;0;0;0;2;0;0;0;0;1082253;6932;1563;75;1083462;4325;573;0;12
FR;4;2022-11-14;0;1;0;0;0;1;0;0;0;1082253;6933;1563;75;1083462;4326;573;0;12
FR;4;2022-11-15;3;1;0;0;3;1;0;0;0;1082256;6934;1563;75;1083465;4327;573;0;12
FR;4;2022-11-16;1;1;1;0;1;1;1;0;0;1082257;6935;1564;75;1083466;4328;574;0;12
FR;4;2022-11-17;0;2;0;0;0;2;0;0;0;1082257;6937;1564;75;1083466;4330;574;0;12
FR;4;2022-11-18;5;0;1;0;5;0;1;0;0;1082262;6937;1565;75;1083471;4330;575;0;12
FR;4;2022-11-19;0;0;0;0;0;0;0;0;0;1082262;6937;1565;75;1083471;4330;575;0;12
FR;4;2022-11-20;0;0;0;1;0;0;0;0;1;1082262;6937;1565;76;1083471;4330;575;0;13
FR;4;2022-11-21;0;0;0;0;0;0;0;0;0;1082262;6937;1565;76;1083471;4330;575;0;13
FR;4;2022-11-22;0;1;1;0;0;2;0;0;0;1082262;6938;1566;76;1083471;4332;575;0;13
FR;4;2022-11-23;1;0;0;0;1;0;0;0;1;1082263;6938;1566;76;1083472;4332;575;0;14
FR;4;2022-11-24;0;2;0;0;0;2;0;0;0;1082263;6940;1566;76;1083472;4334;575;0;14
FR;4;2022-11-25;3;4;0;0;3;4;0;0;0;1082266;6944;1566;76;1083475;4338;575;0;14
FR;4;2022-11-26;1;0;0;0;1;0;0;0;0;1082267;6944;1566;76;1083476;4338;575;0;14
FR;4;2022-11-27;0;0;0;0;0;0;0;0;0;1082267;6944;1566;76;1083476;4338;575;0;14
FR;4;2022-11-28;4;0;0;0;4;0;0;0;0;1082271;6944;1566;76;1083480;4338;575;0;14
FR;4;2022-11-29;3;0;0;0;3;0;0;0;0;1082274;6944;1566;76;1083483;4338;575;0;14
FR;4;2022-11-30;0;0;0;0;0;0;0;0;0;1082274;6944;1566;76;1083483;4338;575;0;14
FR;4;2022-12-01;1;2;2;0;2;2;1;0;0;1082275;6946;1568;76;1083485;4340;576;0;14
FR;4;2022-12-02;6;1;0;1;6;1;0;0;1;1082281;6947;1568;77;1083491;4341;576;0;15
FR;4;2022-12-03;1;0;0;0;1;0;0;0;0;1082282;6947;1568;77;1083492;4341;576;0;15
FR;4;2022-12-04;0;0;0;0;0;0;0;0;0;1082282;6947;1568;77;1083492;4341;576;0;15
FR;4;2022-12-05;2;1;0;0;2;1;0;0;0;1082284;6948;1568;77;1083494;4342;576;0;15
FR;4;2022-12-06;2;0;0;0;2;0;0;0;0;1082286;6948;1568;77;1083496;4342;576;0;15
FR;4;2022-12-07;2;3;1;0;2;4;0;0;0;1082288;6951;1569;77;1083498;4346;576;0;15
FR;4;2022-12-08;1;0;0;0;1;0;0;0;0;1082289;6951;1569;77;1083499;4346;576;0;15
FR;4;2022-12-09;2;0;1;0;2;0;1;0;0;1082291;6951;1570;77;1083501;4346;577;0;15
FR;4;2022-12-10;1;0;0;0;1;0;0;0;0;1082292;6951;1570;77;1083502;4346;577;0;15
FR;4;2022-12-11;0;0;0;0;0;0;0;0;0;1082292;6951;1570;77;1083502;4346;577;0;15
FR;4;2022-12-12;2;1;0;5;2;1;5;0;0;1082294;6952;1570;82;1083504;4347;582;0;15
FR;4;2022-12-13;2;0;0;0;2;0;0;0;0;1082296;6952;1570;82;1083506;4347;582;0;15
FR;4;2022-12-14;0;0;0;0;0;0;0;0;0;1082296;6952;1570;82;1083506;4347;582;0;15
FR;4;2022-12-15;1;1;0;0;1;1;0;0;0;1082297;6953;1570;82;1083507;4348;582;0;15
FR;4;2022-12-16;2;0;0;0;2;0;0;0;0;1082299;6953;1570;82;1083509;4348;582;0;15
FR;4;2022-12-17;0;0;1;0;0;0;1;0;0;1082299;6953;1571;82;1083509;4348;583;0;15
FR;4;2022-12-18;1;0;0;0;1;0;0;0;0;1082300;6953;1571;82;1083510;4348;583;0;15
FR;4;2022-12-19;1;0;0;0;1;0;0;0;0;1082301;6953;1571;82;1083511;4348;583;0;15
FR;4;2022-12-20;4;2;0;0;5;1;0;0;0;1082305;6955;1571;82;1083516;4349;583;0;15
FR;4;2022-12-21;6;0;0;0;6;0;0;0;0;1082311;6955;1571;82;1083522;4349;583;0;15
FR;4;2022-12-22;2;1;0;0;2;1;0;0;0;1082313;6956;1571;82;1083524;4350;583;0;15
FR;4;2022-12-23;3;0;0;0;3;0;0;0;0;1082316;6956;1571;82;1083527;4350;583;0;15
FR;4;2022-12-24;0;0;1;0;0;1;0;0;0;1082316;6956;1572;82;1083527;4351;583;0;15
FR;4;2022-12-25;0;0;0;0;0;0;0;0;0;1082316;6956;1572;82;1083527;4351;583;0;15
FR;4;2022-12-26;1;2;0;0;1;1;0;0;0;1082317;6958;1572;82;1083528;4352;583;0;15
FR;4;2022-12-27;1;1;0;0;1;1;0;0;0;1082318;6959;1572;82;1083529;4353;583;0;15
FR;4;2022-12-28;0;0;0;0;0;0;0;0;0;1082318;6959;1572;82;1083529;4353;583;0;15
FR;4;2022-12-29;0;1;0;0;1;0;0;0;0;1082318;6960;1572;82;1083530;4353;583;0;15
FR;4;2022-12-30;1;0;0;0;1;0;0;0;0;1082319;6960;1572;82;1083531;4353;583;0;15
FR;4;2022-12-31;0;0;0;0;0;0;0;0;0;1082319;6960;1572;82;1083531;4353;583;0;15
FR;4;2023-01-01;0;0;0;0;0;0;0;0;0;1082319;6960;1572;82;1083531;4353;583;0;15
FR;4;2023-01-02;2;0;2;0;2;1;1;0;0;1082321;6960;1574;82;1083533;4354;584;0;15
FR;4;2023-01-03;1;1;0;0;1;1;0;0;0;1082322;6961;1574;82;1083534;4355;584;0;15
FR;4;2023-01-04;0;0;0;0;0;0;0;0;0;1082322;6961;1574;82;1083534;4355;584;0;15
FR;4;2023-01-05;0;0;0;0;0;0;0;0;0;1082322;6961;1574;82;1083534;4355;584;0;15
FR;4;2023-01-06;1;1;3;0;1;4;0;0;0;1082323;6962;1577;82;1083535;4359;584;0;15
FR;4;2023-01-07;1;0;0;0;1;0;0;0;0;1082324;6962;1577;82;1083536;4359;584;0;15
FR;4;2023-01-08;1;0;0;0;1;0;0;0;0;1082325;6962;1577;82;1083537;4359;584;0;15
FR;4;2023-01-09;1;0;0;0;1;0;0;0;0;1082326;6962;1577;82;1083538;4359;584;0;15
FR;4;2023-01-10;2;1;0;0;2;1;0;0;0;1082328;6963;1577;82;1083540;4360;584;0;15
FR;4;2023-01-11;0;0;0;0;0;0;0;0;0;1082328;6963;1577;82;1083540;4360;584;0;15
FR;4;2023-01-12;3;2;0;0;3;2;0;0;0;1082331;6965;1577;82;1083543;4362;584;0;15
FR;4;2023-01-13;3;0;2;0;3;0;2;0;0;1082334;6965;1579;82;1083546;4362;586;0;15
FR;4;2023-01-14;0;0;1;0;0;0;1;0;0;1082334;6965;1580;82;1083546;4362;587;0;15
FR;4;2023-01-15;0;0;0;0;0;0;0;0;0;1082334;6965;1580;82;1083546;4362;587;0;15
FR;4;2023-01-16;3;0;0;0;3;0;0;0;0;1082337;6965;1580;82;1083549;4362;587;0;15
FR;4;2023-01-17;2;0;0;0;2;0;0;0;0;1082339;6965;1580;82;1083551;4362;587;0;15
FR;4;2023-01-18;3;0;0;0;3;0;0;0;0;1082342;6965;1580;82;1083554;4362;587;0;15
FR;4;2023-01-19;1;0;0;2;1;0;0;0;0;1082343;6965;1580;84;1083555;4362;587;0;15
FR;4;2023-01-20;0;0;0;0;0;0;0;0;0;1082343;6965;1580;84;1083555;4362;587;0;15
FR;4;2023-01-21;0;0;0;0;0;0;0;0;0;1082343;6965;1580;84;1083555;4362;587;0;15
FR;4;2023-01-22;0;0;0;0;0;0;0;0;0;1082343;6965;1580;84;1083555;4362;587;0;15
FR;4;2023-01-23;1;0;0;0;1;0;0;0;0;1082344;6965;1580;84;1083556;4362;587;0;15
FR;4;2023-01-24;3;1;0;0;3;1;0;0;0;1082347;6966;1580;84;1083559;4363;587;0;15
FR;4;2023-01-25;6;0;0;0;6;0;0;0;0;1082353;6966;1580;84;1083565;4363;587;0;15
FR;4;2023-01-26;1;0;1;0;1;1;0;0;0;1082354;6966;1581;84;1083566;4364;587;0;15
FR;4;2023-01-27;0;0;0;0;0;0;0;0;0;1082354;6966;1581;84;1083566;4364;587;0;15
FR;4;2023-01-28;0;0;0;0;0;0;0;0;0;1082354;6966;1581;84;1083566;4364;587;0;15
FR;4;2023-01-29;0;0;0;0;0;0;0;0;0;1082354;6966;1581;84;1083566;4364;587;0;15
FR;4;2023-01-30;0;0;0;0;0;0;0;0;0;1082354;6966;1581;84;1083566;4364;587;0;15
FR;4;2023-01-31;0;0;0;0;0;0;0;0;0;1082354;6966;1581;84;1083566;4364;587;0;15
FR;4;2023-02-01;0;0;0;0;0;0;0;0;0;1082354;6966;1581;84;1083566;4364;587;0;15
FR;4;2023-02-02;3;2;2;1;3;3;1;0;0;1082357;6968;1583;85;1083569;4367;588;0;15
FR;4;2023-02-03;0;0;0;0;0;0;0;0;0;1082357;6968;1583;85;1083569;4367;588;0;15
FR;4;2023-02-04;1;0;0;0;1;0;0;0;0;1082358;6968;1583;85;1083570;4367;588;0;15
FR;4;2023-02-05;0;0;0;0;0;0;0;0;0;1082358;6968;1583;85;1083570;4367;588;0;15
FR;4;2023-02-06;1;0;0;0;1;0;0;0;0;1082359;6968;1583;85;1083571;4367;588;0;15
FR;4;2023-02-07;2;0;0;0;2;0;0;0;0;1082361;6968;1583;85;1083573;4367;588;0;15
FR;4;2023-02-08;2;1;0;0;2;0;0;0;0;1082363;6969;1583;85;1083575;4367;588;0;15
FR;4;2023-02-09;1;1;0;0;1;1;0;0;0;1082364;6970;1583;85;1083576;4368;588;0;15
FR;4;2023-02-10;5;1;0;0;5;0;0;0;0;1082369;6971;1583;85;1083581;4368;588;0;15
FR;4;2023-02-11;4;0;0;0;4;0;0;0;0;1082373;6971;1583;85;1083585;4368;588;0;15
FR;4;2023-02-12;0;0;0;0;0;0;0;0;0;1082373;6971;1583;85;1083585;4368;588;0;15
FR;4;2023-02-13;3;0;0;0;3;0;0;0;0;1082376;6971;1583;85;1083588;4368;588;0;15
FR;4;2023-02-14;0;2;0;0;2;0;0;0;0;1082376;6973;1583;85;1083590;4368;588;0;15
FR;4;2023-02-15;2;0;0;0;2;0;0;0;0;1082378;6973;1583;85;1083592;4368;588;0;15
FR;4;2023-02-16;1;1;0;0;1;1;0;0;0;1082379;6974;1583;85;1083593;4369;588;0;15
FR;4;2023-02-17;1;0;0;0;1;0;0;0;0;1082380;6974;1583;85;1083594;4369;588;0;15
FR;4;2023-02-18;0;2;0;0;0;2;0;0;0;1082380;6976;1583;85;1083594;4371;588;0;15
FR;4;2023-02-19;0;0;0;0;0;0;0;0;0;1082380;6976;1583;85;1083594;4371;588;0;15
FR;4;2023-02-20;1;0;0;0;1;0;0;0;0;1082381;6976;1583;85;1083595;4371;588;0;15
FR;4;2023-02-21;2;0;0;0;2;0;0;0;0;1082383;6976;1583;85;1083597;4371;588;0;15
FR;4;2023-02-22;0;0;0;0;0;0;0;0;0;1082383;6976;1583;85;1083597;4371;588;0;15
FR;4;2023-02-23;0;0;0;0;0;0;0;0;0;1082383;6976;1583;85;1083597;4371;588;0;15
FR;4;2023-02-24;1;0;0;0;1;0;0;0;0;1082384;6976;1583;85;1083598;4371;588;0;15
FR;4;2023-02-25;2;1;0;0;2;1;0;0;0;1082386;6977;1583;85;1083600;4372;588;0;15
FR;4;2023-02-26;0;0;0;0;0;0;0;0;0;1082386;6977;1583;85;1083600;4372;588;0;15
FR;4;2023-02-27;1;0;0;0;1;0;0;0;0;1082387;6977;1583;85;1083601;4372;588;0;15
FR;4;2023-02-28;0;0;0;0;0;0;0;0;0;1082387;6977;1583;85;1083601;4372;588;0;15
FR;4;2023-03-01;1;0;0;0;1;0;0;0;0;1082388;6977;1583;85;1083602;4372;588;0;15
FR;4;2023-03-02;1;1;2;0;1;1;2;0;0;1082389;6978;1585;85;1083603;4373;590;0;15
FR;4;2023-03-03;1;0;0;0;1;0;0;0;0;1082390;6978;1585;85;1083604;4373;590;0;15
FR;4;2023-03-04;0;0;0;0;0;0;0;0;0;1082390;6978;1585;85;1083604;4373;590;0;15
FR;4;2023-03-05;0;0;0;0;0;0;0;0;0;1082390;6978;1585;85;1083604;4373;590;0;15
FR;4;2023-03-06;0;0;0;0;0;0;0;0;0;1082390;6978;1585;85;1083604;4373;590;0;15
FR;4;2023-03-07;0;0;0;0;0;0;0;0;0;1082390;6978;1585;85;1083604;4373;590;0;15
FR;4;2023-03-08;1;0;0;0;1;0;0;0;0;1082391;6978;1585;85;1083605;4373;590;0;15
FR;4;2023-03-09;0;0;0;0;0;0;0;0;0;1082391;6978;1585;85;1083605;4373;590;0;15
FR;4;2023-03-10;2;0;1;0;2;0;1;0;0;1082393;6978;1586;85;1083607;4373;591;0;15
FR;4;2023-03-11;0;0;0;0;0;0;0;0;0;1082393;6978;1586;85;1083607;4373;591;0;15
FR;4;2023-03-12;0;0;0;0;0;0;0;0;0;1082393;6978;1586;85;1083607;4373;591;0;15
FR;4;2023-03-13;0;0;0;0;0;0;0;0;0;1082393;6978;1586;85;1083607;4373;591;0;15
FR;4;2023-03-14;0;0;0;0;0;0;0;0;0;1082393;6978;1586;85;1083607;4373;591;0;15
FR;4;2023-03-15;1;0;0;1;1;0;0;0;1;1082394;6978;1586;86;1083608;4373;591;0;16
FR;4;2023-03-16;1;0;0;0;1;0;0;0;0;1082395;6978;1586;86;1083609;4373;591;0;16
FR;4;2023-03-17;1;0;0;0;1;0;0;0;0;1082396;6978;1586;86;1083610;4373;591;0;16
FR;4;2023-03-18;0;1;0;0;0;1;0;0;0;1082396;6979;1586;86;1083610;4374;591;0;16
FR;4;2023-03-19;0;0;0;0;0;0;0;0;0;1082396;6979;1586;86;1083610;4374;591;0;16
FR;4;2023-03-20;0;0;0;0;0;0;0;0;0;1082396;6979;1586;86;1083610;4374;591;0;16
FR;4;2023-03-21;2;0;0;0;2;0;0;0;0;1082398;6979;1586;86;1083612;4374;591;0;16
FR;4;2023-03-22;0;0;1;0;0;0;1;0;0;1082398;6979;1587;86;1083612;4374;592;0;16
FR;4;2023-03-23;1;0;0;0;1;0;0;0;0;1082399;6979;1587;86;1083613;4374;592;0;16
FR;4;2023-03-24;0;0;0;0;0;0;0;0;0;1082399;6979;1587;86;1083613;4374;592;0;16
FR;4;2023-03-25;0;0;0;0;0;0;0;0;0;1082399;6979;1587;86;1083613;4374;592;0;16
FR;4;2023-03-26;0;0;0;0;0;0;0;0;0;1082399;6979;1587;86;1083613;4374;592;0;16
FR;4;2023-03-27;1;0;0;0;1;0;0;0;0;1082400;6979;1587;86;1083614;4374;592;0;16
FR;4;2023-03-28;1;0;0;0;1;0;0;0;0;1082401;6979;1587;86;1083615;4374;592;0;16
FR;4;2023-03-29;2;0;0;0;2;0;0;0;0;1082403;6979;1587;86;1083617;4374;592;0;16
FR;4;2023-03-30;0;1;0;0;1;0;0;0;0;1082403;6980;1587;86;1083618;4374;592;0;16
FR;4;2023-03-31;3;0;0;1;3;0;0;0;4;1082406;6980;1587;87;1083621;4374;592;0;20
FR;4;2023-04-01;2;0;0;0;2;0;0;0;0;1082408;6980;1587;87;1083623;4374;592;0;20
FR;4;2023-04-02;0;0;0;0;0;0;0;0;0;1082408;6980;1587;87;1083623;4374;592;0;20
FR;4;2023-04-03;0;0;0;0;0;0;0;0;0;1082408;6980;1587;87;1083623;4374;592;0;20
FR;4;2023-04-04;0;0;0;0;0;0;0;0;0;1082408;6980;1587;87;1083623;4374;592;0;20
FR;4;2023-04-05;0;0;0;0;0;0;0;0;0;1082408;6980;1587;87;1083623;4374;592;0;20
FR;4;2023-04-06;0;0;0;0;0;0;0;0;0;1082408;6980;1587;87;1083623;4374;592;0;20
FR;4;2023-04-07;0;0;0;0;0;0;0;0;0;1082408;6980;1587;87;1083623;4374;592;0;20
FR;4;2023-04-08;0;0;0;0;0;0;0;0;0;1082408;6980;1587;87;1083623;4374;592;0;20
FR;4;2023-04-09;0;0;0;0;0;0;0;0;0;1082408;6980;1587;87;1083623;4374;592;0;20
FR;4;2023-04-10;1;0;0;0;1;0;0;0;0;1082409;6980;1587;87;1083624;4374;592;0;20
FR;4;2023-04-11;0;0;0;0;0;0;0;0;0;1082409;6980;1587;87;1083624;4374;592;0;20
FR;4;2023-04-12;1;0;0;0;1;0;0;0;0;1082410;6980;1587;87;1083625;4374;592;0;20
FR;4;2023-04-13;0;0;0;0;0;0;0;0;0;1082410;6980;1587;87;1083625;4374;592;0;20
FR;4;2023-04-14;0;0;0;0;0;0;0;0;0;1082410;6980;1587;87;1083625;4374;592;0;20
FR;4;2023-04-15;0;0;0;0;0;0;0;0;0;1082410;6980;1587;87;1083625;4374;592;0;20
FR;4;2023-04-16;0;0;0;0;0;0;0;0;0;1082410;6980;1587;87;1083625;4374;592;0;20
FR;4;2023-04-17;0;0;0;0;0;0;0;0;0;1082410;6980;1587;87;1083625;4374;592;0;20
FR;4;2023-04-18;0;0;0;0;0;0;0;0;0;1082410;6980;1587;87;1083625;4374;592;0;20
FR;4;2023-04-19;1;0;0;0;1;0;0;0;0;1082411;6980;1587;87;1083626;4374;592;0;20
FR;4;2023-04-20;0;0;0;0;0;0;0;0;0;1082411;6980;1587;87;1083626;4374;592;0;20
FR;4;2023-04-21;0;1;0;0;0;1;0;0;0;1082411;6981;1587;87;1083626;4375;592;0;20
FR;4;2023-04-22;0;0;0;0;0;0;0;0;0;1082411;6981;1587;87;1083626;4375;592;0;20
FR;4;2023-04-23;1;0;0;0;1;0;0;0;0;1082412;6981;1587;87;1083627;4375;592;0;20
FR;4;2023-04-24;1;0;0;0;1;0;0;0;0;1082413;6981;1587;87;1083628;4375;592;0;20
FR;4;2023-04-25;1;0;0;0;1;0;0;0;0;1082414;6981;1587;87;1083629;4375;592;0;20
FR;4;2023-04-26;0;0;0;0;0;0;0;0;0;1082414;6981;1587;87;1083629;4375;592;0;20
FR;4;2023-04-27;0;0;0;0;0;0;0;0;0;1082414;6981;1587;87;1083629;4375;592;0;20
FR;4;2023-04-28;0;0;0;0;0;0;0;0;0;1082414;6981;1587;87;1083629;4375;592;0;20
FR;4;2023-04-29;0;0;0;0;0;0;0;0;0;1082414;6981;1587;87;1083629;4375;592;0;20
FR;4;2023-04-30;0;0;0;0;0;0;0;0;0;1082414;6981;1587;87;1083629;4375;592;0;20
FR;4;2023-05-01;1;0;0;0;1;0;0;0;0;1082415;6981;1587;87;1083630;4375;592;0;20
FR;4;2023-05-02;0;0;0;0;0;0;0;0;0;1082415;6981;1587;87;1083630;4375;592;0;20
FR;4;2023-05-03;0;0;0;0;0;0;0;0;0;1082415;6981;1587;87;1083630;4375;592;0;20
FR;4;2023-05-04;0;0;0;0;0;0;0;0;0;1082415;6981;1587;87;1083630;4375;592;0;20
FR;4;2023-05-05;0;0;0;0;0;0;0;0;0;1082415;6981;1587;87;1083630;4375;592;0;20
FR;4;2023-05-06;0;0;0;0;0;0;0;0;0;1082415;6981;1587;87;1083630;4375;592;0;20
FR;4;2023-05-07;0;0;0;0;0;0;0;0;0;1082415;6981;1587;87;1083630;4375;592;0;20
FR;4;2023-05-08;0;0;0;0;0;0;0;0;0;1082415;6981;1587;87;1083630;4375;592;0;20
FR;4;2023-05-09;0;0;0;0;0;0;0;0;0;1082415;6981;1587;87;1083630;4375;592;0;20
FR;4;2023-05-10;0;0;0;0;0;0;0;0;0;1082415;6981;1587;87;1083630;4375;592;0;20
FR;4;2023-05-11;0;0;0;0;0;0;0;0;0;1082415;6981;1587;87;1083630;4375;592;0;20
FR;4;2023-05-12;0;0;0;0;0;0;0;0;0;1082415;6981;1587;87;1083630;4375;592;0;20
FR;4;2023-05-13;0;0;0;0;0;0;0;0;0;1082415;6981;1587;87;1083630;4375;592;0;20
FR;4;2023-05-14;0;0;0;0;0;0;0;0;0;1082415;6981;1587;87;1083630;4375;592;0;20
FR;4;2023-05-15;0;0;0;0;0;0;0;0;0;1082415;6981;1587;87;1083630;4375;592;0;20
FR;4;2023-05-16;0;0;0;0;0;0;0;0;0;1082415;6981;1587;87;1083630;4375;592;0;20
FR;4;2023-05-17;0;0;0;1;0;0;1;0;0;1082415;6981;1587;88;1083630;4375;593;0;20
FR;4;2023-05-18;0;0;0;0;0;0;0;0;0;1082415;6981;1587;88;1083630;4375;593;0;20
FR;4;2023-05-19;0;0;0;0;0;0;0;0;0;1082415;6981;1587;88;1083630;4375;593;0;20
FR;4;2023-05-20;0;0;0;0;0;0;0;0;0;1082415;6981;1587;88;1083630;4375;593;0;20
FR;4;2023-05-21;0;0;0;0;0;0;0;0;0;1082415;6981;1587;88;1083630;4375;593;0;20
FR;4;2023-05-22;0;0;0;0;0;0;0;0;0;1082415;6981;1587;88;1083630;4375;593;0;20
FR;4;2023-05-23;0;0;0;0;0;0;0;0;0;1082415;6981;1587;88;1083630;4375;593;0;20
FR;4;2023-05-24;0;0;0;0;0;0;0;0;0;1082415;6981;1587;88;1083630;4375;593;0;20
FR;4;2023-05-25;0;0;0;0;0;0;0;0;0;1082415;6981;1587;88;1083630;4375;593;0;20
FR;4;2023-05-26;0;0;0;0;0;0;0;0;0;1082415;6981;1587;88;1083630;4375;593;0;20
FR;4;2023-05-27;0;0;0;0;0;0;0;0;0;1082415;6981;1587;88;1083630;4375;593;0;20
FR;4;2023-05-28;0;0;0;0;0;0;0;0;0;1082415;6981;1587;88;1083630;4375;593;0;20
FR;4;2023-05-29;0;0;0;0;0;0;0;0;0;1082415;6981;1587;88;1083630;4375;593;0;20
FR;4;2023-05-30;0;0;0;0;0;0;0;0;0;1082415;6981;1587;88;1083630;4375;593;0;20
FR;4;2023-05-31;0;0;0;0;0;0;0;0;0;1082415;6981;1587;88;1083630;4375;593;0;20
FR;4;2023-06-01;1;0;0;0;1;0;0;0;0;1082416;6981;1587;88;1083631;4375;593;0;20
FR;4;2023-06-02;1;0;0;0;1;0;0;0;0;1082417;6981;1587;88;1083632;4375;593;0;20
FR;4;2023-06-03;0;0;0;0;0;0;0;0;0;1082417;6981;1587;88;1083632;4375;593;0;20
FR;4;2023-06-04;0;0;0;0;0;0;0;0;0;1082417;6981;1587;88;1083632;4375;593;0;20
FR;4;2023-06-05;0;0;0;0;0;0;0;0;0;1082417;6981;1587;88;1083632;4375;593;0;20
FR;4;2023-06-06;1;0;0;0;1;0;0;0;0;1082418;6981;1587;88;1083633;4375;593;0;20
FR;4;2023-06-07;0;0;0;0;0;0;0;0;0;1082418;6981;1587;88;1083633;4375;593;0;20
FR;4;2023-06-08;1;0;0;0;1;0;0;0;0;1082419;6981;1587;88;1083634;4375;593;0;20
FR;4;2023-06-09;1;0;0;0;1;0;0;0;0;1082420;6981;1587;88;1083635;4375;593;0;20
FR;4;2023-06-10;0;0;0;0;0;0;0;0;0;1082420;6981;1587;88;1083635;4375;593;0;20
FR;4;2023-06-11;0;0;0;0;0;0;0;0;0;1082420;6981;1587;88;1083635;4375;593;0;20
FR;4;2023-06-12;0;0;0;0;0;0;0;0;0;1082420;6981;1587;88;1083635;4375;593;0;20
FR;5;2020-12-27;0;0;0;0;0;0;0;0;0;0;0;0;0;0;0;0;0;0
FR;5;2020-12-28;0;0;0;0;0;0;0;0;0;0;0;0;0;0;0;0;0;0
FR;5;2020-12-29;0;0;0;0;0;0;0;0;0;0;0;0;0;0;0;0;0;0
FR;5;2020-12-30;0;0;0;0;0;0;0;0;0;0;0;0;0;0;0;0;0;0
FR;5;2020-12-31;0;0;0;0;0;0;0;0;0;0;0;0;0;0;0;0;0;0
FR;5;2021-01-01;0;0;0;0;0;0;0;0;0;0;0;0;0;0;0;0;0;0
FR;5;2021-01-02;0;0;0;0;0;0;0;0;0;0;0;0;0;0;0;0;0;0
FR;5;2021-01-03;0;0;0;0;0;0;0;0;0;0;0;0;0;0;0;0;0;0
FR;5;2021-01-04;0;0;0;0;0;0;0;0;0;0;0;0;0;0;0;0;0;0
FR;5;2021-01-05;0;0;0;0;0;0;0;0;0;0;0;0;0;0;0;0;0;0
FR;5;2021-01-06;0;0;0;0;0;0;0;0;0;0;0;0;0;0;0;0;0;0
FR;5;2021-01-07;0;0;0;0;0;0;0;0;0;0;0;0;0;0;0;0;0;0
FR;5;2021-01-08;0;0;0;0;0;0;0;0;0;0;0;0;0;0;0;0;0;0
FR;5;2021-01-09;0;0;0;0;0;0;0;0;0;0;0;0;0;0;0;0;0;0
FR;5;2021-01-10;0;0;0;0;0;0;0;0;0;0;0;0;0;0;0;0;0;0
FR;5;2021-01-11;0;0;0;0;0;0;0;0;0;0;0;0;0;0;0;0;0;0
FR;5;2021-01-12;0;0;0;0;0;0;0;0;0;0;0;0;0;0;0;0;0;0
FR;5;2021-01-13;0;0;0;0;0;0;0;0;0;0;0;0;0;0;0;0;0;0
FR;5;2021-01-14;0;0;0;0;0;0;0;0;0;0;0;0;0;0;0;0;0;0
FR;5;2021-01-15;0;0;0;0;0;0;0;0;0;0;0;0;0;0;0;0;0;0
FR;5;2021-01-16;0;0;0;0;0;0;0;0;0;0;0;0;0;0;0;0;0;0
FR;5;2021-01-17;0;0;0;0;0;0;0;0;0;0;0;0;0;0;0;0;0;0
FR;5;2021-01-18;0;0;0;0;0;0;0;0;0;0;0;0;0;0;0;0;0;0
FR;5;2021-01-19;0;0;0;0;0;0;0;0;0;0;0;0;0;0;0;0;0;0
FR;5;2021-01-20;0;0;0;0;0;0;0;0;0;0;0;0;0;0;0;0;0;0
FR;5;2021-01-21;0;0;0;0;0;0;0;0;0;0;0;0;0;0;0;0;0;0
FR;5;2021-01-22;0;0;0;0;0;0;0;0;0;0;0;0;0;0;0;0;0;0
FR;5;2021-01-23;0;0;0;0;0;0;0;0;0;0;0;0;0;0;0;0;0;0
FR;5;2021-01-24;0;0;0;0;0;0;0;0;0;0;0;0;0;0;0;0;0;0
FR;5;2021-01-25;0;0;0;0;0;0;0;0;0;0;0;0;0;0;0;0;0;0
FR;5;2021-01-26;0;0;0;0;0;0;0;0;0;0;0;0;0;0;0;0;0;0
FR;5;2021-01-27;0;0;0;0;0;0;0;0;0;0;0;0;0;0;0;0;0;0
FR;5;2021-01-28;0;0;0;0;0;0;0;0;0;0;0;0;0;0;0;0;0;0
FR;5;2021-01-29;0;0;0;0;0;0;0;0;0;0;0;0;0;0;0;0;0;0
FR;5;2021-01-30;0;0;0;0;0;0;0;0;0;0;0;0;0;0;0;0;0;0
FR;5;2021-01-31;0;0;0;0;0;0;0;0;0;0;0;0;0;0;0;0;0;0
FR;5;2021-02-01;0;0;0;0;0;0;0;0;0;0;0;0;0;0;0;0;0;0
FR;5;2021-02-02;0;0;0;0;0;0;0;0;0;0;0;0;0;0;0;0;0;0
FR;5;2021-02-03;0;0;0;0;0;0;0;0;0;0;0;0;0;0;0;0;0;0
FR;5;2021-02-04;0;0;0;0;0;0;0;0;0;0;0;0;0;0;0;0;0;0
FR;5;2021-02-05;0;0;0;0;0;0;0;0;0;0;0;0;0;0;0;0;0;0
FR;5;2021-02-06;0;0;0;0;0;0;0;0;0;0;0;0;0;0;0;0;0;0
FR;5;2021-02-07;0;0;0;0;0;0;0;0;0;0;0;0;0;0;0;0;0;0
FR;5;2021-02-08;0;0;0;0;0;0;0;0;0;0;0;0;0;0;0;0;0;0
FR;5;2021-02-09;0;0;0;0;0;0;0;0;0;0;0;0;0;0;0;0;0;0
FR;5;2021-02-10;0;0;0;0;0;0;0;0;0;0;0;0;0;0;0;0;0;0
FR;5;2021-02-11;0;0;0;0;0;0;0;0;0;0;0;0;0;0;0;0;0;0
FR;5;2021-02-12;0;0;0;0;0;0;0;0;0;0;0;0;0;0;0;0;0;0
FR;5;2021-02-13;0;0;0;0;0;0;0;0;0;0;0;0;0;0;0;0;0;0
FR;5;2021-02-14;0;0;0;0;0;0;0;0;0;0;0;0;0;0;0;0;0;0
FR;5;2021-02-15;0;0;0;0;0;0;0;0;0;0;0;0;0;0;0;0;0;0
FR;5;2021-02-16;0;0;0;0;0;0;0;0;0;0;0;0;0;0;0;0;0;0
FR;5;2021-02-17;0;0;0;0;0;0;0;0;0;0;0;0;0;0;0;0;0;0
FR;5;2021-02-18;0;0;0;0;0;0;0;0;0;0;0;0;0;0;0;0;0;0
FR;5;2021-02-19;0;0;0;0;0;0;0;0;0;0;0;0;0;0;0;0;0;0
FR;5;2021-02-20;0;0;0;0;0;0;0;0;0;0;0;0;0;0;0;0;0;0
FR;5;2021-02-21;0;0;0;0;0;0;0;0;0;0;0;0;0;0;0;0;0;0
FR;5;2021-02-22;0;0;0;0;0;0;0;0;0;0;0;0;0;0;0;0;0;0
FR;5;2021-02-23;0;0;0;0;0;0;0;0;0;0;0;0;0;0;0;0;0;0
FR;5;2021-02-24;0;0;0;0;0;0;0;0;0;0;0;0;0;0;0;0;0;0
FR;5;2021-02-25;0;0;0;0;0;0;0;0;0;0;0;0;0;0;0;0;0;0
FR;5;2021-02-26;0;0;0;0;0;0;0;0;0;0;0;0;0;0;0;0;0;0
FR;5;2021-02-27;0;0;0;0;0;0;0;0;0;0;0;0;0;0;0;0;0;0
FR;5;2021-02-28;0;0;0;0;0;0;0;0;0;0;0;0;0;0;0;0;0;0
FR;5;2021-03-01;0;0;0;0;0;0;0;0;0;0;0;0;0;0;0;0;0;0
FR;5;2021-03-02;0;0;0;0;0;0;0;0;0;0;0;0;0;0;0;0;0;0
FR;5;2021-03-03;0;0;0;0;0;0;0;0;0;0;0;0;0;0;0;0;0;0
FR;5;2021-03-04;0;0;0;0;0;0;0;0;0;0;0;0;0;0;0;0;0;0
FR;5;2021-03-05;0;0;0;0;0;0;0;0;0;0;0;0;0;0;0;0;0;0
FR;5;2021-03-06;0;0;0;0;0;0;0;0;0;0;0;0;0;0;0;0;0;0
FR;5;2021-03-07;0;0;0;0;0;0;0;0;0;0;0;0;0;0;0;0;0;0
FR;5;2021-03-08;0;0;0;0;0;0;0;0;0;0;0;0;0;0;0;0;0;0
FR;5;2021-03-09;0;0;0;0;0;0;0;0;0;0;0;0;0;0;0;0;0;0
FR;5;2021-03-10;0;0;0;0;0;0;0;0;0;0;0;0;0;0;0;0;0;0
FR;5;2021-03-11;0;0;0;0;0;0;0;0;0;0;0;0;0;0;0;0;0;0
FR;5;2021-03-12;0;0;0;0;0;0;0;0;0;0;0;0;0;0;0;0;0;0
FR;5;2021-03-13;0;0;0;0;0;0;0;0;0;0;0;0;0;0;0;0;0;0
FR;5;2021-03-14;0;0;0;0;0;0;0;0;0;0;0;0;0;0;0;0;0;0
FR;5;2021-03-15;0;0;0;0;0;0;0;0;0;0;0;0;0;0;0;0;0;0
FR;5;2021-03-16;0;0;0;0;0;0;0;0;0;0;0;0;0;0;0;0;0;0
FR;5;2021-03-17;0;0;0;0;0;0;0;0;0;0;0;0;0;0;0;0;0;0
FR;5;2021-03-18;0;0;0;0;0;0;0;0;0;0;0;0;0;0;0;0;0;0
FR;5;2021-03-19;0;0;0;0;0;0;0;0;0;0;0;0;0;0;0;0;0;0
FR;5;2021-03-20;0;0;0;0;0;0;0;0;0;0;0;0;0;0;0;0;0;0
FR;5;2021-03-21;0;0;0;0;0;0;0;0;0;0;0;0;0;0;0;0;0;0
FR;5;2021-03-22;0;0;0;0;0;0;0;0;0;0;0;0;0;0;0;0;0;0
FR;5;2021-03-23;0;0;0;0;0;0;0;0;0;0;0;0;0;0;0;0;0;0
FR;5;2021-03-24;0;0;0;0;0;0;0;0;0;0;0;0;0;0;0;0;0;0
FR;5;2021-03-25;0;0;0;0;0;0;0;0;0;0;0;0;0;0;0;0;0;0
FR;5;2021-03-26;0;0;0;0;0;0;0;0;0;0;0;0;0;0;0;0;0;0
FR;5;2021-03-27;0;0;0;0;0;0;0;0;0;0;0;0;0;0;0;0;0;0
FR;5;2021-03-28;0;0;0;0;0;0;0;0;0;0;0;0;0;0;0;0;0;0
FR;5;2021-03-29;0;0;0;0;0;0;0;0;0;0;0;0;0;0;0;0;0;0
FR;5;2021-03-30;0;0;0;0;0;0;0;0;0;0;0;0;0;0;0;0;0;0
FR;5;2021-03-31;0;0;0;0;0;0;0;0;0;0;0;0;0;0;0;0;0;0
FR;5;2021-04-01;0;0;0;0;0;0;0;0;0;0;0;0;0;0;0;0;0;0
FR;5;2021-04-02;0;0;0;0;0;0;0;0;0;0;0;0;0;0;0;0;0;0
FR;5;2021-04-03;0;0;0;0;0;0;0;0;0;0;0;0;0;0;0;0;0;0
FR;5;2021-04-04;0;0;0;0;0;0;0;0;0;0;0;0;0;0;0;0;0;0
FR;5;2021-04-05;0;0;0;0;0;0;0;0;0;0;0;0;0;0;0;0;0;0
FR;5;2021-04-06;0;0;0;0;0;0;0;0;0;0;0;0;0;0;0;0;0;0
FR;5;2021-04-07;0;0;0;0;0;0;0;0;0;0;0;0;0;0;0;0;0;0
FR;5;2021-04-08;0;0;0;0;0;0;0;0;0;0;0;0;0;0;0;0;0;0
FR;5;2021-04-09;0;0;0;0;0;0;0;0;0;0;0;0;0;0;0;0;0;0
FR;5;2021-04-10;0;0;0;0;0;0;0;0;0;0;0;0;0;0;0;0;0;0
FR;5;2021-04-11;0;0;0;0;0;0;0;0;0;0;0;0;0;0;0;0;0;0
FR;5;2021-04-12;0;0;0;0;0;0;0;0;0;0;0;0;0;0;0;0;0;0
FR;5;2021-04-13;0;0;0;0;0;0;0;0;0;0;0;0;0;0;0;0;0;0
FR;5;2021-04-14;0;0;0;0;0;0;0;0;0;0;0;0;0;0;0;0;0;0
FR;5;2021-04-15;0;0;0;0;0;0;0;0;0;0;0;0;0;0;0;0;0;0
FR;5;2021-04-16;0;0;0;0;0;0;0;0;0;0;0;0;0;0;0;0;0;0
FR;5;2021-04-17;0;0;0;0;0;0;0;0;0;0;0;0;0;0;0;0;0;0
FR;5;2021-04-18;0;0;0;0;0;0;0;0;0;0;0;0;0;0;0;0;0;0
FR;5;2021-04-19;0;0;0;0;0;0;0;0;0;0;0;0;0;0;0;0;0;0
FR;5;2021-04-20;0;0;0;0;0;0;0;0;0;0;0;0;0;0;0;0;0;0
FR;5;2021-04-21;0;0;0;0;0;0;0;0;0;0;0;0;0;0;0;0;0;0
FR;5;2021-04-22;0;0;0;0;0;0;0;0;0;0;0;0;0;0;0;0;0;0
FR;5;2021-04-23;0;0;0;0;0;0;0;0;0;0;0;0;0;0;0;0;0;0
FR;5;2021-04-24;0;0;0;0;0;0;0;0;0;0;0;0;0;0;0;0;0;0
FR;5;2021-04-25;0;0;0;0;0;0;0;0;0;0;0;0;0;0;0;0;0;0
FR;5;2021-04-26;0;0;0;0;0;0;0;0;0;0;0;0;0;0;0;0;0;0
FR;5;2021-04-27;0;0;0;0;0;0;0;0;0;0;0;0;0;0;0;0;0;0
FR;5;2021-04-28;0;0;0;0;0;0;0;0;0;0;0;0;0;0;0;0;0;0
FR;5;2021-04-29;0;0;0;0;0;0;0;0;0;0;0;0;0;0;0;0;0;0
FR;5;2021-04-30;0;0;0;0;0;0;0;0;0;0;0;0;0;0;0;0;0;0
FR;5;2021-05-01;0;0;0;0;0;0;0;0;0;0;0;0;0;0;0;0;0;0
FR;5;2021-05-02;0;0;0;0;0;0;0;0;0;0;0;0;0;0;0;0;0;0
FR;5;2021-05-03;0;0;0;0;0;0;0;0;0;0;0;0;0;0;0;0;0;0
FR;5;2021-05-04;0;0;0;0;0;0;0;0;0;0;0;0;0;0;0;0;0;0
FR;5;2021-05-05;0;0;0;0;0;0;0;0;0;0;0;0;0;0;0;0;0;0
FR;5;2021-05-06;0;0;0;0;0;0;0;0;0;0;0;0;0;0;0;0;0;0
FR;5;2021-05-07;0;0;0;0;0;0;0;0;0;0;0;0;0;0;0;0;0;0
FR;5;2021-05-08;0;0;0;0;0;0;0;0;0;0;0;0;0;0;0;0;0;0
FR;5;2021-05-09;0;0;0;0;0;0;0;0;0;0;0;0;0;0;0;0;0;0
FR;5;2021-05-10;0;0;0;0;0;0;0;0;0;0;0;0;0;0;0;0;0;0
FR;5;2021-05-11;0;0;0;0;0;0;0;0;0;0;0;0;0;0;0;0;0;0
FR;5;2021-05-12;0;0;0;0;0;0;0;0;0;0;0;0;0;0;0;0;0;0
FR;5;2021-05-13;0;0;0;0;0;0;0;0;0;0;0;0;0;0;0;0;0;0
FR;5;2021-05-14;0;0;0;0;0;0;0;0;0;0;0;0;0;0;0;0;0;0
FR;5;2021-05-15;0;0;0;0;0;0;0;0;0;0;0;0;0;0;0;0;0;0
FR;5;2021-05-16;0;0;0;0;0;0;0;0;0;0;0;0;0;0;0;0;0;0
FR;5;2021-05-17;0;0;0;0;0;0;0;0;0;0;0;0;0;0;0;0;0;0
FR;5;2021-05-18;0;0;0;0;0;0;0;0;0;0;0;0;0;0;0;0;0;0
FR;5;2021-05-19;0;0;0;0;0;0;0;0;0;0;0;0;0;0;0;0;0;0
FR;5;2021-05-20;0;0;0;0;0;0;0;0;0;0;0;0;0;0;0;0;0;0
FR;5;2021-05-21;0;0;0;0;0;0;0;0;0;0;0;0;0;0;0;0;0;0
FR;5;2021-05-22;0;0;0;0;0;0;0;0;0;0;0;0;0;0;0;0;0;0
FR;5;2021-05-23;0;0;0;0;0;0;0;0;0;0;0;0;0;0;0;0;0;0
FR;5;2021-05-24;0;0;0;0;0;0;0;0;0;0;0;0;0;0;0;0;0;0
FR;5;2021-05-25;0;0;0;0;0;0;0;0;0;0;0;0;0;0;0;0;0;0
FR;5;2021-05-26;0;0;0;0;0;0;0;0;0;0;0;0;0;0;0;0;0;0
FR;5;2021-05-27;0;0;0;0;0;0;0;0;0;0;0;0;0;0;0;0;0;0
FR;5;2021-05-28;0;0;0;0;0;0;0;0;0;0;0;0;0;0;0;0;0;0
FR;5;2021-05-29;0;0;0;0;0;0;0;0;0;0;0;0;0;0;0;0;0;0
FR;5;2021-05-30;0;0;0;0;0;0;0;0;0;0;0;0;0;0;0;0;0;0
FR;5;2021-05-31;0;0;0;0;0;0;0;0;0;0;0;0;0;0;0;0;0;0
FR;5;2021-06-01;0;0;0;0;0;0;0;0;0;0;0;0;0;0;0;0;0;0
FR;5;2021-06-02;0;0;0;0;0;0;0;0;0;0;0;0;0;0;0;0;0;0
FR;5;2021-06-03;0;0;0;0;0;0;0;0;0;0;0;0;0;0;0;0;0;0
FR;5;2021-06-04;0;0;0;0;0;0;0;0;0;0;0;0;0;0;0;0;0;0
FR;5;2021-06-05;0;0;0;0;0;0;0;0;0;0;0;0;0;0;0;0;0;0
FR;5;2021-06-06;0;0;0;0;0;0;0;0;0;0;0;0;0;0;0;0;0;0
FR;5;2021-06-07;0;0;0;0;0;0;0;0;0;0;0;0;0;0;0;0;0;0
FR;5;2021-06-08;0;0;0;0;0;0;0;0;0;0;0;0;0;0;0;0;0;0
FR;5;2021-06-09;0;0;0;0;0;0;0;0;0;0;0;0;0;0;0;0;0;0
FR;5;2021-06-10;0;0;0;0;0;0;0;0;0;0;0;0;0;0;0;0;0;0
FR;5;2021-06-11;0;0;0;0;0;0;0;0;0;0;0;0;0;0;0;0;0;0
FR;5;2021-06-12;0;0;0;0;0;0;0;0;0;0;0;0;0;0;0;0;0;0
FR;5;2021-06-13;0;0;0;0;0;0;0;0;0;0;0;0;0;0;0;0;0;0
FR;5;2021-06-14;0;0;0;0;0;0;0;0;0;0;0;0;0;0;0;0;0;0
FR;5;2021-06-15;0;0;0;0;0;0;0;0;0;0;0;0;0;0;0;0;0;0
FR;5;2021-06-16;0;0;0;0;0;0;0;0;0;0;0;0;0;0;0;0;0;0
FR;5;2021-06-17;0;0;0;0;0;0;0;0;0;0;0;0;0;0;0;0;0;0
FR;5;2021-06-18;0;0;0;0;0;0;0;0;0;0;0;0;0;0;0;0;0;0
FR;5;2021-06-19;0;0;0;0;0;0;0;0;0;0;0;0;0;0;0;0;0;0
FR;5;2021-06-20;0;0;0;0;0;0;0;0;0;0;0;0;0;0;0;0;0;0
FR;5;2021-06-21;0;0;0;0;0;0;0;0;0;0;0;0;0;0;0;0;0;0
FR;5;2021-06-22;0;0;0;0;0;0;0;0;0;0;0;0;0;0;0;0;0;0
FR;5;2021-06-23;0;0;0;0;0;0;0;0;0;0;0;0;0;0;0;0;0;0
FR;5;2021-06-24;0;0;0;0;0;0;0;0;0;0;0;0;0;0;0;0;0;0
FR;5;2021-06-25;0;0;0;0;0;0;0;0;0;0;0;0;0;0;0;0;0;0
FR;5;2021-06-26;0;0;0;0;0;0;0;0;0;0;0;0;0;0;0;0;0;0
FR;5;2021-06-27;0;0;0;0;0;0;0;0;0;0;0;0;0;0;0;0;0;0
FR;5;2021-06-28;0;0;0;0;0;0;0;0;0;0;0;0;0;0;0;0;0;0
FR;5;2021-06-29;0;0;0;0;0;0;0;0;0;0;0;0;0;0;0;0;0;0
FR;5;2021-06-30;0;0;0;0;0;0;0;0;0;0;0;0;0;0;0;0;0;0
FR;5;2021-07-01;0;0;0;0;0;0;0;0;0;0;0;0;0;0;0;0;0;0
FR;5;2021-07-02;0;0;0;0;0;0;0;0;0;0;0;0;0;0;0;0;0;0
FR;5;2021-07-03;0;0;0;0;0;0;0;0;0;0;0;0;0;0;0;0;0;0
FR;5;2021-07-04;0;0;0;0;0;0;0;0;0;0;0;0;0;0;0;0;0;0
FR;5;2021-07-05;0;0;0;0;0;0;0;0;0;0;0;0;0;0;0;0;0;0
FR;5;2021-07-06;0;0;0;0;0;0;0;0;0;0;0;0;0;0;0;0;0;0
FR;5;2021-07-07;0;0;0;0;0;0;0;0;0;0;0;0;0;0;0;0;0;0
FR;5;2021-07-08;0;0;0;0;0;0;0;0;0;0;0;0;0;0;0;0;0;0
FR;5;2021-07-09;0;0;0;0;0;0;0;0;0;0;0;0;0;0;0;0;0;0
FR;5;2021-07-10;0;0;0;0;0;0;0;0;0;0;0;0;0;0;0;0;0;0
FR;5;2021-07-11;0;0;0;0;0;0;0;0;0;0;0;0;0;0;0;0;0;0
FR;5;2021-07-12;0;0;0;0;0;0;0;0;0;0;0;0;0;0;0;0;0;0
FR;5;2021-07-13;0;0;0;0;0;0;0;0;0;0;0;0;0;0;0;0;0;0
FR;5;2021-07-14;0;0;0;0;0;0;0;0;0;0;0;0;0;0;0;0;0;0
FR;5;2021-07-15;0;0;0;0;0;0;0;0;0;0;0;0;0;0;0;0;0;0
FR;5;2021-07-16;0;0;0;0;0;0;0;0;0;0;0;0;0;0;0;0;0;0
FR;5;2021-07-17;0;0;0;0;0;0;0;0;0;0;0;0;0;0;0;0;0;0
FR;5;2021-07-18;0;0;0;0;0;0;0;0;0;0;0;0;0;0;0;0;0;0
FR;5;2021-07-19;0;0;0;0;0;0;0;0;0;0;0;0;0;0;0;0;0;0
FR;5;2021-07-20;0;0;0;0;0;0;0;0;0;0;0;0;0;0;0;0;0;0
FR;5;2021-07-21;0;0;0;0;0;0;0;0;0;0;0;0;0;0;0;0;0;0
FR;5;2021-07-22;0;0;0;0;0;0;0;0;0;0;0;0;0;0;0;0;0;0
FR;5;2021-07-23;0;0;0;0;0;0;0;0;0;0;0;0;0;0;0;0;0;0
FR;5;2021-07-24;0;0;0;0;0;0;0;0;0;0;0;0;0;0;0;0;0;0
FR;5;2021-07-25;0;0;0;0;0;0;0;0;0;0;0;0;0;0;0;0;0;0
FR;5;2021-07-26;0;0;0;0;0;0;0;0;0;0;0;0;0;0;0;0;0;0
FR;5;2021-07-27;0;0;0;0;0;0;0;0;0;0;0;0;0;0;0;0;0;0
FR;5;2021-07-28;0;0;0;0;0;0;0;0;0;0;0;0;0;0;0;0;0;0
FR;5;2021-07-29;0;0;0;0;0;0;0;0;0;0;0;0;0;0;0;0;0;0
FR;5;2021-07-30;0;0;0;0;0;0;0;0;0;0;0;0;0;0;0;0;0;0
FR;5;2021-07-31;0;0;0;0;0;0;0;0;0;0;0;0;0;0;0;0;0;0
FR;5;2021-08-01;0;0;0;0;0;0;0;0;0;0;0;0;0;0;0;0;0;0
FR;5;2021-08-02;0;0;0;0;0;0;0;0;0;0;0;0;0;0;0;0;0;0
FR;5;2021-08-03;0;0;0;0;0;0;0;0;0;0;0;0;0;0;0;0;0;0
FR;5;2021-08-04;0;0;0;0;0;0;0;0;0;0;0;0;0;0;0;0;0;0
FR;5;2021-08-05;0;0;0;0;0;0;0;0;0;0;0;0;0;0;0;0;0;0
FR;5;2021-08-06;0;0;0;0;0;0;0;0;0;0;0;0;0;0;0;0;0;0
FR;5;2021-08-07;0;0;0;0;0;0;0;0;0;0;0;0;0;0;0;0;0;0
FR;5;2021-08-08;0;0;0;0;0;0;0;0;0;0;0;0;0;0;0;0;0;0
FR;5;2021-08-09;0;0;0;0;0;0;0;0;0;0;0;0;0;0;0;0;0;0
FR;5;2021-08-10;0;0;0;0;0;0;0;0;0;0;0;0;0;0;0;0;0;0
FR;5;2021-08-11;0;0;0;0;0;0;0;0;0;0;0;0;0;0;0;0;0;0
FR;5;2021-08-12;0;0;0;0;0;0;0;0;0;0;0;0;0;0;0;0;0;0
FR;5;2021-08-13;0;0;0;0;0;0;0;0;0;0;0;0;0;0;0;0;0;0
FR;5;2021-08-14;0;0;0;0;0;0;0;0;0;0;0;0;0;0;0;0;0;0
FR;5;2021-08-15;0;0;0;0;0;0;0;0;0;0;0;0;0;0;0;0;0;0
FR;5;2021-08-16;0;0;0;0;0;0;0;0;0;0;0;0;0;0;0;0;0;0
FR;5;2021-08-17;0;0;0;0;0;0;0;0;0;0;0;0;0;0;0;0;0;0
FR;5;2021-08-18;0;0;0;0;0;0;0;0;0;0;0;0;0;0;0;0;0;0
FR;5;2021-08-19;0;0;0;0;0;0;0;0;0;0;0;0;0;0;0;0;0;0
FR;5;2021-08-20;0;0;0;0;0;0;0;0;0;0;0;0;0;0;0;0;0;0
FR;5;2021-08-21;0;0;0;0;0;0;0;0;0;0;0;0;0;0;0;0;0;0
FR;5;2021-08-22;0;0;0;0;0;0;0;0;0;0;0;0;0;0;0;0;0;0
FR;5;2021-08-23;0;0;0;0;0;0;0;0;0;0;0;0;0;0;0;0;0;0
FR;5;2021-08-24;0;0;0;0;0;0;0;0;0;0;0;0;0;0;0;0;0;0
FR;5;2021-08-25;0;0;0;0;0;0;0;0;0;0;0;0;0;0;0;0;0;0
FR;5;2021-08-26;0;0;0;0;0;0;0;0;0;0;0;0;0;0;0;0;0;0
FR;5;2021-08-27;0;0;0;0;0;0;0;0;0;0;0;0;0;0;0;0;0;0
FR;5;2021-08-28;0;0;0;0;0;0;0;0;0;0;0;0;0;0;0;0;0;0
FR;5;2021-08-29;0;0;0;0;0;0;0;0;0;0;0;0;0;0;0;0;0;0
FR;5;2021-08-30;0;0;0;0;0;0;0;0;0;0;0;0;0;0;0;0;0;0
FR;5;2021-08-31;0;0;0;0;0;0;0;0;0;0;0;0;0;0;0;0;0;0
FR;5;2021-09-01;0;0;0;0;0;0;0;0;0;0;0;0;0;0;0;0;0;0
FR;5;2021-09-02;0;0;0;0;0;0;0;0;0;0;0;0;0;0;0;0;0;0
FR;5;2021-09-03;0;0;0;0;0;0;0;0;0;0;0;0;0;0;0;0;0;0
FR;5;2021-09-04;0;0;0;0;0;0;0;0;0;0;0;0;0;0;0;0;0;0
FR;5;2021-09-05;0;0;0;0;0;0;0;0;0;0;0;0;0;0;0;0;0;0
FR;5;2021-09-06;0;0;0;0;0;0;0;0;0;0;0;0;0;0;0;0;0;0
FR;5;2021-09-07;0;0;0;0;0;0;0;0;0;0;0;0;0;0;0;0;0;0
FR;5;2021-09-08;0;0;0;0;0;0;0;0;0;0;0;0;0;0;0;0;0;0
FR;5;2021-09-09;0;0;0;0;0;0;0;0;0;0;0;0;0;0;0;0;0;0
FR;5;2021-09-10;0;0;0;0;0;0;0;0;0;0;0;0;0;0;0;0;0;0
FR;5;2021-09-11;0;0;0;0;0;0;0;0;0;0;0;0;0;0;0;0;0;0
FR;5;2021-09-12;0;0;0;0;0;0;0;0;0;0;0;0;0;0;0;0;0;0
FR;5;2021-09-13;0;0;0;0;0;0;0;0;0;0;0;0;0;0;0;0;0;0
FR;5;2021-09-14;0;0;0;0;0;0;0;0;0;0;0;0;0;0;0;0;0;0
FR;5;2021-09-15;0;0;0;0;0;0;0;0;0;0;0;0;0;0;0;0;0;0
FR;5;2021-09-16;0;0;0;0;0;0;0;0;0;0;0;0;0;0;0;0;0;0
FR;5;2021-09-17;0;0;0;0;0;0;0;0;0;0;0;0;0;0;0;0;0;0
FR;5;2021-09-18;0;0;0;0;0;0;0;0;0;0;0;0;0;0;0;0;0;0
FR;5;2021-09-19;0;0;0;0;0;0;0;0;0;0;0;0;0;0;0;0;0;0
FR;5;2021-09-20;0;0;0;0;0;0;0;0;0;0;0;0;0;0;0;0;0;0
FR;5;2021-09-21;0;0;0;0;0;0;0;0;0;0;0;0;0;0;0;0;0;0
FR;5;2021-09-22;0;0;0;0;0;0;0;0;0;0;0;0;0;0;0;0;0;0
FR;5;2021-09-23;0;0;0;0;0;0;0;0;0;0;0;0;0;0;0;0;0;0
FR;5;2021-09-24;0;0;0;0;0;0;0;0;0;0;0;0;0;0;0;0;0;0
FR;5;2021-09-25;0;0;0;0;0;0;0;0;0;0;0;0;0;0;0;0;0;0
FR;5;2021-09-26;0;0;0;0;0;0;0;0;0;0;0;0;0;0;0;0;0;0
FR;5;2021-09-27;0;0;0;0;0;0;0;0;0;0;0;0;0;0;0;0;0;0
FR;5;2021-09-28;0;0;0;0;0;0;0;0;0;0;0;0;0;0;0;0;0;0
FR;5;2021-09-29;0;0;0;0;0;0;0;0;0;0;0;0;0;0;0;0;0;0
FR;5;2021-09-30;0;0;0;0;0;0;0;0;0;0;0;0;0;0;0;0;0;0
FR;5;2021-10-01;0;0;0;0;0;0;0;0;0;0;0;0;0;0;0;0;0;0
FR;5;2021-10-02;0;0;0;0;0;0;0;0;0;0;0;0;0;0;0;0;0;0
FR;5;2021-10-03;0;0;0;0;0;0;0;0;0;0;0;0;0;0;0;0;0;0
FR;5;2021-10-04;0;0;0;0;0;0;0;0;0;0;0;0;0;0;0;0;0;0
FR;5;2021-10-05;0;0;0;0;0;0;0;0;0;0;0;0;0;0;0;0;0;0
FR;5;2021-10-06;0;0;0;0;0;0;0;0;0;0;0;0;0;0;0;0;0;0
FR;5;2021-10-07;0;0;0;0;0;0;0;0;0;0;0;0;0;0;0;0;0;0
FR;5;2021-10-08;0;0;0;0;0;0;0;0;0;0;0;0;0;0;0;0;0;0
FR;5;2021-10-09;0;0;0;0;0;0;0;0;0;0;0;0;0;0;0;0;0;0
FR;5;2021-10-10;0;0;0;0;0;0;0;0;0;0;0;0;0;0;0;0;0;0
FR;5;2021-10-11;0;0;0;0;0;0;0;0;0;0;0;0;0;0;0;0;0;0
FR;5;2021-10-12;0;0;0;0;0;0;0;0;0;0;0;0;0;0;0;0;0;0
FR;5;2021-10-13;0;0;0;0;0;0;0;0;0;0;0;0;0;0;0;0;0;0
FR;5;2021-10-14;0;0;0;0;0;0;0;0;0;0;0;0;0;0;0;0;0;0
FR;5;2021-10-15;0;0;0;0;0;0;0;0;0;0;0;0;0;0;0;0;0;0
FR;5;2021-10-16;0;0;0;0;0;0;0;0;0;0;0;0;0;0;0;0;0;0
FR;5;2021-10-17;0;0;0;0;0;0;0;0;0;0;0;0;0;0;0;0;0;0
FR;5;2021-10-18;0;0;0;0;0;0;0;0;0;0;0;0;0;0;0;0;0;0
FR;5;2021-10-19;0;0;0;0;0;0;0;0;0;0;0;0;0;0;0;0;0;0
FR;5;2021-10-20;0;0;0;0;0;0;0;0;0;0;0;0;0;0;0;0;0;0
FR;5;2021-10-21;0;0;0;0;0;0;0;0;0;0;0;0;0;0;0;0;0;0
FR;5;2021-10-22;0;0;0;0;0;0;0;0;0;0;0;0;0;0;0;0;0;0
FR;5;2021-10-23;0;0;0;0;0;0;0;0;0;0;0;0;0;0;0;0;0;0
FR;5;2021-10-24;0;0;0;0;0;0;0;0;0;0;0;0;0;0;0;0;0;0
FR;5;2021-10-25;0;0;0;0;0;0;0;0;0;0;0;0;0;0;0;0;0;0
FR;5;2021-10-26;0;0;0;0;0;0;0;0;0;0;0;0;0;0;0;0;0;0
FR;5;2021-10-27;0;0;0;0;0;0;0;0;0;0;0;0;0;0;0;0;0;0
FR;5;2021-10-28;0;0;0;0;0;0;0;0;0;0;0;0;0;0;0;0;0;0
FR;5;2021-10-29;0;0;0;0;0;0;0;0;0;0;0;0;0;0;0;0;0;0
FR;5;2021-10-30;0;0;0;0;0;0;0;0;0;0;0;0;0;0;0;0;0;0
FR;5;2021-10-31;0;0;0;0;0;0;0;0;0;0;0;0;0;0;0;0;0;0
FR;5;2021-11-01;0;0;0;0;0;0;0;0;0;0;0;0;0;0;0;0;0;0
FR;5;2021-11-02;0;0;0;0;0;0;0;0;0;0;0;0;0;0;0;0;0;0
FR;5;2021-11-03;0;0;0;0;0;0;0;0;0;0;0;0;0;0;0;0;0;0
FR;5;2021-11-04;0;0;0;0;0;0;0;0;0;0;0;0;0;0;0;0;0;0
FR;5;2021-11-05;0;0;0;0;0;0;0;0;0;0;0;0;0;0;0;0;0;0
FR;5;2021-11-06;0;0;0;0;0;0;0;0;0;0;0;0;0;0;0;0;0;0
FR;5;2021-11-07;0;0;0;0;0;0;0;0;0;0;0;0;0;0;0;0;0;0
FR;5;2021-11-08;0;0;0;0;0;0;0;0;0;0;0;0;0;0;0;0;0;0
FR;5;2021-11-09;0;0;0;0;0;0;0;0;0;0;0;0;0;0;0;0;0;0
FR;5;2021-11-10;0;0;0;0;0;0;0;0;0;0;0;0;0;0;0;0;0;0
FR;5;2021-11-11;0;0;0;0;0;0;0;0;0;0;0;0;0;0;0;0;0;0
FR;5;2021-11-12;0;0;0;0;0;0;0;0;0;0;0;0;0;0;0;0;0;0
FR;5;2021-11-13;0;0;0;0;0;0;0;0;0;0;0;0;0;0;0;0;0;0
FR;5;2021-11-14;0;0;0;0;0;0;0;0;0;0;0;0;0;0;0;0;0;0
FR;5;2021-11-15;0;0;0;0;0;0;0;0;0;0;0;0;0;0;0;0;0;0
FR;5;2021-11-16;0;0;0;0;0;0;0;0;0;0;0;0;0;0;0;0;0;0
FR;5;2021-11-17;0;0;0;0;0;0;0;0;0;0;0;0;0;0;0;0;0;0
FR;5;2021-11-18;0;0;0;0;0;0;0;0;0;0;0;0;0;0;0;0;0;0
FR;5;2021-11-19;0;0;0;0;0;0;0;0;0;0;0;0;0;0;0;0;0;0
FR;5;2021-11-20;0;0;0;0;0;0;0;0;0;0;0;0;0;0;0;0;0;0
FR;5;2021-11-21;0;0;0;0;0;0;0;0;0;0;0;0;0;0;0;0;0;0
FR;5;2021-11-22;0;0;0;0;0;0;0;0;0;0;0;0;0;0;0;0;0;0
FR;5;2021-11-23;0;0;0;0;0;0;0;0;0;0;0;0;0;0;0;0;0;0
FR;5;2021-11-24;0;0;0;0;0;0;0;0;0;0;0;0;0;0;0;0;0;0
FR;5;2021-11-25;0;0;0;0;0;0;0;0;0;0;0;0;0;0;0;0;0;0
FR;5;2021-11-26;0;0;0;0;0;0;0;0;0;0;0;0;0;0;0;0;0;0
FR;5;2021-11-27;0;0;0;0;0;0;0;0;0;0;0;0;0;0;0;0;0;0
FR;5;2021-11-28;0;0;0;0;0;0;0;0;0;0;0;0;0;0;0;0;0;0
FR;5;2021-11-29;0;0;0;0;0;0;0;0;0;0;0;0;0;0;0;0;0;0
FR;5;2021-11-30;0;0;0;0;0;0;0;0;0;0;0;0;0;0;0;0;0;0
FR;5;2021-12-01;0;0;0;0;0;0;0;0;0;0;0;0;0;0;0;0;0;0
FR;5;2021-12-02;0;0;0;0;0;0;0;0;0;0;0;0;0;0;0;0;0;0
FR;5;2021-12-03;0;0;0;0;0;0;0;0;0;0;0;0;0;0;0;0;0;0
FR;5;2021-12-04;0;0;0;0;0;0;0;0;0;0;0;0;0;0;0;0;0;0
FR;5;2021-12-05;0;0;0;0;0;0;0;0;0;0;0;0;0;0;0;0;0;0
FR;5;2021-12-06;0;0;0;0;0;0;0;0;0;0;0;0;0;0;0;0;0;0
FR;5;2021-12-07;0;0;0;0;0;0;0;0;0;0;0;0;0;0;0;0;0;0
FR;5;2021-12-08;0;0;0;0;0;0;0;0;0;0;0;0;0;0;0;0;0;0
FR;5;2021-12-09;0;0;0;0;0;0;0;0;0;0;0;0;0;0;0;0;0;0
FR;5;2021-12-10;0;0;0;0;0;0;0;0;0;0;0;0;0;0;0;0;0;0
FR;5;2021-12-11;0;0;0;0;0;0;0;0;0;0;0;0;0;0;0;0;0;0
FR;5;2021-12-12;0;0;0;0;0;0;0;0;0;0;0;0;0;0;0;0;0;0
FR;5;2021-12-13;0;0;0;0;0;0;0;0;0;0;0;0;0;0;0;0;0;0
FR;5;2021-12-14;33;45;77;0;27;88;1;0;0;33;45;77;0;27;88;1;0;0
FR;5;2021-12-15;196;44;37;0;42;49;0;0;0;229;89;114;0;69;137;1;0;0
FR;5;2021-12-16;181;21;44;0;38;48;0;0;0;410;110;158;0;107;185;1;0;0
FR;5;2021-12-17;313;16;72;0;34;74;2;0;0;723;126;230;0;141;259;3;0;0
FR;5;2021-12-18;766;24;22;0;67;29;0;0;0;1489;150;252;0;208;288;3;0;0
FR;5;2021-12-19;585;15;15;0;67;17;0;0;0;2074;165;267;0;275;305;3;0;0
FR;5;2021-12-20;1225;31;34;0;134;37;2;0;0;3299;196;301;0;409;342;5;0;0
FR;5;2021-12-21;1535;22;54;1;141;60;0;0;0;4834;218;355;1;550;402;5;0;0
FR;5;2021-12-22;4069;40;37;0;420;46;2;0;0;8903;258;392;1;970;448;7;0;0
FR;5;2021-12-23;3043;16;21;0;305;25;0;0;0;11946;274;413;1;1275;473;7;0;0
FR;5;2021-12-24;761;18;9;0;103;14;0;0;0;12707;292;422;1;1378;487;7;0;0
FR;5;2021-12-25;61;5;2;0;9;3;0;0;0;12768;297;424;1;1387;490;7;0;0
FR;5;2021-12-26;623;6;3;0;101;4;0;0;0;13391;303;427;1;1488;494;7;0;0
FR;5;2021-12-27;4085;25;21;0;458;23;1;0;0;17476;328;448;1;1946;517;8;0;0
FR;5;2021-12-28;5204;23;41;1;513;43;2;0;0;22680;351;489;2;2459;560;10;0;0
FR;5;2021-12-29;8105;34;66;1;888;69;0;0;0;30785;385;555;3;3347;629;10;0;0
FR;5;2021-12-30;5173;18;33;0;525;39;0;0;0;35958;403;588;3;3872;668;10;0;0
FR;5;2021-12-31;1554;8;10;0;182;11;0;0;0;37512;411;598;3;4054;679;10;0;0
FR;5;2022-01-01;186;2;2;0;24;3;0;0;0;37698;413;600;3;4078;682;10;0;0
FR;5;2022-01-02;1489;1;1;0;152;1;0;0;0;39187;414;601;3;4230;683;10;0;0
FR;5;2022-01-03;3069;36;34;0;323;33;1;0;0;42256;450;635;3;4553;716;11;0;0
FR;5;2022-01-04;3034;39;33;0;321;42;3;0;0;45290;489;668;3;4874;758;14;0;0
FR;5;2022-01-05;19324;203;97;1;2118;108;0;0;0;64614;692;765;4;6992;866;14;0;0
FR;5;2022-01-06;3748;134;122;0;507;142;2;0;0;68362;826;887;4;7499;1008;16;0;0
FR;5;2022-01-07;5006;202;48;2;705;56;1;0;0;73368;1028;935;6;8204;1064;17;0;0
FR;5;2022-01-08;13659;514;45;0;2003;52;0;0;0;87027;1542;980;6;10207;1116;17;0;0
FR;5;2022-01-09;5754;399;15;0;1112;20;1;0;0;92781;1941;995;6;11319;1136;18;0;0
FR;5;2022-01-10;3455;326;25;0;735;29;0;0;0;96236;2267;1020;6;12054;1165;18;0;0
FR;5;2022-01-11;3671;283;38;0;661;41;1;0;0;99907;2550;1058;6;12715;1206;19;0;0
FR;5;2022-01-12;22650;3005;89;0;5297;112;2;0;0;122557;5555;1147;6;18012;1318;21;0;0
FR;5;2022-01-13;4039;623;29;0;1052;31;2;0;0;126596;6178;1176;6;19064;1349;23;0;0
FR;5;2022-01-14;4843;583;45;0;1115;52;1;0;0;131439;6761;1221;6;20179;1401;24;0;0
FR;5;2022-01-15;14686;1747;38;3;3378;49;3;0;0;146125;8508;1259;9;23557;1450;27;0;0
FR;5;2022-01-16;4728;666;3;0;1261;5;0;0;0;150853;9174;1262;9;24818;1455;27;0;0
FR;5;2022-01-17;2297;718;26;0;986;29;0;0;0;153150;9892;1288;9;25804;1484;27;0;0
FR;5;2022-01-18;2431;870;30;0;1141;40;0;0;0;155581;10762;1318;9;26945;1524;27;0;0
FR;5;2022-01-19;18484;6423;74;2;8366;142;3;0;0;174065;17185;1392;11;35311;1666;30;0;0
FR;5;2022-01-20;1920;1067;25;0;1295;34;2;0;0;175985;18252;1417;11;36606;1700;32;0;0
FR;5;2022-01-21;3077;1372;47;1;1677;59;2;0;0;179062;19624;1464;12;38283;1759;34;0;0
FR;5;2022-01-22;10720;3454;33;1;4671;43;1;0;0;189782;23078;1497;13;42954;1802;35;0;0
FR;5;2022-01-23;2629;1415;6;0;1789;10;0;0;0;192411;24493;1503;13;44743;1812;35;0;0
FR;5;2022-01-24;1161;1341;19;0;1447;23;1;0;0;193572;25834;1522;13;46190;1835;36;0;0
FR;5;2022-01-25;1220;1550;20;2;1684;31;3;0;0;194792;27384;1542;15;47874;1866;39;0;0
FR;5;2022-01-26;10748;12032;50;1;13300;89;1;0;1;205540;39416;1592;16;61174;1955;40;0;1
FR;5;2022-01-27;1291;1693;10;0;1838;17;0;0;0;206831;41109;1602;16;63012;1972;40;0;1
FR;5;2022-01-28;1698;3346;16;0;3566;19;1;0;0;208529;44455;1618;16;66578;1991;41;0;1
FR;5;2022-01-29;6241;8041;68;0;8855;96;2;0;0;214770;52496;1686;16;75433;2087;43;0;1
FR;5;2022-01-30;1509;2950;5;0;3185;18;0;0;0;216279;55446;1691;16;78618;2105;43;0;1
FR;5;2022-01-31;589;1773;23;0;1837;24;3;0;0;216868;57219;1714;16;80455;2129;46;0;1
FR;5;2022-02-01;712;1706;10;0;1791;15;0;0;0;217580;58925;1724;16;82246;2144;46;0;1
FR;5;2022-02-02;6959;15655;52;0;16603;94;0;0;0;224539;74580;1776;16;98849;2238;46;0;1
FR;5;2022-02-03;492;1691;14;0;1748;13;5;0;0;225031;76271;1790;16;100597;2251;51;0;1
FR;5;2022-02-04;945;3002;19;0;3123;31;0;0;0;225976;79273;1809;16;103720;2282;51;0;1
FR;5;2022-02-05;3536;8919;23;0;9517;37;0;0;0;229512;88192;1832;16;113237;2319;51;0;1
FR;5;2022-02-06;737;2398;10;0;2556;19;0;0;0;230249;90590;1842;16;115793;2338;51;0;1
FR;5;2022-02-07;884;1596;23;0;1715;25;2;0;0;231133;92186;1865;16;117508;2363;53;0;1
FR;5;2022-02-08;725;1287;18;0;1407;20;2;0;0;231858;93473;1883;16;118915;2383;55;0;1
FR;5;2022-02-09;4544;12880;44;0;13608;76;1;0;0;236402;106353;1927;16;132523;2459;56;0;1
FR;5;2022-02-10;646;1059;14;0;1166;15;0;0;0;237048;107412;1941;16;133689;2474;56;0;1
FR;5;2022-02-11;793;2032;16;0;2163;21;1;0;0;237841;109444;1957;16;135852;2495;57;0;1
FR;5;2022-02-12;2286;6812;33;0;7279;53;0;0;0;240127;116256;1990;16;143131;2548;57;0;1
FR;5;2022-02-13;464;1541;8;0;1654;8;1;0;0;240591;117797;1998;16;144785;2556;58;0;1
FR;5;2022-02-14;678;1288;10;0;1407;13;1;0;0;241269;119085;2008;16;146192;2569;59;0;1
FR;5;2022-02-15;482;886;9;0;968;14;1;0;0;241751;119971;2017;16;147160;2583;60;0;1
FR;5;2022-02-16;2980;9124;41;1;9676;58;2;0;0;244731;129095;2058;17;156836;2641;62;0;1
FR;5;2022-02-17;436;809;6;0;876;7;1;0;0;245167;129904;2064;17;157712;2648;63;0;1
FR;5;2022-02-18;649;1408;13;0;1535;17;0;0;0;245816;131312;2077;17;159247;2665;63;0;1
FR;5;2022-02-19;1373;4315;16;0;4623;28;0;0;0;247189;135627;2093;17;163870;2693;63;0;1
FR;5;2022-02-20;247;879;6;0;941;8;0;0;0;247436;136506;2099;17;164811;2701;63;0;1
FR;5;2022-02-21;221;607;2;0;661;4;1;0;0;247657;137113;2101;17;165472;2705;64;0;1
FR;5;2022-02-22;262;545;17;0;591;17;1;0;0;247919;137658;2118;17;166063;2722;65;0;1
FR;5;2022-02-23;1909;6926;23;1;7346;43;0;0;0;249828;144584;2141;18;173409;2765;65;0;1
FR;5;2022-02-24;182;374;6;1;421;7;1;0;0;250010;144958;2147;19;173830;2772;66;0;1
FR;5;2022-02-25;336;951;13;0;1028;12;2;0;0;250346;145909;2160;19;174858;2784;68;0;1
FR;5;2022-02-26;972;3071;11;0;3333;15;2;0;0;251318;148980;2171;19;178191;2799;70;0;1
FR;5;2022-02-27;151;506;0;0;549;3;0;0;0;251469;149486;2171;19;178740;2802;70;0;1
FR;5;2022-02-28;162;369;1;0;408;1;0;0;0;251631;149855;2172;19;179148;2803;70;0;1
FR;5;2022-03-01;130;280;6;0;315;7;1;0;0;251761;150135;2178;19;179463;2810;71;0;1
FR;5;2022-03-02;1242;4156;28;3;4497;40;3;0;0;253003;154291;2206;22;183960;2850;74;0;1
FR;5;2022-03-03;121;251;5;0;271;10;1;0;0;253124;154542;2211;22;184231;2860;75;0;1
FR;5;2022-03-04;197;488;13;0;538;14;2;0;0;253321;155030;2224;22;184769;2874;77;0;1
FR;5;2022-03-05;677;1990;8;0;2243;16;2;0;0;253998;157020;2232;22;187012;2890;79;0;1
FR;5;2022-03-06;108;260;0;0;310;0;0;0;0;254106;157280;2232;22;187322;2890;79;0;1
FR;5;2022-03-07;71;228;5;0;254;3;2;0;0;254177;157508;2237;22;187576;2893;81;0;1
FR;5;2022-03-08;46;134;7;1;141;8;3;0;0;254223;157642;2244;23;187717;2901;84;0;1
FR;5;2022-03-09;911;3078;24;0;3407;36;0;0;0;255134;160720;2268;23;191124;2937;84;0;1
FR;5;2022-03-10;82;202;9;0;216;13;3;0;0;255216;160922;2277;23;191340;2950;87;0;1
FR;5;2022-03-11;148;369;13;1;426;15;0;0;0;255364;161291;2290;24;191766;2965;87;0;1
FR;5;2022-03-12;758;1613;13;1;1977;30;0;0;0;256122;162904;2303;25;193743;2995;87;0;1
FR;5;2022-03-13;78;102;0;0;135;0;0;0;0;256200;163006;2303;25;193878;2995;87;0;1
FR;5;2022-03-14;69;119;7;1;139;7;1;0;0;256269;163125;2310;26;194017;3002;88;0;1
FR;5;2022-03-15;83;99;4;0;119;7;1;0;0;256352;163224;2314;26;194136;3009;89;0;1
FR;5;2022-03-16;882;1827;15;3;2227;36;7;0;0;257234;165051;2329;29;196363;3045;96;0;1
FR;5;2022-03-17;68;123;8;4;151;10;4;0;0;257302;165174;2337;33;196514;3055;100;0;1
FR;5;2022-03-18;172;318;13;4;391;18;4;0;0;257474;165492;2350;37;196905;3073;104;0;1
FR;5;2022-03-19;752;1163;12;5;1555;33;8;0;0;258226;166655;2362;42;198460;3106;112;0;1
FR;5;2022-03-20;45;93;1;0;119;1;0;0;0;258271;166748;2363;42;198579;3107;112;0;1
FR;5;2022-03-21;71;120;10;6;136;15;8;0;0;258342;166868;2373;48;198715;3122;120;0;1
FR;5;2022-03-22;56;119;8;7;143;9;6;0;0;258398;166987;2381;55;198858;3131;126;0;1
FR;5;2022-03-23;805;1461;14;8;1878;36;9;0;0;259203;168448;2395;63;200736;3167;135;0;1
FR;5;2022-03-24;71;93;8;7;118;7;10;0;0;259274;168541;2403;70;200854;3174;145;0;1
FR;5;2022-03-25;222;293;14;8;388;18;9;0;0;259496;168834;2417;78;201242;3192;154;0;1
FR;5;2022-03-26;707;853;12;5;1273;26;6;0;1;260203;169687;2429;83;202515;3218;160;0;2
FR;5;2022-03-27;76;81;0;0;124;3;0;0;0;260279;169768;2429;83;202639;3221;160;0;2
FR;5;2022-03-28;81;93;1;2;132;3;2;0;0;260360;169861;2430;85;202771;3224;162;0;2
FR;5;2022-03-29;71;83;10;4;114;12;5;0;0;260431;169944;2440;89;202885;3236;167;0;2
FR;5;2022-03-30;823;1116;16;13;1604;29;14;0;0;261254;171060;2456;102;204489;3265;181;0;2
FR;5;2022-03-31;102;125;1;4;173;6;4;0;0;261356;171185;2457;106;204662;3271;185;0;2
FR;5;2022-04-01;114;86;7;12;135;11;12;0;1;261470;171271;2464;118;204797;3282;197;0;3
FR;5;2022-04-02;330;349;3;3;535;15;4;0;0;261800;171620;2467;121;205332;3297;201;0;3
FR;5;2022-04-03;54;59;1;0;88;1;0;0;0;261854;171679;2468;121;205420;3298;201;0;3
FR;5;2022-04-04;40;57;4;1;70;8;2;0;0;261894;171736;2472;122;205490;3306;203;0;3
FR;5;2022-04-05;53;60;6;6;75;9;5;0;0;261947;171796;2478;128;205565;3315;208;0;3
FR;5;2022-04-06;421;439;7;14;678;16;14;0;0;262368;172235;2485;142;206243;3331;222;0;3
FR;5;2022-04-07;45;69;5;7;89;7;10;0;0;262413;172304;2490;149;206332;3338;232;0;3
FR;5;2022-04-08;134;112;12;13;175;14;15;0;0;262547;172416;2502;162;206507;3352;247;0;3
FR;5;2022-04-09;311;324;2;5;511;17;5;0;0;262858;172740;2504;167;207018;3369;252;0;3
FR;5;2022-04-10;44;31;2;0;61;2;1;0;0;262902;172771;2506;167;207079;3371;253;0;3
FR;5;2022-04-11;50;60;3;2;78;4;3;0;0;262952;172831;2509;169;207157;3375;256;0;3
FR;5;2022-04-12;59;54;3;3;78;5;3;0;0;263011;172885;2512;172;207235;3380;259;0;3
FR;5;2022-04-13;382;413;3;8;606;16;8;0;0;263393;173298;2515;180;207841;3396;267;0;3
FR;5;2022-04-14;48;53;5;5;70;9;3;0;0;263441;173351;2520;185;207911;3405;270;0;3
FR;5;2022-04-15;91;111;4;4;152;5;6;0;0;263532;173462;2524;189;208063;3410;276;0;3
FR;5;2022-04-16;188;184;2;1;265;13;1;0;0;263720;173646;2526;190;208328;3423;277;0;3
FR;5;2022-04-17;12;11;1;0;17;1;0;0;0;263732;173657;2527;190;208345;3424;277;0;3
FR;5;2022-04-18;9;10;2;0;11;3;1;0;0;263741;173667;2529;190;208356;3427;278;0;3
FR;5;2022-04-19;75;71;6;1;96;6;4;0;0;263816;173738;2535;191;208452;3433;282;0;3
FR;5;2022-04-20;361;349;9;6;521;12;7;0;0;264177;174087;2544;197;208973;3445;289;0;3
FR;5;2022-04-21;42;64;9;10;71;12;14;0;0;264219;174151;2553;207;209044;3457;303;0;3
FR;5;2022-04-22;113;96;5;4;144;5;5;0;0;264332;174247;2558;211;209188;3462;308;0;3
FR;5;2022-04-23;209;193;4;2;284;11;3;0;0;264541;174440;2562;213;209472;3473;311;0;3
FR;5;2022-04-24;37;35;0;0;50;3;0;0;0;264578;174475;2562;213;209522;3476;311;0;3
FR;5;2022-04-25;69;65;1;1;102;4;1;0;0;264647;174540;2563;214;209624;3480;312;0;3
FR;5;2022-04-26;60;63;2;1;85;5;1;0;0;264707;174603;2565;215;209709;3485;313;0;3
FR;5;2022-04-27;335;316;3;7;463;14;8;0;0;265042;174919;2568;222;210172;3499;321;0;3
FR;5;2022-04-28;81;54;4;5;81;8;7;0;0;265123;174973;2572;227;210253;3507;328;0;3
FR;5;2022-04-29;117;84;5;19;118;12;17;0;0;265240;175057;2577;246;210371;3519;345;0;3
FR;5;2022-04-30;183;114;2;3;184;10;4;0;0;265423;175171;2579;249;210555;3529;349;0;3
FR;5;2022-05-01;11;7;0;0;11;0;0;0;0;265434;175178;2579;249;210566;3529;349;0;3
FR;5;2022-05-02;52;28;4;5;48;2;7;0;0;265486;175206;2583;254;210614;3531;356;0;3
FR;5;2022-05-03;87;57;2;4;84;11;4;0;0;265573;175263;2585;258;210698;3542;360;0;3
FR;5;2022-05-04;278;205;1;2;324;7;2;0;0;265851;175468;2586;260;211022;3549;362;0;3
FR;5;2022-05-05;62;32;3;4;46;5;4;0;0;265913;175500;2589;264;211068;3554;366;0;3
FR;5;2022-05-06;105;65;2;3;106;5;3;0;0;266018;175565;2591;267;211174;3559;369;0;3
FR;5;2022-05-07;171;117;2;10;180;13;7;0;0;266189;175682;2593;277;211354;3572;376;0;3
FR;5;2022-05-08;8;8;0;0;9;2;0;0;0;266197;175690;2593;277;211363;3574;376;0;3
FR;5;2022-05-09;44;34;15;3;51;16;4;0;0;266241;175724;2608;280;211414;3590;380;0;3
FR;5;2022-05-10;54;49;3;4;67;5;5;0;0;266295;175773;2611;284;211481;3595;385;0;3
FR;5;2022-05-11;327;237;12;7;344;21;11;0;0;266622;176010;2623;291;211825;3616;396;0;3
FR;5;2022-05-12;46;34;2;2;47;2;3;0;0;266668;176044;2625;293;211872;3618;399;0;3
FR;5;2022-05-13;109;83;3;8;120;8;7;0;0;266777;176127;2628;301;211992;3626;406;0;3
FR;5;2022-05-14;209;131;0;1;212;8;0;0;0;266986;176258;2628;302;212204;3634;406;0;3
FR;5;2022-05-15;22;9;2;0;18;1;1;0;0;267008;176267;2630;302;212222;3635;407;0;3
FR;5;2022-05-16;52;34;4;5;53;4;5;0;0;267060;176301;2634;307;212275;3639;412;0;3
FR;5;2022-05-17;72;40;5;0;68;2;3;0;0;267132;176341;2639;307;212343;3641;415;0;3
FR;5;2022-05-18;289;215;4;4;330;8;6;0;0;267421;176556;2643;311;212673;3649;421;0;3
FR;5;2022-05-19;45;35;5;3;42;3;4;0;0;267466;176591;2648;314;212715;3652;425;0;3
FR;5;2022-05-20;76;63;3;10;92;1;11;0;0;267542;176654;2651;324;212807;3653;436;0;3
FR;5;2022-05-21;242;166;2;3;268;17;1;0;0;267784;176820;2653;327;213075;3670;437;0;3
FR;5;2022-05-22;20;14;2;5;20;2;6;0;0;267804;176834;2655;332;213095;3672;443;0;3
FR;5;2022-05-23;42;31;4;3;42;6;3;0;0;267846;176865;2659;335;213137;3678;446;0;3
FR;5;2022-05-24;47;45;3;2;60;5;2;0;0;267893;176910;2662;337;213197;3683;448;0;3
FR;5;2022-05-25;329;258;4;1;386;16;1;0;0;268222;177168;2666;338;213583;3699;449;0;3
FR;5;2022-05-26;17;5;0;1;9;2;0;0;1;268239;177173;2666;339;213592;3701;449;0;4
FR;5;2022-05-27;99;54;4;4;89;9;3;0;0;268338;177227;2670;343;213681;3710;452;0;4
FR;5;2022-05-28;100;78;5;3;106;10;3;0;0;268438;177305;2675;346;213787;3720;455;0;4
FR;5;2022-05-29;14;14;1;0;18;2;0;0;0;268452;177319;2676;346;213805;3722;455;0;4
FR;5;2022-05-30;56;41;2;1;54;2;2;0;0;268508;177360;2678;347;213859;3724;457;0;4
FR;5;2022-05-31;57;43;1;8;62;1;8;0;0;268565;177403;2679;355;213921;3725;465;0;4
FR;5;2022-06-01;257;241;9;2;302;25;5;0;0;268822;177644;2688;357;214223;3750;470;0;4
FR;5;2022-06-02;63;61;5;0;73;9;1;0;0;268885;177705;2693;357;214296;3759;471;0;4
FR;5;2022-06-03;82;71;4;5;88;10;6;0;0;268967;177776;2697;362;214384;3769;477;0;4
FR;5;2022-06-04;157;109;2;1;187;9;1;0;0;269124;177885;2699;363;214571;3778;478;0;4
FR;5;2022-06-05;18;11;0;0;21;1;0;0;0;269142;177896;2699;363;214592;3779;478;0;4
FR;5;2022-06-06;16;12;0;1;15;0;1;0;0;269158;177908;2699;364;214607;3779;479;0;4
FR;5;2022-06-07;50;56;1;1;76;2;1;0;0;269208;177964;2700;365;214683;3781;480;0;4
FR;5;2022-06-08;283;225;3;4;332;17;2;0;0;269491;178189;2703;369;215015;3798;482;0;4
FR;5;2022-06-09;52;41;6;3;57;7;2;0;1;269543;178230;2709;372;215072;3805;484;0;5
FR;5;2022-06-10;81;72;1;1;105;6;1;0;0;269624;178302;2710;373;215177;3811;485;0;5
FR;5;2022-06-11;173;141;3;3;202;10;4;0;0;269797;178443;2713;376;215379;3821;489;0;5
FR;5;2022-06-12;17;16;0;0;19;2;0;0;0;269814;178459;2713;376;215398;3823;489;0;5
FR;5;2022-06-13;56;47;9;3;70;10;6;0;0;269870;178506;2722;379;215468;3833;495;0;5
FR;5;2022-06-14;59;56;1;4;64;6;4;0;0;269929;178562;2723;383;215532;3839;499;0;5
FR;5;2022-06-15;266;260;5;2;363;27;1;0;0;270195;178822;2728;385;215895;3866;500;0;5
FR;5;2022-06-16;47;30;5;2;44;5;2;0;0;270242;178852;2733;387;215939;3871;502;0;5
FR;5;2022-06-17;100;67;5;5;102;10;5;0;0;270342;178919;2738;392;216041;3881;507;0;5
FR;5;2022-06-18;146;95;10;2;152;26;2;0;1;270488;179014;2748;394;216193;3907;509;0;6
FR;5;2022-06-19;26;15;0;1;18;4;1;0;0;270514;179029;2748;395;216211;3911;510;0;6
FR;5;2022-06-20;56;50;8;0;62;11;2;0;0;270570;179079;2756;395;216273;3922;512;0;6
FR;5;2022-06-21;53;73;5;3;91;7;5;0;1;270623;179152;2761;398;216364;3929;517;0;7
FR;5;2022-06-22;224;248;7;9;348;33;10;0;0;270847;179400;2768;407;216712;3962;527;0;7
FR;5;2022-06-23;50;38;2;5;43;6;6;0;0;270897;179438;2770;412;216755;3968;533;0;7
FR;5;2022-06-24;91;70;12;5;101;16;8;0;0;270988;179508;2782;417;216856;3984;541;0;7
FR;5;2022-06-25;154;124;3;7;185;14;8;0;1;271142;179632;2785;424;217041;3998;549;0;8
FR;5;2022-06-26;26;19;2;0;29;5;0;0;0;271168;179651;2787;424;217070;4003;549;0;8
FR;5;2022-06-27;57;60;5;7;78;11;9;0;0;271225;179711;2792;431;217148;4014;558;0;8
FR;5;2022-06-28;70;49;8;2;69;14;5;0;0;271295;179760;2800;433;217217;4028;563;0;8
FR;5;2022-06-29;297;269;9;21;391;34;23;0;0;271592;180029;2809;454;217608;4062;586;0;8
FR;5;2022-06-30;89;57;10;12;89;17;11;0;0;271681;180086;2819;466;217697;4079;597;0;8
FR;5;2022-07-01;127;65;7;11;118;12;11;0;2;271808;180151;2826;477;217815;4091;608;0;10
FR;5;2022-07-02;191;132;4;0;210;22;0;0;0;271999;180283;2830;477;218025;4113;608;0;10
FR;5;2022-07-03;30;25;1;0;36;4;0;0;0;272029;180308;2831;477;218061;4117;608;0;10
FR;5;2022-07-04;103;65;2;5;102;7;5;0;1;272132;180373;2833;482;218163;4124;613;0;11
FR;5;2022-07-05;104;72;3;8;107;13;8;0;1;272236;180445;2836;490;218270;4137;621;0;12
FR;5;2022-07-06;278;168;9;36;289;27;36;0;0;272514;180613;2845;526;218559;4164;657;0;12
FR;5;2022-07-07;88;69;6;9;89;13;11;0;0;272602;180682;2851;535;218648;4177;668;0;12
FR;5;2022-07-08;152;120;7;14;146;25;13;0;1;272754;180802;2858;549;218794;4202;681;0;13
FR;5;2022-07-09;116;68;1;8;100;10;8;0;0;272870;180870;2859;557;218894;4212;689;0;13
FR;5;2022-07-10;15;6;0;0;10;1;0;0;0;272885;180876;2859;557;218904;4213;689;0;13
FR;5;2022-07-11;92;72;10;2;98;19;3;0;0;272977;180948;2869;559;219002;4232;692;0;13
FR;5;2022-07-12;67;63;5;10;81;7;12;0;0;273044;181011;2874;569;219083;4239;704;0;13
FR;5;2022-07-13;169;118;10;19;196;16;23;0;0;273213;181129;2884;588;219279;4255;727;0;13
FR;5;2022-07-14;8;4;0;0;7;0;0;0;0;273221;181133;2884;588;219286;4255;727;0;13
FR;5;2022-07-15;74;66;5;14;86;15;15;0;0;273295;181199;2889;602;219372;4270;742;0;13
FR;5;2022-07-16;54;44;3;0;71;3;2;0;0;273349;181243;2892;602;219443;4273;744;0;13
FR;5;2022-07-17;10;7;3;0;10;2;2;0;0;273359;181250;2895;602;219453;4275;746;0;13
FR;5;2022-07-18;60;47;0;4;70;4;3;0;0;273419;181297;2895;606;219523;4279;749;0;13
FR;5;2022-07-19;63;42;5;3;63;7;4;0;0;273482;181339;2900;609;219586;4286;753;0;13
FR;5;2022-07-20;120;106;4;11;141;14;9;0;0;273602;181445;2904;620;219727;4300;762;0;13
FR;5;2022-07-21;38;43;2;10;52;5;10;0;0;273640;181488;2906;630;219779;4305;772;0;13
FR;5;2022-07-22;48;69;11;13;75;23;11;0;1;273688;181557;2917;643;219854;4328;783;0;14
FR;5;2022-07-23;59;78;2;1;95;11;2;0;0;273747;181635;2919;644;219949;4339;785;0;14
FR;5;2022-07-24;11;9;3;1;12;3;1;0;0;273758;181644;2922;645;219961;4342;786;0;14
FR;5;2022-07-25;53;48;2;7;57;8;8;0;0;273811;181692;2924;652;220018;4350;794;0;14
FR;5;2022-07-26;58;52;5;41;70;6;44;0;0;273869;181744;2929;693;220088;4356;838;0;14
FR;5;2022-07-27;106;118;4;4;161;13;4;0;0;273975;181862;2933;697;220249;4369;842;0;14
FR;5;2022-07-28;39;35;2;2;47;6;1;0;0;274014;181897;2935;699;220296;4375;843;0;14
FR;5;2022-07-29;56;74;3;14;90;8;10;0;0;274070;181971;2938;713;220386;4383;853;0;14
FR;5;2022-07-30;55;53;5;1;76;7;2;0;0;274125;182024;2943;714;220462;4390;855;0;14
FR;5;2022-07-31;7;11;1;0;13;1;0;0;0;274132;182035;2944;714;220475;4391;855;0;14
FR;5;2022-08-01;39;53;1;2;64;6;2;0;0;274171;182088;2945;716;220539;4397;857;0;14
FR;5;2022-08-02;32;43;8;7;47;8;7;0;1;274203;182131;2953;723;220586;4405;864;0;15
FR;5;2022-08-03;54;51;4;10;70;9;8;0;0;274257;182182;2957;733;220656;4414;872;0;15
FR;5;2022-08-04;20;18;1;6;22;1;6;0;0;274277;182200;2958;739;220678;4415;878;0;15
FR;5;2022-08-05;35;26;3;3;39;3;3;0;0;274312;182226;2961;742;220717;4418;881;0;15
FR;5;2022-08-06;23;26;1;0;31;1;0;0;0;274335;182252;2962;742;220748;4419;881;0;15
FR;5;2022-08-07;2;2;1;0;1;1;1;0;0;274337;182254;2963;742;220749;4420;882;0;15
FR;5;2022-08-08;26;19;1;2;24;2;1;0;0;274363;182273;2964;744;220773;4422;883;0;15
FR;5;2022-08-09;26;28;3;3;35;3;3;0;0;274389;182301;2967;747;220808;4425;886;0;15
FR;5;2022-08-10;47;47;2;0;56;5;0;0;0;274436;182348;2969;747;220864;4430;886;0;15
FR;5;2022-08-11;19;36;2;2;42;5;2;0;0;274455;182384;2971;749;220906;4435;888;0;15
FR;5;2022-08-12;27;28;2;0;39;2;0;0;0;274482;182412;2973;749;220945;4437;888;0;15
FR;5;2022-08-13;16;18;0;0;24;0;0;0;0;274498;182430;2973;749;220969;4437;888;0;15
FR;5;2022-08-14;2;3;0;0;4;0;0;0;0;274500;182433;2973;749;220973;4437;888;0;15
FR;5;2022-08-15;2;6;0;0;6;0;0;0;0;274502;182439;2973;749;220979;4437;888;0;15
FR;5;2022-08-16;33;26;3;0;28;6;0;0;0;274535;182465;2976;749;221007;4443;888;0;15
FR;5;2022-08-17;52;55;2;1;72;1;1;0;0;274587;182520;2978;750;221079;4444;889;0;15
FR;5;2022-08-18;26;18;8;17;25;10;16;0;0;274613;182538;2986;767;221104;4454;905;0;15
FR;5;2022-08-19;26;34;1;2;43;2;2;0;0;274639;182572;2987;769;221147;4456;907;0;15
FR;5;2022-08-20;25;27;2;1;33;4;2;0;0;274664;182599;2989;770;221180;4460;909;0;15
FR;5;2022-08-21;7;4;1;0;7;1;0;0;0;274671;182603;2990;770;221187;4461;909;0;15
FR;5;2022-08-22;39;26;1;6;42;2;5;0;1;274710;182629;2991;776;221229;4463;914;0;16
FR;5;2022-08-23;27;26;1;1;32;2;1;0;0;274737;182655;2992;777;221261;4465;915;0;16
FR;5;2022-08-24;50;43;0;0;62;0;0;0;0;274787;182698;2992;777;221323;4465;915;0;16
FR;5;2022-08-25;27;26;3;1;31;2;0;0;1;274814;182724;2995;778;221354;4467;915;0;17
FR;5;2022-08-26;48;39;7;2;58;5;4;0;0;274862;182763;3002;780;221412;4472;919;0;17
FR;5;2022-08-27;46;28;1;0;46;3;1;0;0;274908;182791;3003;780;221458;4475;920;0;17
FR;5;2022-08-28;5;7;0;0;7;0;0;0;0;274913;182798;3003;780;221465;4475;920;0;17
FR;5;2022-08-29;58;44;1;1;66;4;1;0;0;274971;182842;3004;781;221531;4479;921;0;17
FR;5;2022-08-30;45;23;12;29;40;10;30;0;1;275016;182865;3016;810;221571;4489;951;0;18
FR;5;2022-08-31;53;47;6;1;58;11;1;0;0;275069;182912;3022;811;221629;4500;952;0;18
FR;5;2022-09-01;16;8;1;4;13;1;4;0;0;275085;182920;3023;815;221642;4501;956;0;18
FR;5;2022-09-02;42;23;8;2;35;9;3;0;0;275127;182943;3031;817;221677;4510;959;0;18
FR;5;2022-09-03;69;37;2;0;58;2;0;0;0;275196;182980;3033;817;221735;4512;959;0;18
FR;5;2022-09-04;12;7;1;0;8;3;0;0;0;275208;182987;3034;817;221743;4515;959;0;18
FR;5;2022-09-05;7;4;1;0;4;1;0;0;0;275215;182991;3035;817;221747;4516;959;0;18
FR;5;2022-09-06;23;14;3;15;17;2;14;0;2;275238;183005;3038;832;221764;4518;973;0;20
FR;5;2022-09-07;79;53;1;1;76;3;1;0;0;275317;183058;3039;833;221840;4521;974;0;20
FR;5;2022-09-08;10;4;0;4;7;0;4;0;0;275327;183062;3039;837;221847;4521;978;0;20
FR;5;2022-09-09;42;11;9;2;14;10;3;0;0;275369;183073;3048;839;221861;4531;981;0;20
FR;5;2022-09-10;40;45;1;1;50;8;1;0;0;275409;183118;3049;840;221911;4539;982;0;20
FR;5;2022-09-11;3;3;0;0;3;1;0;0;0;275412;183121;3049;840;221914;4540;982;0;20
FR;5;2022-09-12;7;5;2;2;7;2;2;0;0;275419;183126;3051;842;221921;4542;984;0;20
FR;5;2022-09-13;9;6;0;1;4;3;1;0;0;275428;183132;3051;843;221925;4545;985;0;20
FR;5;2022-09-14;52;47;4;6;55;9;5;0;0;275480;183179;3055;849;221980;4554;990;0;20
FR;5;2022-09-15;11;13;2;3;11;5;3;0;0;275491;183192;3057;852;221991;4559;993;0;20
FR;5;2022-09-16;25;33;1;4;38;3;3;0;0;275516;183225;3058;856;222029;4562;996;0;20
FR;5;2022-09-17;60;43;1;1;51;5;1;0;0;275576;183268;3059;857;222080;4567;997;0;20
FR;5;2022-09-18;9;6;0;1;10;1;0;0;0;275585;183274;3059;858;222090;4568;997;0;20
FR;5;2022-09-19;22;17;2;1;20;5;2;0;0;275607;183291;3061;859;222110;4573;999;0;20
FR;5;2022-09-20;15;11;3;3;15;1;4;0;0;275622;183302;3064;862;222125;4574;1003;0;20
FR;5;2022-09-21;68;45;9;0;65;13;0;0;0;275690;183347;3073;862;222190;4587;1003;0;20
FR;5;2022-09-22;12;6;4;24;6;4;23;0;1;275702;183353;3077;886;222196;4591;1026;0;21
FR;5;2022-09-23;20;25;2;3;23;8;3;0;0;275722;183378;3079;889;222219;4599;1029;0;21
FR;5;2022-09-24;44;51;1;8;65;5;8;0;0;275766;183429;3080;897;222284;4604;1037;0;21
FR;5;2022-09-25;6;12;0;0;13;1;0;0;0;275772;183441;3080;897;222297;4605;1037;0;21
FR;5;2022-09-26;15;7;0;2;12;0;1;0;1;275787;183448;3080;899;222309;4605;1038;0;22
FR;5;2022-09-27;7;12;4;9;14;4;9;0;1;275794;183460;3084;908;222323;4609;1047;0;23
FR;5;2022-09-28;65;67;5;0;91;7;0;0;0;275859;183527;3089;908;222414;4616;1047;0;23
FR;5;2022-09-29;17;9;1;0;15;1;1;0;1;275876;183536;3090;908;222429;4617;1048;0;24
FR;5;2022-09-30;28;47;2;2;54;4;3;0;0;275904;183583;3092;910;222483;4621;1051;0;24
FR;5;2022-10-01;40;35;5;5;48;8;7;0;0;275944;183618;3097;915;222531;4629;1058;0;24
FR;5;2022-10-02;1;9;1;0;10;1;0;0;0;275945;183627;3098;915;222541;4630;1058;0;24
FR;5;2022-10-03;7;6;3;0;5;4;0;0;0;275952;183633;3101;915;222546;4634;1058;0;24
FR;5;2022-10-04;11;8;1;3;11;2;3;0;0;275963;183641;3102;918;222557;4636;1061;0;24
FR;5;2022-10-05;57;62;2;2;79;13;2;0;0;276020;183703;3104;920;222636;4649;1063;0;24
FR;5;2022-10-06;12;10;1;4;15;2;4;0;0;276032;183713;3105;924;222651;4651;1067;0;24
FR;5;2022-10-07;21;31;1;0;34;5;0;0;0;276053;183744;3106;924;222685;4656;1067;0;24
FR;5;2022-10-08;33;51;1;0;54;7;0;0;0;276086;183795;3107;924;222739;4663;1067;0;24
FR;5;2022-10-09;7;10;0;0;11;1;0;0;0;276093;183805;3107;924;222750;4664;1067;0;24
FR;5;2022-10-10;14;6;0;1;8;1;1;0;0;276107;183811;3107;925;222758;4665;1068;0;24
FR;5;2022-10-11;6;13;2;1;14;2;2;0;0;276113;183824;3109;926;222772;4667;1070;0;24
FR;5;2022-10-12;40;57;3;2;69;8;2;0;0;276153;183881;3112;928;222841;4675;1072;0;24
FR;5;2022-10-13;11;16;2;0;18;4;0;0;0;276164;183897;3114;928;222859;4679;1072;0;24
FR;5;2022-10-14;21;21;1;0;20;5;0;0;0;276185;183918;3115;928;222879;4684;1072;0;24
FR;5;2022-10-15;19;26;10;0;25;11;2;0;0;276204;183944;3125;928;222904;4695;1074;0;24
FR;5;2022-10-16;3;1;0;0;1;1;0;0;0;276207;183945;3125;928;222905;4696;1074;0;24
FR;5;2022-10-17;8;8;2;1;8;3;1;0;2;276215;183953;3127;929;222913;4699;1075;0;26
FR;5;2022-10-18;6;7;0;2;8;0;2;0;0;276221;183960;3127;931;222921;4699;1077;0;26
FR;5;2022-10-19;38;44;8;0;53;11;0;0;1;276259;184004;3135;931;222974;4710;1077;0;27
FR;5;2022-10-20;18;15;2;1;16;3;1;0;0;276277;184019;3137;932;222990;4713;1078;0;27
FR;5;2022-10-21;22;15;6;0;19;8;1;0;2;276299;184034;3143;932;223009;4721;1079;0;29
FR;5;2022-10-22;35;29;2;12;32;5;12;0;0;276334;184063;3145;944;223041;4726;1091;0;29
FR;5;2022-10-23;9;3;0;0;4;0;0;0;0;276343;184066;3145;944;223045;4726;1091;0;29
FR;5;2022-10-24;14;7;6;7;9;9;8;0;0;276357;184073;3151;951;223054;4735;1099;0;29
FR;5;2022-10-25;13;9;6;3;9;8;3;0;2;276370;184082;3157;954;223063;4743;1102;0;31
FR;5;2022-10-26;34;22;6;0;29;10;0;0;0;276404;184104;3163;954;223092;4753;1102;0;31
FR;5;2022-10-27;16;4;4;0;11;4;0;0;0;276420;184108;3167;954;223103;4757;1102;0;31
FR;5;2022-10-28;19;13;5;3;14;6;4;0;0;276439;184121;3172;957;223117;4763;1106;0;31
FR;5;2022-10-29;21;13;0;0;17;3;0;0;0;276460;184134;3172;957;223134;4766;1106;0;31
FR;5;2022-10-30;1;4;2;0;4;3;0;0;0;276461;184138;3174;957;223138;4769;1106;0;31
FR;5;2022-10-31;14;11;2;1;12;3;1;0;0;276475;184149;3176;958;223150;4772;1107;0;31
FR;5;2022-11-01;3;3;0;1;3;0;1;0;0;276478;184152;3176;959;223153;4772;1108;0;31
FR;5;2022-11-02;23;17;5;4;23;5;5;0;0;276501;184169;3181;963;223176;4777;1113;0;31
FR;5;2022-11-03;22;4;1;1;11;1;1;0;0;276523;184173;3182;964;223187;4778;1114;0;31
FR;5;2022-11-04;19;18;1;0;18;2;0;0;0;276542;184191;3183;964;223205;4780;1114;0;31
FR;5;2022-11-05;25;16;1;0;21;1;0;0;0;276567;184207;3184;964;223226;4781;1114;0;31
FR;5;2022-11-06;1;7;0;0;7;0;0;0;0;276568;184214;3184;964;223233;4781;1114;0;31
FR;5;2022-11-07;9;3;3;0;3;3;0;0;0;276577;184217;3187;964;223236;4784;1114;0;31
FR;5;2022-11-08;12;7;1;2;8;1;1;0;0;276589;184224;3188;966;223244;4785;1115;0;31
FR;5;2022-11-09;30;29;6;1;32;6;1;0;0;276619;184253;3194;967;223276;4791;1116;0;31
FR;5;2022-11-10;11;16;1;0;17;1;0;0;0;276630;184269;3195;967;223293;4792;1116;0;31
FR;5;2022-11-11;2;4;0;1;6;0;1;0;0;276632;184273;3195;968;223299;4792;1117;0;31
FR;5;2022-11-12;19;10;5;9;18;6;9;0;2;276651;184283;3200;977;223317;4798;1126;0;33
FR;5;2022-11-13;2;2;0;1;2;0;1;0;0;276653;184285;3200;978;223319;4798;1127;0;33
FR;5;2022-11-14;8;11;0;1;10;3;0;0;0;276661;184296;3200;979;223329;4801;1127;0;33
FR;5;2022-11-15;8;6;4;3;6;4;3;0;0;276669;184302;3204;982;223335;4805;1130;0;33
FR;5;2022-11-16;29;28;2;1;33;5;0;0;0;276698;184330;3206;983;223368;4810;1130;0;33
FR;5;2022-11-17;6;15;4;0;15;5;0;0;0;276704;184345;3210;983;223383;4815;1130;0;33
FR;5;2022-11-18;17;17;7;0;19;9;0;0;0;276721;184362;3217;983;223402;4824;1130;0;33
FR;5;2022-11-19;18;27;2;0;28;6;0;0;0;276739;184389;3219;983;223430;4830;1130;0;33
FR;5;2022-11-20;6;3;0;0;5;0;0;0;0;276745;184392;3219;983;223435;4830;1130;0;33
FR;5;2022-11-21;8;5;0;2;4;2;1;0;0;276753;184397;3219;985;223439;4832;1131;0;33
FR;5;2022-11-22;9;3;0;1;4;0;1;0;0;276762;184400;3219;986;223443;4832;1132;0;33
FR;5;2022-11-23;34;25;6;1;27;13;0;0;0;276796;184425;3225;987;223470;4845;1132;0;33
FR;5;2022-11-24;3;7;2;0;8;1;1;0;0;276799;184432;3227;987;223478;4846;1133;0;33
FR;5;2022-11-25;15;20;2;0;25;3;0;0;1;276814;184452;3229;987;223503;4849;1133;0;34
FR;5;2022-11-26;22;19;4;0;20;8;0;0;0;276836;184471;3233;987;223523;4857;1133;0;34
FR;5;2022-11-27;7;0;1;0;3;1;0;0;0;276843;184471;3234;987;223526;4858;1133;0;34
FR;5;2022-11-28;7;15;3;0;15;5;0;0;0;276850;184486;3237;987;223541;4863;1133;0;34
FR;5;2022-11-29;10;9;1;0;11;3;0;0;1;276860;184495;3238;987;223552;4866;1133;0;35
FR;5;2022-11-30;35;48;12;0;56;17;1;0;0;276895;184543;3250;987;223608;4883;1134;0;35
FR;5;2022-12-01;5;10;2;0;10;3;0;0;0;276900;184553;3252;987;223618;4886;1134;0;35
FR;5;2022-12-02;1;5;2;1;4;3;1;0;0;276901;184558;3254;988;223622;4889;1135;0;35
FR;5;2022-12-03;3;3;8;1;5;8;1;0;0;276904;184561;3262;989;223627;4897;1136;0;35
FR;5;2022-12-04;3;2;1;0;2;2;0;0;0;276907;184563;3263;989;223629;4899;1136;0;35
FR;5;2022-12-05;1;1;0;0;0;1;0;0;0;276908;184564;3263;989;223629;4900;1136;0;35
FR;5;2022-12-06;5;1;0;0;1;0;0;0;1;276913;184565;3263;989;223630;4900;1136;0;36
FR;5;2022-12-07;5;8;1;0;8;1;0;0;0;276918;184573;3264;989;223638;4901;1136;0;36
FR;5;2022-12-08;2;2;0;0;2;0;0;0;0;276920;184575;3264;989;223640;4901;1136;0;36
FR;5;2022-12-09;5;8;0;0;6;2;0;0;0;276925;184583;3264;989;223646;4903;1136;0;36
FR;5;2022-12-10;4;7;2;1;8;2;1;0;0;276929;184590;3266;990;223654;4905;1137;0;36
FR;5;2022-12-11;2;0;0;0;0;0;0;0;0;276931;184590;3266;990;223654;4905;1137;0;36
FR;5;2022-12-12;0;0;0;0;0;0;0;0;0;276931;184590;3266;990;223654;4905;1137;0;36
FR;5;2022-12-13;2;3;0;0;4;1;0;0;0;276933;184593;3266;990;223658;4906;1137;0;36
FR;5;2022-12-14;2;3;0;9;3;1;8;0;3;276935;184596;3266;999;223661;4907;1145;0;39
FR;5;2022-12-15;0;2;0;0;2;0;0;0;0;276935;184598;3266;999;223663;4907;1145;0;39
FR;5;2022-12-16;3;3;2;0;4;3;0;0;0;276938;184601;3268;999;223667;4910;1145;0;39
FR;5;2022-12-17;3;3;3;0;3;2;1;0;0;276941;184604;3271;999;223670;4912;1146;0;39
FR;5;2022-12-18;3;0;0;1;0;0;1;0;1;276944;184604;3271;1000;223670;4912;1147;0;40
FR;5;2022-12-19;1;0;0;2;0;0;2;0;0;276945;184604;3271;1002;223670;4912;1149;0;40
FR;5;2022-12-20;0;1;3;0;1;3;0;0;0;276945;184605;3274;1002;223671;4915;1149;0;40
FR;5;2022-12-21;2;4;0;0;4;0;0;0;0;276947;184609;3274;1002;223675;4915;1149;0;40
FR;5;2022-12-22;2;2;1;0;2;1;0;0;0;276949;184611;3275;1002;223677;4916;1149;0;40
FR;5;2022-12-23;3;1;1;0;1;1;0;0;0;276952;184612;3276;1002;223678;4917;1149;0;40
FR;5;2022-12-24;0;1;0;0;1;0;0;0;0;276952;184613;3276;1002;223679;4917;1149;0;40
FR;5;2022-12-25;0;1;2;0;0;3;0;0;0;276952;184614;3278;1002;223679;4920;1149;0;40
FR;5;2022-12-26;2;2;0;0;2;0;0;0;0;276954;184616;3278;1002;223681;4920;1149;0;40
FR;5;2022-12-27;0;3;0;0;3;0;0;0;0;276954;184619;3278;1002;223684;4920;1149;0;40
FR;5;2022-12-28;5;3;3;0;3;3;2;0;0;276959;184622;3281;1002;223687;4923;1151;0;40
FR;5;2022-12-29;3;2;2;0;3;2;0;0;0;276962;184624;3283;1002;223690;4925;1151;0;40
FR;5;2022-12-30;3;2;1;0;2;1;0;0;0;276965;184626;3284;1002;223692;4926;1151;0;40
FR;5;2022-12-31;0;0;0;0;0;0;0;0;0;276965;184626;3284;1002;223692;4926;1151;0;40
FR;5;2023-01-01;0;0;0;0;0;0;0;0;0;276965;184626;3284;1002;223692;4926;1151;0;40
FR;5;2023-01-02;1;1;1;0;1;1;0;0;0;276966;184627;3285;1002;223693;4927;1151;0;40
FR;5;2023-01-03;3;1;0;0;2;0;0;0;0;276969;184628;3285;1002;223695;4927;1151;0;40
FR;5;2023-01-04;6;1;1;0;2;1;0;0;0;276975;184629;3286;1002;223697;4928;1151;0;40
FR;5;2023-01-05;0;3;0;0;3;0;0;0;0;276975;184632;3286;1002;223700;4928;1151;0;40
FR;5;2023-01-06;2;1;1;0;1;1;0;0;0;276977;184633;3287;1002;223701;4929;1151;0;40
FR;5;2023-01-07;5;1;1;0;1;2;0;0;0;276982;184634;3288;1002;223702;4931;1151;0;40
FR;5;2023-01-08;2;2;0;0;2;0;0;0;0;276984;184636;3288;1002;223704;4931;1151;0;40
FR;5;2023-01-09;4;0;1;0;1;1;0;0;0;276988;184636;3289;1002;223705;4932;1151;0;40
FR;5;2023-01-10;3;1;0;0;2;0;0;0;0;276991;184637;3289;1002;223707;4932;1151;0;40
FR;5;2023-01-11;7;5;3;0;4;4;0;0;0;276998;184642;3292;1002;223711;4936;1151;0;40
FR;5;2023-01-12;14;6;4;0;6;6;0;0;0;277012;184648;3296;1002;223717;4942;1151;0;40
FR;5;2023-01-13;56;16;16;0;31;18;0;0;0;277068;184664;3312;1002;223748;4960;1151;0;40
FR;5;2023-01-14;56;34;13;1;34;20;2;0;0;277124;184698;3325;1003;223782;4980;1153;0;40
FR;5;2023-01-15;13;9;0;0;5;4;0;0;0;277137;184707;3325;1003;223787;4984;1153;0;40
FR;5;2023-01-16;13;8;3;0;8;3;0;0;0;277150;184715;3328;1003;223795;4987;1153;0;40
FR;5;2023-01-17;12;8;3;0;4;7;0;0;0;277162;184723;3331;1003;223799;4994;1153;0;40
FR;5;2023-01-18;71;35;21;2;46;25;2;0;0;277233;184758;3352;1005;223845;5019;1155;0;40
FR;5;2023-01-19;13;6;8;0;5;10;1;0;0;277246;184764;3360;1005;223850;5029;1156;0;40
FR;5;2023-01-20;27;17;13;0;17;18;0;0;2;277273;184781;3373;1005;223867;5047;1156;0;42
FR;5;2023-01-21;34;23;18;1;31;21;1;0;0;277307;184804;3391;1006;223898;5068;1157;0;42
FR;5;2023-01-22;6;4;2;0;4;3;0;0;0;277313;184808;3393;1006;223902;5071;1157;0;42
FR;5;2023-01-23;6;5;3;0;3;5;0;0;0;277319;184813;3396;1006;223905;5076;1157;0;42
FR;5;2023-01-24;16;3;3;0;6;4;0;0;0;277335;184816;3399;1006;223911;5080;1157;0;42
FR;5;2023-01-25;33;31;12;2;27;23;2;0;0;277368;184847;3411;1008;223938;5103;1159;0;42
FR;5;2023-01-26;6;5;4;0;6;4;0;0;0;277374;184852;3415;1008;223944;5107;1159;0;42
FR;5;2023-01-27;18;13;8;0;17;8;1;0;0;277392;184865;3423;1008;223961;5115;1160;0;42
FR;5;2023-01-28;21;8;4;3;11;6;3;0;0;277413;184873;3427;1011;223972;5121;1163;0;42
FR;5;2023-01-29;0;3;0;0;2;1;0;0;0;277413;184876;3427;1011;223974;5122;1163;0;42
FR;5;2023-01-30;7;5;3;0;4;6;0;0;0;277420;184881;3430;1011;223978;5128;1163;0;42
FR;5;2023-01-31;3;7;2;0;5;4;0;0;0;277423;184888;3432;1011;223983;5132;1163;0;42
FR;5;2023-02-01;18;18;7;1;19;8;1;0;0;277441;184906;3439;1012;224002;5140;1164;0;42
FR;5;2023-02-02;7;8;1;0;7;2;0;0;0;277448;184914;3440;1012;224009;5142;1164;0;42
FR;5;2023-02-03;15;26;6;0;27;9;0;0;0;277463;184940;3446;1012;224036;5151;1164;0;42
FR;5;2023-02-04;17;23;5;0;25;6;0;0;0;277480;184963;3451;1012;224061;5157;1164;0;42
FR;5;2023-02-05;1;2;0;1;2;1;0;0;0;277481;184965;3451;1013;224063;5158;1164;0;42
FR;5;2023-02-06;12;11;7;0;12;7;0;0;0;277493;184976;3458;1013;224075;5165;1164;0;42
FR;5;2023-02-07;6;11;2;0;10;4;0;0;0;277499;184987;3460;1013;224085;5169;1164;0;42
FR;5;2023-02-08;29;35;8;0;39;10;0;0;0;277528;185022;3468;1013;224124;5179;1164;0;42
FR;5;2023-02-09;15;7;5;0;8;5;0;0;0;277543;185029;3473;1013;224132;5184;1164;0;42
FR;5;2023-02-10;11;22;5;0;24;7;0;0;0;277554;185051;3478;1013;224156;5191;1164;0;42
FR;5;2023-02-11;12;11;3;1;15;4;0;0;0;277566;185062;3481;1014;224171;5195;1164;0;42
FR;5;2023-02-12;4;7;1;0;8;1;0;0;0;277570;185069;3482;1014;224179;5196;1164;0;42
FR;5;2023-02-13;4;6;6;0;5;7;0;0;0;277574;185075;3488;1014;224184;5203;1164;0;42
FR;5;2023-02-14;11;8;2;0;9;3;0;0;0;277585;185083;3490;1014;224193;5206;1164;0;42
FR;5;2023-02-15;27;25;4;0;27;5;0;0;0;277612;185108;3494;1014;224220;5211;1164;0;42
FR;5;2023-02-16;8;4;3;0;8;3;0;0;0;277620;185112;3497;1014;224228;5214;1164;0;42
FR;5;2023-02-17;9;5;9;0;6;9;0;0;0;277629;185117;3506;1014;224234;5223;1164;0;42
FR;5;2023-02-18;9;14;3;1;16;3;1;0;0;277638;185131;3509;1015;224250;5226;1165;0;42
FR;5;2023-02-19;0;1;0;0;1;0;0;0;0;277638;185132;3509;1015;224251;5226;1165;0;42
FR;5;2023-02-20;6;6;4;0;6;5;0;0;0;277644;185138;3513;1015;224257;5231;1165;0;42
FR;5;2023-02-21;4;6;5;0;7;5;0;0;0;277648;185144;3518;1015;224264;5236;1165;0;42
FR;5;2023-02-22;10;16;5;0;15;5;1;0;0;277658;185160;3523;1015;224279;5241;1166;0;42
FR;5;2023-02-23;5;5;2;0;5;2;0;0;0;277663;185165;3525;1015;224284;5243;1166;0;42
FR;5;2023-02-24;17;23;1;0;22;3;0;0;0;277680;185188;3526;1015;224306;5246;1166;0;42
FR;5;2023-02-25;11;9;0;0;10;0;0;0;0;277691;185197;3526;1015;224316;5246;1166;0;42
FR;5;2023-02-26;1;1;0;0;1;0;0;0;0;277692;185198;3526;1015;224317;5246;1166;0;42
FR;5;2023-02-27;7;5;2;0;5;2;0;0;0;277699;185203;3528;1015;224322;5248;1166;0;42
FR;5;2023-02-28;4;8;2;0;8;4;0;0;0;277703;185211;3530;1015;224330;5252;1166;0;42
FR;5;2023-03-01;12;25;1;0;23;3;1;0;0;277715;185236;3531;1015;224353;5255;1167;0;42
FR;5;2023-03-02;7;13;3;0;12;5;0;0;0;277722;185249;3534;1015;224365;5260;1167;0;42
FR;5;2023-03-03;11;4;3;0;8;3;1;0;0;277733;185253;3537;1015;224373;5263;1168;0;42
FR;5;2023-03-04;8;17;7;0;18;8;0;0;0;277741;185270;3544;1015;224391;5271;1168;0;42
FR;5;2023-03-05;3;3;0;0;3;0;0;0;0;277744;185273;3544;1015;224394;5271;1168;0;42
FR;5;2023-03-06;2;8;2;0;6;4;0;0;0;277746;185281;3546;1015;224400;5275;1168;0;42
FR;5;2023-03-07;2;9;4;0;9;4;0;0;0;277748;185290;3550;1015;224409;5279;1168;0;42
FR;5;2023-03-08;9;21;1;0;22;1;0;0;0;277757;185311;3551;1015;224431;5280;1168;0;42
FR;5;2023-03-09;1;6;0;0;5;1;0;0;0;277758;185317;3551;1015;224436;5281;1168;0;42
FR;5;2023-03-10;3;7;2;1;8;2;1;0;0;277761;185324;3553;1016;224444;5283;1169;0;42
FR;5;2023-03-11;5;4;0;0;6;0;0;0;0;277766;185328;3553;1016;224450;5283;1169;0;42
FR;5;2023-03-12;0;1;0;0;1;0;0;0;0;277766;185329;3553;1016;224451;5283;1169;0;42
FR;5;2023-03-13;2;2;0;0;4;0;0;0;0;277768;185331;3553;1016;224455;5283;1169;0;42
FR;5;2023-03-14;6;1;1;1;5;1;1;0;0;277774;185332;3554;1017;224460;5284;1170;0;42
FR;5;2023-03-15;7;8;2;0;12;3;0;0;0;277781;185340;3556;1017;224472;5287;1170;0;42
FR;5;2023-03-16;2;6;0;0;6;0;0;0;0;277783;185346;3556;1017;224478;5287;1170;0;42
FR;5;2023-03-17;14;15;3;0;13;4;1;0;0;277797;185361;3559;1017;224491;5291;1171;0;42
FR;5;2023-03-18;4;9;0;0;9;1;0;0;0;277801;185370;3559;1017;224500;5292;1171;0;42
FR;5;2023-03-19;0;0;0;0;0;0;0;0;0;277801;185370;3559;1017;224500;5292;1171;0;42
FR;5;2023-03-20;3;8;0;0;9;0;0;0;0;277804;185378;3559;1017;224509;5292;1171;0;42
FR;5;2023-03-21;3;8;2;2;8;2;2;0;0;277807;185386;3561;1019;224517;5294;1173;0;42
FR;5;2023-03-22;9;22;3;0;20;4;0;0;0;277816;185408;3564;1019;224537;5298;1173;0;42
FR;5;2023-03-23;2;5;1;0;5;1;0;0;0;277818;185413;3565;1019;224542;5299;1173;0;42
FR;5;2023-03-24;5;9;1;0;9;3;0;0;0;277823;185422;3566;1019;224551;5302;1173;0;42
FR;5;2023-03-25;3;8;2;0;8;2;0;0;0;277826;185430;3568;1019;224559;5304;1173;0;42
FR;5;2023-03-26;0;1;0;0;0;1;0;0;0;277826;185431;3568;1019;224559;5305;1173;0;42
FR;5;2023-03-27;3;0;1;0;1;1;0;0;0;277829;185431;3569;1019;224560;5306;1173;0;42
FR;5;2023-03-28;3;3;0;0;4;0;0;0;0;277832;185434;3569;1019;224564;5306;1173;0;42
FR;5;2023-03-29;7;16;4;0;16;6;0;0;0;277839;185450;3573;1019;224580;5312;1173;0;42
FR;5;2023-03-30;3;2;0;0;4;0;0;0;1;277842;185452;3573;1019;224584;5312;1173;0;43
FR;5;2023-03-31;3;7;2;1;7;2;1;0;0;277845;185459;3575;1020;224591;5314;1174;0;43
FR;5;2023-04-01;5;7;3;1;5;4;2;0;0;277850;185466;3578;1021;224596;5318;1176;0;43
FR;5;2023-04-02;0;1;0;0;1;0;0;0;0;277850;185467;3578;1021;224597;5318;1176;0;43
FR;5;2023-04-03;3;4;2;0;4;0;2;0;0;277853;185471;3580;1021;224601;5318;1178;0;43
FR;5;2023-04-04;1;3;0;0;3;0;0;0;0;277854;185474;3580;1021;224604;5318;1178;0;43
FR;5;2023-04-05;3;6;1;0;5;2;0;0;0;277857;185480;3581;1021;224609;5320;1178;0;43
FR;5;2023-04-06;3;3;0;0;3;0;0;0;0;277860;185483;3581;1021;224612;5320;1178;0;43
FR;5;2023-04-07;6;4;1;0;4;1;0;0;0;277866;185487;3582;1021;224616;5321;1178;0;43
FR;5;2023-04-08;6;10;1;0;10;1;0;0;0;277872;185497;3583;1021;224626;5322;1178;0;43
FR;5;2023-04-09;0;0;0;0;0;0;0;0;0;277872;185497;3583;1021;224626;5322;1178;0;43
FR;5;2023-04-10;0;0;0;0;0;0;0;0;0;277872;185497;3583;1021;224626;5322;1178;0;43
FR;5;2023-04-11;1;6;0;0;6;0;0;0;1;277873;185503;3583;1021;224632;5322;1178;0;44
FR;5;2023-04-12;4;9;1;0;9;1;0;0;0;277877;185512;3584;1021;224641;5323;1178;0;44
FR;5;2023-04-13;2;1;2;0;0;3;0;0;0;277879;185513;3586;1021;224641;5326;1178;0;44
FR;5;2023-04-14;5;5;2;0;8;2;0;0;0;277884;185518;3588;1021;224649;5328;1178;0;44
FR;5;2023-04-15;3;4;0;0;4;0;0;0;0;277887;185522;3588;1021;224653;5328;1178;0;44
FR;5;2023-04-16;1;0;0;0;0;0;0;0;0;277888;185522;3588;1021;224653;5328;1178;0;44
FR;5;2023-04-17;4;4;3;0;4;3;0;0;0;277892;185526;3591;1021;224657;5331;1178;0;44
FR;5;2023-04-18;3;2;0;0;2;0;0;0;0;277895;185528;3591;1021;224659;5331;1178;0;44
FR;5;2023-04-19;9;7;0;0;3;5;0;0;0;277904;185535;3591;1021;224662;5336;1178;0;44
FR;5;2023-04-20;5;2;0;0;2;0;0;0;0;277909;185537;3591;1021;224664;5336;1178;0;44
FR;5;2023-04-21;2;6;1;0;5;2;0;0;0;277911;185543;3592;1021;224669;5338;1178;0;44
FR;5;2023-04-22;4;6;1;0;6;1;0;0;0;277915;185549;3593;1021;224675;5339;1178;0;44
FR;5;2023-04-23;1;0;0;0;0;0;0;0;0;277916;185549;3593;1021;224675;5339;1178;0;44
FR;5;2023-04-24;3;5;2;0;5;2;0;0;0;277919;185554;3595;1021;224680;5341;1178;0;44
FR;5;2023-04-25;0;1;1;2;1;1;2;0;0;277919;185555;3596;1023;224681;5342;1180;0;44
FR;5;2023-04-26;1;3;0;0;3;0;0;0;0;277920;185558;3596;1023;224684;5342;1180;0;44
FR;5;2023-04-27;3;4;0;0;3;1;0;0;0;277923;185562;3596;1023;224687;5343;1180;0;44
FR;5;2023-04-28;2;3;0;0;2;1;0;0;0;277925;185565;3596;1023;224689;5344;1180;0;44
FR;5;2023-04-29;2;9;0;0;9;0;0;0;0;277927;185574;3596;1023;224698;5344;1180;0;44
FR;5;2023-04-30;0;0;0;0;0;0;0;0;0;277927;185574;3596;1023;224698;5344;1180;0;44
FR;5;2023-05-01;0;0;0;0;0;0;0;0;0;277927;185574;3596;1023;224698;5344;1180;0;44
FR;5;2023-05-02;2;2;1;0;3;1;0;0;0;277929;185576;3597;1023;224701;5345;1180;0;44
FR;5;2023-05-03;5;3;0;0;3;0;0;0;0;277934;185579;3597;1023;224704;5345;1180;0;44
FR;5;2023-05-04;1;3;0;0;3;0;0;0;0;277935;185582;3597;1023;224707;5345;1180;0;44
FR;5;2023-05-05;1;1;0;0;1;0;0;0;0;277936;185583;3597;1023;224708;5345;1180;0;44
FR;5;2023-05-06;2;1;0;0;1;0;0;0;0;277938;185584;3597;1023;224709;5345;1180;0;44
FR;5;2023-05-07;0;1;0;0;1;0;0;0;0;277938;185585;3597;1023;224710;5345;1180;0;44
FR;5;2023-05-08;1;1;0;0;1;0;0;0;0;277939;185586;3597;1023;224711;5345;1180;0;44
FR;5;2023-05-09;0;3;0;0;3;0;0;0;0;277939;185589;3597;1023;224714;5345;1180;0;44
FR;5;2023-05-10;2;8;0;0;8;0;0;0;0;277941;185597;3597;1023;224722;5345;1180;0;44
FR;5;2023-05-11;2;1;0;0;1;0;0;0;0;277943;185598;3597;1023;224723;5345;1180;0;44
FR;5;2023-05-12;2;2;0;0;2;0;0;0;0;277945;185600;3597;1023;224725;5345;1180;0;44
FR;5;2023-05-13;6;4;0;0;4;2;0;0;0;277951;185604;3597;1023;224729;5347;1180;0;44
FR;5;2023-05-14;0;0;0;0;0;0;0;0;0;277951;185604;3597;1023;224729;5347;1180;0;44
FR;5;2023-05-15;3;0;0;0;0;0;0;0;1;277954;185604;3597;1023;224729;5347;1180;0;45
FR;5;2023-05-16;0;1;0;0;1;0;0;0;0;277954;185605;3597;1023;224730;5347;1180;0;45
FR;5;2023-05-17;3;6;2;0;7;2;0;0;0;277957;185611;3599;1023;224737;5349;1180;0;45
FR;5;2023-05-18;0;0;0;0;0;0;0;0;0;277957;185611;3599;1023;224737;5349;1180;0;45
FR;5;2023-05-19;1;4;1;0;3;1;0;0;0;277958;185615;3600;1023;224740;5350;1180;0;45
FR;5;2023-05-20;5;0;0;0;0;0;0;0;0;277963;185615;3600;1023;224740;5350;1180;0;45
FR;5;2023-05-21;0;0;0;0;0;0;0;0;0;277963;185615;3600;1023;224740;5350;1180;0;45
FR;5;2023-05-22;0;3;0;0;3;0;0;0;0;277963;185618;3600;1023;224743;5350;1180;0;45
FR;5;2023-05-23;1;1;1;0;1;1;0;0;0;277964;185619;3601;1023;224744;5351;1180;0;45
FR;5;2023-05-24;6;5;0;0;5;0;0;0;0;277970;185624;3601;1023;224749;5351;1180;0;45
FR;5;2023-05-25;1;1;0;0;1;0;0;0;0;277971;185625;3601;1023;224750;5351;1180;0;45
FR;5;2023-05-26;2;5;0;0;5;0;0;0;0;277973;185630;3601;1023;224755;5351;1180;0;45
FR;5;2023-05-27;4;3;1;0;5;1;0;0;0;277977;185633;3602;1023;224760;5352;1180;0;45
FR;5;2023-05-28;0;1;0;0;1;0;0;0;0;277977;185634;3602;1023;224761;5352;1180;0;45
FR;5;2023-05-29;0;1;0;0;0;1;0;0;0;277977;185635;3602;1023;224761;5353;1180;0;45
FR;5;2023-05-30;0;1;0;0;1;0;0;0;0;277977;185636;3602;1023;224762;5353;1180;0;45
FR;5;2023-05-31;5;5;1;0;5;1;0;0;0;277982;185641;3603;1023;224767;5354;1180;0;45
FR;5;2023-06-01;1;0;0;0;0;0;0;0;0;277983;185641;3603;1023;224767;5354;1180;0;45
FR;5;2023-06-02;0;1;0;0;1;0;0;0;0;277983;185642;3603;1023;224768;5354;1180;0;45
FR;5;2023-06-03;3;4;3;0;4;3;1;0;0;277986;185646;3606;1023;224772;5357;1181;0;45
FR;5;2023-06-04;0;0;0;0;0;0;0;0;0;277986;185646;3606;1023;224772;5357;1181;0;45
FR;5;2023-06-05;3;1;0;0;1;0;0;0;0;277989;185647;3606;1023;224773;5357;1181;0;45
FR;5;2023-06-06;3;1;0;0;1;0;0;0;0;277992;185648;3606;1023;224774;5357;1181;0;45
FR;5;2023-06-07;6;1;4;0;0;5;0;0;0;277998;185649;3610;1023;224774;5362;1181;0;45
FR;5;2023-06-08;1;0;1;0;0;1;0;0;0;277999;185649;3611;1023;224774;5363;1181;0;45
FR;5;2023-06-09;1;1;1;0;1;1;0;0;0;278000;185650;3612;1023;224775;5364;1181;0;45
FR;5;2023-06-10;2;2;0;0;3;0;0;0;0;278002;185652;3612;1023;224778;5364;1181;0;45
FR;5;2023-06-11;0;0;1;0;0;1;0;0;0;278002;185652;3613;1023;224778;5365;1181;0;45
FR;5;2023-06-12;0;2;0;0;2;0;0;0;0;278002;185654;3613;1023;224780;5365;1181;0;45
FR;6;2020-12-27;0;0;0;0;0;0;0;0;0;0;0;0;0;0;0;0;0;0
FR;6;2020-12-28;0;0;0;0;0;0;0;0;0;0;0;0;0;0;0;0;0;0
FR;6;2020-12-29;0;0;0;0;0;0;0;0;0;0;0;0;0;0;0;0;0;0
FR;6;2020-12-30;0;0;0;0;0;0;0;0;0;0;0;0;0;0;0;0;0;0
FR;6;2020-12-31;0;0;0;0;0;0;0;0;0;0;0;0;0;0;0;0;0;0
FR;6;2021-01-01;0;0;0;0;0;0;0;0;0;0;0;0;0;0;0;0;0;0
FR;6;2021-01-02;0;0;0;0;0;0;0;0;0;0;0;0;0;0;0;0;0;0
FR;6;2021-01-03;0;0;0;0;0;0;0;0;0;0;0;0;0;0;0;0;0;0
FR;6;2021-01-04;0;0;0;0;0;0;0;0;0;0;0;0;0;0;0;0;0;0
FR;6;2021-01-05;0;0;0;0;0;0;0;0;0;0;0;0;0;0;0;0;0;0
FR;6;2021-01-06;0;0;0;0;0;0;0;0;0;0;0;0;0;0;0;0;0;0
FR;6;2021-01-07;0;0;0;0;0;0;0;0;0;0;0;0;0;0;0;0;0;0
FR;6;2021-01-08;0;0;0;0;0;0;0;0;0;0;0;0;0;0;0;0;0;0
FR;6;2021-01-09;0;0;0;0;0;0;0;0;0;0;0;0;0;0;0;0;0;0
FR;6;2021-01-10;0;0;0;0;0;0;0;0;0;0;0;0;0;0;0;0;0;0
FR;6;2021-01-11;0;0;0;0;0;0;0;0;0;0;0;0;0;0;0;0;0;0
FR;6;2021-01-12;0;0;0;0;0;0;0;0;0;0;0;0;0;0;0;0;0;0
FR;6;2021-01-13;0;0;0;0;0;0;0;0;0;0;0;0;0;0;0;0;0;0
FR;6;2021-01-14;0;0;0;0;0;0;0;0;0;0;0;0;0;0;0;0;0;0
FR;6;2021-01-15;0;0;0;0;0;0;0;0;0;0;0;0;0;0;0;0;0;0
FR;6;2021-01-16;0;0;0;0;0;0;0;0;0;0;0;0;0;0;0;0;0;0
FR;6;2021-01-17;0;0;0;0;0;0;0;0;0;0;0;0;0;0;0;0;0;0
FR;6;2021-01-18;0;0;0;0;0;0;0;0;0;0;0;0;0;0;0;0;0;0
FR;6;2021-01-19;0;0;0;0;0;0;0;0;0;0;0;0;0;0;0;0;0;0
FR;6;2021-01-20;0;0;0;0;0;0;0;0;0;0;0;0;0;0;0;0;0;0
FR;6;2021-01-21;0;0;0;0;0;0;0;0;0;0;0;0;0;0;0;0;0;0
FR;6;2021-01-22;0;0;0;0;0;0;0;0;0;0;0;0;0;0;0;0;0;0
FR;6;2021-01-23;0;0;0;0;0;0;0;0;0;0;0;0;0;0;0;0;0;0
FR;6;2021-01-24;0;0;0;0;0;0;0;0;0;0;0;0;0;0;0;0;0;0
FR;6;2021-01-25;0;0;0;0;0;0;0;0;0;0;0;0;0;0;0;0;0;0
FR;6;2021-01-26;0;0;0;0;0;0;0;0;0;0;0;0;0;0;0;0;0;0
FR;6;2021-01-27;0;0;0;0;0;0;0;0;0;0;0;0;0;0;0;0;0;0
FR;6;2021-01-28;0;0;0;0;0;0;0;0;0;0;0;0;0;0;0;0;0;0
FR;6;2021-01-29;0;0;0;0;0;0;0;0;0;0;0;0;0;0;0;0;0;0
FR;6;2021-01-30;0;0;0;0;0;0;0;0;0;0;0;0;0;0;0;0;0;0
FR;6;2021-01-31;0;0;0;0;0;0;0;0;0;0;0;0;0;0;0;0;0;0
FR;6;2021-02-01;0;0;0;0;0;0;0;0;0;0;0;0;0;0;0;0;0;0
FR;6;2021-02-02;0;0;0;0;0;0;0;0;0;0;0;0;0;0;0;0;0;0
FR;6;2021-02-03;0;0;0;0;0;0;0;0;0;0;0;0;0;0;0;0;0;0
FR;6;2021-02-04;0;0;0;0;0;0;0;0;0;0;0;0;0;0;0;0;0;0
FR;6;2021-02-05;0;0;0;0;0;0;0;0;0;0;0;0;0;0;0;0;0;0
FR;6;2021-02-06;0;0;0;0;0;0;0;0;0;0;0;0;0;0;0;0;0;0
FR;6;2021-02-07;0;0;0;0;0;0;0;0;0;0;0;0;0;0;0;0;0;0
FR;6;2021-02-08;0;0;0;0;0;0;0;0;0;0;0;0;0;0;0;0;0;0
FR;6;2021-02-09;0;0;0;0;0;0;0;0;0;0;0;0;0;0;0;0;0;0
FR;6;2021-02-10;0;0;0;0;0;0;0;0;0;0;0;0;0;0;0;0;0;0
FR;6;2021-02-11;0;0;0;0;0;0;0;0;0;0;0;0;0;0;0;0;0;0
FR;6;2021-02-12;0;0;0;0;0;0;0;0;0;0;0;0;0;0;0;0;0;0
FR;6;2021-02-13;0;0;0;0;0;0;0;0;0;0;0;0;0;0;0;0;0;0
FR;6;2021-02-14;0;0;0;0;0;0;0;0;0;0;0;0;0;0;0;0;0;0
FR;6;2021-02-15;0;0;0;0;0;0;0;0;0;0;0;0;0;0;0;0;0;0
FR;6;2021-02-16;0;0;0;0;0;0;0;0;0;0;0;0;0;0;0;0;0;0
FR;6;2021-02-17;0;0;0;0;0;0;0;0;0;0;0;0;0;0;0;0;0;0
FR;6;2021-02-18;0;0;0;0;0;0;0;0;0;0;0;0;0;0;0;0;0;0
FR;6;2021-02-19;0;0;0;0;0;0;0;0;0;0;0;0;0;0;0;0;0;0
FR;6;2021-02-20;0;0;0;0;0;0;0;0;0;0;0;0;0;0;0;0;0;0
FR;6;2021-02-21;0;0;0;0;0;0;0;0;0;0;0;0;0;0;0;0;0;0
FR;6;2021-02-22;0;0;0;0;0;0;0;0;0;0;0;0;0;0;0;0;0;0
FR;6;2021-02-23;0;0;0;0;0;0;0;0;0;0;0;0;0;0;0;0;0;0
FR;6;2021-02-24;0;0;0;0;0;0;0;0;0;0;0;0;0;0;0;0;0;0
FR;6;2021-02-25;0;0;0;0;0;0;0;0;0;0;0;0;0;0;0;0;0;0
FR;6;2021-02-26;0;0;0;0;0;0;0;0;0;0;0;0;0;0;0;0;0;0
FR;6;2021-02-27;0;0;0;0;0;0;0;0;0;0;0;0;0;0;0;0;0;0
FR;6;2021-02-28;0;0;0;0;0;0;0;0;0;0;0;0;0;0;0;0;0;0
FR;6;2021-03-01;0;0;0;0;0;0;0;0;0;0;0;0;0;0;0;0;0;0
FR;6;2021-03-02;0;0;0;0;0;0;0;0;0;0;0;0;0;0;0;0;0;0
FR;6;2021-03-03;0;0;0;0;0;0;0;0;0;0;0;0;0;0;0;0;0;0
FR;6;2021-03-04;0;0;0;0;0;0;0;0;0;0;0;0;0;0;0;0;0;0
FR;6;2021-03-05;0;0;0;0;0;0;0;0;0;0;0;0;0;0;0;0;0;0
FR;6;2021-03-06;0;0;0;0;0;0;0;0;0;0;0;0;0;0;0;0;0;0
FR;6;2021-03-07;0;0;0;0;0;0;0;0;0;0;0;0;0;0;0;0;0;0
FR;6;2021-03-08;0;0;0;0;0;0;0;0;0;0;0;0;0;0;0;0;0;0
FR;6;2021-03-09;0;0;0;0;0;0;0;0;0;0;0;0;0;0;0;0;0;0
FR;6;2021-03-10;0;0;0;0;0;0;0;0;0;0;0;0;0;0;0;0;0;0
FR;6;2021-03-11;0;0;0;0;0;0;0;0;0;0;0;0;0;0;0;0;0;0
FR;6;2021-03-12;0;0;0;0;0;0;0;0;0;0;0;0;0;0;0;0;0;0
FR;6;2021-03-13;0;0;0;0;0;0;0;0;0;0;0;0;0;0;0;0;0;0
FR;6;2021-03-14;0;0;0;0;0;0;0;0;0;0;0;0;0;0;0;0;0;0
FR;6;2021-03-15;0;0;0;0;0;0;0;0;0;0;0;0;0;0;0;0;0;0
FR;6;2021-03-16;0;0;0;0;0;0;0;0;0;0;0;0;0;0;0;0;0;0
FR;6;2021-03-17;0;0;0;0;0;0;0;0;0;0;0;0;0;0;0;0;0;0
FR;6;2021-03-18;0;0;0;0;0;0;0;0;0;0;0;0;0;0;0;0;0;0
FR;6;2021-03-19;0;0;0;0;0;0;0;0;0;0;0;0;0;0;0;0;0;0
FR;6;2021-03-20;0;0;0;0;0;0;0;0;0;0;0;0;0;0;0;0;0;0
FR;6;2021-03-21;0;0;0;0;0;0;0;0;0;0;0;0;0;0;0;0;0;0
FR;6;2021-03-22;0;0;0;0;0;0;0;0;0;0;0;0;0;0;0;0;0;0
FR;6;2021-03-23;0;0;0;0;0;0;0;0;0;0;0;0;0;0;0;0;0;0
FR;6;2021-03-24;0;0;0;0;0;0;0;0;0;0;0;0;0;0;0;0;0;0
FR;6;2021-03-25;0;0;0;0;0;0;0;0;0;0;0;0;0;0;0;0;0;0
FR;6;2021-03-26;0;0;0;0;0;0;0;0;0;0;0;0;0;0;0;0;0;0
FR;6;2021-03-27;0;0;0;0;0;0;0;0;0;0;0;0;0;0;0;0;0;0
FR;6;2021-03-28;0;0;0;0;0;0;0;0;0;0;0;0;0;0;0;0;0;0
FR;6;2021-03-29;0;0;0;0;0;0;0;0;0;0;0;0;0;0;0;0;0;0
FR;6;2021-03-30;0;0;0;0;0;0;0;0;0;0;0;0;0;0;0;0;0;0
FR;6;2021-03-31;0;0;0;0;0;0;0;0;0;0;0;0;0;0;0;0;0;0
FR;6;2021-04-01;0;0;0;0;0;0;0;0;0;0;0;0;0;0;0;0;0;0
FR;6;2021-04-02;0;0;0;0;0;0;0;0;0;0;0;0;0;0;0;0;0;0
FR;6;2021-04-03;0;0;0;0;0;0;0;0;0;0;0;0;0;0;0;0;0;0
FR;6;2021-04-04;0;0;0;0;0;0;0;0;0;0;0;0;0;0;0;0;0;0
FR;6;2021-04-05;0;0;0;0;0;0;0;0;0;0;0;0;0;0;0;0;0;0
FR;6;2021-04-06;0;0;0;0;0;0;0;0;0;0;0;0;0;0;0;0;0;0
FR;6;2021-04-07;0;0;0;0;0;0;0;0;0;0;0;0;0;0;0;0;0;0
FR;6;2021-04-08;0;0;0;0;0;0;0;0;0;0;0;0;0;0;0;0;0;0
FR;6;2021-04-09;0;0;0;0;0;0;0;0;0;0;0;0;0;0;0;0;0;0
FR;6;2021-04-10;0;0;0;0;0;0;0;0;0;0;0;0;0;0;0;0;0;0
FR;6;2021-04-11;0;0;0;0;0;0;0;0;0;0;0;0;0;0;0;0;0;0
FR;6;2021-04-12;0;0;0;0;0;0;0;0;0;0;0;0;0;0;0;0;0;0
FR;6;2021-04-13;0;0;0;0;0;0;0;0;0;0;0;0;0;0;0;0;0;0
FR;6;2021-04-14;0;0;0;0;0;0;0;0;0;0;0;0;0;0;0;0;0;0
FR;6;2021-04-15;0;0;0;0;0;0;0;0;0;0;0;0;0;0;0;0;0;0
FR;6;2021-04-16;0;0;0;0;0;0;0;0;0;0;0;0;0;0;0;0;0;0
FR;6;2021-04-17;0;0;0;0;0;0;0;0;0;0;0;0;0;0;0;0;0;0
FR;6;2021-04-18;0;0;0;0;0;0;0;0;0;0;0;0;0;0;0;0;0;0
FR;6;2021-04-19;0;0;0;0;0;0;0;0;0;0;0;0;0;0;0;0;0;0
FR;6;2021-04-20;0;0;0;0;0;0;0;0;0;0;0;0;0;0;0;0;0;0
FR;6;2021-04-21;0;0;0;0;0;0;0;0;0;0;0;0;0;0;0;0;0;0
FR;6;2021-04-22;0;0;0;0;0;0;0;0;0;0;0;0;0;0;0;0;0;0
FR;6;2021-04-23;0;0;0;0;0;0;0;0;0;0;0;0;0;0;0;0;0;0
FR;6;2021-04-24;0;0;0;0;0;0;0;0;0;0;0;0;0;0;0;0;0;0
FR;6;2021-04-25;0;0;0;0;0;0;0;0;0;0;0;0;0;0;0;0;0;0
FR;6;2021-04-26;0;0;0;0;0;0;0;0;0;0;0;0;0;0;0;0;0;0
FR;6;2021-04-27;0;0;0;0;0;0;0;0;0;0;0;0;0;0;0;0;0;0
FR;6;2021-04-28;0;0;0;0;0;0;0;0;0;0;0;0;0;0;0;0;0;0
FR;6;2021-04-29;0;0;0;0;0;0;0;0;0;0;0;0;0;0;0;0;0;0
FR;6;2021-04-30;0;0;0;0;0;0;0;0;0;0;0;0;0;0;0;0;0;0
FR;6;2021-05-01;0;0;0;0;0;0;0;0;0;0;0;0;0;0;0;0;0;0
FR;6;2021-05-02;0;0;0;0;0;0;0;0;0;0;0;0;0;0;0;0;0;0
FR;6;2021-05-03;0;0;0;0;0;0;0;0;0;0;0;0;0;0;0;0;0;0
FR;6;2021-05-04;0;0;0;0;0;0;0;0;0;0;0;0;0;0;0;0;0;0
FR;6;2021-05-05;0;0;0;0;0;0;0;0;0;0;0;0;0;0;0;0;0;0
FR;6;2021-05-06;0;0;0;0;0;0;0;0;0;0;0;0;0;0;0;0;0;0
FR;6;2021-05-07;0;0;0;0;0;0;0;0;0;0;0;0;0;0;0;0;0;0
FR;6;2021-05-08;0;0;0;0;0;0;0;0;0;0;0;0;0;0;0;0;0;0
FR;6;2021-05-09;0;0;0;0;0;0;0;0;0;0;0;0;0;0;0;0;0;0
FR;6;2021-05-10;0;0;0;0;0;0;0;0;0;0;0;0;0;0;0;0;0;0
FR;6;2021-05-11;0;0;0;0;0;0;0;0;0;0;0;0;0;0;0;0;0;0
FR;6;2021-05-12;0;0;0;0;0;0;0;0;0;0;0;0;0;0;0;0;0;0
FR;6;2021-05-13;0;0;0;0;0;0;0;0;0;0;0;0;0;0;0;0;0;0
FR;6;2021-05-14;0;0;0;0;0;0;0;0;0;0;0;0;0;0;0;0;0;0
FR;6;2021-05-15;0;0;0;0;0;0;0;0;0;0;0;0;0;0;0;0;0;0
FR;6;2021-05-16;0;0;0;0;0;0;0;0;0;0;0;0;0;0;0;0;0;0
FR;6;2021-05-17;0;0;0;0;0;0;0;0;0;0;0;0;0;0;0;0;0;0
FR;6;2021-05-18;0;0;0;0;0;0;0;0;0;0;0;0;0;0;0;0;0;0
FR;6;2021-05-19;0;0;0;0;0;0;0;0;0;0;0;0;0;0;0;0;0;0
FR;6;2021-05-20;0;0;0;0;0;0;0;0;0;0;0;0;0;0;0;0;0;0
FR;6;2021-05-21;0;0;0;0;0;0;0;0;0;0;0;0;0;0;0;0;0;0
FR;6;2021-05-22;0;0;0;0;0;0;0;0;0;0;0;0;0;0;0;0;0;0
FR;6;2021-05-23;0;0;0;0;0;0;0;0;0;0;0;0;0;0;0;0;0;0
FR;6;2021-05-24;0;0;0;0;0;0;0;0;0;0;0;0;0;0;0;0;0;0
FR;6;2021-05-25;0;0;0;0;0;0;0;0;0;0;0;0;0;0;0;0;0;0
FR;6;2021-05-26;0;0;0;0;0;0;0;0;0;0;0;0;0;0;0;0;0;0
FR;6;2021-05-27;0;0;0;0;0;0;0;0;0;0;0;0;0;0;0;0;0;0
FR;6;2021-05-28;0;0;0;0;0;0;0;0;0;0;0;0;0;0;0;0;0;0
FR;6;2021-05-29;0;0;0;0;0;0;0;0;0;0;0;0;0;0;0;0;0;0
FR;6;2021-05-30;0;0;0;0;0;0;0;0;0;0;0;0;0;0;0;0;0;0
FR;6;2021-05-31;0;0;0;0;0;0;0;0;0;0;0;0;0;0;0;0;0;0
FR;6;2021-06-01;0;0;0;0;0;0;0;0;0;0;0;0;0;0;0;0;0;0
FR;6;2021-06-02;0;0;0;0;0;0;0;0;0;0;0;0;0;0;0;0;0;0
FR;6;2021-06-03;0;0;0;0;0;0;0;0;0;0;0;0;0;0;0;0;0;0
FR;6;2021-06-04;0;0;0;0;0;0;0;0;0;0;0;0;0;0;0;0;0;0
FR;6;2021-06-05;0;0;0;0;0;0;0;0;0;0;0;0;0;0;0;0;0;0
FR;6;2021-06-06;0;0;0;0;0;0;0;0;0;0;0;0;0;0;0;0;0;0
FR;6;2021-06-07;0;0;0;0;0;0;0;0;0;0;0;0;0;0;0;0;0;0
FR;6;2021-06-08;0;0;0;0;0;0;0;0;0;0;0;0;0;0;0;0;0;0
FR;6;2021-06-09;0;0;0;0;0;0;0;0;0;0;0;0;0;0;0;0;0;0
FR;6;2021-06-10;0;0;0;0;0;0;0;0;0;0;0;0;0;0;0;0;0;0
FR;6;2021-06-11;0;0;0;0;0;0;0;0;0;0;0;0;0;0;0;0;0;0
FR;6;2021-06-12;0;0;0;0;0;0;0;0;0;0;0;0;0;0;0;0;0;0
FR;6;2021-06-13;0;0;0;0;0;0;0;0;0;0;0;0;0;0;0;0;0;0
FR;6;2021-06-14;0;0;0;0;0;0;0;0;0;0;0;0;0;0;0;0;0;0
FR;6;2021-06-15;0;0;0;0;0;0;0;0;0;0;0;0;0;0;0;0;0;0
FR;6;2021-06-16;0;0;0;0;0;0;0;0;0;0;0;0;0;0;0;0;0;0
FR;6;2021-06-17;0;0;0;0;0;0;0;0;0;0;0;0;0;0;0;0;0;0
FR;6;2021-06-18;0;0;0;0;0;0;0;0;0;0;0;0;0;0;0;0;0;0
FR;6;2021-06-19;0;0;0;0;0;0;0;0;0;0;0;0;0;0;0;0;0;0
FR;6;2021-06-20;0;0;0;0;0;0;0;0;0;0;0;0;0;0;0;0;0;0
FR;6;2021-06-21;0;0;0;0;0;0;0;0;0;0;0;0;0;0;0;0;0;0
FR;6;2021-06-22;0;0;0;0;0;0;0;0;0;0;0;0;0;0;0;0;0;0
FR;6;2021-06-23;0;0;0;0;0;0;0;0;0;0;0;0;0;0;0;0;0;0
FR;6;2021-06-24;0;0;0;0;0;0;0;0;0;0;0;0;0;0;0;0;0;0
FR;6;2021-06-25;0;0;0;0;0;0;0;0;0;0;0;0;0;0;0;0;0;0
FR;6;2021-06-26;0;0;0;0;0;0;0;0;0;0;0;0;0;0;0;0;0;0
FR;6;2021-06-27;0;0;0;0;0;0;0;0;0;0;0;0;0;0;0;0;0;0
FR;6;2021-06-28;0;0;0;0;0;0;0;0;0;0;0;0;0;0;0;0;0;0
FR;6;2021-06-29;0;0;0;0;0;0;0;0;0;0;0;0;0;0;0;0;0;0
FR;6;2021-06-30;0;0;0;0;0;0;0;0;0;0;0;0;0;0;0;0;0;0
FR;6;2021-07-01;0;0;0;0;0;0;0;0;0;0;0;0;0;0;0;0;0;0
FR;6;2021-07-02;0;0;0;0;0;0;0;0;0;0;0;0;0;0;0;0;0;0
FR;6;2021-07-03;0;0;0;0;0;0;0;0;0;0;0;0;0;0;0;0;0;0
FR;6;2021-07-04;0;0;0;0;0;0;0;0;0;0;0;0;0;0;0;0;0;0
FR;6;2021-07-05;0;0;0;0;0;0;0;0;0;0;0;0;0;0;0;0;0;0
FR;6;2021-07-06;0;0;0;0;0;0;0;0;0;0;0;0;0;0;0;0;0;0
FR;6;2021-07-07;0;0;0;0;0;0;0;0;0;0;0;0;0;0;0;0;0;0
FR;6;2021-07-08;0;0;0;0;0;0;0;0;0;0;0;0;0;0;0;0;0;0
FR;6;2021-07-09;0;0;0;0;0;0;0;0;0;0;0;0;0;0;0;0;0;0
FR;6;2021-07-10;0;0;0;0;0;0;0;0;0;0;0;0;0;0;0;0;0;0
FR;6;2021-07-11;0;0;0;0;0;0;0;0;0;0;0;0;0;0;0;0;0;0
FR;6;2021-07-12;0;0;0;0;0;0;0;0;0;0;0;0;0;0;0;0;0;0
FR;6;2021-07-13;0;0;0;0;0;0;0;0;0;0;0;0;0;0;0;0;0;0
FR;6;2021-07-14;0;0;0;0;0;0;0;0;0;0;0;0;0;0;0;0;0;0
FR;6;2021-07-15;0;0;0;0;0;0;0;0;0;0;0;0;0;0;0;0;0;0
FR;6;2021-07-16;0;0;0;0;0;0;0;0;0;0;0;0;0;0;0;0;0;0
FR;6;2021-07-17;0;0;0;0;0;0;0;0;0;0;0;0;0;0;0;0;0;0
FR;6;2021-07-18;0;0;0;0;0;0;0;0;0;0;0;0;0;0;0;0;0;0
FR;6;2021-07-19;0;0;0;0;0;0;0;0;0;0;0;0;0;0;0;0;0;0
FR;6;2021-07-20;0;0;0;0;0;0;0;0;0;0;0;0;0;0;0;0;0;0
FR;6;2021-07-21;0;0;0;0;0;0;0;0;0;0;0;0;0;0;0;0;0;0
FR;6;2021-07-22;0;0;0;0;0;0;0;0;0;0;0;0;0;0;0;0;0;0
FR;6;2021-07-23;0;0;0;0;0;0;0;0;0;0;0;0;0;0;0;0;0;0
FR;6;2021-07-24;0;0;0;0;0;0;0;0;0;0;0;0;0;0;0;0;0;0
FR;6;2021-07-25;0;0;0;0;0;0;0;0;0;0;0;0;0;0;0;0;0;0
FR;6;2021-07-26;0;0;0;0;0;0;0;0;0;0;0;0;0;0;0;0;0;0
FR;6;2021-07-27;0;0;0;0;0;0;0;0;0;0;0;0;0;0;0;0;0;0
FR;6;2021-07-28;0;0;0;0;0;0;0;0;0;0;0;0;0;0;0;0;0;0
FR;6;2021-07-29;0;0;0;0;0;0;0;0;0;0;0;0;0;0;0;0;0;0
FR;6;2021-07-30;0;0;0;0;0;0;0;0;0;0;0;0;0;0;0;0;0;0
FR;6;2021-07-31;0;0;0;0;0;0;0;0;0;0;0;0;0;0;0;0;0;0
FR;6;2021-08-01;0;0;0;0;0;0;0;0;0;0;0;0;0;0;0;0;0;0
FR;6;2021-08-02;0;0;0;0;0;0;0;0;0;0;0;0;0;0;0;0;0;0
FR;6;2021-08-03;0;0;0;0;0;0;0;0;0;0;0;0;0;0;0;0;0;0
FR;6;2021-08-04;0;0;0;0;0;0;0;0;0;0;0;0;0;0;0;0;0;0
FR;6;2021-08-05;0;0;0;0;0;0;0;0;0;0;0;0;0;0;0;0;0;0
FR;6;2021-08-06;0;0;0;0;0;0;0;0;0;0;0;0;0;0;0;0;0;0
FR;6;2021-08-07;0;0;0;0;0;0;0;0;0;0;0;0;0;0;0;0;0;0
FR;6;2021-08-08;0;0;0;0;0;0;0;0;0;0;0;0;0;0;0;0;0;0
FR;6;2021-08-09;0;0;0;0;0;0;0;0;0;0;0;0;0;0;0;0;0;0
FR;6;2021-08-10;0;0;0;0;0;0;0;0;0;0;0;0;0;0;0;0;0;0
FR;6;2021-08-11;0;0;0;0;0;0;0;0;0;0;0;0;0;0;0;0;0;0
FR;6;2021-08-12;0;0;0;0;0;0;0;0;0;0;0;0;0;0;0;0;0;0
FR;6;2021-08-13;0;0;0;0;0;0;0;0;0;0;0;0;0;0;0;0;0;0
FR;6;2021-08-14;0;0;0;0;0;0;0;0;0;0;0;0;0;0;0;0;0;0
FR;6;2021-08-15;0;0;0;0;0;0;0;0;0;0;0;0;0;0;0;0;0;0
FR;6;2021-08-16;0;0;0;0;0;0;0;0;0;0;0;0;0;0;0;0;0;0
FR;6;2021-08-17;0;0;0;0;0;0;0;0;0;0;0;0;0;0;0;0;0;0
FR;6;2021-08-18;0;0;0;0;0;0;0;0;0;0;0;0;0;0;0;0;0;0
FR;6;2021-08-19;0;0;0;0;0;0;0;0;0;0;0;0;0;0;0;0;0;0
FR;6;2021-08-20;0;0;0;0;0;0;0;0;0;0;0;0;0;0;0;0;0;0
FR;6;2021-08-21;0;0;0;0;0;0;0;0;0;0;0;0;0;0;0;0;0;0
FR;6;2021-08-22;0;0;0;0;0;0;0;0;0;0;0;0;0;0;0;0;0;0
FR;6;2021-08-23;0;0;0;0;0;0;0;0;0;0;0;0;0;0;0;0;0;0
FR;6;2021-08-24;0;0;0;0;0;0;0;0;0;0;0;0;0;0;0;0;0;0
FR;6;2021-08-25;0;0;0;0;0;0;0;0;0;0;0;0;0;0;0;0;0;0
FR;6;2021-08-26;0;0;0;0;0;0;0;0;0;0;0;0;0;0;0;0;0;0
FR;6;2021-08-27;0;0;0;0;0;0;0;0;0;0;0;0;0;0;0;0;0;0
FR;6;2021-08-28;0;0;0;0;0;0;0;0;0;0;0;0;0;0;0;0;0;0
FR;6;2021-08-29;0;0;0;0;0;0;0;0;0;0;0;0;0;0;0;0;0;0
FR;6;2021-08-30;0;0;0;0;0;0;0;0;0;0;0;0;0;0;0;0;0;0
FR;6;2021-08-31;0;0;0;0;0;0;0;0;0;0;0;0;0;0;0;0;0;0
FR;6;2021-09-01;0;0;0;0;0;0;0;0;0;0;0;0;0;0;0;0;0;0
FR;6;2021-09-02;0;0;0;0;0;0;0;0;0;0;0;0;0;0;0;0;0;0
FR;6;2021-09-03;0;0;0;0;0;0;0;0;0;0;0;0;0;0;0;0;0;0
FR;6;2021-09-04;0;0;0;0;0;0;0;0;0;0;0;0;0;0;0;0;0;0
FR;6;2021-09-05;0;0;0;0;0;0;0;0;0;0;0;0;0;0;0;0;0;0
FR;6;2021-09-06;0;0;0;0;0;0;0;0;0;0;0;0;0;0;0;0;0;0
FR;6;2021-09-07;0;0;0;0;0;0;0;0;0;0;0;0;0;0;0;0;0;0
FR;6;2021-09-08;0;0;0;0;0;0;0;0;0;0;0;0;0;0;0;0;0;0
FR;6;2021-09-09;0;0;0;0;0;0;0;0;0;0;0;0;0;0;0;0;0;0
FR;6;2021-09-10;0;0;0;0;0;0;0;0;0;0;0;0;0;0;0;0;0;0
FR;6;2021-09-11;0;0;0;0;0;0;0;0;0;0;0;0;0;0;0;0;0;0
FR;6;2021-09-12;0;0;0;0;0;0;0;0;0;0;0;0;0;0;0;0;0;0
FR;6;2021-09-13;0;0;0;0;0;0;0;0;0;0;0;0;0;0;0;0;0;0
FR;6;2021-09-14;0;0;0;0;0;0;0;0;0;0;0;0;0;0;0;0;0;0
FR;6;2021-09-15;0;0;0;0;0;0;0;0;0;0;0;0;0;0;0;0;0;0
FR;6;2021-09-16;0;0;0;0;0;0;0;0;0;0;0;0;0;0;0;0;0;0
FR;6;2021-09-17;0;0;0;0;0;0;0;0;0;0;0;0;0;0;0;0;0;0
FR;6;2021-09-18;0;0;0;0;0;0;0;0;0;0;0;0;0;0;0;0;0;0
FR;6;2021-09-19;0;0;0;0;0;0;0;0;0;0;0;0;0;0;0;0;0;0
FR;6;2021-09-20;0;0;0;0;0;0;0;0;0;0;0;0;0;0;0;0;0;0
FR;6;2021-09-21;0;0;0;0;0;0;0;0;0;0;0;0;0;0;0;0;0;0
FR;6;2021-09-22;0;0;0;0;0;0;0;0;0;0;0;0;0;0;0;0;0;0
FR;6;2021-09-23;0;0;0;0;0;0;0;0;0;0;0;0;0;0;0;0;0;0
FR;6;2021-09-24;0;0;0;0;0;0;0;0;0;0;0;0;0;0;0;0;0;0
FR;6;2021-09-25;0;0;0;0;0;0;0;0;0;0;0;0;0;0;0;0;0;0
FR;6;2021-09-26;0;0;0;0;0;0;0;0;0;0;0;0;0;0;0;0;0;0
FR;6;2021-09-27;0;0;0;0;0;0;0;0;0;0;0;0;0;0;0;0;0;0
FR;6;2021-09-28;0;0;0;0;0;0;0;0;0;0;0;0;0;0;0;0;0;0
FR;6;2021-09-29;0;0;0;0;0;0;0;0;0;0;0;0;0;0;0;0;0;0
FR;6;2021-09-30;0;0;0;0;0;0;0;0;0;0;0;0;0;0;0;0;0;0
FR;6;2021-10-01;0;0;0;0;0;0;0;0;0;0;0;0;0;0;0;0;0;0
FR;6;2021-10-02;0;0;0;0;0;0;0;0;0;0;0;0;0;0;0;0;0;0
FR;6;2021-10-03;0;0;0;0;0;0;0;0;0;0;0;0;0;0;0;0;0;0
FR;6;2021-10-04;0;0;0;0;0;0;0;0;0;0;0;0;0;0;0;0;0;0
FR;6;2021-10-05;0;0;0;0;0;0;0;0;0;0;0;0;0;0;0;0;0;0
FR;6;2021-10-06;0;0;0;0;0;0;0;0;0;0;0;0;0;0;0;0;0;0
FR;6;2021-10-07;0;0;0;0;0;0;0;0;0;0;0;0;0;0;0;0;0;0
FR;6;2021-10-08;0;0;0;0;0;0;0;0;0;0;0;0;0;0;0;0;0;0
FR;6;2021-10-09;0;0;0;0;0;0;0;0;0;0;0;0;0;0;0;0;0;0
FR;6;2021-10-10;0;0;0;0;0;0;0;0;0;0;0;0;0;0;0;0;0;0
FR;6;2021-10-11;0;0;0;0;0;0;0;0;0;0;0;0;0;0;0;0;0;0
FR;6;2021-10-12;0;0;0;0;0;0;0;0;0;0;0;0;0;0;0;0;0;0
FR;6;2021-10-13;0;0;0;0;0;0;0;0;0;0;0;0;0;0;0;0;0;0
FR;6;2021-10-14;0;0;0;0;0;0;0;0;0;0;0;0;0;0;0;0;0;0
FR;6;2021-10-15;0;0;0;0;0;0;0;0;0;0;0;0;0;0;0;0;0;0
FR;6;2021-10-16;0;0;0;0;0;0;0;0;0;0;0;0;0;0;0;0;0;0
FR;6;2021-10-17;0;0;0;0;0;0;0;0;0;0;0;0;0;0;0;0;0;0
FR;6;2021-10-18;0;0;0;0;0;0;0;0;0;0;0;0;0;0;0;0;0;0
FR;6;2021-10-19;0;0;0;0;0;0;0;0;0;0;0;0;0;0;0;0;0;0
FR;6;2021-10-20;0;0;0;0;0;0;0;0;0;0;0;0;0;0;0;0;0;0
FR;6;2021-10-21;0;0;0;0;0;0;0;0;0;0;0;0;0;0;0;0;0;0
FR;6;2021-10-22;0;0;0;0;0;0;0;0;0;0;0;0;0;0;0;0;0;0
FR;6;2021-10-23;0;0;0;0;0;0;0;0;0;0;0;0;0;0;0;0;0;0
FR;6;2021-10-24;0;0;0;0;0;0;0;0;0;0;0;0;0;0;0;0;0;0
FR;6;2021-10-25;0;0;0;0;0;0;0;0;0;0;0;0;0;0;0;0;0;0
FR;6;2021-10-26;0;0;0;0;0;0;0;0;0;0;0;0;0;0;0;0;0;0
FR;6;2021-10-27;0;0;0;0;0;0;0;0;0;0;0;0;0;0;0;0;0;0
FR;6;2021-10-28;0;0;0;0;0;0;0;0;0;0;0;0;0;0;0;0;0;0
FR;6;2021-10-29;0;0;0;0;0;0;0;0;0;0;0;0;0;0;0;0;0;0
FR;6;2021-10-30;0;0;0;0;0;0;0;0;0;0;0;0;0;0;0;0;0;0
FR;6;2021-10-31;0;0;0;0;0;0;0;0;0;0;0;0;0;0;0;0;0;0
FR;6;2021-11-01;0;0;0;0;0;0;0;0;0;0;0;0;0;0;0;0;0;0
FR;6;2021-11-02;0;0;0;0;0;0;0;0;0;0;0;0;0;0;0;0;0;0
FR;6;2021-11-03;0;0;0;0;0;0;0;0;0;0;0;0;0;0;0;0;0;0
FR;6;2021-11-04;0;0;0;0;0;0;0;0;0;0;0;0;0;0;0;0;0;0
FR;6;2021-11-05;0;0;0;0;0;0;0;0;0;0;0;0;0;0;0;0;0;0
FR;6;2021-11-06;0;0;0;0;0;0;0;0;0;0;0;0;0;0;0;0;0;0
FR;6;2021-11-07;0;0;0;0;0;0;0;0;0;0;0;0;0;0;0;0;0;0
FR;6;2021-11-08;0;0;0;0;0;0;0;0;0;0;0;0;0;0;0;0;0;0
FR;6;2021-11-09;0;0;0;0;0;0;0;0;0;0;0;0;0;0;0;0;0;0
FR;6;2021-11-10;0;0;0;0;0;0;0;0;0;0;0;0;0;0;0;0;0;0
FR;6;2021-11-11;0;0;0;0;0;0;0;0;0;0;0;0;0;0;0;0;0;0
FR;6;2021-11-12;0;0;0;0;0;0;0;0;0;0;0;0;0;0;0;0;0;0
FR;6;2021-11-13;0;0;0;0;0;0;0;0;0;0;0;0;0;0;0;0;0;0
FR;6;2021-11-14;0;0;0;0;0;0;0;0;0;0;0;0;0;0;0;0;0;0
FR;6;2021-11-15;0;0;0;0;0;0;0;0;0;0;0;0;0;0;0;0;0;0
FR;6;2021-11-16;0;0;0;0;0;0;0;0;0;0;0;0;0;0;0;0;0;0
FR;6;2021-11-17;0;0;0;0;0;0;0;0;0;0;0;0;0;0;0;0;0;0
FR;6;2021-11-18;0;0;0;0;0;0;0;0;0;0;0;0;0;0;0;0;0;0
FR;6;2021-11-19;0;0;0;0;0;0;0;0;0;0;0;0;0;0;0;0;0;0
FR;6;2021-11-20;0;0;0;0;0;0;0;0;0;0;0;0;0;0;0;0;0;0
FR;6;2021-11-21;0;0;0;0;0;0;0;0;0;0;0;0;0;0;0;0;0;0
FR;6;2021-11-22;0;0;0;0;0;0;0;0;0;0;0;0;0;0;0;0;0;0
FR;6;2021-11-23;0;0;0;0;0;0;0;0;0;0;0;0;0;0;0;0;0;0
FR;6;2021-11-24;0;0;0;0;0;0;0;0;0;0;0;0;0;0;0;0;0;0
FR;6;2021-11-25;0;0;0;0;0;0;0;0;0;0;0;0;0;0;0;0;0;0
FR;6;2021-11-26;0;0;0;0;0;0;0;0;0;0;0;0;0;0;0;0;0;0
FR;6;2021-11-27;0;0;0;0;0;0;0;0;0;0;0;0;0;0;0;0;0;0
FR;6;2021-11-28;0;0;0;0;0;0;0;0;0;0;0;0;0;0;0;0;0;0
FR;6;2021-11-29;0;0;0;0;0;0;0;0;0;0;0;0;0;0;0;0;0;0
FR;6;2021-11-30;0;0;0;0;0;0;0;0;0;0;0;0;0;0;0;0;0;0
FR;6;2021-12-01;0;0;0;0;0;0;0;0;0;0;0;0;0;0;0;0;0;0
FR;6;2021-12-02;0;0;0;0;0;0;0;0;0;0;0;0;0;0;0;0;0;0
FR;6;2021-12-03;0;0;0;0;0;0;0;0;0;0;0;0;0;0;0;0;0;0
FR;6;2021-12-04;0;0;0;0;0;0;0;0;0;0;0;0;0;0;0;0;0;0
FR;6;2021-12-05;0;0;0;0;0;0;0;0;0;0;0;0;0;0;0;0;0;0
FR;6;2021-12-06;0;0;0;0;0;0;0;0;0;0;0;0;0;0;0;0;0;0
FR;6;2021-12-07;0;0;0;0;0;0;0;0;0;0;0;0;0;0;0;0;0;0
FR;6;2021-12-08;0;0;0;0;0;0;0;0;0;0;0;0;0;0;0;0;0;0
FR;6;2021-12-09;0;0;0;0;0;0;0;0;0;0;0;0;0;0;0;0;0;0
FR;6;2021-12-10;0;0;0;0;0;0;0;0;0;0;0;0;0;0;0;0;0;0
FR;6;2021-12-11;0;0;0;0;0;0;0;0;0;0;0;0;0;0;0;0;0;0
FR;6;2021-12-12;0;0;0;0;0;0;0;0;0;0;0;0;0;0;0;0;0;0
FR;6;2021-12-13;0;0;0;0;0;0;0;0;0;0;0;0;0;0;0;0;0;0
FR;6;2021-12-14;0;0;0;0;0;0;0;0;0;0;0;0;0;0;0;0;0;0
FR;6;2021-12-15;0;0;0;0;0;0;0;0;0;0;0;0;0;0;0;0;0;0
FR;6;2021-12-16;0;0;0;0;0;0;0;0;0;0;0;0;0;0;0;0;0;0
FR;6;2021-12-17;0;0;0;0;0;0;0;0;0;0;0;0;0;0;0;0;0;0
FR;6;2021-12-18;0;0;0;0;0;0;0;0;0;0;0;0;0;0;0;0;0;0
FR;6;2021-12-19;0;0;0;0;0;0;0;0;0;0;0;0;0;0;0;0;0;0
FR;6;2021-12-20;0;0;0;0;0;0;0;0;0;0;0;0;0;0;0;0;0;0
FR;6;2021-12-21;0;0;0;0;0;0;0;0;0;0;0;0;0;0;0;0;0;0
FR;6;2021-12-22;0;0;0;0;0;0;0;0;0;0;0;0;0;0;0;0;0;0
FR;6;2021-12-23;0;0;0;0;0;0;0;0;0;0;0;0;0;0;0;0;0;0
FR;6;2021-12-24;0;0;0;0;0;0;0;0;0;0;0;0;0;0;0;0;0;0
FR;6;2021-12-25;0;0;0;0;0;0;0;0;0;0;0;0;0;0;0;0;0;0
FR;6;2021-12-26;0;0;0;0;0;0;0;0;0;0;0;0;0;0;0;0;0;0
FR;6;2021-12-27;0;0;0;0;0;0;0;0;0;0;0;0;0;0;0;0;0;0
FR;6;2021-12-28;0;0;0;0;0;0;0;0;0;0;0;0;0;0;0;0;0;0
FR;6;2021-12-29;0;0;0;0;0;0;0;0;0;0;0;0;0;0;0;0;0;0
FR;6;2021-12-30;0;0;0;0;0;0;0;0;0;0;0;0;0;0;0;0;0;0
FR;6;2021-12-31;0;0;0;0;0;0;0;0;0;0;0;0;0;0;0;0;0;0
FR;6;2022-01-01;0;0;0;0;0;0;0;0;0;0;0;0;0;0;0;0;0;0
FR;6;2022-01-02;0;0;0;0;0;0;0;0;0;0;0;0;0;0;0;0;0;0
FR;6;2022-01-03;0;0;0;0;0;0;0;0;0;0;0;0;0;0;0;0;0;0
FR;6;2022-01-04;0;0;0;0;0;0;0;0;0;0;0;0;0;0;0;0;0;0
FR;6;2022-01-05;0;0;0;0;0;0;0;0;0;0;0;0;0;0;0;0;0;0
FR;6;2022-01-06;0;0;0;0;0;0;0;0;0;0;0;0;0;0;0;0;0;0
FR;6;2022-01-07;0;0;0;0;0;0;0;0;0;0;0;0;0;0;0;0;0;0
FR;6;2022-01-08;0;0;0;0;0;0;0;0;0;0;0;0;0;0;0;0;0;0
FR;6;2022-01-09;0;0;0;0;0;0;0;0;0;0;0;0;0;0;0;0;0;0
FR;6;2022-01-10;0;0;0;0;0;0;0;0;0;0;0;0;0;0;0;0;0;0
FR;6;2022-01-11;0;0;0;0;0;0;0;0;0;0;0;0;0;0;0;0;0;0
FR;6;2022-01-12;0;0;0;0;0;0;0;0;0;0;0;0;0;0;0;0;0;0
FR;6;2022-01-13;0;0;0;0;0;0;0;0;0;0;0;0;0;0;0;0;0;0
FR;6;2022-01-14;0;0;0;0;0;0;0;0;0;0;0;0;0;0;0;0;0;0
FR;6;2022-01-15;0;0;0;0;0;0;0;0;0;0;0;0;0;0;0;0;0;0
FR;6;2022-01-16;0;0;0;0;0;0;0;0;0;0;0;0;0;0;0;0;0;0
FR;6;2022-01-17;0;0;0;0;0;0;0;0;0;0;0;0;0;0;0;0;0;0
FR;6;2022-01-18;0;0;0;0;0;0;0;0;0;0;0;0;0;0;0;0;0;0
FR;6;2022-01-19;0;0;0;0;0;0;0;0;0;0;0;0;0;0;0;0;0;0
FR;6;2022-01-20;0;0;0;0;0;0;0;0;0;0;0;0;0;0;0;0;0;0
FR;6;2022-01-21;0;0;0;0;0;0;0;0;0;0;0;0;0;0;0;0;0;0
FR;6;2022-01-22;0;0;0;0;0;0;0;0;0;0;0;0;0;0;0;0;0;0
FR;6;2022-01-23;0;0;0;0;0;0;0;0;0;0;0;0;0;0;0;0;0;0
FR;6;2022-01-24;0;0;0;0;0;0;0;0;0;0;0;0;0;0;0;0;0;0
FR;6;2022-01-25;0;0;0;0;0;0;0;0;0;0;0;0;0;0;0;0;0;0
FR;6;2022-01-26;0;0;0;0;0;0;0;0;0;0;0;0;0;0;0;0;0;0
FR;6;2022-01-27;0;0;0;0;0;0;0;0;0;0;0;0;0;0;0;0;0;0
FR;6;2022-01-28;0;0;0;0;0;0;0;0;0;0;0;0;0;0;0;0;0;0
FR;6;2022-01-29;0;0;0;0;0;0;0;0;0;0;0;0;0;0;0;0;0;0
FR;6;2022-01-30;0;0;0;0;0;0;0;0;0;0;0;0;0;0;0;0;0;0
FR;6;2022-01-31;0;0;0;0;0;0;0;0;0;0;0;0;0;0;0;0;0;0
FR;6;2022-02-01;0;0;0;0;0;0;0;0;0;0;0;0;0;0;0;0;0;0
FR;6;2022-02-02;0;0;0;0;0;0;0;0;0;0;0;0;0;0;0;0;0;0
FR;6;2022-02-03;0;0;0;0;0;0;0;0;0;0;0;0;0;0;0;0;0;0
FR;6;2022-02-04;0;0;0;0;0;0;0;0;0;0;0;0;0;0;0;0;0;0
FR;6;2022-02-05;0;0;0;0;0;0;0;0;0;0;0;0;0;0;0;0;0;0
FR;6;2022-02-06;0;0;0;0;0;0;0;0;0;0;0;0;0;0;0;0;0;0
FR;6;2022-02-07;0;0;0;0;0;0;0;0;0;0;0;0;0;0;0;0;0;0
FR;6;2022-02-08;0;0;0;0;0;0;0;0;0;0;0;0;0;0;0;0;0;0
FR;6;2022-02-09;0;0;0;0;0;0;0;0;0;0;0;0;0;0;0;0;0;0
FR;6;2022-02-10;0;0;0;0;0;0;0;0;0;0;0;0;0;0;0;0;0;0
FR;6;2022-02-11;0;0;0;0;0;0;0;0;0;0;0;0;0;0;0;0;0;0
FR;6;2022-02-12;0;0;0;0;0;0;0;0;0;0;0;0;0;0;0;0;0;0
FR;6;2022-02-13;0;0;0;0;0;0;0;0;0;0;0;0;0;0;0;0;0;0
FR;6;2022-02-14;0;0;0;0;0;0;0;0;0;0;0;0;0;0;0;0;0;0
FR;6;2022-02-15;0;0;0;0;0;0;0;0;0;0;0;0;0;0;0;0;0;0
FR;6;2022-02-16;0;0;0;0;0;0;0;0;0;0;0;0;0;0;0;0;0;0
FR;6;2022-02-17;0;0;0;0;0;0;0;0;0;0;0;0;0;0;0;0;0;0
FR;6;2022-02-18;0;0;0;0;0;0;0;0;0;0;0;0;0;0;0;0;0;0
FR;6;2022-02-19;0;0;0;0;0;0;0;0;0;0;0;0;0;0;0;0;0;0
FR;6;2022-02-20;0;0;0;0;0;0;0;0;0;0;0;0;0;0;0;0;0;0
FR;6;2022-02-21;0;0;0;0;0;0;0;0;0;0;0;0;0;0;0;0;0;0
FR;6;2022-02-22;0;0;0;0;0;0;0;0;0;0;0;0;0;0;0;0;0;0
FR;6;2022-02-23;0;0;0;0;0;0;0;0;0;0;0;0;0;0;0;0;0;0
FR;6;2022-02-24;0;0;0;0;0;0;0;0;0;0;0;0;0;0;0;0;0;0
FR;6;2022-02-25;0;0;0;0;0;0;0;0;0;0;0;0;0;0;0;0;0;0
FR;6;2022-02-26;1;0;0;0;0;0;0;0;0;1;0;0;0;0;0;0;0;0
FR;6;2022-02-27;1;0;0;0;1;0;0;0;0;2;0;0;0;1;0;0;0;0
FR;6;2022-02-28;0;0;0;0;0;0;0;0;0;2;0;0;0;1;0;0;0;0
FR;6;2022-03-01;3;0;0;0;0;0;0;0;0;5;0;0;0;1;0;0;0;0
FR;6;2022-03-02;97;9;2;0;15;7;0;0;0;102;9;2;0;16;7;0;0;0
FR;6;2022-03-03;0;0;0;0;0;0;0;0;0;102;9;2;0;16;7;0;0;0
FR;6;2022-03-04;92;4;0;0;8;4;0;0;0;194;13;2;0;24;11;0;0;0
FR;6;2022-03-05;391;23;2;0;60;14;0;0;0;585;36;4;0;84;25;0;0;0
FR;6;2022-03-06;7;1;0;0;2;0;0;0;0;592;37;4;0;86;25;0;0;0
FR;6;2022-03-07;337;19;0;0;51;13;0;0;0;929;56;4;0;137;38;0;0;0
FR;6;2022-03-08;230;14;0;0;47;5;0;0;0;1159;70;4;0;184;43;0;0;0
FR;6;2022-03-09;519;29;2;0;84;21;1;0;0;1678;99;6;0;268;64;1;0;0
FR;6;2022-03-10;206;19;0;1;54;12;1;0;0;1884;118;6;1;322;76;2;0;0
FR;6;2022-03-11;331;22;6;0;53;21;0;0;0;2215;140;12;1;375;97;2;0;0
FR;6;2022-03-12;518;25;1;0;83;20;0;0;0;2733;165;13;1;458;117;2;0;0
FR;6;2022-03-13;40;2;0;0;2;1;0;0;0;2773;167;13;1;460;118;2;0;0
FR;6;2022-03-14;201;4;2;0;39;3;1;0;0;2974;171;15;1;499;121;3;0;0
FR;6;2022-03-15;112;11;2;0;28;9;0;0;0;3086;182;17;1;527;130;3;0;0
FR;6;2022-03-16;310;17;2;1;49;15;1;0;0;3396;199;19;2;576;145;4;0;0
FR;6;2022-03-17;117;6;1;2;14;4;2;0;0;3513;205;20;4;590;149;6;0;0
FR;6;2022-03-18;215;10;0;0;40;6;0;0;0;3728;215;20;4;630;155;6;0;0
FR;6;2022-03-19;307;19;2;0;90;9;0;0;0;4035;234;22;4;720;164;6;0;0
FR;6;2022-03-20;15;5;0;0;5;1;0;0;0;4050;239;22;4;725;165;6;0;0
FR;6;2022-03-21;132;23;1;0;47;4;0;0;0;4182;262;23;4;772;169;6;0;0
FR;6;2022-03-22;97;15;0;0;34;4;0;0;0;4279;277;23;4;806;173;6;0;0
FR;6;2022-03-23;226;108;3;0;155;14;1;0;0;4505;385;26;4;961;187;7;0;0
FR;6;2022-03-24;100;15;1;3;32;4;3;0;0;4605;400;27;7;993;191;10;0;0
FR;6;2022-03-25;203;141;2;1;179;15;2;0;0;4808;541;29;8;1172;206;12;0;0
FR;6;2022-03-26;331;295;7;1;385;19;1;0;0;5139;836;36;9;1557;225;13;0;0
FR;6;2022-03-27;32;30;1;0;37;1;1;0;0;5171;866;37;9;1594;226;14;0;0
FR;6;2022-03-28;201;208;8;1;234;17;3;0;0;5372;1074;45;10;1828;243;17;0;0
FR;6;2022-03-29;124;189;12;2;206;12;9;0;0;5496;1263;57;12;2034;255;26;0;0
FR;6;2022-03-30;305;476;10;2;548;22;6;0;0;5801;1739;67;14;2582;277;32;0;0
FR;6;2022-03-31;123;140;10;0;160;14;5;0;0;5924;1879;77;14;2742;291;37;0;0
FR;6;2022-04-01;195;150;11;2;178;23;3;0;0;6119;2029;88;16;2920;314;40;0;0
FR;6;2022-04-02;206;241;9;1;280;13;8;0;0;6325;2270;97;17;3200;327;48;0;0
FR;6;2022-04-03;17;21;0;0;26;1;0;0;0;6342;2291;97;17;3226;328;48;0;0
FR;6;2022-04-04;137;114;6;1;131;9;5;0;0;6479;2405;103;18;3357;337;53;0;0
FR;6;2022-04-05;146;88;15;1;105;11;8;0;0;6625;2493;118;19;3462;348;61;0;0
FR;6;2022-04-06;204;245;22;26;291;27;33;0;0;6829;2738;140;45;3753;375;94;0;0
FR;6;2022-04-07;127;96;15;9;115;17;14;0;0;6956;2834;155;54;3868;392;108;0;0
FR;6;2022-04-08;199;171;16;3;214;17;9;0;1;7155;3005;171;57;4082;409;117;0;1
FR;6;2022-04-09;145;139;6;12;171;13;4;0;0;7300;3144;177;69;4253;422;121;0;1
FR;6;2022-04-10;11;20;3;0;26;1;3;0;0;7311;3164;180;69;4279;423;124;0;1
FR;6;2022-04-11;101;106;4;0;129;5;3;0;0;7412;3270;184;69;4408;428;127;0;1
FR;6;2022-04-12;136;75;5;8;114;10;10;0;0;7548;3345;189;77;4522;438;137;0;1
FR;6;2022-04-13;162;175;7;5;208;13;8;0;0;7710;3520;196;82;4730;451;145;0;1
FR;6;2022-04-14;100;103;5;10;121;8;10;0;0;7810;3623;201;92;4851;459;155;0;1
FR;6;2022-04-15;158;149;11;7;167;19;14;0;1;7968;3772;212;99;5018;478;169;0;2
FR;6;2022-04-16;127;132;5;0;162;14;2;0;0;8095;3904;217;99;5180;492;171;0;2
FR;6;2022-04-17;8;9;4;0;10;4;0;0;0;8103;3913;221;99;5190;496;171;0;2
FR;6;2022-04-18;8;15;3;0;14;4;0;0;0;8111;3928;224;99;5204;500;171;0;2
FR;6;2022-04-19;97;112;4;3;130;3;7;0;0;8208;4040;228;102;5334;503;178;0;2
FR;6;2022-04-20;177;227;8;7;269;15;3;0;0;8385;4267;236;109;5603;518;181;0;2
FR;6;2022-04-21;111;93;8;4;110;11;7;0;0;8496;4360;244;113;5713;529;188;0;2
FR;6;2022-04-22;139;160;13;12;189;13;13;0;0;8635;4520;257;125;5902;542;201;0;2
FR;6;2022-04-23;106;129;1;1;161;7;1;0;0;8741;4649;258;126;6063;549;202;0;2
FR;6;2022-04-24;5;21;1;0;22;0;1;0;0;8746;4670;259;126;6085;549;203;0;2
FR;6;2022-04-25;90;128;3;8;151;11;9;0;0;8836;4798;262;134;6236;560;212;0;2
FR;6;2022-04-26;101;128;19;2;151;17;13;0;0;8937;4926;281;136;6387;577;225;0;2
FR;6;2022-04-27;197;159;21;1;222;27;11;0;1;9134;5085;302;137;6609;604;236;0;3
FR;6;2022-04-28;109;87;7;1;123;8;7;0;0;9243;5172;309;138;6732;612;243;0;3
FR;6;2022-04-29;191;169;16;2;215;20;6;0;0;9434;5341;325;140;6947;632;249;0;3
FR;6;2022-04-30;133;125;7;1;168;24;2;0;0;9567;5466;332;141;7115;656;251;0;3
FR;6;2022-05-01;7;6;0;0;8;0;0;0;0;9574;5472;332;141;7123;656;251;0;3
FR;6;2022-05-02;94;65;3;4;88;3;4;0;0;9668;5537;335;145;7211;659;255;0;3
FR;6;2022-05-03;136;93;11;2;125;7;9;0;0;9804;5630;346;147;7336;666;264;0;3
FR;6;2022-05-04;167;118;25;12;161;29;12;0;1;9971;5748;371;159;7497;695;276;0;4
FR;6;2022-05-05;101;70;8;3;97;12;6;0;0;10072;5818;379;162;7594;707;282;0;4
FR;6;2022-05-06;152;110;10;9;155;16;11;0;0;10224;5928;389;171;7749;723;293;0;4
FR;6;2022-05-07;139;93;13;3;136;23;8;0;0;10363;6021;402;174;7885;746;301;0;4
FR;6;2022-05-08;20;8;6;5;16;7;5;0;0;10383;6029;408;179;7901;753;306;0;4
FR;6;2022-05-09;86;78;9;7;95;13;6;0;0;10469;6107;417;186;7996;766;312;0;4
FR;6;2022-05-10;112;80;15;7;110;12;13;0;0;10581;6187;432;193;8106;778;325;0;4
FR;6;2022-05-11;130;124;11;14;163;20;6;0;0;10711;6311;443;207;8269;798;331;0;4
FR;6;2022-05-12;105;76;7;5;96;15;6;0;1;10816;6387;450;212;8365;813;337;0;5
FR;6;2022-05-13;155;97;17;21;137;22;16;0;0;10971;6484;467;233;8502;835;353;0;5
FR;6;2022-05-14;81;60;6;7;84;15;2;0;0;11052;6544;473;240;8586;850;355;0;5
FR;6;2022-05-15;12;7;0;0;14;0;0;0;0;11064;6551;473;240;8600;850;355;0;5
FR;6;2022-05-16;65;54;6;2;69;12;3;0;0;11129;6605;479;242;8669;862;358;0;5
FR;6;2022-05-17;123;77;5;7;92;11;8;0;0;11252;6682;484;249;8761;873;366;0;5
FR;6;2022-05-18;131;116;5;1;158;14;3;0;0;11383;6798;489;250;8919;887;369;0;5
FR;6;2022-05-19;124;57;6;8;96;9;8;0;0;11507;6855;495;258;9015;896;377;0;5
FR;6;2022-05-20;125;115;13;3;151;18;10;0;0;11632;6970;508;261;9166;914;387;0;5
FR;6;2022-05-21;92;69;14;3;93;12;8;0;0;11724;7039;522;264;9259;926;395;0;5
FR;6;2022-05-22;19;12;5;0;21;4;1;0;0;11743;7051;527;264;9280;930;396;0;5
FR;6;2022-05-23;77;72;4;2;90;7;2;0;0;11820;7123;531;266;9370;937;398;0;5
FR;6;2022-05-24;117;98;8;2;131;16;4;0;0;11937;7221;539;268;9501;953;402;0;5
FR;6;2022-05-25;140;129;6;3;171;11;6;0;0;12077;7350;545;271;9672;964;408;0;5
FR;6;2022-05-26;7;9;3;0;5;9;0;0;0;12084;7359;548;271;9677;973;408;0;5
FR;6;2022-05-27;127;105;15;11;136;18;18;0;1;12211;7464;563;282;9813;991;426;0;6
FR;6;2022-05-28;54;75;1;5;89;8;5;0;0;12265;7539;564;287;9902;999;431;0;6
FR;6;2022-05-29;8;10;0;0;10;1;0;0;0;12273;7549;564;287;9912;1000;431;0;6
FR;6;2022-05-30;70;70;7;4;86;4;9;0;0;12343;7619;571;291;9998;1004;440;0;6
FR;6;2022-05-31;87;102;10;2;121;14;7;0;0;12430;7721;581;293;10119;1018;447;0;6
FR;6;2022-06-01;97;89;10;1;111;11;6;0;0;12527;7810;591;294;10230;1029;453;0;6
FR;6;2022-06-02;91;60;6;3;80;9;6;0;0;12618;7870;597;297;10310;1038;459;0;6
FR;6;2022-06-03;126;102;13;7;128;21;8;0;0;12744;7972;610;304;10438;1059;467;0;6
FR;6;2022-06-04;63;51;10;0;64;12;3;0;0;12807;8023;620;304;10502;1071;470;0;6
FR;6;2022-06-05;16;15;2;1;18;4;1;0;0;12823;8038;622;305;10520;1075;471;0;6
FR;6;2022-06-06;9;6;0;0;8;0;0;0;0;12832;8044;622;305;10528;1075;471;0;6
FR;6;2022-06-07;79;90;3;4;117;8;6;0;0;12911;8134;625;309;10645;1083;477;0;6
FR;6;2022-06-08;92;110;13;5;130;20;6;0;0;13003;8244;638;314;10775;1103;483;0;6
FR;6;2022-06-09;75;81;15;3;106;15;8;0;0;13078;8325;653;317;10881;1118;491;0;6
FR;6;2022-06-10;116;93;26;10;120;22;13;0;0;13194;8418;679;327;11001;1140;504;0;6
FR;6;2022-06-11;83;62;6;10;82;12;11;0;0;13277;8480;685;337;11083;1152;515;0;6
FR;6;2022-06-12;6;14;1;0;16;2;0;0;0;13283;8494;686;337;11099;1154;515;0;6
FR;6;2022-06-13;74;59;18;1;68;7;4;0;0;13357;8553;704;338;11167;1161;519;0;6
FR;6;2022-06-14;98;100;8;5;116;16;8;0;0;13455;8653;712;343;11283;1177;527;0;6
FR;6;2022-06-15;80;86;7;8;114;15;10;0;0;13535;8739;719;351;11397;1192;537;0;6
FR;6;2022-06-16;53;40;11;7;45;14;6;0;0;13588;8779;730;358;11442;1206;543;0;6
FR;6;2022-06-17;86;85;3;13;109;11;5;0;0;13674;8864;733;371;11551;1217;548;0;6
FR;6;2022-06-18;71;62;13;0;88;21;1;0;0;13745;8926;746;371;11639;1238;549;0;6
FR;6;2022-06-19;6;6;3;0;7;4;1;0;0;13751;8932;749;371;11646;1242;550;0;6
FR;6;2022-06-20;42;41;4;1;55;6;1;0;0;13793;8973;753;372;11701;1248;551;0;6
FR;6;2022-06-21;59;73;10;7;83;17;7;0;0;13852;9046;763;379;11784;1265;558;0;6
FR;6;2022-06-22;86;85;8;2;98;17;3;0;0;13938;9131;771;381;11882;1282;561;0;6
FR;6;2022-06-23;64;39;13;7;41;15;10;0;0;14002;9170;784;388;11923;1297;571;0;6
FR;6;2022-06-24;77;85;7;14;95;20;16;0;0;14079;9255;791;402;12018;1317;587;0;6
FR;6;2022-06-25;67;61;4;3;77;8;5;0;0;14146;9316;795;405;12095;1325;592;0;6
FR;6;2022-06-26;6;7;1;0;10;1;0;0;0;14152;9323;796;405;12105;1326;592;0;6
FR;6;2022-06-27;51;50;4;9;62;12;7;0;0;14203;9373;800;414;12167;1338;599;0;6
FR;6;2022-06-28;68;47;6;3;53;15;5;0;0;14271;9420;806;417;12220;1353;604;0;6
FR;6;2022-06-29;98;117;26;37;115;19;35;0;5;14369;9537;832;454;12335;1372;639;0;11
FR;6;2022-06-30;84;60;33;10;61;12;7;0;0;14453;9597;865;464;12396;1384;646;0;11
FR;6;2022-07-01;115;94;25;33;102;18;27;0;1;14568;9691;890;497;12498;1402;673;0;12
FR;6;2022-07-02;58;67;26;2;64;37;6;0;0;14626;9758;916;499;12562;1439;679;0;12
FR;6;2022-07-03;11;4;4;3;5;4;3;0;0;14637;9762;920;502;12567;1443;682;0;12
FR;6;2022-07-04;61;43;3;23;55;13;20;0;0;14698;9805;923;525;12622;1456;702;0;12
FR;6;2022-07-05;65;53;19;67;60;27;63;0;0;14763;9858;942;592;12682;1483;765;0;12
FR;6;2022-07-06;94;64;7;11;78;12;17;0;0;14857;9922;949;603;12760;1495;782;0;12
FR;6;2022-07-07;99;79;42;37;99;14;34;0;4;14956;10001;991;640;12859;1509;816;0;16
FR;6;2022-07-08;139;87;42;27;115;10;25;0;3;15095;10088;1033;667;12974;1519;841;0;19
FR;6;2022-07-09;53;51;16;29;51;27;33;0;1;15148;10139;1049;696;13025;1546;874;0;20
FR;6;2022-07-10;3;7;8;0;9;9;0;0;0;15151;10146;1057;696;13034;1555;874;0;20
FR;6;2022-07-11;54;44;5;4;47;12;4;0;0;15205;10190;1062;700;13081;1567;878;0;20
FR;6;2022-07-12;70;72;12;23;87;12;27;0;0;15275;10262;1074;723;13168;1579;905;0;20
FR;6;2022-07-13;84;65;14;21;71;25;22;0;0;15359;10327;1088;744;13239;1604;927;0;20
FR;6;2022-07-14;4;3;1;0;4;1;0;0;0;15363;10330;1089;744;13243;1605;927;0;20
FR;6;2022-07-15;74;59;9;57;85;16;45;0;0;15437;10389;1098;801;13328;1621;972;0;20
FR;6;2022-07-16;27;31;17;0;37;17;3;0;0;15464;10420;1115;801;13365;1638;975;0;20
FR;6;2022-07-17;3;7;0;0;8;0;0;0;0;15467;10427;1115;801;13373;1638;975;0;20
FR;6;2022-07-18;37;62;11;14;60;15;14;0;6;15504;10489;1126;815;13433;1653;989;0;26
FR;6;2022-07-19;54;48;4;19;60;6;21;0;1;15558;10537;1130;834;13493;1659;1010;0;27
FR;6;2022-07-20;53;70;7;22;75;11;27;0;0;15611;10607;1137;856;13568;1670;1037;0;27
FR;6;2022-07-21;51;61;4;7;56;11;9;0;0;15662;10668;1141;863;13624;1681;1046;0;27
FR;6;2022-07-22;55;74;7;26;82;8;16;0;2;15717;10742;1148;889;13706;1689;1062;0;29
FR;6;2022-07-23;38;40;6;10;40;6;9;0;1;15755;10782;1154;899;13746;1695;1071;0;30
FR;6;2022-07-24;11;14;1;3;19;3;3;0;0;15766;10796;1155;902;13765;1698;1074;0;30
FR;6;2022-07-25;60;44;8;12;41;9;13;0;1;15826;10840;1163;914;13806;1707;1087;0;31
FR;6;2022-07-26;47;64;14;6;62;10;13;0;0;15873;10904;1177;920;13868;1717;1100;0;31
FR;6;2022-07-27;54;78;15;11;80;18;15;0;8;15927;10982;1192;931;13948;1735;1115;0;39
FR;6;2022-07-28;30;48;4;6;50;8;7;0;1;15957;11030;1196;937;13998;1743;1122;0;40
FR;6;2022-07-29;43;71;10;38;60;24;36;0;1;16000;11101;1206;975;14058;1767;1158;0;41
FR;6;2022-07-30;26;48;4;15;49;7;15;0;0;16026;11149;1210;990;14107;1774;1173;0;41
FR;6;2022-07-31;0;1;1;0;1;0;1;0;0;16026;11150;1211;990;14108;1774;1174;0;41
FR;6;2022-08-01;39;36;14;8;32;10;6;0;1;16065;11186;1225;998;14140;1784;1180;0;42
FR;6;2022-08-02;37;46;10;14;52;6;16;0;0;16102;11232;1235;1012;14192;1790;1196;0;42
FR;6;2022-08-03;29;52;7;16;53;11;19;0;0;16131;11284;1242;1028;14245;1801;1215;0;42
FR;6;2022-08-04;25;21;4;9;20;6;10;0;1;16156;11305;1246;1037;14265;1807;1225;0;43
FR;6;2022-08-05;43;45;1;7;54;5;7;0;0;16199;11350;1247;1044;14319;1812;1232;0;43
FR;6;2022-08-06;17;27;1;3;33;2;4;0;0;16216;11377;1248;1047;14352;1814;1236;0;43
FR;6;2022-08-07;1;2;0;0;2;0;0;0;0;16217;11379;1248;1047;14354;1814;1236;0;43
FR;6;2022-08-08;24;33;1;0;40;1;0;0;0;16241;11412;1249;1047;14394;1815;1236;0;43
FR;6;2022-08-09;22;30;6;3;29;3;3;0;0;16263;11442;1255;1050;14423;1818;1239;0;43
FR;6;2022-08-10;32;36;5;9;38;5;9;0;5;16295;11478;1260;1059;14461;1823;1248;0;48
FR;6;2022-08-11;32;33;1;1;40;1;0;0;1;16327;11511;1261;1060;14501;1824;1248;0;49
FR;6;2022-08-12;50;44;6;2;50;15;3;0;1;16377;11555;1267;1062;14551;1839;1251;0;50
FR;6;2022-08-13;9;20;0;0;22;1;0;0;0;16386;11575;1267;1062;14573;1840;1251;0;50
FR;6;2022-08-14;3;1;0;0;2;0;0;0;0;16389;11576;1267;1062;14575;1840;1251;0;50
FR;6;2022-08-15;2;3;1;0;4;0;1;0;0;16391;11579;1268;1062;14579;1840;1252;0;50
FR;6;2022-08-16;35;66;21;7;66;7;2;0;0;16426;11645;1289;1069;14645;1847;1254;0;50
FR;6;2022-08-17;32;44;10;9;41;10;6;0;7;16458;11689;1299;1078;14686;1857;1260;0;57
FR;6;2022-08-18;29;55;14;4;61;4;0;0;1;16487;11744;1313;1082;14747;1861;1260;0;58
FR;6;2022-08-19;30;45;5;4;47;3;2;0;1;16517;11789;1318;1086;14794;1864;1262;0;59
FR;6;2022-08-20;26;28;3;0;27;8;1;0;0;16543;11817;1321;1086;14821;1872;1263;0;59
FR;6;2022-08-21;1;5;2;0;5;0;0;0;0;16544;11822;1323;1086;14826;1872;1263;0;59
FR;6;2022-08-22;20;42;15;1;45;0;0;0;0;16564;11864;1338;1087;14871;1872;1263;0;59
FR;6;2022-08-23;34;45;6;7;47;6;4;0;2;16598;11909;1344;1094;14918;1878;1267;0;61
FR;6;2022-08-24;34;30;6;3;36;6;2;0;3;16632;11939;1350;1097;14954;1884;1269;0;64
FR;6;2022-08-25;25;27;1;1;29;5;1;0;0;16657;11966;1351;1098;14983;1889;1270;0;64
FR;6;2022-08-26;38;44;4;4;51;7;7;0;0;16695;12010;1355;1102;15034;1896;1277;0;64
FR;6;2022-08-27;19;21;7;3;22;8;4;0;0;16714;12031;1362;1105;15056;1904;1281;0;64
FR;6;2022-08-28;6;3;0;6;3;1;1;0;4;16720;12034;1362;1111;15059;1905;1282;0;68
FR;6;2022-08-29;26;22;2;6;29;3;6;0;0;16746;12056;1364;1117;15088;1908;1288;0;68
FR;6;2022-08-30;28;35;4;12;33;8;13;0;0;16774;12091;1368;1129;15121;1916;1301;0;68
FR;6;2022-08-31;35;38;2;11;46;3;12;0;0;16809;12129;1370;1140;15167;1919;1313;0;68
FR;6;2022-09-01;17;11;5;1;13;4;3;0;0;16826;12140;1375;1141;15180;1923;1316;0;68
FR;6;2022-09-02;19;14;2;1;13;3;2;0;0;16845;12154;1377;1142;15193;1926;1318;0;68
FR;6;2022-09-03;10;3;1;5;4;2;5;0;0;16855;12157;1378;1147;15197;1928;1323;0;68
FR;6;2022-09-04;4;1;0;0;1;0;0;0;0;16859;12158;1378;1147;15198;1928;1323;0;68
FR;6;2022-09-05;8;7;0;0;10;0;0;0;0;16867;12165;1378;1147;15208;1928;1323;0;68
FR;6;2022-09-06;7;9;7;12;8;6;15;0;0;16874;12174;1385;1159;15216;1934;1338;0;68
FR;6;2022-09-07;3;8;1;0;8;1;0;0;0;16877;12182;1386;1159;15224;1935;1338;0;68
FR;6;2022-09-08;6;4;0;2;3;1;2;0;0;16883;12186;1386;1161;15227;1936;1340;0;68
FR;6;2022-09-09;7;9;2;7;9;3;8;0;0;16890;12195;1388;1168;15236;1939;1348;0;68
FR;6;2022-09-10;3;4;1;0;3;1;1;0;0;16893;12199;1389;1168;15239;1940;1349;0;68
FR;6;2022-09-11;1;3;0;0;3;0;0;0;0;16894;12202;1389;1168;15242;1940;1349;0;68
FR;6;2022-09-12;10;4;1;0;3;3;0;0;0;16904;12206;1390;1168;15245;1943;1349;0;68
FR;6;2022-09-13;7;2;3;0;2;2;2;0;0;16911;12208;1393;1168;15247;1945;1351;0;68
FR;6;2022-09-14;9;8;2;0;7;4;0;0;0;16920;12216;1395;1168;15254;1949;1351;0;68
FR;6;2022-09-15;8;13;5;5;9;9;3;0;2;16928;12229;1400;1173;15263;1958;1354;0;70
FR;6;2022-09-16;25;39;1;1;47;4;1;0;2;16953;12268;1401;1174;15310;1962;1355;0;72
FR;6;2022-09-17;24;22;0;6;24;5;3;0;2;16977;12290;1401;1180;15334;1967;1358;0;74
FR;6;2022-09-18;5;4;0;0;4;1;0;0;0;16982;12294;1401;1180;15338;1968;1358;0;74
FR;6;2022-09-19;30;30;2;1;32;5;1;0;0;17012;12324;1403;1181;15370;1973;1359;0;74
FR;6;2022-09-20;34;25;1;4;30;6;2;0;1;17046;12349;1404;1185;15400;1979;1361;0;75
FR;6;2022-09-21;21;9;3;3;7;7;5;0;3;17067;12358;1407;1188;15407;1986;1366;0;78
FR;6;2022-09-22;19;28;1;22;32;3;21;0;1;17086;12386;1408;1210;15439;1989;1387;0;79
FR;6;2022-09-23;28;41;5;9;47;9;2;0;0;17114;12427;1413;1219;15486;1998;1389;0;79
FR;6;2022-09-24;16;16;4;2;21;6;2;0;0;17130;12443;1417;1221;15507;2004;1391;0;79
FR;6;2022-09-25;3;14;0;0;14;1;0;0;0;17133;12457;1417;1221;15521;2005;1391;0;79
FR;6;2022-09-26;16;13;0;18;12;5;18;0;2;17149;12470;1417;1239;15533;2010;1409;0;81
FR;6;2022-09-27;32;19;2;3;23;4;4;0;0;17181;12489;1419;1242;15556;2014;1413;0;81
FR;6;2022-09-28;27;10;9;11;16;5;17;0;2;17208;12499;1428;1253;15572;2019;1430;0;83
FR;6;2022-09-29;13;13;10;34;16;6;33;0;7;17221;12512;1438;1287;15588;2025;1463;0;90
FR;6;2022-09-30;34;24;5;6;33;5;3;0;0;17255;12536;1443;1293;15621;2030;1466;0;90
FR;6;2022-10-01;17;12;5;8;9;8;8;0;2;17272;12548;1448;1301;15630;2038;1474;0;92
FR;6;2022-10-02;4;0;0;0;1;0;0;0;0;17276;12548;1448;1301;15631;2038;1474;0;92
FR;6;2022-10-03;11;10;3;5;11;4;6;0;0;17287;12558;1451;1306;15642;2042;1480;0;92
FR;6;2022-10-04;19;17;4;28;21;3;30;0;3;17306;12575;1455;1334;15663;2045;1510;0;95
FR;6;2022-10-05;11;12;3;2;9;7;4;0;0;17317;12587;1458;1336;15672;2052;1514;0;95
FR;6;2022-10-06;19;13;4;6;17;2;10;0;0;17336;12600;1462;1342;15689;2054;1524;0;95
FR;6;2022-10-07;27;26;5;24;24;11;16;0;5;17363;12626;1467;1366;15713;2065;1540;0;100
FR;6;2022-10-08;18;13;0;0;16;0;0;0;0;17381;12639;1467;1366;15729;2065;1540;0;100
FR;6;2022-10-09;7;3;4;27;3;4;30;0;6;17388;12642;1471;1393;15732;2069;1570;0;106
FR;6;2022-10-10;15;14;1;16;16;6;13;0;0;17403;12656;1472;1409;15748;2075;1583;0;106
FR;6;2022-10-11;21;23;3;11;22;8;13;0;3;17424;12679;1475;1420;15770;2083;1596;0;109
FR;6;2022-10-12;20;16;7;19;18;3;24;0;7;17444;12695;1482;1439;15788;2086;1620;0;116
FR;6;2022-10-13;28;15;2;36;23;0;38;0;6;17472;12710;1484;1475;15811;2086;1658;0;122
FR;6;2022-10-14;29;23;5;49;24;11;45;0;13;17501;12733;1489;1524;15835;2097;1703;0;135
FR;6;2022-10-15;13;9;0;22;8;4;21;0;6;17514;12742;1489;1546;15843;2101;1724;0;141
FR;6;2022-10-16;4;5;0;6;2;3;6;0;0;17518;12747;1489;1552;15845;2104;1730;0;141
FR;6;2022-10-17;14;14;2;10;14;1;12;0;2;17532;12761;1491;1562;15859;2105;1742;0;143
FR;6;2022-10-18;12;19;9;26;19;4;18;0;11;17544;12780;1500;1588;15878;2109;1760;0;154
FR;6;2022-10-19;10;20;6;16;20;5;19;0;5;17554;12800;1506;1604;15898;2114;1779;0;159
FR;6;2022-10-20;16;15;12;57;19;5;67;0;13;17570;12815;1518;1661;15917;2119;1846;0;172
FR;6;2022-10-21;16;21;9;34;22;11;37;0;10;17586;12836;1527;1695;15939;2130;1883;0;182
FR;6;2022-10-22;19;14;1;4;17;3;4;0;0;17605;12850;1528;1699;15956;2133;1887;0;182
FR;6;2022-10-23;3;3;1;0;4;0;1;0;0;17608;12853;1529;1699;15960;2133;1888;0;182
FR;6;2022-10-24;12;14;2;7;14;6;5;0;2;17620;12867;1531;1706;15974;2139;1893;0;184
FR;6;2022-10-25;20;13;6;17;16;7;19;0;4;17640;12880;1537;1723;15990;2146;1912;0;188
FR;6;2022-10-26;17;9;4;13;12;4;15;0;5;17657;12889;1541;1736;16002;2150;1927;0;193
FR;6;2022-10-27;20;7;8;37;10;6;36;0;14;17677;12896;1549;1773;16012;2156;1963;0;207
FR;6;2022-10-28;21;27;3;4;28;6;5;0;1;17698;12923;1552;1777;16040;2162;1968;0;208
FR;6;2022-10-29;7;11;5;11;10;6;14;0;12;17705;12934;1557;1788;16050;2168;1982;0;220
FR;6;2022-10-30;2;5;0;0;5;0;0;0;0;17707;12939;1557;1788;16055;2168;1982;0;220
FR;6;2022-10-31;20;14;2;13;17;4;12;0;3;17727;12953;1559;1801;16072;2172;1994;0;223
FR;6;2022-11-01;2;1;1;0;1;1;0;0;0;17729;12954;1560;1801;16073;2173;1994;0;223
FR;6;2022-11-02;15;25;9;21;26;11;19;0;12;17744;12979;1569;1822;16099;2184;2013;0;235
FR;6;2022-11-03;17;17;11;39;20;8;43;0;9;17761;12996;1580;1861;16119;2192;2056;0;244
FR;6;2022-11-04;19;22;9;16;27;5;16;0;10;17780;13018;1589;1877;16146;2197;2072;0;254
FR;6;2022-11-05;9;16;2;4;17;4;6;0;0;17789;13034;1591;1881;16163;2201;2078;0;254
FR;6;2022-11-06;5;1;0;0;1;0;0;0;0;17794;13035;1591;1881;16164;2201;2078;0;254
FR;6;2022-11-07;18;10;6;17;12;4;18;0;11;17812;13045;1597;1898;16176;2205;2096;0;265
FR;6;2022-11-08;18;10;2;3;8;5;5;0;4;17830;13055;1599;1901;16184;2210;2101;0;269
FR;6;2022-11-09;16;22;1;6;21;4;5;0;4;17846;13077;1600;1907;16205;2214;2106;0;273
FR;6;2022-11-10;10;10;4;12;8;5;11;0;10;17856;13087;1604;1919;16213;2219;2117;0;283
FR;6;2022-11-11;4;1;0;0;1;1;0;0;0;17860;13088;1604;1919;16214;2220;2117;0;283
FR;6;2022-11-12;4;11;1;7;11;2;5;0;9;17864;13099;1605;1926;16225;2222;2122;0;292
FR;6;2022-11-13;1;1;0;1;1;0;1;0;0;17865;13100;1605;1927;16226;2222;2123;0;292
FR;6;2022-11-14;13;10;7;32;14;8;33;0;14;17878;13110;1612;1959;16240;2230;2156;0;306
FR;6;2022-11-15;7;18;1;11;16;4;7;0;2;17885;13128;1613;1970;16256;2234;2163;0;308
FR;6;2022-11-16;16;15;9;32;16;3;42;0;9;17901;13143;1622;2002;16272;2237;2205;0;317
FR;6;2022-11-17;10;8;1;29;8;2;28;0;5;17911;13151;1623;2031;16280;2239;2233;0;322
FR;6;2022-11-18;19;12;5;23;17;4;25;0;7;17930;13163;1628;2054;16297;2243;2258;0;329
FR;6;2022-11-19;5;13;0;2;11;3;2;0;1;17935;13176;1628;2056;16308;2246;2260;0;330
FR;6;2022-11-20;2;1;2;0;1;2;0;0;0;17937;13177;1630;2056;16309;2248;2260;0;330
FR;6;2022-11-21;22;13;1;14;14;6;11;0;3;17959;13190;1631;2070;16323;2254;2271;0;333
FR;6;2022-11-22;14;9;0;4;11;1;3;0;1;17973;13199;1631;2074;16334;2255;2274;0;334
FR;6;2022-11-23;14;15;15;23;17;9;31;0;8;17987;13214;1646;2097;16351;2264;2305;0;342
FR;6;2022-11-24;14;17;1;13;19;5;12;0;7;18001;13231;1647;2110;16370;2269;2317;0;349
FR;6;2022-11-25;23;15;5;50;15;5;47;0;5;18024;13246;1652;2160;16385;2274;2364;0;354
FR;6;2022-11-26;9;5;2;4;3;2;5;0;1;18033;13251;1654;2164;16388;2276;2369;0;355
FR;6;2022-11-27;1;4;0;0;4;0;0;0;0;18034;13255;1654;2164;16392;2276;2369;0;355
FR;6;2022-11-28;9;11;6;22;11;3;24;0;11;18043;13266;1660;2186;16403;2279;2393;0;366
FR;6;2022-11-29;15;10;1;12;14;1;8;0;7;18058;13276;1661;2198;16417;2280;2401;0;373
FR;6;2022-11-30;18;20;8;23;19;12;22;0;8;18076;13296;1669;2221;16436;2292;2423;0;381
FR;6;2022-12-01;12;9;7;20;11;4;24;0;9;18088;13305;1676;2241;16447;2296;2447;0;390
FR;6;2022-12-02;17;9;12;36;12;8;42;0;1;18105;13314;1688;2277;16459;2304;2489;0;391
FR;6;2022-12-03;13;3;13;20;6;5;28;0;13;18118;13317;1701;2297;16465;2309;2517;0;404
FR;6;2022-12-04;3;1;0;2;1;0;2;0;0;18121;13318;1701;2299;16466;2309;2519;0;404
FR;6;2022-12-05;11;10;7;16;10;4;19;0;8;18132;13328;1708;2315;16476;2313;2538;0;412
FR;6;2022-12-06;10;19;3;30;12;11;28;0;3;18142;13347;1711;2345;16488;2324;2566;0;415
FR;6;2022-12-07;17;8;10;56;10;8;57;0;30;18159;13355;1721;2401;16498;2332;2623;0;445
FR;6;2022-12-08;9;13;8;19;11;7;21;0;13;18168;13368;1729;2420;16509;2339;2644;0;458
FR;6;2022-12-09;15;9;5;29;12;4;30;0;6;18183;13377;1734;2449;16521;2343;2674;0;464
FR;6;2022-12-10;12;9;6;9;7;4;14;0;7;18195;13386;1740;2458;16528;2347;2688;0;471
FR;6;2022-12-11;4;2;1;0;2;1;0;0;0;18199;13388;1741;2458;16530;2348;2688;0;471
FR;6;2022-12-12;17;10;8;36;14;9;33;0;17;18216;13398;1749;2494;16544;2357;2721;0;488
FR;6;2022-12-13;17;21;12;66;16;18;65;0;14;18233;13419;1761;2560;16560;2375;2786;0;502
FR;6;2022-12-14;14;13;8;53;11;12;53;0;14;18247;13432;1769;2613;16571;2387;2839;0;516
FR;6;2022-12-15;12;15;14;38;13;9;44;0;9;18259;13447;1783;2651;16584;2396;2883;0;525
FR;6;2022-12-16;18;14;15;39;15;14;39;0;13;18277;13461;1798;2690;16599;2410;2922;0;538
FR;6;2022-12-17;11;10;15;28;9;15;29;0;8;18288;13471;1813;2718;16608;2425;2951;0;546
FR;6;2022-12-18;7;4;0;2;5;0;2;0;0;18295;13475;1813;2720;16613;2425;2953;0;546
FR;6;2022-12-19;12;8;9;29;8;12;29;0;15;18307;13483;1822;2749;16621;2437;2982;0;561
FR;6;2022-12-20;17;23;11;23;17;19;22;0;21;18324;13506;1833;2772;16638;2456;3004;0;582
FR;6;2022-12-21;23;16;9;19;13;13;17;0;5;18347;13522;1842;2791;16651;2469;3021;0;587
FR;6;2022-12-22;13;14;9;21;15;13;18;0;11;18360;13536;1851;2812;16666;2482;3039;0;598
FR;6;2022-12-23;10;19;12;7;14;18;7;0;3;18370;13555;1863;2819;16680;2500;3046;0;601
FR;6;2022-12-24;4;5;3;1;5;2;2;0;1;18374;13560;1866;2820;16685;2502;3048;0;602
FR;6;2022-12-25;0;0;0;0;0;0;0;0;0;18374;13560;1866;2820;16685;2502;3048;0;602
FR;6;2022-12-26;8;12;12;11;10;18;11;0;3;18382;13572;1878;2831;16695;2520;3059;0;605
FR;6;2022-12-27;16;13;15;8;11;19;8;0;0;18398;13585;1893;2839;16706;2539;3067;0;605
FR;6;2022-12-28;15;19;6;8;19;9;9;0;4;18413;13604;1899;2847;16725;2548;3076;0;609
FR;6;2022-12-29;15;12;7;8;10;9;9;0;7;18428;13616;1906;2855;16735;2557;3085;0;616
FR;6;2022-12-30;20;19;13;8;20;13;11;0;4;18448;13635;1919;2863;16755;2570;3096;0;620
FR;6;2022-12-31;5;2;6;1;4;7;1;0;1;18453;13637;1925;2864;16759;2577;3097;0;621
FR;6;2023-01-01;2;1;0;3;0;3;0;0;1;18455;13638;1925;2867;16759;2580;3097;0;622
FR;6;2023-01-02;9;14;2;3;10;7;3;0;0;18464;13652;1927;2870;16769;2587;3100;0;622
FR;6;2023-01-03;8;17;9;21;17;9;21;0;7;18472;13669;1936;2891;16786;2596;3121;0;629
FR;6;2023-01-04;9;10;4;10;9;8;6;0;14;18481;13679;1940;2901;16795;2604;3127;0;643
FR;6;2023-01-05;11;11;6;23;10;3;26;0;8;18492;13690;1946;2924;16805;2607;3153;0;651
FR;6;2023-01-06;16;24;15;30;21;17;29;0;15;18508;13714;1961;2954;16826;2624;3182;0;666
FR;6;2023-01-07;9;19;4;1;10;13;3;0;1;18517;13733;1965;2955;16836;2637;3185;0;667
FR;6;2023-01-08;2;7;4;11;6;4;11;0;3;18519;13740;1969;2966;16842;2641;3196;0;670
FR;6;2023-01-09;16;10;5;35;9;8;34;0;17;18535;13750;1974;3001;16851;2649;3230;0;687
FR;6;2023-01-10;13;15;13;23;13;10;26;0;9;18548;13765;1987;3024;16864;2659;3256;0;696
FR;6;2023-01-11;15;14;5;16;18;6;14;0;12;18563;13779;1992;3040;16882;2665;3270;0;708
FR;6;2023-01-12;7;13;2;5;10;3;5;0;12;18570;13792;1994;3045;16892;2668;3275;0;720
FR;6;2023-01-13;20;14;18;43;15;20;43;0;31;18590;13806;2012;3088;16907;2688;3318;0;751
FR;6;2023-01-14;20;8;6;2;9;9;2;0;0;18610;13814;2018;3090;16916;2697;3320;0;751
FR;6;2023-01-15;0;0;1;3;0;1;3;0;0;18610;13814;2019;3093;16916;2698;3323;0;751
FR;6;2023-01-16;22;12;2;1;10;6;3;0;2;18632;13826;2021;3094;16926;2704;3326;0;753
FR;6;2023-01-17;8;17;12;8;17;11;14;0;5;18640;13843;2033;3102;16943;2715;3340;0;758
FR;6;2023-01-18;22;15;9;7;17;10;8;0;1;18662;13858;2042;3109;16960;2725;3348;0;759
FR;6;2023-01-19;9;9;14;9;11;12;13;0;7;18671;13867;2056;3118;16971;2737;3361;0;766
FR;6;2023-01-20;17;13;9;32;15;7;34;0;27;18688;13880;2065;3150;16986;2744;3395;0;793
FR;6;2023-01-21;12;7;5;2;6;8;3;0;1;18700;13887;2070;3152;16992;2752;3398;0;794
FR;6;2023-01-22;0;0;1;1;0;1;1;0;0;18700;13887;2071;3153;16992;2753;3399;0;794
FR;6;2023-01-23;9;9;5;11;8;5;11;0;3;18709;13896;2076;3164;17000;2758;3410;0;797
FR;6;2023-01-24;14;15;15;13;15;14;18;0;6;18723;13911;2091;3177;17015;2772;3428;0;803
FR;6;2023-01-25;15;7;5;3;6;6;4;0;4;18738;13918;2096;3180;17021;2778;3432;0;807
FR;6;2023-01-26;13;15;3;11;12;8;13;0;9;18751;13933;2099;3191;17033;2786;3445;0;816
FR;6;2023-01-27;21;17;7;34;22;7;29;0;29;18772;13950;2106;3225;17055;2793;3474;0;845
FR;6;2023-01-28;15;15;7;4;17;6;5;0;1;18787;13965;2113;3229;17072;2799;3479;0;846
FR;6;2023-01-29;1;4;0;0;3;1;0;0;0;18788;13969;2113;3229;17075;2800;3479;0;846
FR;6;2023-01-30;2;15;8;4;15;8;3;0;8;18790;13984;2121;3233;17090;2808;3482;0;854
FR;6;2023-01-31;9;8;5;8;8;5;8;0;5;18799;13992;2126;3241;17098;2813;3490;0;859
FR;6;2023-02-01;20;18;4;4;17;4;8;0;4;18819;14010;2130;3245;17115;2817;3498;0;863
FR;6;2023-02-02;8;10;9;1;10;10;1;0;1;18827;14020;2139;3246;17125;2827;3499;0;864
FR;6;2023-02-03;16;15;11;18;15;11;19;0;13;18843;14035;2150;3264;17140;2838;3518;0;877
FR;6;2023-02-04;6;9;9;7;11;9;8;0;2;18849;14044;2159;3271;17151;2847;3526;0;879
FR;6;2023-02-05;0;0;0;4;0;0;4;0;0;18849;14044;2159;3275;17151;2847;3530;0;879
FR;6;2023-02-06;10;16;1;4;15;5;4;0;0;18859;14060;2160;3279;17166;2852;3534;0;879
FR;6;2023-02-07;8;9;4;8;9;7;7;0;3;18867;14069;2164;3287;17175;2859;3541;0;882
FR;6;2023-02-08;7;3;3;2;2;6;1;0;1;18874;14072;2167;3289;17177;2865;3542;0;883
FR;6;2023-02-09;6;11;1;6;8;8;2;0;2;18880;14083;2168;3295;17185;2873;3544;0;885
FR;6;2023-02-10;13;21;6;12;15;15;11;0;2;18893;14104;2174;3307;17200;2888;3555;0;887
FR;6;2023-02-11;12;8;7;4;9;3;9;0;5;18905;14112;2181;3311;17209;2891;3564;0;892
FR;6;2023-02-12;0;1;0;0;1;0;0;0;0;18905;14113;2181;3311;17210;2891;3564;0;892
FR;6;2023-02-13;5;6;0;0;6;1;0;0;0;18910;14119;2181;3311;17216;2892;3564;0;892
FR;6;2023-02-14;12;13;3;15;15;4;14;0;0;18922;14132;2184;3326;17231;2896;3578;0;892
FR;6;2023-02-15;8;11;3;2;11;2;2;0;4;18930;14143;2187;3328;17242;2898;3580;0;896
FR;6;2023-02-16;17;8;1;3;18;1;3;0;4;18947;14151;2188;3331;17260;2899;3583;0;900
FR;6;2023-02-17;9;15;3;9;12;8;9;0;5;18956;14166;2191;3340;17272;2907;3592;0;905
FR;6;2023-02-18;10;6;1;1;7;1;1;0;0;18966;14172;2192;3341;17279;2908;3593;0;905
FR;6;2023-02-19;0;0;0;0;0;0;0;0;0;18966;14172;2192;3341;17279;2908;3593;0;905
FR;6;2023-02-20;10;8;3;2;9;5;1;0;0;18976;14180;2195;3343;17288;2913;3594;0;905
FR;6;2023-02-21;9;8;8;5;6;7;8;0;1;18985;14188;2203;3348;17294;2920;3602;0;906
FR;6;2023-02-22;4;13;1;3;13;3;3;0;5;18989;14201;2204;3351;17307;2923;3605;0;911
FR;6;2023-02-23;7;11;6;2;10;6;4;0;1;18996;14212;2210;3353;17317;2929;3609;0;912
FR;6;2023-02-24;9;13;5;21;15;4;19;0;15;19005;14225;2215;3374;17332;2933;3628;0;927
FR;6;2023-02-25;4;5;1;1;6;1;1;0;0;19009;14230;2216;3375;17338;2934;3629;0;927
FR;6;2023-02-26;0;1;0;0;0;1;0;0;0;19009;14231;2216;3375;17338;2935;3629;0;927
FR;6;2023-02-27;10;8;3;1;3;9;0;0;2;19019;14239;2219;3376;17341;2944;3629;0;929
FR;6;2023-02-28;3;8;4;4;9;3;6;0;0;19022;14247;2223;3380;17350;2947;3635;0;929
FR;6;2023-03-01;6;10;3;2;10;4;2;0;0;19028;14257;2226;3382;17360;2951;3637;0;929
FR;6;2023-03-02;8;7;1;3;7;3;2;0;5;19036;14264;2227;3385;17367;2954;3639;0;934
FR;6;2023-03-03;14;12;5;7;11;9;6;0;7;19050;14276;2232;3392;17378;2963;3645;0;941
FR;6;2023-03-04;8;14;1;0;13;3;0;0;0;19058;14290;2233;3392;17391;2966;3645;0;941
FR;6;2023-03-05;4;0;0;0;0;0;0;0;0;19062;14290;2233;3392;17391;2966;3645;0;941
FR;6;2023-03-06;8;12;0;1;11;2;0;0;1;19070;14302;2233;3393;17402;2968;3645;0;942
FR;6;2023-03-07;4;6;0;1;4;3;0;0;5;19074;14308;2233;3394;17406;2971;3645;0;947
FR;6;2023-03-08;3;7;2;0;7;2;0;0;0;19077;14315;2235;3394;17413;2973;3645;0;947
FR;6;2023-03-09;7;6;0;1;6;2;1;0;0;19084;14321;2235;3395;17419;2975;3646;0;947
FR;6;2023-03-10;9;9;2;9;9;2;9;0;9;19093;14330;2237;3404;17428;2977;3655;0;956
FR;6;2023-03-11;13;12;2;0;12;2;2;0;0;19106;14342;2239;3404;17440;2979;3657;0;956
FR;6;2023-03-12;2;0;0;0;1;0;0;0;0;19108;14342;2239;3404;17441;2979;3657;0;956
FR;6;2023-03-13;7;12;4;1;13;2;1;0;2;19115;14354;2243;3405;17454;2981;3658;0;958
FR;6;2023-03-14;5;12;2;0;8;6;0;0;0;19120;14366;2245;3405;17462;2987;3658;0;958
FR;6;2023-03-15;6;4;2;3;5;3;3;0;1;19126;14370;2247;3408;17467;2990;3661;0;959
FR;6;2023-03-16;9;5;2;0;5;3;0;0;0;19135;14375;2249;3408;17472;2993;3661;0;959
FR;6;2023-03-17;10;12;5;5;8;8;5;0;3;19145;14387;2254;3413;17480;3001;3666;0;962
FR;6;2023-03-18;6;2;2;0;3;2;0;0;0;19151;14389;2256;3413;17483;3003;3666;0;962
FR;6;2023-03-19;0;0;1;0;0;0;0;0;0;19151;14389;2257;3413;17483;3003;3666;0;962
FR;6;2023-03-20;2;6;3;7;5;4;5;0;4;19153;14395;2260;3420;17488;3007;3671;0;966
FR;6;2023-03-21;2;1;5;2;1;3;4;0;0;19155;14396;2265;3422;17489;3010;3675;0;966
FR;6;2023-03-22;1;4;3;0;4;3;0;0;3;19156;14400;2268;3422;17493;3013;3675;0;969
FR;6;2023-03-23;3;4;3;2;4;3;2;0;0;19159;14404;2271;3424;17497;3016;3677;0;969
FR;6;2023-03-24;3;9;6;0;9;7;0;0;0;19162;14413;2277;3424;17506;3023;3677;0;969
FR;6;2023-03-25;10;7;0;0;9;0;0;0;0;19172;14420;2277;3424;17515;3023;3677;0;969
FR;6;2023-03-26;1;0;0;0;0;0;0;0;0;19173;14420;2277;3424;17515;3023;3677;0;969
FR;6;2023-03-27;6;9;2;2;8;4;1;0;0;19179;14429;2279;3426;17523;3027;3678;0;969
FR;6;2023-03-28;8;4;2;2;6;2;2;0;2;19187;14433;2281;3428;17529;3029;3680;0;971
FR;6;2023-03-29;4;1;2;0;1;2;0;0;0;19191;14434;2283;3428;17530;3031;3680;0;971
FR;6;2023-03-30;4;7;1;0;5;3;0;0;0;19195;14441;2284;3428;17535;3034;3680;0;971
FR;6;2023-03-31;1;3;3;3;3;3;1;0;7;19196;14444;2287;3431;17538;3037;3681;0;978
FR;6;2023-04-01;5;11;0;0;11;1;0;0;3;19201;14455;2287;3431;17549;3038;3681;0;981
FR;6;2023-04-02;0;0;0;0;0;0;0;0;0;19201;14455;2287;3431;17549;3038;3681;0;981
FR;6;2023-04-03;5;10;0;1;10;2;1;0;2;19206;14465;2287;3432;17559;3040;3682;0;983
FR;6;2023-04-04;5;10;2;4;8;3;5;0;7;19211;14475;2289;3436;17567;3043;3687;0;990
FR;6;2023-04-05;0;7;3;0;7;3;0;0;3;19211;14482;2292;3436;17574;3046;3687;0;993
FR;6;2023-04-06;3;6;4;1;3;7;1;0;2;19214;14488;2296;3437;17577;3053;3688;0;995
FR;6;2023-04-07;11;8;2;0;9;4;0;0;0;19225;14496;2298;3437;17586;3057;3688;0;995
FR;6;2023-04-08;2;1;3;0;1;3;0;0;0;19227;14497;2301;3437;17587;3060;3688;0;995
FR;6;2023-04-09;0;0;0;0;0;0;0;0;0;19227;14497;2301;3437;17587;3060;3688;0;995
FR;6;2023-04-10;0;0;0;0;0;0;0;0;0;19227;14497;2301;3437;17587;3060;3688;0;995
FR;6;2023-04-11;3;8;1;0;6;3;0;0;0;19230;14505;2302;3437;17593;3063;3688;0;995
FR;6;2023-04-12;3;4;2;0;5;2;0;0;4;19233;14509;2304;3437;17598;3065;3688;0;999
FR;6;2023-04-13;1;4;0;0;3;1;0;0;2;19234;14513;2304;3437;17601;3066;3688;0;1001
FR;6;2023-04-14;4;5;0;0;5;0;0;0;1;19238;14518;2304;3437;17606;3066;3688;0;1002
FR;6;2023-04-15;7;2;1;1;4;1;1;0;0;19245;14520;2305;3438;17610;3067;3689;0;1002
FR;6;2023-04-16;0;2;0;0;1;1;0;0;0;19245;14522;2305;3438;17611;3068;3689;0;1002
FR;6;2023-04-17;4;8;2;0;8;2;0;0;0;19249;14530;2307;3438;17619;3070;3689;0;1002
FR;6;2023-04-18;3;2;1;0;2;1;0;0;1;19252;14532;2308;3438;17621;3071;3689;0;1003
FR;6;2023-04-19;1;3;0;0;2;1;0;0;0;19253;14535;2308;3438;17623;3072;3689;0;1003
FR;6;2023-04-20;5;4;0;0;3;2;0;0;0;19258;14539;2308;3438;17626;3074;3689;0;1003
FR;6;2023-04-21;7;3;2;3;1;5;3;0;1;19265;14542;2310;3441;17627;3079;3692;0;1004
FR;6;2023-04-22;3;3;3;0;1;5;0;0;0;19268;14545;2313;3441;17628;3084;3692;0;1004
FR;6;2023-04-23;0;2;0;0;1;1;0;0;0;19268;14547;2313;3441;17629;3085;3692;0;1004
FR;6;2023-04-24;2;8;0;1;5;3;1;0;0;19270;14555;2313;3442;17634;3088;3693;0;1004
FR;6;2023-04-25;5;2;0;1;2;0;1;0;1;19275;14557;2313;3443;17636;3088;3694;0;1005
FR;6;2023-04-26;7;5;1;0;4;2;0;0;2;19282;14562;2314;3443;17640;3090;3694;0;1007
FR;6;2023-04-27;8;9;2;0;9;3;1;0;3;19290;14571;2316;3443;17649;3093;3695;0;1010
FR;6;2023-04-28;5;4;0;1;4;0;1;0;2;19295;14575;2316;3444;17653;3093;3696;0;1012
FR;6;2023-04-29;7;3;2;0;4;2;1;0;0;19302;14578;2318;3444;17657;3095;3697;0;1012
FR;6;2023-04-30;0;0;0;0;0;0;0;0;0;19302;14578;2318;3444;17657;3095;3697;0;1012
FR;6;2023-05-01;0;0;0;0;0;0;0;0;0;19302;14578;2318;3444;17657;3095;3697;0;1012
FR;6;2023-05-02;3;4;3;0;3;3;1;0;0;19305;14582;2321;3444;17660;3098;3698;0;1012
FR;6;2023-05-03;1;3;0;0;2;1;0;0;2;19306;14585;2321;3444;17662;3099;3698;0;1014
FR;6;2023-05-04;3;4;7;0;5;6;3;0;1;19309;14589;2328;3444;17667;3105;3701;0;1015
FR;6;2023-05-05;3;2;0;0;3;0;0;0;0;19312;14591;2328;3444;17670;3105;3701;0;1015
FR;6;2023-05-06;0;2;1;1;1;2;1;0;0;19312;14593;2329;3445;17671;3107;3702;0;1015
FR;6;2023-05-07;1;0;0;0;0;0;0;0;0;19313;14593;2329;3445;17671;3107;3702;0;1015
FR;6;2023-05-08;0;0;7;0;0;3;4;0;0;19313;14593;2336;3445;17671;3110;3706;0;1015
FR;6;2023-05-09;5;4;2;1;6;2;1;0;0;19318;14597;2338;3446;17677;3112;3707;0;1015
FR;6;2023-05-10;5;2;2;0;3;1;1;0;0;19323;14599;2340;3446;17680;3113;3708;0;1015
FR;6;2023-05-11;2;3;3;1;3;4;2;0;2;19325;14602;2343;3447;17683;3117;3710;0;1017
FR;6;2023-05-12;1;2;0;0;3;0;0;0;1;19326;14604;2343;3447;17686;3117;3710;0;1018
FR;6;2023-05-13;0;3;2;0;1;2;2;0;2;19326;14607;2345;3447;17687;3119;3712;0;1020
FR;6;2023-05-14;0;0;0;0;0;0;0;0;0;19326;14607;2345;3447;17687;3119;3712;0;1020
FR;6;2023-05-15;2;3;2;0;2;3;0;0;0;19328;14610;2347;3447;17689;3122;3712;0;1020
FR;6;2023-05-16;2;5;1;0;5;1;0;0;1;19330;14615;2348;3447;17694;3123;3712;0;1021
FR;6;2023-05-17;7;5;2;0;5;2;1;0;2;19337;14620;2350;3447;17699;3125;3713;0;1023
FR;6;2023-05-18;0;0;0;0;0;0;0;0;0;19337;14620;2350;3447;17699;3125;3713;0;1023
FR;6;2023-05-19;2;2;1;0;2;1;0;0;0;19339;14622;2351;3447;17701;3126;3713;0;1023
FR;6;2023-05-20;1;4;1;0;3;2;0;0;0;19340;14626;2352;3447;17704;3128;3713;0;1023
FR;6;2023-05-21;0;0;0;0;0;0;0;0;0;19340;14626;2352;3447;17704;3128;3713;0;1023
FR;6;2023-05-22;2;1;1;0;1;0;1;0;0;19342;14627;2353;3447;17705;3128;3714;0;1023
FR;6;2023-05-23;1;2;2;2;2;1;3;0;0;19343;14629;2355;3449;17707;3129;3717;0;1023
FR;6;2023-05-24;1;2;3;2;2;2;3;0;1;19344;14631;2358;3451;17709;3131;3720;0;1024
FR;6;2023-05-25;1;3;0;1;1;2;0;0;4;19345;14634;2358;3452;17710;3133;3720;0;1028
FR;6;2023-05-26;3;2;0;4;3;0;4;0;3;19348;14636;2358;3456;17713;3133;3724;0;1031
FR;6;2023-05-27;2;3;0;0;3;0;0;0;1;19350;14639;2358;3456;17716;3133;3724;0;1032
FR;6;2023-05-28;0;1;0;0;1;0;0;0;0;19350;14640;2358;3456;17717;3133;3724;0;1032
FR;6;2023-05-29;0;0;0;0;0;0;0;0;0;19350;14640;2358;3456;17717;3133;3724;0;1032
FR;6;2023-05-30;4;5;3;1;2;5;2;0;0;19354;14645;2361;3457;17719;3138;3726;0;1032
FR;6;2023-05-31;2;4;0;0;3;1;0;0;2;19356;14649;2361;3457;17722;3139;3726;0;1034
FR;6;2023-06-01;0;1;4;0;1;4;0;0;2;19356;14650;2365;3457;17723;3143;3726;0;1036
FR;6;2023-06-02;0;3;1;0;3;1;0;0;0;19356;14653;2366;3457;17726;3144;3726;0;1036
FR;6;2023-06-03;0;1;0;0;1;0;0;0;0;19356;14654;2366;3457;17727;3144;3726;0;1036
FR;6;2023-06-04;0;0;0;0;0;0;0;0;0;19356;14654;2366;3457;17727;3144;3726;0;1036
FR;6;2023-06-05;4;1;2;0;2;2;0;0;2;19360;14655;2368;3457;17729;3146;3726;0;1038
FR;6;2023-06-06;2;2;2;0;2;2;0;0;1;19362;14657;2370;3457;17731;3148;3726;0;1039
FR;6;2023-06-07;0;2;0;0;2;0;0;0;0;19362;14659;2370;3457;17733;3148;3726;0;1039
FR;6;2023-06-08;0;2;0;0;2;0;0;0;0;19362;14661;2370;3457;17735;3148;3726;0;1039
FR;6;2023-06-09;1;2;0;3;2;0;3;0;2;19363;14663;2370;3460;17737;3148;3729;0;1041
FR;6;2023-06-10;1;1;2;1;2;0;4;0;0;19364;14664;2372;3461;17739;3148;3733;0;1041
FR;6;2023-06-11;0;0;0;0;0;0;0;0;0;19364;14664;2372;3461;17739;3148;3733;0;1041
FR;6;2023-06-12;0;1;1;0;1;0;1;0;0;19364;14665;2373;3461;17740;3148;3734;0;1041
FR;8;2020-12-27;0;0;0;0;0;0;0;0;0;0;0;0;0;0;0;0;0;0
FR;8;2020-12-28;0;0;0;0;0;0;0;0;0;0;0;0;0;0;0;0;0;0
FR;8;2020-12-29;0;0;0;0;0;0;0;0;0;0;0;0;0;0;0;0;0;0
FR;8;2020-12-30;0;0;0;0;0;0;0;0;0;0;0;0;0;0;0;0;0;0
FR;8;2020-12-31;0;0;0;0;0;0;0;0;0;0;0;0;0;0;0;0;0;0
FR;8;2021-01-01;0;0;0;0;0;0;0;0;0;0;0;0;0;0;0;0;0;0
FR;8;2021-01-02;0;0;0;0;0;0;0;0;0;0;0;0;0;0;0;0;0;0
FR;8;2021-01-03;0;0;0;0;0;0;0;0;0;0;0;0;0;0;0;0;0;0
FR;8;2021-01-04;0;0;0;0;0;0;0;0;0;0;0;0;0;0;0;0;0;0
FR;8;2021-01-05;0;0;0;0;0;0;0;0;0;0;0;0;0;0;0;0;0;0
FR;8;2021-01-06;0;0;0;0;0;0;0;0;0;0;0;0;0;0;0;0;0;0
FR;8;2021-01-07;0;0;0;0;0;0;0;0;0;0;0;0;0;0;0;0;0;0
FR;8;2021-01-08;0;0;0;0;0;0;0;0;0;0;0;0;0;0;0;0;0;0
FR;8;2021-01-09;0;0;0;0;0;0;0;0;0;0;0;0;0;0;0;0;0;0
FR;8;2021-01-10;0;0;0;0;0;0;0;0;0;0;0;0;0;0;0;0;0;0
FR;8;2021-01-11;0;0;0;0;0;0;0;0;0;0;0;0;0;0;0;0;0;0
FR;8;2021-01-12;0;0;0;0;0;0;0;0;0;0;0;0;0;0;0;0;0;0
FR;8;2021-01-13;0;0;0;0;0;0;0;0;0;0;0;0;0;0;0;0;0;0
FR;8;2021-01-14;0;0;0;0;0;0;0;0;0;0;0;0;0;0;0;0;0;0
FR;8;2021-01-15;0;0;0;0;0;0;0;0;0;0;0;0;0;0;0;0;0;0
FR;8;2021-01-16;0;0;0;0;0;0;0;0;0;0;0;0;0;0;0;0;0;0
FR;8;2021-01-17;0;0;0;0;0;0;0;0;0;0;0;0;0;0;0;0;0;0
FR;8;2021-01-18;0;0;0;0;0;0;0;0;0;0;0;0;0;0;0;0;0;0
FR;8;2021-01-19;0;0;0;0;0;0;0;0;0;0;0;0;0;0;0;0;0;0
FR;8;2021-01-20;0;0;0;0;0;0;0;0;0;0;0;0;0;0;0;0;0;0
FR;8;2021-01-21;0;0;0;0;0;0;0;0;0;0;0;0;0;0;0;0;0;0
FR;8;2021-01-22;0;0;0;0;0;0;0;0;0;0;0;0;0;0;0;0;0;0
FR;8;2021-01-23;0;0;0;0;0;0;0;0;0;0;0;0;0;0;0;0;0;0
FR;8;2021-01-24;0;0;0;0;0;0;0;0;0;0;0;0;0;0;0;0;0;0
FR;8;2021-01-25;0;0;0;0;0;0;0;0;0;0;0;0;0;0;0;0;0;0
FR;8;2021-01-26;0;0;0;0;0;0;0;0;0;0;0;0;0;0;0;0;0;0
FR;8;2021-01-27;0;0;0;0;0;0;0;0;0;0;0;0;0;0;0;0;0;0
FR;8;2021-01-28;0;0;0;0;0;0;0;0;0;0;0;0;0;0;0;0;0;0
FR;8;2021-01-29;0;0;0;0;0;0;0;0;0;0;0;0;0;0;0;0;0;0
FR;8;2021-01-30;0;0;0;0;0;0;0;0;0;0;0;0;0;0;0;0;0;0
FR;8;2021-01-31;0;0;0;0;0;0;0;0;0;0;0;0;0;0;0;0;0;0
FR;8;2021-02-01;0;0;0;0;0;0;0;0;0;0;0;0;0;0;0;0;0;0
FR;8;2021-02-02;0;0;0;0;0;0;0;0;0;0;0;0;0;0;0;0;0;0
FR;8;2021-02-03;0;0;0;0;0;0;0;0;0;0;0;0;0;0;0;0;0;0
FR;8;2021-02-04;0;0;0;0;0;0;0;0;0;0;0;0;0;0;0;0;0;0
FR;8;2021-02-05;0;0;0;0;0;0;0;0;0;0;0;0;0;0;0;0;0;0
FR;8;2021-02-06;0;0;0;0;0;0;0;0;0;0;0;0;0;0;0;0;0;0
FR;8;2021-02-07;0;0;0;0;0;0;0;0;0;0;0;0;0;0;0;0;0;0
FR;8;2021-02-08;0;0;0;0;0;0;0;0;0;0;0;0;0;0;0;0;0;0
FR;8;2021-02-09;0;0;0;0;0;0;0;0;0;0;0;0;0;0;0;0;0;0
FR;8;2021-02-10;0;0;0;0;0;0;0;0;0;0;0;0;0;0;0;0;0;0
FR;8;2021-02-11;0;0;0;0;0;0;0;0;0;0;0;0;0;0;0;0;0;0
FR;8;2021-02-12;0;0;0;0;0;0;0;0;0;0;0;0;0;0;0;0;0;0
FR;8;2021-02-13;0;0;0;0;0;0;0;0;0;0;0;0;0;0;0;0;0;0
FR;8;2021-02-14;0;0;0;0;0;0;0;0;0;0;0;0;0;0;0;0;0;0
FR;8;2021-02-15;0;0;0;0;0;0;0;0;0;0;0;0;0;0;0;0;0;0
FR;8;2021-02-16;0;0;0;0;0;0;0;0;0;0;0;0;0;0;0;0;0;0
FR;8;2021-02-17;0;0;0;0;0;0;0;0;0;0;0;0;0;0;0;0;0;0
FR;8;2021-02-18;0;0;0;0;0;0;0;0;0;0;0;0;0;0;0;0;0;0
FR;8;2021-02-19;0;0;0;0;0;0;0;0;0;0;0;0;0;0;0;0;0;0
FR;8;2021-02-20;0;0;0;0;0;0;0;0;0;0;0;0;0;0;0;0;0;0
FR;8;2021-02-21;0;0;0;0;0;0;0;0;0;0;0;0;0;0;0;0;0;0
FR;8;2021-02-22;0;0;0;0;0;0;0;0;0;0;0;0;0;0;0;0;0;0
FR;8;2021-02-23;0;0;0;0;0;0;0;0;0;0;0;0;0;0;0;0;0;0
FR;8;2021-02-24;0;0;0;0;0;0;0;0;0;0;0;0;0;0;0;0;0;0
FR;8;2021-02-25;0;0;0;0;0;0;0;0;0;0;0;0;0;0;0;0;0;0
FR;8;2021-02-26;0;0;0;0;0;0;0;0;0;0;0;0;0;0;0;0;0;0
FR;8;2021-02-27;0;0;0;0;0;0;0;0;0;0;0;0;0;0;0;0;0;0
FR;8;2021-02-28;0;0;0;0;0;0;0;0;0;0;0;0;0;0;0;0;0;0
FR;8;2021-03-01;0;0;0;0;0;0;0;0;0;0;0;0;0;0;0;0;0;0
FR;8;2021-03-02;0;0;0;0;0;0;0;0;0;0;0;0;0;0;0;0;0;0
FR;8;2021-03-03;0;0;0;0;0;0;0;0;0;0;0;0;0;0;0;0;0;0
FR;8;2021-03-04;0;0;0;0;0;0;0;0;0;0;0;0;0;0;0;0;0;0
FR;8;2021-03-05;0;0;0;0;0;0;0;0;0;0;0;0;0;0;0;0;0;0
FR;8;2021-03-06;0;0;0;0;0;0;0;0;0;0;0;0;0;0;0;0;0;0
FR;8;2021-03-07;0;0;0;0;0;0;0;0;0;0;0;0;0;0;0;0;0;0
FR;8;2021-03-08;0;0;0;0;0;0;0;0;0;0;0;0;0;0;0;0;0;0
FR;8;2021-03-09;0;0;0;0;0;0;0;0;0;0;0;0;0;0;0;0;0;0
FR;8;2021-03-10;0;0;0;0;0;0;0;0;0;0;0;0;0;0;0;0;0;0
FR;8;2021-03-11;0;0;0;0;0;0;0;0;0;0;0;0;0;0;0;0;0;0
FR;8;2021-03-12;0;0;0;0;0;0;0;0;0;0;0;0;0;0;0;0;0;0
FR;8;2021-03-13;0;0;0;0;0;0;0;0;0;0;0;0;0;0;0;0;0;0
FR;8;2021-03-14;0;0;0;0;0;0;0;0;0;0;0;0;0;0;0;0;0;0
FR;8;2021-03-15;0;0;0;0;0;0;0;0;0;0;0;0;0;0;0;0;0;0
FR;8;2021-03-16;0;0;0;0;0;0;0;0;0;0;0;0;0;0;0;0;0;0
FR;8;2021-03-17;0;0;0;0;0;0;0;0;0;0;0;0;0;0;0;0;0;0
FR;8;2021-03-18;0;0;0;0;0;0;0;0;0;0;0;0;0;0;0;0;0;0
FR;8;2021-03-19;0;0;0;0;0;0;0;0;0;0;0;0;0;0;0;0;0;0
FR;8;2021-03-20;0;0;0;0;0;0;0;0;0;0;0;0;0;0;0;0;0;0
FR;8;2021-03-21;0;0;0;0;0;0;0;0;0;0;0;0;0;0;0;0;0;0
FR;8;2021-03-22;0;0;0;0;0;0;0;0;0;0;0;0;0;0;0;0;0;0
FR;8;2021-03-23;0;0;0;0;0;0;0;0;0;0;0;0;0;0;0;0;0;0
FR;8;2021-03-24;0;0;0;0;0;0;0;0;0;0;0;0;0;0;0;0;0;0
FR;8;2021-03-25;0;0;0;0;0;0;0;0;0;0;0;0;0;0;0;0;0;0
FR;8;2021-03-26;0;0;0;0;0;0;0;0;0;0;0;0;0;0;0;0;0;0
FR;8;2021-03-27;0;0;0;0;0;0;0;0;0;0;0;0;0;0;0;0;0;0
FR;8;2021-03-28;0;0;0;0;0;0;0;0;0;0;0;0;0;0;0;0;0;0
FR;8;2021-03-29;0;0;0;0;0;0;0;0;0;0;0;0;0;0;0;0;0;0
FR;8;2021-03-30;0;0;0;0;0;0;0;0;0;0;0;0;0;0;0;0;0;0
FR;8;2021-03-31;0;0;0;0;0;0;0;0;0;0;0;0;0;0;0;0;0;0
FR;8;2021-04-01;0;0;0;0;0;0;0;0;0;0;0;0;0;0;0;0;0;0
FR;8;2021-04-02;0;0;0;0;0;0;0;0;0;0;0;0;0;0;0;0;0;0
FR;8;2021-04-03;0;0;0;0;0;0;0;0;0;0;0;0;0;0;0;0;0;0
FR;8;2021-04-04;0;0;0;0;0;0;0;0;0;0;0;0;0;0;0;0;0;0
FR;8;2021-04-05;0;0;0;0;0;0;0;0;0;0;0;0;0;0;0;0;0;0
FR;8;2021-04-06;0;0;0;0;0;0;0;0;0;0;0;0;0;0;0;0;0;0
FR;8;2021-04-07;0;0;0;0;0;0;0;0;0;0;0;0;0;0;0;0;0;0
FR;8;2021-04-08;0;0;0;0;0;0;0;0;0;0;0;0;0;0;0;0;0;0
FR;8;2021-04-09;0;0;0;0;0;0;0;0;0;0;0;0;0;0;0;0;0;0
FR;8;2021-04-10;0;0;0;0;0;0;0;0;0;0;0;0;0;0;0;0;0;0
FR;8;2021-04-11;0;0;0;0;0;0;0;0;0;0;0;0;0;0;0;0;0;0
FR;8;2021-04-12;0;0;0;0;0;0;0;0;0;0;0;0;0;0;0;0;0;0
FR;8;2021-04-13;0;0;0;0;0;0;0;0;0;0;0;0;0;0;0;0;0;0
FR;8;2021-04-14;0;0;0;0;0;0;0;0;0;0;0;0;0;0;0;0;0;0
FR;8;2021-04-15;0;0;0;0;0;0;0;0;0;0;0;0;0;0;0;0;0;0
FR;8;2021-04-16;0;0;0;0;0;0;0;0;0;0;0;0;0;0;0;0;0;0
FR;8;2021-04-17;0;0;0;0;0;0;0;0;0;0;0;0;0;0;0;0;0;0
FR;8;2021-04-18;0;0;0;0;0;0;0;0;0;0;0;0;0;0;0;0;0;0
FR;8;2021-04-19;0;0;0;0;0;0;0;0;0;0;0;0;0;0;0;0;0;0
FR;8;2021-04-20;0;0;0;0;0;0;0;0;0;0;0;0;0;0;0;0;0;0
FR;8;2021-04-21;0;0;0;0;0;0;0;0;0;0;0;0;0;0;0;0;0;0
FR;8;2021-04-22;0;0;0;0;0;0;0;0;0;0;0;0;0;0;0;0;0;0
FR;8;2021-04-23;0;0;0;0;0;0;0;0;0;0;0;0;0;0;0;0;0;0
FR;8;2021-04-24;0;0;0;0;0;0;0;0;0;0;0;0;0;0;0;0;0;0
FR;8;2021-04-25;0;0;0;0;0;0;0;0;0;0;0;0;0;0;0;0;0;0
FR;8;2021-04-26;0;0;0;0;0;0;0;0;0;0;0;0;0;0;0;0;0;0
FR;8;2021-04-27;0;0;0;0;0;0;0;0;0;0;0;0;0;0;0;0;0;0
FR;8;2021-04-28;0;0;0;0;0;0;0;0;0;0;0;0;0;0;0;0;0;0
FR;8;2021-04-29;0;0;0;0;0;0;0;0;0;0;0;0;0;0;0;0;0;0
FR;8;2021-04-30;0;0;0;0;0;0;0;0;0;0;0;0;0;0;0;0;0;0
FR;8;2021-05-01;0;0;0;0;0;0;0;0;0;0;0;0;0;0;0;0;0;0
FR;8;2021-05-02;0;0;0;0;0;0;0;0;0;0;0;0;0;0;0;0;0;0
FR;8;2021-05-03;0;0;0;0;0;0;0;0;0;0;0;0;0;0;0;0;0;0
FR;8;2021-05-04;0;0;0;0;0;0;0;0;0;0;0;0;0;0;0;0;0;0
FR;8;2021-05-05;0;0;0;0;0;0;0;0;0;0;0;0;0;0;0;0;0;0
FR;8;2021-05-06;0;0;0;0;0;0;0;0;0;0;0;0;0;0;0;0;0;0
FR;8;2021-05-07;0;0;0;0;0;0;0;0;0;0;0;0;0;0;0;0;0;0
FR;8;2021-05-08;0;0;0;0;0;0;0;0;0;0;0;0;0;0;0;0;0;0
FR;8;2021-05-09;0;0;0;0;0;0;0;0;0;0;0;0;0;0;0;0;0;0
FR;8;2021-05-10;0;0;0;0;0;0;0;0;0;0;0;0;0;0;0;0;0;0
FR;8;2021-05-11;0;0;0;0;0;0;0;0;0;0;0;0;0;0;0;0;0;0
FR;8;2021-05-12;0;0;0;0;0;0;0;0;0;0;0;0;0;0;0;0;0;0
FR;8;2021-05-13;0;0;0;0;0;0;0;0;0;0;0;0;0;0;0;0;0;0
FR;8;2021-05-14;0;0;0;0;0;0;0;0;0;0;0;0;0;0;0;0;0;0
FR;8;2021-05-15;0;0;0;0;0;0;0;0;0;0;0;0;0;0;0;0;0;0
FR;8;2021-05-16;0;0;0;0;0;0;0;0;0;0;0;0;0;0;0;0;0;0
FR;8;2021-05-17;0;0;0;0;0;0;0;0;0;0;0;0;0;0;0;0;0;0
FR;8;2021-05-18;0;0;0;0;0;0;0;0;0;0;0;0;0;0;0;0;0;0
FR;8;2021-05-19;0;0;0;0;0;0;0;0;0;0;0;0;0;0;0;0;0;0
FR;8;2021-05-20;0;0;0;0;0;0;0;0;0;0;0;0;0;0;0;0;0;0
FR;8;2021-05-21;0;0;0;0;0;0;0;0;0;0;0;0;0;0;0;0;0;0
FR;8;2021-05-22;0;0;0;0;0;0;0;0;0;0;0;0;0;0;0;0;0;0
FR;8;2021-05-23;0;0;0;0;0;0;0;0;0;0;0;0;0;0;0;0;0;0
FR;8;2021-05-24;0;0;0;0;0;0;0;0;0;0;0;0;0;0;0;0;0;0
FR;8;2021-05-25;0;0;0;0;0;0;0;0;0;0;0;0;0;0;0;0;0;0
FR;8;2021-05-26;0;0;0;0;0;0;0;0;0;0;0;0;0;0;0;0;0;0
FR;8;2021-05-27;0;0;0;0;0;0;0;0;0;0;0;0;0;0;0;0;0;0
FR;8;2021-05-28;0;0;0;0;0;0;0;0;0;0;0;0;0;0;0;0;0;0
FR;8;2021-05-29;0;0;0;0;0;0;0;0;0;0;0;0;0;0;0;0;0;0
FR;8;2021-05-30;0;0;0;0;0;0;0;0;0;0;0;0;0;0;0;0;0;0
FR;8;2021-05-31;0;0;0;0;0;0;0;0;0;0;0;0;0;0;0;0;0;0
FR;8;2021-06-01;0;0;0;0;0;0;0;0;0;0;0;0;0;0;0;0;0;0
FR;8;2021-06-02;0;0;0;0;0;0;0;0;0;0;0;0;0;0;0;0;0;0
FR;8;2021-06-03;0;0;0;0;0;0;0;0;0;0;0;0;0;0;0;0;0;0
FR;8;2021-06-04;0;0;0;0;0;0;0;0;0;0;0;0;0;0;0;0;0;0
FR;8;2021-06-05;0;0;0;0;0;0;0;0;0;0;0;0;0;0;0;0;0;0
FR;8;2021-06-06;0;0;0;0;0;0;0;0;0;0;0;0;0;0;0;0;0;0
FR;8;2021-06-07;0;0;0;0;0;0;0;0;0;0;0;0;0;0;0;0;0;0
FR;8;2021-06-08;0;0;0;0;0;0;0;0;0;0;0;0;0;0;0;0;0;0
FR;8;2021-06-09;0;0;0;0;0;0;0;0;0;0;0;0;0;0;0;0;0;0
FR;8;2021-06-10;0;0;0;0;0;0;0;0;0;0;0;0;0;0;0;0;0;0
FR;8;2021-06-11;0;0;0;0;0;0;0;0;0;0;0;0;0;0;0;0;0;0
FR;8;2021-06-12;0;0;0;0;0;0;0;0;0;0;0;0;0;0;0;0;0;0
FR;8;2021-06-13;0;0;0;0;0;0;0;0;0;0;0;0;0;0;0;0;0;0
FR;8;2021-06-14;0;0;0;0;0;0;0;0;0;0;0;0;0;0;0;0;0;0
FR;8;2021-06-15;0;0;0;0;0;0;0;0;0;0;0;0;0;0;0;0;0;0
FR;8;2021-06-16;0;0;0;0;0;0;0;0;0;0;0;0;0;0;0;0;0;0
FR;8;2021-06-17;0;0;0;0;0;0;0;0;0;0;0;0;0;0;0;0;0;0
FR;8;2021-06-18;0;0;0;0;0;0;0;0;0;0;0;0;0;0;0;0;0;0
FR;8;2021-06-19;0;0;0;0;0;0;0;0;0;0;0;0;0;0;0;0;0;0
FR;8;2021-06-20;0;0;0;0;0;0;0;0;0;0;0;0;0;0;0;0;0;0
FR;8;2021-06-21;0;0;0;0;0;0;0;0;0;0;0;0;0;0;0;0;0;0
FR;8;2021-06-22;0;0;0;0;0;0;0;0;0;0;0;0;0;0;0;0;0;0
FR;8;2021-06-23;0;0;0;0;0;0;0;0;0;0;0;0;0;0;0;0;0;0
FR;8;2021-06-24;0;0;0;0;0;0;0;0;0;0;0;0;0;0;0;0;0;0
FR;8;2021-06-25;0;0;0;0;0;0;0;0;0;0;0;0;0;0;0;0;0;0
FR;8;2021-06-26;0;0;0;0;0;0;0;0;0;0;0;0;0;0;0;0;0;0
FR;8;2021-06-27;0;0;0;0;0;0;0;0;0;0;0;0;0;0;0;0;0;0
FR;8;2021-06-28;0;0;0;0;0;0;0;0;0;0;0;0;0;0;0;0;0;0
FR;8;2021-06-29;0;0;0;0;0;0;0;0;0;0;0;0;0;0;0;0;0;0
FR;8;2021-06-30;0;0;0;0;0;0;0;0;0;0;0;0;0;0;0;0;0;0
FR;8;2021-07-01;0;0;0;0;0;0;0;0;0;0;0;0;0;0;0;0;0;0
FR;8;2021-07-02;0;0;0;0;0;0;0;0;0;0;0;0;0;0;0;0;0;0
FR;8;2021-07-03;0;0;0;0;0;0;0;0;0;0;0;0;0;0;0;0;0;0
FR;8;2021-07-04;0;0;0;0;0;0;0;0;0;0;0;0;0;0;0;0;0;0
FR;8;2021-07-05;0;0;0;0;0;0;0;0;0;0;0;0;0;0;0;0;0;0
FR;8;2021-07-06;0;0;0;0;0;0;0;0;0;0;0;0;0;0;0;0;0;0
FR;8;2021-07-07;0;0;0;0;0;0;0;0;0;0;0;0;0;0;0;0;0;0
FR;8;2021-07-08;0;0;0;0;0;0;0;0;0;0;0;0;0;0;0;0;0;0
FR;8;2021-07-09;0;0;0;0;0;0;0;0;0;0;0;0;0;0;0;0;0;0
FR;8;2021-07-10;0;0;0;0;0;0;0;0;0;0;0;0;0;0;0;0;0;0
FR;8;2021-07-11;0;0;0;0;0;0;0;0;0;0;0;0;0;0;0;0;0;0
FR;8;2021-07-12;0;0;0;0;0;0;0;0;0;0;0;0;0;0;0;0;0;0
FR;8;2021-07-13;0;0;0;0;0;0;0;0;0;0;0;0;0;0;0;0;0;0
FR;8;2021-07-14;0;0;0;0;0;0;0;0;0;0;0;0;0;0;0;0;0;0
FR;8;2021-07-15;0;0;0;0;0;0;0;0;0;0;0;0;0;0;0;0;0;0
FR;8;2021-07-16;0;0;0;0;0;0;0;0;0;0;0;0;0;0;0;0;0;0
FR;8;2021-07-17;0;0;0;0;0;0;0;0;0;0;0;0;0;0;0;0;0;0
FR;8;2021-07-18;0;0;0;0;0;0;0;0;0;0;0;0;0;0;0;0;0;0
FR;8;2021-07-19;0;0;0;0;0;0;0;0;0;0;0;0;0;0;0;0;0;0
FR;8;2021-07-20;0;0;0;0;0;0;0;0;0;0;0;0;0;0;0;0;0;0
FR;8;2021-07-21;0;0;0;0;0;0;0;0;0;0;0;0;0;0;0;0;0;0
FR;8;2021-07-22;0;0;0;0;0;0;0;0;0;0;0;0;0;0;0;0;0;0
FR;8;2021-07-23;0;0;0;0;0;0;0;0;0;0;0;0;0;0;0;0;0;0
FR;8;2021-07-24;0;0;0;0;0;0;0;0;0;0;0;0;0;0;0;0;0;0
FR;8;2021-07-25;0;0;0;0;0;0;0;0;0;0;0;0;0;0;0;0;0;0
FR;8;2021-07-26;0;0;0;0;0;0;0;0;0;0;0;0;0;0;0;0;0;0
FR;8;2021-07-27;0;0;0;0;0;0;0;0;0;0;0;0;0;0;0;0;0;0
FR;8;2021-07-28;0;0;0;0;0;0;0;0;0;0;0;0;0;0;0;0;0;0
FR;8;2021-07-29;0;0;0;0;0;0;0;0;0;0;0;0;0;0;0;0;0;0
FR;8;2021-07-30;0;0;0;0;0;0;0;0;0;0;0;0;0;0;0;0;0;0
FR;8;2021-07-31;0;0;0;0;0;0;0;0;0;0;0;0;0;0;0;0;0;0
FR;8;2021-08-01;0;0;0;0;0;0;0;0;0;0;0;0;0;0;0;0;0;0
FR;8;2021-08-02;0;0;0;0;0;0;0;0;0;0;0;0;0;0;0;0;0;0
FR;8;2021-08-03;0;0;0;0;0;0;0;0;0;0;0;0;0;0;0;0;0;0
FR;8;2021-08-04;0;0;0;0;0;0;0;0;0;0;0;0;0;0;0;0;0;0
FR;8;2021-08-05;0;0;0;0;0;0;0;0;0;0;0;0;0;0;0;0;0;0
FR;8;2021-08-06;0;0;0;0;0;0;0;0;0;0;0;0;0;0;0;0;0;0
FR;8;2021-08-07;0;0;0;0;0;0;0;0;0;0;0;0;0;0;0;0;0;0
FR;8;2021-08-08;0;0;0;0;0;0;0;0;0;0;0;0;0;0;0;0;0;0
FR;8;2021-08-09;0;0;0;0;0;0;0;0;0;0;0;0;0;0;0;0;0;0
FR;8;2021-08-10;0;0;0;0;0;0;0;0;0;0;0;0;0;0;0;0;0;0
FR;8;2021-08-11;0;0;0;0;0;0;0;0;0;0;0;0;0;0;0;0;0;0
FR;8;2021-08-12;0;0;0;0;0;0;0;0;0;0;0;0;0;0;0;0;0;0
FR;8;2021-08-13;0;0;0;0;0;0;0;0;0;0;0;0;0;0;0;0;0;0
FR;8;2021-08-14;0;0;0;0;0;0;0;0;0;0;0;0;0;0;0;0;0;0
FR;8;2021-08-15;0;0;0;0;0;0;0;0;0;0;0;0;0;0;0;0;0;0
FR;8;2021-08-16;0;0;0;0;0;0;0;0;0;0;0;0;0;0;0;0;0;0
FR;8;2021-08-17;0;0;0;0;0;0;0;0;0;0;0;0;0;0;0;0;0;0
FR;8;2021-08-18;0;0;0;0;0;0;0;0;0;0;0;0;0;0;0;0;0;0
FR;8;2021-08-19;0;0;0;0;0;0;0;0;0;0;0;0;0;0;0;0;0;0
FR;8;2021-08-20;0;0;0;0;0;0;0;0;0;0;0;0;0;0;0;0;0;0
FR;8;2021-08-21;0;0;0;0;0;0;0;0;0;0;0;0;0;0;0;0;0;0
FR;8;2021-08-22;0;0;0;0;0;0;0;0;0;0;0;0;0;0;0;0;0;0
FR;8;2021-08-23;0;0;0;0;0;0;0;0;0;0;0;0;0;0;0;0;0;0
FR;8;2021-08-24;0;0;0;0;0;0;0;0;0;0;0;0;0;0;0;0;0;0
FR;8;2021-08-25;0;0;0;0;0;0;0;0;0;0;0;0;0;0;0;0;0;0
FR;8;2021-08-26;0;0;0;0;0;0;0;0;0;0;0;0;0;0;0;0;0;0
FR;8;2021-08-27;0;0;0;0;0;0;0;0;0;0;0;0;0;0;0;0;0;0
FR;8;2021-08-28;0;0;0;0;0;0;0;0;0;0;0;0;0;0;0;0;0;0
FR;8;2021-08-29;0;0;0;0;0;0;0;0;0;0;0;0;0;0;0;0;0;0
FR;8;2021-08-30;0;0;0;0;0;0;0;0;0;0;0;0;0;0;0;0;0;0
FR;8;2021-08-31;0;0;0;0;0;0;0;0;0;0;0;0;0;0;0;0;0;0
FR;8;2021-09-01;0;0;0;0;0;0;0;0;0;0;0;0;0;0;0;0;0;0
FR;8;2021-09-02;0;0;0;0;0;0;0;0;0;0;0;0;0;0;0;0;0;0
FR;8;2021-09-03;0;0;0;0;0;0;0;0;0;0;0;0;0;0;0;0;0;0
FR;8;2021-09-04;0;0;0;0;0;0;0;0;0;0;0;0;0;0;0;0;0;0
FR;8;2021-09-05;0;0;0;0;0;0;0;0;0;0;0;0;0;0;0;0;0;0
FR;8;2021-09-06;0;0;0;0;0;0;0;0;0;0;0;0;0;0;0;0;0;0
FR;8;2021-09-07;0;0;0;0;0;0;0;0;0;0;0;0;0;0;0;0;0;0
FR;8;2021-09-08;0;0;0;0;0;0;0;0;0;0;0;0;0;0;0;0;0;0
FR;8;2021-09-09;0;0;0;0;0;0;0;0;0;0;0;0;0;0;0;0;0;0
FR;8;2021-09-10;0;0;0;0;0;0;0;0;0;0;0;0;0;0;0;0;0;0
FR;8;2021-09-11;0;0;0;0;0;0;0;0;0;0;0;0;0;0;0;0;0;0
FR;8;2021-09-12;0;0;0;0;0;0;0;0;0;0;0;0;0;0;0;0;0;0
FR;8;2021-09-13;0;0;0;0;0;0;0;0;0;0;0;0;0;0;0;0;0;0
FR;8;2021-09-14;0;0;0;0;0;0;0;0;0;0;0;0;0;0;0;0;0;0
FR;8;2021-09-15;0;0;0;0;0;0;0;0;0;0;0;0;0;0;0;0;0;0
FR;8;2021-09-16;0;0;0;0;0;0;0;0;0;0;0;0;0;0;0;0;0;0
FR;8;2021-09-17;0;0;0;0;0;0;0;0;0;0;0;0;0;0;0;0;0;0
FR;8;2021-09-18;0;0;0;0;0;0;0;0;0;0;0;0;0;0;0;0;0;0
FR;8;2021-09-19;0;0;0;0;0;0;0;0;0;0;0;0;0;0;0;0;0;0
FR;8;2021-09-20;0;0;0;0;0;0;0;0;0;0;0;0;0;0;0;0;0;0
FR;8;2021-09-21;0;0;0;0;0;0;0;0;0;0;0;0;0;0;0;0;0;0
FR;8;2021-09-22;0;0;0;0;0;0;0;0;0;0;0;0;0;0;0;0;0;0
FR;8;2021-09-23;0;0;0;0;0;0;0;0;0;0;0;0;0;0;0;0;0;0
FR;8;2021-09-24;0;0;0;0;0;0;0;0;0;0;0;0;0;0;0;0;0;0
FR;8;2021-09-25;0;0;0;0;0;0;0;0;0;0;0;0;0;0;0;0;0;0
FR;8;2021-09-26;0;0;0;0;0;0;0;0;0;0;0;0;0;0;0;0;0;0
FR;8;2021-09-27;0;0;0;0;0;0;0;0;0;0;0;0;0;0;0;0;0;0
FR;8;2021-09-28;0;0;0;0;0;0;0;0;0;0;0;0;0;0;0;0;0;0
FR;8;2021-09-29;0;0;0;0;0;0;0;0;0;0;0;0;0;0;0;0;0;0
FR;8;2021-09-30;0;0;0;0;0;0;0;0;0;0;0;0;0;0;0;0;0;0
FR;8;2021-10-01;0;0;0;0;0;0;0;0;0;0;0;0;0;0;0;0;0;0
FR;8;2021-10-02;0;0;0;0;0;0;0;0;0;0;0;0;0;0;0;0;0;0
FR;8;2021-10-03;0;0;0;0;0;0;0;0;0;0;0;0;0;0;0;0;0;0
FR;8;2021-10-04;0;0;0;0;0;0;0;0;0;0;0;0;0;0;0;0;0;0
FR;8;2021-10-05;0;0;0;0;0;0;0;0;0;0;0;0;0;0;0;0;0;0
FR;8;2021-10-06;0;0;0;0;0;0;0;0;0;0;0;0;0;0;0;0;0;0
FR;8;2021-10-07;0;0;0;0;0;0;0;0;0;0;0;0;0;0;0;0;0;0
FR;8;2021-10-08;0;0;0;0;0;0;0;0;0;0;0;0;0;0;0;0;0;0
FR;8;2021-10-09;0;0;0;0;0;0;0;0;0;0;0;0;0;0;0;0;0;0
FR;8;2021-10-10;0;0;0;0;0;0;0;0;0;0;0;0;0;0;0;0;0;0
FR;8;2021-10-11;0;0;0;0;0;0;0;0;0;0;0;0;0;0;0;0;0;0
FR;8;2021-10-12;0;0;0;0;0;0;0;0;0;0;0;0;0;0;0;0;0;0
FR;8;2021-10-13;0;0;0;0;0;0;0;0;0;0;0;0;0;0;0;0;0;0
FR;8;2021-10-14;0;0;0;0;0;0;0;0;0;0;0;0;0;0;0;0;0;0
FR;8;2021-10-15;0;0;0;0;0;0;0;0;0;0;0;0;0;0;0;0;0;0
FR;8;2021-10-16;0;0;0;0;0;0;0;0;0;0;0;0;0;0;0;0;0;0
FR;8;2021-10-17;0;0;0;0;0;0;0;0;0;0;0;0;0;0;0;0;0;0
FR;8;2021-10-18;0;0;0;0;0;0;0;0;0;0;0;0;0;0;0;0;0;0
FR;8;2021-10-19;0;0;0;0;0;0;0;0;0;0;0;0;0;0;0;0;0;0
FR;8;2021-10-20;0;0;0;0;0;0;0;0;0;0;0;0;0;0;0;0;0;0
FR;8;2021-10-21;0;0;0;0;0;0;0;0;0;0;0;0;0;0;0;0;0;0
FR;8;2021-10-22;0;0;0;0;0;0;0;0;0;0;0;0;0;0;0;0;0;0
FR;8;2021-10-23;0;0;0;0;0;0;0;0;0;0;0;0;0;0;0;0;0;0
FR;8;2021-10-24;0;0;0;0;0;0;0;0;0;0;0;0;0;0;0;0;0;0
FR;8;2021-10-25;0;0;0;0;0;0;0;0;0;0;0;0;0;0;0;0;0;0
FR;8;2021-10-26;0;0;0;0;0;0;0;0;0;0;0;0;0;0;0;0;0;0
FR;8;2021-10-27;0;0;0;0;0;0;0;0;0;0;0;0;0;0;0;0;0;0
FR;8;2021-10-28;0;0;0;0;0;0;0;0;0;0;0;0;0;0;0;0;0;0
FR;8;2021-10-29;0;0;0;0;0;0;0;0;0;0;0;0;0;0;0;0;0;0
FR;8;2021-10-30;0;0;0;0;0;0;0;0;0;0;0;0;0;0;0;0;0;0
FR;8;2021-10-31;0;0;0;0;0;0;0;0;0;0;0;0;0;0;0;0;0;0
FR;8;2021-11-01;0;0;0;0;0;0;0;0;0;0;0;0;0;0;0;0;0;0
FR;8;2021-11-02;0;0;0;0;0;0;0;0;0;0;0;0;0;0;0;0;0;0
FR;8;2021-11-03;0;0;0;0;0;0;0;0;0;0;0;0;0;0;0;0;0;0
FR;8;2021-11-04;0;0;0;0;0;0;0;0;0;0;0;0;0;0;0;0;0;0
FR;8;2021-11-05;0;0;0;0;0;0;0;0;0;0;0;0;0;0;0;0;0;0
FR;8;2021-11-06;0;0;0;0;0;0;0;0;0;0;0;0;0;0;0;0;0;0
FR;8;2021-11-07;0;0;0;0;0;0;0;0;0;0;0;0;0;0;0;0;0;0
FR;8;2021-11-08;0;0;0;0;0;0;0;0;0;0;0;0;0;0;0;0;0;0
FR;8;2021-11-09;0;0;0;0;0;0;0;0;0;0;0;0;0;0;0;0;0;0
FR;8;2021-11-10;0;0;0;0;0;0;0;0;0;0;0;0;0;0;0;0;0;0
FR;8;2021-11-11;0;0;0;0;0;0;0;0;0;0;0;0;0;0;0;0;0;0
FR;8;2021-11-12;0;0;0;0;0;0;0;0;0;0;0;0;0;0;0;0;0;0
FR;8;2021-11-13;0;0;0;0;0;0;0;0;0;0;0;0;0;0;0;0;0;0
FR;8;2021-11-14;0;0;0;0;0;0;0;0;0;0;0;0;0;0;0;0;0;0
FR;8;2021-11-15;0;0;0;0;0;0;0;0;0;0;0;0;0;0;0;0;0;0
FR;8;2021-11-16;0;0;0;0;0;0;0;0;0;0;0;0;0;0;0;0;0;0
FR;8;2021-11-17;0;0;0;0;0;0;0;0;0;0;0;0;0;0;0;0;0;0
FR;8;2021-11-18;0;0;0;0;0;0;0;0;0;0;0;0;0;0;0;0;0;0
FR;8;2021-11-19;0;0;0;0;0;0;0;0;0;0;0;0;0;0;0;0;0;0
FR;8;2021-11-20;0;0;0;0;0;0;0;0;0;0;0;0;0;0;0;0;0;0
FR;8;2021-11-21;0;0;0;0;0;0;0;0;0;0;0;0;0;0;0;0;0;0
FR;8;2021-11-22;0;0;0;0;0;0;0;0;0;0;0;0;0;0;0;0;0;0
FR;8;2021-11-23;0;0;0;0;0;0;0;0;0;0;0;0;0;0;0;0;0;0
FR;8;2021-11-24;0;0;0;0;0;0;0;0;0;0;0;0;0;0;0;0;0;0
FR;8;2021-11-25;0;0;0;0;0;0;0;0;0;0;0;0;0;0;0;0;0;0
FR;8;2021-11-26;0;0;0;0;0;0;0;0;0;0;0;0;0;0;0;0;0;0
FR;8;2021-11-27;0;0;0;0;0;0;0;0;0;0;0;0;0;0;0;0;0;0
FR;8;2021-11-28;0;0;0;0;0;0;0;0;0;0;0;0;0;0;0;0;0;0
FR;8;2021-11-29;0;0;0;0;0;0;0;0;0;0;0;0;0;0;0;0;0;0
FR;8;2021-11-30;0;0;0;0;0;0;0;0;0;0;0;0;0;0;0;0;0;0
FR;8;2021-12-01;0;0;0;0;0;0;0;0;0;0;0;0;0;0;0;0;0;0
FR;8;2021-12-02;0;0;0;0;0;0;0;0;0;0;0;0;0;0;0;0;0;0
FR;8;2021-12-03;0;0;0;0;0;0;0;0;0;0;0;0;0;0;0;0;0;0
FR;8;2021-12-04;0;0;0;0;0;0;0;0;0;0;0;0;0;0;0;0;0;0
FR;8;2021-12-05;0;0;0;0;0;0;0;0;0;0;0;0;0;0;0;0;0;0
FR;8;2021-12-06;0;0;0;0;0;0;0;0;0;0;0;0;0;0;0;0;0;0
FR;8;2021-12-07;0;0;0;0;0;0;0;0;0;0;0;0;0;0;0;0;0;0
FR;8;2021-12-08;0;0;0;0;0;0;0;0;0;0;0;0;0;0;0;0;0;0
FR;8;2021-12-09;0;0;0;0;0;0;0;0;0;0;0;0;0;0;0;0;0;0
FR;8;2021-12-10;0;0;0;0;0;0;0;0;0;0;0;0;0;0;0;0;0;0
FR;8;2021-12-11;0;0;0;0;0;0;0;0;0;0;0;0;0;0;0;0;0;0
FR;8;2021-12-12;0;0;0;0;0;0;0;0;0;0;0;0;0;0;0;0;0;0
FR;8;2021-12-13;0;0;0;0;0;0;0;0;0;0;0;0;0;0;0;0;0;0
FR;8;2021-12-14;0;0;0;0;0;0;0;0;0;0;0;0;0;0;0;0;0;0
FR;8;2021-12-15;0;0;0;0;0;0;0;0;0;0;0;0;0;0;0;0;0;0
FR;8;2021-12-16;0;0;0;0;0;0;0;0;0;0;0;0;0;0;0;0;0;0
FR;8;2021-12-17;0;0;0;0;0;0;0;0;0;0;0;0;0;0;0;0;0;0
FR;8;2021-12-18;0;0;0;0;0;0;0;0;0;0;0;0;0;0;0;0;0;0
FR;8;2021-12-19;0;0;0;0;0;0;0;0;0;0;0;0;0;0;0;0;0;0
FR;8;2021-12-20;0;0;0;0;0;0;0;0;0;0;0;0;0;0;0;0;0;0
FR;8;2021-12-21;0;0;0;0;0;0;0;0;0;0;0;0;0;0;0;0;0;0
FR;8;2021-12-22;0;0;0;0;0;0;0;0;0;0;0;0;0;0;0;0;0;0
FR;8;2021-12-23;0;0;0;0;0;0;0;0;0;0;0;0;0;0;0;0;0;0
FR;8;2021-12-24;0;0;0;0;0;0;0;0;0;0;0;0;0;0;0;0;0;0
FR;8;2021-12-25;0;0;0;0;0;0;0;0;0;0;0;0;0;0;0;0;0;0
FR;8;2021-12-26;0;0;0;0;0;0;0;0;0;0;0;0;0;0;0;0;0;0
FR;8;2021-12-27;0;0;0;0;0;0;0;0;0;0;0;0;0;0;0;0;0;0
FR;8;2021-12-28;0;0;0;0;0;0;0;0;0;0;0;0;0;0;0;0;0;0
FR;8;2021-12-29;0;0;0;0;0;0;0;0;0;0;0;0;0;0;0;0;0;0
FR;8;2021-12-30;0;0;0;0;0;0;0;0;0;0;0;0;0;0;0;0;0;0
FR;8;2021-12-31;0;0;0;0;0;0;0;0;0;0;0;0;0;0;0;0;0;0
FR;8;2022-01-01;0;0;0;0;0;0;0;0;0;0;0;0;0;0;0;0;0;0
FR;8;2022-01-02;0;0;0;0;0;0;0;0;0;0;0;0;0;0;0;0;0;0
FR;8;2022-01-03;0;0;0;0;0;0;0;0;0;0;0;0;0;0;0;0;0;0
FR;8;2022-01-04;0;0;0;0;0;0;0;0;0;0;0;0;0;0;0;0;0;0
FR;8;2022-01-05;0;0;0;0;0;0;0;0;0;0;0;0;0;0;0;0;0;0
FR;8;2022-01-06;0;0;0;0;0;0;0;0;0;0;0;0;0;0;0;0;0;0
FR;8;2022-01-07;0;0;0;0;0;0;0;0;0;0;0;0;0;0;0;0;0;0
FR;8;2022-01-08;0;0;0;0;0;0;0;0;0;0;0;0;0;0;0;0;0;0
FR;8;2022-01-09;0;0;0;0;0;0;0;0;0;0;0;0;0;0;0;0;0;0
FR;8;2022-01-10;0;0;0;0;0;0;0;0;0;0;0;0;0;0;0;0;0;0
FR;8;2022-01-11;0;0;0;0;0;0;0;0;0;0;0;0;0;0;0;0;0;0
FR;8;2022-01-12;0;0;0;0;0;0;0;0;0;0;0;0;0;0;0;0;0;0
FR;8;2022-01-13;0;0;0;0;0;0;0;0;0;0;0;0;0;0;0;0;0;0
FR;8;2022-01-14;0;0;0;0;0;0;0;0;0;0;0;0;0;0;0;0;0;0
FR;8;2022-01-15;0;0;0;0;0;0;0;0;0;0;0;0;0;0;0;0;0;0
FR;8;2022-01-16;0;0;0;0;0;0;0;0;0;0;0;0;0;0;0;0;0;0
FR;8;2022-01-17;0;0;0;0;0;0;0;0;0;0;0;0;0;0;0;0;0;0
FR;8;2022-01-18;0;0;0;0;0;0;0;0;0;0;0;0;0;0;0;0;0;0
FR;8;2022-01-19;0;0;0;0;0;0;0;0;0;0;0;0;0;0;0;0;0;0
FR;8;2022-01-20;0;0;0;0;0;0;0;0;0;0;0;0;0;0;0;0;0;0
FR;8;2022-01-21;0;0;0;0;0;0;0;0;0;0;0;0;0;0;0;0;0;0
FR;8;2022-01-22;0;0;0;0;0;0;0;0;0;0;0;0;0;0;0;0;0;0
FR;8;2022-01-23;0;0;0;0;0;0;0;0;0;0;0;0;0;0;0;0;0;0
FR;8;2022-01-24;0;0;0;0;0;0;0;0;0;0;0;0;0;0;0;0;0;0
FR;8;2022-01-25;0;0;0;0;0;0;0;0;0;0;0;0;0;0;0;0;0;0
FR;8;2022-01-26;0;0;0;0;0;0;0;0;0;0;0;0;0;0;0;0;0;0
FR;8;2022-01-27;0;0;0;0;0;0;0;0;0;0;0;0;0;0;0;0;0;0
FR;8;2022-01-28;0;0;0;0;0;0;0;0;0;0;0;0;0;0;0;0;0;0
FR;8;2022-01-29;0;0;0;0;0;0;0;0;0;0;0;0;0;0;0;0;0;0
FR;8;2022-01-30;0;0;0;0;0;0;0;0;0;0;0;0;0;0;0;0;0;0
FR;8;2022-01-31;0;0;0;0;0;0;0;0;0;0;0;0;0;0;0;0;0;0
FR;8;2022-02-01;0;0;0;0;0;0;0;0;0;0;0;0;0;0;0;0;0;0
FR;8;2022-02-02;0;0;0;0;0;0;0;0;0;0;0;0;0;0;0;0;0;0
FR;8;2022-02-03;0;0;0;0;0;0;0;0;0;0;0;0;0;0;0;0;0;0
FR;8;2022-02-04;0;0;0;0;0;0;0;0;0;0;0;0;0;0;0;0;0;0
FR;8;2022-02-05;0;0;0;0;0;0;0;0;0;0;0;0;0;0;0;0;0;0
FR;8;2022-02-06;0;0;0;0;0;0;0;0;0;0;0;0;0;0;0;0;0;0
FR;8;2022-02-07;0;0;0;0;0;0;0;0;0;0;0;0;0;0;0;0;0;0
FR;8;2022-02-08;0;0;0;0;0;0;0;0;0;0;0;0;0;0;0;0;0;0
FR;8;2022-02-09;0;0;0;0;0;0;0;0;0;0;0;0;0;0;0;0;0;0
FR;8;2022-02-10;0;0;0;0;0;0;0;0;0;0;0;0;0;0;0;0;0;0
FR;8;2022-02-11;0;0;0;0;0;0;0;0;0;0;0;0;0;0;0;0;0;0
FR;8;2022-02-12;0;0;0;0;0;0;0;0;0;0;0;0;0;0;0;0;0;0
FR;8;2022-02-13;0;0;0;0;0;0;0;0;0;0;0;0;0;0;0;0;0;0
FR;8;2022-02-14;0;0;0;0;0;0;0;0;0;0;0;0;0;0;0;0;0;0
FR;8;2022-02-15;0;0;0;0;0;0;0;0;0;0;0;0;0;0;0;0;0;0
FR;8;2022-02-16;0;0;0;0;0;0;0;0;0;0;0;0;0;0;0;0;0;0
FR;8;2022-02-17;0;0;0;0;0;0;0;0;0;0;0;0;0;0;0;0;0;0
FR;8;2022-02-18;0;0;0;0;0;0;0;0;0;0;0;0;0;0;0;0;0;0
FR;8;2022-02-19;0;0;0;0;0;0;0;0;0;0;0;0;0;0;0;0;0;0
FR;8;2022-02-20;0;0;0;0;0;0;0;0;0;0;0;0;0;0;0;0;0;0
FR;8;2022-02-21;0;0;0;0;0;0;0;0;0;0;0;0;0;0;0;0;0;0
FR;8;2022-02-22;0;0;0;0;0;0;0;0;0;0;0;0;0;0;0;0;0;0
FR;8;2022-02-23;0;0;0;0;0;0;0;0;0;0;0;0;0;0;0;0;0;0
FR;8;2022-02-24;0;0;0;0;0;0;0;0;0;0;0;0;0;0;0;0;0;0
FR;8;2022-02-25;0;0;0;0;0;0;0;0;0;0;0;0;0;0;0;0;0;0
FR;8;2022-02-26;0;0;0;0;0;0;0;0;0;0;0;0;0;0;0;0;0;0
FR;8;2022-02-27;0;0;0;0;0;0;0;0;0;0;0;0;0;0;0;0;0;0
FR;8;2022-02-28;0;0;0;0;0;0;0;0;0;0;0;0;0;0;0;0;0;0
FR;8;2022-03-01;0;0;0;0;0;0;0;0;0;0;0;0;0;0;0;0;0;0
FR;8;2022-03-02;0;0;0;0;0;0;0;0;0;0;0;0;0;0;0;0;0;0
FR;8;2022-03-03;0;0;0;0;0;0;0;0;0;0;0;0;0;0;0;0;0;0
FR;8;2022-03-04;0;0;0;0;0;0;0;0;0;0;0;0;0;0;0;0;0;0
FR;8;2022-03-05;0;0;0;0;0;0;0;0;0;0;0;0;0;0;0;0;0;0
FR;8;2022-03-06;0;0;0;0;0;0;0;0;0;0;0;0;0;0;0;0;0;0
FR;8;2022-03-07;0;0;0;0;0;0;0;0;0;0;0;0;0;0;0;0;0;0
FR;8;2022-03-08;0;0;0;0;0;0;0;0;0;0;0;0;0;0;0;0;0;0
FR;8;2022-03-09;0;0;0;0;0;0;0;0;0;0;0;0;0;0;0;0;0;0
FR;8;2022-03-10;0;0;0;0;0;0;0;0;0;0;0;0;0;0;0;0;0;0
FR;8;2022-03-11;0;0;0;0;0;0;0;0;0;0;0;0;0;0;0;0;0;0
FR;8;2022-03-12;0;0;0;0;0;0;0;0;0;0;0;0;0;0;0;0;0;0
FR;8;2022-03-13;0;0;0;0;0;0;0;0;0;0;0;0;0;0;0;0;0;0
FR;8;2022-03-14;0;0;0;0;0;0;0;0;0;0;0;0;0;0;0;0;0;0
FR;8;2022-03-15;0;0;0;0;0;0;0;0;0;0;0;0;0;0;0;0;0;0
FR;8;2022-03-16;0;0;0;0;0;0;0;0;0;0;0;0;0;0;0;0;0;0
FR;8;2022-03-17;0;0;0;0;0;0;0;0;0;0;0;0;0;0;0;0;0;0
FR;8;2022-03-18;0;0;0;0;0;0;0;0;0;0;0;0;0;0;0;0;0;0
FR;8;2022-03-19;0;0;0;0;0;0;0;0;0;0;0;0;0;0;0;0;0;0
FR;8;2022-03-20;0;0;0;0;0;0;0;0;0;0;0;0;0;0;0;0;0;0
FR;8;2022-03-21;0;0;0;0;0;0;0;0;0;0;0;0;0;0;0;0;0;0
FR;8;2022-03-22;0;0;0;0;0;0;0;0;0;0;0;0;0;0;0;0;0;0
FR;8;2022-03-23;0;0;0;0;0;0;0;0;0;0;0;0;0;0;0;0;0;0
FR;8;2022-03-24;0;0;0;0;0;0;0;0;0;0;0;0;0;0;0;0;0;0
FR;8;2022-03-25;0;0;0;0;0;0;0;0;0;0;0;0;0;0;0;0;0;0
FR;8;2022-03-26;0;0;0;0;0;0;0;0;0;0;0;0;0;0;0;0;0;0
FR;8;2022-03-27;0;0;0;0;0;0;0;0;0;0;0;0;0;0;0;0;0;0
FR;8;2022-03-28;0;0;0;0;0;0;0;0;0;0;0;0;0;0;0;0;0;0
FR;8;2022-03-29;0;0;0;0;0;0;0;0;0;0;0;0;0;0;0;0;0;0
FR;8;2022-03-30;0;0;0;0;0;0;0;0;0;0;0;0;0;0;0;0;0;0
FR;8;2022-03-31;0;0;0;0;0;0;0;0;0;0;0;0;0;0;0;0;0;0
FR;8;2022-04-01;0;0;0;0;0;0;0;0;0;0;0;0;0;0;0;0;0;0
FR;8;2022-04-02;0;0;0;0;0;0;0;0;0;0;0;0;0;0;0;0;0;0
FR;8;2022-04-03;0;0;0;0;0;0;0;0;0;0;0;0;0;0;0;0;0;0
FR;8;2022-04-04;0;0;0;0;0;0;0;0;0;0;0;0;0;0;0;0;0;0
FR;8;2022-04-05;0;0;0;0;0;0;0;0;0;0;0;0;0;0;0;0;0;0
FR;8;2022-04-06;0;0;0;0;0;0;0;0;0;0;0;0;0;0;0;0;0;0
FR;8;2022-04-07;0;0;0;0;0;0;0;0;0;0;0;0;0;0;0;0;0;0
FR;8;2022-04-08;0;0;0;0;0;0;0;0;0;0;0;0;0;0;0;0;0;0
FR;8;2022-04-09;0;0;0;0;0;0;0;0;0;0;0;0;0;0;0;0;0;0
FR;8;2022-04-10;0;0;0;0;0;0;0;0;0;0;0;0;0;0;0;0;0;0
FR;8;2022-04-11;0;0;0;0;0;0;0;0;0;0;0;0;0;0;0;0;0;0
FR;8;2022-04-12;0;0;0;0;0;0;0;0;0;0;0;0;0;0;0;0;0;0
FR;8;2022-04-13;0;0;0;0;0;0;0;0;0;0;0;0;0;0;0;0;0;0
FR;8;2022-04-14;0;0;0;0;0;0;0;0;0;0;0;0;0;0;0;0;0;0
FR;8;2022-04-15;0;0;0;0;0;0;0;0;0;0;0;0;0;0;0;0;0;0
FR;8;2022-04-16;0;0;0;0;0;0;0;0;0;0;0;0;0;0;0;0;0;0
FR;8;2022-04-17;0;0;0;0;0;0;0;0;0;0;0;0;0;0;0;0;0;0
FR;8;2022-04-18;0;0;0;0;0;0;0;0;0;0;0;0;0;0;0;0;0;0
FR;8;2022-04-19;0;0;0;0;0;0;0;0;0;0;0;0;0;0;0;0;0;0
FR;8;2022-04-20;0;0;0;0;0;0;0;0;0;0;0;0;0;0;0;0;0;0
FR;8;2022-04-21;0;0;0;0;0;0;0;0;0;0;0;0;0;0;0;0;0;0
FR;8;2022-04-22;0;0;0;0;0;0;0;0;0;0;0;0;0;0;0;0;0;0
FR;8;2022-04-23;0;0;0;0;0;0;0;0;0;0;0;0;0;0;0;0;0;0
FR;8;2022-04-24;0;0;0;0;0;0;0;0;0;0;0;0;0;0;0;0;0;0
FR;8;2022-04-25;0;0;0;0;0;0;0;0;0;0;0;0;0;0;0;0;0;0
FR;8;2022-04-26;0;0;0;0;0;0;0;0;0;0;0;0;0;0;0;0;0;0
FR;8;2022-04-27;0;0;0;0;0;0;0;0;0;0;0;0;0;0;0;0;0;0
FR;8;2022-04-28;0;0;0;0;0;0;0;0;0;0;0;0;0;0;0;0;0;0
FR;8;2022-04-29;0;0;0;0;0;0;0;0;0;0;0;0;0;0;0;0;0;0
FR;8;2022-04-30;0;0;0;0;0;0;0;0;0;0;0;0;0;0;0;0;0;0
FR;8;2022-05-01;0;0;0;0;0;0;0;0;0;0;0;0;0;0;0;0;0;0
FR;8;2022-05-02;0;0;0;0;0;0;0;0;0;0;0;0;0;0;0;0;0;0
FR;8;2022-05-03;0;0;0;0;0;0;0;0;0;0;0;0;0;0;0;0;0;0
FR;8;2022-05-04;0;0;0;0;0;0;0;0;0;0;0;0;0;0;0;0;0;0
FR;8;2022-05-05;0;0;0;0;0;0;0;0;0;0;0;0;0;0;0;0;0;0
FR;8;2022-05-06;0;0;0;0;0;0;0;0;0;0;0;0;0;0;0;0;0;0
FR;8;2022-05-07;0;0;0;0;0;0;0;0;0;0;0;0;0;0;0;0;0;0
FR;8;2022-05-08;0;0;0;0;0;0;0;0;0;0;0;0;0;0;0;0;0;0
FR;8;2022-05-09;0;0;0;0;0;0;0;0;0;0;0;0;0;0;0;0;0;0
FR;8;2022-05-10;0;0;0;0;0;0;0;0;0;0;0;0;0;0;0;0;0;0
FR;8;2022-05-11;0;0;0;0;0;0;0;0;0;0;0;0;0;0;0;0;0;0
FR;8;2022-05-12;0;0;0;0;0;0;0;0;0;0;0;0;0;0;0;0;0;0
FR;8;2022-05-13;0;0;0;0;0;0;0;0;0;0;0;0;0;0;0;0;0;0
FR;8;2022-05-14;0;0;0;0;0;0;0;0;0;0;0;0;0;0;0;0;0;0
FR;8;2022-05-15;0;0;0;0;0;0;0;0;0;0;0;0;0;0;0;0;0;0
FR;8;2022-05-16;0;0;0;0;0;0;0;0;0;0;0;0;0;0;0;0;0;0
FR;8;2022-05-17;0;0;0;0;0;0;0;0;0;0;0;0;0;0;0;0;0;0
FR;8;2022-05-18;0;0;0;0;0;0;0;0;0;0;0;0;0;0;0;0;0;0
FR;8;2022-05-19;0;0;0;0;0;0;0;0;0;0;0;0;0;0;0;0;0;0
FR;8;2022-05-20;0;0;0;0;0;0;0;0;0;0;0;0;0;0;0;0;0;0
FR;8;2022-05-21;0;0;0;0;0;0;0;0;0;0;0;0;0;0;0;0;0;0
FR;8;2022-05-22;0;0;0;0;0;0;0;0;0;0;0;0;0;0;0;0;0;0
FR;8;2022-05-23;0;0;0;0;0;0;0;0;0;0;0;0;0;0;0;0;0;0
FR;8;2022-05-24;0;0;0;0;0;0;0;0;0;0;0;0;0;0;0;0;0;0
FR;8;2022-05-25;0;0;0;0;0;0;0;0;0;0;0;0;0;0;0;0;0;0
FR;8;2022-05-26;0;0;0;0;0;0;0;0;0;0;0;0;0;0;0;0;0;0
FR;8;2022-05-27;0;0;0;0;0;0;0;0;0;0;0;0;0;0;0;0;0;0
FR;8;2022-05-28;0;0;0;0;0;0;0;0;0;0;0;0;0;0;0;0;0;0
FR;8;2022-05-29;0;0;0;0;0;0;0;0;0;0;0;0;0;0;0;0;0;0
FR;8;2022-05-30;0;0;0;0;0;0;0;0;0;0;0;0;0;0;0;0;0;0
FR;8;2022-05-31;0;0;0;0;0;0;0;0;0;0;0;0;0;0;0;0;0;0
FR;8;2022-06-01;0;0;0;0;0;0;0;0;0;0;0;0;0;0;0;0;0;0
FR;8;2022-06-02;0;0;0;0;0;0;0;0;0;0;0;0;0;0;0;0;0;0
FR;8;2022-06-03;0;0;0;0;0;0;0;0;0;0;0;0;0;0;0;0;0;0
FR;8;2022-06-04;0;0;0;0;0;0;0;0;0;0;0;0;0;0;0;0;0;0
FR;8;2022-06-05;0;0;0;0;0;0;0;0;0;0;0;0;0;0;0;0;0;0
FR;8;2022-06-06;0;0;0;0;0;0;0;0;0;0;0;0;0;0;0;0;0;0
FR;8;2022-06-07;0;0;0;0;0;0;0;0;0;0;0;0;0;0;0;0;0;0
FR;8;2022-06-08;0;0;0;0;0;0;0;0;0;0;0;0;0;0;0;0;0;0
FR;8;2022-06-09;0;0;0;0;0;0;0;0;0;0;0;0;0;0;0;0;0;0
FR;8;2022-06-10;0;0;0;0;0;0;0;0;0;0;0;0;0;0;0;0;0;0
FR;8;2022-06-11;0;0;0;0;0;0;0;0;0;0;0;0;0;0;0;0;0;0
FR;8;2022-06-12;0;0;0;0;0;0;0;0;0;0;0;0;0;0;0;0;0;0
FR;8;2022-06-13;0;0;0;0;0;0;0;0;0;0;0;0;0;0;0;0;0;0
FR;8;2022-06-14;0;0;0;0;0;0;0;0;0;0;0;0;0;0;0;0;0;0
FR;8;2022-06-15;0;0;0;0;0;0;0;0;0;0;0;0;0;0;0;0;0;0
FR;8;2022-06-16;0;0;0;0;0;0;0;0;0;0;0;0;0;0;0;0;0;0
FR;8;2022-06-17;0;0;0;0;0;0;0;0;0;0;0;0;0;0;0;0;0;0
FR;8;2022-06-18;0;0;0;0;0;0;0;0;0;0;0;0;0;0;0;0;0;0
FR;8;2022-06-19;0;0;0;0;0;0;0;0;0;0;0;0;0;0;0;0;0;0
FR;8;2022-06-20;0;0;0;0;0;0;0;0;0;0;0;0;0;0;0;0;0;0
FR;8;2022-06-21;0;0;0;0;0;0;0;0;0;0;0;0;0;0;0;0;0;0
FR;8;2022-06-22;0;0;0;0;0;0;0;0;0;0;0;0;0;0;0;0;0;0
FR;8;2022-06-23;0;0;0;0;0;0;0;0;0;0;0;0;0;0;0;0;0;0
FR;8;2022-06-24;0;0;0;0;0;0;0;0;0;0;0;0;0;0;0;0;0;0
FR;8;2022-06-25;0;0;0;0;0;0;0;0;0;0;0;0;0;0;0;0;0;0
FR;8;2022-06-26;0;0;0;0;0;0;0;0;0;0;0;0;0;0;0;0;0;0
FR;8;2022-06-27;0;0;0;0;0;0;0;0;0;0;0;0;0;0;0;0;0;0
FR;8;2022-06-28;0;0;0;0;0;0;0;0;0;0;0;0;0;0;0;0;0;0
FR;8;2022-06-29;0;0;0;0;0;0;0;0;0;0;0;0;0;0;0;0;0;0
FR;8;2022-06-30;0;0;0;0;0;0;0;0;0;0;0;0;0;0;0;0;0;0
FR;8;2022-07-01;0;0;0;0;0;0;0;0;0;0;0;0;0;0;0;0;0;0
FR;8;2022-07-02;0;0;0;0;0;0;0;0;0;0;0;0;0;0;0;0;0;0
FR;8;2022-07-03;0;0;0;0;0;0;0;0;0;0;0;0;0;0;0;0;0;0
FR;8;2022-07-04;0;0;0;0;0;0;0;0;0;0;0;0;0;0;0;0;0;0
FR;8;2022-07-05;0;0;0;0;0;0;0;0;0;0;0;0;0;0;0;0;0;0
FR;8;2022-07-06;0;0;0;0;0;0;0;0;0;0;0;0;0;0;0;0;0;0
FR;8;2022-07-07;0;0;0;0;0;0;0;0;0;0;0;0;0;0;0;0;0;0
FR;8;2022-07-08;0;0;0;0;0;0;0;0;0;0;0;0;0;0;0;0;0;0
FR;8;2022-07-09;0;0;0;0;0;0;0;0;0;0;0;0;0;0;0;0;0;0
FR;8;2022-07-10;0;0;0;0;0;0;0;0;0;0;0;0;0;0;0;0;0;0
FR;8;2022-07-11;0;0;0;0;0;0;0;0;0;0;0;0;0;0;0;0;0;0
FR;8;2022-07-12;0;0;0;0;0;0;0;0;0;0;0;0;0;0;0;0;0;0
FR;8;2022-07-13;0;0;0;0;0;0;0;0;0;0;0;0;0;0;0;0;0;0
FR;8;2022-07-14;0;0;0;0;0;0;0;0;0;0;0;0;0;0;0;0;0;0
FR;8;2022-07-15;0;0;0;0;0;0;0;0;0;0;0;0;0;0;0;0;0;0
FR;8;2022-07-16;0;0;0;0;0;0;0;0;0;0;0;0;0;0;0;0;0;0
FR;8;2022-07-17;0;0;0;0;0;0;0;0;0;0;0;0;0;0;0;0;0;0
FR;8;2022-07-18;0;0;0;0;0;0;0;0;0;0;0;0;0;0;0;0;0;0
FR;8;2022-07-19;0;0;0;0;0;0;0;0;0;0;0;0;0;0;0;0;0;0
FR;8;2022-07-20;0;0;0;0;0;0;0;0;0;0;0;0;0;0;0;0;0;0
FR;8;2022-07-21;0;0;0;0;0;0;0;0;0;0;0;0;0;0;0;0;0;0
FR;8;2022-07-22;0;0;0;0;0;0;0;0;0;0;0;0;0;0;0;0;0;0
FR;8;2022-07-23;0;0;0;0;0;0;0;0;0;0;0;0;0;0;0;0;0;0
FR;8;2022-07-24;0;0;0;0;0;0;0;0;0;0;0;0;0;0;0;0;0;0
FR;8;2022-07-25;0;0;0;0;0;0;0;0;0;0;0;0;0;0;0;0;0;0
FR;8;2022-07-26;0;0;0;0;0;0;0;0;0;0;0;0;0;0;0;0;0;0
FR;8;2022-07-27;0;0;0;0;0;0;0;0;0;0;0;0;0;0;0;0;0;0
FR;8;2022-07-28;0;0;0;0;0;0;0;0;0;0;0;0;0;0;0;0;0;0
FR;8;2022-07-29;0;0;0;0;0;0;0;0;0;0;0;0;0;0;0;0;0;0
FR;8;2022-07-30;0;0;0;0;0;0;0;0;0;0;0;0;0;0;0;0;0;0
FR;8;2022-07-31;0;0;0;0;0;0;0;0;0;0;0;0;0;0;0;0;0;0
FR;8;2022-08-01;0;0;0;0;0;0;0;0;0;0;0;0;0;0;0;0;0;0
FR;8;2022-08-02;0;0;0;0;0;0;0;0;0;0;0;0;0;0;0;0;0;0
FR;8;2022-08-03;0;0;0;0;0;0;0;0;0;0;0;0;0;0;0;0;0;0
FR;8;2022-08-04;0;0;0;0;0;0;0;0;0;0;0;0;0;0;0;0;0;0
FR;8;2022-08-05;0;0;0;0;0;0;0;0;0;0;0;0;0;0;0;0;0;0
FR;8;2022-08-06;0;0;0;0;0;0;0;0;0;0;0;0;0;0;0;0;0;0
FR;8;2022-08-07;0;0;0;0;0;0;0;0;0;0;0;0;0;0;0;0;0;0
FR;8;2022-08-08;0;0;0;0;0;0;0;0;0;0;0;0;0;0;0;0;0;0
FR;8;2022-08-09;0;0;0;0;0;0;0;0;0;0;0;0;0;0;0;0;0;0
FR;8;2022-08-10;0;0;0;0;0;0;0;0;0;0;0;0;0;0;0;0;0;0
FR;8;2022-08-11;0;0;0;0;0;0;0;0;0;0;0;0;0;0;0;0;0;0
FR;8;2022-08-12;0;0;0;0;0;0;0;0;0;0;0;0;0;0;0;0;0;0
FR;8;2022-08-13;0;0;0;0;0;0;0;0;0;0;0;0;0;0;0;0;0;0
FR;8;2022-08-14;0;0;0;0;0;0;0;0;0;0;0;0;0;0;0;0;0;0
FR;8;2022-08-15;0;0;0;0;0;0;0;0;0;0;0;0;0;0;0;0;0;0
FR;8;2022-08-16;0;0;0;0;0;0;0;0;0;0;0;0;0;0;0;0;0;0
FR;8;2022-08-17;0;0;0;0;0;0;0;0;0;0;0;0;0;0;0;0;0;0
FR;8;2022-08-18;0;0;0;0;0;0;0;0;0;0;0;0;0;0;0;0;0;0
FR;8;2022-08-19;0;0;0;0;0;0;0;0;0;0;0;0;0;0;0;0;0;0
FR;8;2022-08-20;0;0;0;0;0;0;0;0;0;0;0;0;0;0;0;0;0;0
FR;8;2022-08-21;0;0;0;0;0;0;0;0;0;0;0;0;0;0;0;0;0;0
FR;8;2022-08-22;0;0;0;0;0;0;0;0;0;0;0;0;0;0;0;0;0;0
FR;8;2022-08-23;0;0;0;0;0;0;0;0;0;0;0;0;0;0;0;0;0;0
FR;8;2022-08-24;0;0;0;0;0;0;0;0;0;0;0;0;0;0;0;0;0;0
FR;8;2022-08-25;0;0;0;0;0;0;0;0;0;0;0;0;0;0;0;0;0;0
FR;8;2022-08-26;0;0;0;0;0;0;0;0;0;0;0;0;0;0;0;0;0;0
FR;8;2022-08-27;0;0;0;0;0;0;0;0;0;0;0;0;0;0;0;0;0;0
FR;8;2022-08-28;0;0;0;0;0;0;0;0;0;0;0;0;0;0;0;0;0;0
FR;8;2022-08-29;0;0;0;0;0;0;0;0;0;0;0;0;0;0;0;0;0;0
FR;8;2022-08-30;0;0;0;0;0;0;0;0;0;0;0;0;0;0;0;0;0;0
FR;8;2022-08-31;0;0;0;0;0;0;0;0;0;0;0;0;0;0;0;0;0;0
FR;8;2022-09-01;0;0;0;0;0;0;0;0;0;0;0;0;0;0;0;0;0;0
FR;8;2022-09-02;0;0;0;0;0;0;0;0;0;0;0;0;0;0;0;0;0;0
FR;8;2022-09-03;0;0;0;0;0;0;0;0;0;0;0;0;0;0;0;0;0;0
FR;8;2022-09-04;0;0;0;0;0;0;0;0;0;0;0;0;0;0;0;0;0;0
FR;8;2022-09-05;0;0;0;0;0;0;0;0;0;0;0;0;0;0;0;0;0;0
FR;8;2022-09-06;0;0;0;0;0;0;0;0;0;0;0;0;0;0;0;0;0;0
FR;8;2022-09-07;0;0;0;0;0;0;0;0;0;0;0;0;0;0;0;0;0;0
FR;8;2022-09-08;0;0;0;0;0;0;0;0;0;0;0;0;0;0;0;0;0;0
FR;8;2022-09-09;0;0;0;0;0;0;0;0;0;0;0;0;0;0;0;0;0;0
FR;8;2022-09-10;0;0;0;0;0;0;0;0;0;0;0;0;0;0;0;0;0;0
FR;8;2022-09-11;0;0;0;0;0;0;0;0;0;0;0;0;0;0;0;0;0;0
FR;8;2022-09-12;0;0;0;0;0;0;0;0;0;0;0;0;0;0;0;0;0;0
FR;8;2022-09-13;0;0;0;0;0;0;0;0;0;0;0;0;0;0;0;0;0;0
FR;8;2022-09-14;0;0;0;0;0;0;0;0;0;0;0;0;0;0;0;0;0;0
FR;8;2022-09-15;0;0;0;0;0;0;0;0;0;0;0;0;0;0;0;0;0;0
FR;8;2022-09-16;0;0;0;0;0;0;0;0;0;0;0;0;0;0;0;0;0;0
FR;8;2022-09-17;0;0;0;0;0;0;0;0;0;0;0;0;0;0;0;0;0;0
FR;8;2022-09-18;0;0;0;0;0;0;0;0;0;0;0;0;0;0;0;0;0;0
FR;8;2022-09-19;0;0;0;0;0;0;0;0;0;0;0;0;0;0;0;0;0;0
FR;8;2022-09-20;0;0;0;0;0;0;0;0;0;0;0;0;0;0;0;0;0;0
FR;8;2022-09-21;0;0;0;0;0;0;0;0;0;0;0;0;0;0;0;0;0;0
FR;8;2022-09-22;0;0;0;0;0;0;0;0;0;0;0;0;0;0;0;0;0;0
FR;8;2022-09-23;0;0;0;0;0;0;0;0;0;0;0;0;0;0;0;0;0;0
FR;8;2022-09-24;0;0;0;0;0;0;0;0;0;0;0;0;0;0;0;0;0;0
FR;8;2022-09-25;0;0;0;0;0;0;0;0;0;0;0;0;0;0;0;0;0;0
FR;8;2022-09-26;0;0;0;0;0;0;0;0;0;0;0;0;0;0;0;0;0;0
FR;8;2022-09-27;0;0;0;0;0;0;0;0;0;0;0;0;0;0;0;0;0;0
FR;8;2022-09-28;0;0;0;0;0;0;0;0;0;0;0;0;0;0;0;0;0;0
FR;8;2022-09-29;0;0;0;0;0;0;0;0;0;0;0;0;0;0;0;0;0;0
FR;8;2022-09-30;0;0;0;0;0;0;0;0;0;0;0;0;0;0;0;0;0;0
FR;8;2022-10-01;0;0;0;0;0;0;0;0;0;0;0;0;0;0;0;0;0;0
FR;8;2022-10-02;0;0;0;0;0;0;0;0;0;0;0;0;0;0;0;0;0;0
FR;8;2022-10-03;0;0;0;0;0;0;0;0;0;0;0;0;0;0;0;0;0;0
FR;8;2022-10-04;0;0;0;0;0;0;0;0;0;0;0;0;0;0;0;0;0;0
FR;8;2022-10-05;0;0;0;0;0;0;0;0;0;0;0;0;0;0;0;0;0;0
FR;8;2022-10-06;14;17;113;861;8;83;866;1059;110;14;17;113;861;8;83;866;1059;110
FR;8;2022-10-07;75;103;842;8012;63;699;8066;9845;1073;89;120;955;8873;71;782;8932;10904;1183
FR;8;2022-10-08;37;115;610;4057;50;516;4109;5310;676;126;235;1565;12930;121;1298;13041;16214;1859
FR;8;2022-10-09;17;22;145;885;13;132;913;1234;185;143;257;1710;13815;134;1430;13954;17448;2044
FR;8;2022-10-10;128;192;1351;12751;106;1044;12982;16301;2253;271;449;3061;26566;240;2474;26936;33749;4297
FR;8;2022-10-11;205;264;2476;26928;136;2012;27199;33965;4717;476;713;5537;53494;376;4486;54135;67714;9014
FR;8;2022-10-12;164;258;1831;18238;152;1441;18474;23474;3535;640;971;7368;71732;528;5927;72609;91188;12549
FR;8;2022-10-13;209;281;2512;28079;178;1905;28443;35582;5206;849;1252;9880;99811;706;7832;101052;126770;17755
FR;8;2022-10-14;257;419;3272;36247;241;2557;36672;45578;6307;1106;1671;13152;136058;947;10389;137724;172348;24062
FR;8;2022-10-15;105;182;1203;8806;79;1002;8932;11783;1829;1211;1853;14355;144864;1026;11391;146656;184131;25891
FR;8;2022-10-16;36;54;248;1522;26;215;1557;2179;402;1247;1907;14603;146386;1052;11606;148213;186310;26293
FR;8;2022-10-17;159;313;2101;21806;175;1631;22113;28301;4535;1406;2220;16704;168192;1227;13237;170326;214611;30828
FR;8;2022-10-18;276;350;3356;37862;227;2654;38245;50787;9815;1682;2570;20060;206054;1454;15891;208571;265398;40643
FR;8;2022-10-19;205;314;2632;28301;183;2187;28622;38741;7871;1887;2884;22692;234355;1637;18078;237193;304139;48514
FR;8;2022-10-20;257;368;3577;41211;229;2653;41816;55722;11168;2144;3252;26269;275566;1866;20731;279009;359861;59682
FR;8;2022-10-21;325;489;4461;49420;276;3475;50019;66310;12717;2469;3741;30730;324986;2142;24206;329028;426171;72399
FR;8;2022-10-22;127;168;1230;10665;111;927;10851;14746;2949;2596;3909;31960;335651;2253;25133;339879;440917;75348
FR;8;2022-10-23;50;53;266;1762;48;197;1841;2610;571;2646;3962;32226;337413;2301;25330;341720;443527;75919
FR;8;2022-10-24;231;312;2475;24047;175;2074;24345;33555;7085;2877;4274;34701;361460;2476;27404;366065;477082;83004
FR;8;2022-10-25;307;417;4082;43467;257;3138;44066;61317;14010;3184;4691;38783;404927;2733;30542;410131;538399;97014
FR;8;2022-10-26;228;343;2885;28761;187;2381;29040;41472;9963;3412;5034;41668;433688;2920;32923;439171;579871;106977
FR;8;2022-10-27;277;415;3330;36200;243;2636;36676;51266;11889;3689;5449;44998;469888;3163;35559;475847;631137;118866
FR;8;2022-10-28;329;466;3829;39480;259;2864;40203;55137;12001;4018;5915;48827;509368;3422;38423;516050;686274;130867
FR;8;2022-10-29;113;165;1074;8230;94;803;8374;11861;2667;4131;6080;49901;517598;3516;39226;524424;698135;133534
FR;8;2022-10-30;40;53;210;1348;38;180;1394;2063;485;4171;6133;50111;518946;3554;39406;525818;700198;134019
FR;8;2022-10-31;196;260;1665;14543;145;1277;14808;21209;5106;4367;6393;51776;533489;3699;40683;540626;721407;139125
FR;8;2022-11-01;50;43;137;963;25;171;978;1626;474;4417;6436;51913;534452;3724;40854;541604;723033;139599
FR;8;2022-11-02;200;371;2377;23320;206;1982;23716;35076;9311;4617;6807;54290;557772;3930;42836;565320;758109;148910
FR;8;2022-11-03;310;419;3487;36970;260;2604;37615;54694;14376;4927;7226;57777;594742;4190;45440;602935;812803;163286
FR;8;2022-11-04;357;497;3784;40211;262;2976;40734;58003;14182;5284;7723;61561;634953;4452;48416;643669;870806;177468
FR;8;2022-11-05;113;189;1103;8770;123;850;8937;12893;3071;5397;7912;62664;643723;4575;49266;652606;883699;180539
FR;8;2022-11-06;45;56;224;1410;38;205;1443;2252;594;5442;7968;62888;645133;4613;49471;654049;885951;181133
FR;8;2022-11-07;274;281;2324;24845;210;1799;25433;37636;10336;5716;8249;65212;669978;4823;51270;679482;923587;191469
FR;8;2022-11-08;374;508;4340;48423;308;3274;49404;71666;18826;6090;8757;69552;718401;5131;54544;728886;995253;210295
FR;8;2022-11-09;269;370;2879;29183;212;2263;29868;44486;12271;6359;9127;72431;747584;5343;56807;758754;1039739;222566
FR;8;2022-11-10;370;549;3959;40302;317;3036;41213;60601;16212;6729;9676;76390;787886;5660;59843;799967;1100340;238778
FR;8;2022-11-11;40;66;243;1480;37;204;1526;2676;933;6769;9742;76633;789366;5697;60047;801493;1103016;239711
FR;8;2022-11-12;84;166;881;6433;80;687;6636;9894;2552;6853;9908;77514;795799;5777;60734;808129;1112910;242263
FR;8;2022-11-13;36;56;213;1110;37;173;1162;1927;586;6889;9964;77727;796909;5814;60907;809291;1114837;242849
FR;8;2022-11-14;237;307;2243;22462;168;1726;23004;35118;10313;7126;10271;79970;819371;5982;62633;832295;1149955;253162
FR;8;2022-11-15;353;432;3765;42376;266;2875;43284;64845;18552;7479;10703;83735;861747;6248;65508;875579;1214800;271714
FR;8;2022-11-16;314;353;2622;26559;222;2158;27034;41784;12507;7793;11056;86357;888306;6470;67666;902613;1256584;284221
FR;8;2022-11-17;373;431;3390;36886;293;2621;37468;56698;16510;8166;11487;89747;925192;6763;70287;940081;1313282;300731
FR;8;2022-11-18;346;468;4074;42328;290;2978;43180;63700;17438;8512;11955;93821;967520;7053;73265;983261;1376982;318169
FR;8;2022-11-19;121;182;1198;8974;121;844;9156;13839;3801;8633;12137;95019;976494;7174;74109;992417;1390821;321970
FR;8;2022-11-20;35;55;260;1585;39;217;1653;2663;788;8668;12192;95279;978079;7213;74326;994070;1393484;322758
FR;8;2022-11-21;218;303;2078;20129;178;1601;20661;32199;9870;8886;12495;97357;998208;7391;75927;1014731;1425683;332628
FR;8;2022-11-22;338;409;3477;37571;252;2675;38088;58212;17338;9224;12904;100834;1035779;7643;78602;1052819;1483895;349966
FR;8;2022-11-23;234;327;2415;24441;192;2018;24871;39252;12281;9458;13231;103249;1060220;7835;80620;1077690;1523147;362247
FR;8;2022-11-24;352;391;3373;34921;238;2581;35608;55385;17097;9810;13622;106622;1095141;8073;83201;1113298;1578532;379344
FR;8;2022-11-25;311;428;3633;37739;291;2625;38537;57858;16572;10121;14050;110255;1132880;8364;85826;1151835;1636390;395916
FR;8;2022-11-26;172;195;1177;8819;127;898;8976;13689;3784;10293;14245;111432;1141699;8491;86724;1160811;1650079;399700
FR;8;2022-11-27;45;43;227;1545;38;180;1561;2472;721;10338;14288;111659;1143244;8529;86904;1162372;1652551;400421
FR;8;2022-11-28;184;301;2309;23385;172;1703;24049;37337;11511;10522;14589;113968;1166629;8701;88607;1186421;1689888;411932
FR;8;2022-11-29;293;430;3978;44085;218;2944;44771;69168;21330;10815;15019;117946;1210714;8919;91551;1231192;1759056;433262
FR;8;2022-11-30;284;413;3377;34889;230;2545;35653;54727;16411;11099;15432;121323;1245603;9149;94096;1266845;1813783;449673
FR;8;2022-12-01;334;476;4478;49383;274;3132;50162;77763;24306;11433;15908;125801;1294986;9423;97228;1317007;1891546;473979
FR;8;2022-12-02;410;522;5438;58452;308;3742;59629;89818;26257;11843;16430;131239;1353438;9731;100970;1376636;1981364;500236
FR;8;2022-12-03;178;218;1918;16861;108;1328;17273;25844;7207;12021;16648;133157;1370299;9839;102298;1393909;2007208;507443
FR;8;2022-12-04;54;90;489;4056;59;404;4116;6288;1756;12075;16738;133646;1374355;9898;102702;1398025;2013496;509199
FR;8;2022-12-05;300;407;3850;42365;250;2517;43288;66943;20989;12375;17145;137496;1416720;10148;105219;1441313;2080439;530188
FR;8;2022-12-06;432;555;6301;74330;313;4215;75753;117965;37751;12807;17700;143797;1491050;10461;109434;1517066;2198404;567939
FR;8;2022-12-07;365;438;4909;55038;266;3244;56128;87717;28150;13172;18138;148706;1546088;10727;112678;1573194;2286121;596089
FR;8;2022-12-08;454;541;6447;75453;299;4197;77035;120480;38987;13626;18679;155153;1621541;11026;116875;1650229;2406601;635076
FR;8;2022-12-09;546;608;8021;90910;360;5216;92679;143048;44883;14172;19287;163174;1712451;11386;122091;1742908;2549649;679959
FR;8;2022-12-10;264;368;3341;31718;235;2089;32564;48738;13994;14436;19655;166515;1744169;11621;124180;1775472;2598387;693953
FR;8;2022-12-11;90;106;938;7866;67;645;8085;11895;3145;14526;19761;167453;1752035;11688;124825;1783557;2610282;697098
FR;8;2022-12-12;356;465;5859;64351;256;3730;65862;103407;33617;14882;20226;173312;1816386;11944;128555;1849419;2713689;730715
FR;8;2022-12-13;537;611;8430;99119;359;5206;101559;160225;53125;15419;20837;181742;1915505;12303;133761;1950978;2873914;783840
FR;8;2022-12-14;458;535;6363;70058;308;4213;71642;113506;37381;15877;21372;188105;1985563;12611;137974;2022620;2987420;821221
FR;8;2022-12-15;493;663;8161;91749;378;5142;93960;149264;49821;16370;22035;196266;2077312;12989;143116;2116580;3136684;871042
FR;8;2022-12-16;580;714;8876;100320;390;5709;102450;161938;53404;16950;22749;205142;2177632;13379;148825;2219030;3298622;924446
FR;8;2022-12-17;235;309;3145;30075;192;2004;30844;46784;13831;17185;23058;208287;2207707;13571;150829;2249874;3345406;938277
FR;8;2022-12-18;63;94;732;5975;50;499;6124;9309;2657;17248;23152;209019;2213682;13621;151328;2255998;3354715;940934
FR;8;2022-12-19;402;453;5344;53774;265;3368;55337;87778;28891;17650;23605;214363;2267456;13886;154696;2311335;3442493;969825
FR;8;2022-12-20;555;584;7347;76591;351;4755;78688;127126;43355;18205;24189;221710;2344047;14237;159451;2390023;3569619;1013180
FR;8;2022-12-21;426;482;4970;48810;288;3325;50102;81792;28167;18631;24671;226680;2392857;14525;162776;2440125;3651411;1041347
FR;8;2022-12-22;463;526;4589;44284;315;3188;45504;74796;25949;19094;25197;231269;2437141;14840;165964;2485629;3726207;1067296
FR;8;2022-12-23;321;391;2886;25049;254;2101;25697;42333;14417;19415;25588;234155;2462190;15094;168065;2511326;3768540;1081713
FR;8;2022-12-24;70;70;395;2551;41;295;2665;4151;1174;19485;25658;234550;2464741;15135;168360;2513991;3772691;1082887
FR;8;2022-12-25;29;30;106;546;22;84;567;914;260;19514;25688;234656;2465287;15157;168444;2514558;3773605;1083147
FR;8;2022-12-26;245;278;2158;16092;180;1508;16705;26812;8504;19759;25966;236814;2481379;15337;169952;2531263;3800417;1091651
FR;8;2022-12-27;393;453;3776;32422;265;2534;33517;55333;19135;20152;26419;240590;2513801;15602;172486;2564780;3855750;1110786
FR;8;2022-12-28;345;343;2942;24667;192;2056;25255;41768;14337;20497;26762;243532;2538468;15794;174542;2590035;3897518;1125123
FR;8;2022-12-29;298;409;3159;25513;227;2187;26465;43973;15191;20795;27171;246691;2563981;16021;176729;2616500;3941491;1140314
FR;8;2022-12-30;300;344;2445;18677;217;1703;19319;31742;10612;21095;27515;249136;2582658;16238;178432;2635819;3973233;1150926
FR;8;2022-12-31;92;117;453;2959;75;364;3102;4755;1269;21187;27632;249589;2585617;16313;178796;2638921;3977988;1152195
FR;8;2023-01-01;17;30;112;661;14;85;684;995;225;21204;27662;249701;2586278;16327;178881;2639605;3978983;1152420
FR;8;2023-01-02;280;413;2267;18226;244;1615;18686;32080;11694;21484;28075;251968;2604504;16571;180496;2658291;4011063;1164114
FR;8;2023-01-03;474;546;4251;42808;326;2915;43724;80860;33898;21958;28621;256219;2647312;16897;183411;2702015;4091923;1198012
FR;8;2023-01-04;413;479;3495;29986;296;2426;30741;58281;24927;22371;29100;259714;2677298;17193;185837;2732756;4150204;1222939
FR;8;2023-01-05;504;599;4370;41818;400;2934;42710;82012;36048;22875;29699;264084;2719116;17593;188771;2775466;4232216;1258987
FR;8;2023-01-06;518;671;5108;46738;406;3346;47750;89695;38268;23393;30370;269192;2765854;17999;192117;2823216;4321911;1297255
FR;8;2023-01-07;219;289;1704;12301;182;1199;12615;22349;8435;23612;30659;270896;2778155;18181;193316;2835831;4344260;1305690
FR;8;2023-01-08;68;105;443;2744;64;312;2839;5094;1926;23680;30764;271339;2780899;18245;193628;2838670;4349354;1307616
FR;8;2023-01-09;405;482;2622;21482;315;1847;22051;44584;20466;24085;31246;273961;2802381;18560;195475;2860721;4393938;1328082
FR;8;2023-01-10;462;634;4349;40172;396;3067;40937;85041;40653;24547;31880;278310;2842553;18956;198542;2901658;4478979;1368735
FR;8;2023-01-11;349;461;2950;24115;287;2117;24625;51482;24448;24896;32341;281260;2866668;19243;200659;2926283;4530461;1393183
FR;8;2023-01-12;411;542;3657;33168;332;2574;33791;70822;34087;25307;32883;284917;2899836;19575;203233;2960074;4601283;1427270
FR;8;2023-01-13;449;590;4049;34891;340;2863;35504;72884;34138;25756;33473;288966;2934727;19915;206096;2995578;4674167;1461408
FR;8;2023-01-14;178;229;1343;8860;123;959;9043;17188;7106;25934;33702;290309;2943587;20038;207055;3004621;4691355;1468514
FR;8;2023-01-15;63;87;329;1479;53;244;1585;3186;1345;25997;33789;290638;2945066;20091;207299;3006206;4694541;1469859
FR;8;2023-01-16;267;339;1997;15750;198;1433;16011;35209;17562;26264;34128;292635;2960816;20289;208732;3022217;4729750;1487421
FR;8;2023-01-17;360;453;3248;28164;281;2321;28672;64507;33107;26624;34581;295883;2988980;20570;211053;3050889;4794257;1520528
FR;8;2023-01-18;266;407;2192;16822;247;1669;17066;38334;19344;26890;34988;298075;3005802;20817;212722;3067955;4832591;1539872
FR;8;2023-01-19;355;414;2667;22305;252;1950;22653;51219;26244;27245;35402;300742;3028107;21069;214672;3090608;4883810;1566116
FR;8;2023-01-20;406;508;3175;24804;309;2340;25286;56594;28587;27651;35910;303917;3052911;21378;217012;3115894;4940404;1594703
FR;8;2023-01-21;147;189;1004;6114;102;732;6241;12899;5829;27798;36099;304921;3059025;21480;217744;3122135;4953303;1600532
FR;8;2023-01-22;31;52;156;833;23;138;878;1880;844;27829;36151;305077;3059858;21503;217882;3123013;4955183;1601376
FR;8;2023-01-23;215;299;1588;10614;163;1162;10834;26665;14421;28044;36450;306665;3070472;21666;219044;3133847;4981848;1615797
FR;8;2023-01-24;305;419;2408;20003;250;1795;20264;49918;27441;28349;36869;309073;3090475;21916;220839;3154111;5031766;1643238
FR;8;2023-01-25;241;378;1800;12091;230;1324;12493;29960;15877;28590;37247;310873;3102566;22146;222163;3166604;5061726;1659115
FR;8;2023-01-26;299;384;2222;16489;263;1642;16766;41541;22742;28889;37631;313095;3119055;22409;223805;3183370;5103267;1681857
FR;8;2023-01-27;312;493;2459;17868;298;1841;18104;44183;23814;29201;38124;315554;3136923;22707;225646;3201474;5147450;1705671
FR;8;2023-01-28;125;187;767;4327;124;600;4442;9722;4591;29326;38311;316321;3141250;22831;226246;3205916;5157172;1710262
FR;8;2023-01-29;26;43;86;438;28;67;470;1058;513;29352;38354;316407;3141688;22859;226313;3206386;5158230;1710775
FR;8;2023-01-30;208;314;1227;7966;186;1012;8130;20457;11066;29560;38668;317634;3149654;23045;227325;3214516;5178687;1721841
FR;8;2023-01-31;272;382;1917;13605;235;1420;13840;36258;20707;29832;39050;319551;3163259;23280;228745;3228356;5214945;1742548
FR;8;2023-02-01;247;347;1332;8018;226;1089;8140;21703;12196;30079;39397;320883;3171277;23506;229834;3236496;5236648;1754744
FR;8;2023-02-02;257;384;1572;11467;233;1281;11688;31056;17725;30336;39781;322455;3182744;23739;231115;3248184;5267704;1772469
FR;8;2023-02-03;279;448;1847;12109;286;1437;12291;32952;18843;30615;40229;324302;3194853;24025;232552;3260475;5300656;1791312
FR;8;2023-02-04;118;159;568;2956;110;461;2998;7188;3658;30733;40388;324870;3197809;24135;233013;3263473;5307844;1794970
FR;8;2023-02-05;10;53;66;224;31;61;239;572;264;30743;40441;324936;3198033;24166;233074;3263712;5308416;1795234
FR;8;2023-02-06;185;242;942;5174;170;702;5359;15012;8719;30928;40683;325878;3203207;24336;233776;3269071;5323428;1803953
FR;8;2023-02-07;234;388;1458;9429;262;1183;9585;27573;16397;31162;41071;327336;3212636;24598;234959;3278656;5351001;1820350
FR;8;2023-02-08;173;250;1019;5841;171;808;5988;16526;9449;31335;41321;328355;3218477;24769;235767;3284644;5367527;1829799
FR;8;2023-02-09;235;384;1175;7553;246;983;7737;22240;13192;31570;41705;329530;3226030;25015;236750;3292381;5389767;1842991
FR;8;2023-02-10;277;362;1400;7956;244;1158;8090;23131;13501;31847;42067;330930;3233986;25259;237908;3300471;5412898;1856492
FR;8;2023-02-11;88;145;470;2015;100;402;2092;5228;2665;31935;42212;331400;3236001;25359;238310;3302563;5418126;1859157
FR;8;2023-02-12;26;31;51;163;25;45;184;425;189;31961;42243;331451;3236164;25384;238355;3302747;5418551;1859346
FR;8;2023-02-13;131;206;671;3168;129;607;3263;9302;5295;32092;42449;332122;3239332;25513;238962;3306010;5427853;1864641
FR;8;2023-02-14;192;264;1062;5707;160;891;5854;17116;10073;32284;42713;333184;3245039;25673;239853;3311864;5444969;1874714
FR;8;2023-02-15;164;254;847;3876;145;726;4048;11821;6845;32448;42967;334031;3248915;25818;240579;3315912;5456790;1881559
FR;8;2023-02-16;168;306;1001;4918;173;855;5061;14622;8456;32616;43273;335032;3253833;25991;241434;3320973;5471412;1890015
FR;8;2023-02-17;227;318;1101;5202;224;941;5425;15938;9313;32843;43591;336133;3259035;26215;242375;3326398;5487350;1899328
FR;8;2023-02-18;95;130;395;1491;86;312;1565;3903;1970;32938;43721;336528;3260526;26301;242687;3327963;5491253;1901298
FR;8;2023-02-19;22;36;43;132;31;35;135;333;159;32960;43757;336571;3260658;26332;242722;3328098;5491586;1901457
FR;8;2023-02-20;140;257;639;2680;161;593;2795;8202;4667;33100;44014;337210;3263338;26493;243315;3330893;5499788;1906124
FR;8;2023-02-21;178;307;966;4294;163;840;4497;13574;7960;33278;44321;338176;3267632;26656;244155;3335390;5513362;1914084
FR;8;2023-02-22;157;257;664;2773;173;622;2815;8651;5046;33435;44578;338840;3270405;26829;244777;3338205;5522013;1919130
FR;8;2023-02-23;151;262;826;3782;154;739;3963;11869;6888;33586;44840;339666;3274187;26983;245516;3342168;5533882;1926018
FR;8;2023-02-24;158;311;953;4116;191;829;4305;12438;7065;33744;45151;340619;3278303;27174;246345;3346473;5546320;1933083
FR;8;2023-02-25;58;102;346;1058;69;276;1113;2945;1498;33802;45253;340965;3279361;27243;246621;3347586;5549265;1934581
FR;8;2023-02-26;14;21;31;95;22;28;108;249;106;33816;45274;340996;3279456;27265;246649;3347694;5549514;1934687
FR;8;2023-02-27;92;223;506;1829;154;481;1898;6241;3725;33908;45497;341502;3281285;27419;247130;3349592;5555755;1938412
FR;8;2023-02-28;158;257;758;3343;153;716;3476;11642;7145;34066;45754;342260;3284628;27572;247846;3353068;5567397;1945557
FR;8;2023-03-01;130;195;522;1831;145;460;1983;6238;3648;34196;45949;342782;3286459;27717;248306;3355051;5573635;1949205
FR;8;2023-03-02;131;220;715;2764;135;607;2956;9696;5903;34327;46169;343497;3289223;27852;248913;3358007;5583331;1955108
FR;8;2023-03-03;182;330;897;3415;219;794;3544;11307;6655;34509;46499;344394;3292638;28071;249707;3361551;5594638;1961763
FR;8;2023-03-04;58;135;311;975;81;295;981;2632;1296;34567;46634;344705;3293613;28152;250002;3362532;5597270;1963059
FR;8;2023-03-05;12;19;22;49;15;26;49;185;99;34579;46653;344727;3293662;28167;250028;3362581;5597455;1963158
FR;8;2023-03-06;119;178;414;1309;103;394;1370;4426;2524;34698;46831;345141;3294971;28270;250422;3363951;5601881;1965682
FR;8;2023-03-07;121;211;566;2159;127;523;2235;7520;4572;34819;47042;345707;3297130;28397;250945;3366186;5609401;1970254
FR;8;2023-03-08;93;177;449;1329;110;399;1417;4717;2748;34912;47219;346156;3298459;28507;251344;3367603;5614118;1973002
FR;8;2023-03-09;119;202;559;1869;123;525;1932;6760;4131;35031;47421;346715;3300328;28630;251869;3369535;5620878;1977133
FR;8;2023-03-10;201;335;773;2426;214;699;2566;8579;5074;35232;47756;347488;3302754;28844;252568;3372101;5629457;1982207
FR;8;2023-03-11;54;115;271;734;79;236;768;2152;1096;35286;47871;347759;3303488;28923;252804;3372869;5631609;1983303
FR;8;2023-03-12;6;10;23;60;8;22;61;172;85;35292;47881;347782;3303548;28931;252826;3372930;5631781;1983388
FR;8;2023-03-13;81;138;385;991;89;344;1068;3432;1930;35373;48019;348167;3304539;29020;253170;3373998;5635213;1985318
FR;8;2023-03-14;110;211;561;1741;125;544;1816;6400;3833;35483;48230;348728;3306280;29145;253714;3375814;5641613;1989151
FR;8;2023-03-15;105;166;407;1101;117;370;1173;4063;2372;35588;48396;349135;3307381;29262;254084;3376987;5645676;1991523
FR;8;2023-03-16;99;192;504;1498;124;461;1583;5577;3338;35687;48588;349639;3308879;29386;254545;3378570;5651253;1994861
FR;8;2023-03-17;141;222;646;1834;136;563;1981;6835;4046;35828;48810;350285;3310713;29522;255108;3380551;5658088;1998907
FR;8;2023-03-18;75;111;272;528;70;258;587;1850;944;35903;48921;350557;3311241;29592;255366;3381138;5659938;1999851
FR;8;2023-03-19;3;15;24;45;15;12;52;116;49;35906;48936;350581;3311286;29607;255378;3381190;5660054;1999900
FR;8;2023-03-20;85;171;405;923;95;402;1005;3514;1976;35991;49107;350986;3312209;29702;255780;3382195;5663568;2001876
FR;8;2023-03-21;126;202;570;1509;119;547;1680;6105;3632;36117;49309;351556;3313718;29821;256327;3383875;5669673;2005508
FR;8;2023-03-22;118;158;396;935;106;370;1049;3635;2090;36235;49467;351952;3314653;29927;256697;3384924;5673308;2007598
FR;8;2023-03-23;89;161;515;1283;90;458;1370;4883;2846;36324;49628;352467;3315936;30017;257155;3386294;5678191;2010444
FR;8;2023-03-24;145;265;696;1618;157;635;1789;6233;3553;36469;49893;353163;3317554;30174;257790;3388083;5684424;2013997
FR;8;2023-03-25;58;94;274;491;71;240;545;1616;760;36527;49987;353437;3318045;30245;258030;3388628;5686040;2014757
FR;8;2023-03-26;6;9;16;30;8;13;30;83;38;36533;49996;353453;3318075;30253;258043;3388658;5686123;2014795
FR;8;2023-03-27;111;171;407;789;125;386;877;3125;1740;36644;50167;353860;3318864;30378;258429;3389535;5689248;2016535
FR;8;2023-03-28;110;179;529;1454;96;487;1587;5803;3446;36754;50346;354389;3320318;30474;258916;3391122;5695051;2019981
FR;8;2023-03-29;90;168;370;891;87;362;1028;3546;1968;36844;50514;354759;3321209;30561;259278;3392150;5698597;2021949
FR;8;2023-03-30;101;172;486;1252;88;480;1396;5065;2891;36945;50686;355245;3322461;30649;259758;3393546;5703662;2024840
FR;8;2023-03-31;129;248;641;1623;166;559;1764;6387;3699;37074;50934;355886;3324084;30815;260317;3395310;5710049;2028539
FR;8;2023-04-01;58;106;283;537;52;242;625;1831;870;37132;51040;356169;3324621;30867;260559;3395935;5711880;2029409
FR;8;2023-04-02;5;21;20;34;12;26;36;106;44;37137;51061;356189;3324655;30879;260585;3395971;5711986;2029453
FR;8;2023-04-03;77;140;362;738;91;333;834;2947;1611;37214;51201;356551;3325393;30970;260918;3396805;5714933;2031064
FR;8;2023-04-04;77;179;461;1100;118;383;1252;4879;2885;37291;51380;357012;3326493;31088;261301;3398057;5719812;2033949
FR;8;2023-04-05;69;134;345;730;85;331;815;3145;1790;37360;51514;357357;3327223;31173;261632;3398872;5722957;2035739
FR;8;2023-04-06;92;119;368;954;75;334;1062;3941;2246;37452;51633;357725;3328177;31248;261966;3399934;5726898;2037985
FR;8;2023-04-07;119;214;490;1163;130;452;1284;4645;2587;37571;51847;358215;3329340;31378;262418;3401218;5731543;2040572
FR;8;2023-04-08;33;93;209;347;57;204;382;1215;538;37604;51940;358424;3329687;31435;262622;3401600;5732758;2041110
FR;8;2023-04-09;4;16;16;12;9;19;16;55;15;37608;51956;358440;3329699;31444;262641;3401616;5732813;2041125
FR;8;2023-04-10;6;12;26;27;5;26;36;91;25;37614;51968;358466;3329726;31449;262667;3401652;5732904;2041150
FR;8;2023-04-11;73;174;463;883;91;457;986;4011;2200;37687;52142;358929;3330609;31540;263124;3402638;5736915;2043350
FR;8;2023-04-12;80;144;319;660;98;309;715;2953;1655;37767;52286;359248;3331269;31638;263433;3403353;5739868;2045005
FR;8;2023-04-13;67;166;360;862;100;350;948;3963;2273;37834;52452;359608;3332131;31738;263783;3404301;5743831;2047278
FR;8;2023-04-14;120;193;471;1115;129;423;1189;4838;2791;37954;52645;360079;3333246;31867;264206;3405490;5748669;2050069
FR;8;2023-04-15;32;80;197;366;42;195;393;1366;628;37986;52725;360276;3333612;31909;264401;3405883;5750035;2050697
FR;8;2023-04-16;14;14;12;34;11;16;30;106;45;38000;52739;360288;3333646;31920;264417;3405913;5750141;2050742
FR;8;2023-04-17;56;134;285;582;71;295;675;2781;1482;38056;52873;360573;3334228;31991;264712;3406588;5752922;2052224
FR;8;2023-04-18;96;136;352;796;85;357;884;3865;2188;38152;53009;360925;3335024;32076;265069;3407472;5756787;2054412
FR;8;2023-04-19;59;92;264;552;60;240;644;2604;1369;38211;53101;361189;3335576;32136;265309;3408116;5759391;2055781
FR;8;2023-04-20;66;138;292;733;86;285;784;3209;1749;38277;53239;361481;3336309;32222;265594;3408900;5762600;2057530
FR;8;2023-04-21;85;175;389;897;94;388;1014;4009;2114;38362;53414;361870;3337206;32316;265982;3409914;5766609;2059644
FR;8;2023-04-22;26;69;134;234;42;145;257;1016;496;38388;53483;362004;3337440;32358;266127;3410171;5767625;2060140
FR;8;2023-04-23;2;5;12;16;4;12;19;60;21;38390;53488;362016;3337456;32362;266139;3410190;5767685;2060161
FR;8;2023-04-24;69;115;245;483;67;230;560;2191;1101;38459;53603;362261;3337939;32429;266369;3410750;5769876;2061262
FR;8;2023-04-25;81;133;322;748;84;333;797;3763;2034;38540;53736;362583;3338687;32513;266702;3411547;5773639;2063296
FR;8;2023-04-26;54;97;243;450;75;236;512;2329;1182;38594;53833;362826;3339137;32588;266938;3412059;5775968;2064478
FR;8;2023-04-27;85;117;286;709;70;293;802;3450;1824;38679;53950;363112;3339846;32658;267231;3412861;5779418;2066302
FR;8;2023-04-28;110;194;362;767;100;381;877;3948;1981;38789;54144;363474;3340613;32758;267612;3413738;5783366;2068283
FR;8;2023-04-29;51;58;127;234;42;117;274;994;453;38840;54202;363601;3340847;32800;267729;3414012;5784360;2068736
FR;8;2023-04-30;1;7;10;9;3;9;11;52;23;38841;54209;363611;3340856;32803;267738;3414023;5784412;2068759
FR;8;2023-05-01;13;6;13;10;3;13;13;62;21;38854;54215;363624;3340866;32806;267751;3414036;5784474;2068780
FR;8;2023-05-02;92;148;309;576;89;304;679;3244;1661;38946;54363;363933;3341442;32895;268055;3414715;5787718;2070441
FR;8;2023-05-03;77;94;218;429;66;217;475;2522;1272;39023;54457;364151;3341871;32961;268272;3415190;5790240;2071713
FR;8;2023-05-04;67;121;258;674;82;314;702;3760;1926;39090;54578;364409;3342545;33043;268586;3415892;5794000;2073639
FR;8;2023-05-05;90;156;306;723;89;348;803;4141;2166;39180;54734;364715;3343268;33132;268934;3416695;5798141;2075805
FR;8;2023-05-06;53;55;107;217;38;121;229;1000;462;39233;54789;364822;3343485;33170;269055;3416924;5799141;2076267
FR;8;2023-05-07;4;5;7;17;3;7;19;83;31;39237;54794;364829;3343502;33173;269062;3416943;5799224;2076298
FR;8;2023-05-08;12;9;15;17;7;17;36;123;61;39249;54803;364844;3343519;33180;269079;3416979;5799347;2076359
FR;8;2023-05-09;65;94;203;491;68;211;537;3175;1584;39314;54897;365047;3344010;33248;269290;3417516;5802522;2077943
FR;8;2023-05-10;64;87;179;466;62;217;508;3053;1434;39378;54984;365226;3344476;33310;269507;3418024;5805575;2079377
FR;8;2023-05-11;63;80;205;603;59;193;680;3751;1832;39441;55064;365431;3345079;33369;269700;3418704;5809326;2081209
FR;8;2023-05-12;69;92;232;693;63;236;728;4136;1940;39510;55156;365663;3345772;33432;269936;3419432;5813462;2083149
FR;8;2023-05-13;29;45;97;190;28;105;208;931;383;39539;55201;365760;3345962;33460;270041;3419640;5814393;2083532
FR;8;2023-05-14;3;12;6;14;7;10;15;81;29;39542;55213;365766;3345976;33467;270051;3419655;5814474;2083561
FR;8;2023-05-15;40;65;156;436;40;144;479;3045;1427;39582;55278;365922;3346412;33507;270195;3420134;5817519;2084988
FR;8;2023-05-16;65;116;200;792;78;216;933;5715;2683;39647;55394;366122;3347204;33585;270411;3421067;5823234;2087671
FR;8;2023-05-17;61;75;184;465;44;183;517;2989;1321;39708;55469;366306;3347669;33629;270594;3421584;5826223;2088992
FR;8;2023-05-18;3;5;7;25;3;9;25;159;65;39711;55474;366313;3347694;33632;270603;3421609;5826382;2089057
FR;8;2023-05-19;55;98;172;439;63;169;492;2621;1106;39766;55572;366485;3348133;33695;270772;3422101;5829003;2090163
FR;8;2023-05-20;32;29;71;110;19;64;123;761;303;39798;55601;366556;3348243;33714;270836;3422224;5829764;2090466
FR;8;2023-05-21;5;6;5;13;7;5;14;139;42;39803;55607;366561;3348256;33721;270841;3422238;5829903;2090508
FR;8;2023-05-22;41;42;133;432;33;133;491;3029;1363;39844;55649;366694;3348688;33754;270974;3422729;5832932;2091871
FR;8;2023-05-23;33;56;166;581;40;150;691;4500;2056;39877;55705;366860;3349269;33794;271124;3423420;5837432;2093927
FR;8;2023-05-24;42;53;160;475;38;156;548;3124;1382;39919;55758;367020;3349744;33832;271280;3423968;5840556;2095309
FR;8;2023-05-25;54;65;157;536;49;149;596;4400;1977;39973;55823;367177;3350280;33881;271429;3424564;5844956;2097286
FR;8;2023-05-26;56;97;175;580;66;179;631;4347;2000;40029;55920;367352;3350860;33947;271608;3425195;5849303;2099286
FR;8;2023-05-27;20;42;63;127;24;67;150;790;370;40049;55962;367415;3350987;33971;271675;3425345;5850093;2099656
FR;8;2023-05-28;2;1;3;8;2;2;14;68;32;40051;55963;367418;3350995;33973;271677;3425359;5850161;2099688
FR;8;2023-05-29;4;3;7;32;2;8;44;303;118;40055;55966;367425;3351027;33975;271685;3425403;5850464;2099806
FR;8;2023-05-30;43;73;128;550;46;132;631;4151;1762;40098;56039;367553;3351577;34021;271817;3426034;5854615;2101568
FR;8;2023-05-31;40;72;109;448;45;124;532;3293;1457;40138;56111;367662;3352025;34066;271941;3426566;5857908;2103025
FR;8;2023-06-01;53;67;144;523;47;151;577;4261;1752;40191;56178;367806;3352548;34113;272092;3427143;5862169;2104777
FR;8;2023-06-02;51;88;162;535;52;180;643;4573;2042;40242;56266;367968;3353083;34165;272272;3427786;5866742;2106819
FR;8;2023-06-03;17;38;62;141;20;67;155;929;360;40259;56304;368030;3353224;34185;272339;3427941;5867671;2107179
FR;8;2023-06-04;2;5;5;11;2;8;14;95;25;40261;56309;368035;3353235;34187;272347;3427955;5867766;2107204
FR;8;2023-06-05;46;68;141;489;48;168;553;3676;1535;40307;56377;368176;3353724;34235;272515;3428508;5871442;2108739
FR;8;2023-06-06;64;76;187;645;57;223;746;6009;2488;40371;56453;368363;3354369;34292;272738;3429254;5877451;2111227
FR;8;2023-06-07;35;63;121;455;43;109;494;3314;1382;40406;56516;368484;3354824;34335;272847;3429748;5880765;2112609
FR;8;2023-06-08;40;56;163;597;41;175;697;5229;2175;40446;56572;368647;3355421;34376;273022;3430445;5885994;2114784
FR;8;2023-06-09;42;93;162;484;73;168;527;4359;1782;40488;56665;368809;3355905;34449;273190;3430972;5890353;2116566
FR;8;2023-06-10;18;28;51;115;20;50;142;832;314;40506;56693;368860;3356020;34469;273240;3431114;5891185;2116880
FR;8;2023-06-11;1;5;4;13;5;5;16;126;52;40507;56698;368864;3356033;34474;273245;3431130;5891311;2116932
FR;8;2023-06-12;32;72;132;429;54;135;456;3598;1448;40539;56770;368996;3356462;34528;273380;3431586;5894909;2118380
FR;9;2020-12-27;0;0;0;0;0;0;0;0;0;0;0;0;0;0;0;0;0;0
FR;9;2020-12-28;0;0;0;0;0;0;0;0;0;0;0;0;0;0;0;0;0;0
FR;9;2020-12-29;0;0;0;0;0;0;0;0;0;0;0;0;0;0;0;0;0;0
FR;9;2020-12-30;0;0;0;0;0;0;0;0;0;0;0;0;0;0;0;0;0;0
FR;9;2020-12-31;0;0;0;0;0;0;0;0;0;0;0;0;0;0;0;0;0;0
FR;9;2021-01-01;0;0;0;0;0;0;0;0;0;0;0;0;0;0;0;0;0;0
FR;9;2021-01-02;0;0;0;0;0;0;0;0;0;0;0;0;0;0;0;0;0;0
FR;9;2021-01-03;0;0;0;0;0;0;0;0;0;0;0;0;0;0;0;0;0;0
FR;9;2021-01-04;0;0;0;0;0;0;0;0;0;0;0;0;0;0;0;0;0;0
FR;9;2021-01-05;0;0;0;0;0;0;0;0;0;0;0;0;0;0;0;0;0;0
FR;9;2021-01-06;0;0;0;0;0;0;0;0;0;0;0;0;0;0;0;0;0;0
FR;9;2021-01-07;0;0;0;0;0;0;0;0;0;0;0;0;0;0;0;0;0;0
FR;9;2021-01-08;0;0;0;0;0;0;0;0;0;0;0;0;0;0;0;0;0;0
FR;9;2021-01-09;0;0;0;0;0;0;0;0;0;0;0;0;0;0;0;0;0;0
FR;9;2021-01-10;0;0;0;0;0;0;0;0;0;0;0;0;0;0;0;0;0;0
FR;9;2021-01-11;0;0;0;0;0;0;0;0;0;0;0;0;0;0;0;0;0;0
FR;9;2021-01-12;0;0;0;0;0;0;0;0;0;0;0;0;0;0;0;0;0;0
FR;9;2021-01-13;0;0;0;0;0;0;0;0;0;0;0;0;0;0;0;0;0;0
FR;9;2021-01-14;0;0;0;0;0;0;0;0;0;0;0;0;0;0;0;0;0;0
FR;9;2021-01-15;0;0;0;0;0;0;0;0;0;0;0;0;0;0;0;0;0;0
FR;9;2021-01-16;0;0;0;0;0;0;0;0;0;0;0;0;0;0;0;0;0;0
FR;9;2021-01-17;0;0;0;0;0;0;0;0;0;0;0;0;0;0;0;0;0;0
FR;9;2021-01-18;0;0;0;0;0;0;0;0;0;0;0;0;0;0;0;0;0;0
FR;9;2021-01-19;0;0;0;0;0;0;0;0;0;0;0;0;0;0;0;0;0;0
FR;9;2021-01-20;0;0;0;0;0;0;0;0;0;0;0;0;0;0;0;0;0;0
FR;9;2021-01-21;0;0;0;0;0;0;0;0;0;0;0;0;0;0;0;0;0;0
FR;9;2021-01-22;0;0;0;0;0;0;0;0;0;0;0;0;0;0;0;0;0;0
FR;9;2021-01-23;0;0;0;0;0;0;0;0;0;0;0;0;0;0;0;0;0;0
FR;9;2021-01-24;0;0;0;0;0;0;0;0;0;0;0;0;0;0;0;0;0;0
FR;9;2021-01-25;0;0;0;0;0;0;0;0;0;0;0;0;0;0;0;0;0;0
FR;9;2021-01-26;0;0;0;0;0;0;0;0;0;0;0;0;0;0;0;0;0;0
FR;9;2021-01-27;0;0;0;0;0;0;0;0;0;0;0;0;0;0;0;0;0;0
FR;9;2021-01-28;0;0;0;0;0;0;0;0;0;0;0;0;0;0;0;0;0;0
FR;9;2021-01-29;0;0;0;0;0;0;0;0;0;0;0;0;0;0;0;0;0;0
FR;9;2021-01-30;0;0;0;0;0;0;0;0;0;0;0;0;0;0;0;0;0;0
FR;9;2021-01-31;0;0;0;0;0;0;0;0;0;0;0;0;0;0;0;0;0;0
FR;9;2021-02-01;0;0;0;0;0;0;0;0;0;0;0;0;0;0;0;0;0;0
FR;9;2021-02-02;0;0;0;0;0;0;0;0;0;0;0;0;0;0;0;0;0;0
FR;9;2021-02-03;0;0;0;0;0;0;0;0;0;0;0;0;0;0;0;0;0;0
FR;9;2021-02-04;0;0;0;0;0;0;0;0;0;0;0;0;0;0;0;0;0;0
FR;9;2021-02-05;0;0;0;0;0;0;0;0;0;0;0;0;0;0;0;0;0;0
FR;9;2021-02-06;0;0;0;0;0;0;0;0;0;0;0;0;0;0;0;0;0;0
FR;9;2021-02-07;0;0;0;0;0;0;0;0;0;0;0;0;0;0;0;0;0;0
FR;9;2021-02-08;0;0;0;0;0;0;0;0;0;0;0;0;0;0;0;0;0;0
FR;9;2021-02-09;0;0;0;0;0;0;0;0;0;0;0;0;0;0;0;0;0;0
FR;9;2021-02-10;0;0;0;0;0;0;0;0;0;0;0;0;0;0;0;0;0;0
FR;9;2021-02-11;0;0;0;0;0;0;0;0;0;0;0;0;0;0;0;0;0;0
FR;9;2021-02-12;0;0;0;0;0;0;0;0;0;0;0;0;0;0;0;0;0;0
FR;9;2021-02-13;0;0;0;0;0;0;0;0;0;0;0;0;0;0;0;0;0;0
FR;9;2021-02-14;0;0;0;0;0;0;0;0;0;0;0;0;0;0;0;0;0;0
FR;9;2021-02-15;0;0;0;0;0;0;0;0;0;0;0;0;0;0;0;0;0;0
FR;9;2021-02-16;0;0;0;0;0;0;0;0;0;0;0;0;0;0;0;0;0;0
FR;9;2021-02-17;0;0;0;0;0;0;0;0;0;0;0;0;0;0;0;0;0;0
FR;9;2021-02-18;0;0;0;0;0;0;0;0;0;0;0;0;0;0;0;0;0;0
FR;9;2021-02-19;0;0;0;0;0;0;0;0;0;0;0;0;0;0;0;0;0;0
FR;9;2021-02-20;0;0;0;0;0;0;0;0;0;0;0;0;0;0;0;0;0;0
FR;9;2021-02-21;0;0;0;0;0;0;0;0;0;0;0;0;0;0;0;0;0;0
FR;9;2021-02-22;0;0;0;0;0;0;0;0;0;0;0;0;0;0;0;0;0;0
FR;9;2021-02-23;0;0;0;0;0;0;0;0;0;0;0;0;0;0;0;0;0;0
FR;9;2021-02-24;0;0;0;0;0;0;0;0;0;0;0;0;0;0;0;0;0;0
FR;9;2021-02-25;0;0;0;0;0;0;0;0;0;0;0;0;0;0;0;0;0;0
FR;9;2021-02-26;0;0;0;0;0;0;0;0;0;0;0;0;0;0;0;0;0;0
FR;9;2021-02-27;0;0;0;0;0;0;0;0;0;0;0;0;0;0;0;0;0;0
FR;9;2021-02-28;0;0;0;0;0;0;0;0;0;0;0;0;0;0;0;0;0;0
FR;9;2021-03-01;0;0;0;0;0;0;0;0;0;0;0;0;0;0;0;0;0;0
FR;9;2021-03-02;0;0;0;0;0;0;0;0;0;0;0;0;0;0;0;0;0;0
FR;9;2021-03-03;0;0;0;0;0;0;0;0;0;0;0;0;0;0;0;0;0;0
FR;9;2021-03-04;0;0;0;0;0;0;0;0;0;0;0;0;0;0;0;0;0;0
FR;9;2021-03-05;0;0;0;0;0;0;0;0;0;0;0;0;0;0;0;0;0;0
FR;9;2021-03-06;0;0;0;0;0;0;0;0;0;0;0;0;0;0;0;0;0;0
FR;9;2021-03-07;0;0;0;0;0;0;0;0;0;0;0;0;0;0;0;0;0;0
FR;9;2021-03-08;0;0;0;0;0;0;0;0;0;0;0;0;0;0;0;0;0;0
FR;9;2021-03-09;0;0;0;0;0;0;0;0;0;0;0;0;0;0;0;0;0;0
FR;9;2021-03-10;0;0;0;0;0;0;0;0;0;0;0;0;0;0;0;0;0;0
FR;9;2021-03-11;0;0;0;0;0;0;0;0;0;0;0;0;0;0;0;0;0;0
FR;9;2021-03-12;0;0;0;0;0;0;0;0;0;0;0;0;0;0;0;0;0;0
FR;9;2021-03-13;0;0;0;0;0;0;0;0;0;0;0;0;0;0;0;0;0;0
FR;9;2021-03-14;0;0;0;0;0;0;0;0;0;0;0;0;0;0;0;0;0;0
FR;9;2021-03-15;0;0;0;0;0;0;0;0;0;0;0;0;0;0;0;0;0;0
FR;9;2021-03-16;0;0;0;0;0;0;0;0;0;0;0;0;0;0;0;0;0;0
FR;9;2021-03-17;0;0;0;0;0;0;0;0;0;0;0;0;0;0;0;0;0;0
FR;9;2021-03-18;0;0;0;0;0;0;0;0;0;0;0;0;0;0;0;0;0;0
FR;9;2021-03-19;0;0;0;0;0;0;0;0;0;0;0;0;0;0;0;0;0;0
FR;9;2021-03-20;0;0;0;0;0;0;0;0;0;0;0;0;0;0;0;0;0;0
FR;9;2021-03-21;0;0;0;0;0;0;0;0;0;0;0;0;0;0;0;0;0;0
FR;9;2021-03-22;0;0;0;0;0;0;0;0;0;0;0;0;0;0;0;0;0;0
FR;9;2021-03-23;0;0;0;0;0;0;0;0;0;0;0;0;0;0;0;0;0;0
FR;9;2021-03-24;0;0;0;0;0;0;0;0;0;0;0;0;0;0;0;0;0;0
FR;9;2021-03-25;0;0;0;0;0;0;0;0;0;0;0;0;0;0;0;0;0;0
FR;9;2021-03-26;0;0;0;0;0;0;0;0;0;0;0;0;0;0;0;0;0;0
FR;9;2021-03-27;0;0;0;0;0;0;0;0;0;0;0;0;0;0;0;0;0;0
FR;9;2021-03-28;0;0;0;0;0;0;0;0;0;0;0;0;0;0;0;0;0;0
FR;9;2021-03-29;0;0;0;0;0;0;0;0;0;0;0;0;0;0;0;0;0;0
FR;9;2021-03-30;0;0;0;0;0;0;0;0;0;0;0;0;0;0;0;0;0;0
FR;9;2021-03-31;0;0;0;0;0;0;0;0;0;0;0;0;0;0;0;0;0;0
FR;9;2021-04-01;0;0;0;0;0;0;0;0;0;0;0;0;0;0;0;0;0;0
FR;9;2021-04-02;0;0;0;0;0;0;0;0;0;0;0;0;0;0;0;0;0;0
FR;9;2021-04-03;0;0;0;0;0;0;0;0;0;0;0;0;0;0;0;0;0;0
FR;9;2021-04-04;0;0;0;0;0;0;0;0;0;0;0;0;0;0;0;0;0;0
FR;9;2021-04-05;0;0;0;0;0;0;0;0;0;0;0;0;0;0;0;0;0;0
FR;9;2021-04-06;0;0;0;0;0;0;0;0;0;0;0;0;0;0;0;0;0;0
FR;9;2021-04-07;0;0;0;0;0;0;0;0;0;0;0;0;0;0;0;0;0;0
FR;9;2021-04-08;0;0;0;0;0;0;0;0;0;0;0;0;0;0;0;0;0;0
FR;9;2021-04-09;0;0;0;0;0;0;0;0;0;0;0;0;0;0;0;0;0;0
FR;9;2021-04-10;0;0;0;0;0;0;0;0;0;0;0;0;0;0;0;0;0;0
FR;9;2021-04-11;0;0;0;0;0;0;0;0;0;0;0;0;0;0;0;0;0;0
FR;9;2021-04-12;0;0;0;0;0;0;0;0;0;0;0;0;0;0;0;0;0;0
FR;9;2021-04-13;0;0;0;0;0;0;0;0;0;0;0;0;0;0;0;0;0;0
FR;9;2021-04-14;0;0;0;0;0;0;0;0;0;0;0;0;0;0;0;0;0;0
FR;9;2021-04-15;0;0;0;0;0;0;0;0;0;0;0;0;0;0;0;0;0;0
FR;9;2021-04-16;0;0;0;0;0;0;0;0;0;0;0;0;0;0;0;0;0;0
FR;9;2021-04-17;0;0;0;0;0;0;0;0;0;0;0;0;0;0;0;0;0;0
FR;9;2021-04-18;0;0;0;0;0;0;0;0;0;0;0;0;0;0;0;0;0;0
FR;9;2021-04-19;0;0;0;0;0;0;0;0;0;0;0;0;0;0;0;0;0;0
FR;9;2021-04-20;0;0;0;0;0;0;0;0;0;0;0;0;0;0;0;0;0;0
FR;9;2021-04-21;0;0;0;0;0;0;0;0;0;0;0;0;0;0;0;0;0;0
FR;9;2021-04-22;0;0;0;0;0;0;0;0;0;0;0;0;0;0;0;0;0;0
FR;9;2021-04-23;0;0;0;0;0;0;0;0;0;0;0;0;0;0;0;0;0;0
FR;9;2021-04-24;0;0;0;0;0;0;0;0;0;0;0;0;0;0;0;0;0;0
FR;9;2021-04-25;0;0;0;0;0;0;0;0;0;0;0;0;0;0;0;0;0;0
FR;9;2021-04-26;0;0;0;0;0;0;0;0;0;0;0;0;0;0;0;0;0;0
FR;9;2021-04-27;0;0;0;0;0;0;0;0;0;0;0;0;0;0;0;0;0;0
FR;9;2021-04-28;0;0;0;0;0;0;0;0;0;0;0;0;0;0;0;0;0;0
FR;9;2021-04-29;0;0;0;0;0;0;0;0;0;0;0;0;0;0;0;0;0;0
FR;9;2021-04-30;0;0;0;0;0;0;0;0;0;0;0;0;0;0;0;0;0;0
FR;9;2021-05-01;0;0;0;0;0;0;0;0;0;0;0;0;0;0;0;0;0;0
FR;9;2021-05-02;0;0;0;0;0;0;0;0;0;0;0;0;0;0;0;0;0;0
FR;9;2021-05-03;0;0;0;0;0;0;0;0;0;0;0;0;0;0;0;0;0;0
FR;9;2021-05-04;0;0;0;0;0;0;0;0;0;0;0;0;0;0;0;0;0;0
FR;9;2021-05-05;0;0;0;0;0;0;0;0;0;0;0;0;0;0;0;0;0;0
FR;9;2021-05-06;0;0;0;0;0;0;0;0;0;0;0;0;0;0;0;0;0;0
FR;9;2021-05-07;0;0;0;0;0;0;0;0;0;0;0;0;0;0;0;0;0;0
FR;9;2021-05-08;0;0;0;0;0;0;0;0;0;0;0;0;0;0;0;0;0;0
FR;9;2021-05-09;0;0;0;0;0;0;0;0;0;0;0;0;0;0;0;0;0;0
FR;9;2021-05-10;0;0;0;0;0;0;0;0;0;0;0;0;0;0;0;0;0;0
FR;9;2021-05-11;0;0;0;0;0;0;0;0;0;0;0;0;0;0;0;0;0;0
FR;9;2021-05-12;0;0;0;0;0;0;0;0;0;0;0;0;0;0;0;0;0;0
FR;9;2021-05-13;0;0;0;0;0;0;0;0;0;0;0;0;0;0;0;0;0;0
FR;9;2021-05-14;0;0;0;0;0;0;0;0;0;0;0;0;0;0;0;0;0;0
FR;9;2021-05-15;0;0;0;0;0;0;0;0;0;0;0;0;0;0;0;0;0;0
FR;9;2021-05-16;0;0;0;0;0;0;0;0;0;0;0;0;0;0;0;0;0;0
FR;9;2021-05-17;0;0;0;0;0;0;0;0;0;0;0;0;0;0;0;0;0;0
FR;9;2021-05-18;0;0;0;0;0;0;0;0;0;0;0;0;0;0;0;0;0;0
FR;9;2021-05-19;0;0;0;0;0;0;0;0;0;0;0;0;0;0;0;0;0;0
FR;9;2021-05-20;0;0;0;0;0;0;0;0;0;0;0;0;0;0;0;0;0;0
FR;9;2021-05-21;0;0;0;0;0;0;0;0;0;0;0;0;0;0;0;0;0;0
FR;9;2021-05-22;0;0;0;0;0;0;0;0;0;0;0;0;0;0;0;0;0;0
FR;9;2021-05-23;0;0;0;0;0;0;0;0;0;0;0;0;0;0;0;0;0;0
FR;9;2021-05-24;0;0;0;0;0;0;0;0;0;0;0;0;0;0;0;0;0;0
FR;9;2021-05-25;0;0;0;0;0;0;0;0;0;0;0;0;0;0;0;0;0;0
FR;9;2021-05-26;0;0;0;0;0;0;0;0;0;0;0;0;0;0;0;0;0;0
FR;9;2021-05-27;0;0;0;0;0;0;0;0;0;0;0;0;0;0;0;0;0;0
FR;9;2021-05-28;0;0;0;0;0;0;0;0;0;0;0;0;0;0;0;0;0;0
FR;9;2021-05-29;0;0;0;0;0;0;0;0;0;0;0;0;0;0;0;0;0;0
FR;9;2021-05-30;0;0;0;0;0;0;0;0;0;0;0;0;0;0;0;0;0;0
FR;9;2021-05-31;0;0;0;0;0;0;0;0;0;0;0;0;0;0;0;0;0;0
FR;9;2021-06-01;0;0;0;0;0;0;0;0;0;0;0;0;0;0;0;0;0;0
FR;9;2021-06-02;0;0;0;0;0;0;0;0;0;0;0;0;0;0;0;0;0;0
FR;9;2021-06-03;0;0;0;0;0;0;0;0;0;0;0;0;0;0;0;0;0;0
FR;9;2021-06-04;0;0;0;0;0;0;0;0;0;0;0;0;0;0;0;0;0;0
FR;9;2021-06-05;0;0;0;0;0;0;0;0;0;0;0;0;0;0;0;0;0;0
FR;9;2021-06-06;0;0;0;0;0;0;0;0;0;0;0;0;0;0;0;0;0;0
FR;9;2021-06-07;0;0;0;0;0;0;0;0;0;0;0;0;0;0;0;0;0;0
FR;9;2021-06-08;0;0;0;0;0;0;0;0;0;0;0;0;0;0;0;0;0;0
FR;9;2021-06-09;0;0;0;0;0;0;0;0;0;0;0;0;0;0;0;0;0;0
FR;9;2021-06-10;0;0;0;0;0;0;0;0;0;0;0;0;0;0;0;0;0;0
FR;9;2021-06-11;0;0;0;0;0;0;0;0;0;0;0;0;0;0;0;0;0;0
FR;9;2021-06-12;0;0;0;0;0;0;0;0;0;0;0;0;0;0;0;0;0;0
FR;9;2021-06-13;0;0;0;0;0;0;0;0;0;0;0;0;0;0;0;0;0;0
FR;9;2021-06-14;0;0;0;0;0;0;0;0;0;0;0;0;0;0;0;0;0;0
FR;9;2021-06-15;0;0;0;0;0;0;0;0;0;0;0;0;0;0;0;0;0;0
FR;9;2021-06-16;0;0;0;0;0;0;0;0;0;0;0;0;0;0;0;0;0;0
FR;9;2021-06-17;0;0;0;0;0;0;0;0;0;0;0;0;0;0;0;0;0;0
FR;9;2021-06-18;0;0;0;0;0;0;0;0;0;0;0;0;0;0;0;0;0;0
FR;9;2021-06-19;0;0;0;0;0;0;0;0;0;0;0;0;0;0;0;0;0;0
FR;9;2021-06-20;0;0;0;0;0;0;0;0;0;0;0;0;0;0;0;0;0;0
FR;9;2021-06-21;0;0;0;0;0;0;0;0;0;0;0;0;0;0;0;0;0;0
FR;9;2021-06-22;0;0;0;0;0;0;0;0;0;0;0;0;0;0;0;0;0;0
FR;9;2021-06-23;0;0;0;0;0;0;0;0;0;0;0;0;0;0;0;0;0;0
FR;9;2021-06-24;0;0;0;0;0;0;0;0;0;0;0;0;0;0;0;0;0;0
FR;9;2021-06-25;0;0;0;0;0;0;0;0;0;0;0;0;0;0;0;0;0;0
FR;9;2021-06-26;0;0;0;0;0;0;0;0;0;0;0;0;0;0;0;0;0;0
FR;9;2021-06-27;0;0;0;0;0;0;0;0;0;0;0;0;0;0;0;0;0;0
FR;9;2021-06-28;0;0;0;0;0;0;0;0;0;0;0;0;0;0;0;0;0;0
FR;9;2021-06-29;0;0;0;0;0;0;0;0;0;0;0;0;0;0;0;0;0;0
FR;9;2021-06-30;0;0;0;0;0;0;0;0;0;0;0;0;0;0;0;0;0;0
FR;9;2021-07-01;0;0;0;0;0;0;0;0;0;0;0;0;0;0;0;0;0;0
FR;9;2021-07-02;0;0;0;0;0;0;0;0;0;0;0;0;0;0;0;0;0;0
FR;9;2021-07-03;0;0;0;0;0;0;0;0;0;0;0;0;0;0;0;0;0;0
FR;9;2021-07-04;0;0;0;0;0;0;0;0;0;0;0;0;0;0;0;0;0;0
FR;9;2021-07-05;0;0;0;0;0;0;0;0;0;0;0;0;0;0;0;0;0;0
FR;9;2021-07-06;0;0;0;0;0;0;0;0;0;0;0;0;0;0;0;0;0;0
FR;9;2021-07-07;0;0;0;0;0;0;0;0;0;0;0;0;0;0;0;0;0;0
FR;9;2021-07-08;0;0;0;0;0;0;0;0;0;0;0;0;0;0;0;0;0;0
FR;9;2021-07-09;0;0;0;0;0;0;0;0;0;0;0;0;0;0;0;0;0;0
FR;9;2021-07-10;0;0;0;0;0;0;0;0;0;0;0;0;0;0;0;0;0;0
FR;9;2021-07-11;0;0;0;0;0;0;0;0;0;0;0;0;0;0;0;0;0;0
FR;9;2021-07-12;0;0;0;0;0;0;0;0;0;0;0;0;0;0;0;0;0;0
FR;9;2021-07-13;0;0;0;0;0;0;0;0;0;0;0;0;0;0;0;0;0;0
FR;9;2021-07-14;0;0;0;0;0;0;0;0;0;0;0;0;0;0;0;0;0;0
FR;9;2021-07-15;0;0;0;0;0;0;0;0;0;0;0;0;0;0;0;0;0;0
FR;9;2021-07-16;0;0;0;0;0;0;0;0;0;0;0;0;0;0;0;0;0;0
FR;9;2021-07-17;0;0;0;0;0;0;0;0;0;0;0;0;0;0;0;0;0;0
FR;9;2021-07-18;0;0;0;0;0;0;0;0;0;0;0;0;0;0;0;0;0;0
FR;9;2021-07-19;0;0;0;0;0;0;0;0;0;0;0;0;0;0;0;0;0;0
FR;9;2021-07-20;0;0;0;0;0;0;0;0;0;0;0;0;0;0;0;0;0;0
FR;9;2021-07-21;0;0;0;0;0;0;0;0;0;0;0;0;0;0;0;0;0;0
FR;9;2021-07-22;0;0;0;0;0;0;0;0;0;0;0;0;0;0;0;0;0;0
FR;9;2021-07-23;0;0;0;0;0;0;0;0;0;0;0;0;0;0;0;0;0;0
FR;9;2021-07-24;0;0;0;0;0;0;0;0;0;0;0;0;0;0;0;0;0;0
FR;9;2021-07-25;0;0;0;0;0;0;0;0;0;0;0;0;0;0;0;0;0;0
FR;9;2021-07-26;0;0;0;0;0;0;0;0;0;0;0;0;0;0;0;0;0;0
FR;9;2021-07-27;0;0;0;0;0;0;0;0;0;0;0;0;0;0;0;0;0;0
FR;9;2021-07-28;0;0;0;0;0;0;0;0;0;0;0;0;0;0;0;0;0;0
FR;9;2021-07-29;0;0;0;0;0;0;0;0;0;0;0;0;0;0;0;0;0;0
FR;9;2021-07-30;0;0;0;0;0;0;0;0;0;0;0;0;0;0;0;0;0;0
FR;9;2021-07-31;0;0;0;0;0;0;0;0;0;0;0;0;0;0;0;0;0;0
FR;9;2021-08-01;0;0;0;0;0;0;0;0;0;0;0;0;0;0;0;0;0;0
FR;9;2021-08-02;0;0;0;0;0;0;0;0;0;0;0;0;0;0;0;0;0;0
FR;9;2021-08-03;0;0;0;0;0;0;0;0;0;0;0;0;0;0;0;0;0;0
FR;9;2021-08-04;0;0;0;0;0;0;0;0;0;0;0;0;0;0;0;0;0;0
FR;9;2021-08-05;0;0;0;0;0;0;0;0;0;0;0;0;0;0;0;0;0;0
FR;9;2021-08-06;0;0;0;0;0;0;0;0;0;0;0;0;0;0;0;0;0;0
FR;9;2021-08-07;0;0;0;0;0;0;0;0;0;0;0;0;0;0;0;0;0;0
FR;9;2021-08-08;0;0;0;0;0;0;0;0;0;0;0;0;0;0;0;0;0;0
FR;9;2021-08-09;0;0;0;0;0;0;0;0;0;0;0;0;0;0;0;0;0;0
FR;9;2021-08-10;0;0;0;0;0;0;0;0;0;0;0;0;0;0;0;0;0;0
FR;9;2021-08-11;0;0;0;0;0;0;0;0;0;0;0;0;0;0;0;0;0;0
FR;9;2021-08-12;0;0;0;0;0;0;0;0;0;0;0;0;0;0;0;0;0;0
FR;9;2021-08-13;0;0;0;0;0;0;0;0;0;0;0;0;0;0;0;0;0;0
FR;9;2021-08-14;0;0;0;0;0;0;0;0;0;0;0;0;0;0;0;0;0;0
FR;9;2021-08-15;0;0;0;0;0;0;0;0;0;0;0;0;0;0;0;0;0;0
FR;9;2021-08-16;0;0;0;0;0;0;0;0;0;0;0;0;0;0;0;0;0;0
FR;9;2021-08-17;0;0;0;0;0;0;0;0;0;0;0;0;0;0;0;0;0;0
FR;9;2021-08-18;0;0;0;0;0;0;0;0;0;0;0;0;0;0;0;0;0;0
FR;9;2021-08-19;0;0;0;0;0;0;0;0;0;0;0;0;0;0;0;0;0;0
FR;9;2021-08-20;0;0;0;0;0;0;0;0;0;0;0;0;0;0;0;0;0;0
FR;9;2021-08-21;0;0;0;0;0;0;0;0;0;0;0;0;0;0;0;0;0;0
FR;9;2021-08-22;0;0;0;0;0;0;0;0;0;0;0;0;0;0;0;0;0;0
FR;9;2021-08-23;0;0;0;0;0;0;0;0;0;0;0;0;0;0;0;0;0;0
FR;9;2021-08-24;0;0;0;0;0;0;0;0;0;0;0;0;0;0;0;0;0;0
FR;9;2021-08-25;0;0;0;0;0;0;0;0;0;0;0;0;0;0;0;0;0;0
FR;9;2021-08-26;0;0;0;0;0;0;0;0;0;0;0;0;0;0;0;0;0;0
FR;9;2021-08-27;0;0;0;0;0;0;0;0;0;0;0;0;0;0;0;0;0;0
FR;9;2021-08-28;0;0;0;0;0;0;0;0;0;0;0;0;0;0;0;0;0;0
FR;9;2021-08-29;0;0;0;0;0;0;0;0;0;0;0;0;0;0;0;0;0;0
FR;9;2021-08-30;0;0;0;0;0;0;0;0;0;0;0;0;0;0;0;0;0;0
FR;9;2021-08-31;0;0;0;0;0;0;0;0;0;0;0;0;0;0;0;0;0;0
FR;9;2021-09-01;0;0;0;0;0;0;0;0;0;0;0;0;0;0;0;0;0;0
FR;9;2021-09-02;0;0;0;0;0;0;0;0;0;0;0;0;0;0;0;0;0;0
FR;9;2021-09-03;0;0;0;0;0;0;0;0;0;0;0;0;0;0;0;0;0;0
FR;9;2021-09-04;0;0;0;0;0;0;0;0;0;0;0;0;0;0;0;0;0;0
FR;9;2021-09-05;0;0;0;0;0;0;0;0;0;0;0;0;0;0;0;0;0;0
FR;9;2021-09-06;0;0;0;0;0;0;0;0;0;0;0;0;0;0;0;0;0;0
FR;9;2021-09-07;0;0;0;0;0;0;0;0;0;0;0;0;0;0;0;0;0;0
FR;9;2021-09-08;0;0;0;0;0;0;0;0;0;0;0;0;0;0;0;0;0;0
FR;9;2021-09-09;0;0;0;0;0;0;0;0;0;0;0;0;0;0;0;0;0;0
FR;9;2021-09-10;0;0;0;0;0;0;0;0;0;0;0;0;0;0;0;0;0;0
FR;9;2021-09-11;0;0;0;0;0;0;0;0;0;0;0;0;0;0;0;0;0;0
FR;9;2021-09-12;0;0;0;0;0;0;0;0;0;0;0;0;0;0;0;0;0;0
FR;9;2021-09-13;0;0;0;0;0;0;0;0;0;0;0;0;0;0;0;0;0;0
FR;9;2021-09-14;0;0;0;0;0;0;0;0;0;0;0;0;0;0;0;0;0;0
FR;9;2021-09-15;0;0;0;0;0;0;0;0;0;0;0;0;0;0;0;0;0;0
FR;9;2021-09-16;0;0;0;0;0;0;0;0;0;0;0;0;0;0;0;0;0;0
FR;9;2021-09-17;0;0;0;0;0;0;0;0;0;0;0;0;0;0;0;0;0;0
FR;9;2021-09-18;0;0;0;0;0;0;0;0;0;0;0;0;0;0;0;0;0;0
FR;9;2021-09-19;0;0;0;0;0;0;0;0;0;0;0;0;0;0;0;0;0;0
FR;9;2021-09-20;0;0;0;0;0;0;0;0;0;0;0;0;0;0;0;0;0;0
FR;9;2021-09-21;0;0;0;0;0;0;0;0;0;0;0;0;0;0;0;0;0;0
FR;9;2021-09-22;0;0;0;0;0;0;0;0;0;0;0;0;0;0;0;0;0;0
FR;9;2021-09-23;0;0;0;0;0;0;0;0;0;0;0;0;0;0;0;0;0;0
FR;9;2021-09-24;0;0;0;0;0;0;0;0;0;0;0;0;0;0;0;0;0;0
FR;9;2021-09-25;0;0;0;0;0;0;0;0;0;0;0;0;0;0;0;0;0;0
FR;9;2021-09-26;0;0;0;0;0;0;0;0;0;0;0;0;0;0;0;0;0;0
FR;9;2021-09-27;0;0;0;0;0;0;0;0;0;0;0;0;0;0;0;0;0;0
FR;9;2021-09-28;0;0;0;0;0;0;0;0;0;0;0;0;0;0;0;0;0;0
FR;9;2021-09-29;0;0;0;0;0;0;0;0;0;0;0;0;0;0;0;0;0;0
FR;9;2021-09-30;0;0;0;0;0;0;0;0;0;0;0;0;0;0;0;0;0;0
FR;9;2021-10-01;0;0;0;0;0;0;0;0;0;0;0;0;0;0;0;0;0;0
FR;9;2021-10-02;0;0;0;0;0;0;0;0;0;0;0;0;0;0;0;0;0;0
FR;9;2021-10-03;0;0;0;0;0;0;0;0;0;0;0;0;0;0;0;0;0;0
FR;9;2021-10-04;0;0;0;0;0;0;0;0;0;0;0;0;0;0;0;0;0;0
FR;9;2021-10-05;0;0;0;0;0;0;0;0;0;0;0;0;0;0;0;0;0;0
FR;9;2021-10-06;0;0;0;0;0;0;0;0;0;0;0;0;0;0;0;0;0;0
FR;9;2021-10-07;0;0;0;0;0;0;0;0;0;0;0;0;0;0;0;0;0;0
FR;9;2021-10-08;0;0;0;0;0;0;0;0;0;0;0;0;0;0;0;0;0;0
FR;9;2021-10-09;0;0;0;0;0;0;0;0;0;0;0;0;0;0;0;0;0;0
FR;9;2021-10-10;0;0;0;0;0;0;0;0;0;0;0;0;0;0;0;0;0;0
FR;9;2021-10-11;0;0;0;0;0;0;0;0;0;0;0;0;0;0;0;0;0;0
FR;9;2021-10-12;0;0;0;0;0;0;0;0;0;0;0;0;0;0;0;0;0;0
FR;9;2021-10-13;0;0;0;0;0;0;0;0;0;0;0;0;0;0;0;0;0;0
FR;9;2021-10-14;0;0;0;0;0;0;0;0;0;0;0;0;0;0;0;0;0;0
FR;9;2021-10-15;0;0;0;0;0;0;0;0;0;0;0;0;0;0;0;0;0;0
FR;9;2021-10-16;0;0;0;0;0;0;0;0;0;0;0;0;0;0;0;0;0;0
FR;9;2021-10-17;0;0;0;0;0;0;0;0;0;0;0;0;0;0;0;0;0;0
FR;9;2021-10-18;0;0;0;0;0;0;0;0;0;0;0;0;0;0;0;0;0;0
FR;9;2021-10-19;0;0;0;0;0;0;0;0;0;0;0;0;0;0;0;0;0;0
FR;9;2021-10-20;0;0;0;0;0;0;0;0;0;0;0;0;0;0;0;0;0;0
FR;9;2021-10-21;0;0;0;0;0;0;0;0;0;0;0;0;0;0;0;0;0;0
FR;9;2021-10-22;0;0;0;0;0;0;0;0;0;0;0;0;0;0;0;0;0;0
FR;9;2021-10-23;0;0;0;0;0;0;0;0;0;0;0;0;0;0;0;0;0;0
FR;9;2021-10-24;0;0;0;0;0;0;0;0;0;0;0;0;0;0;0;0;0;0
FR;9;2021-10-25;0;0;0;0;0;0;0;0;0;0;0;0;0;0;0;0;0;0
FR;9;2021-10-26;0;0;0;0;0;0;0;0;0;0;0;0;0;0;0;0;0;0
FR;9;2021-10-27;0;0;0;0;0;0;0;0;0;0;0;0;0;0;0;0;0;0
FR;9;2021-10-28;0;0;0;0;0;0;0;0;0;0;0;0;0;0;0;0;0;0
FR;9;2021-10-29;0;0;0;0;0;0;0;0;0;0;0;0;0;0;0;0;0;0
FR;9;2021-10-30;0;0;0;0;0;0;0;0;0;0;0;0;0;0;0;0;0;0
FR;9;2021-10-31;0;0;0;0;0;0;0;0;0;0;0;0;0;0;0;0;0;0
FR;9;2021-11-01;0;0;0;0;0;0;0;0;0;0;0;0;0;0;0;0;0;0
FR;9;2021-11-02;0;0;0;0;0;0;0;0;0;0;0;0;0;0;0;0;0;0
FR;9;2021-11-03;0;0;0;0;0;0;0;0;0;0;0;0;0;0;0;0;0;0
FR;9;2021-11-04;0;0;0;0;0;0;0;0;0;0;0;0;0;0;0;0;0;0
FR;9;2021-11-05;0;0;0;0;0;0;0;0;0;0;0;0;0;0;0;0;0;0
FR;9;2021-11-06;0;0;0;0;0;0;0;0;0;0;0;0;0;0;0;0;0;0
FR;9;2021-11-07;0;0;0;0;0;0;0;0;0;0;0;0;0;0;0;0;0;0
FR;9;2021-11-08;0;0;0;0;0;0;0;0;0;0;0;0;0;0;0;0;0;0
FR;9;2021-11-09;0;0;0;0;0;0;0;0;0;0;0;0;0;0;0;0;0;0
FR;9;2021-11-10;0;0;0;0;0;0;0;0;0;0;0;0;0;0;0;0;0;0
FR;9;2021-11-11;0;0;0;0;0;0;0;0;0;0;0;0;0;0;0;0;0;0
FR;9;2021-11-12;0;0;0;0;0;0;0;0;0;0;0;0;0;0;0;0;0;0
FR;9;2021-11-13;0;0;0;0;0;0;0;0;0;0;0;0;0;0;0;0;0;0
FR;9;2021-11-14;0;0;0;0;0;0;0;0;0;0;0;0;0;0;0;0;0;0
FR;9;2021-11-15;0;0;0;0;0;0;0;0;0;0;0;0;0;0;0;0;0;0
FR;9;2021-11-16;0;0;0;0;0;0;0;0;0;0;0;0;0;0;0;0;0;0
FR;9;2021-11-17;0;0;0;0;0;0;0;0;0;0;0;0;0;0;0;0;0;0
FR;9;2021-11-18;0;0;0;0;0;0;0;0;0;0;0;0;0;0;0;0;0;0
FR;9;2021-11-19;0;0;0;0;0;0;0;0;0;0;0;0;0;0;0;0;0;0
FR;9;2021-11-20;0;0;0;0;0;0;0;0;0;0;0;0;0;0;0;0;0;0
FR;9;2021-11-21;0;0;0;0;0;0;0;0;0;0;0;0;0;0;0;0;0;0
FR;9;2021-11-22;0;0;0;0;0;0;0;0;0;0;0;0;0;0;0;0;0;0
FR;9;2021-11-23;0;0;0;0;0;0;0;0;0;0;0;0;0;0;0;0;0;0
FR;9;2021-11-24;0;0;0;0;0;0;0;0;0;0;0;0;0;0;0;0;0;0
FR;9;2021-11-25;0;0;0;0;0;0;0;0;0;0;0;0;0;0;0;0;0;0
FR;9;2021-11-26;0;0;0;0;0;0;0;0;0;0;0;0;0;0;0;0;0;0
FR;9;2021-11-27;0;0;0;0;0;0;0;0;0;0;0;0;0;0;0;0;0;0
FR;9;2021-11-28;0;0;0;0;0;0;0;0;0;0;0;0;0;0;0;0;0;0
FR;9;2021-11-29;0;0;0;0;0;0;0;0;0;0;0;0;0;0;0;0;0;0
FR;9;2021-11-30;0;0;0;0;0;0;0;0;0;0;0;0;0;0;0;0;0;0
FR;9;2021-12-01;0;0;0;0;0;0;0;0;0;0;0;0;0;0;0;0;0;0
FR;9;2021-12-02;0;0;0;0;0;0;0;0;0;0;0;0;0;0;0;0;0;0
FR;9;2021-12-03;0;0;0;0;0;0;0;0;0;0;0;0;0;0;0;0;0;0
FR;9;2021-12-04;0;0;0;0;0;0;0;0;0;0;0;0;0;0;0;0;0;0
FR;9;2021-12-05;0;0;0;0;0;0;0;0;0;0;0;0;0;0;0;0;0;0
FR;9;2021-12-06;0;0;0;0;0;0;0;0;0;0;0;0;0;0;0;0;0;0
FR;9;2021-12-07;0;0;0;0;0;0;0;0;0;0;0;0;0;0;0;0;0;0
FR;9;2021-12-08;0;0;0;0;0;0;0;0;0;0;0;0;0;0;0;0;0;0
FR;9;2021-12-09;0;0;0;0;0;0;0;0;0;0;0;0;0;0;0;0;0;0
FR;9;2021-12-10;0;0;0;0;0;0;0;0;0;0;0;0;0;0;0;0;0;0
FR;9;2021-12-11;0;0;0;0;0;0;0;0;0;0;0;0;0;0;0;0;0;0
FR;9;2021-12-12;0;0;0;0;0;0;0;0;0;0;0;0;0;0;0;0;0;0
FR;9;2021-12-13;0;0;0;0;0;0;0;0;0;0;0;0;0;0;0;0;0;0
FR;9;2021-12-14;0;0;0;0;0;0;0;0;0;0;0;0;0;0;0;0;0;0
FR;9;2021-12-15;0;0;0;0;0;0;0;0;0;0;0;0;0;0;0;0;0;0
FR;9;2021-12-16;0;0;0;0;0;0;0;0;0;0;0;0;0;0;0;0;0;0
FR;9;2021-12-17;0;0;0;0;0;0;0;0;0;0;0;0;0;0;0;0;0;0
FR;9;2021-12-18;0;0;0;0;0;0;0;0;0;0;0;0;0;0;0;0;0;0
FR;9;2021-12-19;0;0;0;0;0;0;0;0;0;0;0;0;0;0;0;0;0;0
FR;9;2021-12-20;0;0;0;0;0;0;0;0;0;0;0;0;0;0;0;0;0;0
FR;9;2021-12-21;0;0;0;0;0;0;0;0;0;0;0;0;0;0;0;0;0;0
FR;9;2021-12-22;0;0;0;0;0;0;0;0;0;0;0;0;0;0;0;0;0;0
FR;9;2021-12-23;0;0;0;0;0;0;0;0;0;0;0;0;0;0;0;0;0;0
FR;9;2021-12-24;0;0;0;0;0;0;0;0;0;0;0;0;0;0;0;0;0;0
FR;9;2021-12-25;0;0;0;0;0;0;0;0;0;0;0;0;0;0;0;0;0;0
FR;9;2021-12-26;0;0;0;0;0;0;0;0;0;0;0;0;0;0;0;0;0;0
FR;9;2021-12-27;0;0;0;0;0;0;0;0;0;0;0;0;0;0;0;0;0;0
FR;9;2021-12-28;0;0;0;0;0;0;0;0;0;0;0;0;0;0;0;0;0;0
FR;9;2021-12-29;0;0;0;0;0;0;0;0;0;0;0;0;0;0;0;0;0;0
FR;9;2021-12-30;0;0;0;0;0;0;0;0;0;0;0;0;0;0;0;0;0;0
FR;9;2021-12-31;0;0;0;0;0;0;0;0;0;0;0;0;0;0;0;0;0;0
FR;9;2022-01-01;0;0;0;0;0;0;0;0;0;0;0;0;0;0;0;0;0;0
FR;9;2022-01-02;0;0;0;0;0;0;0;0;0;0;0;0;0;0;0;0;0;0
FR;9;2022-01-03;0;0;0;0;0;0;0;0;0;0;0;0;0;0;0;0;0;0
FR;9;2022-01-04;0;0;0;0;0;0;0;0;0;0;0;0;0;0;0;0;0;0
FR;9;2022-01-05;0;0;0;0;0;0;0;0;0;0;0;0;0;0;0;0;0;0
FR;9;2022-01-06;0;0;0;0;0;0;0;0;0;0;0;0;0;0;0;0;0;0
FR;9;2022-01-07;0;0;0;0;0;0;0;0;0;0;0;0;0;0;0;0;0;0
FR;9;2022-01-08;0;0;0;0;0;0;0;0;0;0;0;0;0;0;0;0;0;0
FR;9;2022-01-09;0;0;0;0;0;0;0;0;0;0;0;0;0;0;0;0;0;0
FR;9;2022-01-10;0;0;0;0;0;0;0;0;0;0;0;0;0;0;0;0;0;0
FR;9;2022-01-11;0;0;0;0;0;0;0;0;0;0;0;0;0;0;0;0;0;0
FR;9;2022-01-12;0;0;0;0;0;0;0;0;0;0;0;0;0;0;0;0;0;0
FR;9;2022-01-13;0;0;0;0;0;0;0;0;0;0;0;0;0;0;0;0;0;0
FR;9;2022-01-14;0;0;0;0;0;0;0;0;0;0;0;0;0;0;0;0;0;0
FR;9;2022-01-15;0;0;0;0;0;0;0;0;0;0;0;0;0;0;0;0;0;0
FR;9;2022-01-16;0;0;0;0;0;0;0;0;0;0;0;0;0;0;0;0;0;0
FR;9;2022-01-17;0;0;0;0;0;0;0;0;0;0;0;0;0;0;0;0;0;0
FR;9;2022-01-18;0;0;0;0;0;0;0;0;0;0;0;0;0;0;0;0;0;0
FR;9;2022-01-19;0;0;0;0;0;0;0;0;0;0;0;0;0;0;0;0;0;0
FR;9;2022-01-20;0;0;0;0;0;0;0;0;0;0;0;0;0;0;0;0;0;0
FR;9;2022-01-21;0;0;0;0;0;0;0;0;0;0;0;0;0;0;0;0;0;0
FR;9;2022-01-22;0;0;0;0;0;0;0;0;0;0;0;0;0;0;0;0;0;0
FR;9;2022-01-23;0;0;0;0;0;0;0;0;0;0;0;0;0;0;0;0;0;0
FR;9;2022-01-24;0;0;0;0;0;0;0;0;0;0;0;0;0;0;0;0;0;0
FR;9;2022-01-25;0;0;0;0;0;0;0;0;0;0;0;0;0;0;0;0;0;0
FR;9;2022-01-26;0;0;0;0;0;0;0;0;0;0;0;0;0;0;0;0;0;0
FR;9;2022-01-27;0;0;0;0;0;0;0;0;0;0;0;0;0;0;0;0;0;0
FR;9;2022-01-28;0;0;0;0;0;0;0;0;0;0;0;0;0;0;0;0;0;0
FR;9;2022-01-29;0;0;0;0;0;0;0;0;0;0;0;0;0;0;0;0;0;0
FR;9;2022-01-30;0;0;0;0;0;0;0;0;0;0;0;0;0;0;0;0;0;0
FR;9;2022-01-31;0;0;0;0;0;0;0;0;0;0;0;0;0;0;0;0;0;0
FR;9;2022-02-01;0;0;0;0;0;0;0;0;0;0;0;0;0;0;0;0;0;0
FR;9;2022-02-02;0;0;0;0;0;0;0;0;0;0;0;0;0;0;0;0;0;0
FR;9;2022-02-03;0;0;0;0;0;0;0;0;0;0;0;0;0;0;0;0;0;0
FR;9;2022-02-04;0;0;0;0;0;0;0;0;0;0;0;0;0;0;0;0;0;0
FR;9;2022-02-05;0;0;0;0;0;0;0;0;0;0;0;0;0;0;0;0;0;0
FR;9;2022-02-06;0;0;0;0;0;0;0;0;0;0;0;0;0;0;0;0;0;0
FR;9;2022-02-07;0;0;0;0;0;0;0;0;0;0;0;0;0;0;0;0;0;0
FR;9;2022-02-08;0;0;0;0;0;0;0;0;0;0;0;0;0;0;0;0;0;0
FR;9;2022-02-09;0;0;0;0;0;0;0;0;0;0;0;0;0;0;0;0;0;0
FR;9;2022-02-10;0;0;0;0;0;0;0;0;0;0;0;0;0;0;0;0;0;0
FR;9;2022-02-11;0;0;0;0;0;0;0;0;0;0;0;0;0;0;0;0;0;0
FR;9;2022-02-12;0;0;0;0;0;0;0;0;0;0;0;0;0;0;0;0;0;0
FR;9;2022-02-13;0;0;0;0;0;0;0;0;0;0;0;0;0;0;0;0;0;0
FR;9;2022-02-14;0;0;0;0;0;0;0;0;0;0;0;0;0;0;0;0;0;0
FR;9;2022-02-15;0;0;0;0;0;0;0;0;0;0;0;0;0;0;0;0;0;0
FR;9;2022-02-16;0;0;0;0;0;0;0;0;0;0;0;0;0;0;0;0;0;0
FR;9;2022-02-17;0;0;0;0;0;0;0;0;0;0;0;0;0;0;0;0;0;0
FR;9;2022-02-18;0;0;0;0;0;0;0;0;0;0;0;0;0;0;0;0;0;0
FR;9;2022-02-19;0;0;0;0;0;0;0;0;0;0;0;0;0;0;0;0;0;0
FR;9;2022-02-20;0;0;0;0;0;0;0;0;0;0;0;0;0;0;0;0;0;0
FR;9;2022-02-21;0;0;0;0;0;0;0;0;0;0;0;0;0;0;0;0;0;0
FR;9;2022-02-22;0;0;0;0;0;0;0;0;0;0;0;0;0;0;0;0;0;0
FR;9;2022-02-23;0;0;0;0;0;0;0;0;0;0;0;0;0;0;0;0;0;0
FR;9;2022-02-24;0;0;0;0;0;0;0;0;0;0;0;0;0;0;0;0;0;0
FR;9;2022-02-25;0;0;0;0;0;0;0;0;0;0;0;0;0;0;0;0;0;0
FR;9;2022-02-26;0;0;0;0;0;0;0;0;0;0;0;0;0;0;0;0;0;0
FR;9;2022-02-27;0;0;0;0;0;0;0;0;0;0;0;0;0;0;0;0;0;0
FR;9;2022-02-28;0;0;0;0;0;0;0;0;0;0;0;0;0;0;0;0;0;0
FR;9;2022-03-01;0;0;0;0;0;0;0;0;0;0;0;0;0;0;0;0;0;0
FR;9;2022-03-02;0;0;0;0;0;0;0;0;0;0;0;0;0;0;0;0;0;0
FR;9;2022-03-03;0;0;0;0;0;0;0;0;0;0;0;0;0;0;0;0;0;0
FR;9;2022-03-04;0;0;0;0;0;0;0;0;0;0;0;0;0;0;0;0;0;0
FR;9;2022-03-05;0;0;0;0;0;0;0;0;0;0;0;0;0;0;0;0;0;0
FR;9;2022-03-06;0;0;0;0;0;0;0;0;0;0;0;0;0;0;0;0;0;0
FR;9;2022-03-07;0;0;0;0;0;0;0;0;0;0;0;0;0;0;0;0;0;0
FR;9;2022-03-08;0;0;0;0;0;0;0;0;0;0;0;0;0;0;0;0;0;0
FR;9;2022-03-09;0;0;0;0;0;0;0;0;0;0;0;0;0;0;0;0;0;0
FR;9;2022-03-10;0;0;0;0;0;0;0;0;0;0;0;0;0;0;0;0;0;0
FR;9;2022-03-11;0;0;0;0;0;0;0;0;0;0;0;0;0;0;0;0;0;0
FR;9;2022-03-12;0;0;0;0;0;0;0;0;0;0;0;0;0;0;0;0;0;0
FR;9;2022-03-13;0;0;0;0;0;0;0;0;0;0;0;0;0;0;0;0;0;0
FR;9;2022-03-14;0;0;0;0;0;0;0;0;0;0;0;0;0;0;0;0;0;0
FR;9;2022-03-15;0;0;0;0;0;0;0;0;0;0;0;0;0;0;0;0;0;0
FR;9;2022-03-16;0;0;0;0;0;0;0;0;0;0;0;0;0;0;0;0;0;0
FR;9;2022-03-17;0;0;0;0;0;0;0;0;0;0;0;0;0;0;0;0;0;0
FR;9;2022-03-18;0;0;0;0;0;0;0;0;0;0;0;0;0;0;0;0;0;0
FR;9;2022-03-19;0;0;0;0;0;0;0;0;0;0;0;0;0;0;0;0;0;0
FR;9;2022-03-20;0;0;0;0;0;0;0;0;0;0;0;0;0;0;0;0;0;0
FR;9;2022-03-21;0;0;0;0;0;0;0;0;0;0;0;0;0;0;0;0;0;0
FR;9;2022-03-22;0;0;0;0;0;0;0;0;0;0;0;0;0;0;0;0;0;0
FR;9;2022-03-23;0;0;0;0;0;0;0;0;0;0;0;0;0;0;0;0;0;0
FR;9;2022-03-24;0;0;0;0;0;0;0;0;0;0;0;0;0;0;0;0;0;0
FR;9;2022-03-25;0;0;0;0;0;0;0;0;0;0;0;0;0;0;0;0;0;0
FR;9;2022-03-26;0;0;0;0;0;0;0;0;0;0;0;0;0;0;0;0;0;0
FR;9;2022-03-27;0;0;0;0;0;0;0;0;0;0;0;0;0;0;0;0;0;0
FR;9;2022-03-28;0;0;0;0;0;0;0;0;0;0;0;0;0;0;0;0;0;0
FR;9;2022-03-29;0;0;0;0;0;0;0;0;0;0;0;0;0;0;0;0;0;0
FR;9;2022-03-30;0;0;0;0;0;0;0;0;0;0;0;0;0;0;0;0;0;0
FR;9;2022-03-31;0;0;0;0;0;0;0;0;0;0;0;0;0;0;0;0;0;0
FR;9;2022-04-01;0;0;0;0;0;0;0;0;0;0;0;0;0;0;0;0;0;0
FR;9;2022-04-02;0;0;0;0;0;0;0;0;0;0;0;0;0;0;0;0;0;0
FR;9;2022-04-03;0;0;0;0;0;0;0;0;0;0;0;0;0;0;0;0;0;0
FR;9;2022-04-04;0;0;0;0;0;0;0;0;0;0;0;0;0;0;0;0;0;0
FR;9;2022-04-05;0;0;0;0;0;0;0;0;0;0;0;0;0;0;0;0;0;0
FR;9;2022-04-06;0;0;0;0;0;0;0;0;0;0;0;0;0;0;0;0;0;0
FR;9;2022-04-07;0;0;0;0;0;0;0;0;0;0;0;0;0;0;0;0;0;0
FR;9;2022-04-08;0;0;0;0;0;0;0;0;0;0;0;0;0;0;0;0;0;0
FR;9;2022-04-09;0;0;0;0;0;0;0;0;0;0;0;0;0;0;0;0;0;0
FR;9;2022-04-10;0;0;0;0;0;0;0;0;0;0;0;0;0;0;0;0;0;0
FR;9;2022-04-11;0;0;0;0;0;0;0;0;0;0;0;0;0;0;0;0;0;0
FR;9;2022-04-12;0;0;0;0;0;0;0;0;0;0;0;0;0;0;0;0;0;0
FR;9;2022-04-13;0;0;0;0;0;0;0;0;0;0;0;0;0;0;0;0;0;0
FR;9;2022-04-14;0;0;0;0;0;0;0;0;0;0;0;0;0;0;0;0;0;0
FR;9;2022-04-15;0;0;0;0;0;0;0;0;0;0;0;0;0;0;0;0;0;0
FR;9;2022-04-16;0;0;0;0;0;0;0;0;0;0;0;0;0;0;0;0;0;0
FR;9;2022-04-17;0;0;0;0;0;0;0;0;0;0;0;0;0;0;0;0;0;0
FR;9;2022-04-18;0;0;0;0;0;0;0;0;0;0;0;0;0;0;0;0;0;0
FR;9;2022-04-19;0;0;0;0;0;0;0;0;0;0;0;0;0;0;0;0;0;0
FR;9;2022-04-20;0;0;0;0;0;0;0;0;0;0;0;0;0;0;0;0;0;0
FR;9;2022-04-21;0;0;0;0;0;0;0;0;0;0;0;0;0;0;0;0;0;0
FR;9;2022-04-22;0;0;0;0;0;0;0;0;0;0;0;0;0;0;0;0;0;0
FR;9;2022-04-23;0;0;0;0;0;0;0;0;0;0;0;0;0;0;0;0;0;0
FR;9;2022-04-24;0;0;0;0;0;0;0;0;0;0;0;0;0;0;0;0;0;0
FR;9;2022-04-25;0;0;0;0;0;0;0;0;0;0;0;0;0;0;0;0;0;0
FR;9;2022-04-26;0;0;0;0;0;0;0;0;0;0;0;0;0;0;0;0;0;0
FR;9;2022-04-27;0;0;0;0;0;0;0;0;0;0;0;0;0;0;0;0;0;0
FR;9;2022-04-28;0;0;0;0;0;0;0;0;0;0;0;0;0;0;0;0;0;0
FR;9;2022-04-29;0;0;0;0;0;0;0;0;0;0;0;0;0;0;0;0;0;0
FR;9;2022-04-30;0;0;0;0;0;0;0;0;0;0;0;0;0;0;0;0;0;0
FR;9;2022-05-01;0;0;0;0;0;0;0;0;0;0;0;0;0;0;0;0;0;0
FR;9;2022-05-02;0;0;0;0;0;0;0;0;0;0;0;0;0;0;0;0;0;0
FR;9;2022-05-03;0;0;0;0;0;0;0;0;0;0;0;0;0;0;0;0;0;0
FR;9;2022-05-04;0;0;0;0;0;0;0;0;0;0;0;0;0;0;0;0;0;0
FR;9;2022-05-05;0;0;0;0;0;0;0;0;0;0;0;0;0;0;0;0;0;0
FR;9;2022-05-06;0;0;0;0;0;0;0;0;0;0;0;0;0;0;0;0;0;0
FR;9;2022-05-07;0;0;0;0;0;0;0;0;0;0;0;0;0;0;0;0;0;0
FR;9;2022-05-08;0;0;0;0;0;0;0;0;0;0;0;0;0;0;0;0;0;0
FR;9;2022-05-09;0;0;0;0;0;0;0;0;0;0;0;0;0;0;0;0;0;0
FR;9;2022-05-10;0;0;0;0;0;0;0;0;0;0;0;0;0;0;0;0;0;0
FR;9;2022-05-11;0;0;0;0;0;0;0;0;0;0;0;0;0;0;0;0;0;0
FR;9;2022-05-12;0;0;0;0;0;0;0;0;0;0;0;0;0;0;0;0;0;0
FR;9;2022-05-13;0;0;0;0;0;0;0;0;0;0;0;0;0;0;0;0;0;0
FR;9;2022-05-14;0;0;0;0;0;0;0;0;0;0;0;0;0;0;0;0;0;0
FR;9;2022-05-15;0;0;0;0;0;0;0;0;0;0;0;0;0;0;0;0;0;0
FR;9;2022-05-16;0;0;0;0;0;0;0;0;0;0;0;0;0;0;0;0;0;0
FR;9;2022-05-17;0;0;0;0;0;0;0;0;0;0;0;0;0;0;0;0;0;0
FR;9;2022-05-18;0;0;0;0;0;0;0;0;0;0;0;0;0;0;0;0;0;0
FR;9;2022-05-19;0;0;0;0;0;0;0;0;0;0;0;0;0;0;0;0;0;0
FR;9;2022-05-20;0;0;0;0;0;0;0;0;0;0;0;0;0;0;0;0;0;0
FR;9;2022-05-21;0;0;0;0;0;0;0;0;0;0;0;0;0;0;0;0;0;0
FR;9;2022-05-22;0;0;0;0;0;0;0;0;0;0;0;0;0;0;0;0;0;0
FR;9;2022-05-23;0;0;0;0;0;0;0;0;0;0;0;0;0;0;0;0;0;0
FR;9;2022-05-24;0;0;0;0;0;0;0;0;0;0;0;0;0;0;0;0;0;0
FR;9;2022-05-25;0;0;0;0;0;0;0;0;0;0;0;0;0;0;0;0;0;0
FR;9;2022-05-26;0;0;0;0;0;0;0;0;0;0;0;0;0;0;0;0;0;0
FR;9;2022-05-27;0;0;0;0;0;0;0;0;0;0;0;0;0;0;0;0;0;0
FR;9;2022-05-28;0;0;0;0;0;0;0;0;0;0;0;0;0;0;0;0;0;0
FR;9;2022-05-29;0;0;0;0;0;0;0;0;0;0;0;0;0;0;0;0;0;0
FR;9;2022-05-30;0;0;0;0;0;0;0;0;0;0;0;0;0;0;0;0;0;0
FR;9;2022-05-31;0;0;0;0;0;0;0;0;0;0;0;0;0;0;0;0;0;0
FR;9;2022-06-01;0;0;0;0;0;0;0;0;0;0;0;0;0;0;0;0;0;0
FR;9;2022-06-02;0;0;0;0;0;0;0;0;0;0;0;0;0;0;0;0;0;0
FR;9;2022-06-03;0;0;0;0;0;0;0;0;0;0;0;0;0;0;0;0;0;0
FR;9;2022-06-04;0;0;0;0;0;0;0;0;0;0;0;0;0;0;0;0;0;0
FR;9;2022-06-05;0;0;0;0;0;0;0;0;0;0;0;0;0;0;0;0;0;0
FR;9;2022-06-06;0;0;0;0;0;0;0;0;0;0;0;0;0;0;0;0;0;0
FR;9;2022-06-07;0;0;0;0;0;0;0;0;0;0;0;0;0;0;0;0;0;0
FR;9;2022-06-08;0;0;0;0;0;0;0;0;0;0;0;0;0;0;0;0;0;0
FR;9;2022-06-09;0;0;0;0;0;0;0;0;0;0;0;0;0;0;0;0;0;0
FR;9;2022-06-10;0;0;0;0;0;0;0;0;0;0;0;0;0;0;0;0;0;0
FR;9;2022-06-11;0;0;0;0;0;0;0;0;0;0;0;0;0;0;0;0;0;0
FR;9;2022-06-12;0;0;0;0;0;0;0;0;0;0;0;0;0;0;0;0;0;0
FR;9;2022-06-13;0;0;0;0;0;0;0;0;0;0;0;0;0;0;0;0;0;0
FR;9;2022-06-14;0;0;0;0;0;0;0;0;0;0;0;0;0;0;0;0;0;0
FR;9;2022-06-15;0;0;0;0;0;0;0;0;0;0;0;0;0;0;0;0;0;0
FR;9;2022-06-16;0;0;0;0;0;0;0;0;0;0;0;0;0;0;0;0;0;0
FR;9;2022-06-17;0;0;0;0;0;0;0;0;0;0;0;0;0;0;0;0;0;0
FR;9;2022-06-18;0;0;0;0;0;0;0;0;0;0;0;0;0;0;0;0;0;0
FR;9;2022-06-19;0;0;0;0;0;0;0;0;0;0;0;0;0;0;0;0;0;0
FR;9;2022-06-20;0;0;0;0;0;0;0;0;0;0;0;0;0;0;0;0;0;0
FR;9;2022-06-21;0;0;0;0;0;0;0;0;0;0;0;0;0;0;0;0;0;0
FR;9;2022-06-22;0;0;0;0;0;0;0;0;0;0;0;0;0;0;0;0;0;0
FR;9;2022-06-23;0;0;0;0;0;0;0;0;0;0;0;0;0;0;0;0;0;0
FR;9;2022-06-24;0;0;0;0;0;0;0;0;0;0;0;0;0;0;0;0;0;0
FR;9;2022-06-25;0;0;0;0;0;0;0;0;0;0;0;0;0;0;0;0;0;0
FR;9;2022-06-26;0;0;0;0;0;0;0;0;0;0;0;0;0;0;0;0;0;0
FR;9;2022-06-27;0;0;0;0;0;0;0;0;0;0;0;0;0;0;0;0;0;0
FR;9;2022-06-28;0;0;0;0;0;0;0;0;0;0;0;0;0;0;0;0;0;0
FR;9;2022-06-29;0;0;0;0;0;0;0;0;0;0;0;0;0;0;0;0;0;0
FR;9;2022-06-30;0;0;0;0;0;0;0;0;0;0;0;0;0;0;0;0;0;0
FR;9;2022-07-01;0;0;0;0;0;0;0;0;0;0;0;0;0;0;0;0;0;0
FR;9;2022-07-02;0;0;0;0;0;0;0;0;0;0;0;0;0;0;0;0;0;0
FR;9;2022-07-03;0;0;0;0;0;0;0;0;0;0;0;0;0;0;0;0;0;0
FR;9;2022-07-04;0;0;0;0;0;0;0;0;0;0;0;0;0;0;0;0;0;0
FR;9;2022-07-05;0;0;0;0;0;0;0;0;0;0;0;0;0;0;0;0;0;0
FR;9;2022-07-06;0;0;0;0;0;0;0;0;0;0;0;0;0;0;0;0;0;0
FR;9;2022-07-07;0;0;0;0;0;0;0;0;0;0;0;0;0;0;0;0;0;0
FR;9;2022-07-08;0;0;0;0;0;0;0;0;0;0;0;0;0;0;0;0;0;0
FR;9;2022-07-09;0;0;0;0;0;0;0;0;0;0;0;0;0;0;0;0;0;0
FR;9;2022-07-10;0;0;0;0;0;0;0;0;0;0;0;0;0;0;0;0;0;0
FR;9;2022-07-11;0;0;0;0;0;0;0;0;0;0;0;0;0;0;0;0;0;0
FR;9;2022-07-12;0;0;0;0;0;0;0;0;0;0;0;0;0;0;0;0;0;0
FR;9;2022-07-13;0;0;0;0;0;0;0;0;0;0;0;0;0;0;0;0;0;0
FR;9;2022-07-14;0;0;0;0;0;0;0;0;0;0;0;0;0;0;0;0;0;0
FR;9;2022-07-15;0;0;0;0;0;0;0;0;0;0;0;0;0;0;0;0;0;0
FR;9;2022-07-16;0;0;0;0;0;0;0;0;0;0;0;0;0;0;0;0;0;0
FR;9;2022-07-17;0;0;0;0;0;0;0;0;0;0;0;0;0;0;0;0;0;0
FR;9;2022-07-18;0;0;0;0;0;0;0;0;0;0;0;0;0;0;0;0;0;0
FR;9;2022-07-19;0;0;0;0;0;0;0;0;0;0;0;0;0;0;0;0;0;0
FR;9;2022-07-20;0;0;0;0;0;0;0;0;0;0;0;0;0;0;0;0;0;0
FR;9;2022-07-21;0;0;0;0;0;0;0;0;0;0;0;0;0;0;0;0;0;0
FR;9;2022-07-22;0;0;0;0;0;0;0;0;0;0;0;0;0;0;0;0;0;0
FR;9;2022-07-23;0;0;0;0;0;0;0;0;0;0;0;0;0;0;0;0;0;0
FR;9;2022-07-24;0;0;0;0;0;0;0;0;0;0;0;0;0;0;0;0;0;0
FR;9;2022-07-25;0;0;0;0;0;0;0;0;0;0;0;0;0;0;0;0;0;0
FR;9;2022-07-26;0;0;0;0;0;0;0;0;0;0;0;0;0;0;0;0;0;0
FR;9;2022-07-27;0;0;0;0;0;0;0;0;0;0;0;0;0;0;0;0;0;0
FR;9;2022-07-28;0;0;0;0;0;0;0;0;0;0;0;0;0;0;0;0;0;0
FR;9;2022-07-29;0;0;0;0;0;0;0;0;0;0;0;0;0;0;0;0;0;0
FR;9;2022-07-30;0;0;0;0;0;0;0;0;0;0;0;0;0;0;0;0;0;0
FR;9;2022-07-31;0;0;0;0;0;0;0;0;0;0;0;0;0;0;0;0;0;0
FR;9;2022-08-01;0;0;0;0;0;0;0;0;0;0;0;0;0;0;0;0;0;0
FR;9;2022-08-02;0;0;0;0;0;0;0;0;0;0;0;0;0;0;0;0;0;0
FR;9;2022-08-03;0;0;0;0;0;0;0;0;0;0;0;0;0;0;0;0;0;0
FR;9;2022-08-04;0;0;0;0;0;0;0;0;0;0;0;0;0;0;0;0;0;0
FR;9;2022-08-05;0;0;0;0;0;0;0;0;0;0;0;0;0;0;0;0;0;0
FR;9;2022-08-06;0;0;0;0;0;0;0;0;0;0;0;0;0;0;0;0;0;0
FR;9;2022-08-07;0;0;0;0;0;0;0;0;0;0;0;0;0;0;0;0;0;0
FR;9;2022-08-08;0;0;0;0;0;0;0;0;0;0;0;0;0;0;0;0;0;0
FR;9;2022-08-09;0;0;0;0;0;0;0;0;0;0;0;0;0;0;0;0;0;0
FR;9;2022-08-10;0;0;0;0;0;0;0;0;0;0;0;0;0;0;0;0;0;0
FR;9;2022-08-11;0;0;0;0;0;0;0;0;0;0;0;0;0;0;0;0;0;0
FR;9;2022-08-12;0;0;0;0;0;0;0;0;0;0;0;0;0;0;0;0;0;0
FR;9;2022-08-13;0;0;0;0;0;0;0;0;0;0;0;0;0;0;0;0;0;0
FR;9;2022-08-14;0;0;0;0;0;0;0;0;0;0;0;0;0;0;0;0;0;0
FR;9;2022-08-15;0;0;0;0;0;0;0;0;0;0;0;0;0;0;0;0;0;0
FR;9;2022-08-16;0;0;0;0;0;0;0;0;0;0;0;0;0;0;0;0;0;0
FR;9;2022-08-17;0;0;0;0;0;0;0;0;0;0;0;0;0;0;0;0;0;0
FR;9;2022-08-18;0;0;0;0;0;0;0;0;0;0;0;0;0;0;0;0;0;0
FR;9;2022-08-19;0;0;0;0;0;0;0;0;0;0;0;0;0;0;0;0;0;0
FR;9;2022-08-20;0;0;0;0;0;0;0;0;0;0;0;0;0;0;0;0;0;0
FR;9;2022-08-21;0;0;0;0;0;0;0;0;0;0;0;0;0;0;0;0;0;0
FR;9;2022-08-22;0;0;0;0;0;0;0;0;0;0;0;0;0;0;0;0;0;0
FR;9;2022-08-23;0;0;0;0;0;0;0;0;0;0;0;0;0;0;0;0;0;0
FR;9;2022-08-24;0;0;0;0;0;0;0;0;0;0;0;0;0;0;0;0;0;0
FR;9;2022-08-25;0;0;0;0;0;0;0;0;0;0;0;0;0;0;0;0;0;0
FR;9;2022-08-26;0;0;0;0;0;0;0;0;0;0;0;0;0;0;0;0;0;0
FR;9;2022-08-27;0;0;0;0;0;0;0;0;0;0;0;0;0;0;0;0;0;0
FR;9;2022-08-28;0;0;0;0;0;0;0;0;0;0;0;0;0;0;0;0;0;0
FR;9;2022-08-29;0;0;0;0;0;0;0;0;0;0;0;0;0;0;0;0;0;0
FR;9;2022-08-30;0;0;0;0;0;0;0;0;0;0;0;0;0;0;0;0;0;0
FR;9;2022-08-31;0;0;0;0;0;0;0;0;0;0;0;0;0;0;0;0;0;0
FR;9;2022-09-01;0;0;0;0;0;0;0;0;0;0;0;0;0;0;0;0;0;0
FR;9;2022-09-02;0;0;0;0;0;0;0;0;0;0;0;0;0;0;0;0;0;0
FR;9;2022-09-03;0;0;0;0;0;0;0;0;0;0;0;0;0;0;0;0;0;0
FR;9;2022-09-04;0;0;0;0;0;0;0;0;0;0;0;0;0;0;0;0;0;0
FR;9;2022-09-05;0;0;0;0;0;0;0;0;0;0;0;0;0;0;0;0;0;0
FR;9;2022-09-06;0;0;0;0;0;0;0;0;0;0;0;0;0;0;0;0;0;0
FR;9;2022-09-07;0;0;0;0;0;0;0;0;0;0;0;0;0;0;0;0;0;0
FR;9;2022-09-08;0;0;0;0;0;0;0;0;0;0;0;0;0;0;0;0;0;0
FR;9;2022-09-09;0;0;0;0;0;0;0;0;0;0;0;0;0;0;0;0;0;0
FR;9;2022-09-10;0;0;0;0;0;0;0;0;0;0;0;0;0;0;0;0;0;0
FR;9;2022-09-11;0;0;0;0;0;0;0;0;0;0;0;0;0;0;0;0;0;0
FR;9;2022-09-12;0;0;0;0;0;0;0;0;0;0;0;0;0;0;0;0;0;0
FR;9;2022-09-13;0;0;0;0;0;0;0;0;0;0;0;0;0;0;0;0;0;0
FR;9;2022-09-14;0;0;0;0;0;0;0;0;0;0;0;0;0;0;0;0;0;0
FR;9;2022-09-15;0;0;0;0;0;0;0;0;0;0;0;0;0;0;0;0;0;0
FR;9;2022-09-16;0;0;0;0;0;0;0;0;0;0;0;0;0;0;0;0;0;0
FR;9;2022-09-17;0;0;0;0;0;0;0;0;0;0;0;0;0;0;0;0;0;0
FR;9;2022-09-18;0;0;0;0;0;0;0;0;0;0;0;0;0;0;0;0;0;0
FR;9;2022-09-19;0;0;0;0;0;0;0;0;0;0;0;0;0;0;0;0;0;0
FR;9;2022-09-20;0;0;0;0;0;0;0;0;0;0;0;0;0;0;0;0;0;0
FR;9;2022-09-21;0;0;0;0;0;0;0;0;0;0;0;0;0;0;0;0;0;0
FR;9;2022-09-22;0;0;0;0;0;0;0;0;0;0;0;0;0;0;0;0;0;0
FR;9;2022-09-23;0;0;0;0;0;0;0;0;0;0;0;0;0;0;0;0;0;0
FR;9;2022-09-24;0;0;0;0;0;0;0;0;0;0;0;0;0;0;0;0;0;0
FR;9;2022-09-25;0;0;0;0;0;0;0;0;0;0;0;0;0;0;0;0;0;0
FR;9;2022-09-26;0;0;0;0;0;0;0;0;0;0;0;0;0;0;0;0;0;0
FR;9;2022-09-27;0;0;0;0;0;0;0;0;0;0;0;0;0;0;0;0;0;0
FR;9;2022-09-28;0;0;0;0;0;0;0;0;0;0;0;0;0;0;0;0;0;0
FR;9;2022-09-29;1;1;8;33;0;6;35;43;2;1;1;8;33;0;6;35;43;2
FR;9;2022-09-30;5;13;62;606;7;48;614;715;51;6;14;70;639;7;54;649;758;53
FR;9;2022-10-01;10;2;43;327;3;26;335;396;35;16;16;113;966;10;80;984;1154;88
FR;9;2022-10-02;2;1;5;50;0;4;51;66;11;18;17;118;1016;10;84;1035;1220;99
FR;9;2022-10-03;15;17;151;1714;11;129;1708;2074;234;33;34;269;2730;21;213;2743;3294;333
FR;9;2022-10-04;23;48;353;3954;18;228;4022;4704;450;56;82;622;6684;39;441;6765;7998;783
FR;9;2022-10-05;30;21;269;3000;18;203;3013;3658;433;86;103;891;9684;57;644;9778;11656;1216
FR;9;2022-10-06;23;35;400;4598;18;301;4631;5609;672;109;138;1291;14282;75;945;14409;17265;1888
FR;9;2022-10-07;29;50;499;5706;19;384;5720;7029;923;138;188;1790;19988;94;1329;20129;24294;2811
FR;9;2022-10-08;10;18;128;1090;8;86;1108;1389;191;148;206;1918;21078;102;1415;21237;25683;3002
FR;9;2022-10-09;1;7;22;197;1;29;198;277;50;149;213;1940;21275;103;1444;21435;25960;3052
FR;9;2022-10-10;11;26;207;2572;14;181;2576;3296;533;160;239;2147;23847;117;1625;24011;29256;3585
FR;9;2022-10-11;31;40;424;5043;27;312;5024;6198;851;191;279;2571;28890;144;1937;29035;35454;4436
FR;9;2022-10-12;22;26;297;2987;16;212;3044;3830;572;213;305;2868;31877;160;2149;32079;39284;5008
FR;9;2022-10-13;25;42;374;3980;16;245;4036;5027;740;238;347;3242;35857;176;2394;36115;44311;5748
FR;9;2022-10-14;27;26;383;4430;12;295;4414;5558;838;265;373;3625;40287;188;2689;40529;49869;6586
FR;9;2022-10-15;14;8;101;1052;7;79;1029;1308;198;279;381;3726;41339;195;2768;41558;51177;6784
FR;9;2022-10-16;4;1;9;132;2;12;126;168;28;283;382;3735;41471;197;2780;41684;51345;6812
FR;9;2022-10-17;4;22;165;1875;11;127;1883;2492;475;287;404;3900;43346;208;2907;43567;53837;7287
FR;9;2022-10-18;36;29;317;3430;17;237;3454;4663;963;323;433;4217;46776;225;3144;47021;58500;8250
FR;9;2022-10-19;22;19;262;2688;17;174;2717;3733;827;345;452;4479;49464;242;3318;49738;62233;9077
FR;9;2022-10-20;22;22;308;3628;8;233;3639;4813;933;367;474;4787;53092;250;3551;53377;67046;10010
FR;9;2022-10-21;14;32;327;3550;11;228;3556;4656;864;381;506;5114;56642;261;3779;56933;71702;10874
FR;9;2022-10-22;10;11;90;914;8;62;919;1193;207;391;517;5204;57556;269;3841;57852;72895;11081
FR;9;2022-10-23;2;2;17;100;2;10;105;148;33;393;519;5221;57656;271;3851;57957;73043;11114
FR;9;2022-10-24;7;17;159;1363;6;106;1434;1942;397;400;536;5380;59019;277;3957;59391;74985;11511
FR;9;2022-10-25;19;22;228;2841;16;188;2851;3938;896;419;558;5608;61860;293;4145;62242;78923;12407
FR;9;2022-10-26;14;16;169;1800;13;123;1812;2527;590;433;574;5777;63660;306;4268;64054;81450;12997
FR;9;2022-10-27;9;26;230;2303;15;173;2337;3210;689;442;600;6007;65963;321;4441;66391;84660;13686
FR;9;2022-10-28;18;27;224;2277;17;151;2303;3142;681;460;627;6231;68240;338;4592;68694;87802;14367
FR;9;2022-10-29;12;8;55;505;5;46;496;662;119;472;635;6286;68745;343;4638;69190;88464;14486
FR;9;2022-10-30;2;1;8;58;1;8;58;82;16;474;636;6294;68803;344;4646;69248;88546;14502
FR;9;2022-10-31;13;7;105;660;9;59;695;996;240;487;643;6399;69463;353;4705;69943;89542;14742
FR;9;2022-11-01;1;2;15;43;1;11;49;71;11;488;645;6414;69506;354;4716;69992;89613;14753
FR;9;2022-11-02;7;12;102;1027;4;76;1045;1577;452;495;657;6516;70533;358;4792;71037;91190;15205
FR;9;2022-11-03;17;18;157;1599;16;92;1647;2348;599;512;675;6673;72132;374;4884;72684;93538;15804
FR;9;2022-11-04;21;19;193;1751;15;120;1800;2536;611;533;694;6866;73883;389;5004;74484;96074;16415
FR;9;2022-11-05;8;10;58;403;9;39;424;573;107;541;704;6924;74286;398;5043;74908;96647;16522
FR;9;2022-11-06;5;4;5;62;6;2;61;88;25;546;708;6929;74348;404;5045;74969;96735;16547
FR;9;2022-11-07;16;19;89;942;16;110;941;1489;432;562;727;7018;75290;420;5155;75910;98224;16979
FR;9;2022-11-08;11;19;171;1827;13;137;1815;2660;703;573;746;7189;77117;433;5292;77725;100884;17682
FR;9;2022-11-09;16;16;123;1261;9;98;1322;1878;453;589;762;7312;78378;442;5390;79047;102762;18135
FR;9;2022-11-10;13;22;162;1623;14;137;1621;2281;519;602;784;7474;80001;456;5527;80668;105043;18654
FR;9;2022-11-11;1;1;13;81;1;6;83;124;35;603;785;7487;80082;457;5533;80751;105167;18689
FR;9;2022-11-12;5;8;44;259;7;19;278;395;97;608;793;7531;80341;464;5552;81029;105562;18786
FR;9;2022-11-13;2;0;4;30;0;4;31;51;16;610;793;7535;80371;464;5556;81060;105613;18802
FR;9;2022-11-14;11;12;56;713;11;44;722;1108;339;621;805;7591;81084;475;5600;81782;106721;19141
FR;9;2022-11-15;18;17;150;1346;8;103;1356;2103;638;639;822;7741;82430;483;5703;83138;108824;19779
FR;9;2022-11-16;10;5;99;979;8;58;997;1490;431;649;827;7840;83409;491;5761;84135;110314;20210
FR;9;2022-11-17;9;17;126;1086;11;78;1111;1695;501;658;844;7966;84495;502;5839;85246;112009;20711
FR;9;2022-11-18;7;16;120;1440;5;78;1455;2027;492;665;860;8086;85935;507;5917;86701;114036;21203
FR;9;2022-11-19;3;5;51;364;1;28;351;490;106;668;865;8137;86299;508;5945;87052;114526;21309
FR;9;2022-11-20;1;0;5;37;0;3;35;54;16;669;865;8142;86336;508;5948;87087;114580;21325
FR;9;2022-11-21;9;12;66;636;5;51;639;960;263;678;877;8208;86972;513;5999;87726;115540;21588
FR;9;2022-11-22;15;12;121;1037;13;74;1067;1592;449;693;889;8329;88009;526;6073;88793;117132;22037
FR;9;2022-11-23;7;10;69;735;5;33;762;1172;372;700;899;8398;88744;531;6106;89555;118304;22409
FR;9;2022-11-24;8;19;93;979;14;68;992;1472;406;708;918;8491;89723;545;6174;90547;119776;22815
FR;9;2022-11-25;8;11;107;1180;9;82;1195;1781;503;716;929;8598;90903;554;6256;91742;121557;23318
FR;9;2022-11-26;6;6;35;217;7;24;214;310;68;722;935;8633;91120;561;6280;91956;121867;23386
FR;9;2022-11-27;1;1;6;42;0;2;46;82;34;723;936;8639;91162;561;6282;92002;121949;23420
FR;9;2022-11-28;5;7;103;698;7;60;726;1135;344;728;943;8742;91860;568;6342;92728;123084;23764
FR;9;2022-11-29;6;18;142;1299;6;89;1327;1942;521;734;961;8884;93159;574;6431;94055;125026;24285
FR;9;2022-11-30;9;12;99;1032;5;76;1055;1606;470;743;973;8983;94191;579;6507;95110;126632;24755
FR;9;2022-12-01;16;14;112;1345;8;80;1331;1970;554;759;987;9095;95536;587;6587;96441;128602;25309
FR;9;2022-12-02;10;13;193;1817;10;107;1818;2631;700;769;1000;9288;97353;597;6694;98259;131233;26009
FR;9;2022-12-03;7;9;79;619;5;41;632;887;208;776;1009;9367;97972;602;6735;98891;132120;26217
FR;9;2022-12-04;11;4;15;105;5;8;105;153;40;787;1013;9382;98077;607;6743;98996;132273;26257
FR;9;2022-12-05;21;24;144;1406;18;98;1421;2110;584;808;1037;9526;99483;625;6841;100417;134383;26841
FR;9;2022-12-06;30;21;264;2453;21;148;2548;3812;1097;838;1058;9790;101936;646;6989;102965;138195;27938
FR;9;2022-12-07;15;22;181;1848;20;112;1890;2826;814;853;1080;9971;103784;666;7101;104855;141021;28752
FR;9;2022-12-08;14;22;222;2404;15;125;2467;3701;1092;867;1102;10193;106188;681;7226;107322;144722;29844
FR;9;2022-12-09;14;25;287;2888;10;143;2986;4337;1200;881;1127;10480;109076;691;7369;110308;149059;31044
FR;9;2022-12-10;12;13;122;1324;5;56;1347;1819;410;893;1140;10602;110400;696;7425;111655;150878;31454
FR;9;2022-12-11;5;5;21;277;6;10;283;363;66;898;1145;10623;110677;702;7435;111938;151241;31520
FR;9;2022-12-12;17;14;215;1958;12;109;2032;2892;746;915;1159;10838;112635;714;7544;113970;154133;32266
FR;9;2022-12-13;28;23;317;3085;15;151;3221;4720;1337;943;1182;11155;115720;729;7695;117191;158853;33603
FR;9;2022-12-14;15;10;191;2335;8;94;2405;3505;989;958;1192;11346;118055;737;7789;119596;162358;34592
FR;9;2022-12-15;17;24;257;2611;13;138;2682;4069;1238;975;1216;11603;120666;750;7927;122278;166427;35830
FR;9;2022-12-16;15;29;294;3072;21;165;3155;4603;1274;990;1245;11897;123738;771;8092;125433;171030;37104
FR;9;2022-12-17;8;11;106;1193;6;50;1208;1664;402;998;1256;12003;124931;777;8142;126641;172694;37506
FR;9;2022-12-18;1;7;30;245;6;14;251;333;67;999;1263;12033;125176;783;8156;126892;173027;37573
FR;9;2022-12-19;20;21;149;1599;15;78;1631;2507;789;1019;1284;12182;126775;798;8234;128523;175534;38362
FR;9;2022-12-20;21;19;232;2306;6;115;2349;3708;1233;1040;1303;12414;129081;804;8349;130872;179242;39595
FR;9;2022-12-21;6;14;139;1501;7;66;1554;2402;775;1046;1317;12553;130582;811;8415;132426;181644;40370
FR;9;2022-12-22;19;9;136;1402;9;78;1418;2119;615;1065;1326;12689;131984;820;8493;133844;183763;40985
FR;9;2022-12-23;11;15;77;728;9;51;730;1092;305;1076;1341;12766;132712;829;8544;134574;184855;41290
FR;9;2022-12-24;1;5;13;96;4;6;98;138;34;1077;1346;12779;132808;833;8550;134672;184993;41324
FR;9;2022-12-25;1;0;5;5;0;4;6;12;2;1078;1346;12784;132813;833;8554;134678;185005;41326
FR;9;2022-12-26;17;8;64;547;11;37;554;829;235;1095;1354;12848;133360;844;8591;135232;185834;41561
FR;9;2022-12-27;12;30;97;882;14;69;917;1422;430;1107;1384;12945;134242;858;8660;136149;187256;41991
FR;9;2022-12-28;8;9;82;749;8;40;768;1185;372;1115;1393;13027;134991;866;8700;136917;188441;42363
FR;9;2022-12-29;9;14;92;720;10;51;753;1135;324;1124;1407;13119;135711;876;8751;137670;189576;42687
FR;9;2022-12-30;12;17;77;592;9;47;612;899;237;1136;1424;13196;136303;885;8798;138282;190475;42924
FR;9;2022-12-31;2;3;17;136;2;12;139;190;38;1138;1427;13213;136439;887;8810;138421;190665;42962
FR;9;2023-01-01;0;2;3;19;1;4;19;31;8;1138;1429;13216;136458;888;8814;138440;190696;42970
FR;9;2023-01-02;11;11;56;592;4;40;585;949;320;1149;1440;13272;137050;892;8854;139025;191645;43290
FR;9;2023-01-03;19;20;122;1079;20;75;1101;1940;749;1168;1460;13394;138129;912;8929;140126;193585;44039
FR;9;2023-01-04;21;19;113;846;9;73;898;1609;633;1189;1479;13507;138975;921;9002;141024;195194;44672
FR;9;2023-01-05;5;20;115;1059;11;65;1091;2048;882;1194;1499;13622;140034;932;9067;142115;197242;45554
FR;9;2023-01-06;13;17;152;1370;4;73;1388;2410;938;1207;1516;13774;141404;936;9140;143503;199652;46492
FR;9;2023-01-07;6;13;58;436;14;36;427;687;220;1213;1529;13832;141840;950;9176;143930;200339;46712
FR;9;2023-01-08;4;11;15;92;9;12;91;137;32;1217;1540;13847;141932;959;9188;144021;200476;46744
FR;9;2023-01-09;16;15;87;623;9;62;615;1276;586;1233;1555;13934;142555;968;9250;144636;201752;47330
FR;9;2023-01-10;13;12;154;979;11;74;1033;1990;871;1246;1567;14088;143534;979;9324;145669;203742;48201
FR;9;2023-01-11;19;9;74;680;10;49;689;1387;643;1265;1576;14162;144214;989;9373;146358;205129;48844
FR;9;2023-01-12;21;9;92;845;3;77;823;1688;775;1286;1585;14254;145059;992;9450;147181;206817;49619
FR;9;2023-01-13;15;19;106;888;12;73;910;1784;785;1301;1604;14360;145947;1004;9523;148091;208601;50404
FR;9;2023-01-14;9;9;55;294;5;33;299;585;247;1310;1613;14415;146241;1009;9556;148390;209186;50651
FR;9;2023-01-15;1;3;15;37;0;9;41;82;32;1311;1616;14430;146278;1009;9565;148431;209268;50683
FR;9;2023-01-16;6;15;54;366;13;24;383;785;371;1317;1631;14484;146644;1022;9589;148814;210053;51054
FR;9;2023-01-17;7;9;83;563;4;49;577;1244;609;1324;1640;14567;147207;1026;9638;149391;211297;51663
FR;9;2023-01-18;8;14;37;380;6;32;397;841;405;1332;1654;14604;147587;1032;9670;149788;212138;52068
FR;9;2023-01-19;10;9;58;477;8;30;478;1088;569;1342;1663;14662;148064;1040;9700;150266;213226;52637
FR;9;2023-01-20;15;19;96;578;16;57;595;1190;534;1357;1682;14758;148642;1056;9757;150861;214416;53171
FR;9;2023-01-21;8;15;20;192;11;13;190;347;140;1365;1697;14778;148834;1067;9770;151051;214763;53311
FR;9;2023-01-22;0;0;8;20;0;5;21;42;16;1365;1697;14786;148854;1067;9775;151072;214805;53327
FR;9;2023-01-23;4;15;27;253;9;25;242;563;287;1369;1712;14813;149107;1076;9800;151314;215368;53614
FR;9;2023-01-24;11;10;70;461;9;42;484;1162;633;1380;1722;14883;149568;1085;9842;151798;216530;54247
FR;9;2023-01-25;11;20;50;325;9;47;336;798;410;1391;1742;14933;149893;1094;9889;152134;217328;54657
FR;9;2023-01-26;7;17;64;391;8;50;390;967;515;1398;1759;14997;150284;1102;9939;152524;218295;55172
FR;9;2023-01-27;4;7;59;381;3;31;397;906;462;1402;1766;15056;150665;1105;9970;152921;219201;55634
FR;9;2023-01-28;3;6;31;128;5;27;120;265;116;1405;1772;15087;150793;1110;9997;153041;219466;55750
FR;9;2023-01-29;3;0;3;18;2;1;17;40;22;1408;1772;15090;150811;1112;9998;153058;219506;55772
FR;9;2023-01-30;4;6;31;192;5;11;211;501;272;1412;1778;15121;151003;1117;10009;153269;220007;56044
FR;9;2023-01-31;14;7;38;260;8;18;264;649;359;1426;1785;15159;151263;1125;10027;153533;220656;56403
FR;9;2023-02-01;5;7;26;173;4;20;179;519;309;1431;1792;15185;151436;1129;10047;153712;221175;56712
FR;9;2023-02-02;4;6;31;252;6;23;233;666;395;1435;1798;15216;151688;1135;10070;153945;221841;57107
FR;9;2023-02-03;8;13;42;289;10;37;275;677;355;1443;1811;15258;151977;1145;10107;154220;222518;57462
FR;9;2023-02-04;6;5;10;70;7;8;68;160;84;1449;1816;15268;152047;1152;10115;154288;222678;57546
FR;9;2023-02-05;1;1;4;7;0;4;7;17;6;1450;1817;15272;152054;1152;10119;154295;222695;57552
FR;9;2023-02-06;3;5;17;81;4;15;78;229;134;1453;1822;15289;152135;1156;10134;154373;222924;57686
FR;9;2023-02-07;3;5;30;145;3;21;138;451;285;1456;1827;15319;152280;1159;10155;154511;223375;57971
FR;9;2023-02-08;4;6;25;116;3;13;125;301;160;1460;1833;15344;152396;1162;10168;154636;223676;58131
FR;9;2023-02-09;8;3;20;138;4;14;123;343;202;1468;1836;15364;152534;1166;10182;154759;224019;58333
FR;9;2023-02-10;8;8;19;149;10;11;145;315;153;1476;1844;15383;152683;1176;10193;154904;224334;58486
FR;9;2023-02-11;5;4;14;42;3;9;47;84;28;1481;1848;15397;152725;1179;10202;154951;224418;58514
FR;9;2023-02-12;0;0;0;1;0;0;1;8;7;1481;1848;15397;152726;1179;10202;154952;224426;58521
FR;9;2023-02-13;3;8;5;50;8;4;45;107;55;1484;1856;15402;152776;1187;10206;154997;224533;58576
FR;9;2023-02-14;10;10;16;66;10;13;63;225;146;1494;1866;15418;152842;1197;10219;155060;224758;58722
FR;9;2023-02-15;1;5;17;52;3;13;50;163;99;1495;1871;15435;152894;1200;10232;155110;224921;58821
FR;9;2023-02-16;4;6;19;77;1;17;78;197;93;1499;1877;15454;152971;1201;10249;155188;225118;58914
FR;9;2023-02-17;6;4;15;62;5;11;64;178;99;1505;1881;15469;153033;1206;10260;155252;225296;59013
FR;9;2023-02-18;1;5;1;30;5;3;25;58;29;1506;1886;15470;153063;1211;10263;155277;225354;59042
FR;9;2023-02-19;1;0;0;1;0;0;1;3;2;1507;1886;15470;153064;1211;10263;155278;225357;59044
FR;9;2023-02-20;2;3;9;60;2;6;60;123;55;1509;1889;15479;153124;1213;10269;155338;225480;59099
FR;9;2023-02-21;6;9;11;65;7;10;65;160;83;1515;1898;15490;153189;1220;10279;155403;225640;59182
FR;9;2023-02-22;2;4;18;70;3;13;72;210;118;1517;1902;15508;153259;1223;10292;155475;225850;59300
FR;9;2023-02-23;5;3;17;63;1;12;69;146;61;1522;1905;15525;153322;1224;10304;155544;225996;59361
FR;9;2023-02-24;6;5;13;80;6;8;83;211;114;1528;1910;15538;153402;1230;10312;155627;226207;59475
FR;9;2023-02-25;2;2;10;14;4;4;23;43;16;1530;1912;15548;153416;1234;10316;155650;226250;59491
FR;9;2023-02-26;3;1;0;4;3;1;4;5;0;1533;1913;15548;153420;1237;10317;155654;226255;59491
FR;9;2023-02-27;2;3;5;17;3;2;19;49;26;1535;1916;15553;153437;1240;10319;155673;226304;59517
FR;9;2023-02-28;7;13;18;55;11;16;58;155;76;1542;1929;15571;153492;1251;10335;155731;226459;59593
FR;9;2023-03-01;0;9;6;20;7;7;20;78;48;1542;1938;15577;153512;1258;10342;155751;226537;59641
FR;9;2023-03-02;0;1;7;31;1;2;36;80;41;1542;1939;15584;153543;1259;10344;155787;226617;59682
FR;9;2023-03-03;1;4;9;47;3;7;48;122;67;1543;1943;15593;153590;1262;10351;155835;226739;59749
FR;9;2023-03-04;1;2;7;19;1;4;25;41;10;1544;1945;15600;153609;1263;10355;155860;226780;59759
FR;9;2023-03-05;0;1;1;0;1;0;1;8;7;1544;1946;15601;153609;1264;10355;155861;226788;59766
FR;9;2023-03-06;1;6;6;8;3;6;9;35;19;1545;1952;15607;153617;1267;10361;155870;226823;59785
FR;9;2023-03-07;2;4;8;20;0;9;24;69;34;1547;1956;15615;153637;1267;10370;155894;226892;59819
FR;9;2023-03-08;2;4;10;6;4;4;13;39;20;1549;1960;15625;153643;1271;10374;155907;226931;59839
FR;9;2023-03-09;1;3;9;12;2;6;17;65;42;1550;1963;15634;153655;1273;10380;155924;226996;59881
FR;9;2023-03-10;3;3;6;23;3;4;20;73;47;1553;1966;15640;153678;1276;10384;155944;227069;59928
FR;9;2023-03-11;2;3;4;8;2;1;11;15;3;1555;1969;15644;153686;1278;10385;155955;227084;59931
FR;9;2023-03-12;0;1;0;0;1;0;0;0;0;1555;1970;15644;153686;1279;10385;155955;227084;59931
FR;9;2023-03-13;3;5;9;34;3;4;14;49;29;1558;1975;15653;153720;1282;10389;155969;227133;59960
FR;9;2023-03-14;3;3;7;27;1;6;29;79;41;1561;1978;15660;153747;1283;10395;155998;227212;60001
FR;9;2023-03-15;0;6;4;15;4;4;17;47;24;1561;1984;15664;153762;1287;10399;156015;227259;60025
FR;9;2023-03-16;0;9;7;15;5;8;15;77;52;1561;1993;15671;153777;1292;10407;156030;227336;60077
FR;9;2023-03-17;0;7;6;40;3;8;27;113;71;1561;2000;15677;153817;1295;10415;156057;227449;60148
FR;9;2023-03-18;2;2;5;13;1;4;16;48;26;1563;2002;15682;153830;1296;10419;156073;227497;60174
FR;9;2023-03-19;0;1;0;0;1;0;0;0;0;1563;2003;15682;153830;1297;10419;156073;227497;60174
FR;9;2023-03-20;3;7;1;25;6;1;13;54;40;1566;2010;15683;153855;1303;10420;156086;227551;60214
FR;9;2023-03-21;1;1;6;16;1;1;21;69;47;1567;2011;15689;153871;1304;10421;156107;227620;60261
FR;9;2023-03-22;1;2;4;19;2;2;22;78;49;1568;2013;15693;153890;1306;10423;156129;227698;60310
FR;9;2023-03-23;0;6;7;22;4;7;21;56;25;1568;2019;15700;153912;1310;10430;156150;227754;60335
FR;9;2023-03-24;2;2;5;25;2;5;26;53;19;1570;2021;15705;153937;1312;10435;156176;227807;60354
FR;9;2023-03-25;0;0;4;6;0;3;8;16;5;1570;2021;15709;153943;1312;10438;156184;227823;60359
FR;9;2023-03-26;0;1;0;0;0;1;0;2;1;1570;2022;15709;153943;1312;10439;156184;227825;60360
FR;9;2023-03-27;0;3;4;8;2;2;12;32;15;1570;2025;15713;153951;1314;10441;156196;227857;60375
FR;9;2023-03-28;5;13;6;17;12;7;16;49;22;1575;2038;15719;153968;1326;10448;156212;227906;60397
FR;9;2023-03-29;3;6;8;5;2;8;8;28;12;1578;2044;15727;153973;1328;10456;156220;227934;60409
FR;9;2023-03-30;2;2;2;17;2;3;17;43;20;1580;2046;15729;153990;1330;10459;156237;227977;60429
FR;9;2023-03-31;1;3;2;18;1;6;15;45;22;1581;2049;15731;154008;1331;10465;156252;228022;60451
FR;9;2023-04-01;0;1;5;2;0;4;5;12;3;1581;2050;15736;154010;1331;10469;156257;228034;60454
FR;9;2023-04-02;3;1;1;0;0;2;0;4;2;1584;2051;15737;154010;1331;10471;156257;228038;60456
FR;9;2023-04-03;0;1;3;13;0;4;10;53;34;1584;2052;15740;154023;1331;10475;156267;228091;60490
FR;9;2023-04-04;4;4;11;18;2;7;22;61;29;1588;2056;15751;154041;1333;10482;156289;228152;60519
FR;9;2023-04-05;0;2;5;27;1;3;32;78;39;1588;2058;15756;154068;1334;10485;156321;228230;60558
FR;9;2023-04-06;0;0;4;13;0;2;16;42;23;1588;2058;15760;154081;1334;10487;156337;228272;60581
FR;9;2023-04-07;1;6;1;7;2;4;7;34;19;1589;2064;15761;154088;1336;10491;156344;228306;60600
FR;9;2023-04-08;0;1;2;1;0;1;3;7;2;1589;2065;15763;154089;1336;10492;156347;228313;60602
FR;9;2023-04-09;0;1;0;0;1;0;0;2;1;1589;2066;15763;154089;1337;10492;156347;228315;60603
FR;9;2023-04-10;0;1;1;5;1;1;5;6;0;1589;2067;15764;154094;1338;10493;156352;228321;60603
FR;9;2023-04-11;2;5;4;9;4;3;8;22;8;1591;2072;15768;154103;1342;10496;156360;228343;60611
FR;9;2023-04-12;1;2;6;8;2;4;10;41;24;1592;2074;15774;154111;1344;10500;156370;228384;60635
FR;9;2023-04-13;0;0;2;4;0;2;4;15;9;1592;2074;15776;154115;1344;10502;156374;228399;60644
FR;9;2023-04-14;1;4;7;10;1;6;12;38;13;1593;2078;15783;154125;1345;10508;156386;228437;60657
FR;9;2023-04-15;0;1;2;2;1;1;2;7;4;1593;2079;15785;154127;1346;10509;156388;228444;60661
FR;9;2023-04-16;0;1;0;0;1;0;0;0;0;1593;2080;15785;154127;1347;10509;156388;228444;60661
FR;9;2023-04-17;1;2;7;11;2;3;14;45;21;1594;2082;15792;154138;1349;10512;156402;228489;60682
FR;9;2023-04-18;2;1;3;8;1;2;9;34;21;1596;2083;15795;154146;1350;10514;156411;228523;60703
FR;9;2023-04-19;1;0;2;4;0;2;4;28;16;1597;2083;15797;154150;1350;10516;156415;228551;60719
FR;9;2023-04-20;1;0;2;6;0;2;6;24;13;1598;2083;15799;154156;1350;10518;156421;228575;60732
FR;9;2023-04-21;0;2;2;5;1;3;8;31;15;1598;2085;15801;154161;1351;10521;156429;228606;60747
FR;9;2023-04-22;0;1;0;2;1;0;2;3;1;1598;2086;15801;154163;1352;10521;156431;228609;60748
FR;9;2023-04-23;0;0;0;0;0;0;0;1;0;1598;2086;15801;154163;1352;10521;156431;228610;60748
FR;9;2023-04-24;1;3;3;13;3;3;11;26;9;1599;2089;15804;154176;1355;10524;156442;228636;60757
FR;9;2023-04-25;1;2;5;11;2;1;16;87;43;1600;2091;15809;154187;1357;10525;156458;228723;60800
FR;9;2023-04-26;5;0;4;9;0;5;4;13;3;1605;2091;15813;154196;1357;10530;156462;228736;60803
FR;9;2023-04-27;0;2;4;2;2;4;1;9;3;1605;2093;15817;154198;1359;10534;156463;228745;60806
FR;9;2023-04-28;0;0;0;0;0;0;0;4;4;1605;2093;15817;154198;1359;10534;156463;228749;60810
FR;9;2023-04-29;1;2;2;0;1;1;3;8;3;1606;2095;15819;154198;1360;10535;156466;228757;60813
FR;9;2023-04-30;0;1;0;0;1;0;0;0;0;1606;2096;15819;154198;1361;10535;156466;228757;60813
FR;9;2023-05-01;0;0;0;0;0;0;0;0;0;1606;2096;15819;154198;1361;10535;156466;228757;60813
FR;9;2023-05-02;1;1;3;2;0;3;3;18;7;1607;2097;15822;154200;1361;10538;156469;228775;60820
FR;9;2023-05-03;2;2;2;2;1;3;2;9;3;1609;2099;15824;154202;1362;10541;156471;228784;60823
FR;9;2023-05-04;0;1;2;2;1;2;3;9;2;1609;2100;15826;154204;1363;10543;156474;228793;60825
FR;9;2023-05-05;0;1;2;1;1;0;3;19;11;1609;2101;15828;154205;1364;10543;156477;228812;60836
FR;9;2023-05-06;0;1;0;0;1;0;0;3;2;1609;2102;15828;154205;1365;10543;156477;228815;60838
FR;9;2023-05-07;0;1;0;0;0;1;0;1;0;1609;2103;15828;154205;1365;10544;156477;228816;60838
FR;9;2023-05-08;0;0;0;0;0;0;0;0;0;1609;2103;15828;154205;1365;10544;156477;228816;60838
FR;9;2023-05-09;0;1;3;16;1;3;14;45;28;1609;2104;15831;154221;1366;10547;156491;228861;60866
FR;9;2023-05-10;1;0;0;0;0;1;0;9;3;1610;2104;15831;154221;1366;10548;156491;228870;60869
FR;9;2023-05-11;0;0;1;0;0;1;0;7;5;1610;2104;15832;154221;1366;10549;156491;228877;60874
FR;9;2023-05-12;1;1;4;1;0;3;3;14;7;1611;2105;15836;154222;1366;10552;156494;228891;60881
FR;9;2023-05-13;0;0;0;0;0;0;0;2;1;1611;2105;15836;154222;1366;10552;156494;228893;60882
FR;9;2023-05-14;0;0;0;0;0;0;0;0;0;1611;2105;15836;154222;1366;10552;156494;228893;60882
FR;9;2023-05-15;0;0;0;1;0;0;1;9;2;1611;2105;15836;154223;1366;10552;156495;228902;60884
FR;9;2023-05-16;0;1;0;3;1;0;3;11;4;1611;2106;15836;154226;1367;10552;156498;228913;60888
FR;9;2023-05-17;0;0;1;4;0;1;3;7;0;1611;2106;15837;154230;1367;10553;156501;228920;60888
FR;9;2023-05-18;0;0;0;0;0;0;0;0;0;1611;2106;15837;154230;1367;10553;156501;228920;60888
FR;9;2023-05-19;0;1;1;1;1;0;2;6;4;1611;2107;15838;154231;1368;10553;156503;228926;60892
FR;9;2023-05-20;0;0;0;0;0;0;0;2;0;1611;2107;15838;154231;1368;10553;156503;228928;60892
FR;9;2023-05-21;0;0;0;0;0;0;0;0;0;1611;2107;15838;154231;1368;10553;156503;228928;60892
FR;9;2023-05-22;0;1;0;0;1;0;0;4;4;1611;2108;15838;154231;1369;10553;156503;228932;60896
FR;9;2023-05-23;1;1;0;1;0;1;1;10;3;1612;2109;15838;154232;1369;10554;156504;228942;60899
FR;9;2023-05-24;0;1;0;2;1;0;2;4;0;1612;2110;15838;154234;1370;10554;156506;228946;60899
FR;9;2023-05-25;0;0;0;0;0;0;0;3;0;1612;2110;15838;154234;1370;10554;156506;228949;60899
FR;9;2023-05-26;0;0;2;4;0;3;2;14;8;1612;2110;15840;154238;1370;10557;156508;228963;60907
FR;9;2023-05-27;0;0;0;0;0;0;0;0;0;1612;2110;15840;154238;1370;10557;156508;228963;60907
FR;9;2023-05-28;0;0;0;0;0;0;0;0;0;1612;2110;15840;154238;1370;10557;156508;228963;60907
FR;9;2023-05-29;0;0;0;0;0;0;0;0;0;1612;2110;15840;154238;1370;10557;156508;228963;60907
FR;9;2023-05-30;0;0;1;1;0;0;1;15;9;1612;2110;15841;154239;1370;10557;156509;228978;60916
FR;9;2023-05-31;0;0;2;1;0;1;0;5;1;1612;2110;15843;154240;1370;10558;156509;228983;60917
FR;9;2023-06-01;0;0;0;1;0;0;1;8;5;1612;2110;15843;154241;1370;10558;156510;228991;60922
FR;9;2023-06-02;0;0;1;2;0;1;2;15;6;1612;2110;15844;154243;1370;10559;156512;229006;60928
FR;9;2023-06-03;0;0;1;2;0;0;6;9;3;1612;2110;15845;154245;1370;10559;156518;229015;60931
FR;9;2023-06-04;0;0;0;0;0;0;0;0;0;1612;2110;15845;154245;1370;10559;156518;229015;60931
FR;9;2023-06-05;0;0;0;0;0;0;0;1;0;1612;2110;15845;154245;1370;10559;156518;229016;60931
FR;9;2023-06-06;0;0;0;0;0;0;0;9;3;1612;2110;15845;154245;1370;10559;156518;229025;60934
FR;9;2023-06-07;0;0;0;2;0;0;2;8;3;1612;2110;15845;154247;1370;10559;156520;229033;60937
FR;9;2023-06-08;0;0;1;1;0;1;1;7;4;1612;2110;15846;154248;1370;10560;156521;229040;60941
FR;9;2023-06-09;0;0;0;0;0;0;0;9;1;1612;2110;15846;154248;1370;10560;156521;229049;60942
FR;9;2023-06-10;0;1;1;1;0;1;2;8;1;1612;2111;15847;154249;1370;10561;156523;229057;60943
FR;9;2023-06-11;0;0;0;0;0;0;0;0;0;1612;2111;15847;154249;1370;10561;156523;229057;60943
FR;9;2023-06-12;0;0;0;0;0;0;0;4;3;1612;2111;15847;154249;1370;10561;156523;229061;60946
FR;10;2020-12-27;0;0;0;0;0;0;0;0;0;0;0;0;0;0;0;0;0;0
FR;10;2020-12-28;0;0;0;0;0;0;0;0;0;0;0;0;0;0;0;0;0;0
FR;10;2020-12-29;0;0;0;0;0;0;0;0;0;0;0;0;0;0;0;0;0;0
FR;10;2020-12-30;0;0;0;0;0;0;0;0;0;0;0;0;0;0;0;0;0;0
FR;10;2020-12-31;0;0;0;0;0;0;0;0;0;0;0;0;0;0;0;0;0;0
FR;10;2021-01-01;0;0;0;0;0;0;0;0;0;0;0;0;0;0;0;0;0;0
FR;10;2021-01-02;0;0;0;0;0;0;0;0;0;0;0;0;0;0;0;0;0;0
FR;10;2021-01-03;0;0;0;0;0;0;0;0;0;0;0;0;0;0;0;0;0;0
FR;10;2021-01-04;0;0;0;0;0;0;0;0;0;0;0;0;0;0;0;0;0;0
FR;10;2021-01-05;0;0;0;0;0;0;0;0;0;0;0;0;0;0;0;0;0;0
FR;10;2021-01-06;0;0;0;0;0;0;0;0;0;0;0;0;0;0;0;0;0;0
FR;10;2021-01-07;0;0;0;0;0;0;0;0;0;0;0;0;0;0;0;0;0;0
FR;10;2021-01-08;0;0;0;0;0;0;0;0;0;0;0;0;0;0;0;0;0;0
FR;10;2021-01-09;0;0;0;0;0;0;0;0;0;0;0;0;0;0;0;0;0;0
FR;10;2021-01-10;0;0;0;0;0;0;0;0;0;0;0;0;0;0;0;0;0;0
FR;10;2021-01-11;0;0;0;0;0;0;0;0;0;0;0;0;0;0;0;0;0;0
FR;10;2021-01-12;0;0;0;0;0;0;0;0;0;0;0;0;0;0;0;0;0;0
FR;10;2021-01-13;0;0;0;0;0;0;0;0;0;0;0;0;0;0;0;0;0;0
FR;10;2021-01-14;0;0;0;0;0;0;0;0;0;0;0;0;0;0;0;0;0;0
FR;10;2021-01-15;0;0;0;0;0;0;0;0;0;0;0;0;0;0;0;0;0;0
FR;10;2021-01-16;0;0;0;0;0;0;0;0;0;0;0;0;0;0;0;0;0;0
FR;10;2021-01-17;0;0;0;0;0;0;0;0;0;0;0;0;0;0;0;0;0;0
FR;10;2021-01-18;0;0;0;0;0;0;0;0;0;0;0;0;0;0;0;0;0;0
FR;10;2021-01-19;0;0;0;0;0;0;0;0;0;0;0;0;0;0;0;0;0;0
FR;10;2021-01-20;0;0;0;0;0;0;0;0;0;0;0;0;0;0;0;0;0;0
FR;10;2021-01-21;0;0;0;0;0;0;0;0;0;0;0;0;0;0;0;0;0;0
FR;10;2021-01-22;0;0;0;0;0;0;0;0;0;0;0;0;0;0;0;0;0;0
FR;10;2021-01-23;0;0;0;0;0;0;0;0;0;0;0;0;0;0;0;0;0;0
FR;10;2021-01-24;0;0;0;0;0;0;0;0;0;0;0;0;0;0;0;0;0;0
FR;10;2021-01-25;0;0;0;0;0;0;0;0;0;0;0;0;0;0;0;0;0;0
FR;10;2021-01-26;0;0;0;0;0;0;0;0;0;0;0;0;0;0;0;0;0;0
FR;10;2021-01-27;0;0;0;0;0;0;0;0;0;0;0;0;0;0;0;0;0;0
FR;10;2021-01-28;0;0;0;0;0;0;0;0;0;0;0;0;0;0;0;0;0;0
FR;10;2021-01-29;0;0;0;0;0;0;0;0;0;0;0;0;0;0;0;0;0;0
FR;10;2021-01-30;0;0;0;0;0;0;0;0;0;0;0;0;0;0;0;0;0;0
FR;10;2021-01-31;0;0;0;0;0;0;0;0;0;0;0;0;0;0;0;0;0;0
FR;10;2021-02-01;0;0;0;0;0;0;0;0;0;0;0;0;0;0;0;0;0;0
FR;10;2021-02-02;0;0;0;0;0;0;0;0;0;0;0;0;0;0;0;0;0;0
FR;10;2021-02-03;0;0;0;0;0;0;0;0;0;0;0;0;0;0;0;0;0;0
FR;10;2021-02-04;0;0;0;0;0;0;0;0;0;0;0;0;0;0;0;0;0;0
FR;10;2021-02-05;0;0;0;0;0;0;0;0;0;0;0;0;0;0;0;0;0;0
FR;10;2021-02-06;0;0;0;0;0;0;0;0;0;0;0;0;0;0;0;0;0;0
FR;10;2021-02-07;0;0;0;0;0;0;0;0;0;0;0;0;0;0;0;0;0;0
FR;10;2021-02-08;0;0;0;0;0;0;0;0;0;0;0;0;0;0;0;0;0;0
FR;10;2021-02-09;0;0;0;0;0;0;0;0;0;0;0;0;0;0;0;0;0;0
FR;10;2021-02-10;0;0;0;0;0;0;0;0;0;0;0;0;0;0;0;0;0;0
FR;10;2021-02-11;0;0;0;0;0;0;0;0;0;0;0;0;0;0;0;0;0;0
FR;10;2021-02-12;0;0;0;0;0;0;0;0;0;0;0;0;0;0;0;0;0;0
FR;10;2021-02-13;0;0;0;0;0;0;0;0;0;0;0;0;0;0;0;0;0;0
FR;10;2021-02-14;0;0;0;0;0;0;0;0;0;0;0;0;0;0;0;0;0;0
FR;10;2021-02-15;0;0;0;0;0;0;0;0;0;0;0;0;0;0;0;0;0;0
FR;10;2021-02-16;0;0;0;0;0;0;0;0;0;0;0;0;0;0;0;0;0;0
FR;10;2021-02-17;0;0;0;0;0;0;0;0;0;0;0;0;0;0;0;0;0;0
FR;10;2021-02-18;0;0;0;0;0;0;0;0;0;0;0;0;0;0;0;0;0;0
FR;10;2021-02-19;0;0;0;0;0;0;0;0;0;0;0;0;0;0;0;0;0;0
FR;10;2021-02-20;0;0;0;0;0;0;0;0;0;0;0;0;0;0;0;0;0;0
FR;10;2021-02-21;0;0;0;0;0;0;0;0;0;0;0;0;0;0;0;0;0;0
FR;10;2021-02-22;0;0;0;0;0;0;0;0;0;0;0;0;0;0;0;0;0;0
FR;10;2021-02-23;0;0;0;0;0;0;0;0;0;0;0;0;0;0;0;0;0;0
FR;10;2021-02-24;0;0;0;0;0;0;0;0;0;0;0;0;0;0;0;0;0;0
FR;10;2021-02-25;0;0;0;0;0;0;0;0;0;0;0;0;0;0;0;0;0;0
FR;10;2021-02-26;0;0;0;0;0;0;0;0;0;0;0;0;0;0;0;0;0;0
FR;10;2021-02-27;0;0;0;0;0;0;0;0;0;0;0;0;0;0;0;0;0;0
FR;10;2021-02-28;0;0;0;0;0;0;0;0;0;0;0;0;0;0;0;0;0;0
FR;10;2021-03-01;0;0;0;0;0;0;0;0;0;0;0;0;0;0;0;0;0;0
FR;10;2021-03-02;0;0;0;0;0;0;0;0;0;0;0;0;0;0;0;0;0;0
FR;10;2021-03-03;0;0;0;0;0;0;0;0;0;0;0;0;0;0;0;0;0;0
FR;10;2021-03-04;0;0;0;0;0;0;0;0;0;0;0;0;0;0;0;0;0;0
FR;10;2021-03-05;0;0;0;0;0;0;0;0;0;0;0;0;0;0;0;0;0;0
FR;10;2021-03-06;0;0;0;0;0;0;0;0;0;0;0;0;0;0;0;0;0;0
FR;10;2021-03-07;0;0;0;0;0;0;0;0;0;0;0;0;0;0;0;0;0;0
FR;10;2021-03-08;0;0;0;0;0;0;0;0;0;0;0;0;0;0;0;0;0;0
FR;10;2021-03-09;0;0;0;0;0;0;0;0;0;0;0;0;0;0;0;0;0;0
FR;10;2021-03-10;0;0;0;0;0;0;0;0;0;0;0;0;0;0;0;0;0;0
FR;10;2021-03-11;0;0;0;0;0;0;0;0;0;0;0;0;0;0;0;0;0;0
FR;10;2021-03-12;0;0;0;0;0;0;0;0;0;0;0;0;0;0;0;0;0;0
FR;10;2021-03-13;0;0;0;0;0;0;0;0;0;0;0;0;0;0;0;0;0;0
FR;10;2021-03-14;0;0;0;0;0;0;0;0;0;0;0;0;0;0;0;0;0;0
FR;10;2021-03-15;0;0;0;0;0;0;0;0;0;0;0;0;0;0;0;0;0;0
FR;10;2021-03-16;0;0;0;0;0;0;0;0;0;0;0;0;0;0;0;0;0;0
FR;10;2021-03-17;0;0;0;0;0;0;0;0;0;0;0;0;0;0;0;0;0;0
FR;10;2021-03-18;0;0;0;0;0;0;0;0;0;0;0;0;0;0;0;0;0;0
FR;10;2021-03-19;0;0;0;0;0;0;0;0;0;0;0;0;0;0;0;0;0;0
FR;10;2021-03-20;0;0;0;0;0;0;0;0;0;0;0;0;0;0;0;0;0;0
FR;10;2021-03-21;0;0;0;0;0;0;0;0;0;0;0;0;0;0;0;0;0;0
FR;10;2021-03-22;0;0;0;0;0;0;0;0;0;0;0;0;0;0;0;0;0;0
FR;10;2021-03-23;0;0;0;0;0;0;0;0;0;0;0;0;0;0;0;0;0;0
FR;10;2021-03-24;0;0;0;0;0;0;0;0;0;0;0;0;0;0;0;0;0;0
FR;10;2021-03-25;0;0;0;0;0;0;0;0;0;0;0;0;0;0;0;0;0;0
FR;10;2021-03-26;0;0;0;0;0;0;0;0;0;0;0;0;0;0;0;0;0;0
FR;10;2021-03-27;0;0;0;0;0;0;0;0;0;0;0;0;0;0;0;0;0;0
FR;10;2021-03-28;0;0;0;0;0;0;0;0;0;0;0;0;0;0;0;0;0;0
FR;10;2021-03-29;0;0;0;0;0;0;0;0;0;0;0;0;0;0;0;0;0;0
FR;10;2021-03-30;0;0;0;0;0;0;0;0;0;0;0;0;0;0;0;0;0;0
FR;10;2021-03-31;0;0;0;0;0;0;0;0;0;0;0;0;0;0;0;0;0;0
FR;10;2021-04-01;0;0;0;0;0;0;0;0;0;0;0;0;0;0;0;0;0;0
FR;10;2021-04-02;0;0;0;0;0;0;0;0;0;0;0;0;0;0;0;0;0;0
FR;10;2021-04-03;0;0;0;0;0;0;0;0;0;0;0;0;0;0;0;0;0;0
FR;10;2021-04-04;0;0;0;0;0;0;0;0;0;0;0;0;0;0;0;0;0;0
FR;10;2021-04-05;0;0;0;0;0;0;0;0;0;0;0;0;0;0;0;0;0;0
FR;10;2021-04-06;0;0;0;0;0;0;0;0;0;0;0;0;0;0;0;0;0;0
FR;10;2021-04-07;0;0;0;0;0;0;0;0;0;0;0;0;0;0;0;0;0;0
FR;10;2021-04-08;0;0;0;0;0;0;0;0;0;0;0;0;0;0;0;0;0;0
FR;10;2021-04-09;0;0;0;0;0;0;0;0;0;0;0;0;0;0;0;0;0;0
FR;10;2021-04-10;0;0;0;0;0;0;0;0;0;0;0;0;0;0;0;0;0;0
FR;10;2021-04-11;0;0;0;0;0;0;0;0;0;0;0;0;0;0;0;0;0;0
FR;10;2021-04-12;0;0;0;0;0;0;0;0;0;0;0;0;0;0;0;0;0;0
FR;10;2021-04-13;0;0;0;0;0;0;0;0;0;0;0;0;0;0;0;0;0;0
FR;10;2021-04-14;0;0;0;0;0;0;0;0;0;0;0;0;0;0;0;0;0;0
FR;10;2021-04-15;0;0;0;0;0;0;0;0;0;0;0;0;0;0;0;0;0;0
FR;10;2021-04-16;0;0;0;0;0;0;0;0;0;0;0;0;0;0;0;0;0;0
FR;10;2021-04-17;0;0;0;0;0;0;0;0;0;0;0;0;0;0;0;0;0;0
FR;10;2021-04-18;0;0;0;0;0;0;0;0;0;0;0;0;0;0;0;0;0;0
FR;10;2021-04-19;0;0;0;0;0;0;0;0;0;0;0;0;0;0;0;0;0;0
FR;10;2021-04-20;0;0;0;0;0;0;0;0;0;0;0;0;0;0;0;0;0;0
FR;10;2021-04-21;0;0;0;0;0;0;0;0;0;0;0;0;0;0;0;0;0;0
FR;10;2021-04-22;0;0;0;0;0;0;0;0;0;0;0;0;0;0;0;0;0;0
FR;10;2021-04-23;0;0;0;0;0;0;0;0;0;0;0;0;0;0;0;0;0;0
FR;10;2021-04-24;0;0;0;0;0;0;0;0;0;0;0;0;0;0;0;0;0;0
FR;10;2021-04-25;0;0;0;0;0;0;0;0;0;0;0;0;0;0;0;0;0;0
FR;10;2021-04-26;0;0;0;0;0;0;0;0;0;0;0;0;0;0;0;0;0;0
FR;10;2021-04-27;0;0;0;0;0;0;0;0;0;0;0;0;0;0;0;0;0;0
FR;10;2021-04-28;0;0;0;0;0;0;0;0;0;0;0;0;0;0;0;0;0;0
FR;10;2021-04-29;0;0;0;0;0;0;0;0;0;0;0;0;0;0;0;0;0;0
FR;10;2021-04-30;0;0;0;0;0;0;0;0;0;0;0;0;0;0;0;0;0;0
FR;10;2021-05-01;0;0;0;0;0;0;0;0;0;0;0;0;0;0;0;0;0;0
FR;10;2021-05-02;0;0;0;0;0;0;0;0;0;0;0;0;0;0;0;0;0;0
FR;10;2021-05-03;0;0;0;0;0;0;0;0;0;0;0;0;0;0;0;0;0;0
FR;10;2021-05-04;0;0;0;0;0;0;0;0;0;0;0;0;0;0;0;0;0;0
FR;10;2021-05-05;0;0;0;0;0;0;0;0;0;0;0;0;0;0;0;0;0;0
FR;10;2021-05-06;0;0;0;0;0;0;0;0;0;0;0;0;0;0;0;0;0;0
FR;10;2021-05-07;0;0;0;0;0;0;0;0;0;0;0;0;0;0;0;0;0;0
FR;10;2021-05-08;0;0;0;0;0;0;0;0;0;0;0;0;0;0;0;0;0;0
FR;10;2021-05-09;0;0;0;0;0;0;0;0;0;0;0;0;0;0;0;0;0;0
FR;10;2021-05-10;0;0;0;0;0;0;0;0;0;0;0;0;0;0;0;0;0;0
FR;10;2021-05-11;0;0;0;0;0;0;0;0;0;0;0;0;0;0;0;0;0;0
FR;10;2021-05-12;0;0;0;0;0;0;0;0;0;0;0;0;0;0;0;0;0;0
FR;10;2021-05-13;0;0;0;0;0;0;0;0;0;0;0;0;0;0;0;0;0;0
FR;10;2021-05-14;0;0;0;0;0;0;0;0;0;0;0;0;0;0;0;0;0;0
FR;10;2021-05-15;0;0;0;0;0;0;0;0;0;0;0;0;0;0;0;0;0;0
FR;10;2021-05-16;0;0;0;0;0;0;0;0;0;0;0;0;0;0;0;0;0;0
FR;10;2021-05-17;0;0;0;0;0;0;0;0;0;0;0;0;0;0;0;0;0;0
FR;10;2021-05-18;0;0;0;0;0;0;0;0;0;0;0;0;0;0;0;0;0;0
FR;10;2021-05-19;0;0;0;0;0;0;0;0;0;0;0;0;0;0;0;0;0;0
FR;10;2021-05-20;0;0;0;0;0;0;0;0;0;0;0;0;0;0;0;0;0;0
FR;10;2021-05-21;0;0;0;0;0;0;0;0;0;0;0;0;0;0;0;0;0;0
FR;10;2021-05-22;0;0;0;0;0;0;0;0;0;0;0;0;0;0;0;0;0;0
FR;10;2021-05-23;0;0;0;0;0;0;0;0;0;0;0;0;0;0;0;0;0;0
FR;10;2021-05-24;0;0;0;0;0;0;0;0;0;0;0;0;0;0;0;0;0;0
FR;10;2021-05-25;0;0;0;0;0;0;0;0;0;0;0;0;0;0;0;0;0;0
FR;10;2021-05-26;0;0;0;0;0;0;0;0;0;0;0;0;0;0;0;0;0;0
FR;10;2021-05-27;0;0;0;0;0;0;0;0;0;0;0;0;0;0;0;0;0;0
FR;10;2021-05-28;0;0;0;0;0;0;0;0;0;0;0;0;0;0;0;0;0;0
FR;10;2021-05-29;0;0;0;0;0;0;0;0;0;0;0;0;0;0;0;0;0;0
FR;10;2021-05-30;0;0;0;0;0;0;0;0;0;0;0;0;0;0;0;0;0;0
FR;10;2021-05-31;0;0;0;0;0;0;0;0;0;0;0;0;0;0;0;0;0;0
FR;10;2021-06-01;0;0;0;0;0;0;0;0;0;0;0;0;0;0;0;0;0;0
FR;10;2021-06-02;0;0;0;0;0;0;0;0;0;0;0;0;0;0;0;0;0;0
FR;10;2021-06-03;0;0;0;0;0;0;0;0;0;0;0;0;0;0;0;0;0;0
FR;10;2021-06-04;0;0;0;0;0;0;0;0;0;0;0;0;0;0;0;0;0;0
FR;10;2021-06-05;0;0;0;0;0;0;0;0;0;0;0;0;0;0;0;0;0;0
FR;10;2021-06-06;0;0;0;0;0;0;0;0;0;0;0;0;0;0;0;0;0;0
FR;10;2021-06-07;0;0;0;0;0;0;0;0;0;0;0;0;0;0;0;0;0;0
FR;10;2021-06-08;0;0;0;0;0;0;0;0;0;0;0;0;0;0;0;0;0;0
FR;10;2021-06-09;0;0;0;0;0;0;0;0;0;0;0;0;0;0;0;0;0;0
FR;10;2021-06-10;0;0;0;0;0;0;0;0;0;0;0;0;0;0;0;0;0;0
FR;10;2021-06-11;0;0;0;0;0;0;0;0;0;0;0;0;0;0;0;0;0;0
FR;10;2021-06-12;0;0;0;0;0;0;0;0;0;0;0;0;0;0;0;0;0;0
FR;10;2021-06-13;0;0;0;0;0;0;0;0;0;0;0;0;0;0;0;0;0;0
FR;10;2021-06-14;0;0;0;0;0;0;0;0;0;0;0;0;0;0;0;0;0;0
FR;10;2021-06-15;0;0;0;0;0;0;0;0;0;0;0;0;0;0;0;0;0;0
FR;10;2021-06-16;0;0;0;0;0;0;0;0;0;0;0;0;0;0;0;0;0;0
FR;10;2021-06-17;0;0;0;0;0;0;0;0;0;0;0;0;0;0;0;0;0;0
FR;10;2021-06-18;0;0;0;0;0;0;0;0;0;0;0;0;0;0;0;0;0;0
FR;10;2021-06-19;0;0;0;0;0;0;0;0;0;0;0;0;0;0;0;0;0;0
FR;10;2021-06-20;0;0;0;0;0;0;0;0;0;0;0;0;0;0;0;0;0;0
FR;10;2021-06-21;0;0;0;0;0;0;0;0;0;0;0;0;0;0;0;0;0;0
FR;10;2021-06-22;0;0;0;0;0;0;0;0;0;0;0;0;0;0;0;0;0;0
FR;10;2021-06-23;0;0;0;0;0;0;0;0;0;0;0;0;0;0;0;0;0;0
FR;10;2021-06-24;0;0;0;0;0;0;0;0;0;0;0;0;0;0;0;0;0;0
FR;10;2021-06-25;0;0;0;0;0;0;0;0;0;0;0;0;0;0;0;0;0;0
FR;10;2021-06-26;0;0;0;0;0;0;0;0;0;0;0;0;0;0;0;0;0;0
FR;10;2021-06-27;0;0;0;0;0;0;0;0;0;0;0;0;0;0;0;0;0;0
FR;10;2021-06-28;0;0;0;0;0;0;0;0;0;0;0;0;0;0;0;0;0;0
FR;10;2021-06-29;0;0;0;0;0;0;0;0;0;0;0;0;0;0;0;0;0;0
FR;10;2021-06-30;0;0;0;0;0;0;0;0;0;0;0;0;0;0;0;0;0;0
FR;10;2021-07-01;0;0;0;0;0;0;0;0;0;0;0;0;0;0;0;0;0;0
FR;10;2021-07-02;0;0;0;0;0;0;0;0;0;0;0;0;0;0;0;0;0;0
FR;10;2021-07-03;0;0;0;0;0;0;0;0;0;0;0;0;0;0;0;0;0;0
FR;10;2021-07-04;0;0;0;0;0;0;0;0;0;0;0;0;0;0;0;0;0;0
FR;10;2021-07-05;0;0;0;0;0;0;0;0;0;0;0;0;0;0;0;0;0;0
FR;10;2021-07-06;0;0;0;0;0;0;0;0;0;0;0;0;0;0;0;0;0;0
FR;10;2021-07-07;0;0;0;0;0;0;0;0;0;0;0;0;0;0;0;0;0;0
FR;10;2021-07-08;0;0;0;0;0;0;0;0;0;0;0;0;0;0;0;0;0;0
FR;10;2021-07-09;0;0;0;0;0;0;0;0;0;0;0;0;0;0;0;0;0;0
FR;10;2021-07-10;0;0;0;0;0;0;0;0;0;0;0;0;0;0;0;0;0;0
FR;10;2021-07-11;0;0;0;0;0;0;0;0;0;0;0;0;0;0;0;0;0;0
FR;10;2021-07-12;0;0;0;0;0;0;0;0;0;0;0;0;0;0;0;0;0;0
FR;10;2021-07-13;0;0;0;0;0;0;0;0;0;0;0;0;0;0;0;0;0;0
FR;10;2021-07-14;0;0;0;0;0;0;0;0;0;0;0;0;0;0;0;0;0;0
FR;10;2021-07-15;0;0;0;0;0;0;0;0;0;0;0;0;0;0;0;0;0;0
FR;10;2021-07-16;0;0;0;0;0;0;0;0;0;0;0;0;0;0;0;0;0;0
FR;10;2021-07-17;0;0;0;0;0;0;0;0;0;0;0;0;0;0;0;0;0;0
FR;10;2021-07-18;0;0;0;0;0;0;0;0;0;0;0;0;0;0;0;0;0;0
FR;10;2021-07-19;0;0;0;0;0;0;0;0;0;0;0;0;0;0;0;0;0;0
FR;10;2021-07-20;0;0;0;0;0;0;0;0;0;0;0;0;0;0;0;0;0;0
FR;10;2021-07-21;0;0;0;0;0;0;0;0;0;0;0;0;0;0;0;0;0;0
FR;10;2021-07-22;0;0;0;0;0;0;0;0;0;0;0;0;0;0;0;0;0;0
FR;10;2021-07-23;0;0;0;0;0;0;0;0;0;0;0;0;0;0;0;0;0;0
FR;10;2021-07-24;0;0;0;0;0;0;0;0;0;0;0;0;0;0;0;0;0;0
FR;10;2021-07-25;0;0;0;0;0;0;0;0;0;0;0;0;0;0;0;0;0;0
FR;10;2021-07-26;0;0;0;0;0;0;0;0;0;0;0;0;0;0;0;0;0;0
FR;10;2021-07-27;0;0;0;0;0;0;0;0;0;0;0;0;0;0;0;0;0;0
FR;10;2021-07-28;0;0;0;0;0;0;0;0;0;0;0;0;0;0;0;0;0;0
FR;10;2021-07-29;0;0;0;0;0;0;0;0;0;0;0;0;0;0;0;0;0;0
FR;10;2021-07-30;0;0;0;0;0;0;0;0;0;0;0;0;0;0;0;0;0;0
FR;10;2021-07-31;0;0;0;0;0;0;0;0;0;0;0;0;0;0;0;0;0;0
FR;10;2021-08-01;0;0;0;0;0;0;0;0;0;0;0;0;0;0;0;0;0;0
FR;10;2021-08-02;0;0;0;0;0;0;0;0;0;0;0;0;0;0;0;0;0;0
FR;10;2021-08-03;0;0;0;0;0;0;0;0;0;0;0;0;0;0;0;0;0;0
FR;10;2021-08-04;0;0;0;0;0;0;0;0;0;0;0;0;0;0;0;0;0;0
FR;10;2021-08-05;0;0;0;0;0;0;0;0;0;0;0;0;0;0;0;0;0;0
FR;10;2021-08-06;0;0;0;0;0;0;0;0;0;0;0;0;0;0;0;0;0;0
FR;10;2021-08-07;0;0;0;0;0;0;0;0;0;0;0;0;0;0;0;0;0;0
FR;10;2021-08-08;0;0;0;0;0;0;0;0;0;0;0;0;0;0;0;0;0;0
FR;10;2021-08-09;0;0;0;0;0;0;0;0;0;0;0;0;0;0;0;0;0;0
FR;10;2021-08-10;0;0;0;0;0;0;0;0;0;0;0;0;0;0;0;0;0;0
FR;10;2021-08-11;0;0;0;0;0;0;0;0;0;0;0;0;0;0;0;0;0;0
FR;10;2021-08-12;0;0;0;0;0;0;0;0;0;0;0;0;0;0;0;0;0;0
FR;10;2021-08-13;0;0;0;0;0;0;0;0;0;0;0;0;0;0;0;0;0;0
FR;10;2021-08-14;0;0;0;0;0;0;0;0;0;0;0;0;0;0;0;0;0;0
FR;10;2021-08-15;0;0;0;0;0;0;0;0;0;0;0;0;0;0;0;0;0;0
FR;10;2021-08-16;0;0;0;0;0;0;0;0;0;0;0;0;0;0;0;0;0;0
FR;10;2021-08-17;0;0;0;0;0;0;0;0;0;0;0;0;0;0;0;0;0;0
FR;10;2021-08-18;0;0;0;0;0;0;0;0;0;0;0;0;0;0;0;0;0;0
FR;10;2021-08-19;0;0;0;0;0;0;0;0;0;0;0;0;0;0;0;0;0;0
FR;10;2021-08-20;0;0;0;0;0;0;0;0;0;0;0;0;0;0;0;0;0;0
FR;10;2021-08-21;0;0;0;0;0;0;0;0;0;0;0;0;0;0;0;0;0;0
FR;10;2021-08-22;0;0;0;0;0;0;0;0;0;0;0;0;0;0;0;0;0;0
FR;10;2021-08-23;0;0;0;0;0;0;0;0;0;0;0;0;0;0;0;0;0;0
FR;10;2021-08-24;0;0;0;0;0;0;0;0;0;0;0;0;0;0;0;0;0;0
FR;10;2021-08-25;0;0;0;0;0;0;0;0;0;0;0;0;0;0;0;0;0;0
FR;10;2021-08-26;0;0;0;0;0;0;0;0;0;0;0;0;0;0;0;0;0;0
FR;10;2021-08-27;0;0;0;0;0;0;0;0;0;0;0;0;0;0;0;0;0;0
FR;10;2021-08-28;0;0;0;0;0;0;0;0;0;0;0;0;0;0;0;0;0;0
FR;10;2021-08-29;0;0;0;0;0;0;0;0;0;0;0;0;0;0;0;0;0;0
FR;10;2021-08-30;0;0;0;0;0;0;0;0;0;0;0;0;0;0;0;0;0;0
FR;10;2021-08-31;0;0;0;0;0;0;0;0;0;0;0;0;0;0;0;0;0;0
FR;10;2021-09-01;0;0;0;0;0;0;0;0;0;0;0;0;0;0;0;0;0;0
FR;10;2021-09-02;0;0;0;0;0;0;0;0;0;0;0;0;0;0;0;0;0;0
FR;10;2021-09-03;0;0;0;0;0;0;0;0;0;0;0;0;0;0;0;0;0;0
FR;10;2021-09-04;0;0;0;0;0;0;0;0;0;0;0;0;0;0;0;0;0;0
FR;10;2021-09-05;0;0;0;0;0;0;0;0;0;0;0;0;0;0;0;0;0;0
FR;10;2021-09-06;0;0;0;0;0;0;0;0;0;0;0;0;0;0;0;0;0;0
FR;10;2021-09-07;0;0;0;0;0;0;0;0;0;0;0;0;0;0;0;0;0;0
FR;10;2021-09-08;0;0;0;0;0;0;0;0;0;0;0;0;0;0;0;0;0;0
FR;10;2021-09-09;0;0;0;0;0;0;0;0;0;0;0;0;0;0;0;0;0;0
FR;10;2021-09-10;0;0;0;0;0;0;0;0;0;0;0;0;0;0;0;0;0;0
FR;10;2021-09-11;0;0;0;0;0;0;0;0;0;0;0;0;0;0;0;0;0;0
FR;10;2021-09-12;0;0;0;0;0;0;0;0;0;0;0;0;0;0;0;0;0;0
FR;10;2021-09-13;0;0;0;0;0;0;0;0;0;0;0;0;0;0;0;0;0;0
FR;10;2021-09-14;0;0;0;0;0;0;0;0;0;0;0;0;0;0;0;0;0;0
FR;10;2021-09-15;0;0;0;0;0;0;0;0;0;0;0;0;0;0;0;0;0;0
FR;10;2021-09-16;0;0;0;0;0;0;0;0;0;0;0;0;0;0;0;0;0;0
FR;10;2021-09-17;0;0;0;0;0;0;0;0;0;0;0;0;0;0;0;0;0;0
FR;10;2021-09-18;0;0;0;0;0;0;0;0;0;0;0;0;0;0;0;0;0;0
FR;10;2021-09-19;0;0;0;0;0;0;0;0;0;0;0;0;0;0;0;0;0;0
FR;10;2021-09-20;0;0;0;0;0;0;0;0;0;0;0;0;0;0;0;0;0;0
FR;10;2021-09-21;0;0;0;0;0;0;0;0;0;0;0;0;0;0;0;0;0;0
FR;10;2021-09-22;0;0;0;0;0;0;0;0;0;0;0;0;0;0;0;0;0;0
FR;10;2021-09-23;0;0;0;0;0;0;0;0;0;0;0;0;0;0;0;0;0;0
FR;10;2021-09-24;0;0;0;0;0;0;0;0;0;0;0;0;0;0;0;0;0;0
FR;10;2021-09-25;0;0;0;0;0;0;0;0;0;0;0;0;0;0;0;0;0;0
FR;10;2021-09-26;0;0;0;0;0;0;0;0;0;0;0;0;0;0;0;0;0;0
FR;10;2021-09-27;0;0;0;0;0;0;0;0;0;0;0;0;0;0;0;0;0;0
FR;10;2021-09-28;0;0;0;0;0;0;0;0;0;0;0;0;0;0;0;0;0;0
FR;10;2021-09-29;0;0;0;0;0;0;0;0;0;0;0;0;0;0;0;0;0;0
FR;10;2021-09-30;0;0;0;0;0;0;0;0;0;0;0;0;0;0;0;0;0;0
FR;10;2021-10-01;0;0;0;0;0;0;0;0;0;0;0;0;0;0;0;0;0;0
FR;10;2021-10-02;0;0;0;0;0;0;0;0;0;0;0;0;0;0;0;0;0;0
FR;10;2021-10-03;0;0;0;0;0;0;0;0;0;0;0;0;0;0;0;0;0;0
FR;10;2021-10-04;0;0;0;0;0;0;0;0;0;0;0;0;0;0;0;0;0;0
FR;10;2021-10-05;0;0;0;0;0;0;0;0;0;0;0;0;0;0;0;0;0;0
FR;10;2021-10-06;0;0;0;0;0;0;0;0;0;0;0;0;0;0;0;0;0;0
FR;10;2021-10-07;0;0;0;0;0;0;0;0;0;0;0;0;0;0;0;0;0;0
FR;10;2021-10-08;0;0;0;0;0;0;0;0;0;0;0;0;0;0;0;0;0;0
FR;10;2021-10-09;0;0;0;0;0;0;0;0;0;0;0;0;0;0;0;0;0;0
FR;10;2021-10-10;0;0;0;0;0;0;0;0;0;0;0;0;0;0;0;0;0;0
FR;10;2021-10-11;0;0;0;0;0;0;0;0;0;0;0;0;0;0;0;0;0;0
FR;10;2021-10-12;0;0;0;0;0;0;0;0;0;0;0;0;0;0;0;0;0;0
FR;10;2021-10-13;0;0;0;0;0;0;0;0;0;0;0;0;0;0;0;0;0;0
FR;10;2021-10-14;0;0;0;0;0;0;0;0;0;0;0;0;0;0;0;0;0;0
FR;10;2021-10-15;0;0;0;0;0;0;0;0;0;0;0;0;0;0;0;0;0;0
FR;10;2021-10-16;0;0;0;0;0;0;0;0;0;0;0;0;0;0;0;0;0;0
FR;10;2021-10-17;0;0;0;0;0;0;0;0;0;0;0;0;0;0;0;0;0;0
FR;10;2021-10-18;0;0;0;0;0;0;0;0;0;0;0;0;0;0;0;0;0;0
FR;10;2021-10-19;0;0;0;0;0;0;0;0;0;0;0;0;0;0;0;0;0;0
FR;10;2021-10-20;0;0;0;0;0;0;0;0;0;0;0;0;0;0;0;0;0;0
FR;10;2021-10-21;0;0;0;0;0;0;0;0;0;0;0;0;0;0;0;0;0;0
FR;10;2021-10-22;0;0;0;0;0;0;0;0;0;0;0;0;0;0;0;0;0;0
FR;10;2021-10-23;0;0;0;0;0;0;0;0;0;0;0;0;0;0;0;0;0;0
FR;10;2021-10-24;0;0;0;0;0;0;0;0;0;0;0;0;0;0;0;0;0;0
FR;10;2021-10-25;0;0;0;0;0;0;0;0;0;0;0;0;0;0;0;0;0;0
FR;10;2021-10-26;0;0;0;0;0;0;0;0;0;0;0;0;0;0;0;0;0;0
FR;10;2021-10-27;0;0;0;0;0;0;0;0;0;0;0;0;0;0;0;0;0;0
FR;10;2021-10-28;0;0;0;0;0;0;0;0;0;0;0;0;0;0;0;0;0;0
FR;10;2021-10-29;0;0;0;0;0;0;0;0;0;0;0;0;0;0;0;0;0;0
FR;10;2021-10-30;0;0;0;0;0;0;0;0;0;0;0;0;0;0;0;0;0;0
FR;10;2021-10-31;0;0;0;0;0;0;0;0;0;0;0;0;0;0;0;0;0;0
FR;10;2021-11-01;0;0;0;0;0;0;0;0;0;0;0;0;0;0;0;0;0;0
FR;10;2021-11-02;0;0;0;0;0;0;0;0;0;0;0;0;0;0;0;0;0;0
FR;10;2021-11-03;0;0;0;0;0;0;0;0;0;0;0;0;0;0;0;0;0;0
FR;10;2021-11-04;0;0;0;0;0;0;0;0;0;0;0;0;0;0;0;0;0;0
FR;10;2021-11-05;0;0;0;0;0;0;0;0;0;0;0;0;0;0;0;0;0;0
FR;10;2021-11-06;0;0;0;0;0;0;0;0;0;0;0;0;0;0;0;0;0;0
FR;10;2021-11-07;0;0;0;0;0;0;0;0;0;0;0;0;0;0;0;0;0;0
FR;10;2021-11-08;0;0;0;0;0;0;0;0;0;0;0;0;0;0;0;0;0;0
FR;10;2021-11-09;0;0;0;0;0;0;0;0;0;0;0;0;0;0;0;0;0;0
FR;10;2021-11-10;0;0;0;0;0;0;0;0;0;0;0;0;0;0;0;0;0;0
FR;10;2021-11-11;0;0;0;0;0;0;0;0;0;0;0;0;0;0;0;0;0;0
FR;10;2021-11-12;0;0;0;0;0;0;0;0;0;0;0;0;0;0;0;0;0;0
FR;10;2021-11-13;0;0;0;0;0;0;0;0;0;0;0;0;0;0;0;0;0;0
FR;10;2021-11-14;0;0;0;0;0;0;0;0;0;0;0;0;0;0;0;0;0;0
FR;10;2021-11-15;0;0;0;0;0;0;0;0;0;0;0;0;0;0;0;0;0;0
FR;10;2021-11-16;0;0;0;0;0;0;0;0;0;0;0;0;0;0;0;0;0;0
FR;10;2021-11-17;0;0;0;0;0;0;0;0;0;0;0;0;0;0;0;0;0;0
FR;10;2021-11-18;0;0;0;0;0;0;0;0;0;0;0;0;0;0;0;0;0;0
FR;10;2021-11-19;0;0;0;0;0;0;0;0;0;0;0;0;0;0;0;0;0;0
FR;10;2021-11-20;0;0;0;0;0;0;0;0;0;0;0;0;0;0;0;0;0;0
FR;10;2021-11-21;0;0;0;0;0;0;0;0;0;0;0;0;0;0;0;0;0;0
FR;10;2021-11-22;0;0;0;0;0;0;0;0;0;0;0;0;0;0;0;0;0;0
FR;10;2021-11-23;0;0;0;0;0;0;0;0;0;0;0;0;0;0;0;0;0;0
FR;10;2021-11-24;0;0;0;0;0;0;0;0;0;0;0;0;0;0;0;0;0;0
FR;10;2021-11-25;0;0;0;0;0;0;0;0;0;0;0;0;0;0;0;0;0;0
FR;10;2021-11-26;0;0;0;0;0;0;0;0;0;0;0;0;0;0;0;0;0;0
FR;10;2021-11-27;0;0;0;0;0;0;0;0;0;0;0;0;0;0;0;0;0;0
FR;10;2021-11-28;0;0;0;0;0;0;0;0;0;0;0;0;0;0;0;0;0;0
FR;10;2021-11-29;0;0;0;0;0;0;0;0;0;0;0;0;0;0;0;0;0;0
FR;10;2021-11-30;0;0;0;0;0;0;0;0;0;0;0;0;0;0;0;0;0;0
FR;10;2021-12-01;0;0;0;0;0;0;0;0;0;0;0;0;0;0;0;0;0;0
FR;10;2021-12-02;0;0;0;0;0;0;0;0;0;0;0;0;0;0;0;0;0;0
FR;10;2021-12-03;0;0;0;0;0;0;0;0;0;0;0;0;0;0;0;0;0;0
FR;10;2021-12-04;0;0;0;0;0;0;0;0;0;0;0;0;0;0;0;0;0;0
FR;10;2021-12-05;0;0;0;0;0;0;0;0;0;0;0;0;0;0;0;0;0;0
FR;10;2021-12-06;0;0;0;0;0;0;0;0;0;0;0;0;0;0;0;0;0;0
FR;10;2021-12-07;0;0;0;0;0;0;0;0;0;0;0;0;0;0;0;0;0;0
FR;10;2021-12-08;0;0;0;0;0;0;0;0;0;0;0;0;0;0;0;0;0;0
FR;10;2021-12-09;0;0;0;0;0;0;0;0;0;0;0;0;0;0;0;0;0;0
FR;10;2021-12-10;0;0;0;0;0;0;0;0;0;0;0;0;0;0;0;0;0;0
FR;10;2021-12-11;0;0;0;0;0;0;0;0;0;0;0;0;0;0;0;0;0;0
FR;10;2021-12-12;0;0;0;0;0;0;0;0;0;0;0;0;0;0;0;0;0;0
FR;10;2021-12-13;0;0;0;0;0;0;0;0;0;0;0;0;0;0;0;0;0;0
FR;10;2021-12-14;0;0;0;0;0;0;0;0;0;0;0;0;0;0;0;0;0;0
FR;10;2021-12-15;0;0;0;0;0;0;0;0;0;0;0;0;0;0;0;0;0;0
FR;10;2021-12-16;0;0;0;0;0;0;0;0;0;0;0;0;0;0;0;0;0;0
FR;10;2021-12-17;0;0;0;0;0;0;0;0;0;0;0;0;0;0;0;0;0;0
FR;10;2021-12-18;0;0;0;0;0;0;0;0;0;0;0;0;0;0;0;0;0;0
FR;10;2021-12-19;0;0;0;0;0;0;0;0;0;0;0;0;0;0;0;0;0;0
FR;10;2021-12-20;0;0;0;0;0;0;0;0;0;0;0;0;0;0;0;0;0;0
FR;10;2021-12-21;0;0;0;0;0;0;0;0;0;0;0;0;0;0;0;0;0;0
FR;10;2021-12-22;0;0;0;0;0;0;0;0;0;0;0;0;0;0;0;0;0;0
FR;10;2021-12-23;0;0;0;0;0;0;0;0;0;0;0;0;0;0;0;0;0;0
FR;10;2021-12-24;0;0;0;0;0;0;0;0;0;0;0;0;0;0;0;0;0;0
FR;10;2021-12-25;0;0;0;0;0;0;0;0;0;0;0;0;0;0;0;0;0;0
FR;10;2021-12-26;0;0;0;0;0;0;0;0;0;0;0;0;0;0;0;0;0;0
FR;10;2021-12-27;0;0;0;0;0;0;0;0;0;0;0;0;0;0;0;0;0;0
FR;10;2021-12-28;0;0;0;0;0;0;0;0;0;0;0;0;0;0;0;0;0;0
FR;10;2021-12-29;0;0;0;0;0;0;0;0;0;0;0;0;0;0;0;0;0;0
FR;10;2021-12-30;0;0;0;0;0;0;0;0;0;0;0;0;0;0;0;0;0;0
FR;10;2021-12-31;0;0;0;0;0;0;0;0;0;0;0;0;0;0;0;0;0;0
FR;10;2022-01-01;0;0;0;0;0;0;0;0;0;0;0;0;0;0;0;0;0;0
FR;10;2022-01-02;0;0;0;0;0;0;0;0;0;0;0;0;0;0;0;0;0;0
FR;10;2022-01-03;0;0;0;0;0;0;0;0;0;0;0;0;0;0;0;0;0;0
FR;10;2022-01-04;0;0;0;0;0;0;0;0;0;0;0;0;0;0;0;0;0;0
FR;10;2022-01-05;0;0;0;0;0;0;0;0;0;0;0;0;0;0;0;0;0;0
FR;10;2022-01-06;0;0;0;0;0;0;0;0;0;0;0;0;0;0;0;0;0;0
FR;10;2022-01-07;0;0;0;0;0;0;0;0;0;0;0;0;0;0;0;0;0;0
FR;10;2022-01-08;0;0;0;0;0;0;0;0;0;0;0;0;0;0;0;0;0;0
FR;10;2022-01-09;0;0;0;0;0;0;0;0;0;0;0;0;0;0;0;0;0;0
FR;10;2022-01-10;0;0;0;0;0;0;0;0;0;0;0;0;0;0;0;0;0;0
FR;10;2022-01-11;0;0;0;0;0;0;0;0;0;0;0;0;0;0;0;0;0;0
FR;10;2022-01-12;0;0;0;0;0;0;0;0;0;0;0;0;0;0;0;0;0;0
FR;10;2022-01-13;0;0;0;0;0;0;0;0;0;0;0;0;0;0;0;0;0;0
FR;10;2022-01-14;0;0;0;0;0;0;0;0;0;0;0;0;0;0;0;0;0;0
FR;10;2022-01-15;0;0;0;0;0;0;0;0;0;0;0;0;0;0;0;0;0;0
FR;10;2022-01-16;0;0;0;0;0;0;0;0;0;0;0;0;0;0;0;0;0;0
FR;10;2022-01-17;0;0;0;0;0;0;0;0;0;0;0;0;0;0;0;0;0;0
FR;10;2022-01-18;0;0;0;0;0;0;0;0;0;0;0;0;0;0;0;0;0;0
FR;10;2022-01-19;0;0;0;0;0;0;0;0;0;0;0;0;0;0;0;0;0;0
FR;10;2022-01-20;0;0;0;0;0;0;0;0;0;0;0;0;0;0;0;0;0;0
FR;10;2022-01-21;0;0;0;0;0;0;0;0;0;0;0;0;0;0;0;0;0;0
FR;10;2022-01-22;0;0;0;0;0;0;0;0;0;0;0;0;0;0;0;0;0;0
FR;10;2022-01-23;0;0;0;0;0;0;0;0;0;0;0;0;0;0;0;0;0;0
FR;10;2022-01-24;0;0;0;0;0;0;0;0;0;0;0;0;0;0;0;0;0;0
FR;10;2022-01-25;0;0;0;0;0;0;0;0;0;0;0;0;0;0;0;0;0;0
FR;10;2022-01-26;0;0;0;0;0;0;0;0;0;0;0;0;0;0;0;0;0;0
FR;10;2022-01-27;0;0;0;0;0;0;0;0;0;0;0;0;0;0;0;0;0;0
FR;10;2022-01-28;0;0;0;0;0;0;0;0;0;0;0;0;0;0;0;0;0;0
FR;10;2022-01-29;0;0;0;0;0;0;0;0;0;0;0;0;0;0;0;0;0;0
FR;10;2022-01-30;0;0;0;0;0;0;0;0;0;0;0;0;0;0;0;0;0;0
FR;10;2022-01-31;0;0;0;0;0;0;0;0;0;0;0;0;0;0;0;0;0;0
FR;10;2022-02-01;0;0;0;0;0;0;0;0;0;0;0;0;0;0;0;0;0;0
FR;10;2022-02-02;0;0;0;0;0;0;0;0;0;0;0;0;0;0;0;0;0;0
FR;10;2022-02-03;0;0;0;0;0;0;0;0;0;0;0;0;0;0;0;0;0;0
FR;10;2022-02-04;0;0;0;0;0;0;0;0;0;0;0;0;0;0;0;0;0;0
FR;10;2022-02-05;0;0;0;0;0;0;0;0;0;0;0;0;0;0;0;0;0;0
FR;10;2022-02-06;0;0;0;0;0;0;0;0;0;0;0;0;0;0;0;0;0;0
FR;10;2022-02-07;0;0;0;0;0;0;0;0;0;0;0;0;0;0;0;0;0;0
FR;10;2022-02-08;0;0;0;0;0;0;0;0;0;0;0;0;0;0;0;0;0;0
FR;10;2022-02-09;0;0;0;0;0;0;0;0;0;0;0;0;0;0;0;0;0;0
FR;10;2022-02-10;0;0;0;0;0;0;0;0;0;0;0;0;0;0;0;0;0;0
FR;10;2022-02-11;0;0;0;0;0;0;0;0;0;0;0;0;0;0;0;0;0;0
FR;10;2022-02-12;0;0;0;0;0;0;0;0;0;0;0;0;0;0;0;0;0;0
FR;10;2022-02-13;0;0;0;0;0;0;0;0;0;0;0;0;0;0;0;0;0;0
FR;10;2022-02-14;0;0;0;0;0;0;0;0;0;0;0;0;0;0;0;0;0;0
FR;10;2022-02-15;0;0;0;0;0;0;0;0;0;0;0;0;0;0;0;0;0;0
FR;10;2022-02-16;0;0;0;0;0;0;0;0;0;0;0;0;0;0;0;0;0;0
FR;10;2022-02-17;0;0;0;0;0;0;0;0;0;0;0;0;0;0;0;0;0;0
FR;10;2022-02-18;0;0;0;0;0;0;0;0;0;0;0;0;0;0;0;0;0;0
FR;10;2022-02-19;0;0;0;0;0;0;0;0;0;0;0;0;0;0;0;0;0;0
FR;10;2022-02-20;0;0;0;0;0;0;0;0;0;0;0;0;0;0;0;0;0;0
FR;10;2022-02-21;0;0;0;0;0;0;0;0;0;0;0;0;0;0;0;0;0;0
FR;10;2022-02-22;0;0;0;0;0;0;0;0;0;0;0;0;0;0;0;0;0;0
FR;10;2022-02-23;0;0;0;0;0;0;0;0;0;0;0;0;0;0;0;0;0;0
FR;10;2022-02-24;0;0;0;0;0;0;0;0;0;0;0;0;0;0;0;0;0;0
FR;10;2022-02-25;0;0;0;0;0;0;0;0;0;0;0;0;0;0;0;0;0;0
FR;10;2022-02-26;0;0;0;0;0;0;0;0;0;0;0;0;0;0;0;0;0;0
FR;10;2022-02-27;0;0;0;0;0;0;0;0;0;0;0;0;0;0;0;0;0;0
FR;10;2022-02-28;0;0;0;0;0;0;0;0;0;0;0;0;0;0;0;0;0;0
FR;10;2022-03-01;0;0;0;0;0;0;0;0;0;0;0;0;0;0;0;0;0;0
FR;10;2022-03-02;0;0;0;0;0;0;0;0;0;0;0;0;0;0;0;0;0;0
FR;10;2022-03-03;0;0;0;0;0;0;0;0;0;0;0;0;0;0;0;0;0;0
FR;10;2022-03-04;0;0;0;0;0;0;0;0;0;0;0;0;0;0;0;0;0;0
FR;10;2022-03-05;0;0;0;0;0;0;0;0;0;0;0;0;0;0;0;0;0;0
FR;10;2022-03-06;0;0;0;0;0;0;0;0;0;0;0;0;0;0;0;0;0;0
FR;10;2022-03-07;0;0;0;0;0;0;0;0;0;0;0;0;0;0;0;0;0;0
FR;10;2022-03-08;0;0;0;0;0;0;0;0;0;0;0;0;0;0;0;0;0;0
FR;10;2022-03-09;0;0;0;0;0;0;0;0;0;0;0;0;0;0;0;0;0;0
FR;10;2022-03-10;0;0;0;0;0;0;0;0;0;0;0;0;0;0;0;0;0;0
FR;10;2022-03-11;0;0;0;0;0;0;0;0;0;0;0;0;0;0;0;0;0;0
FR;10;2022-03-12;0;0;0;0;0;0;0;0;0;0;0;0;0;0;0;0;0;0
FR;10;2022-03-13;0;0;0;0;0;0;0;0;0;0;0;0;0;0;0;0;0;0
FR;10;2022-03-14;0;0;0;0;0;0;0;0;0;0;0;0;0;0;0;0;0;0
FR;10;2022-03-15;0;0;0;0;0;0;0;0;0;0;0;0;0;0;0;0;0;0
FR;10;2022-03-16;0;0;0;0;0;0;0;0;0;0;0;0;0;0;0;0;0;0
FR;10;2022-03-17;0;0;0;0;0;0;0;0;0;0;0;0;0;0;0;0;0;0
FR;10;2022-03-18;0;0;0;0;0;0;0;0;0;0;0;0;0;0;0;0;0;0
FR;10;2022-03-19;0;0;0;0;0;0;0;0;0;0;0;0;0;0;0;0;0;0
FR;10;2022-03-20;0;0;0;0;0;0;0;0;0;0;0;0;0;0;0;0;0;0
FR;10;2022-03-21;0;0;0;0;0;0;0;0;0;0;0;0;0;0;0;0;0;0
FR;10;2022-03-22;0;0;0;0;0;0;0;0;0;0;0;0;0;0;0;0;0;0
FR;10;2022-03-23;0;0;0;0;0;0;0;0;0;0;0;0;0;0;0;0;0;0
FR;10;2022-03-24;0;0;0;0;0;0;0;0;0;0;0;0;0;0;0;0;0;0
FR;10;2022-03-25;0;0;0;0;0;0;0;0;0;0;0;0;0;0;0;0;0;0
FR;10;2022-03-26;0;0;0;0;0;0;0;0;0;0;0;0;0;0;0;0;0;0
FR;10;2022-03-27;0;0;0;0;0;0;0;0;0;0;0;0;0;0;0;0;0;0
FR;10;2022-03-28;0;0;0;0;0;0;0;0;0;0;0;0;0;0;0;0;0;0
FR;10;2022-03-29;0;0;0;0;0;0;0;0;0;0;0;0;0;0;0;0;0;0
FR;10;2022-03-30;0;0;0;0;0;0;0;0;0;0;0;0;0;0;0;0;0;0
FR;10;2022-03-31;0;0;0;0;0;0;0;0;0;0;0;0;0;0;0;0;0;0
FR;10;2022-04-01;0;0;0;0;0;0;0;0;0;0;0;0;0;0;0;0;0;0
FR;10;2022-04-02;0;0;0;0;0;0;0;0;0;0;0;0;0;0;0;0;0;0
FR;10;2022-04-03;0;0;0;0;0;0;0;0;0;0;0;0;0;0;0;0;0;0
FR;10;2022-04-04;0;0;0;0;0;0;0;0;0;0;0;0;0;0;0;0;0;0
FR;10;2022-04-05;0;0;0;0;0;0;0;0;0;0;0;0;0;0;0;0;0;0
FR;10;2022-04-06;0;0;0;0;0;0;0;0;0;0;0;0;0;0;0;0;0;0
FR;10;2022-04-07;0;0;0;0;0;0;0;0;0;0;0;0;0;0;0;0;0;0
FR;10;2022-04-08;0;0;0;0;0;0;0;0;0;0;0;0;0;0;0;0;0;0
FR;10;2022-04-09;0;0;0;0;0;0;0;0;0;0;0;0;0;0;0;0;0;0
FR;10;2022-04-10;0;0;0;0;0;0;0;0;0;0;0;0;0;0;0;0;0;0
FR;10;2022-04-11;0;0;0;0;0;0;0;0;0;0;0;0;0;0;0;0;0;0
FR;10;2022-04-12;0;0;0;0;0;0;0;0;0;0;0;0;0;0;0;0;0;0
FR;10;2022-04-13;0;0;0;0;0;0;0;0;0;0;0;0;0;0;0;0;0;0
FR;10;2022-04-14;0;0;0;0;0;0;0;0;0;0;0;0;0;0;0;0;0;0
FR;10;2022-04-15;0;0;0;0;0;0;0;0;0;0;0;0;0;0;0;0;0;0
FR;10;2022-04-16;0;0;0;0;0;0;0;0;0;0;0;0;0;0;0;0;0;0
FR;10;2022-04-17;0;0;0;0;0;0;0;0;0;0;0;0;0;0;0;0;0;0
FR;10;2022-04-18;0;0;0;0;0;0;0;0;0;0;0;0;0;0;0;0;0;0
FR;10;2022-04-19;0;0;0;0;0;0;0;0;0;0;0;0;0;0;0;0;0;0
FR;10;2022-04-20;0;0;0;0;0;0;0;0;0;0;0;0;0;0;0;0;0;0
FR;10;2022-04-21;0;0;0;0;0;0;0;0;0;0;0;0;0;0;0;0;0;0
FR;10;2022-04-22;0;0;0;0;0;0;0;0;0;0;0;0;0;0;0;0;0;0
FR;10;2022-04-23;0;0;0;0;0;0;0;0;0;0;0;0;0;0;0;0;0;0
FR;10;2022-04-24;0;0;0;0;0;0;0;0;0;0;0;0;0;0;0;0;0;0
FR;10;2022-04-25;0;0;0;0;0;0;0;0;0;0;0;0;0;0;0;0;0;0
FR;10;2022-04-26;0;0;0;0;0;0;0;0;0;0;0;0;0;0;0;0;0;0
FR;10;2022-04-27;0;0;0;0;0;0;0;0;0;0;0;0;0;0;0;0;0;0
FR;10;2022-04-28;0;0;0;0;0;0;0;0;0;0;0;0;0;0;0;0;0;0
FR;10;2022-04-29;0;0;0;0;0;0;0;0;0;0;0;0;0;0;0;0;0;0
FR;10;2022-04-30;0;0;0;0;0;0;0;0;0;0;0;0;0;0;0;0;0;0
FR;10;2022-05-01;0;0;0;0;0;0;0;0;0;0;0;0;0;0;0;0;0;0
FR;10;2022-05-02;0;0;0;0;0;0;0;0;0;0;0;0;0;0;0;0;0;0
FR;10;2022-05-03;0;0;0;0;0;0;0;0;0;0;0;0;0;0;0;0;0;0
FR;10;2022-05-04;0;0;0;0;0;0;0;0;0;0;0;0;0;0;0;0;0;0
FR;10;2022-05-05;0;0;0;0;0;0;0;0;0;0;0;0;0;0;0;0;0;0
FR;10;2022-05-06;0;0;0;0;0;0;0;0;0;0;0;0;0;0;0;0;0;0
FR;10;2022-05-07;0;0;0;0;0;0;0;0;0;0;0;0;0;0;0;0;0;0
FR;10;2022-05-08;0;0;0;0;0;0;0;0;0;0;0;0;0;0;0;0;0;0
FR;10;2022-05-09;0;0;0;0;0;0;0;0;0;0;0;0;0;0;0;0;0;0
FR;10;2022-05-10;0;0;0;0;0;0;0;0;0;0;0;0;0;0;0;0;0;0
FR;10;2022-05-11;0;0;0;0;0;0;0;0;0;0;0;0;0;0;0;0;0;0
FR;10;2022-05-12;0;0;0;0;0;0;0;0;0;0;0;0;0;0;0;0;0;0
FR;10;2022-05-13;0;0;0;0;0;0;0;0;0;0;0;0;0;0;0;0;0;0
FR;10;2022-05-14;0;0;0;0;0;0;0;0;0;0;0;0;0;0;0;0;0;0
FR;10;2022-05-15;0;0;0;0;0;0;0;0;0;0;0;0;0;0;0;0;0;0
FR;10;2022-05-16;0;0;0;0;0;0;0;0;0;0;0;0;0;0;0;0;0;0
FR;10;2022-05-17;0;0;0;0;0;0;0;0;0;0;0;0;0;0;0;0;0;0
FR;10;2022-05-18;0;0;0;0;0;0;0;0;0;0;0;0;0;0;0;0;0;0
FR;10;2022-05-19;0;0;0;0;0;0;0;0;0;0;0;0;0;0;0;0;0;0
FR;10;2022-05-20;0;0;0;0;0;0;0;0;0;0;0;0;0;0;0;0;0;0
FR;10;2022-05-21;0;0;0;0;0;0;0;0;0;0;0;0;0;0;0;0;0;0
FR;10;2022-05-22;0;0;0;0;0;0;0;0;0;0;0;0;0;0;0;0;0;0
FR;10;2022-05-23;0;0;0;0;0;0;0;0;0;0;0;0;0;0;0;0;0;0
FR;10;2022-05-24;0;0;0;0;0;0;0;0;0;0;0;0;0;0;0;0;0;0
FR;10;2022-05-25;0;0;0;0;0;0;0;0;0;0;0;0;0;0;0;0;0;0
FR;10;2022-05-26;0;0;0;0;0;0;0;0;0;0;0;0;0;0;0;0;0;0
FR;10;2022-05-27;0;0;0;0;0;0;0;0;0;0;0;0;0;0;0;0;0;0
FR;10;2022-05-28;0;0;0;0;0;0;0;0;0;0;0;0;0;0;0;0;0;0
FR;10;2022-05-29;0;0;0;0;0;0;0;0;0;0;0;0;0;0;0;0;0;0
FR;10;2022-05-30;0;0;0;0;0;0;0;0;0;0;0;0;0;0;0;0;0;0
FR;10;2022-05-31;0;0;0;0;0;0;0;0;0;0;0;0;0;0;0;0;0;0
FR;10;2022-06-01;0;0;0;0;0;0;0;0;0;0;0;0;0;0;0;0;0;0
FR;10;2022-06-02;0;0;0;0;0;0;0;0;0;0;0;0;0;0;0;0;0;0
FR;10;2022-06-03;0;0;0;0;0;0;0;0;0;0;0;0;0;0;0;0;0;0
FR;10;2022-06-04;0;0;0;0;0;0;0;0;0;0;0;0;0;0;0;0;0;0
FR;10;2022-06-05;0;0;0;0;0;0;0;0;0;0;0;0;0;0;0;0;0;0
FR;10;2022-06-06;0;0;0;0;0;0;0;0;0;0;0;0;0;0;0;0;0;0
FR;10;2022-06-07;0;0;0;0;0;0;0;0;0;0;0;0;0;0;0;0;0;0
FR;10;2022-06-08;0;0;0;0;0;0;0;0;0;0;0;0;0;0;0;0;0;0
FR;10;2022-06-09;0;0;0;0;0;0;0;0;0;0;0;0;0;0;0;0;0;0
FR;10;2022-06-10;0;0;0;0;0;0;0;0;0;0;0;0;0;0;0;0;0;0
FR;10;2022-06-11;0;0;0;0;0;0;0;0;0;0;0;0;0;0;0;0;0;0
FR;10;2022-06-12;0;0;0;0;0;0;0;0;0;0;0;0;0;0;0;0;0;0
FR;10;2022-06-13;0;0;0;0;0;0;0;0;0;0;0;0;0;0;0;0;0;0
FR;10;2022-06-14;0;0;0;0;0;0;0;0;0;0;0;0;0;0;0;0;0;0
FR;10;2022-06-15;0;0;0;0;0;0;0;0;0;0;0;0;0;0;0;0;0;0
FR;10;2022-06-16;0;0;0;0;0;0;0;0;0;0;0;0;0;0;0;0;0;0
FR;10;2022-06-17;0;0;0;0;0;0;0;0;0;0;0;0;0;0;0;0;0;0
FR;10;2022-06-18;0;0;0;0;0;0;0;0;0;0;0;0;0;0;0;0;0;0
FR;10;2022-06-19;0;0;0;0;0;0;0;0;0;0;0;0;0;0;0;0;0;0
FR;10;2022-06-20;0;0;0;0;0;0;0;0;0;0;0;0;0;0;0;0;0;0
FR;10;2022-06-21;0;0;0;0;0;0;0;0;0;0;0;0;0;0;0;0;0;0
FR;10;2022-06-22;0;0;0;0;0;0;0;0;0;0;0;0;0;0;0;0;0;0
FR;10;2022-06-23;0;0;0;0;0;0;0;0;0;0;0;0;0;0;0;0;0;0
FR;10;2022-06-24;0;0;0;0;0;0;0;0;0;0;0;0;0;0;0;0;0;0
FR;10;2022-06-25;0;0;0;0;0;0;0;0;0;0;0;0;0;0;0;0;0;0
FR;10;2022-06-26;0;0;0;0;0;0;0;0;0;0;0;0;0;0;0;0;0;0
FR;10;2022-06-27;0;0;0;0;0;0;0;0;0;0;0;0;0;0;0;0;0;0
FR;10;2022-06-28;0;0;0;0;0;0;0;0;0;0;0;0;0;0;0;0;0;0
FR;10;2022-06-29;0;0;0;0;0;0;0;0;0;0;0;0;0;0;0;0;0;0
FR;10;2022-06-30;0;0;0;0;0;0;0;0;0;0;0;0;0;0;0;0;0;0
FR;10;2022-07-01;0;0;0;0;0;0;0;0;0;0;0;0;0;0;0;0;0;0
FR;10;2022-07-02;0;0;0;0;0;0;0;0;0;0;0;0;0;0;0;0;0;0
FR;10;2022-07-03;0;0;0;0;0;0;0;0;0;0;0;0;0;0;0;0;0;0
FR;10;2022-07-04;0;0;0;0;0;0;0;0;0;0;0;0;0;0;0;0;0;0
FR;10;2022-07-05;0;0;0;0;0;0;0;0;0;0;0;0;0;0;0;0;0;0
FR;10;2022-07-06;0;0;0;0;0;0;0;0;0;0;0;0;0;0;0;0;0;0
FR;10;2022-07-07;0;0;0;0;0;0;0;0;0;0;0;0;0;0;0;0;0;0
FR;10;2022-07-08;0;0;0;0;0;0;0;0;0;0;0;0;0;0;0;0;0;0
FR;10;2022-07-09;0;0;0;0;0;0;0;0;0;0;0;0;0;0;0;0;0;0
FR;10;2022-07-10;0;0;0;0;0;0;0;0;0;0;0;0;0;0;0;0;0;0
FR;10;2022-07-11;0;0;0;0;0;0;0;0;0;0;0;0;0;0;0;0;0;0
FR;10;2022-07-12;0;0;0;0;0;0;0;0;0;0;0;0;0;0;0;0;0;0
FR;10;2022-07-13;0;0;0;0;0;0;0;0;0;0;0;0;0;0;0;0;0;0
FR;10;2022-07-14;0;0;0;0;0;0;0;0;0;0;0;0;0;0;0;0;0;0
FR;10;2022-07-15;0;0;0;0;0;0;0;0;0;0;0;0;0;0;0;0;0;0
FR;10;2022-07-16;0;0;0;0;0;0;0;0;0;0;0;0;0;0;0;0;0;0
FR;10;2022-07-17;0;0;0;0;0;0;0;0;0;0;0;0;0;0;0;0;0;0
FR;10;2022-07-18;0;0;0;0;0;0;0;0;0;0;0;0;0;0;0;0;0;0
FR;10;2022-07-19;0;0;0;0;0;0;0;0;0;0;0;0;0;0;0;0;0;0
FR;10;2022-07-20;0;0;0;0;0;0;0;0;0;0;0;0;0;0;0;0;0;0
FR;10;2022-07-21;0;0;0;0;0;0;0;0;0;0;0;0;0;0;0;0;0;0
FR;10;2022-07-22;0;0;0;0;0;0;0;0;0;0;0;0;0;0;0;0;0;0
FR;10;2022-07-23;0;0;0;0;0;0;0;0;0;0;0;0;0;0;0;0;0;0
FR;10;2022-07-24;0;0;0;0;0;0;0;0;0;0;0;0;0;0;0;0;0;0
FR;10;2022-07-25;0;0;0;0;0;0;0;0;0;0;0;0;0;0;0;0;0;0
FR;10;2022-07-26;0;0;0;0;0;0;0;0;0;0;0;0;0;0;0;0;0;0
FR;10;2022-07-27;0;0;0;0;0;0;0;0;0;0;0;0;0;0;0;0;0;0
FR;10;2022-07-28;0;0;0;0;0;0;0;0;0;0;0;0;0;0;0;0;0;0
FR;10;2022-07-29;0;0;0;0;0;0;0;0;0;0;0;0;0;0;0;0;0;0
FR;10;2022-07-30;0;0;0;0;0;0;0;0;0;0;0;0;0;0;0;0;0;0
FR;10;2022-07-31;0;0;0;0;0;0;0;0;0;0;0;0;0;0;0;0;0;0
FR;10;2022-08-01;0;0;0;0;0;0;0;0;0;0;0;0;0;0;0;0;0;0
FR;10;2022-08-02;0;0;0;0;0;0;0;0;0;0;0;0;0;0;0;0;0;0
FR;10;2022-08-03;0;0;0;0;0;0;0;0;0;0;0;0;0;0;0;0;0;0
FR;10;2022-08-04;0;0;0;0;0;0;0;0;0;0;0;0;0;0;0;0;0;0
FR;10;2022-08-05;0;0;0;0;0;0;0;0;0;0;0;0;0;0;0;0;0;0
FR;10;2022-08-06;0;0;0;0;0;0;0;0;0;0;0;0;0;0;0;0;0;0
FR;10;2022-08-07;0;0;0;0;0;0;0;0;0;0;0;0;0;0;0;0;0;0
FR;10;2022-08-08;0;0;0;0;0;0;0;0;0;0;0;0;0;0;0;0;0;0
FR;10;2022-08-09;0;0;0;0;0;0;0;0;0;0;0;0;0;0;0;0;0;0
FR;10;2022-08-10;0;0;0;0;0;0;0;0;0;0;0;0;0;0;0;0;0;0
FR;10;2022-08-11;0;0;0;0;0;0;0;0;0;0;0;0;0;0;0;0;0;0
FR;10;2022-08-12;0;0;0;0;0;0;0;0;0;0;0;0;0;0;0;0;0;0
FR;10;2022-08-13;0;0;0;0;0;0;0;0;0;0;0;0;0;0;0;0;0;0
FR;10;2022-08-14;0;0;0;0;0;0;0;0;0;0;0;0;0;0;0;0;0;0
FR;10;2022-08-15;0;0;0;0;0;0;0;0;0;0;0;0;0;0;0;0;0;0
FR;10;2022-08-16;0;0;0;0;0;0;0;0;0;0;0;0;0;0;0;0;0;0
FR;10;2022-08-17;0;0;0;0;0;0;0;0;0;0;0;0;0;0;0;0;0;0
FR;10;2022-08-18;0;0;0;0;0;0;0;0;0;0;0;0;0;0;0;0;0;0
FR;10;2022-08-19;0;0;0;0;0;0;0;0;0;0;0;0;0;0;0;0;0;0
FR;10;2022-08-20;0;0;0;0;0;0;0;0;0;0;0;0;0;0;0;0;0;0
FR;10;2022-08-21;0;0;0;0;0;0;0;0;0;0;0;0;0;0;0;0;0;0
FR;10;2022-08-22;0;0;0;0;0;0;0;0;0;0;0;0;0;0;0;0;0;0
FR;10;2022-08-23;0;0;0;0;0;0;0;0;0;0;0;0;0;0;0;0;0;0
FR;10;2022-08-24;0;0;0;0;0;0;0;0;0;0;0;0;0;0;0;0;0;0
FR;10;2022-08-25;0;0;0;0;0;0;0;0;0;0;0;0;0;0;0;0;0;0
FR;10;2022-08-26;0;0;0;0;0;0;0;0;0;0;0;0;0;0;0;0;0;0
FR;10;2022-08-27;0;0;0;0;0;0;0;0;0;0;0;0;0;0;0;0;0;0
FR;10;2022-08-28;0;0;0;0;0;0;0;0;0;0;0;0;0;0;0;0;0;0
FR;10;2022-08-29;0;0;0;0;0;0;0;0;0;0;0;0;0;0;0;0;0;0
FR;10;2022-08-30;0;0;0;0;0;0;0;0;0;0;0;0;0;0;0;0;0;0
FR;10;2022-08-31;0;0;0;0;0;0;0;0;0;0;0;0;0;0;0;0;0;0
FR;10;2022-09-01;0;0;0;0;0;0;0;0;0;0;0;0;0;0;0;0;0;0
FR;10;2022-09-02;0;0;0;0;0;0;0;0;0;0;0;0;0;0;0;0;0;0
FR;10;2022-09-03;0;0;0;0;0;0;0;0;0;0;0;0;0;0;0;0;0;0
FR;10;2022-09-04;0;0;0;0;0;0;0;0;0;0;0;0;0;0;0;0;0;0
FR;10;2022-09-05;0;0;0;0;0;0;0;0;0;0;0;0;0;0;0;0;0;0
FR;10;2022-09-06;0;0;0;0;0;0;0;0;0;0;0;0;0;0;0;0;0;0
FR;10;2022-09-07;0;0;0;0;0;0;0;0;0;0;0;0;0;0;0;0;0;0
FR;10;2022-09-08;0;0;0;0;0;0;0;0;0;0;0;0;0;0;0;0;0;0
FR;10;2022-09-09;0;0;0;0;0;0;0;0;0;0;0;0;0;0;0;0;0;0
FR;10;2022-09-10;0;0;0;0;0;0;0;0;0;0;0;0;0;0;0;0;0;0
FR;10;2022-09-11;0;0;0;0;0;0;0;0;0;0;0;0;0;0;0;0;0;0
FR;10;2022-09-12;0;0;0;0;0;0;0;0;0;0;0;0;0;0;0;0;0;0
FR;10;2022-09-13;0;0;0;0;0;0;0;0;0;0;0;0;0;0;0;0;0;0
FR;10;2022-09-14;0;0;0;0;0;0;0;0;0;0;0;0;0;0;0;0;0;0
FR;10;2022-09-15;0;0;0;0;0;0;0;0;0;0;0;0;0;0;0;0;0;0
FR;10;2022-09-16;0;0;0;0;0;0;0;0;0;0;0;0;0;0;0;0;0;0
FR;10;2022-09-17;0;0;0;0;0;0;0;0;0;0;0;0;0;0;0;0;0;0
FR;10;2022-09-18;0;0;0;0;0;0;0;0;0;0;0;0;0;0;0;0;0;0
FR;10;2022-09-19;0;0;0;0;0;0;0;0;0;0;0;0;0;0;0;0;0;0
FR;10;2022-09-20;0;0;0;0;0;0;0;0;0;0;0;0;0;0;0;0;0;0
FR;10;2022-09-21;0;0;0;0;0;0;0;0;0;0;0;0;0;0;0;0;0;0
FR;10;2022-09-22;0;0;0;0;0;0;0;0;0;0;0;0;0;0;0;0;0;0
FR;10;2022-09-23;0;0;0;0;0;0;0;0;0;0;0;0;0;0;0;0;0;0
FR;10;2022-09-24;0;0;0;0;0;0;0;0;0;0;0;0;0;0;0;0;0;0
FR;10;2022-09-25;0;0;0;0;0;0;0;0;0;0;0;0;0;0;0;0;0;0
FR;10;2022-09-26;0;0;0;0;0;0;0;0;0;0;0;0;0;0;0;0;0;0
FR;10;2022-09-27;0;0;0;0;0;0;0;0;0;0;0;0;0;0;0;0;0;0
FR;10;2022-09-28;0;0;0;0;0;0;0;0;0;0;0;0;0;0;0;0;0;0
FR;10;2022-09-29;0;0;0;0;0;0;0;0;0;0;0;0;0;0;0;0;0;0
FR;10;2022-09-30;0;0;0;0;0;0;0;0;0;0;0;0;0;0;0;0;0;0
FR;10;2022-10-01;0;0;0;0;0;0;0;0;0;0;0;0;0;0;0;0;0;0
FR;10;2022-10-02;0;0;0;0;0;0;0;0;0;0;0;0;0;0;0;0;0;0
FR;10;2022-10-03;0;0;0;0;0;0;0;0;0;0;0;0;0;0;0;0;0;0
FR;10;2022-10-04;0;0;0;0;0;0;0;0;0;0;0;0;0;0;0;0;0;0
FR;10;2022-10-05;0;0;0;0;0;0;0;0;0;0;0;0;0;0;0;0;0;0
FR;10;2022-10-06;0;0;0;0;0;0;0;0;0;0;0;0;0;0;0;0;0;0
FR;10;2022-10-07;0;0;0;0;0;0;0;0;0;0;0;0;0;0;0;0;0;0
FR;10;2022-10-08;0;0;0;0;0;0;0;0;0;0;0;0;0;0;0;0;0;0
FR;10;2022-10-09;0;0;0;0;0;0;0;0;0;0;0;0;0;0;0;0;0;0
FR;10;2022-10-10;0;0;0;0;0;0;0;0;0;0;0;0;0;0;0;0;0;0
FR;10;2022-10-11;0;0;0;0;0;0;0;0;0;0;0;0;0;0;0;0;0;0
FR;10;2022-10-12;0;0;0;0;0;0;0;0;0;0;0;0;0;0;0;0;0;0
FR;10;2022-10-13;0;0;0;0;0;0;0;0;0;0;0;0;0;0;0;0;0;0
FR;10;2022-10-14;0;0;0;0;0;0;0;0;0;0;0;0;0;0;0;0;0;0
FR;10;2022-10-15;0;0;0;0;0;0;0;0;0;0;0;0;0;0;0;0;0;0
FR;10;2022-10-16;0;0;0;0;0;0;0;0;0;0;0;0;0;0;0;0;0;0
FR;10;2022-10-17;0;0;0;0;0;0;0;0;0;0;0;0;0;0;0;0;0;0
FR;10;2022-10-18;0;0;0;0;0;0;0;0;0;0;0;0;0;0;0;0;0;0
FR;10;2022-10-19;0;0;0;0;0;0;0;0;0;0;0;0;0;0;0;0;0;0
FR;10;2022-10-20;0;0;0;0;0;0;0;0;0;0;0;0;0;0;0;0;0;0
FR;10;2022-10-21;0;0;0;0;0;0;0;0;0;0;0;0;0;0;0;0;0;0
FR;10;2022-10-22;0;0;0;0;0;0;0;0;0;0;0;0;0;0;0;0;0;0
FR;10;2022-10-23;0;0;0;0;0;0;0;0;0;0;0;0;0;0;0;0;0;0
FR;10;2022-10-24;0;0;0;0;0;0;0;0;0;0;0;0;0;0;0;0;0;0
FR;10;2022-10-25;0;0;0;0;0;0;0;0;0;0;0;0;0;0;0;0;0;0
FR;10;2022-10-26;0;0;0;0;0;0;0;0;0;0;0;0;0;0;0;0;0;0
FR;10;2022-10-27;0;0;0;0;0;0;0;0;0;0;0;0;0;0;0;0;0;0
FR;10;2022-10-28;0;0;0;0;0;0;0;0;0;0;0;0;0;0;0;0;0;0
FR;10;2022-10-29;0;0;0;0;0;0;0;0;0;0;0;0;0;0;0;0;0;0
FR;10;2022-10-30;0;0;0;0;0;0;0;0;0;0;0;0;0;0;0;0;0;0
FR;10;2022-10-31;0;0;0;0;0;0;0;0;0;0;0;0;0;0;0;0;0;0
FR;10;2022-11-01;0;0;0;0;0;0;0;0;0;0;0;0;0;0;0;0;0;0
FR;10;2022-11-02;0;0;0;0;0;0;0;0;0;0;0;0;0;0;0;0;0;0
FR;10;2022-11-03;0;0;0;0;0;0;0;0;0;0;0;0;0;0;0;0;0;0
FR;10;2022-11-04;0;0;0;0;0;0;0;0;0;0;0;0;0;0;0;0;0;0
FR;10;2022-11-05;0;0;0;0;0;0;0;0;0;0;0;0;0;0;0;0;0;0
FR;10;2022-11-06;0;0;0;0;0;0;0;0;0;0;0;0;0;0;0;0;0;0
FR;10;2022-11-07;0;0;0;0;0;0;0;0;0;0;0;0;0;0;0;0;0;0
FR;10;2022-11-08;0;0;0;0;0;0;0;0;0;0;0;0;0;0;0;0;0;0
FR;10;2022-11-09;0;0;0;0;0;0;0;0;0;0;0;0;0;0;0;0;0;0
FR;10;2022-11-10;0;0;0;0;0;0;0;0;0;0;0;0;0;0;0;0;0;0
FR;10;2022-11-11;0;0;0;0;0;0;0;0;0;0;0;0;0;0;0;0;0;0
FR;10;2022-11-12;0;0;0;0;0;0;0;0;0;0;0;0;0;0;0;0;0;0
FR;10;2022-11-13;0;0;0;0;0;0;0;0;0;0;0;0;0;0;0;0;0;0
FR;10;2022-11-14;0;0;0;0;0;0;0;0;0;0;0;0;0;0;0;0;0;0
FR;10;2022-11-15;0;0;0;0;0;0;0;0;0;0;0;0;0;0;0;0;0;0
FR;10;2022-11-16;0;0;0;0;0;0;0;0;0;0;0;0;0;0;0;0;0;0
FR;10;2022-11-17;0;0;0;0;0;0;0;0;0;0;0;0;0;0;0;0;0;0
FR;10;2022-11-18;0;0;0;0;0;0;0;0;0;0;0;0;0;0;0;0;0;0
FR;10;2022-11-19;0;0;0;0;0;0;0;0;0;0;0;0;0;0;0;0;0;0
FR;10;2022-11-20;0;0;0;0;0;0;0;0;0;0;0;0;0;0;0;0;0;0
FR;10;2022-11-21;0;0;0;0;0;0;0;0;0;0;0;0;0;0;0;0;0;0
FR;10;2022-11-22;0;0;0;0;0;0;0;0;0;0;0;0;0;0;0;0;0;0
FR;10;2022-11-23;0;0;0;0;0;0;0;0;0;0;0;0;0;0;0;0;0;0
FR;10;2022-11-24;0;0;0;0;0;0;0;0;0;0;0;0;0;0;0;0;0;0
FR;10;2022-11-25;0;0;0;0;0;0;0;0;0;0;0;0;0;0;0;0;0;0
FR;10;2022-11-26;0;0;0;0;0;0;0;0;0;0;0;0;0;0;0;0;0;0
FR;10;2022-11-27;0;0;0;0;0;0;0;0;0;0;0;0;0;0;0;0;0;0
FR;10;2022-11-28;0;0;0;0;0;0;0;0;0;0;0;0;0;0;0;0;0;0
FR;10;2022-11-29;0;0;0;0;0;0;0;0;0;0;0;0;0;0;0;0;0;0
FR;10;2022-11-30;0;0;0;0;0;0;0;0;0;0;0;0;0;0;0;0;0;0
FR;10;2022-12-01;0;0;0;0;0;0;0;0;0;0;0;0;0;0;0;0;0;0
FR;10;2022-12-02;0;0;0;0;0;0;0;0;0;0;0;0;0;0;0;0;0;0
FR;10;2022-12-03;0;0;0;0;0;0;0;0;0;0;0;0;0;0;0;0;0;0
FR;10;2022-12-04;0;0;0;0;0;0;0;0;0;0;0;0;0;0;0;0;0;0
FR;10;2022-12-05;0;0;0;0;0;0;0;0;0;0;0;0;0;0;0;0;0;0
FR;10;2022-12-06;0;0;0;0;0;0;0;0;0;0;0;0;0;0;0;0;0;0
FR;10;2022-12-07;0;0;0;0;0;0;0;0;0;0;0;0;0;0;0;0;0;0
FR;10;2022-12-08;0;0;0;0;0;0;0;0;0;0;0;0;0;0;0;0;0;0
FR;10;2022-12-09;0;0;0;0;0;0;0;0;0;0;0;0;0;0;0;0;0;0
FR;10;2022-12-10;0;0;0;0;0;0;0;0;0;0;0;0;0;0;0;0;0;0
FR;10;2022-12-11;0;0;0;0;0;0;0;0;0;0;0;0;0;0;0;0;0;0
FR;10;2022-12-12;0;0;0;0;0;0;0;0;0;0;0;0;0;0;0;0;0;0
FR;10;2022-12-13;0;0;0;0;0;0;0;0;0;0;0;0;0;0;0;0;0;0
FR;10;2022-12-14;0;0;0;0;0;0;0;0;0;0;0;0;0;0;0;0;0;0
FR;10;2022-12-15;0;0;0;0;0;0;0;0;0;0;0;0;0;0;0;0;0;0
FR;10;2022-12-16;0;0;0;0;0;0;0;0;0;0;0;0;0;0;0;0;0;0
FR;10;2022-12-17;0;0;0;0;0;0;0;0;0;0;0;0;0;0;0;0;0;0
FR;10;2022-12-18;0;0;0;0;0;0;0;0;0;0;0;0;0;0;0;0;0;0
FR;10;2022-12-19;0;0;0;0;0;0;0;0;0;0;0;0;0;0;0;0;0;0
FR;10;2022-12-20;0;0;0;0;0;0;0;0;0;0;0;0;0;0;0;0;0;0
FR;10;2022-12-21;0;0;1;0;0;1;0;0;0;0;0;1;0;0;1;0;0;0
FR;10;2022-12-22;0;0;0;1;0;0;1;0;0;0;0;1;1;0;1;1;0;0
FR;10;2022-12-23;0;0;1;14;0;2;14;0;7;0;0;2;15;0;3;15;0;7
FR;10;2022-12-24;0;0;0;3;0;0;3;0;1;0;0;2;18;0;3;18;0;8
FR;10;2022-12-25;0;0;0;0;0;0;0;0;0;0;0;2;18;0;3;18;0;8
FR;10;2022-12-26;3;1;11;35;0;8;39;0;5;3;1;13;53;0;11;57;0;13
FR;10;2022-12-27;1;1;14;35;1;11;38;0;10;4;2;27;88;1;22;95;0;23
FR;10;2022-12-28;0;0;2;15;0;1;14;0;3;4;2;29;103;1;23;109;0;26
FR;10;2022-12-29;0;0;6;48;0;1;48;0;17;4;2;35;151;1;24;157;0;43
FR;10;2022-12-30;0;1;5;33;0;8;31;0;6;4;3;40;184;1;32;188;0;49
FR;10;2022-12-31;0;0;3;12;0;4;10;0;4;4;3;43;196;1;36;198;0;53
FR;10;2023-01-01;0;0;1;6;0;0;7;0;2;4;3;44;202;1;36;205;0;55
FR;10;2023-01-02;0;4;4;37;1;6;36;0;21;4;7;48;239;2;42;241;0;76
FR;10;2023-01-03;1;2;6;63;2;5;64;0;25;5;9;54;302;4;47;305;0;101
FR;10;2023-01-04;0;1;7;52;0;6;53;0;53;5;10;61;354;4;53;358;0;154
FR;10;2023-01-05;1;2;16;74;0;12;76;0;37;6;12;77;428;4;65;434;0;191
FR;10;2023-01-06;2;3;16;107;2;13;107;0;52;8;15;93;535;6;78;541;0;243
FR;10;2023-01-07;3;1;3;41;1;3;40;0;13;11;16;96;576;7;81;581;0;256
FR;10;2023-01-08;1;0;0;9;0;0;7;0;5;12;16;96;585;7;81;588;0;261
FR;10;2023-01-09;3;2;7;67;1;7;66;0;26;15;18;103;652;8;88;654;0;287
FR;10;2023-01-10;6;1;21;118;0;13;124;0;57;21;19;124;770;8;101;778;0;344
FR;10;2023-01-11;5;4;19;77;1;16;79;0;38;26;23;143;847;9;117;857;0;382
FR;10;2023-01-12;13;1;7;77;2;3;80;0;51;39;24;150;924;11;120;937;0;433
FR;10;2023-01-13;0;6;15;122;1;8;129;0;77;39;30;165;1046;12;128;1066;0;510
FR;10;2023-01-14;2;1;8;43;0;5;47;0;3;41;31;173;1089;12;133;1113;0;513
FR;10;2023-01-15;0;0;2;10;0;1;7;0;8;41;31;175;1099;12;134;1120;0;521
FR;10;2023-01-16;0;1;11;70;1;7;73;0;68;41;32;186;1169;13;141;1193;0;589
FR;10;2023-01-17;0;7;22;109;2;11;118;0;61;41;39;208;1278;15;152;1311;0;650
FR;10;2023-01-18;2;1;13;92;1;9;104;0;15;43;40;221;1370;16;161;1415;0;665
FR;10;2023-01-19;6;6;24;142;3;22;135;0;56;49;46;245;1512;19;183;1550;0;721
FR;10;2023-01-20;2;1;11;111;0;9;106;0;73;51;47;256;1623;19;192;1656;0;794
FR;10;2023-01-21;2;1;5;26;0;5;23;0;15;53;48;261;1649;19;197;1679;0;809
FR;10;2023-01-22;0;0;0;5;0;0;5;0;0;53;48;261;1654;19;197;1684;0;809
FR;10;2023-01-23;1;2;5;62;1;5;59;0;23;54;50;266;1716;20;202;1743;0;832
FR;10;2023-01-24;6;6;27;148;2;19;152;0;75;60;56;293;1864;22;221;1895;0;907
FR;10;2023-01-25;2;1;9;81;1;5;82;0;55;62;57;302;1945;23;226;1977;0;962
FR;10;2023-01-26;4;5;33;147;1;22;159;0;52;66;62;335;2092;24;248;2136;0;1014
FR;10;2023-01-27;1;1;16;117;1;6;118;0;78;67;63;351;2209;25;254;2254;0;1092
FR;10;2023-01-28;0;1;3;18;1;1;21;0;15;67;64;354;2227;26;255;2275;0;1107
FR;10;2023-01-29;0;0;1;0;0;1;0;0;1;67;64;355;2227;26;256;2275;0;1108
FR;10;2023-01-30;2;1;11;60;1;5;63;0;40;69;65;366;2287;27;261;2338;0;1148
FR;10;2023-01-31;5;2;25;121;3;18;121;0;51;74;67;391;2408;30;279;2459;0;1199
FR;10;2023-02-01;0;2;11;49;2;10;49;0;28;74;69;402;2457;32;289;2508;0;1227
FR;10;2023-02-02;3;0;21;104;0;16;108;0;48;77;69;423;2561;32;305;2616;0;1275
FR;10;2023-02-03;6;5;18;48;4;11;51;0;64;83;74;441;2609;36;316;2667;0;1339
FR;10;2023-02-04;1;0;1;8;0;0;10;0;6;84;74;442;2617;36;316;2677;0;1345
FR;10;2023-02-05;7;1;2;3;2;1;4;0;5;91;75;444;2620;38;317;2681;0;1350
FR;10;2023-02-06;1;0;9;28;0;8;22;0;46;92;75;453;2648;38;325;2703;0;1396
FR;10;2023-02-07;2;2;2;12;1;3;12;0;13;94;77;455;2660;39;328;2715;0;1409
FR;10;2023-02-08;1;3;3;15;2;4;15;0;12;95;80;458;2675;41;332;2730;0;1421
FR;10;2023-02-09;2;1;11;91;2;7;97;0;41;97;81;469;2766;43;339;2827;0;1462
FR;10;2023-02-10;8;3;12;29;0;6;37;0;25;105;84;481;2795;43;345;2864;0;1487
FR;10;2023-02-11;1;0;2;2;0;2;2;0;1;106;84;483;2797;43;347;2866;0;1488
FR;10;2023-02-12;1;1;0;0;1;0;0;0;0;107;85;483;2797;44;347;2866;0;1488
FR;10;2023-02-13;3;1;9;15;0;7;18;0;10;110;86;492;2812;44;354;2884;0;1498
FR;10;2023-02-14;2;4;11;49;3;9;50;0;17;112;90;503;2861;47;363;2934;0;1515
FR;10;2023-02-15;7;3;2;10;2;3;8;0;8;119;93;505;2871;49;366;2942;0;1523
FR;10;2023-02-16;0;0;8;17;0;5;18;0;8;119;93;513;2888;49;371;2960;0;1531
FR;10;2023-02-17;13;5;7;28;5;2;22;0;17;132;98;520;2916;54;373;2982;0;1548
FR;10;2023-02-18;2;0;3;11;0;3;10;0;6;134;98;523;2927;54;376;2992;0;1554
FR;10;2023-02-19;0;0;0;0;0;0;0;0;0;134;98;523;2927;54;376;2992;0;1554
FR;10;2023-02-20;2;1;2;25;1;1;23;0;23;136;99;525;2952;55;377;3015;0;1577
FR;10;2023-02-21;2;3;12;27;1;6;35;0;30;138;102;537;2979;56;383;3050;0;1607
FR;10;2023-02-22;5;4;2;7;3;3;6;0;1;143;106;539;2986;59;386;3056;0;1608
FR;10;2023-02-23;3;2;17;31;2;14;37;0;12;146;108;556;3017;61;400;3093;0;1620
FR;10;2023-02-24;1;2;8;27;0;5;27;0;29;147;110;564;3044;61;405;3120;0;1649
FR;10;2023-02-25;0;0;2;3;0;2;3;0;7;147;110;566;3047;61;407;3123;0;1656
FR;10;2023-02-26;0;0;0;0;0;0;0;0;0;147;110;566;3047;61;407;3123;0;1656
FR;10;2023-02-27;3;3;3;20;4;3;21;0;15;150;113;569;3067;65;410;3144;0;1671
FR;10;2023-02-28;3;2;3;10;2;1;11;0;10;153;115;572;3077;67;411;3155;0;1681
FR;10;2023-03-01;2;6;34;12;6;33;12;0;14;155;121;606;3089;73;444;3167;0;1695
FR;10;2023-03-02;2;1;10;22;2;6;22;0;31;157;122;616;3111;75;450;3189;0;1726
FR;10;2023-03-03;7;2;5;21;0;6;20;0;18;164;124;621;3132;75;456;3209;0;1744
FR;10;2023-03-04;0;1;0;6;1;0;6;0;2;164;125;621;3138;76;456;3215;0;1746
FR;10;2023-03-05;0;0;0;1;0;0;0;0;2;164;125;621;3139;76;456;3215;0;1748
FR;10;2023-03-06;2;2;8;8;3;7;9;0;8;166;127;629;3147;79;463;3224;0;1756
FR;10;2023-03-07;2;3;0;11;1;2;11;0;8;168;130;629;3158;80;465;3235;0;1764
FR;10;2023-03-08;1;4;4;20;3;3;22;0;9;169;134;633;3178;83;468;3257;0;1773
FR;10;2023-03-09;0;3;1;9;1;2;8;0;8;169;137;634;3187;84;470;3265;0;1781
FR;10;2023-03-10;1;2;1;8;2;1;9;0;9;170;139;635;3195;86;471;3274;0;1790
FR;10;2023-03-11;2;1;5;4;0;3;7;0;2;172;140;640;3199;86;474;3281;0;1792
FR;10;2023-03-12;0;0;0;0;0;0;0;0;0;172;140;640;3199;86;474;3281;0;1792
FR;10;2023-03-13;0;2;2;3;2;2;3;0;5;172;142;642;3202;88;476;3284;0;1797
FR;10;2023-03-14;2;0;6;25;0;4;27;0;21;174;142;648;3227;88;480;3311;0;1818
FR;10;2023-03-15;0;2;5;5;1;7;4;0;6;174;144;653;3232;89;487;3315;0;1824
FR;10;2023-03-16;3;1;7;12;0;5;15;0;11;177;145;660;3244;89;492;3330;0;1835
FR;10;2023-03-17;3;5;8;18;4;4;22;0;19;180;150;668;3262;93;496;3352;0;1854
FR;10;2023-03-18;0;1;1;3;0;2;2;0;3;180;151;669;3265;93;498;3354;0;1857
FR;10;2023-03-19;6;0;0;0;0;0;0;0;0;186;151;669;3265;93;498;3354;0;1857
FR;10;2023-03-20;5;4;0;12;3;1;13;0;12;191;155;669;3277;96;499;3367;0;1869
FR;10;2023-03-21;1;2;2;7;0;3;9;0;14;192;157;671;3284;96;502;3376;0;1883
FR;10;2023-03-22;0;0;3;4;0;3;3;0;3;192;157;674;3288;96;505;3379;0;1886
FR;10;2023-03-23;9;9;4;6;9;1;8;0;13;201;166;678;3294;105;506;3387;0;1899
FR;10;2023-03-24;3;3;2;14;2;1;10;0;17;204;169;680;3308;107;507;3397;0;1916
FR;10;2023-03-25;1;3;0;4;1;3;5;0;8;205;172;680;3312;108;510;3402;0;1924
FR;10;2023-03-26;1;1;0;0;1;0;0;0;0;206;173;680;3312;109;510;3402;0;1924
FR;10;2023-03-27;0;2;3;4;2;3;2;0;16;206;175;683;3316;111;513;3404;0;1940
FR;10;2023-03-28;9;8;3;5;8;1;6;0;6;215;183;686;3321;119;514;3410;0;1946
FR;10;2023-03-29;7;7;3;2;6;4;2;0;6;222;190;689;3323;125;518;3412;0;1952
FR;10;2023-03-30;16;13;3;7;13;2;8;0;6;238;203;692;3330;138;520;3420;0;1958
FR;10;2023-03-31;8;6;4;12;5;4;13;0;19;246;209;696;3342;143;524;3433;0;1977
FR;10;2023-04-01;9;8;1;0;8;1;0;0;0;255;217;697;3342;151;525;3433;0;1977
FR;10;2023-04-02;1;0;0;0;0;0;0;0;1;256;217;697;3342;151;525;3433;0;1978
FR;10;2023-04-03;2;1;0;3;1;0;2;0;5;258;218;697;3345;152;525;3435;0;1983
FR;10;2023-04-04;0;1;0;3;1;0;3;0;5;258;219;697;3348;153;525;3438;0;1988
FR;10;2023-04-05;0;0;2;1;0;2;3;0;2;258;219;699;3349;153;527;3441;0;1990
FR;10;2023-04-06;2;2;4;4;2;1;7;0;2;260;221;703;3353;155;528;3448;0;1992
FR;10;2023-04-07;3;0;2;3;0;1;3;0;9;263;221;705;3356;155;529;3451;0;2001
FR;10;2023-04-08;0;0;1;0;0;1;0;0;0;263;221;706;3356;155;530;3451;0;2001
FR;10;2023-04-09;0;0;0;0;0;0;0;0;0;263;221;706;3356;155;530;3451;0;2001
FR;10;2023-04-10;0;0;2;0;0;0;2;0;0;263;221;708;3356;155;530;3453;0;2001
FR;10;2023-04-11;1;0;1;3;0;1;2;0;3;264;221;709;3359;155;531;3455;0;2004
FR;10;2023-04-12;0;0;2;1;0;1;2;0;4;264;221;711;3360;155;532;3457;0;2008
FR;10;2023-04-13;0;1;0;5;1;0;5;0;5;264;222;711;3365;156;532;3462;0;2013
FR;10;2023-04-14;3;0;1;7;0;1;4;0;5;267;222;712;3372;156;533;3466;0;2018
FR;10;2023-04-15;0;1;1;3;1;0;4;0;0;267;223;713;3375;157;533;3470;0;2018
FR;10;2023-04-16;0;0;0;2;0;0;2;0;0;267;223;713;3377;157;533;3472;0;2018
FR;10;2023-04-17;1;2;2;0;1;2;0;0;0;268;225;715;3377;158;535;3472;0;2018
FR;10;2023-04-18;2;2;1;3;2;1;0;0;2;270;227;716;3380;160;536;3472;0;2020
FR;10;2023-04-19;0;0;1;0;0;1;0;0;1;270;227;717;3380;160;537;3472;0;2021
FR;10;2023-04-20;0;2;1;1;1;2;1;0;2;270;229;718;3381;161;539;3473;0;2023
FR;10;2023-04-21;0;1;5;7;0;4;9;0;3;270;230;723;3388;161;543;3482;0;2026
FR;10;2023-04-22;1;1;0;2;1;0;2;0;1;271;231;723;3390;162;543;3484;0;2027
FR;10;2023-04-23;0;0;0;0;0;0;0;0;0;271;231;723;3390;162;543;3484;0;2027
FR;10;2023-04-24;0;1;0;0;1;0;0;0;4;271;232;723;3390;163;543;3484;0;2031
FR;10;2023-04-25;0;0;1;0;0;1;0;0;2;271;232;724;3390;163;544;3484;0;2033
FR;10;2023-04-26;1;0;2;1;1;2;1;0;1;272;232;726;3391;164;546;3485;0;2034
FR;10;2023-04-27;0;0;1;1;0;1;1;0;1;272;232;727;3392;164;547;3486;0;2035
FR;10;2023-04-28;0;1;3;5;1;0;6;0;6;272;233;730;3397;165;547;3492;0;2041
FR;10;2023-04-29;0;0;0;1;0;0;0;0;1;272;233;730;3398;165;547;3492;0;2042
FR;10;2023-04-30;0;0;0;0;0;0;0;0;0;272;233;730;3398;165;547;3492;0;2042
FR;10;2023-05-01;0;0;0;0;0;0;0;0;0;272;233;730;3398;165;547;3492;0;2042
FR;10;2023-05-02;2;1;0;2;2;0;2;0;4;274;234;730;3400;167;547;3494;0;2046
FR;10;2023-05-03;0;1;1;2;1;1;1;0;17;274;235;731;3402;168;548;3495;0;2063
FR;10;2023-05-04;0;1;1;0;1;1;0;0;1;274;236;732;3402;169;549;3495;0;2064
FR;10;2023-05-05;0;1;2;6;0;2;6;0;9;274;237;734;3408;169;551;3501;0;2073
FR;10;2023-05-06;0;0;3;3;0;2;4;0;1;274;237;737;3411;169;553;3505;0;2074
FR;10;2023-05-07;0;0;0;0;0;0;0;0;0;274;237;737;3411;169;553;3505;0;2074
FR;10;2023-05-08;0;0;0;0;0;0;0;0;0;274;237;737;3411;169;553;3505;0;2074
FR;10;2023-05-09;0;1;1;0;0;1;1;0;1;274;238;738;3411;169;554;3506;0;2075
FR;10;2023-05-10;15;5;1;1;5;0;2;0;0;289;243;739;3412;174;554;3508;0;2075
FR;10;2023-05-11;0;0;0;2;0;0;2;0;4;289;243;739;3414;174;554;3510;0;2079
FR;10;2023-05-12;1;0;1;6;0;2;5;0;9;290;243;740;3420;174;556;3515;0;2088
FR;10;2023-05-13;0;0;1;0;0;0;1;0;0;290;243;741;3420;174;556;3516;0;2088
FR;10;2023-05-14;0;0;0;0;0;0;0;0;0;290;243;741;3420;174;556;3516;0;2088
FR;10;2023-05-15;0;1;0;0;0;1;0;0;1;290;244;741;3420;174;557;3516;0;2089
FR;10;2023-05-16;0;0;0;2;0;0;2;0;3;290;244;741;3422;174;557;3518;0;2092
FR;10;2023-05-17;0;0;0;1;0;0;1;0;1;290;244;741;3423;174;557;3519;0;2093
FR;10;2023-05-18;0;0;0;0;0;0;0;0;0;290;244;741;3423;174;557;3519;0;2093
FR;10;2023-05-19;1;0;1;2;0;1;2;0;0;291;244;742;3425;174;558;3521;0;2093
FR;10;2023-05-20;1;0;0;1;0;0;1;0;1;292;244;742;3426;174;558;3522;0;2094
FR;10;2023-05-21;0;0;0;0;0;0;0;0;0;292;244;742;3426;174;558;3522;0;2094
FR;10;2023-05-22;1;0;1;3;0;1;3;0;0;293;244;743;3429;174;559;3525;0;2094
FR;10;2023-05-23;0;0;3;1;0;1;4;0;2;293;244;746;3430;174;560;3529;0;2096
FR;10;2023-05-24;1;2;0;0;3;0;1;0;5;294;246;746;3430;177;560;3530;0;2101
FR;10;2023-05-25;1;1;1;1;2;0;2;0;4;295;247;747;3431;179;560;3532;0;2105
FR;10;2023-05-26;1;0;2;5;0;2;5;0;6;296;247;749;3436;179;562;3537;0;2111
FR;10;2023-05-27;1;0;0;0;0;0;0;0;0;297;247;749;3436;179;562;3537;0;2111
FR;10;2023-05-28;1;0;0;0;1;0;0;0;0;298;247;749;3436;180;562;3537;0;2111
FR;10;2023-05-29;1;1;0;0;1;0;0;0;0;299;248;749;3436;181;562;3537;0;2111
FR;10;2023-05-30;0;0;1;3;0;1;4;0;1;299;248;750;3439;181;563;3541;0;2112
FR;10;2023-05-31;1;2;0;2;1;1;2;0;5;300;250;750;3441;182;564;3543;0;2117
FR;10;2023-06-01;0;0;2;0;0;2;0;0;8;300;250;752;3441;182;566;3543;0;2125
FR;10;2023-06-02;0;1;0;3;1;0;2;0;5;300;251;752;3444;183;566;3545;0;2130
FR;10;2023-06-03;0;0;0;1;0;0;1;0;1;300;251;752;3445;183;566;3546;0;2131
FR;10;2023-06-04;0;0;0;0;0;0;0;0;0;300;251;752;3445;183;566;3546;0;2131
FR;10;2023-06-05;0;0;0;2;0;0;2;0;1;300;251;752;3447;183;566;3548;0;2132
FR;10;2023-06-06;0;0;2;6;0;1;7;0;11;300;251;754;3453;183;567;3555;0;2143
FR;10;2023-06-07;0;0;0;0;0;0;0;0;0;300;251;754;3453;183;567;3555;0;2143
FR;10;2023-06-08;1;1;0;3;1;0;3;0;6;301;252;754;3456;184;567;3558;0;2149
FR;10;2023-06-09;1;0;0;0;0;0;0;0;0;302;252;754;3456;184;567;3558;0;2149
FR;10;2023-06-10;0;0;0;0;0;0;0;0;1;302;252;754;3456;184;567;3558;0;2150
FR;10;2023-06-11;0;0;0;0;0;0;0;0;0;302;252;754;3456;184;567;3558;0;2150
FR;10;2023-06-12;0;0;1;0;0;1;0;0;1;302;252;755;3456;184;568;3558;0;2151
FR;11;2020-12-27;0;0;0;0;0;0;0;0;0;0;0;0;0;0;0;0;0;0
FR;11;2020-12-28;0;0;0;0;0;0;0;0;0;0;0;0;0;0;0;0;0;0
FR;11;2020-12-29;0;0;0;0;0;0;0;0;0;0;0;0;0;0;0;0;0;0
FR;11;2020-12-30;0;0;0;0;0;0;0;0;0;0;0;0;0;0;0;0;0;0
FR;11;2020-12-31;0;0;0;0;0;0;0;0;0;0;0;0;0;0;0;0;0;0
FR;11;2021-01-01;0;0;0;0;0;0;0;0;0;0;0;0;0;0;0;0;0;0
FR;11;2021-01-02;0;0;0;0;0;0;0;0;0;0;0;0;0;0;0;0;0;0
FR;11;2021-01-03;0;0;0;0;0;0;0;0;0;0;0;0;0;0;0;0;0;0
FR;11;2021-01-04;0;0;0;0;0;0;0;0;0;0;0;0;0;0;0;0;0;0
FR;11;2021-01-05;0;0;0;0;0;0;0;0;0;0;0;0;0;0;0;0;0;0
FR;11;2021-01-06;0;0;0;0;0;0;0;0;0;0;0;0;0;0;0;0;0;0
FR;11;2021-01-07;0;0;0;0;0;0;0;0;0;0;0;0;0;0;0;0;0;0
FR;11;2021-01-08;0;0;0;0;0;0;0;0;0;0;0;0;0;0;0;0;0;0
FR;11;2021-01-09;0;0;0;0;0;0;0;0;0;0;0;0;0;0;0;0;0;0
FR;11;2021-01-10;0;0;0;0;0;0;0;0;0;0;0;0;0;0;0;0;0;0
FR;11;2021-01-11;0;0;0;0;0;0;0;0;0;0;0;0;0;0;0;0;0;0
FR;11;2021-01-12;0;0;0;0;0;0;0;0;0;0;0;0;0;0;0;0;0;0
FR;11;2021-01-13;0;0;0;0;0;0;0;0;0;0;0;0;0;0;0;0;0;0
FR;11;2021-01-14;0;0;0;0;0;0;0;0;0;0;0;0;0;0;0;0;0;0
FR;11;2021-01-15;0;0;0;0;0;0;0;0;0;0;0;0;0;0;0;0;0;0
FR;11;2021-01-16;0;0;0;0;0;0;0;0;0;0;0;0;0;0;0;0;0;0
FR;11;2021-01-17;0;0;0;0;0;0;0;0;0;0;0;0;0;0;0;0;0;0
FR;11;2021-01-18;0;0;0;0;0;0;0;0;0;0;0;0;0;0;0;0;0;0
FR;11;2021-01-19;0;0;0;0;0;0;0;0;0;0;0;0;0;0;0;0;0;0
FR;11;2021-01-20;0;0;0;0;0;0;0;0;0;0;0;0;0;0;0;0;0;0
FR;11;2021-01-21;0;0;0;0;0;0;0;0;0;0;0;0;0;0;0;0;0;0
FR;11;2021-01-22;0;0;0;0;0;0;0;0;0;0;0;0;0;0;0;0;0;0
FR;11;2021-01-23;0;0;0;0;0;0;0;0;0;0;0;0;0;0;0;0;0;0
FR;11;2021-01-24;0;0;0;0;0;0;0;0;0;0;0;0;0;0;0;0;0;0
FR;11;2021-01-25;0;0;0;0;0;0;0;0;0;0;0;0;0;0;0;0;0;0
FR;11;2021-01-26;0;0;0;0;0;0;0;0;0;0;0;0;0;0;0;0;0;0
FR;11;2021-01-27;0;0;0;0;0;0;0;0;0;0;0;0;0;0;0;0;0;0
FR;11;2021-01-28;0;0;0;0;0;0;0;0;0;0;0;0;0;0;0;0;0;0
FR;11;2021-01-29;0;0;0;0;0;0;0;0;0;0;0;0;0;0;0;0;0;0
FR;11;2021-01-30;0;0;0;0;0;0;0;0;0;0;0;0;0;0;0;0;0;0
FR;11;2021-01-31;0;0;0;0;0;0;0;0;0;0;0;0;0;0;0;0;0;0
FR;11;2021-02-01;0;0;0;0;0;0;0;0;0;0;0;0;0;0;0;0;0;0
FR;11;2021-02-02;0;0;0;0;0;0;0;0;0;0;0;0;0;0;0;0;0;0
FR;11;2021-02-03;0;0;0;0;0;0;0;0;0;0;0;0;0;0;0;0;0;0
FR;11;2021-02-04;0;0;0;0;0;0;0;0;0;0;0;0;0;0;0;0;0;0
FR;11;2021-02-05;0;0;0;0;0;0;0;0;0;0;0;0;0;0;0;0;0;0
FR;11;2021-02-06;0;0;0;0;0;0;0;0;0;0;0;0;0;0;0;0;0;0
FR;11;2021-02-07;0;0;0;0;0;0;0;0;0;0;0;0;0;0;0;0;0;0
FR;11;2021-02-08;0;0;0;0;0;0;0;0;0;0;0;0;0;0;0;0;0;0
FR;11;2021-02-09;0;0;0;0;0;0;0;0;0;0;0;0;0;0;0;0;0;0
FR;11;2021-02-10;0;0;0;0;0;0;0;0;0;0;0;0;0;0;0;0;0;0
FR;11;2021-02-11;0;0;0;0;0;0;0;0;0;0;0;0;0;0;0;0;0;0
FR;11;2021-02-12;0;0;0;0;0;0;0;0;0;0;0;0;0;0;0;0;0;0
FR;11;2021-02-13;0;0;0;0;0;0;0;0;0;0;0;0;0;0;0;0;0;0
FR;11;2021-02-14;0;0;0;0;0;0;0;0;0;0;0;0;0;0;0;0;0;0
FR;11;2021-02-15;0;0;0;0;0;0;0;0;0;0;0;0;0;0;0;0;0;0
FR;11;2021-02-16;0;0;0;0;0;0;0;0;0;0;0;0;0;0;0;0;0;0
FR;11;2021-02-17;0;0;0;0;0;0;0;0;0;0;0;0;0;0;0;0;0;0
FR;11;2021-02-18;0;0;0;0;0;0;0;0;0;0;0;0;0;0;0;0;0;0
FR;11;2021-02-19;0;0;0;0;0;0;0;0;0;0;0;0;0;0;0;0;0;0
FR;11;2021-02-20;0;0;0;0;0;0;0;0;0;0;0;0;0;0;0;0;0;0
FR;11;2021-02-21;0;0;0;0;0;0;0;0;0;0;0;0;0;0;0;0;0;0
FR;11;2021-02-22;0;0;0;0;0;0;0;0;0;0;0;0;0;0;0;0;0;0
FR;11;2021-02-23;0;0;0;0;0;0;0;0;0;0;0;0;0;0;0;0;0;0
FR;11;2021-02-24;0;0;0;0;0;0;0;0;0;0;0;0;0;0;0;0;0;0
FR;11;2021-02-25;0;0;0;0;0;0;0;0;0;0;0;0;0;0;0;0;0;0
FR;11;2021-02-26;0;0;0;0;0;0;0;0;0;0;0;0;0;0;0;0;0;0
FR;11;2021-02-27;0;0;0;0;0;0;0;0;0;0;0;0;0;0;0;0;0;0
FR;11;2021-02-28;0;0;0;0;0;0;0;0;0;0;0;0;0;0;0;0;0;0
FR;11;2021-03-01;0;0;0;0;0;0;0;0;0;0;0;0;0;0;0;0;0;0
FR;11;2021-03-02;0;0;0;0;0;0;0;0;0;0;0;0;0;0;0;0;0;0
FR;11;2021-03-03;0;0;0;0;0;0;0;0;0;0;0;0;0;0;0;0;0;0
FR;11;2021-03-04;0;0;0;0;0;0;0;0;0;0;0;0;0;0;0;0;0;0
FR;11;2021-03-05;0;0;0;0;0;0;0;0;0;0;0;0;0;0;0;0;0;0
FR;11;2021-03-06;0;0;0;0;0;0;0;0;0;0;0;0;0;0;0;0;0;0
FR;11;2021-03-07;0;0;0;0;0;0;0;0;0;0;0;0;0;0;0;0;0;0
FR;11;2021-03-08;0;0;0;0;0;0;0;0;0;0;0;0;0;0;0;0;0;0
FR;11;2021-03-09;0;0;0;0;0;0;0;0;0;0;0;0;0;0;0;0;0;0
FR;11;2021-03-10;0;0;0;0;0;0;0;0;0;0;0;0;0;0;0;0;0;0
FR;11;2021-03-11;0;0;0;0;0;0;0;0;0;0;0;0;0;0;0;0;0;0
FR;11;2021-03-12;0;0;0;0;0;0;0;0;0;0;0;0;0;0;0;0;0;0
FR;11;2021-03-13;0;0;0;0;0;0;0;0;0;0;0;0;0;0;0;0;0;0
FR;11;2021-03-14;0;0;0;0;0;0;0;0;0;0;0;0;0;0;0;0;0;0
FR;11;2021-03-15;0;0;0;0;0;0;0;0;0;0;0;0;0;0;0;0;0;0
FR;11;2021-03-16;0;0;0;0;0;0;0;0;0;0;0;0;0;0;0;0;0;0
FR;11;2021-03-17;0;0;0;0;0;0;0;0;0;0;0;0;0;0;0;0;0;0
FR;11;2021-03-18;0;0;0;0;0;0;0;0;0;0;0;0;0;0;0;0;0;0
FR;11;2021-03-19;0;0;0;0;0;0;0;0;0;0;0;0;0;0;0;0;0;0
FR;11;2021-03-20;0;0;0;0;0;0;0;0;0;0;0;0;0;0;0;0;0;0
FR;11;2021-03-21;0;0;0;0;0;0;0;0;0;0;0;0;0;0;0;0;0;0
FR;11;2021-03-22;0;0;0;0;0;0;0;0;0;0;0;0;0;0;0;0;0;0
FR;11;2021-03-23;0;0;0;0;0;0;0;0;0;0;0;0;0;0;0;0;0;0
FR;11;2021-03-24;0;0;0;0;0;0;0;0;0;0;0;0;0;0;0;0;0;0
FR;11;2021-03-25;0;0;0;0;0;0;0;0;0;0;0;0;0;0;0;0;0;0
FR;11;2021-03-26;0;0;0;0;0;0;0;0;0;0;0;0;0;0;0;0;0;0
FR;11;2021-03-27;0;0;0;0;0;0;0;0;0;0;0;0;0;0;0;0;0;0
FR;11;2021-03-28;0;0;0;0;0;0;0;0;0;0;0;0;0;0;0;0;0;0
FR;11;2021-03-29;0;0;0;0;0;0;0;0;0;0;0;0;0;0;0;0;0;0
FR;11;2021-03-30;0;0;0;0;0;0;0;0;0;0;0;0;0;0;0;0;0;0
FR;11;2021-03-31;0;0;0;0;0;0;0;0;0;0;0;0;0;0;0;0;0;0
FR;11;2021-04-01;0;0;0;0;0;0;0;0;0;0;0;0;0;0;0;0;0;0
FR;11;2021-04-02;0;0;0;0;0;0;0;0;0;0;0;0;0;0;0;0;0;0
FR;11;2021-04-03;0;0;0;0;0;0;0;0;0;0;0;0;0;0;0;0;0;0
FR;11;2021-04-04;0;0;0;0;0;0;0;0;0;0;0;0;0;0;0;0;0;0
FR;11;2021-04-05;0;0;0;0;0;0;0;0;0;0;0;0;0;0;0;0;0;0
FR;11;2021-04-06;0;0;0;0;0;0;0;0;0;0;0;0;0;0;0;0;0;0
FR;11;2021-04-07;0;0;0;0;0;0;0;0;0;0;0;0;0;0;0;0;0;0
FR;11;2021-04-08;0;0;0;0;0;0;0;0;0;0;0;0;0;0;0;0;0;0
FR;11;2021-04-09;0;0;0;0;0;0;0;0;0;0;0;0;0;0;0;0;0;0
FR;11;2021-04-10;0;0;0;0;0;0;0;0;0;0;0;0;0;0;0;0;0;0
FR;11;2021-04-11;0;0;0;0;0;0;0;0;0;0;0;0;0;0;0;0;0;0
FR;11;2021-04-12;0;0;0;0;0;0;0;0;0;0;0;0;0;0;0;0;0;0
FR;11;2021-04-13;0;0;0;0;0;0;0;0;0;0;0;0;0;0;0;0;0;0
FR;11;2021-04-14;0;0;0;0;0;0;0;0;0;0;0;0;0;0;0;0;0;0
FR;11;2021-04-15;0;0;0;0;0;0;0;0;0;0;0;0;0;0;0;0;0;0
FR;11;2021-04-16;0;0;0;0;0;0;0;0;0;0;0;0;0;0;0;0;0;0
FR;11;2021-04-17;0;0;0;0;0;0;0;0;0;0;0;0;0;0;0;0;0;0
FR;11;2021-04-18;0;0;0;0;0;0;0;0;0;0;0;0;0;0;0;0;0;0
FR;11;2021-04-19;0;0;0;0;0;0;0;0;0;0;0;0;0;0;0;0;0;0
FR;11;2021-04-20;0;0;0;0;0;0;0;0;0;0;0;0;0;0;0;0;0;0
FR;11;2021-04-21;0;0;0;0;0;0;0;0;0;0;0;0;0;0;0;0;0;0
FR;11;2021-04-22;0;0;0;0;0;0;0;0;0;0;0;0;0;0;0;0;0;0
FR;11;2021-04-23;0;0;0;0;0;0;0;0;0;0;0;0;0;0;0;0;0;0
FR;11;2021-04-24;0;0;0;0;0;0;0;0;0;0;0;0;0;0;0;0;0;0
FR;11;2021-04-25;0;0;0;0;0;0;0;0;0;0;0;0;0;0;0;0;0;0
FR;11;2021-04-26;0;0;0;0;0;0;0;0;0;0;0;0;0;0;0;0;0;0
FR;11;2021-04-27;0;0;0;0;0;0;0;0;0;0;0;0;0;0;0;0;0;0
FR;11;2021-04-28;0;0;0;0;0;0;0;0;0;0;0;0;0;0;0;0;0;0
FR;11;2021-04-29;0;0;0;0;0;0;0;0;0;0;0;0;0;0;0;0;0;0
FR;11;2021-04-30;0;0;0;0;0;0;0;0;0;0;0;0;0;0;0;0;0;0
FR;11;2021-05-01;0;0;0;0;0;0;0;0;0;0;0;0;0;0;0;0;0;0
FR;11;2021-05-02;0;0;0;0;0;0;0;0;0;0;0;0;0;0;0;0;0;0
FR;11;2021-05-03;0;0;0;0;0;0;0;0;0;0;0;0;0;0;0;0;0;0
FR;11;2021-05-04;0;0;0;0;0;0;0;0;0;0;0;0;0;0;0;0;0;0
FR;11;2021-05-05;0;0;0;0;0;0;0;0;0;0;0;0;0;0;0;0;0;0
FR;11;2021-05-06;0;0;0;0;0;0;0;0;0;0;0;0;0;0;0;0;0;0
FR;11;2021-05-07;0;0;0;0;0;0;0;0;0;0;0;0;0;0;0;0;0;0
FR;11;2021-05-08;0;0;0;0;0;0;0;0;0;0;0;0;0;0;0;0;0;0
FR;11;2021-05-09;0;0;0;0;0;0;0;0;0;0;0;0;0;0;0;0;0;0
FR;11;2021-05-10;0;0;0;0;0;0;0;0;0;0;0;0;0;0;0;0;0;0
FR;11;2021-05-11;0;0;0;0;0;0;0;0;0;0;0;0;0;0;0;0;0;0
FR;11;2021-05-12;0;0;0;0;0;0;0;0;0;0;0;0;0;0;0;0;0;0
FR;11;2021-05-13;0;0;0;0;0;0;0;0;0;0;0;0;0;0;0;0;0;0
FR;11;2021-05-14;0;0;0;0;0;0;0;0;0;0;0;0;0;0;0;0;0;0
FR;11;2021-05-15;0;0;0;0;0;0;0;0;0;0;0;0;0;0;0;0;0;0
FR;11;2021-05-16;0;0;0;0;0;0;0;0;0;0;0;0;0;0;0;0;0;0
FR;11;2021-05-17;0;0;0;0;0;0;0;0;0;0;0;0;0;0;0;0;0;0
FR;11;2021-05-18;0;0;0;0;0;0;0;0;0;0;0;0;0;0;0;0;0;0
FR;11;2021-05-19;0;0;0;0;0;0;0;0;0;0;0;0;0;0;0;0;0;0
FR;11;2021-05-20;0;0;0;0;0;0;0;0;0;0;0;0;0;0;0;0;0;0
FR;11;2021-05-21;0;0;0;0;0;0;0;0;0;0;0;0;0;0;0;0;0;0
FR;11;2021-05-22;0;0;0;0;0;0;0;0;0;0;0;0;0;0;0;0;0;0
FR;11;2021-05-23;0;0;0;0;0;0;0;0;0;0;0;0;0;0;0;0;0;0
FR;11;2021-05-24;0;0;0;0;0;0;0;0;0;0;0;0;0;0;0;0;0;0
FR;11;2021-05-25;0;0;0;0;0;0;0;0;0;0;0;0;0;0;0;0;0;0
FR;11;2021-05-26;0;0;0;0;0;0;0;0;0;0;0;0;0;0;0;0;0;0
FR;11;2021-05-27;0;0;0;0;0;0;0;0;0;0;0;0;0;0;0;0;0;0
FR;11;2021-05-28;0;0;0;0;0;0;0;0;0;0;0;0;0;0;0;0;0;0
FR;11;2021-05-29;0;0;0;0;0;0;0;0;0;0;0;0;0;0;0;0;0;0
FR;11;2021-05-30;0;0;0;0;0;0;0;0;0;0;0;0;0;0;0;0;0;0
FR;11;2021-05-31;0;0;0;0;0;0;0;0;0;0;0;0;0;0;0;0;0;0
FR;11;2021-06-01;0;0;0;0;0;0;0;0;0;0;0;0;0;0;0;0;0;0
FR;11;2021-06-02;0;0;0;0;0;0;0;0;0;0;0;0;0;0;0;0;0;0
FR;11;2021-06-03;0;0;0;0;0;0;0;0;0;0;0;0;0;0;0;0;0;0
FR;11;2021-06-04;0;0;0;0;0;0;0;0;0;0;0;0;0;0;0;0;0;0
FR;11;2021-06-05;0;0;0;0;0;0;0;0;0;0;0;0;0;0;0;0;0;0
FR;11;2021-06-06;0;0;0;0;0;0;0;0;0;0;0;0;0;0;0;0;0;0
FR;11;2021-06-07;0;0;0;0;0;0;0;0;0;0;0;0;0;0;0;0;0;0
FR;11;2021-06-08;0;0;0;0;0;0;0;0;0;0;0;0;0;0;0;0;0;0
FR;11;2021-06-09;0;0;0;0;0;0;0;0;0;0;0;0;0;0;0;0;0;0
FR;11;2021-06-10;0;0;0;0;0;0;0;0;0;0;0;0;0;0;0;0;0;0
FR;11;2021-06-11;0;0;0;0;0;0;0;0;0;0;0;0;0;0;0;0;0;0
FR;11;2021-06-12;0;0;0;0;0;0;0;0;0;0;0;0;0;0;0;0;0;0
FR;11;2021-06-13;0;0;0;0;0;0;0;0;0;0;0;0;0;0;0;0;0;0
FR;11;2021-06-14;0;0;0;0;0;0;0;0;0;0;0;0;0;0;0;0;0;0
FR;11;2021-06-15;0;0;0;0;0;0;0;0;0;0;0;0;0;0;0;0;0;0
FR;11;2021-06-16;0;0;0;0;0;0;0;0;0;0;0;0;0;0;0;0;0;0
FR;11;2021-06-17;0;0;0;0;0;0;0;0;0;0;0;0;0;0;0;0;0;0
FR;11;2021-06-18;0;0;0;0;0;0;0;0;0;0;0;0;0;0;0;0;0;0
FR;11;2021-06-19;0;0;0;0;0;0;0;0;0;0;0;0;0;0;0;0;0;0
FR;11;2021-06-20;0;0;0;0;0;0;0;0;0;0;0;0;0;0;0;0;0;0
FR;11;2021-06-21;0;0;0;0;0;0;0;0;0;0;0;0;0;0;0;0;0;0
FR;11;2021-06-22;0;0;0;0;0;0;0;0;0;0;0;0;0;0;0;0;0;0
FR;11;2021-06-23;0;0;0;0;0;0;0;0;0;0;0;0;0;0;0;0;0;0
FR;11;2021-06-24;0;0;0;0;0;0;0;0;0;0;0;0;0;0;0;0;0;0
FR;11;2021-06-25;0;0;0;0;0;0;0;0;0;0;0;0;0;0;0;0;0;0
FR;11;2021-06-26;0;0;0;0;0;0;0;0;0;0;0;0;0;0;0;0;0;0
FR;11;2021-06-27;0;0;0;0;0;0;0;0;0;0;0;0;0;0;0;0;0;0
FR;11;2021-06-28;0;0;0;0;0;0;0;0;0;0;0;0;0;0;0;0;0;0
FR;11;2021-06-29;0;0;0;0;0;0;0;0;0;0;0;0;0;0;0;0;0;0
FR;11;2021-06-30;0;0;0;0;0;0;0;0;0;0;0;0;0;0;0;0;0;0
FR;11;2021-07-01;0;0;0;0;0;0;0;0;0;0;0;0;0;0;0;0;0;0
FR;11;2021-07-02;0;0;0;0;0;0;0;0;0;0;0;0;0;0;0;0;0;0
FR;11;2021-07-03;0;0;0;0;0;0;0;0;0;0;0;0;0;0;0;0;0;0
FR;11;2021-07-04;0;0;0;0;0;0;0;0;0;0;0;0;0;0;0;0;0;0
FR;11;2021-07-05;0;0;0;0;0;0;0;0;0;0;0;0;0;0;0;0;0;0
FR;11;2021-07-06;0;0;0;0;0;0;0;0;0;0;0;0;0;0;0;0;0;0
FR;11;2021-07-07;0;0;0;0;0;0;0;0;0;0;0;0;0;0;0;0;0;0
FR;11;2021-07-08;0;0;0;0;0;0;0;0;0;0;0;0;0;0;0;0;0;0
FR;11;2021-07-09;0;0;0;0;0;0;0;0;0;0;0;0;0;0;0;0;0;0
FR;11;2021-07-10;0;0;0;0;0;0;0;0;0;0;0;0;0;0;0;0;0;0
FR;11;2021-07-11;0;0;0;0;0;0;0;0;0;0;0;0;0;0;0;0;0;0
FR;11;2021-07-12;0;0;0;0;0;0;0;0;0;0;0;0;0;0;0;0;0;0
FR;11;2021-07-13;0;0;0;0;0;0;0;0;0;0;0;0;0;0;0;0;0;0
FR;11;2021-07-14;0;0;0;0;0;0;0;0;0;0;0;0;0;0;0;0;0;0
FR;11;2021-07-15;0;0;0;0;0;0;0;0;0;0;0;0;0;0;0;0;0;0
FR;11;2021-07-16;0;0;0;0;0;0;0;0;0;0;0;0;0;0;0;0;0;0
FR;11;2021-07-17;0;0;0;0;0;0;0;0;0;0;0;0;0;0;0;0;0;0
FR;11;2021-07-18;0;0;0;0;0;0;0;0;0;0;0;0;0;0;0;0;0;0
FR;11;2021-07-19;0;0;0;0;0;0;0;0;0;0;0;0;0;0;0;0;0;0
FR;11;2021-07-20;0;0;0;0;0;0;0;0;0;0;0;0;0;0;0;0;0;0
FR;11;2021-07-21;0;0;0;0;0;0;0;0;0;0;0;0;0;0;0;0;0;0
FR;11;2021-07-22;0;0;0;0;0;0;0;0;0;0;0;0;0;0;0;0;0;0
FR;11;2021-07-23;0;0;0;0;0;0;0;0;0;0;0;0;0;0;0;0;0;0
FR;11;2021-07-24;0;0;0;0;0;0;0;0;0;0;0;0;0;0;0;0;0;0
FR;11;2021-07-25;0;0;0;0;0;0;0;0;0;0;0;0;0;0;0;0;0;0
FR;11;2021-07-26;0;0;0;0;0;0;0;0;0;0;0;0;0;0;0;0;0;0
FR;11;2021-07-27;0;0;0;0;0;0;0;0;0;0;0;0;0;0;0;0;0;0
FR;11;2021-07-28;0;0;0;0;0;0;0;0;0;0;0;0;0;0;0;0;0;0
FR;11;2021-07-29;0;0;0;0;0;0;0;0;0;0;0;0;0;0;0;0;0;0
FR;11;2021-07-30;0;0;0;0;0;0;0;0;0;0;0;0;0;0;0;0;0;0
FR;11;2021-07-31;0;0;0;0;0;0;0;0;0;0;0;0;0;0;0;0;0;0
FR;11;2021-08-01;0;0;0;0;0;0;0;0;0;0;0;0;0;0;0;0;0;0
FR;11;2021-08-02;0;0;0;0;0;0;0;0;0;0;0;0;0;0;0;0;0;0
FR;11;2021-08-03;0;0;0;0;0;0;0;0;0;0;0;0;0;0;0;0;0;0
FR;11;2021-08-04;0;0;0;0;0;0;0;0;0;0;0;0;0;0;0;0;0;0
FR;11;2021-08-05;0;0;0;0;0;0;0;0;0;0;0;0;0;0;0;0;0;0
FR;11;2021-08-06;0;0;0;0;0;0;0;0;0;0;0;0;0;0;0;0;0;0
FR;11;2021-08-07;0;0;0;0;0;0;0;0;0;0;0;0;0;0;0;0;0;0
FR;11;2021-08-08;0;0;0;0;0;0;0;0;0;0;0;0;0;0;0;0;0;0
FR;11;2021-08-09;0;0;0;0;0;0;0;0;0;0;0;0;0;0;0;0;0;0
FR;11;2021-08-10;0;0;0;0;0;0;0;0;0;0;0;0;0;0;0;0;0;0
FR;11;2021-08-11;0;0;0;0;0;0;0;0;0;0;0;0;0;0;0;0;0;0
FR;11;2021-08-12;0;0;0;0;0;0;0;0;0;0;0;0;0;0;0;0;0;0
FR;11;2021-08-13;0;0;0;0;0;0;0;0;0;0;0;0;0;0;0;0;0;0
FR;11;2021-08-14;0;0;0;0;0;0;0;0;0;0;0;0;0;0;0;0;0;0
FR;11;2021-08-15;0;0;0;0;0;0;0;0;0;0;0;0;0;0;0;0;0;0
FR;11;2021-08-16;0;0;0;0;0;0;0;0;0;0;0;0;0;0;0;0;0;0
FR;11;2021-08-17;0;0;0;0;0;0;0;0;0;0;0;0;0;0;0;0;0;0
FR;11;2021-08-18;0;0;0;0;0;0;0;0;0;0;0;0;0;0;0;0;0;0
FR;11;2021-08-19;0;0;0;0;0;0;0;0;0;0;0;0;0;0;0;0;0;0
FR;11;2021-08-20;0;0;0;0;0;0;0;0;0;0;0;0;0;0;0;0;0;0
FR;11;2021-08-21;0;0;0;0;0;0;0;0;0;0;0;0;0;0;0;0;0;0
FR;11;2021-08-22;0;0;0;0;0;0;0;0;0;0;0;0;0;0;0;0;0;0
FR;11;2021-08-23;0;0;0;0;0;0;0;0;0;0;0;0;0;0;0;0;0;0
FR;11;2021-08-24;0;0;0;0;0;0;0;0;0;0;0;0;0;0;0;0;0;0
FR;11;2021-08-25;0;0;0;0;0;0;0;0;0;0;0;0;0;0;0;0;0;0
FR;11;2021-08-26;0;0;0;0;0;0;0;0;0;0;0;0;0;0;0;0;0;0
FR;11;2021-08-27;0;0;0;0;0;0;0;0;0;0;0;0;0;0;0;0;0;0
FR;11;2021-08-28;0;0;0;0;0;0;0;0;0;0;0;0;0;0;0;0;0;0
FR;11;2021-08-29;0;0;0;0;0;0;0;0;0;0;0;0;0;0;0;0;0;0
FR;11;2021-08-30;0;0;0;0;0;0;0;0;0;0;0;0;0;0;0;0;0;0
FR;11;2021-08-31;0;0;0;0;0;0;0;0;0;0;0;0;0;0;0;0;0;0
FR;11;2021-09-01;0;0;0;0;0;0;0;0;0;0;0;0;0;0;0;0;0;0
FR;11;2021-09-02;0;0;0;0;0;0;0;0;0;0;0;0;0;0;0;0;0;0
FR;11;2021-09-03;0;0;0;0;0;0;0;0;0;0;0;0;0;0;0;0;0;0
FR;11;2021-09-04;0;0;0;0;0;0;0;0;0;0;0;0;0;0;0;0;0;0
FR;11;2021-09-05;0;0;0;0;0;0;0;0;0;0;0;0;0;0;0;0;0;0
FR;11;2021-09-06;0;0;0;0;0;0;0;0;0;0;0;0;0;0;0;0;0;0
FR;11;2021-09-07;0;0;0;0;0;0;0;0;0;0;0;0;0;0;0;0;0;0
FR;11;2021-09-08;0;0;0;0;0;0;0;0;0;0;0;0;0;0;0;0;0;0
FR;11;2021-09-09;0;0;0;0;0;0;0;0;0;0;0;0;0;0;0;0;0;0
FR;11;2021-09-10;0;0;0;0;0;0;0;0;0;0;0;0;0;0;0;0;0;0
FR;11;2021-09-11;0;0;0;0;0;0;0;0;0;0;0;0;0;0;0;0;0;0
FR;11;2021-09-12;0;0;0;0;0;0;0;0;0;0;0;0;0;0;0;0;0;0
FR;11;2021-09-13;0;0;0;0;0;0;0;0;0;0;0;0;0;0;0;0;0;0
FR;11;2021-09-14;0;0;0;0;0;0;0;0;0;0;0;0;0;0;0;0;0;0
FR;11;2021-09-15;0;0;0;0;0;0;0;0;0;0;0;0;0;0;0;0;0;0
FR;11;2021-09-16;0;0;0;0;0;0;0;0;0;0;0;0;0;0;0;0;0;0
FR;11;2021-09-17;0;0;0;0;0;0;0;0;0;0;0;0;0;0;0;0;0;0
FR;11;2021-09-18;0;0;0;0;0;0;0;0;0;0;0;0;0;0;0;0;0;0
FR;11;2021-09-19;0;0;0;0;0;0;0;0;0;0;0;0;0;0;0;0;0;0
FR;11;2021-09-20;0;0;0;0;0;0;0;0;0;0;0;0;0;0;0;0;0;0
FR;11;2021-09-21;0;0;0;0;0;0;0;0;0;0;0;0;0;0;0;0;0;0
FR;11;2021-09-22;0;0;0;0;0;0;0;0;0;0;0;0;0;0;0;0;0;0
FR;11;2021-09-23;0;0;0;0;0;0;0;0;0;0;0;0;0;0;0;0;0;0
FR;11;2021-09-24;0;0;0;0;0;0;0;0;0;0;0;0;0;0;0;0;0;0
FR;11;2021-09-25;0;0;0;0;0;0;0;0;0;0;0;0;0;0;0;0;0;0
FR;11;2021-09-26;0;0;0;0;0;0;0;0;0;0;0;0;0;0;0;0;0;0
FR;11;2021-09-27;0;0;0;0;0;0;0;0;0;0;0;0;0;0;0;0;0;0
FR;11;2021-09-28;0;0;0;0;0;0;0;0;0;0;0;0;0;0;0;0;0;0
FR;11;2021-09-29;0;0;0;0;0;0;0;0;0;0;0;0;0;0;0;0;0;0
FR;11;2021-09-30;0;0;0;0;0;0;0;0;0;0;0;0;0;0;0;0;0;0
FR;11;2021-10-01;0;0;0;0;0;0;0;0;0;0;0;0;0;0;0;0;0;0
FR;11;2021-10-02;0;0;0;0;0;0;0;0;0;0;0;0;0;0;0;0;0;0
FR;11;2021-10-03;0;0;0;0;0;0;0;0;0;0;0;0;0;0;0;0;0;0
FR;11;2021-10-04;0;0;0;0;0;0;0;0;0;0;0;0;0;0;0;0;0;0
FR;11;2021-10-05;0;0;0;0;0;0;0;0;0;0;0;0;0;0;0;0;0;0
FR;11;2021-10-06;0;0;0;0;0;0;0;0;0;0;0;0;0;0;0;0;0;0
FR;11;2021-10-07;0;0;0;0;0;0;0;0;0;0;0;0;0;0;0;0;0;0
FR;11;2021-10-08;0;0;0;0;0;0;0;0;0;0;0;0;0;0;0;0;0;0
FR;11;2021-10-09;0;0;0;0;0;0;0;0;0;0;0;0;0;0;0;0;0;0
FR;11;2021-10-10;0;0;0;0;0;0;0;0;0;0;0;0;0;0;0;0;0;0
FR;11;2021-10-11;0;0;0;0;0;0;0;0;0;0;0;0;0;0;0;0;0;0
FR;11;2021-10-12;0;0;0;0;0;0;0;0;0;0;0;0;0;0;0;0;0;0
FR;11;2021-10-13;0;0;0;0;0;0;0;0;0;0;0;0;0;0;0;0;0;0
FR;11;2021-10-14;0;0;0;0;0;0;0;0;0;0;0;0;0;0;0;0;0;0
FR;11;2021-10-15;0;0;0;0;0;0;0;0;0;0;0;0;0;0;0;0;0;0
FR;11;2021-10-16;0;0;0;0;0;0;0;0;0;0;0;0;0;0;0;0;0;0
FR;11;2021-10-17;0;0;0;0;0;0;0;0;0;0;0;0;0;0;0;0;0;0
FR;11;2021-10-18;0;0;0;0;0;0;0;0;0;0;0;0;0;0;0;0;0;0
FR;11;2021-10-19;0;0;0;0;0;0;0;0;0;0;0;0;0;0;0;0;0;0
FR;11;2021-10-20;0;0;0;0;0;0;0;0;0;0;0;0;0;0;0;0;0;0
FR;11;2021-10-21;0;0;0;0;0;0;0;0;0;0;0;0;0;0;0;0;0;0
FR;11;2021-10-22;0;0;0;0;0;0;0;0;0;0;0;0;0;0;0;0;0;0
FR;11;2021-10-23;0;0;0;0;0;0;0;0;0;0;0;0;0;0;0;0;0;0
FR;11;2021-10-24;0;0;0;0;0;0;0;0;0;0;0;0;0;0;0;0;0;0
FR;11;2021-10-25;0;0;0;0;0;0;0;0;0;0;0;0;0;0;0;0;0;0
FR;11;2021-10-26;0;0;0;0;0;0;0;0;0;0;0;0;0;0;0;0;0;0
FR;11;2021-10-27;0;0;0;0;0;0;0;0;0;0;0;0;0;0;0;0;0;0
FR;11;2021-10-28;0;0;0;0;0;0;0;0;0;0;0;0;0;0;0;0;0;0
FR;11;2021-10-29;0;0;0;0;0;0;0;0;0;0;0;0;0;0;0;0;0;0
FR;11;2021-10-30;0;0;0;0;0;0;0;0;0;0;0;0;0;0;0;0;0;0
FR;11;2021-10-31;0;0;0;0;0;0;0;0;0;0;0;0;0;0;0;0;0;0
FR;11;2021-11-01;0;0;0;0;0;0;0;0;0;0;0;0;0;0;0;0;0;0
FR;11;2021-11-02;0;0;0;0;0;0;0;0;0;0;0;0;0;0;0;0;0;0
FR;11;2021-11-03;0;0;0;0;0;0;0;0;0;0;0;0;0;0;0;0;0;0
FR;11;2021-11-04;0;0;0;0;0;0;0;0;0;0;0;0;0;0;0;0;0;0
FR;11;2021-11-05;0;0;0;0;0;0;0;0;0;0;0;0;0;0;0;0;0;0
FR;11;2021-11-06;0;0;0;0;0;0;0;0;0;0;0;0;0;0;0;0;0;0
FR;11;2021-11-07;0;0;0;0;0;0;0;0;0;0;0;0;0;0;0;0;0;0
FR;11;2021-11-08;0;0;0;0;0;0;0;0;0;0;0;0;0;0;0;0;0;0
FR;11;2021-11-09;0;0;0;0;0;0;0;0;0;0;0;0;0;0;0;0;0;0
FR;11;2021-11-10;0;0;0;0;0;0;0;0;0;0;0;0;0;0;0;0;0;0
FR;11;2021-11-11;0;0;0;0;0;0;0;0;0;0;0;0;0;0;0;0;0;0
FR;11;2021-11-12;0;0;0;0;0;0;0;0;0;0;0;0;0;0;0;0;0;0
FR;11;2021-11-13;0;0;0;0;0;0;0;0;0;0;0;0;0;0;0;0;0;0
FR;11;2021-11-14;0;0;0;0;0;0;0;0;0;0;0;0;0;0;0;0;0;0
FR;11;2021-11-15;0;0;0;0;0;0;0;0;0;0;0;0;0;0;0;0;0;0
FR;11;2021-11-16;0;0;0;0;0;0;0;0;0;0;0;0;0;0;0;0;0;0
FR;11;2021-11-17;0;0;0;0;0;0;0;0;0;0;0;0;0;0;0;0;0;0
FR;11;2021-11-18;0;0;0;0;0;0;0;0;0;0;0;0;0;0;0;0;0;0
FR;11;2021-11-19;0;0;0;0;0;0;0;0;0;0;0;0;0;0;0;0;0;0
FR;11;2021-11-20;0;0;0;0;0;0;0;0;0;0;0;0;0;0;0;0;0;0
FR;11;2021-11-21;0;0;0;0;0;0;0;0;0;0;0;0;0;0;0;0;0;0
FR;11;2021-11-22;0;0;0;0;0;0;0;0;0;0;0;0;0;0;0;0;0;0
FR;11;2021-11-23;0;0;0;0;0;0;0;0;0;0;0;0;0;0;0;0;0;0
FR;11;2021-11-24;0;0;0;0;0;0;0;0;0;0;0;0;0;0;0;0;0;0
FR;11;2021-11-25;0;0;0;0;0;0;0;0;0;0;0;0;0;0;0;0;0;0
FR;11;2021-11-26;0;0;0;0;0;0;0;0;0;0;0;0;0;0;0;0;0;0
FR;11;2021-11-27;0;0;0;0;0;0;0;0;0;0;0;0;0;0;0;0;0;0
FR;11;2021-11-28;0;0;0;0;0;0;0;0;0;0;0;0;0;0;0;0;0;0
FR;11;2021-11-29;0;0;0;0;0;0;0;0;0;0;0;0;0;0;0;0;0;0
FR;11;2021-11-30;0;0;0;0;0;0;0;0;0;0;0;0;0;0;0;0;0;0
FR;11;2021-12-01;0;0;0;0;0;0;0;0;0;0;0;0;0;0;0;0;0;0
FR;11;2021-12-02;0;0;0;0;0;0;0;0;0;0;0;0;0;0;0;0;0;0
FR;11;2021-12-03;0;0;0;0;0;0;0;0;0;0;0;0;0;0;0;0;0;0
FR;11;2021-12-04;0;0;0;0;0;0;0;0;0;0;0;0;0;0;0;0;0;0
FR;11;2021-12-05;0;0;0;0;0;0;0;0;0;0;0;0;0;0;0;0;0;0
FR;11;2021-12-06;0;0;0;0;0;0;0;0;0;0;0;0;0;0;0;0;0;0
FR;11;2021-12-07;0;0;0;0;0;0;0;0;0;0;0;0;0;0;0;0;0;0
FR;11;2021-12-08;0;0;0;0;0;0;0;0;0;0;0;0;0;0;0;0;0;0
FR;11;2021-12-09;0;0;0;0;0;0;0;0;0;0;0;0;0;0;0;0;0;0
FR;11;2021-12-10;0;0;0;0;0;0;0;0;0;0;0;0;0;0;0;0;0;0
FR;11;2021-12-11;0;0;0;0;0;0;0;0;0;0;0;0;0;0;0;0;0;0
FR;11;2021-12-12;0;0;0;0;0;0;0;0;0;0;0;0;0;0;0;0;0;0
FR;11;2021-12-13;0;0;0;0;0;0;0;0;0;0;0;0;0;0;0;0;0;0
FR;11;2021-12-14;0;0;0;0;0;0;0;0;0;0;0;0;0;0;0;0;0;0
FR;11;2021-12-15;0;0;0;0;0;0;0;0;0;0;0;0;0;0;0;0;0;0
FR;11;2021-12-16;0;0;0;0;0;0;0;0;0;0;0;0;0;0;0;0;0;0
FR;11;2021-12-17;0;0;0;0;0;0;0;0;0;0;0;0;0;0;0;0;0;0
FR;11;2021-12-18;0;0;0;0;0;0;0;0;0;0;0;0;0;0;0;0;0;0
FR;11;2021-12-19;0;0;0;0;0;0;0;0;0;0;0;0;0;0;0;0;0;0
FR;11;2021-12-20;0;0;0;0;0;0;0;0;0;0;0;0;0;0;0;0;0;0
FR;11;2021-12-21;0;0;0;0;0;0;0;0;0;0;0;0;0;0;0;0;0;0
FR;11;2021-12-22;0;0;0;0;0;0;0;0;0;0;0;0;0;0;0;0;0;0
FR;11;2021-12-23;0;0;0;0;0;0;0;0;0;0;0;0;0;0;0;0;0;0
FR;11;2021-12-24;0;0;0;0;0;0;0;0;0;0;0;0;0;0;0;0;0;0
FR;11;2021-12-25;0;0;0;0;0;0;0;0;0;0;0;0;0;0;0;0;0;0
FR;11;2021-12-26;0;0;0;0;0;0;0;0;0;0;0;0;0;0;0;0;0;0
FR;11;2021-12-27;0;0;0;0;0;0;0;0;0;0;0;0;0;0;0;0;0;0
FR;11;2021-12-28;0;0;0;0;0;0;0;0;0;0;0;0;0;0;0;0;0;0
FR;11;2021-12-29;0;0;0;0;0;0;0;0;0;0;0;0;0;0;0;0;0;0
FR;11;2021-12-30;0;0;0;0;0;0;0;0;0;0;0;0;0;0;0;0;0;0
FR;11;2021-12-31;0;0;0;0;0;0;0;0;0;0;0;0;0;0;0;0;0;0
FR;11;2022-01-01;0;0;0;0;0;0;0;0;0;0;0;0;0;0;0;0;0;0
FR;11;2022-01-02;0;0;0;0;0;0;0;0;0;0;0;0;0;0;0;0;0;0
FR;11;2022-01-03;0;0;0;0;0;0;0;0;0;0;0;0;0;0;0;0;0;0
FR;11;2022-01-04;0;0;0;0;0;0;0;0;0;0;0;0;0;0;0;0;0;0
FR;11;2022-01-05;0;0;0;0;0;0;0;0;0;0;0;0;0;0;0;0;0;0
FR;11;2022-01-06;0;0;0;0;0;0;0;0;0;0;0;0;0;0;0;0;0;0
FR;11;2022-01-07;0;0;0;0;0;0;0;0;0;0;0;0;0;0;0;0;0;0
FR;11;2022-01-08;0;0;0;0;0;0;0;0;0;0;0;0;0;0;0;0;0;0
FR;11;2022-01-09;0;0;0;0;0;0;0;0;0;0;0;0;0;0;0;0;0;0
FR;11;2022-01-10;0;0;0;0;0;0;0;0;0;0;0;0;0;0;0;0;0;0
FR;11;2022-01-11;0;0;0;0;0;0;0;0;0;0;0;0;0;0;0;0;0;0
FR;11;2022-01-12;0;0;0;0;0;0;0;0;0;0;0;0;0;0;0;0;0;0
FR;11;2022-01-13;0;0;0;0;0;0;0;0;0;0;0;0;0;0;0;0;0;0
FR;11;2022-01-14;0;0;0;0;0;0;0;0;0;0;0;0;0;0;0;0;0;0
FR;11;2022-01-15;0;0;0;0;0;0;0;0;0;0;0;0;0;0;0;0;0;0
FR;11;2022-01-16;0;0;0;0;0;0;0;0;0;0;0;0;0;0;0;0;0;0
FR;11;2022-01-17;0;0;0;0;0;0;0;0;0;0;0;0;0;0;0;0;0;0
FR;11;2022-01-18;0;0;0;0;0;0;0;0;0;0;0;0;0;0;0;0;0;0
FR;11;2022-01-19;0;0;0;0;0;0;0;0;0;0;0;0;0;0;0;0;0;0
FR;11;2022-01-20;0;0;0;0;0;0;0;0;0;0;0;0;0;0;0;0;0;0
FR;11;2022-01-21;0;0;0;0;0;0;0;0;0;0;0;0;0;0;0;0;0;0
FR;11;2022-01-22;0;0;0;0;0;0;0;0;0;0;0;0;0;0;0;0;0;0
FR;11;2022-01-23;0;0;0;0;0;0;0;0;0;0;0;0;0;0;0;0;0;0
FR;11;2022-01-24;0;0;0;0;0;0;0;0;0;0;0;0;0;0;0;0;0;0
FR;11;2022-01-25;0;0;0;0;0;0;0;0;0;0;0;0;0;0;0;0;0;0
FR;11;2022-01-26;0;0;0;0;0;0;0;0;0;0;0;0;0;0;0;0;0;0
FR;11;2022-01-27;0;0;0;0;0;0;0;0;0;0;0;0;0;0;0;0;0;0
FR;11;2022-01-28;0;0;0;0;0;0;0;0;0;0;0;0;0;0;0;0;0;0
FR;11;2022-01-29;0;0;0;0;0;0;0;0;0;0;0;0;0;0;0;0;0;0
FR;11;2022-01-30;0;0;0;0;0;0;0;0;0;0;0;0;0;0;0;0;0;0
FR;11;2022-01-31;0;0;0;0;0;0;0;0;0;0;0;0;0;0;0;0;0;0
FR;11;2022-02-01;0;0;0;0;0;0;0;0;0;0;0;0;0;0;0;0;0;0
FR;11;2022-02-02;0;0;0;0;0;0;0;0;0;0;0;0;0;0;0;0;0;0
FR;11;2022-02-03;0;0;0;0;0;0;0;0;0;0;0;0;0;0;0;0;0;0
FR;11;2022-02-04;0;0;0;0;0;0;0;0;0;0;0;0;0;0;0;0;0;0
FR;11;2022-02-05;0;0;0;0;0;0;0;0;0;0;0;0;0;0;0;0;0;0
FR;11;2022-02-06;0;0;0;0;0;0;0;0;0;0;0;0;0;0;0;0;0;0
FR;11;2022-02-07;0;0;0;0;0;0;0;0;0;0;0;0;0;0;0;0;0;0
FR;11;2022-02-08;0;0;0;0;0;0;0;0;0;0;0;0;0;0;0;0;0;0
FR;11;2022-02-09;0;0;0;0;0;0;0;0;0;0;0;0;0;0;0;0;0;0
FR;11;2022-02-10;0;0;0;0;0;0;0;0;0;0;0;0;0;0;0;0;0;0
FR;11;2022-02-11;0;0;0;0;0;0;0;0;0;0;0;0;0;0;0;0;0;0
FR;11;2022-02-12;0;0;0;0;0;0;0;0;0;0;0;0;0;0;0;0;0;0
FR;11;2022-02-13;0;0;0;0;0;0;0;0;0;0;0;0;0;0;0;0;0;0
FR;11;2022-02-14;0;0;0;0;0;0;0;0;0;0;0;0;0;0;0;0;0;0
FR;11;2022-02-15;0;0;0;0;0;0;0;0;0;0;0;0;0;0;0;0;0;0
FR;11;2022-02-16;0;0;0;0;0;0;0;0;0;0;0;0;0;0;0;0;0;0
FR;11;2022-02-17;0;0;0;0;0;0;0;0;0;0;0;0;0;0;0;0;0;0
FR;11;2022-02-18;0;0;0;0;0;0;0;0;0;0;0;0;0;0;0;0;0;0
FR;11;2022-02-19;0;0;0;0;0;0;0;0;0;0;0;0;0;0;0;0;0;0
FR;11;2022-02-20;0;0;0;0;0;0;0;0;0;0;0;0;0;0;0;0;0;0
FR;11;2022-02-21;0;0;0;0;0;0;0;0;0;0;0;0;0;0;0;0;0;0
FR;11;2022-02-22;0;0;0;0;0;0;0;0;0;0;0;0;0;0;0;0;0;0
FR;11;2022-02-23;0;0;0;0;0;0;0;0;0;0;0;0;0;0;0;0;0;0
FR;11;2022-02-24;0;0;0;0;0;0;0;0;0;0;0;0;0;0;0;0;0;0
FR;11;2022-02-25;0;0;0;0;0;0;0;0;0;0;0;0;0;0;0;0;0;0
FR;11;2022-02-26;0;0;0;0;0;0;0;0;0;0;0;0;0;0;0;0;0;0
FR;11;2022-02-27;0;0;0;0;0;0;0;0;0;0;0;0;0;0;0;0;0;0
FR;11;2022-02-28;0;0;0;0;0;0;0;0;0;0;0;0;0;0;0;0;0;0
FR;11;2022-03-01;0;0;0;0;0;0;0;0;0;0;0;0;0;0;0;0;0;0
FR;11;2022-03-02;0;0;0;0;0;0;0;0;0;0;0;0;0;0;0;0;0;0
FR;11;2022-03-03;0;0;0;0;0;0;0;0;0;0;0;0;0;0;0;0;0;0
FR;11;2022-03-04;0;0;0;0;0;0;0;0;0;0;0;0;0;0;0;0;0;0
FR;11;2022-03-05;0;0;0;0;0;0;0;0;0;0;0;0;0;0;0;0;0;0
FR;11;2022-03-06;0;0;0;0;0;0;0;0;0;0;0;0;0;0;0;0;0;0
FR;11;2022-03-07;0;0;0;0;0;0;0;0;0;0;0;0;0;0;0;0;0;0
FR;11;2022-03-08;0;0;0;0;0;0;0;0;0;0;0;0;0;0;0;0;0;0
FR;11;2022-03-09;0;0;0;0;0;0;0;0;0;0;0;0;0;0;0;0;0;0
FR;11;2022-03-10;0;0;0;0;0;0;0;0;0;0;0;0;0;0;0;0;0;0
FR;11;2022-03-11;0;0;0;0;0;0;0;0;0;0;0;0;0;0;0;0;0;0
FR;11;2022-03-12;0;0;0;0;0;0;0;0;0;0;0;0;0;0;0;0;0;0
FR;11;2022-03-13;0;0;0;0;0;0;0;0;0;0;0;0;0;0;0;0;0;0
FR;11;2022-03-14;0;0;0;0;0;0;0;0;0;0;0;0;0;0;0;0;0;0
FR;11;2022-03-15;0;0;0;0;0;0;0;0;0;0;0;0;0;0;0;0;0;0
FR;11;2022-03-16;0;0;0;0;0;0;0;0;0;0;0;0;0;0;0;0;0;0
FR;11;2022-03-17;0;0;0;0;0;0;0;0;0;0;0;0;0;0;0;0;0;0
FR;11;2022-03-18;0;0;0;0;0;0;0;0;0;0;0;0;0;0;0;0;0;0
FR;11;2022-03-19;0;0;0;0;0;0;0;0;0;0;0;0;0;0;0;0;0;0
FR;11;2022-03-20;0;0;0;0;0;0;0;0;0;0;0;0;0;0;0;0;0;0
FR;11;2022-03-21;0;0;0;0;0;0;0;0;0;0;0;0;0;0;0;0;0;0
FR;11;2022-03-22;0;0;0;0;0;0;0;0;0;0;0;0;0;0;0;0;0;0
FR;11;2022-03-23;0;0;0;0;0;0;0;0;0;0;0;0;0;0;0;0;0;0
FR;11;2022-03-24;0;0;0;0;0;0;0;0;0;0;0;0;0;0;0;0;0;0
FR;11;2022-03-25;0;0;0;0;0;0;0;0;0;0;0;0;0;0;0;0;0;0
FR;11;2022-03-26;0;0;0;0;0;0;0;0;0;0;0;0;0;0;0;0;0;0
FR;11;2022-03-27;0;0;0;0;0;0;0;0;0;0;0;0;0;0;0;0;0;0
FR;11;2022-03-28;0;0;0;0;0;0;0;0;0;0;0;0;0;0;0;0;0;0
FR;11;2022-03-29;0;0;0;0;0;0;0;0;0;0;0;0;0;0;0;0;0;0
FR;11;2022-03-30;0;0;0;0;0;0;0;0;0;0;0;0;0;0;0;0;0;0
FR;11;2022-03-31;0;0;0;0;0;0;0;0;0;0;0;0;0;0;0;0;0;0
FR;11;2022-04-01;0;0;0;0;0;0;0;0;0;0;0;0;0;0;0;0;0;0
FR;11;2022-04-02;0;0;0;0;0;0;0;0;0;0;0;0;0;0;0;0;0;0
FR;11;2022-04-03;0;0;0;0;0;0;0;0;0;0;0;0;0;0;0;0;0;0
FR;11;2022-04-04;0;0;0;0;0;0;0;0;0;0;0;0;0;0;0;0;0;0
FR;11;2022-04-05;0;0;0;0;0;0;0;0;0;0;0;0;0;0;0;0;0;0
FR;11;2022-04-06;0;0;0;0;0;0;0;0;0;0;0;0;0;0;0;0;0;0
FR;11;2022-04-07;0;0;0;0;0;0;0;0;0;0;0;0;0;0;0;0;0;0
FR;11;2022-04-08;0;0;0;0;0;0;0;0;0;0;0;0;0;0;0;0;0;0
FR;11;2022-04-09;0;0;0;0;0;0;0;0;0;0;0;0;0;0;0;0;0;0
FR;11;2022-04-10;0;0;0;0;0;0;0;0;0;0;0;0;0;0;0;0;0;0
FR;11;2022-04-11;0;0;0;0;0;0;0;0;0;0;0;0;0;0;0;0;0;0
FR;11;2022-04-12;0;0;0;0;0;0;0;0;0;0;0;0;0;0;0;0;0;0
FR;11;2022-04-13;0;0;0;0;0;0;0;0;0;0;0;0;0;0;0;0;0;0
FR;11;2022-04-14;0;0;0;0;0;0;0;0;0;0;0;0;0;0;0;0;0;0
FR;11;2022-04-15;0;0;0;0;0;0;0;0;0;0;0;0;0;0;0;0;0;0
FR;11;2022-04-16;0;0;0;0;0;0;0;0;0;0;0;0;0;0;0;0;0;0
FR;11;2022-04-17;0;0;0;0;0;0;0;0;0;0;0;0;0;0;0;0;0;0
FR;11;2022-04-18;0;0;0;0;0;0;0;0;0;0;0;0;0;0;0;0;0;0
FR;11;2022-04-19;0;0;0;0;0;0;0;0;0;0;0;0;0;0;0;0;0;0
FR;11;2022-04-20;0;0;0;0;0;0;0;0;0;0;0;0;0;0;0;0;0;0
FR;11;2022-04-21;0;0;0;0;0;0;0;0;0;0;0;0;0;0;0;0;0;0
FR;11;2022-04-22;0;0;0;0;0;0;0;0;0;0;0;0;0;0;0;0;0;0
FR;11;2022-04-23;0;0;0;0;0;0;0;0;0;0;0;0;0;0;0;0;0;0
FR;11;2022-04-24;0;0;0;0;0;0;0;0;0;0;0;0;0;0;0;0;0;0
FR;11;2022-04-25;0;0;0;0;0;0;0;0;0;0;0;0;0;0;0;0;0;0
FR;11;2022-04-26;0;0;0;0;0;0;0;0;0;0;0;0;0;0;0;0;0;0
FR;11;2022-04-27;0;0;0;0;0;0;0;0;0;0;0;0;0;0;0;0;0;0
FR;11;2022-04-28;0;0;0;0;0;0;0;0;0;0;0;0;0;0;0;0;0;0
FR;11;2022-04-29;0;0;0;0;0;0;0;0;0;0;0;0;0;0;0;0;0;0
FR;11;2022-04-30;0;0;0;0;0;0;0;0;0;0;0;0;0;0;0;0;0;0
FR;11;2022-05-01;0;0;0;0;0;0;0;0;0;0;0;0;0;0;0;0;0;0
FR;11;2022-05-02;0;0;0;0;0;0;0;0;0;0;0;0;0;0;0;0;0;0
FR;11;2022-05-03;0;0;0;0;0;0;0;0;0;0;0;0;0;0;0;0;0;0
FR;11;2022-05-04;0;0;0;0;0;0;0;0;0;0;0;0;0;0;0;0;0;0
FR;11;2022-05-05;0;0;0;0;0;0;0;0;0;0;0;0;0;0;0;0;0;0
FR;11;2022-05-06;0;0;0;0;0;0;0;0;0;0;0;0;0;0;0;0;0;0
FR;11;2022-05-07;0;0;0;0;0;0;0;0;0;0;0;0;0;0;0;0;0;0
FR;11;2022-05-08;0;0;0;0;0;0;0;0;0;0;0;0;0;0;0;0;0;0
FR;11;2022-05-09;0;0;0;0;0;0;0;0;0;0;0;0;0;0;0;0;0;0
FR;11;2022-05-10;0;0;0;0;0;0;0;0;0;0;0;0;0;0;0;0;0;0
FR;11;2022-05-11;0;0;0;0;0;0;0;0;0;0;0;0;0;0;0;0;0;0
FR;11;2022-05-12;0;0;0;0;0;0;0;0;0;0;0;0;0;0;0;0;0;0
FR;11;2022-05-13;0;0;0;0;0;0;0;0;0;0;0;0;0;0;0;0;0;0
FR;11;2022-05-14;0;0;0;0;0;0;0;0;0;0;0;0;0;0;0;0;0;0
FR;11;2022-05-15;0;0;0;0;0;0;0;0;0;0;0;0;0;0;0;0;0;0
FR;11;2022-05-16;0;0;0;0;0;0;0;0;0;0;0;0;0;0;0;0;0;0
FR;11;2022-05-17;0;0;0;0;0;0;0;0;0;0;0;0;0;0;0;0;0;0
FR;11;2022-05-18;0;0;0;0;0;0;0;0;0;0;0;0;0;0;0;0;0;0
FR;11;2022-05-19;0;0;0;0;0;0;0;0;0;0;0;0;0;0;0;0;0;0
FR;11;2022-05-20;0;0;0;0;0;0;0;0;0;0;0;0;0;0;0;0;0;0
FR;11;2022-05-21;0;0;0;0;0;0;0;0;0;0;0;0;0;0;0;0;0;0
FR;11;2022-05-22;0;0;0;0;0;0;0;0;0;0;0;0;0;0;0;0;0;0
FR;11;2022-05-23;0;0;0;0;0;0;0;0;0;0;0;0;0;0;0;0;0;0
FR;11;2022-05-24;0;0;0;0;0;0;0;0;0;0;0;0;0;0;0;0;0;0
FR;11;2022-05-25;0;0;0;0;0;0;0;0;0;0;0;0;0;0;0;0;0;0
FR;11;2022-05-26;0;0;0;0;0;0;0;0;0;0;0;0;0;0;0;0;0;0
FR;11;2022-05-27;0;0;0;0;0;0;0;0;0;0;0;0;0;0;0;0;0;0
FR;11;2022-05-28;0;0;0;0;0;0;0;0;0;0;0;0;0;0;0;0;0;0
FR;11;2022-05-29;0;0;0;0;0;0;0;0;0;0;0;0;0;0;0;0;0;0
FR;11;2022-05-30;0;0;0;0;0;0;0;0;0;0;0;0;0;0;0;0;0;0
FR;11;2022-05-31;0;0;0;0;0;0;0;0;0;0;0;0;0;0;0;0;0;0
FR;11;2022-06-01;0;0;0;0;0;0;0;0;0;0;0;0;0;0;0;0;0;0
FR;11;2022-06-02;0;0;0;0;0;0;0;0;0;0;0;0;0;0;0;0;0;0
FR;11;2022-06-03;0;0;0;0;0;0;0;0;0;0;0;0;0;0;0;0;0;0
FR;11;2022-06-04;0;0;0;0;0;0;0;0;0;0;0;0;0;0;0;0;0;0
FR;11;2022-06-05;0;0;0;0;0;0;0;0;0;0;0;0;0;0;0;0;0;0
FR;11;2022-06-06;0;0;0;0;0;0;0;0;0;0;0;0;0;0;0;0;0;0
FR;11;2022-06-07;0;0;0;0;0;0;0;0;0;0;0;0;0;0;0;0;0;0
FR;11;2022-06-08;0;0;0;0;0;0;0;0;0;0;0;0;0;0;0;0;0;0
FR;11;2022-06-09;0;0;0;0;0;0;0;0;0;0;0;0;0;0;0;0;0;0
FR;11;2022-06-10;0;0;0;0;0;0;0;0;0;0;0;0;0;0;0;0;0;0
FR;11;2022-06-11;0;0;0;0;0;0;0;0;0;0;0;0;0;0;0;0;0;0
FR;11;2022-06-12;0;0;0;0;0;0;0;0;0;0;0;0;0;0;0;0;0;0
FR;11;2022-06-13;0;0;0;0;0;0;0;0;0;0;0;0;0;0;0;0;0;0
FR;11;2022-06-14;0;0;0;0;0;0;0;0;0;0;0;0;0;0;0;0;0;0
FR;11;2022-06-15;0;0;0;0;0;0;0;0;0;0;0;0;0;0;0;0;0;0
FR;11;2022-06-16;0;0;0;0;0;0;0;0;0;0;0;0;0;0;0;0;0;0
FR;11;2022-06-17;0;0;0;0;0;0;0;0;0;0;0;0;0;0;0;0;0;0
FR;11;2022-06-18;0;0;0;0;0;0;0;0;0;0;0;0;0;0;0;0;0;0
FR;11;2022-06-19;0;0;0;0;0;0;0;0;0;0;0;0;0;0;0;0;0;0
FR;11;2022-06-20;0;0;0;0;0;0;0;0;0;0;0;0;0;0;0;0;0;0
FR;11;2022-06-21;0;0;0;0;0;0;0;0;0;0;0;0;0;0;0;0;0;0
FR;11;2022-06-22;0;0;0;0;0;0;0;0;0;0;0;0;0;0;0;0;0;0
FR;11;2022-06-23;0;0;0;0;0;0;0;0;0;0;0;0;0;0;0;0;0;0
FR;11;2022-06-24;0;0;0;0;0;0;0;0;0;0;0;0;0;0;0;0;0;0
FR;11;2022-06-25;0;0;0;0;0;0;0;0;0;0;0;0;0;0;0;0;0;0
FR;11;2022-06-26;0;0;0;0;0;0;0;0;0;0;0;0;0;0;0;0;0;0
FR;11;2022-06-27;0;0;0;0;0;0;0;0;0;0;0;0;0;0;0;0;0;0
FR;11;2022-06-28;0;0;0;0;0;0;0;0;0;0;0;0;0;0;0;0;0;0
FR;11;2022-06-29;0;0;0;0;0;0;0;0;0;0;0;0;0;0;0;0;0;0
FR;11;2022-06-30;0;0;0;0;0;0;0;0;0;0;0;0;0;0;0;0;0;0
FR;11;2022-07-01;0;0;0;0;0;0;0;0;0;0;0;0;0;0;0;0;0;0
FR;11;2022-07-02;0;0;0;0;0;0;0;0;0;0;0;0;0;0;0;0;0;0
FR;11;2022-07-03;0;0;0;0;0;0;0;0;0;0;0;0;0;0;0;0;0;0
FR;11;2022-07-04;0;0;0;0;0;0;0;0;0;0;0;0;0;0;0;0;0;0
FR;11;2022-07-05;0;0;0;0;0;0;0;0;0;0;0;0;0;0;0;0;0;0
FR;11;2022-07-06;0;0;0;0;0;0;0;0;0;0;0;0;0;0;0;0;0;0
FR;11;2022-07-07;0;0;0;0;0;0;0;0;0;0;0;0;0;0;0;0;0;0
FR;11;2022-07-08;0;0;0;0;0;0;0;0;0;0;0;0;0;0;0;0;0;0
FR;11;2022-07-09;0;0;0;0;0;0;0;0;0;0;0;0;0;0;0;0;0;0
FR;11;2022-07-10;0;0;0;0;0;0;0;0;0;0;0;0;0;0;0;0;0;0
FR;11;2022-07-11;0;0;0;0;0;0;0;0;0;0;0;0;0;0;0;0;0;0
FR;11;2022-07-12;0;0;0;0;0;0;0;0;0;0;0;0;0;0;0;0;0;0
FR;11;2022-07-13;0;0;0;0;0;0;0;0;0;0;0;0;0;0;0;0;0;0
FR;11;2022-07-14;0;0;0;0;0;0;0;0;0;0;0;0;0;0;0;0;0;0
FR;11;2022-07-15;0;0;0;0;0;0;0;0;0;0;0;0;0;0;0;0;0;0
FR;11;2022-07-16;0;0;0;0;0;0;0;0;0;0;0;0;0;0;0;0;0;0
FR;11;2022-07-17;0;0;0;0;0;0;0;0;0;0;0;0;0;0;0;0;0;0
FR;11;2022-07-18;0;0;0;0;0;0;0;0;0;0;0;0;0;0;0;0;0;0
FR;11;2022-07-19;0;0;0;0;0;0;0;0;0;0;0;0;0;0;0;0;0;0
FR;11;2022-07-20;0;0;0;0;0;0;0;0;0;0;0;0;0;0;0;0;0;0
FR;11;2022-07-21;0;0;0;0;0;0;0;0;0;0;0;0;0;0;0;0;0;0
FR;11;2022-07-22;0;0;0;0;0;0;0;0;0;0;0;0;0;0;0;0;0;0
FR;11;2022-07-23;0;0;0;0;0;0;0;0;0;0;0;0;0;0;0;0;0;0
FR;11;2022-07-24;0;0;0;0;0;0;0;0;0;0;0;0;0;0;0;0;0;0
FR;11;2022-07-25;0;0;0;0;0;0;0;0;0;0;0;0;0;0;0;0;0;0
FR;11;2022-07-26;0;0;0;0;0;0;0;0;0;0;0;0;0;0;0;0;0;0
FR;11;2022-07-27;0;0;0;0;0;0;0;0;0;0;0;0;0;0;0;0;0;0
FR;11;2022-07-28;0;0;0;0;0;0;0;0;0;0;0;0;0;0;0;0;0;0
FR;11;2022-07-29;0;0;0;0;0;0;0;0;0;0;0;0;0;0;0;0;0;0
FR;11;2022-07-30;0;0;0;0;0;0;0;0;0;0;0;0;0;0;0;0;0;0
FR;11;2022-07-31;0;0;0;0;0;0;0;0;0;0;0;0;0;0;0;0;0;0
FR;11;2022-08-01;0;0;0;0;0;0;0;0;0;0;0;0;0;0;0;0;0;0
FR;11;2022-08-02;0;0;0;0;0;0;0;0;0;0;0;0;0;0;0;0;0;0
FR;11;2022-08-03;0;0;0;0;0;0;0;0;0;0;0;0;0;0;0;0;0;0
FR;11;2022-08-04;0;0;0;0;0;0;0;0;0;0;0;0;0;0;0;0;0;0
FR;11;2022-08-05;0;0;0;0;0;0;0;0;0;0;0;0;0;0;0;0;0;0
FR;11;2022-08-06;0;0;0;0;0;0;0;0;0;0;0;0;0;0;0;0;0;0
FR;11;2022-08-07;0;0;0;0;0;0;0;0;0;0;0;0;0;0;0;0;0;0
FR;11;2022-08-08;0;0;0;0;0;0;0;0;0;0;0;0;0;0;0;0;0;0
FR;11;2022-08-09;0;0;0;0;0;0;0;0;0;0;0;0;0;0;0;0;0;0
FR;11;2022-08-10;0;0;0;0;0;0;0;0;0;0;0;0;0;0;0;0;0;0
FR;11;2022-08-11;0;0;0;0;0;0;0;0;0;0;0;0;0;0;0;0;0;0
FR;11;2022-08-12;0;0;0;0;0;0;0;0;0;0;0;0;0;0;0;0;0;0
FR;11;2022-08-13;0;0;0;0;0;0;0;0;0;0;0;0;0;0;0;0;0;0
FR;11;2022-08-14;0;0;0;0;0;0;0;0;0;0;0;0;0;0;0;0;0;0
FR;11;2022-08-15;0;0;0;0;0;0;0;0;0;0;0;0;0;0;0;0;0;0
FR;11;2022-08-16;0;0;0;0;0;0;0;0;0;0;0;0;0;0;0;0;0;0
FR;11;2022-08-17;0;0;0;0;0;0;0;0;0;0;0;0;0;0;0;0;0;0
FR;11;2022-08-18;0;0;0;0;0;0;0;0;0;0;0;0;0;0;0;0;0;0
FR;11;2022-08-19;0;0;0;0;0;0;0;0;0;0;0;0;0;0;0;0;0;0
FR;11;2022-08-20;0;0;0;0;0;0;0;0;0;0;0;0;0;0;0;0;0;0
FR;11;2022-08-21;0;0;0;0;0;0;0;0;0;0;0;0;0;0;0;0;0;0
FR;11;2022-08-22;0;0;0;0;0;0;0;0;0;0;0;0;0;0;0;0;0;0
FR;11;2022-08-23;0;0;0;0;0;0;0;0;0;0;0;0;0;0;0;0;0;0
FR;11;2022-08-24;0;0;0;0;0;0;0;0;0;0;0;0;0;0;0;0;0;0
FR;11;2022-08-25;0;0;0;0;0;0;0;0;0;0;0;0;0;0;0;0;0;0
FR;11;2022-08-26;0;0;0;0;0;0;0;0;0;0;0;0;0;0;0;0;0;0
FR;11;2022-08-27;0;0;0;0;0;0;0;0;0;0;0;0;0;0;0;0;0;0
FR;11;2022-08-28;0;0;0;0;0;0;0;0;0;0;0;0;0;0;0;0;0;0
FR;11;2022-08-29;0;0;0;0;0;0;0;0;0;0;0;0;0;0;0;0;0;0
FR;11;2022-08-30;0;0;0;0;0;0;0;0;0;0;0;0;0;0;0;0;0;0
FR;11;2022-08-31;0;0;0;0;0;0;0;0;0;0;0;0;0;0;0;0;0;0
FR;11;2022-09-01;0;0;0;0;0;0;0;0;0;0;0;0;0;0;0;0;0;0
FR;11;2022-09-02;0;0;0;0;0;0;0;0;0;0;0;0;0;0;0;0;0;0
FR;11;2022-09-03;0;0;0;0;0;0;0;0;0;0;0;0;0;0;0;0;0;0
FR;11;2022-09-04;0;0;0;0;0;0;0;0;0;0;0;0;0;0;0;0;0;0
FR;11;2022-09-05;0;0;0;0;0;0;0;0;0;0;0;0;0;0;0;0;0;0
FR;11;2022-09-06;0;0;0;0;0;0;0;0;0;0;0;0;0;0;0;0;0;0
FR;11;2022-09-07;0;0;0;0;0;0;0;0;0;0;0;0;0;0;0;0;0;0
FR;11;2022-09-08;0;0;0;0;0;0;0;0;0;0;0;0;0;0;0;0;0;0
FR;11;2022-09-09;0;0;0;0;0;0;0;0;0;0;0;0;0;0;0;0;0;0
FR;11;2022-09-10;0;0;0;0;0;0;0;0;0;0;0;0;0;0;0;0;0;0
FR;11;2022-09-11;0;0;0;0;0;0;0;0;0;0;0;0;0;0;0;0;0;0
FR;11;2022-09-12;0;0;0;0;0;0;0;0;0;0;0;0;0;0;0;0;0;0
FR;11;2022-09-13;0;0;0;0;0;0;0;0;0;0;0;0;0;0;0;0;0;0
FR;11;2022-09-14;0;0;0;0;0;0;0;0;0;0;0;0;0;0;0;0;0;0
FR;11;2022-09-15;0;0;0;0;0;0;0;0;0;0;0;0;0;0;0;0;0;0
FR;11;2022-09-16;0;0;0;0;0;0;0;0;0;0;0;0;0;0;0;0;0;0
FR;11;2022-09-17;0;0;0;0;0;0;0;0;0;0;0;0;0;0;0;0;0;0
FR;11;2022-09-18;0;0;0;0;0;0;0;0;0;0;0;0;0;0;0;0;0;0
FR;11;2022-09-19;0;0;0;0;0;0;0;0;0;0;0;0;0;0;0;0;0;0
FR;11;2022-09-20;0;0;0;0;0;0;0;0;0;0;0;0;0;0;0;0;0;0
FR;11;2022-09-21;0;0;0;0;0;0;0;0;0;0;0;0;0;0;0;0;0;0
FR;11;2022-09-22;0;0;0;0;0;0;0;0;0;0;0;0;0;0;0;0;0;0
FR;11;2022-09-23;0;0;0;0;0;0;0;0;0;0;0;0;0;0;0;0;0;0
FR;11;2022-09-24;0;0;0;0;0;0;0;0;0;0;0;0;0;0;0;0;0;0
FR;11;2022-09-25;0;0;0;0;0;0;0;0;0;0;0;0;0;0;0;0;0;0
FR;11;2022-09-26;0;0;0;0;0;0;0;0;0;0;0;0;0;0;0;0;0;0
FR;11;2022-09-27;0;0;0;0;0;0;0;0;0;0;0;0;0;0;0;0;0;0
FR;11;2022-09-28;0;0;0;0;0;0;0;0;0;0;0;0;0;0;0;0;0;0
FR;11;2022-09-29;0;0;0;0;0;0;0;0;0;0;0;0;0;0;0;0;0;0
FR;11;2022-09-30;0;0;0;0;0;0;0;0;0;0;0;0;0;0;0;0;0;0
FR;11;2022-10-01;0;0;0;0;0;0;0;0;0;0;0;0;0;0;0;0;0;0
FR;11;2022-10-02;0;0;0;0;0;0;0;0;0;0;0;0;0;0;0;0;0;0
FR;11;2022-10-03;0;0;0;0;0;0;0;0;0;0;0;0;0;0;0;0;0;0
FR;11;2022-10-04;0;0;0;0;0;0;0;0;0;0;0;0;0;0;0;0;0;0
FR;11;2022-10-05;0;0;0;0;0;0;0;0;0;0;0;0;0;0;0;0;0;0
FR;11;2022-10-06;0;0;0;0;0;0;0;0;0;0;0;0;0;0;0;0;0;0
FR;11;2022-10-07;0;0;0;0;0;0;0;0;0;0;0;0;0;0;0;0;0;0
FR;11;2022-10-08;0;0;0;0;0;0;0;0;0;0;0;0;0;0;0;0;0;0
FR;11;2022-10-09;0;0;0;0;0;0;0;0;0;0;0;0;0;0;0;0;0;0
FR;11;2022-10-10;0;0;0;0;0;0;0;0;0;0;0;0;0;0;0;0;0;0
FR;11;2022-10-11;0;0;0;0;0;0;0;0;0;0;0;0;0;0;0;0;0;0
FR;11;2022-10-12;0;0;0;0;0;0;0;0;0;0;0;0;0;0;0;0;0;0
FR;11;2022-10-13;0;0;0;0;0;0;0;0;0;0;0;0;0;0;0;0;0;0
FR;11;2022-10-14;0;0;0;0;0;0;0;0;0;0;0;0;0;0;0;0;0;0
FR;11;2022-10-15;0;0;0;0;0;0;0;0;0;0;0;0;0;0;0;0;0;0
FR;11;2022-10-16;0;0;0;0;0;0;0;0;0;0;0;0;0;0;0;0;0;0
FR;11;2022-10-17;0;0;0;0;0;0;0;0;0;0;0;0;0;0;0;0;0;0
FR;11;2022-10-18;0;0;0;0;0;0;0;0;0;0;0;0;0;0;0;0;0;0
FR;11;2022-10-19;0;0;0;0;0;0;0;0;0;0;0;0;0;0;0;0;0;0
FR;11;2022-10-20;0;0;0;0;0;0;0;0;0;0;0;0;0;0;0;0;0;0
FR;11;2022-10-21;0;0;0;0;0;0;0;0;0;0;0;0;0;0;0;0;0;0
FR;11;2022-10-22;0;0;0;0;0;0;0;0;0;0;0;0;0;0;0;0;0;0
FR;11;2022-10-23;0;0;0;0;0;0;0;0;0;0;0;0;0;0;0;0;0;0
FR;11;2022-10-24;0;0;0;0;0;0;0;0;0;0;0;0;0;0;0;0;0;0
FR;11;2022-10-25;0;0;0;0;0;0;0;0;0;0;0;0;0;0;0;0;0;0
FR;11;2022-10-26;0;0;0;0;0;0;0;0;0;0;0;0;0;0;0;0;0;0
FR;11;2022-10-27;0;0;0;0;0;0;0;0;0;0;0;0;0;0;0;0;0;0
FR;11;2022-10-28;0;0;0;0;0;0;0;0;0;0;0;0;0;0;0;0;0;0
FR;11;2022-10-29;0;0;0;0;0;0;0;0;0;0;0;0;0;0;0;0;0;0
FR;11;2022-10-30;0;0;0;0;0;0;0;0;0;0;0;0;0;0;0;0;0;0
FR;11;2022-10-31;0;0;0;0;0;0;0;0;0;0;0;0;0;0;0;0;0;0
FR;11;2022-11-01;0;0;0;0;0;0;0;0;0;0;0;0;0;0;0;0;0;0
FR;11;2022-11-02;0;0;0;0;0;0;0;0;0;0;0;0;0;0;0;0;0;0
FR;11;2022-11-03;0;0;0;0;0;0;0;0;0;0;0;0;0;0;0;0;0;0
FR;11;2022-11-04;0;0;0;0;0;0;0;0;0;0;0;0;0;0;0;0;0;0
FR;11;2022-11-05;0;0;0;0;0;0;0;0;0;0;0;0;0;0;0;0;0;0
FR;11;2022-11-06;0;0;0;0;0;0;0;0;0;0;0;0;0;0;0;0;0;0
FR;11;2022-11-07;0;0;0;0;0;0;0;0;0;0;0;0;0;0;0;0;0;0
FR;11;2022-11-08;0;0;0;0;0;0;0;0;0;0;0;0;0;0;0;0;0;0
FR;11;2022-11-09;0;0;0;0;0;0;0;0;0;0;0;0;0;0;0;0;0;0
FR;11;2022-11-10;0;0;0;0;0;0;0;0;0;0;0;0;0;0;0;0;0;0
FR;11;2022-11-11;0;0;0;0;0;0;0;0;0;0;0;0;0;0;0;0;0;0
FR;11;2022-11-12;0;0;0;0;0;0;0;0;0;0;0;0;0;0;0;0;0;0
FR;11;2022-11-13;0;0;0;0;0;0;0;0;0;0;0;0;0;0;0;0;0;0
FR;11;2022-11-14;0;0;0;0;0;0;0;0;0;0;0;0;0;0;0;0;0;0
FR;11;2022-11-15;0;0;0;0;0;0;0;0;0;0;0;0;0;0;0;0;0;0
FR;11;2022-11-16;0;0;0;0;0;0;0;0;0;0;0;0;0;0;0;0;0;0
FR;11;2022-11-17;0;0;0;0;0;0;0;0;0;0;0;0;0;0;0;0;0;0
FR;11;2022-11-18;0;0;0;0;0;0;0;0;0;0;0;0;0;0;0;0;0;0
FR;11;2022-11-19;0;0;0;0;0;0;0;0;0;0;0;0;0;0;0;0;0;0
FR;11;2022-11-20;0;0;0;0;0;0;0;0;0;0;0;0;0;0;0;0;0;0
FR;11;2022-11-21;0;0;0;0;0;0;0;0;0;0;0;0;0;0;0;0;0;0
FR;11;2022-11-22;0;0;0;0;0;0;0;0;0;0;0;0;0;0;0;0;0;0
FR;11;2022-11-23;0;0;0;0;0;0;0;0;0;0;0;0;0;0;0;0;0;0
FR;11;2022-11-24;0;0;0;0;0;0;0;0;0;0;0;0;0;0;0;0;0;0
FR;11;2022-11-25;0;0;0;0;0;0;0;0;0;0;0;0;0;0;0;0;0;0
FR;11;2022-11-26;0;0;0;0;0;0;0;0;0;0;0;0;0;0;0;0;0;0
FR;11;2022-11-27;0;0;0;0;0;0;0;0;0;0;0;0;0;0;0;0;0;0
FR;11;2022-11-28;0;0;0;0;0;0;0;0;0;0;0;0;0;0;0;0;0;0
FR;11;2022-11-29;0;0;0;0;0;0;0;0;0;0;0;0;0;0;0;0;0;0
FR;11;2022-11-30;0;0;0;0;0;0;0;0;0;0;0;0;0;0;0;0;0;0
FR;11;2022-12-01;0;0;0;0;0;0;0;0;0;0;0;0;0;0;0;0;0;0
FR;11;2022-12-02;0;0;0;0;0;0;0;0;0;0;0;0;0;0;0;0;0;0
FR;11;2022-12-03;0;0;0;0;0;0;0;0;0;0;0;0;0;0;0;0;0;0
FR;11;2022-12-04;0;0;0;0;0;0;0;0;0;0;0;0;0;0;0;0;0;0
FR;11;2022-12-05;0;0;0;0;0;0;0;0;0;0;0;0;0;0;0;0;0;0
FR;11;2022-12-06;0;0;0;0;0;0;0;0;0;0;0;0;0;0;0;0;0;0
FR;11;2022-12-07;0;0;0;0;0;0;0;0;0;0;0;0;0;0;0;0;0;0
FR;11;2022-12-08;0;0;0;0;0;0;0;0;0;0;0;0;0;0;0;0;0;0
FR;11;2022-12-09;0;0;0;0;0;0;0;0;0;0;0;0;0;0;0;0;0;0
FR;11;2022-12-10;0;0;0;0;0;0;0;0;0;0;0;0;0;0;0;0;0;0
FR;11;2022-12-11;0;0;0;0;0;0;0;0;0;0;0;0;0;0;0;0;0;0
FR;11;2022-12-12;0;0;0;0;0;0;0;0;0;0;0;0;0;0;0;0;0;0
FR;11;2022-12-13;0;0;0;0;0;0;0;0;0;0;0;0;0;0;0;0;0;0
FR;11;2022-12-14;0;0;0;0;0;0;0;0;0;0;0;0;0;0;0;0;0;0
FR;11;2022-12-15;0;0;0;0;0;0;0;0;0;0;0;0;0;0;0;0;0;0
FR;11;2022-12-16;0;0;0;0;0;0;0;0;0;0;0;0;0;0;0;0;0;0
FR;11;2022-12-17;0;0;0;0;0;0;0;0;0;0;0;0;0;0;0;0;0;0
FR;11;2022-12-18;0;0;0;0;0;0;0;0;0;0;0;0;0;0;0;0;0;0
FR;11;2022-12-19;0;0;0;0;0;0;0;0;0;0;0;0;0;0;0;0;0;0
FR;11;2022-12-20;0;0;0;0;0;0;0;0;0;0;0;0;0;0;0;0;0;0
FR;11;2022-12-21;0;0;0;0;0;0;0;0;0;0;0;0;0;0;0;0;0;0
FR;11;2022-12-22;0;0;0;0;0;0;0;0;0;0;0;0;0;0;0;0;0;0
FR;11;2022-12-23;0;0;0;0;0;0;0;0;0;0;0;0;0;0;0;0;0;0
FR;11;2022-12-24;0;0;0;0;0;0;0;0;0;0;0;0;0;0;0;0;0;0
FR;11;2022-12-25;0;0;0;0;0;0;0;0;0;0;0;0;0;0;0;0;0;0
FR;11;2022-12-26;0;0;0;0;0;0;0;0;0;0;0;0;0;0;0;0;0;0
FR;11;2022-12-27;0;0;0;0;0;0;0;0;0;0;0;0;0;0;0;0;0;0
FR;11;2022-12-28;0;0;0;0;0;0;0;0;0;0;0;0;0;0;0;0;0;0
FR;11;2022-12-29;0;0;0;0;0;0;0;0;0;0;0;0;0;0;0;0;0;0
FR;11;2022-12-30;0;0;0;0;0;0;0;0;0;0;0;0;0;0;0;0;0;0
FR;11;2022-12-31;0;0;0;0;0;0;0;0;0;0;0;0;0;0;0;0;0;0
FR;11;2023-01-01;0;0;0;0;0;0;0;0;0;0;0;0;0;0;0;0;0;0
FR;11;2023-01-02;0;0;0;0;0;0;0;0;0;0;0;0;0;0;0;0;0;0
FR;11;2023-01-03;0;0;0;0;0;0;0;0;0;0;0;0;0;0;0;0;0;0
FR;11;2023-01-04;0;0;0;0;0;0;0;0;0;0;0;0;0;0;0;0;0;0
FR;11;2023-01-05;0;0;0;0;0;0;0;0;0;0;0;0;0;0;0;0;0;0
FR;11;2023-01-06;0;0;0;0;0;0;0;0;0;0;0;0;0;0;0;0;0;0
FR;11;2023-01-07;0;0;0;0;0;0;0;0;0;0;0;0;0;0;0;0;0;0
FR;11;2023-01-08;0;0;0;0;0;0;0;0;0;0;0;0;0;0;0;0;0;0
FR;11;2023-01-09;0;0;0;0;0;0;0;0;0;0;0;0;0;0;0;0;0;0
FR;11;2023-01-10;0;0;0;0;0;0;0;0;0;0;0;0;0;0;0;0;0;0
FR;11;2023-01-11;0;0;0;0;0;0;0;0;0;0;0;0;0;0;0;0;0;0
FR;11;2023-01-12;0;0;0;0;0;0;0;0;0;0;0;0;0;0;0;0;0;0
FR;11;2023-01-13;0;0;0;0;0;0;0;0;0;0;0;0;0;0;0;0;0;0
FR;11;2023-01-14;0;0;0;0;0;0;0;0;0;0;0;0;0;0;0;0;0;0
FR;11;2023-01-15;0;0;0;0;0;0;0;0;0;0;0;0;0;0;0;0;0;0
FR;11;2023-01-16;0;0;0;0;0;0;0;0;0;0;0;0;0;0;0;0;0;0
FR;11;2023-01-17;0;0;0;0;0;0;0;0;0;0;0;0;0;0;0;0;0;0
FR;11;2023-01-18;0;0;0;0;0;0;0;0;0;0;0;0;0;0;0;0;0;0
FR;11;2023-01-19;0;0;0;0;0;0;0;0;0;0;0;0;0;0;0;0;0;0
FR;11;2023-01-20;0;0;0;0;0;0;0;0;0;0;0;0;0;0;0;0;0;0
FR;11;2023-01-21;0;0;0;0;0;0;0;0;0;0;0;0;0;0;0;0;0;0
FR;11;2023-01-22;0;0;0;0;0;0;0;0;0;0;0;0;0;0;0;0;0;0
FR;11;2023-01-23;0;0;0;0;0;0;0;0;0;0;0;0;0;0;0;0;0;0
FR;11;2023-01-24;0;0;0;0;0;0;0;0;0;0;0;0;0;0;0;0;0;0
FR;11;2023-01-25;0;0;0;0;0;0;0;0;0;0;0;0;0;0;0;0;0;0
FR;11;2023-01-26;0;0;0;0;0;0;0;0;0;0;0;0;0;0;0;0;0;0
FR;11;2023-01-27;0;0;0;0;0;0;0;0;0;0;0;0;0;0;0;0;0;0
FR;11;2023-01-28;0;0;0;0;0;0;0;0;0;0;0;0;0;0;0;0;0;0
FR;11;2023-01-29;0;0;0;0;0;0;0;0;0;0;0;0;0;0;0;0;0;0
FR;11;2023-01-30;0;0;0;0;0;0;0;0;0;0;0;0;0;0;0;0;0;0
FR;11;2023-01-31;0;0;0;0;0;0;0;0;0;0;0;0;0;0;0;0;0;0
FR;11;2023-02-01;0;0;0;0;0;0;0;0;0;0;0;0;0;0;0;0;0;0
FR;11;2023-02-02;0;0;0;0;0;0;0;0;0;0;0;0;0;0;0;0;0;0
FR;11;2023-02-03;0;0;0;0;0;0;0;0;0;0;0;0;0;0;0;0;0;0
FR;11;2023-02-04;0;0;0;0;0;0;0;0;0;0;0;0;0;0;0;0;0;0
FR;11;2023-02-05;0;0;0;0;0;0;0;0;0;0;0;0;0;0;0;0;0;0
FR;11;2023-02-06;1;0;0;0;0;0;0;0;0;1;0;0;0;0;0;0;0;0
FR;11;2023-02-07;0;0;0;0;0;0;0;0;0;1;0;0;0;0;0;0;0;0
FR;11;2023-02-08;2;0;0;0;0;0;0;0;0;3;0;0;0;0;0;0;0;0
FR;11;2023-02-09;2;0;0;0;0;0;0;0;0;5;0;0;0;0;0;0;0;0
FR;11;2023-02-10;0;0;0;0;0;0;0;0;0;5;0;0;0;0;0;0;0;0
FR;11;2023-02-11;0;0;0;0;0;0;0;0;0;5;0;0;0;0;0;0;0;0
FR;11;2023-02-12;0;0;0;0;0;0;0;0;0;5;0;0;0;0;0;0;0;0
FR;11;2023-02-13;2;0;0;0;0;0;0;0;0;7;0;0;0;0;0;0;0;0
FR;11;2023-02-14;0;0;0;0;0;0;0;0;0;7;0;0;0;0;0;0;0;0
FR;11;2023-02-15;2;0;0;0;0;0;0;0;0;9;0;0;0;0;0;0;0;0
FR;11;2023-02-16;0;0;0;0;0;0;0;0;0;9;0;0;0;0;0;0;0;0
FR;11;2023-02-17;0;0;0;0;0;0;0;0;0;9;0;0;0;0;0;0;0;0
FR;11;2023-02-18;0;0;0;0;0;0;0;0;0;9;0;0;0;0;0;0;0;0
FR;11;2023-02-19;0;0;0;0;0;0;0;0;0;9;0;0;0;0;0;0;0;0
FR;11;2023-02-20;0;0;0;0;0;0;0;0;0;9;0;0;0;0;0;0;0;0
FR;11;2023-02-21;1;0;0;0;0;0;0;0;0;10;0;0;0;0;0;0;0;0
FR;11;2023-02-22;0;0;0;0;0;0;0;0;0;10;0;0;0;0;0;0;0;0
FR;11;2023-02-23;0;0;0;0;0;0;0;0;0;10;0;0;0;0;0;0;0;0
FR;11;2023-02-24;0;0;0;0;0;0;0;0;0;10;0;0;0;0;0;0;0;0
FR;11;2023-02-25;0;0;0;0;0;0;0;0;0;10;0;0;0;0;0;0;0;0
FR;11;2023-02-26;0;0;2;0;0;2;0;0;0;10;0;2;0;0;2;0;0;0
FR;11;2023-02-27;0;0;0;0;0;0;0;0;0;10;0;2;0;0;2;0;0;0
FR;11;2023-02-28;1;1;0;0;1;0;0;0;0;11;1;2;0;1;2;0;0;0
FR;11;2023-03-01;0;1;0;0;1;0;0;0;0;11;2;2;0;2;2;0;0;0
FR;11;2023-03-02;0;0;0;0;0;0;0;0;0;11;2;2;0;2;2;0;0;0
FR;11;2023-03-03;0;0;0;0;0;0;0;0;0;11;2;2;0;2;2;0;0;0
FR;11;2023-03-04;2;1;0;0;1;0;0;0;0;13;3;2;0;3;2;0;0;0
FR;11;2023-03-05;0;0;0;0;0;0;0;0;0;13;3;2;0;3;2;0;0;0
FR;11;2023-03-06;4;0;1;0;1;1;0;0;0;17;3;3;0;4;3;0;0;0
FR;11;2023-03-07;0;1;0;0;1;0;0;0;0;17;4;3;0;5;3;0;0;0
FR;11;2023-03-08;1;1;0;0;1;0;0;0;0;18;5;3;0;6;3;0;0;0
FR;11;2023-03-09;0;0;0;0;0;0;0;0;0;18;5;3;0;6;3;0;0;0
FR;11;2023-03-10;0;0;0;0;0;0;0;0;0;18;5;3;0;6;3;0;0;0
FR;11;2023-03-11;2;0;0;0;0;0;0;0;0;20;5;3;0;6;3;0;0;0
FR;11;2023-03-12;0;1;0;0;1;0;0;0;0;20;6;3;0;7;3;0;0;0
FR;11;2023-03-13;0;0;0;0;0;0;0;0;0;20;6;3;0;7;3;0;0;0
FR;11;2023-03-14;0;0;0;0;0;0;0;0;0;20;6;3;0;7;3;0;0;0
FR;11;2023-03-15;0;1;0;0;1;0;0;0;0;20;7;3;0;8;3;0;0;0
FR;11;2023-03-16;0;0;0;0;0;0;0;0;0;20;7;3;0;8;3;0;0;0
FR;11;2023-03-17;0;0;0;0;0;0;0;0;0;20;7;3;0;8;3;0;0;0
FR;11;2023-03-18;1;0;0;0;0;0;0;0;0;21;7;3;0;8;3;0;0;0
FR;11;2023-03-19;0;0;0;0;0;0;0;0;0;21;7;3;0;8;3;0;0;0
FR;11;2023-03-20;0;0;0;0;0;0;0;0;0;21;7;3;0;8;3;0;0;0
FR;11;2023-03-21;1;0;0;0;0;0;0;0;0;22;7;3;0;8;3;0;0;0
FR;11;2023-03-22;2;0;0;0;0;0;0;0;0;24;7;3;0;8;3;0;0;0
FR;11;2023-03-23;0;0;0;1;0;0;1;0;0;24;7;3;1;8;3;1;0;0
FR;11;2023-03-24;0;0;0;0;0;0;0;0;0;24;7;3;1;8;3;1;0;0
FR;11;2023-03-25;1;1;0;0;1;0;0;0;0;25;8;3;1;9;3;1;0;0
FR;11;2023-03-26;0;0;0;0;0;0;0;0;0;25;8;3;1;9;3;1;0;0
FR;11;2023-03-27;0;1;0;0;0;1;0;0;0;25;9;3;1;9;4;1;0;0
FR;11;2023-03-28;0;0;0;0;0;0;0;0;0;25;9;3;1;9;4;1;0;0
FR;11;2023-03-29;0;1;0;0;1;0;0;0;0;25;10;3;1;10;4;1;0;0
FR;11;2023-03-30;1;1;0;0;1;0;0;0;0;26;11;3;1;11;4;1;0;0
FR;11;2023-03-31;0;0;0;0;0;0;0;0;0;26;11;3;1;11;4;1;0;0
FR;11;2023-04-01;0;2;0;0;2;0;0;0;0;26;13;3;1;13;4;1;0;0
FR;11;2023-04-02;0;0;0;0;0;0;0;0;0;26;13;3;1;13;4;1;0;0
FR;11;2023-04-03;0;3;0;0;3;0;0;0;0;26;16;3;1;16;4;1;0;0
FR;11;2023-04-04;0;0;0;0;0;0;0;0;0;26;16;3;1;16;4;1;0;0
FR;11;2023-04-05;0;0;0;0;0;0;0;0;0;26;16;3;1;16;4;1;0;0
FR;11;2023-04-06;0;0;0;0;0;0;0;0;0;26;16;3;1;16;4;1;0;0
FR;11;2023-04-07;0;1;0;0;1;0;0;0;0;26;17;3;1;17;4;1;0;0
FR;11;2023-04-08;0;0;0;0;0;0;0;0;0;26;17;3;1;17;4;1;0;0
FR;11;2023-04-09;0;0;0;0;0;0;0;0;0;26;17;3;1;17;4;1;0;0
FR;11;2023-04-10;0;0;0;0;0;0;0;0;0;26;17;3;1;17;4;1;0;0
FR;11;2023-04-11;0;1;0;0;1;0;0;0;0;26;18;3;1;18;4;1;0;0
FR;11;2023-04-12;1;1;0;0;1;0;0;0;0;27;19;3;1;19;4;1;0;0
FR;11;2023-04-13;0;0;0;0;0;0;0;0;0;27;19;3;1;19;4;1;0;0
FR;11;2023-04-14;0;0;0;0;0;0;0;0;0;27;19;3;1;19;4;1;0;0
FR;11;2023-04-15;0;1;0;0;1;0;0;0;0;27;20;3;1;20;4;1;0;0
FR;11;2023-04-16;0;0;0;0;0;0;0;0;0;27;20;3;1;20;4;1;0;0
FR;11;2023-04-17;0;1;0;0;1;0;0;0;0;27;21;3;1;21;4;1;0;0
FR;11;2023-04-18;0;0;0;0;0;0;0;0;0;27;21;3;1;21;4;1;0;0
FR;11;2023-04-19;1;0;0;0;0;0;0;0;0;28;21;3;1;21;4;1;0;0
FR;11;2023-04-20;0;1;0;0;1;0;0;0;0;28;22;3;1;22;4;1;0;0
FR;11;2023-04-21;2;0;0;0;0;0;0;0;0;30;22;3;1;22;4;1;0;0
FR;11;2023-04-22;0;2;0;0;2;0;0;0;0;30;24;3;1;24;4;1;0;0
FR;11;2023-04-23;0;0;0;0;0;0;0;0;0;30;24;3;1;24;4;1;0;0
FR;11;2023-04-24;0;0;1;0;0;1;0;0;0;30;24;4;1;24;5;1;0;0
FR;11;2023-04-25;0;0;0;0;0;0;0;0;0;30;24;4;1;24;5;1;0;0
FR;11;2023-04-26;0;0;0;0;0;0;0;0;0;30;24;4;1;24;5;1;0;0
FR;11;2023-04-27;0;0;0;0;0;0;0;0;0;30;24;4;1;24;5;1;0;0
FR;11;2023-04-28;0;0;0;0;0;0;0;0;0;30;24;4;1;24;5;1;0;0
FR;11;2023-04-29;0;0;0;0;0;0;0;0;0;30;24;4;1;24;5;1;0;0
FR;11;2023-04-30;0;0;0;0;0;0;0;0;0;30;24;4;1;24;5;1;0;0
FR;11;2023-05-01;0;0;0;0;0;0;0;0;0;30;24;4;1;24;5;1;0;0
FR;11;2023-05-02;0;0;0;0;0;0;0;0;0;30;24;4;1;24;5;1;0;0
FR;11;2023-05-03;0;0;2;0;0;2;0;0;0;30;24;6;1;24;7;1;0;0
FR;11;2023-05-04;0;0;0;0;0;0;0;0;0;30;24;6;1;24;7;1;0;0
FR;11;2023-05-05;0;0;0;0;0;0;0;0;0;30;24;6;1;24;7;1;0;0
FR;11;2023-05-06;0;0;0;0;0;0;0;0;0;30;24;6;1;24;7;1;0;0
FR;11;2023-05-07;0;0;0;0;0;0;0;0;0;30;24;6;1;24;7;1;0;0
FR;11;2023-05-08;0;0;0;0;0;0;0;0;0;30;24;6;1;24;7;1;0;0
FR;11;2023-05-09;0;0;0;0;0;0;0;0;0;30;24;6;1;24;7;1;0;0
FR;11;2023-05-10;2;2;0;0;2;0;0;0;0;32;26;6;1;26;7;1;0;0
FR;11;2023-05-11;0;0;0;0;0;0;0;0;0;32;26;6;1;26;7;1;0;0
FR;11;2023-05-12;0;0;0;0;0;0;0;0;0;32;26;6;1;26;7;1;0;0
FR;11;2023-05-13;0;0;0;0;0;0;0;0;0;32;26;6;1;26;7;1;0;0
FR;11;2023-05-14;0;0;0;0;0;0;0;0;0;32;26;6;1;26;7;1;0;0
FR;11;2023-05-15;0;0;0;0;0;0;0;0;0;32;26;6;1;26;7;1;0;0
FR;11;2023-05-16;0;0;0;0;0;0;0;0;0;32;26;6;1;26;7;1;0;0
FR;11;2023-05-17;0;0;0;0;0;0;0;0;0;32;26;6;1;26;7;1;0;0
FR;11;2023-05-18;0;0;0;0;0;0;0;0;0;32;26;6;1;26;7;1;0;0
FR;11;2023-05-19;0;0;0;0;0;0;0;0;0;32;26;6;1;26;7;1;0;0
FR;11;2023-05-20;0;0;0;0;0;0;0;0;0;32;26;6;1;26;7;1;0;0
FR;11;2023-05-21;0;0;0;0;0;0;0;0;0;32;26;6;1;26;7;1;0;0
FR;11;2023-05-22;0;0;0;0;0;0;0;0;0;32;26;6;1;26;7;1;0;0
FR;11;2023-05-23;0;0;0;0;0;0;0;0;0;32;26;6;1;26;7;1;0;0
FR;11;2023-05-24;1;0;1;0;0;0;0;0;0;33;26;7;1;26;7;1;0;0
FR;11;2023-05-25;0;0;0;0;0;0;0;0;0;33;26;7;1;26;7;1;0;0
FR;11;2023-05-26;0;0;0;0;0;0;0;0;0;33;26;7;1;26;7;1;0;0
FR;11;2023-05-27;0;0;3;0;0;3;0;0;0;33;26;10;1;26;10;1;0;0
FR;11;2023-05-28;0;0;0;0;0;0;0;0;0;33;26;10;1;26;10;1;0;0
FR;11;2023-05-29;0;0;0;0;0;0;0;0;0;33;26;10;1;26;10;1;0;0
FR;11;2023-05-30;0;1;3;0;1;3;0;0;0;33;27;13;1;27;13;1;0;0
FR;11;2023-05-31;0;0;1;0;0;0;1;0;0;33;27;14;1;27;13;2;0;0
FR;11;2023-06-01;0;0;0;0;0;0;0;0;0;33;27;14;1;27;13;2;0;0
FR;11;2023-06-02;0;0;1;0;0;1;0;0;0;33;27;15;1;27;14;2;0;0
FR;11;2023-06-03;0;0;0;0;0;0;0;0;0;33;27;15;1;27;14;2;0;0
FR;11;2023-06-04;0;0;0;0;0;0;0;0;0;33;27;15;1;27;14;2;0;0
FR;11;2023-06-05;0;0;0;0;0;0;0;0;0;33;27;15;1;27;14;2;0;0
FR;11;2023-06-06;0;0;1;0;0;0;0;0;0;33;27;16;1;27;14;2;0;0
FR;11;2023-06-07;2;0;1;0;0;1;0;0;0;35;27;17;1;27;15;2;0;0
FR;11;2023-06-08;3;0;0;0;0;0;0;0;0;38;27;17;1;27;15;2;0;0
FR;11;2023-06-09;0;0;0;0;0;0;0;0;0;38;27;17;1;27;15;2;0;0
FR;11;2023-06-10;0;0;0;0;0;0;0;0;0;38;27;17;1;27;15;2;0;0
FR;11;2023-06-11;2;0;0;0;0;0;0;0;0;40;27;17;1;27;15;2;0;0
FR;11;2023-06-12;0;0;0;0;0;0;0;0;0;40;27;17;1;27;15;2;0;0
FR;12;2020-12-27;0;0;0;0;0;0;0;0;0;0;0;0;0;0;0;0;0;0
FR;12;2020-12-28;0;0;0;0;0;0;0;0;0;0;0;0;0;0;0;0;0;0
FR;12;2020-12-29;0;0;0;0;0;0;0;0;0;0;0;0;0;0;0;0;0;0
FR;12;2020-12-30;0;0;0;0;0;0;0;0;0;0;0;0;0;0;0;0;0;0
FR;12;2020-12-31;0;0;0;0;0;0;0;0;0;0;0;0;0;0;0;0;0;0
FR;12;2021-01-01;0;0;0;0;0;0;0;0;0;0;0;0;0;0;0;0;0;0
FR;12;2021-01-02;0;0;0;0;0;0;0;0;0;0;0;0;0;0;0;0;0;0
FR;12;2021-01-03;0;0;0;0;0;0;0;0;0;0;0;0;0;0;0;0;0;0
FR;12;2021-01-04;0;0;0;0;0;0;0;0;0;0;0;0;0;0;0;0;0;0
FR;12;2021-01-05;0;0;0;0;0;0;0;0;0;0;0;0;0;0;0;0;0;0
FR;12;2021-01-06;0;0;0;0;0;0;0;0;0;0;0;0;0;0;0;0;0;0
FR;12;2021-01-07;0;0;0;0;0;0;0;0;0;0;0;0;0;0;0;0;0;0
FR;12;2021-01-08;0;0;0;0;0;0;0;0;0;0;0;0;0;0;0;0;0;0
FR;12;2021-01-09;0;0;0;0;0;0;0;0;0;0;0;0;0;0;0;0;0;0
FR;12;2021-01-10;0;0;0;0;0;0;0;0;0;0;0;0;0;0;0;0;0;0
FR;12;2021-01-11;0;0;0;0;0;0;0;0;0;0;0;0;0;0;0;0;0;0
FR;12;2021-01-12;0;0;0;0;0;0;0;0;0;0;0;0;0;0;0;0;0;0
FR;12;2021-01-13;0;0;0;0;0;0;0;0;0;0;0;0;0;0;0;0;0;0
FR;12;2021-01-14;0;0;0;0;0;0;0;0;0;0;0;0;0;0;0;0;0;0
FR;12;2021-01-15;0;0;0;0;0;0;0;0;0;0;0;0;0;0;0;0;0;0
FR;12;2021-01-16;0;0;0;0;0;0;0;0;0;0;0;0;0;0;0;0;0;0
FR;12;2021-01-17;0;0;0;0;0;0;0;0;0;0;0;0;0;0;0;0;0;0
FR;12;2021-01-18;0;0;0;0;0;0;0;0;0;0;0;0;0;0;0;0;0;0
FR;12;2021-01-19;0;0;0;0;0;0;0;0;0;0;0;0;0;0;0;0;0;0
FR;12;2021-01-20;0;0;0;0;0;0;0;0;0;0;0;0;0;0;0;0;0;0
FR;12;2021-01-21;0;0;0;0;0;0;0;0;0;0;0;0;0;0;0;0;0;0
FR;12;2021-01-22;0;0;0;0;0;0;0;0;0;0;0;0;0;0;0;0;0;0
FR;12;2021-01-23;0;0;0;0;0;0;0;0;0;0;0;0;0;0;0;0;0;0
FR;12;2021-01-24;0;0;0;0;0;0;0;0;0;0;0;0;0;0;0;0;0;0
FR;12;2021-01-25;0;0;0;0;0;0;0;0;0;0;0;0;0;0;0;0;0;0
FR;12;2021-01-26;0;0;0;0;0;0;0;0;0;0;0;0;0;0;0;0;0;0
FR;12;2021-01-27;0;0;0;0;0;0;0;0;0;0;0;0;0;0;0;0;0;0
FR;12;2021-01-28;0;0;0;0;0;0;0;0;0;0;0;0;0;0;0;0;0;0
FR;12;2021-01-29;0;0;0;0;0;0;0;0;0;0;0;0;0;0;0;0;0;0
FR;12;2021-01-30;0;0;0;0;0;0;0;0;0;0;0;0;0;0;0;0;0;0
FR;12;2021-01-31;0;0;0;0;0;0;0;0;0;0;0;0;0;0;0;0;0;0
FR;12;2021-02-01;0;0;0;0;0;0;0;0;0;0;0;0;0;0;0;0;0;0
FR;12;2021-02-02;0;0;0;0;0;0;0;0;0;0;0;0;0;0;0;0;0;0
FR;12;2021-02-03;0;0;0;0;0;0;0;0;0;0;0;0;0;0;0;0;0;0
FR;12;2021-02-04;0;0;0;0;0;0;0;0;0;0;0;0;0;0;0;0;0;0
FR;12;2021-02-05;0;0;0;0;0;0;0;0;0;0;0;0;0;0;0;0;0;0
FR;12;2021-02-06;0;0;0;0;0;0;0;0;0;0;0;0;0;0;0;0;0;0
FR;12;2021-02-07;0;0;0;0;0;0;0;0;0;0;0;0;0;0;0;0;0;0
FR;12;2021-02-08;0;0;0;0;0;0;0;0;0;0;0;0;0;0;0;0;0;0
FR;12;2021-02-09;0;0;0;0;0;0;0;0;0;0;0;0;0;0;0;0;0;0
FR;12;2021-02-10;0;0;0;0;0;0;0;0;0;0;0;0;0;0;0;0;0;0
FR;12;2021-02-11;0;0;0;0;0;0;0;0;0;0;0;0;0;0;0;0;0;0
FR;12;2021-02-12;0;0;0;0;0;0;0;0;0;0;0;0;0;0;0;0;0;0
FR;12;2021-02-13;0;0;0;0;0;0;0;0;0;0;0;0;0;0;0;0;0;0
FR;12;2021-02-14;0;0;0;0;0;0;0;0;0;0;0;0;0;0;0;0;0;0
FR;12;2021-02-15;0;0;0;0;0;0;0;0;0;0;0;0;0;0;0;0;0;0
FR;12;2021-02-16;0;0;0;0;0;0;0;0;0;0;0;0;0;0;0;0;0;0
FR;12;2021-02-17;0;0;0;0;0;0;0;0;0;0;0;0;0;0;0;0;0;0
FR;12;2021-02-18;0;0;0;0;0;0;0;0;0;0;0;0;0;0;0;0;0;0
FR;12;2021-02-19;0;0;0;0;0;0;0;0;0;0;0;0;0;0;0;0;0;0
FR;12;2021-02-20;0;0;0;0;0;0;0;0;0;0;0;0;0;0;0;0;0;0
FR;12;2021-02-21;0;0;0;0;0;0;0;0;0;0;0;0;0;0;0;0;0;0
FR;12;2021-02-22;0;0;0;0;0;0;0;0;0;0;0;0;0;0;0;0;0;0
FR;12;2021-02-23;0;0;0;0;0;0;0;0;0;0;0;0;0;0;0;0;0;0
FR;12;2021-02-24;0;0;0;0;0;0;0;0;0;0;0;0;0;0;0;0;0;0
FR;12;2021-02-25;0;0;0;0;0;0;0;0;0;0;0;0;0;0;0;0;0;0
FR;12;2021-02-26;0;0;0;0;0;0;0;0;0;0;0;0;0;0;0;0;0;0
FR;12;2021-02-27;0;0;0;0;0;0;0;0;0;0;0;0;0;0;0;0;0;0
FR;12;2021-02-28;0;0;0;0;0;0;0;0;0;0;0;0;0;0;0;0;0;0
FR;12;2021-03-01;0;0;0;0;0;0;0;0;0;0;0;0;0;0;0;0;0;0
FR;12;2021-03-02;0;0;0;0;0;0;0;0;0;0;0;0;0;0;0;0;0;0
FR;12;2021-03-03;0;0;0;0;0;0;0;0;0;0;0;0;0;0;0;0;0;0
FR;12;2021-03-04;0;0;0;0;0;0;0;0;0;0;0;0;0;0;0;0;0;0
FR;12;2021-03-05;0;0;0;0;0;0;0;0;0;0;0;0;0;0;0;0;0;0
FR;12;2021-03-06;0;0;0;0;0;0;0;0;0;0;0;0;0;0;0;0;0;0
FR;12;2021-03-07;0;0;0;0;0;0;0;0;0;0;0;0;0;0;0;0;0;0
FR;12;2021-03-08;0;0;0;0;0;0;0;0;0;0;0;0;0;0;0;0;0;0
FR;12;2021-03-09;0;0;0;0;0;0;0;0;0;0;0;0;0;0;0;0;0;0
FR;12;2021-03-10;0;0;0;0;0;0;0;0;0;0;0;0;0;0;0;0;0;0
FR;12;2021-03-11;0;0;0;0;0;0;0;0;0;0;0;0;0;0;0;0;0;0
FR;12;2021-03-12;0;0;0;0;0;0;0;0;0;0;0;0;0;0;0;0;0;0
FR;12;2021-03-13;0;0;0;0;0;0;0;0;0;0;0;0;0;0;0;0;0;0
FR;12;2021-03-14;0;0;0;0;0;0;0;0;0;0;0;0;0;0;0;0;0;0
FR;12;2021-03-15;0;0;0;0;0;0;0;0;0;0;0;0;0;0;0;0;0;0
FR;12;2021-03-16;0;0;0;0;0;0;0;0;0;0;0;0;0;0;0;0;0;0
FR;12;2021-03-17;0;0;0;0;0;0;0;0;0;0;0;0;0;0;0;0;0;0
FR;12;2021-03-18;0;0;0;0;0;0;0;0;0;0;0;0;0;0;0;0;0;0
FR;12;2021-03-19;0;0;0;0;0;0;0;0;0;0;0;0;0;0;0;0;0;0
FR;12;2021-03-20;0;0;0;0;0;0;0;0;0;0;0;0;0;0;0;0;0;0
FR;12;2021-03-21;0;0;0;0;0;0;0;0;0;0;0;0;0;0;0;0;0;0
FR;12;2021-03-22;0;0;0;0;0;0;0;0;0;0;0;0;0;0;0;0;0;0
FR;12;2021-03-23;0;0;0;0;0;0;0;0;0;0;0;0;0;0;0;0;0;0
FR;12;2021-03-24;0;0;0;0;0;0;0;0;0;0;0;0;0;0;0;0;0;0
FR;12;2021-03-25;0;0;0;0;0;0;0;0;0;0;0;0;0;0;0;0;0;0
FR;12;2021-03-26;0;0;0;0;0;0;0;0;0;0;0;0;0;0;0;0;0;0
FR;12;2021-03-27;0;0;0;0;0;0;0;0;0;0;0;0;0;0;0;0;0;0
FR;12;2021-03-28;0;0;0;0;0;0;0;0;0;0;0;0;0;0;0;0;0;0
FR;12;2021-03-29;0;0;0;0;0;0;0;0;0;0;0;0;0;0;0;0;0;0
FR;12;2021-03-30;0;0;0;0;0;0;0;0;0;0;0;0;0;0;0;0;0;0
FR;12;2021-03-31;0;0;0;0;0;0;0;0;0;0;0;0;0;0;0;0;0;0
FR;12;2021-04-01;0;0;0;0;0;0;0;0;0;0;0;0;0;0;0;0;0;0
FR;12;2021-04-02;0;0;0;0;0;0;0;0;0;0;0;0;0;0;0;0;0;0
FR;12;2021-04-03;0;0;0;0;0;0;0;0;0;0;0;0;0;0;0;0;0;0
FR;12;2021-04-04;0;0;0;0;0;0;0;0;0;0;0;0;0;0;0;0;0;0
FR;12;2021-04-05;0;0;0;0;0;0;0;0;0;0;0;0;0;0;0;0;0;0
FR;12;2021-04-06;0;0;0;0;0;0;0;0;0;0;0;0;0;0;0;0;0;0
FR;12;2021-04-07;0;0;0;0;0;0;0;0;0;0;0;0;0;0;0;0;0;0
FR;12;2021-04-08;0;0;0;0;0;0;0;0;0;0;0;0;0;0;0;0;0;0
FR;12;2021-04-09;0;0;0;0;0;0;0;0;0;0;0;0;0;0;0;0;0;0
FR;12;2021-04-10;0;0;0;0;0;0;0;0;0;0;0;0;0;0;0;0;0;0
FR;12;2021-04-11;0;0;0;0;0;0;0;0;0;0;0;0;0;0;0;0;0;0
FR;12;2021-04-12;0;0;0;0;0;0;0;0;0;0;0;0;0;0;0;0;0;0
FR;12;2021-04-13;0;0;0;0;0;0;0;0;0;0;0;0;0;0;0;0;0;0
FR;12;2021-04-14;0;0;0;0;0;0;0;0;0;0;0;0;0;0;0;0;0;0
FR;12;2021-04-15;0;0;0;0;0;0;0;0;0;0;0;0;0;0;0;0;0;0
FR;12;2021-04-16;0;0;0;0;0;0;0;0;0;0;0;0;0;0;0;0;0;0
FR;12;2021-04-17;0;0;0;0;0;0;0;0;0;0;0;0;0;0;0;0;0;0
FR;12;2021-04-18;0;0;0;0;0;0;0;0;0;0;0;0;0;0;0;0;0;0
FR;12;2021-04-19;0;0;0;0;0;0;0;0;0;0;0;0;0;0;0;0;0;0
FR;12;2021-04-20;0;0;0;0;0;0;0;0;0;0;0;0;0;0;0;0;0;0
FR;12;2021-04-21;0;0;0;0;0;0;0;0;0;0;0;0;0;0;0;0;0;0
FR;12;2021-04-22;0;0;0;0;0;0;0;0;0;0;0;0;0;0;0;0;0;0
FR;12;2021-04-23;0;0;0;0;0;0;0;0;0;0;0;0;0;0;0;0;0;0
FR;12;2021-04-24;0;0;0;0;0;0;0;0;0;0;0;0;0;0;0;0;0;0
FR;12;2021-04-25;0;0;0;0;0;0;0;0;0;0;0;0;0;0;0;0;0;0
FR;12;2021-04-26;0;0;0;0;0;0;0;0;0;0;0;0;0;0;0;0;0;0
FR;12;2021-04-27;0;0;0;0;0;0;0;0;0;0;0;0;0;0;0;0;0;0
FR;12;2021-04-28;0;0;0;0;0;0;0;0;0;0;0;0;0;0;0;0;0;0
FR;12;2021-04-29;0;0;0;0;0;0;0;0;0;0;0;0;0;0;0;0;0;0
FR;12;2021-04-30;0;0;0;0;0;0;0;0;0;0;0;0;0;0;0;0;0;0
FR;12;2021-05-01;0;0;0;0;0;0;0;0;0;0;0;0;0;0;0;0;0;0
FR;12;2021-05-02;0;0;0;0;0;0;0;0;0;0;0;0;0;0;0;0;0;0
FR;12;2021-05-03;0;0;0;0;0;0;0;0;0;0;0;0;0;0;0;0;0;0
FR;12;2021-05-04;0;0;0;0;0;0;0;0;0;0;0;0;0;0;0;0;0;0
FR;12;2021-05-05;0;0;0;0;0;0;0;0;0;0;0;0;0;0;0;0;0;0
FR;12;2021-05-06;0;0;0;0;0;0;0;0;0;0;0;0;0;0;0;0;0;0
FR;12;2021-05-07;0;0;0;0;0;0;0;0;0;0;0;0;0;0;0;0;0;0
FR;12;2021-05-08;0;0;0;0;0;0;0;0;0;0;0;0;0;0;0;0;0;0
FR;12;2021-05-09;0;0;0;0;0;0;0;0;0;0;0;0;0;0;0;0;0;0
FR;12;2021-05-10;0;0;0;0;0;0;0;0;0;0;0;0;0;0;0;0;0;0
FR;12;2021-05-11;0;0;0;0;0;0;0;0;0;0;0;0;0;0;0;0;0;0
FR;12;2021-05-12;0;0;0;0;0;0;0;0;0;0;0;0;0;0;0;0;0;0
FR;12;2021-05-13;0;0;0;0;0;0;0;0;0;0;0;0;0;0;0;0;0;0
FR;12;2021-05-14;0;0;0;0;0;0;0;0;0;0;0;0;0;0;0;0;0;0
FR;12;2021-05-15;0;0;0;0;0;0;0;0;0;0;0;0;0;0;0;0;0;0
FR;12;2021-05-16;0;0;0;0;0;0;0;0;0;0;0;0;0;0;0;0;0;0
FR;12;2021-05-17;0;0;0;0;0;0;0;0;0;0;0;0;0;0;0;0;0;0
FR;12;2021-05-18;0;0;0;0;0;0;0;0;0;0;0;0;0;0;0;0;0;0
FR;12;2021-05-19;0;0;0;0;0;0;0;0;0;0;0;0;0;0;0;0;0;0
FR;12;2021-05-20;0;0;0;0;0;0;0;0;0;0;0;0;0;0;0;0;0;0
FR;12;2021-05-21;0;0;0;0;0;0;0;0;0;0;0;0;0;0;0;0;0;0
FR;12;2021-05-22;0;0;0;0;0;0;0;0;0;0;0;0;0;0;0;0;0;0
FR;12;2021-05-23;0;0;0;0;0;0;0;0;0;0;0;0;0;0;0;0;0;0
FR;12;2021-05-24;0;0;0;0;0;0;0;0;0;0;0;0;0;0;0;0;0;0
FR;12;2021-05-25;0;0;0;0;0;0;0;0;0;0;0;0;0;0;0;0;0;0
FR;12;2021-05-26;0;0;0;0;0;0;0;0;0;0;0;0;0;0;0;0;0;0
FR;12;2021-05-27;0;0;0;0;0;0;0;0;0;0;0;0;0;0;0;0;0;0
FR;12;2021-05-28;0;0;0;0;0;0;0;0;0;0;0;0;0;0;0;0;0;0
FR;12;2021-05-29;0;0;0;0;0;0;0;0;0;0;0;0;0;0;0;0;0;0
FR;12;2021-05-30;0;0;0;0;0;0;0;0;0;0;0;0;0;0;0;0;0;0
FR;12;2021-05-31;0;0;0;0;0;0;0;0;0;0;0;0;0;0;0;0;0;0
FR;12;2021-06-01;0;0;0;0;0;0;0;0;0;0;0;0;0;0;0;0;0;0
FR;12;2021-06-02;0;0;0;0;0;0;0;0;0;0;0;0;0;0;0;0;0;0
FR;12;2021-06-03;0;0;0;0;0;0;0;0;0;0;0;0;0;0;0;0;0;0
FR;12;2021-06-04;0;0;0;0;0;0;0;0;0;0;0;0;0;0;0;0;0;0
FR;12;2021-06-05;0;0;0;0;0;0;0;0;0;0;0;0;0;0;0;0;0;0
FR;12;2021-06-06;0;0;0;0;0;0;0;0;0;0;0;0;0;0;0;0;0;0
FR;12;2021-06-07;0;0;0;0;0;0;0;0;0;0;0;0;0;0;0;0;0;0
FR;12;2021-06-08;0;0;0;0;0;0;0;0;0;0;0;0;0;0;0;0;0;0
FR;12;2021-06-09;0;0;0;0;0;0;0;0;0;0;0;0;0;0;0;0;0;0
FR;12;2021-06-10;0;0;0;0;0;0;0;0;0;0;0;0;0;0;0;0;0;0
FR;12;2021-06-11;0;0;0;0;0;0;0;0;0;0;0;0;0;0;0;0;0;0
FR;12;2021-06-12;0;0;0;0;0;0;0;0;0;0;0;0;0;0;0;0;0;0
FR;12;2021-06-13;0;0;0;0;0;0;0;0;0;0;0;0;0;0;0;0;0;0
FR;12;2021-06-14;0;0;0;0;0;0;0;0;0;0;0;0;0;0;0;0;0;0
FR;12;2021-06-15;0;0;0;0;0;0;0;0;0;0;0;0;0;0;0;0;0;0
FR;12;2021-06-16;0;0;0;0;0;0;0;0;0;0;0;0;0;0;0;0;0;0
FR;12;2021-06-17;0;0;0;0;0;0;0;0;0;0;0;0;0;0;0;0;0;0
FR;12;2021-06-18;0;0;0;0;0;0;0;0;0;0;0;0;0;0;0;0;0;0
FR;12;2021-06-19;0;0;0;0;0;0;0;0;0;0;0;0;0;0;0;0;0;0
FR;12;2021-06-20;0;0;0;0;0;0;0;0;0;0;0;0;0;0;0;0;0;0
FR;12;2021-06-21;0;0;0;0;0;0;0;0;0;0;0;0;0;0;0;0;0;0
FR;12;2021-06-22;0;0;0;0;0;0;0;0;0;0;0;0;0;0;0;0;0;0
FR;12;2021-06-23;0;0;0;0;0;0;0;0;0;0;0;0;0;0;0;0;0;0
FR;12;2021-06-24;0;0;0;0;0;0;0;0;0;0;0;0;0;0;0;0;0;0
FR;12;2021-06-25;0;0;0;0;0;0;0;0;0;0;0;0;0;0;0;0;0;0
FR;12;2021-06-26;0;0;0;0;0;0;0;0;0;0;0;0;0;0;0;0;0;0
FR;12;2021-06-27;0;0;0;0;0;0;0;0;0;0;0;0;0;0;0;0;0;0
FR;12;2021-06-28;0;0;0;0;0;0;0;0;0;0;0;0;0;0;0;0;0;0
FR;12;2021-06-29;0;0;0;0;0;0;0;0;0;0;0;0;0;0;0;0;0;0
FR;12;2021-06-30;0;0;0;0;0;0;0;0;0;0;0;0;0;0;0;0;0;0
FR;12;2021-07-01;0;0;0;0;0;0;0;0;0;0;0;0;0;0;0;0;0;0
FR;12;2021-07-02;0;0;0;0;0;0;0;0;0;0;0;0;0;0;0;0;0;0
FR;12;2021-07-03;0;0;0;0;0;0;0;0;0;0;0;0;0;0;0;0;0;0
FR;12;2021-07-04;0;0;0;0;0;0;0;0;0;0;0;0;0;0;0;0;0;0
FR;12;2021-07-05;0;0;0;0;0;0;0;0;0;0;0;0;0;0;0;0;0;0
FR;12;2021-07-06;0;0;0;0;0;0;0;0;0;0;0;0;0;0;0;0;0;0
FR;12;2021-07-07;0;0;0;0;0;0;0;0;0;0;0;0;0;0;0;0;0;0
FR;12;2021-07-08;0;0;0;0;0;0;0;0;0;0;0;0;0;0;0;0;0;0
FR;12;2021-07-09;0;0;0;0;0;0;0;0;0;0;0;0;0;0;0;0;0;0
FR;12;2021-07-10;0;0;0;0;0;0;0;0;0;0;0;0;0;0;0;0;0;0
FR;12;2021-07-11;0;0;0;0;0;0;0;0;0;0;0;0;0;0;0;0;0;0
FR;12;2021-07-12;0;0;0;0;0;0;0;0;0;0;0;0;0;0;0;0;0;0
FR;12;2021-07-13;0;0;0;0;0;0;0;0;0;0;0;0;0;0;0;0;0;0
FR;12;2021-07-14;0;0;0;0;0;0;0;0;0;0;0;0;0;0;0;0;0;0
FR;12;2021-07-15;0;0;0;0;0;0;0;0;0;0;0;0;0;0;0;0;0;0
FR;12;2021-07-16;0;0;0;0;0;0;0;0;0;0;0;0;0;0;0;0;0;0
FR;12;2021-07-17;0;0;0;0;0;0;0;0;0;0;0;0;0;0;0;0;0;0
FR;12;2021-07-18;0;0;0;0;0;0;0;0;0;0;0;0;0;0;0;0;0;0
FR;12;2021-07-19;0;0;0;0;0;0;0;0;0;0;0;0;0;0;0;0;0;0
FR;12;2021-07-20;0;0;0;0;0;0;0;0;0;0;0;0;0;0;0;0;0;0
FR;12;2021-07-21;0;0;0;0;0;0;0;0;0;0;0;0;0;0;0;0;0;0
FR;12;2021-07-22;0;0;0;0;0;0;0;0;0;0;0;0;0;0;0;0;0;0
FR;12;2021-07-23;0;0;0;0;0;0;0;0;0;0;0;0;0;0;0;0;0;0
FR;12;2021-07-24;0;0;0;0;0;0;0;0;0;0;0;0;0;0;0;0;0;0
FR;12;2021-07-25;0;0;0;0;0;0;0;0;0;0;0;0;0;0;0;0;0;0
FR;12;2021-07-26;0;0;0;0;0;0;0;0;0;0;0;0;0;0;0;0;0;0
FR;12;2021-07-27;0;0;0;0;0;0;0;0;0;0;0;0;0;0;0;0;0;0
FR;12;2021-07-28;0;0;0;0;0;0;0;0;0;0;0;0;0;0;0;0;0;0
FR;12;2021-07-29;0;0;0;0;0;0;0;0;0;0;0;0;0;0;0;0;0;0
FR;12;2021-07-30;0;0;0;0;0;0;0;0;0;0;0;0;0;0;0;0;0;0
FR;12;2021-07-31;0;0;0;0;0;0;0;0;0;0;0;0;0;0;0;0;0;0
FR;12;2021-08-01;0;0;0;0;0;0;0;0;0;0;0;0;0;0;0;0;0;0
FR;12;2021-08-02;0;0;0;0;0;0;0;0;0;0;0;0;0;0;0;0;0;0
FR;12;2021-08-03;0;0;0;0;0;0;0;0;0;0;0;0;0;0;0;0;0;0
FR;12;2021-08-04;0;0;0;0;0;0;0;0;0;0;0;0;0;0;0;0;0;0
FR;12;2021-08-05;0;0;0;0;0;0;0;0;0;0;0;0;0;0;0;0;0;0
FR;12;2021-08-06;0;0;0;0;0;0;0;0;0;0;0;0;0;0;0;0;0;0
FR;12;2021-08-07;0;0;0;0;0;0;0;0;0;0;0;0;0;0;0;0;0;0
FR;12;2021-08-08;0;0;0;0;0;0;0;0;0;0;0;0;0;0;0;0;0;0
FR;12;2021-08-09;0;0;0;0;0;0;0;0;0;0;0;0;0;0;0;0;0;0
FR;12;2021-08-10;0;0;0;0;0;0;0;0;0;0;0;0;0;0;0;0;0;0
FR;12;2021-08-11;0;0;0;0;0;0;0;0;0;0;0;0;0;0;0;0;0;0
FR;12;2021-08-12;0;0;0;0;0;0;0;0;0;0;0;0;0;0;0;0;0;0
FR;12;2021-08-13;0;0;0;0;0;0;0;0;0;0;0;0;0;0;0;0;0;0
FR;12;2021-08-14;0;0;0;0;0;0;0;0;0;0;0;0;0;0;0;0;0;0
FR;12;2021-08-15;0;0;0;0;0;0;0;0;0;0;0;0;0;0;0;0;0;0
FR;12;2021-08-16;0;0;0;0;0;0;0;0;0;0;0;0;0;0;0;0;0;0
FR;12;2021-08-17;0;0;0;0;0;0;0;0;0;0;0;0;0;0;0;0;0;0
FR;12;2021-08-18;0;0;0;0;0;0;0;0;0;0;0;0;0;0;0;0;0;0
FR;12;2021-08-19;0;0;0;0;0;0;0;0;0;0;0;0;0;0;0;0;0;0
FR;12;2021-08-20;0;0;0;0;0;0;0;0;0;0;0;0;0;0;0;0;0;0
FR;12;2021-08-21;0;0;0;0;0;0;0;0;0;0;0;0;0;0;0;0;0;0
FR;12;2021-08-22;0;0;0;0;0;0;0;0;0;0;0;0;0;0;0;0;0;0
FR;12;2021-08-23;0;0;0;0;0;0;0;0;0;0;0;0;0;0;0;0;0;0
FR;12;2021-08-24;0;0;0;0;0;0;0;0;0;0;0;0;0;0;0;0;0;0
FR;12;2021-08-25;0;0;0;0;0;0;0;0;0;0;0;0;0;0;0;0;0;0
FR;12;2021-08-26;0;0;0;0;0;0;0;0;0;0;0;0;0;0;0;0;0;0
FR;12;2021-08-27;0;0;0;0;0;0;0;0;0;0;0;0;0;0;0;0;0;0
FR;12;2021-08-28;0;0;0;0;0;0;0;0;0;0;0;0;0;0;0;0;0;0
FR;12;2021-08-29;0;0;0;0;0;0;0;0;0;0;0;0;0;0;0;0;0;0
FR;12;2021-08-30;0;0;0;0;0;0;0;0;0;0;0;0;0;0;0;0;0;0
FR;12;2021-08-31;0;0;0;0;0;0;0;0;0;0;0;0;0;0;0;0;0;0
FR;12;2021-09-01;0;0;0;0;0;0;0;0;0;0;0;0;0;0;0;0;0;0
FR;12;2021-09-02;0;0;0;0;0;0;0;0;0;0;0;0;0;0;0;0;0;0
FR;12;2021-09-03;0;0;0;0;0;0;0;0;0;0;0;0;0;0;0;0;0;0
FR;12;2021-09-04;0;0;0;0;0;0;0;0;0;0;0;0;0;0;0;0;0;0
FR;12;2021-09-05;0;0;0;0;0;0;0;0;0;0;0;0;0;0;0;0;0;0
FR;12;2021-09-06;0;0;0;0;0;0;0;0;0;0;0;0;0;0;0;0;0;0
FR;12;2021-09-07;0;0;0;0;0;0;0;0;0;0;0;0;0;0;0;0;0;0
FR;12;2021-09-08;0;0;0;0;0;0;0;0;0;0;0;0;0;0;0;0;0;0
FR;12;2021-09-09;0;0;0;0;0;0;0;0;0;0;0;0;0;0;0;0;0;0
FR;12;2021-09-10;0;0;0;0;0;0;0;0;0;0;0;0;0;0;0;0;0;0
FR;12;2021-09-11;0;0;0;0;0;0;0;0;0;0;0;0;0;0;0;0;0;0
FR;12;2021-09-12;0;0;0;0;0;0;0;0;0;0;0;0;0;0;0;0;0;0
FR;12;2021-09-13;0;0;0;0;0;0;0;0;0;0;0;0;0;0;0;0;0;0
FR;12;2021-09-14;0;0;0;0;0;0;0;0;0;0;0;0;0;0;0;0;0;0
FR;12;2021-09-15;0;0;0;0;0;0;0;0;0;0;0;0;0;0;0;0;0;0
FR;12;2021-09-16;0;0;0;0;0;0;0;0;0;0;0;0;0;0;0;0;0;0
FR;12;2021-09-17;0;0;0;0;0;0;0;0;0;0;0;0;0;0;0;0;0;0
FR;12;2021-09-18;0;0;0;0;0;0;0;0;0;0;0;0;0;0;0;0;0;0
FR;12;2021-09-19;0;0;0;0;0;0;0;0;0;0;0;0;0;0;0;0;0;0
FR;12;2021-09-20;0;0;0;0;0;0;0;0;0;0;0;0;0;0;0;0;0;0
FR;12;2021-09-21;0;0;0;0;0;0;0;0;0;0;0;0;0;0;0;0;0;0
FR;12;2021-09-22;0;0;0;0;0;0;0;0;0;0;0;0;0;0;0;0;0;0
FR;12;2021-09-23;0;0;0;0;0;0;0;0;0;0;0;0;0;0;0;0;0;0
FR;12;2021-09-24;0;0;0;0;0;0;0;0;0;0;0;0;0;0;0;0;0;0
FR;12;2021-09-25;0;0;0;0;0;0;0;0;0;0;0;0;0;0;0;0;0;0
FR;12;2021-09-26;0;0;0;0;0;0;0;0;0;0;0;0;0;0;0;0;0;0
FR;12;2021-09-27;0;0;0;0;0;0;0;0;0;0;0;0;0;0;0;0;0;0
FR;12;2021-09-28;0;0;0;0;0;0;0;0;0;0;0;0;0;0;0;0;0;0
FR;12;2021-09-29;0;0;0;0;0;0;0;0;0;0;0;0;0;0;0;0;0;0
FR;12;2021-09-30;0;0;0;0;0;0;0;0;0;0;0;0;0;0;0;0;0;0
FR;12;2021-10-01;0;0;0;0;0;0;0;0;0;0;0;0;0;0;0;0;0;0
FR;12;2021-10-02;0;0;0;0;0;0;0;0;0;0;0;0;0;0;0;0;0;0
FR;12;2021-10-03;0;0;0;0;0;0;0;0;0;0;0;0;0;0;0;0;0;0
FR;12;2021-10-04;0;0;0;0;0;0;0;0;0;0;0;0;0;0;0;0;0;0
FR;12;2021-10-05;0;0;0;0;0;0;0;0;0;0;0;0;0;0;0;0;0;0
FR;12;2021-10-06;0;0;0;0;0;0;0;0;0;0;0;0;0;0;0;0;0;0
FR;12;2021-10-07;0;0;0;0;0;0;0;0;0;0;0;0;0;0;0;0;0;0
FR;12;2021-10-08;0;0;0;0;0;0;0;0;0;0;0;0;0;0;0;0;0;0
FR;12;2021-10-09;0;0;0;0;0;0;0;0;0;0;0;0;0;0;0;0;0;0
FR;12;2021-10-10;0;0;0;0;0;0;0;0;0;0;0;0;0;0;0;0;0;0
FR;12;2021-10-11;0;0;0;0;0;0;0;0;0;0;0;0;0;0;0;0;0;0
FR;12;2021-10-12;0;0;0;0;0;0;0;0;0;0;0;0;0;0;0;0;0;0
FR;12;2021-10-13;0;0;0;0;0;0;0;0;0;0;0;0;0;0;0;0;0;0
FR;12;2021-10-14;0;0;0;0;0;0;0;0;0;0;0;0;0;0;0;0;0;0
FR;12;2021-10-15;0;0;0;0;0;0;0;0;0;0;0;0;0;0;0;0;0;0
FR;12;2021-10-16;0;0;0;0;0;0;0;0;0;0;0;0;0;0;0;0;0;0
FR;12;2021-10-17;0;0;0;0;0;0;0;0;0;0;0;0;0;0;0;0;0;0
FR;12;2021-10-18;0;0;0;0;0;0;0;0;0;0;0;0;0;0;0;0;0;0
FR;12;2021-10-19;0;0;0;0;0;0;0;0;0;0;0;0;0;0;0;0;0;0
FR;12;2021-10-20;0;0;0;0;0;0;0;0;0;0;0;0;0;0;0;0;0;0
FR;12;2021-10-21;0;0;0;0;0;0;0;0;0;0;0;0;0;0;0;0;0;0
FR;12;2021-10-22;0;0;0;0;0;0;0;0;0;0;0;0;0;0;0;0;0;0
FR;12;2021-10-23;0;0;0;0;0;0;0;0;0;0;0;0;0;0;0;0;0;0
FR;12;2021-10-24;0;0;0;0;0;0;0;0;0;0;0;0;0;0;0;0;0;0
FR;12;2021-10-25;0;0;0;0;0;0;0;0;0;0;0;0;0;0;0;0;0;0
FR;12;2021-10-26;0;0;0;0;0;0;0;0;0;0;0;0;0;0;0;0;0;0
FR;12;2021-10-27;0;0;0;0;0;0;0;0;0;0;0;0;0;0;0;0;0;0
FR;12;2021-10-28;0;0;0;0;0;0;0;0;0;0;0;0;0;0;0;0;0;0
FR;12;2021-10-29;0;0;0;0;0;0;0;0;0;0;0;0;0;0;0;0;0;0
FR;12;2021-10-30;0;0;0;0;0;0;0;0;0;0;0;0;0;0;0;0;0;0
FR;12;2021-10-31;0;0;0;0;0;0;0;0;0;0;0;0;0;0;0;0;0;0
FR;12;2021-11-01;0;0;0;0;0;0;0;0;0;0;0;0;0;0;0;0;0;0
FR;12;2021-11-02;0;0;0;0;0;0;0;0;0;0;0;0;0;0;0;0;0;0
FR;12;2021-11-03;0;0;0;0;0;0;0;0;0;0;0;0;0;0;0;0;0;0
FR;12;2021-11-04;0;0;0;0;0;0;0;0;0;0;0;0;0;0;0;0;0;0
FR;12;2021-11-05;0;0;0;0;0;0;0;0;0;0;0;0;0;0;0;0;0;0
FR;12;2021-11-06;0;0;0;0;0;0;0;0;0;0;0;0;0;0;0;0;0;0
FR;12;2021-11-07;0;0;0;0;0;0;0;0;0;0;0;0;0;0;0;0;0;0
FR;12;2021-11-08;0;0;0;0;0;0;0;0;0;0;0;0;0;0;0;0;0;0
FR;12;2021-11-09;0;0;0;0;0;0;0;0;0;0;0;0;0;0;0;0;0;0
FR;12;2021-11-10;0;0;0;0;0;0;0;0;0;0;0;0;0;0;0;0;0;0
FR;12;2021-11-11;0;0;0;0;0;0;0;0;0;0;0;0;0;0;0;0;0;0
FR;12;2021-11-12;0;0;0;0;0;0;0;0;0;0;0;0;0;0;0;0;0;0
FR;12;2021-11-13;0;0;0;0;0;0;0;0;0;0;0;0;0;0;0;0;0;0
FR;12;2021-11-14;0;0;0;0;0;0;0;0;0;0;0;0;0;0;0;0;0;0
FR;12;2021-11-15;0;0;0;0;0;0;0;0;0;0;0;0;0;0;0;0;0;0
FR;12;2021-11-16;0;0;0;0;0;0;0;0;0;0;0;0;0;0;0;0;0;0
FR;12;2021-11-17;0;0;0;0;0;0;0;0;0;0;0;0;0;0;0;0;0;0
FR;12;2021-11-18;0;0;0;0;0;0;0;0;0;0;0;0;0;0;0;0;0;0
FR;12;2021-11-19;0;0;0;0;0;0;0;0;0;0;0;0;0;0;0;0;0;0
FR;12;2021-11-20;0;0;0;0;0;0;0;0;0;0;0;0;0;0;0;0;0;0
FR;12;2021-11-21;0;0;0;0;0;0;0;0;0;0;0;0;0;0;0;0;0;0
FR;12;2021-11-22;0;0;0;0;0;0;0;0;0;0;0;0;0;0;0;0;0;0
FR;12;2021-11-23;0;0;0;0;0;0;0;0;0;0;0;0;0;0;0;0;0;0
FR;12;2021-11-24;0;0;0;0;0;0;0;0;0;0;0;0;0;0;0;0;0;0
FR;12;2021-11-25;0;0;0;0;0;0;0;0;0;0;0;0;0;0;0;0;0;0
FR;12;2021-11-26;0;0;0;0;0;0;0;0;0;0;0;0;0;0;0;0;0;0
FR;12;2021-11-27;0;0;0;0;0;0;0;0;0;0;0;0;0;0;0;0;0;0
FR;12;2021-11-28;0;0;0;0;0;0;0;0;0;0;0;0;0;0;0;0;0;0
FR;12;2021-11-29;0;0;0;0;0;0;0;0;0;0;0;0;0;0;0;0;0;0
FR;12;2021-11-30;0;0;0;0;0;0;0;0;0;0;0;0;0;0;0;0;0;0
FR;12;2021-12-01;0;0;0;0;0;0;0;0;0;0;0;0;0;0;0;0;0;0
FR;12;2021-12-02;0;0;0;0;0;0;0;0;0;0;0;0;0;0;0;0;0;0
FR;12;2021-12-03;0;0;0;0;0;0;0;0;0;0;0;0;0;0;0;0;0;0
FR;12;2021-12-04;0;0;0;0;0;0;0;0;0;0;0;0;0;0;0;0;0;0
FR;12;2021-12-05;0;0;0;0;0;0;0;0;0;0;0;0;0;0;0;0;0;0
FR;12;2021-12-06;0;0;0;0;0;0;0;0;0;0;0;0;0;0;0;0;0;0
FR;12;2021-12-07;0;0;0;0;0;0;0;0;0;0;0;0;0;0;0;0;0;0
FR;12;2021-12-08;0;0;0;0;0;0;0;0;0;0;0;0;0;0;0;0;0;0
FR;12;2021-12-09;0;0;0;0;0;0;0;0;0;0;0;0;0;0;0;0;0;0
FR;12;2021-12-10;0;0;0;0;0;0;0;0;0;0;0;0;0;0;0;0;0;0
FR;12;2021-12-11;0;0;0;0;0;0;0;0;0;0;0;0;0;0;0;0;0;0
FR;12;2021-12-12;0;0;0;0;0;0;0;0;0;0;0;0;0;0;0;0;0;0
FR;12;2021-12-13;0;0;0;0;0;0;0;0;0;0;0;0;0;0;0;0;0;0
FR;12;2021-12-14;0;0;0;0;0;0;0;0;0;0;0;0;0;0;0;0;0;0
FR;12;2021-12-15;0;0;0;0;0;0;0;0;0;0;0;0;0;0;0;0;0;0
FR;12;2021-12-16;0;0;0;0;0;0;0;0;0;0;0;0;0;0;0;0;0;0
FR;12;2021-12-17;0;0;0;0;0;0;0;0;0;0;0;0;0;0;0;0;0;0
FR;12;2021-12-18;0;0;0;0;0;0;0;0;0;0;0;0;0;0;0;0;0;0
FR;12;2021-12-19;0;0;0;0;0;0;0;0;0;0;0;0;0;0;0;0;0;0
FR;12;2021-12-20;0;0;0;0;0;0;0;0;0;0;0;0;0;0;0;0;0;0
FR;12;2021-12-21;0;0;0;0;0;0;0;0;0;0;0;0;0;0;0;0;0;0
FR;12;2021-12-22;0;0;0;0;0;0;0;0;0;0;0;0;0;0;0;0;0;0
FR;12;2021-12-23;0;0;0;0;0;0;0;0;0;0;0;0;0;0;0;0;0;0
FR;12;2021-12-24;0;0;0;0;0;0;0;0;0;0;0;0;0;0;0;0;0;0
FR;12;2021-12-25;0;0;0;0;0;0;0;0;0;0;0;0;0;0;0;0;0;0
FR;12;2021-12-26;0;0;0;0;0;0;0;0;0;0;0;0;0;0;0;0;0;0
FR;12;2021-12-27;0;0;0;0;0;0;0;0;0;0;0;0;0;0;0;0;0;0
FR;12;2021-12-28;0;0;0;0;0;0;0;0;0;0;0;0;0;0;0;0;0;0
FR;12;2021-12-29;0;0;0;0;0;0;0;0;0;0;0;0;0;0;0;0;0;0
FR;12;2021-12-30;0;0;0;0;0;0;0;0;0;0;0;0;0;0;0;0;0;0
FR;12;2021-12-31;0;0;0;0;0;0;0;0;0;0;0;0;0;0;0;0;0;0
FR;12;2022-01-01;0;0;0;0;0;0;0;0;0;0;0;0;0;0;0;0;0;0
FR;12;2022-01-02;0;0;0;0;0;0;0;0;0;0;0;0;0;0;0;0;0;0
FR;12;2022-01-03;0;0;0;0;0;0;0;0;0;0;0;0;0;0;0;0;0;0
FR;12;2022-01-04;0;0;0;0;0;0;0;0;0;0;0;0;0;0;0;0;0;0
FR;12;2022-01-05;0;0;0;0;0;0;0;0;0;0;0;0;0;0;0;0;0;0
FR;12;2022-01-06;0;0;0;0;0;0;0;0;0;0;0;0;0;0;0;0;0;0
FR;12;2022-01-07;0;0;0;0;0;0;0;0;0;0;0;0;0;0;0;0;0;0
FR;12;2022-01-08;0;0;0;0;0;0;0;0;0;0;0;0;0;0;0;0;0;0
FR;12;2022-01-09;0;0;0;0;0;0;0;0;0;0;0;0;0;0;0;0;0;0
FR;12;2022-01-10;0;0;0;0;0;0;0;0;0;0;0;0;0;0;0;0;0;0
FR;12;2022-01-11;0;0;0;0;0;0;0;0;0;0;0;0;0;0;0;0;0;0
FR;12;2022-01-12;0;0;0;0;0;0;0;0;0;0;0;0;0;0;0;0;0;0
FR;12;2022-01-13;0;0;0;0;0;0;0;0;0;0;0;0;0;0;0;0;0;0
FR;12;2022-01-14;0;0;0;0;0;0;0;0;0;0;0;0;0;0;0;0;0;0
FR;12;2022-01-15;0;0;0;0;0;0;0;0;0;0;0;0;0;0;0;0;0;0
FR;12;2022-01-16;0;0;0;0;0;0;0;0;0;0;0;0;0;0;0;0;0;0
FR;12;2022-01-17;0;0;0;0;0;0;0;0;0;0;0;0;0;0;0;0;0;0
FR;12;2022-01-18;0;0;0;0;0;0;0;0;0;0;0;0;0;0;0;0;0;0
FR;12;2022-01-19;0;0;0;0;0;0;0;0;0;0;0;0;0;0;0;0;0;0
FR;12;2022-01-20;0;0;0;0;0;0;0;0;0;0;0;0;0;0;0;0;0;0
FR;12;2022-01-21;0;0;0;0;0;0;0;0;0;0;0;0;0;0;0;0;0;0
FR;12;2022-01-22;0;0;0;0;0;0;0;0;0;0;0;0;0;0;0;0;0;0
FR;12;2022-01-23;0;0;0;0;0;0;0;0;0;0;0;0;0;0;0;0;0;0
FR;12;2022-01-24;0;0;0;0;0;0;0;0;0;0;0;0;0;0;0;0;0;0
FR;12;2022-01-25;0;0;0;0;0;0;0;0;0;0;0;0;0;0;0;0;0;0
FR;12;2022-01-26;0;0;0;0;0;0;0;0;0;0;0;0;0;0;0;0;0;0
FR;12;2022-01-27;0;0;0;0;0;0;0;0;0;0;0;0;0;0;0;0;0;0
FR;12;2022-01-28;0;0;0;0;0;0;0;0;0;0;0;0;0;0;0;0;0;0
FR;12;2022-01-29;0;0;0;0;0;0;0;0;0;0;0;0;0;0;0;0;0;0
FR;12;2022-01-30;0;0;0;0;0;0;0;0;0;0;0;0;0;0;0;0;0;0
FR;12;2022-01-31;0;0;0;0;0;0;0;0;0;0;0;0;0;0;0;0;0;0
FR;12;2022-02-01;0;0;0;0;0;0;0;0;0;0;0;0;0;0;0;0;0;0
FR;12;2022-02-02;0;0;0;0;0;0;0;0;0;0;0;0;0;0;0;0;0;0
FR;12;2022-02-03;0;0;0;0;0;0;0;0;0;0;0;0;0;0;0;0;0;0
FR;12;2022-02-04;0;0;0;0;0;0;0;0;0;0;0;0;0;0;0;0;0;0
FR;12;2022-02-05;0;0;0;0;0;0;0;0;0;0;0;0;0;0;0;0;0;0
FR;12;2022-02-06;0;0;0;0;0;0;0;0;0;0;0;0;0;0;0;0;0;0
FR;12;2022-02-07;0;0;0;0;0;0;0;0;0;0;0;0;0;0;0;0;0;0
FR;12;2022-02-08;0;0;0;0;0;0;0;0;0;0;0;0;0;0;0;0;0;0
FR;12;2022-02-09;0;0;0;0;0;0;0;0;0;0;0;0;0;0;0;0;0;0
FR;12;2022-02-10;0;0;0;0;0;0;0;0;0;0;0;0;0;0;0;0;0;0
FR;12;2022-02-11;0;0;0;0;0;0;0;0;0;0;0;0;0;0;0;0;0;0
FR;12;2022-02-12;0;0;0;0;0;0;0;0;0;0;0;0;0;0;0;0;0;0
FR;12;2022-02-13;0;0;0;0;0;0;0;0;0;0;0;0;0;0;0;0;0;0
FR;12;2022-02-14;0;0;0;0;0;0;0;0;0;0;0;0;0;0;0;0;0;0
FR;12;2022-02-15;0;0;0;0;0;0;0;0;0;0;0;0;0;0;0;0;0;0
FR;12;2022-02-16;0;0;0;0;0;0;0;0;0;0;0;0;0;0;0;0;0;0
FR;12;2022-02-17;0;0;0;0;0;0;0;0;0;0;0;0;0;0;0;0;0;0
FR;12;2022-02-18;0;0;0;0;0;0;0;0;0;0;0;0;0;0;0;0;0;0
FR;12;2022-02-19;0;0;0;0;0;0;0;0;0;0;0;0;0;0;0;0;0;0
FR;12;2022-02-20;0;0;0;0;0;0;0;0;0;0;0;0;0;0;0;0;0;0
FR;12;2022-02-21;0;0;0;0;0;0;0;0;0;0;0;0;0;0;0;0;0;0
FR;12;2022-02-22;0;0;0;0;0;0;0;0;0;0;0;0;0;0;0;0;0;0
FR;12;2022-02-23;0;0;0;0;0;0;0;0;0;0;0;0;0;0;0;0;0;0
FR;12;2022-02-24;0;0;0;0;0;0;0;0;0;0;0;0;0;0;0;0;0;0
FR;12;2022-02-25;0;0;0;0;0;0;0;0;0;0;0;0;0;0;0;0;0;0
FR;12;2022-02-26;0;0;0;0;0;0;0;0;0;0;0;0;0;0;0;0;0;0
FR;12;2022-02-27;0;0;0;0;0;0;0;0;0;0;0;0;0;0;0;0;0;0
FR;12;2022-02-28;0;0;0;0;0;0;0;0;0;0;0;0;0;0;0;0;0;0
FR;12;2022-03-01;0;0;0;0;0;0;0;0;0;0;0;0;0;0;0;0;0;0
FR;12;2022-03-02;0;0;0;0;0;0;0;0;0;0;0;0;0;0;0;0;0;0
FR;12;2022-03-03;0;0;0;0;0;0;0;0;0;0;0;0;0;0;0;0;0;0
FR;12;2022-03-04;0;0;0;0;0;0;0;0;0;0;0;0;0;0;0;0;0;0
FR;12;2022-03-05;0;0;0;0;0;0;0;0;0;0;0;0;0;0;0;0;0;0
FR;12;2022-03-06;0;0;0;0;0;0;0;0;0;0;0;0;0;0;0;0;0;0
FR;12;2022-03-07;0;0;0;0;0;0;0;0;0;0;0;0;0;0;0;0;0;0
FR;12;2022-03-08;0;0;0;0;0;0;0;0;0;0;0;0;0;0;0;0;0;0
FR;12;2022-03-09;0;0;0;0;0;0;0;0;0;0;0;0;0;0;0;0;0;0
FR;12;2022-03-10;0;0;0;0;0;0;0;0;0;0;0;0;0;0;0;0;0;0
FR;12;2022-03-11;0;0;0;0;0;0;0;0;0;0;0;0;0;0;0;0;0;0
FR;12;2022-03-12;0;0;0;0;0;0;0;0;0;0;0;0;0;0;0;0;0;0
FR;12;2022-03-13;0;0;0;0;0;0;0;0;0;0;0;0;0;0;0;0;0;0
FR;12;2022-03-14;0;0;0;0;0;0;0;0;0;0;0;0;0;0;0;0;0;0
FR;12;2022-03-15;0;0;0;0;0;0;0;0;0;0;0;0;0;0;0;0;0;0
FR;12;2022-03-16;0;0;0;0;0;0;0;0;0;0;0;0;0;0;0;0;0;0
FR;12;2022-03-17;0;0;0;0;0;0;0;0;0;0;0;0;0;0;0;0;0;0
FR;12;2022-03-18;0;0;0;0;0;0;0;0;0;0;0;0;0;0;0;0;0;0
FR;12;2022-03-19;0;0;0;0;0;0;0;0;0;0;0;0;0;0;0;0;0;0
FR;12;2022-03-20;0;0;0;0;0;0;0;0;0;0;0;0;0;0;0;0;0;0
FR;12;2022-03-21;0;0;0;0;0;0;0;0;0;0;0;0;0;0;0;0;0;0
FR;12;2022-03-22;0;0;0;0;0;0;0;0;0;0;0;0;0;0;0;0;0;0
FR;12;2022-03-23;0;0;0;0;0;0;0;0;0;0;0;0;0;0;0;0;0;0
FR;12;2022-03-24;0;0;0;0;0;0;0;0;0;0;0;0;0;0;0;0;0;0
FR;12;2022-03-25;0;0;0;0;0;0;0;0;0;0;0;0;0;0;0;0;0;0
FR;12;2022-03-26;0;0;0;0;0;0;0;0;0;0;0;0;0;0;0;0;0;0
FR;12;2022-03-27;0;0;0;0;0;0;0;0;0;0;0;0;0;0;0;0;0;0
FR;12;2022-03-28;0;0;0;0;0;0;0;0;0;0;0;0;0;0;0;0;0;0
FR;12;2022-03-29;0;0;0;0;0;0;0;0;0;0;0;0;0;0;0;0;0;0
FR;12;2022-03-30;0;0;0;0;0;0;0;0;0;0;0;0;0;0;0;0;0;0
FR;12;2022-03-31;0;0;0;0;0;0;0;0;0;0;0;0;0;0;0;0;0;0
FR;12;2022-04-01;0;0;0;0;0;0;0;0;0;0;0;0;0;0;0;0;0;0
FR;12;2022-04-02;0;0;0;0;0;0;0;0;0;0;0;0;0;0;0;0;0;0
FR;12;2022-04-03;0;0;0;0;0;0;0;0;0;0;0;0;0;0;0;0;0;0
FR;12;2022-04-04;0;0;0;0;0;0;0;0;0;0;0;0;0;0;0;0;0;0
FR;12;2022-04-05;0;0;0;0;0;0;0;0;0;0;0;0;0;0;0;0;0;0
FR;12;2022-04-06;0;0;0;0;0;0;0;0;0;0;0;0;0;0;0;0;0;0
FR;12;2022-04-07;0;0;0;0;0;0;0;0;0;0;0;0;0;0;0;0;0;0
FR;12;2022-04-08;0;0;0;0;0;0;0;0;0;0;0;0;0;0;0;0;0;0
FR;12;2022-04-09;0;0;0;0;0;0;0;0;0;0;0;0;0;0;0;0;0;0
FR;12;2022-04-10;0;0;0;0;0;0;0;0;0;0;0;0;0;0;0;0;0;0
FR;12;2022-04-11;0;0;0;0;0;0;0;0;0;0;0;0;0;0;0;0;0;0
FR;12;2022-04-12;0;0;0;0;0;0;0;0;0;0;0;0;0;0;0;0;0;0
FR;12;2022-04-13;0;0;0;0;0;0;0;0;0;0;0;0;0;0;0;0;0;0
FR;12;2022-04-14;0;0;0;0;0;0;0;0;0;0;0;0;0;0;0;0;0;0
FR;12;2022-04-15;0;0;0;0;0;0;0;0;0;0;0;0;0;0;0;0;0;0
FR;12;2022-04-16;0;0;0;0;0;0;0;0;0;0;0;0;0;0;0;0;0;0
FR;12;2022-04-17;0;0;0;0;0;0;0;0;0;0;0;0;0;0;0;0;0;0
FR;12;2022-04-18;0;0;0;0;0;0;0;0;0;0;0;0;0;0;0;0;0;0
FR;12;2022-04-19;0;0;0;0;0;0;0;0;0;0;0;0;0;0;0;0;0;0
FR;12;2022-04-20;0;0;0;0;0;0;0;0;0;0;0;0;0;0;0;0;0;0
FR;12;2022-04-21;0;0;0;0;0;0;0;0;0;0;0;0;0;0;0;0;0;0
FR;12;2022-04-22;0;0;0;0;0;0;0;0;0;0;0;0;0;0;0;0;0;0
FR;12;2022-04-23;0;0;0;0;0;0;0;0;0;0;0;0;0;0;0;0;0;0
FR;12;2022-04-24;0;0;0;0;0;0;0;0;0;0;0;0;0;0;0;0;0;0
FR;12;2022-04-25;0;0;0;0;0;0;0;0;0;0;0;0;0;0;0;0;0;0
FR;12;2022-04-26;0;0;0;0;0;0;0;0;0;0;0;0;0;0;0;0;0;0
FR;12;2022-04-27;0;0;0;0;0;0;0;0;0;0;0;0;0;0;0;0;0;0
FR;12;2022-04-28;0;0;0;0;0;0;0;0;0;0;0;0;0;0;0;0;0;0
FR;12;2022-04-29;0;0;0;0;0;0;0;0;0;0;0;0;0;0;0;0;0;0
FR;12;2022-04-30;0;0;0;0;0;0;0;0;0;0;0;0;0;0;0;0;0;0
FR;12;2022-05-01;0;0;0;0;0;0;0;0;0;0;0;0;0;0;0;0;0;0
FR;12;2022-05-02;0;0;0;0;0;0;0;0;0;0;0;0;0;0;0;0;0;0
FR;12;2022-05-03;0;0;0;0;0;0;0;0;0;0;0;0;0;0;0;0;0;0
FR;12;2022-05-04;0;0;0;0;0;0;0;0;0;0;0;0;0;0;0;0;0;0
FR;12;2022-05-05;0;0;0;0;0;0;0;0;0;0;0;0;0;0;0;0;0;0
FR;12;2022-05-06;0;0;0;0;0;0;0;0;0;0;0;0;0;0;0;0;0;0
FR;12;2022-05-07;0;0;0;0;0;0;0;0;0;0;0;0;0;0;0;0;0;0
FR;12;2022-05-08;0;0;0;0;0;0;0;0;0;0;0;0;0;0;0;0;0;0
FR;12;2022-05-09;0;0;0;0;0;0;0;0;0;0;0;0;0;0;0;0;0;0
FR;12;2022-05-10;0;0;0;0;0;0;0;0;0;0;0;0;0;0;0;0;0;0
FR;12;2022-05-11;0;0;0;0;0;0;0;0;0;0;0;0;0;0;0;0;0;0
FR;12;2022-05-12;0;0;0;0;0;0;0;0;0;0;0;0;0;0;0;0;0;0
FR;12;2022-05-13;0;0;0;0;0;0;0;0;0;0;0;0;0;0;0;0;0;0
FR;12;2022-05-14;0;0;0;0;0;0;0;0;0;0;0;0;0;0;0;0;0;0
FR;12;2022-05-15;0;0;0;0;0;0;0;0;0;0;0;0;0;0;0;0;0;0
FR;12;2022-05-16;0;0;0;0;0;0;0;0;0;0;0;0;0;0;0;0;0;0
FR;12;2022-05-17;0;0;0;0;0;0;0;0;0;0;0;0;0;0;0;0;0;0
FR;12;2022-05-18;0;0;0;0;0;0;0;0;0;0;0;0;0;0;0;0;0;0
FR;12;2022-05-19;0;0;0;0;0;0;0;0;0;0;0;0;0;0;0;0;0;0
FR;12;2022-05-20;0;0;0;0;0;0;0;0;0;0;0;0;0;0;0;0;0;0
FR;12;2022-05-21;0;0;0;0;0;0;0;0;0;0;0;0;0;0;0;0;0;0
FR;12;2022-05-22;0;0;0;0;0;0;0;0;0;0;0;0;0;0;0;0;0;0
FR;12;2022-05-23;0;0;0;0;0;0;0;0;0;0;0;0;0;0;0;0;0;0
FR;12;2022-05-24;0;0;0;0;0;0;0;0;0;0;0;0;0;0;0;0;0;0
FR;12;2022-05-25;0;0;0;0;0;0;0;0;0;0;0;0;0;0;0;0;0;0
FR;12;2022-05-26;0;0;0;0;0;0;0;0;0;0;0;0;0;0;0;0;0;0
FR;12;2022-05-27;0;0;0;0;0;0;0;0;0;0;0;0;0;0;0;0;0;0
FR;12;2022-05-28;0;0;0;0;0;0;0;0;0;0;0;0;0;0;0;0;0;0
FR;12;2022-05-29;0;0;0;0;0;0;0;0;0;0;0;0;0;0;0;0;0;0
FR;12;2022-05-30;0;0;0;0;0;0;0;0;0;0;0;0;0;0;0;0;0;0
FR;12;2022-05-31;0;0;0;0;0;0;0;0;0;0;0;0;0;0;0;0;0;0
FR;12;2022-06-01;0;0;0;0;0;0;0;0;0;0;0;0;0;0;0;0;0;0
FR;12;2022-06-02;0;0;0;0;0;0;0;0;0;0;0;0;0;0;0;0;0;0
FR;12;2022-06-03;0;0;0;0;0;0;0;0;0;0;0;0;0;0;0;0;0;0
FR;12;2022-06-04;0;0;0;0;0;0;0;0;0;0;0;0;0;0;0;0;0;0
FR;12;2022-06-05;0;0;0;0;0;0;0;0;0;0;0;0;0;0;0;0;0;0
FR;12;2022-06-06;0;0;0;0;0;0;0;0;0;0;0;0;0;0;0;0;0;0
FR;12;2022-06-07;0;0;0;0;0;0;0;0;0;0;0;0;0;0;0;0;0;0
FR;12;2022-06-08;0;0;0;0;0;0;0;0;0;0;0;0;0;0;0;0;0;0
FR;12;2022-06-09;0;0;0;0;0;0;0;0;0;0;0;0;0;0;0;0;0;0
FR;12;2022-06-10;0;0;0;0;0;0;0;0;0;0;0;0;0;0;0;0;0;0
FR;12;2022-06-11;0;0;0;0;0;0;0;0;0;0;0;0;0;0;0;0;0;0
FR;12;2022-06-12;0;0;0;0;0;0;0;0;0;0;0;0;0;0;0;0;0;0
FR;12;2022-06-13;0;0;0;0;0;0;0;0;0;0;0;0;0;0;0;0;0;0
FR;12;2022-06-14;0;0;0;0;0;0;0;0;0;0;0;0;0;0;0;0;0;0
FR;12;2022-06-15;0;0;0;0;0;0;0;0;0;0;0;0;0;0;0;0;0;0
FR;12;2022-06-16;0;0;0;0;0;0;0;0;0;0;0;0;0;0;0;0;0;0
FR;12;2022-06-17;0;0;0;0;0;0;0;0;0;0;0;0;0;0;0;0;0;0
FR;12;2022-06-18;0;0;0;0;0;0;0;0;0;0;0;0;0;0;0;0;0;0
FR;12;2022-06-19;0;0;0;0;0;0;0;0;0;0;0;0;0;0;0;0;0;0
FR;12;2022-06-20;0;0;0;0;0;0;0;0;0;0;0;0;0;0;0;0;0;0
FR;12;2022-06-21;0;0;0;0;0;0;0;0;0;0;0;0;0;0;0;0;0;0
FR;12;2022-06-22;0;0;0;0;0;0;0;0;0;0;0;0;0;0;0;0;0;0
FR;12;2022-06-23;0;0;0;0;0;0;0;0;0;0;0;0;0;0;0;0;0;0
FR;12;2022-06-24;0;0;0;0;0;0;0;0;0;0;0;0;0;0;0;0;0;0
FR;12;2022-06-25;0;0;0;0;0;0;0;0;0;0;0;0;0;0;0;0;0;0
FR;12;2022-06-26;0;0;0;0;0;0;0;0;0;0;0;0;0;0;0;0;0;0
FR;12;2022-06-27;0;0;0;0;0;0;0;0;0;0;0;0;0;0;0;0;0;0
FR;12;2022-06-28;0;0;0;0;0;0;0;0;0;0;0;0;0;0;0;0;0;0
FR;12;2022-06-29;0;0;0;0;0;0;0;0;0;0;0;0;0;0;0;0;0;0
FR;12;2022-06-30;0;0;0;0;0;0;0;0;0;0;0;0;0;0;0;0;0;0
FR;12;2022-07-01;0;0;0;0;0;0;0;0;0;0;0;0;0;0;0;0;0;0
FR;12;2022-07-02;0;0;0;0;0;0;0;0;0;0;0;0;0;0;0;0;0;0
FR;12;2022-07-03;0;0;0;0;0;0;0;0;0;0;0;0;0;0;0;0;0;0
FR;12;2022-07-04;0;0;0;0;0;0;0;0;0;0;0;0;0;0;0;0;0;0
FR;12;2022-07-05;0;0;0;0;0;0;0;0;0;0;0;0;0;0;0;0;0;0
FR;12;2022-07-06;0;0;0;0;0;0;0;0;0;0;0;0;0;0;0;0;0;0
FR;12;2022-07-07;0;0;0;0;0;0;0;0;0;0;0;0;0;0;0;0;0;0
FR;12;2022-07-08;0;0;0;0;0;0;0;0;0;0;0;0;0;0;0;0;0;0
FR;12;2022-07-09;0;0;0;0;0;0;0;0;0;0;0;0;0;0;0;0;0;0
FR;12;2022-07-10;0;0;0;0;0;0;0;0;0;0;0;0;0;0;0;0;0;0
FR;12;2022-07-11;0;0;0;0;0;0;0;0;0;0;0;0;0;0;0;0;0;0
FR;12;2022-07-12;0;0;0;0;0;0;0;0;0;0;0;0;0;0;0;0;0;0
FR;12;2022-07-13;0;0;0;0;0;0;0;0;0;0;0;0;0;0;0;0;0;0
FR;12;2022-07-14;0;0;0;0;0;0;0;0;0;0;0;0;0;0;0;0;0;0
FR;12;2022-07-15;0;0;0;0;0;0;0;0;0;0;0;0;0;0;0;0;0;0
FR;12;2022-07-16;0;0;0;0;0;0;0;0;0;0;0;0;0;0;0;0;0;0
FR;12;2022-07-17;0;0;0;0;0;0;0;0;0;0;0;0;0;0;0;0;0;0
FR;12;2022-07-18;0;0;0;0;0;0;0;0;0;0;0;0;0;0;0;0;0;0
FR;12;2022-07-19;0;0;0;0;0;0;0;0;0;0;0;0;0;0;0;0;0;0
FR;12;2022-07-20;0;0;0;0;0;0;0;0;0;0;0;0;0;0;0;0;0;0
FR;12;2022-07-21;0;0;0;0;0;0;0;0;0;0;0;0;0;0;0;0;0;0
FR;12;2022-07-22;0;0;0;0;0;0;0;0;0;0;0;0;0;0;0;0;0;0
FR;12;2022-07-23;0;0;0;0;0;0;0;0;0;0;0;0;0;0;0;0;0;0
FR;12;2022-07-24;0;0;0;0;0;0;0;0;0;0;0;0;0;0;0;0;0;0
FR;12;2022-07-25;0;0;0;0;0;0;0;0;0;0;0;0;0;0;0;0;0;0
FR;12;2022-07-26;0;0;0;0;0;0;0;0;0;0;0;0;0;0;0;0;0;0
FR;12;2022-07-27;0;0;0;0;0;0;0;0;0;0;0;0;0;0;0;0;0;0
FR;12;2022-07-28;0;0;0;0;0;0;0;0;0;0;0;0;0;0;0;0;0;0
FR;12;2022-07-29;0;0;0;0;0;0;0;0;0;0;0;0;0;0;0;0;0;0
FR;12;2022-07-30;0;0;0;0;0;0;0;0;0;0;0;0;0;0;0;0;0;0
FR;12;2022-07-31;0;0;0;0;0;0;0;0;0;0;0;0;0;0;0;0;0;0
FR;12;2022-08-01;0;0;0;0;0;0;0;0;0;0;0;0;0;0;0;0;0;0
FR;12;2022-08-02;0;0;0;0;0;0;0;0;0;0;0;0;0;0;0;0;0;0
FR;12;2022-08-03;0;0;0;0;0;0;0;0;0;0;0;0;0;0;0;0;0;0
FR;12;2022-08-04;0;0;0;0;0;0;0;0;0;0;0;0;0;0;0;0;0;0
FR;12;2022-08-05;0;0;0;0;0;0;0;0;0;0;0;0;0;0;0;0;0;0
FR;12;2022-08-06;0;0;0;0;0;0;0;0;0;0;0;0;0;0;0;0;0;0
FR;12;2022-08-07;0;0;0;0;0;0;0;0;0;0;0;0;0;0;0;0;0;0
FR;12;2022-08-08;0;0;0;0;0;0;0;0;0;0;0;0;0;0;0;0;0;0
FR;12;2022-08-09;0;0;0;0;0;0;0;0;0;0;0;0;0;0;0;0;0;0
FR;12;2022-08-10;0;0;0;0;0;0;0;0;0;0;0;0;0;0;0;0;0;0
FR;12;2022-08-11;0;0;0;0;0;0;0;0;0;0;0;0;0;0;0;0;0;0
FR;12;2022-08-12;0;0;0;0;0;0;0;0;0;0;0;0;0;0;0;0;0;0
FR;12;2022-08-13;0;0;0;0;0;0;0;0;0;0;0;0;0;0;0;0;0;0
FR;12;2022-08-14;0;0;0;0;0;0;0;0;0;0;0;0;0;0;0;0;0;0
FR;12;2022-08-15;0;0;0;0;0;0;0;0;0;0;0;0;0;0;0;0;0;0
FR;12;2022-08-16;0;0;0;0;0;0;0;0;0;0;0;0;0;0;0;0;0;0
FR;12;2022-08-17;0;0;0;0;0;0;0;0;0;0;0;0;0;0;0;0;0;0
FR;12;2022-08-18;0;0;0;0;0;0;0;0;0;0;0;0;0;0;0;0;0;0
FR;12;2022-08-19;0;0;0;0;0;0;0;0;0;0;0;0;0;0;0;0;0;0
FR;12;2022-08-20;0;0;0;0;0;0;0;0;0;0;0;0;0;0;0;0;0;0
FR;12;2022-08-21;0;0;0;0;0;0;0;0;0;0;0;0;0;0;0;0;0;0
FR;12;2022-08-22;0;0;0;0;0;0;0;0;0;0;0;0;0;0;0;0;0;0
FR;12;2022-08-23;0;0;0;0;0;0;0;0;0;0;0;0;0;0;0;0;0;0
FR;12;2022-08-24;0;0;0;0;0;0;0;0;0;0;0;0;0;0;0;0;0;0
FR;12;2022-08-25;0;0;0;0;0;0;0;0;0;0;0;0;0;0;0;0;0;0
FR;12;2022-08-26;0;0;0;0;0;0;0;0;0;0;0;0;0;0;0;0;0;0
FR;12;2022-08-27;0;0;0;0;0;0;0;0;0;0;0;0;0;0;0;0;0;0
FR;12;2022-08-28;0;0;0;0;0;0;0;0;0;0;0;0;0;0;0;0;0;0
FR;12;2022-08-29;0;0;0;0;0;0;0;0;0;0;0;0;0;0;0;0;0;0
FR;12;2022-08-30;0;0;0;0;0;0;0;0;0;0;0;0;0;0;0;0;0;0
FR;12;2022-08-31;0;0;0;0;0;0;0;0;0;0;0;0;0;0;0;0;0;0
FR;12;2022-09-01;0;0;0;0;0;0;0;0;0;0;0;0;0;0;0;0;0;0
FR;12;2022-09-02;0;0;0;0;0;0;0;0;0;0;0;0;0;0;0;0;0;0
FR;12;2022-09-03;0;0;0;0;0;0;0;0;0;0;0;0;0;0;0;0;0;0
FR;12;2022-09-04;0;0;0;0;0;0;0;0;0;0;0;0;0;0;0;0;0;0
FR;12;2022-09-05;0;0;0;0;0;0;0;0;0;0;0;0;0;0;0;0;0;0
FR;12;2022-09-06;0;0;0;0;0;0;0;0;0;0;0;0;0;0;0;0;0;0
FR;12;2022-09-07;0;0;0;0;0;0;0;0;0;0;0;0;0;0;0;0;0;0
FR;12;2022-09-08;0;0;0;0;0;0;0;0;0;0;0;0;0;0;0;0;0;0
FR;12;2022-09-09;0;0;0;0;0;0;0;0;0;0;0;0;0;0;0;0;0;0
FR;12;2022-09-10;0;0;0;0;0;0;0;0;0;0;0;0;0;0;0;0;0;0
FR;12;2022-09-11;0;0;0;0;0;0;0;0;0;0;0;0;0;0;0;0;0;0
FR;12;2022-09-12;0;0;0;0;0;0;0;0;0;0;0;0;0;0;0;0;0;0
FR;12;2022-09-13;0;0;0;0;0;0;0;0;0;0;0;0;0;0;0;0;0;0
FR;12;2022-09-14;0;0;0;0;0;0;0;0;0;0;0;0;0;0;0;0;0;0
FR;12;2022-09-15;0;0;0;0;0;0;0;0;0;0;0;0;0;0;0;0;0;0
FR;12;2022-09-16;0;0;0;0;0;0;0;0;0;0;0;0;0;0;0;0;0;0
FR;12;2022-09-17;0;0;0;0;0;0;0;0;0;0;0;0;0;0;0;0;0;0
FR;12;2022-09-18;0;0;0;0;0;0;0;0;0;0;0;0;0;0;0;0;0;0
FR;12;2022-09-19;0;0;0;0;0;0;0;0;0;0;0;0;0;0;0;0;0;0
FR;12;2022-09-20;0;0;0;0;0;0;0;0;0;0;0;0;0;0;0;0;0;0
FR;12;2022-09-21;0;0;0;0;0;0;0;0;0;0;0;0;0;0;0;0;0;0
FR;12;2022-09-22;0;0;0;0;0;0;0;0;0;0;0;0;0;0;0;0;0;0
FR;12;2022-09-23;0;0;0;0;0;0;0;0;0;0;0;0;0;0;0;0;0;0
FR;12;2022-09-24;0;0;0;0;0;0;0;0;0;0;0;0;0;0;0;0;0;0
FR;12;2022-09-25;0;0;0;0;0;0;0;0;0;0;0;0;0;0;0;0;0;0
FR;12;2022-09-26;0;0;0;0;0;0;0;0;0;0;0;0;0;0;0;0;0;0
FR;12;2022-09-27;0;0;0;0;0;0;0;0;0;0;0;0;0;0;0;0;0;0
FR;12;2022-09-28;0;0;0;0;0;0;0;0;0;0;0;0;0;0;0;0;0;0
FR;12;2022-09-29;0;0;0;0;0;0;0;0;0;0;0;0;0;0;0;0;0;0
FR;12;2022-09-30;0;0;0;0;0;0;0;0;0;0;0;0;0;0;0;0;0;0
FR;12;2022-10-01;0;0;0;0;0;0;0;0;0;0;0;0;0;0;0;0;0;0
FR;12;2022-10-02;0;0;0;0;0;0;0;0;0;0;0;0;0;0;0;0;0;0
FR;12;2022-10-03;0;0;0;0;0;0;0;0;0;0;0;0;0;0;0;0;0;0
FR;12;2022-10-04;0;0;0;0;0;0;0;0;0;0;0;0;0;0;0;0;0;0
FR;12;2022-10-05;0;0;0;0;0;0;0;0;0;0;0;0;0;0;0;0;0;0
FR;12;2022-10-06;0;0;0;0;0;0;0;0;0;0;0;0;0;0;0;0;0;0
FR;12;2022-10-07;0;0;0;0;0;0;0;0;0;0;0;0;0;0;0;0;0;0
FR;12;2022-10-08;0;0;0;0;0;0;0;0;0;0;0;0;0;0;0;0;0;0
FR;12;2022-10-09;0;0;0;0;0;0;0;0;0;0;0;0;0;0;0;0;0;0
FR;12;2022-10-10;0;0;0;0;0;0;0;0;0;0;0;0;0;0;0;0;0;0
FR;12;2022-10-11;0;0;0;0;0;0;0;0;0;0;0;0;0;0;0;0;0;0
FR;12;2022-10-12;0;0;0;0;0;0;0;0;0;0;0;0;0;0;0;0;0;0
FR;12;2022-10-13;0;0;0;0;0;0;0;0;0;0;0;0;0;0;0;0;0;0
FR;12;2022-10-14;0;0;0;0;0;0;0;0;0;0;0;0;0;0;0;0;0;0
FR;12;2022-10-15;0;0;0;0;0;0;0;0;0;0;0;0;0;0;0;0;0;0
FR;12;2022-10-16;0;0;0;0;0;0;0;0;0;0;0;0;0;0;0;0;0;0
FR;12;2022-10-17;0;0;0;0;0;0;0;0;0;0;0;0;0;0;0;0;0;0
FR;12;2022-10-18;0;0;0;0;0;0;0;0;0;0;0;0;0;0;0;0;0;0
FR;12;2022-10-19;0;0;0;0;0;0;0;0;0;0;0;0;0;0;0;0;0;0
FR;12;2022-10-20;0;0;0;0;0;0;0;0;0;0;0;0;0;0;0;0;0;0
FR;12;2022-10-21;0;0;0;0;0;0;0;0;0;0;0;0;0;0;0;0;0;0
FR;12;2022-10-22;0;0;0;0;0;0;0;0;0;0;0;0;0;0;0;0;0;0
FR;12;2022-10-23;0;0;0;0;0;0;0;0;0;0;0;0;0;0;0;0;0;0
FR;12;2022-10-24;0;0;0;0;0;0;0;0;0;0;0;0;0;0;0;0;0;0
FR;12;2022-10-25;0;0;0;0;0;0;0;0;0;0;0;0;0;0;0;0;0;0
FR;12;2022-10-26;0;0;0;0;0;0;0;0;0;0;0;0;0;0;0;0;0;0
FR;12;2022-10-27;0;0;0;0;0;0;0;0;0;0;0;0;0;0;0;0;0;0
FR;12;2022-10-28;0;0;0;0;0;0;0;0;0;0;0;0;0;0;0;0;0;0
FR;12;2022-10-29;0;0;0;0;0;0;0;0;0;0;0;0;0;0;0;0;0;0
FR;12;2022-10-30;0;0;0;0;0;0;0;0;0;0;0;0;0;0;0;0;0;0
FR;12;2022-10-31;0;0;0;0;0;0;0;0;0;0;0;0;0;0;0;0;0;0
FR;12;2022-11-01;0;0;0;0;0;0;0;0;0;0;0;0;0;0;0;0;0;0
FR;12;2022-11-02;0;0;0;0;0;0;0;0;0;0;0;0;0;0;0;0;0;0
FR;12;2022-11-03;0;0;0;0;0;0;0;0;0;0;0;0;0;0;0;0;0;0
FR;12;2022-11-04;0;0;0;0;0;0;0;0;0;0;0;0;0;0;0;0;0;0
FR;12;2022-11-05;0;0;0;0;0;0;0;0;0;0;0;0;0;0;0;0;0;0
FR;12;2022-11-06;0;0;0;0;0;0;0;0;0;0;0;0;0;0;0;0;0;0
FR;12;2022-11-07;0;0;0;0;0;0;0;0;0;0;0;0;0;0;0;0;0;0
FR;12;2022-11-08;0;0;0;0;0;0;0;0;0;0;0;0;0;0;0;0;0;0
FR;12;2022-11-09;0;0;0;0;0;0;0;0;0;0;0;0;0;0;0;0;0;0
FR;12;2022-11-10;0;0;0;0;0;0;0;0;0;0;0;0;0;0;0;0;0;0
FR;12;2022-11-11;0;0;0;0;0;0;0;0;0;0;0;0;0;0;0;0;0;0
FR;12;2022-11-12;0;0;0;0;0;0;0;0;0;0;0;0;0;0;0;0;0;0
FR;12;2022-11-13;0;0;0;0;0;0;0;0;0;0;0;0;0;0;0;0;0;0
FR;12;2022-11-14;0;0;0;0;0;0;0;0;0;0;0;0;0;0;0;0;0;0
FR;12;2022-11-15;0;0;0;0;0;0;0;0;0;0;0;0;0;0;0;0;0;0
FR;12;2022-11-16;0;0;0;0;0;0;0;0;0;0;0;0;0;0;0;0;0;0
FR;12;2022-11-17;0;0;0;0;0;0;0;0;0;0;0;0;0;0;0;0;0;0
FR;12;2022-11-18;0;0;0;0;0;0;0;0;0;0;0;0;0;0;0;0;0;0
FR;12;2022-11-19;0;0;0;0;0;0;0;0;0;0;0;0;0;0;0;0;0;0
FR;12;2022-11-20;0;0;0;0;0;0;0;0;0;0;0;0;0;0;0;0;0;0
FR;12;2022-11-21;0;0;0;0;0;0;0;0;0;0;0;0;0;0;0;0;0;0
FR;12;2022-11-22;0;0;0;0;0;0;0;0;0;0;0;0;0;0;0;0;0;0
FR;12;2022-11-23;0;0;0;0;0;0;0;0;0;0;0;0;0;0;0;0;0;0
FR;12;2022-11-24;0;0;0;0;0;0;0;0;0;0;0;0;0;0;0;0;0;0
FR;12;2022-11-25;0;0;0;0;0;0;0;0;0;0;0;0;0;0;0;0;0;0
FR;12;2022-11-26;0;0;0;0;0;0;0;0;0;0;0;0;0;0;0;0;0;0
FR;12;2022-11-27;0;0;0;0;0;0;0;0;0;0;0;0;0;0;0;0;0;0
FR;12;2022-11-28;0;0;0;0;0;0;0;0;0;0;0;0;0;0;0;0;0;0
FR;12;2022-11-29;0;0;0;0;0;0;0;0;0;0;0;0;0;0;0;0;0;0
FR;12;2022-11-30;0;0;0;0;0;0;0;0;0;0;0;0;0;0;0;0;0;0
FR;12;2022-12-01;0;0;0;0;0;0;0;0;0;0;0;0;0;0;0;0;0;0
FR;12;2022-12-02;0;0;0;0;0;0;0;0;0;0;0;0;0;0;0;0;0;0
FR;12;2022-12-03;0;0;0;0;0;0;0;0;0;0;0;0;0;0;0;0;0;0
FR;12;2022-12-04;0;0;0;0;0;0;0;0;0;0;0;0;0;0;0;0;0;0
FR;12;2022-12-05;0;0;0;0;0;0;0;0;0;0;0;0;0;0;0;0;0;0
FR;12;2022-12-06;0;0;0;0;0;0;0;0;0;0;0;0;0;0;0;0;0;0
FR;12;2022-12-07;0;0;0;0;0;0;0;0;0;0;0;0;0;0;0;0;0;0
FR;12;2022-12-08;0;0;0;0;0;0;0;0;0;0;0;0;0;0;0;0;0;0
FR;12;2022-12-09;0;0;0;0;0;0;0;0;0;0;0;0;0;0;0;0;0;0
FR;12;2022-12-10;0;0;0;0;0;0;0;0;0;0;0;0;0;0;0;0;0;0
FR;12;2022-12-11;0;0;0;0;0;0;0;0;0;0;0;0;0;0;0;0;0;0
FR;12;2022-12-12;0;0;0;0;0;0;0;0;0;0;0;0;0;0;0;0;0;0
FR;12;2022-12-13;0;0;0;0;0;0;0;0;0;0;0;0;0;0;0;0;0;0
FR;12;2022-12-14;0;0;0;0;0;0;0;0;0;0;0;0;0;0;0;0;0;0
FR;12;2022-12-15;0;0;0;0;0;0;0;0;0;0;0;0;0;0;0;0;0;0
FR;12;2022-12-16;0;0;0;0;0;0;0;0;0;0;0;0;0;0;0;0;0;0
FR;12;2022-12-17;0;0;0;0;0;0;0;0;0;0;0;0;0;0;0;0;0;0
FR;12;2022-12-18;0;0;0;0;0;0;0;0;0;0;0;0;0;0;0;0;0;0
FR;12;2022-12-19;0;0;0;0;0;0;0;0;0;0;0;0;0;0;0;0;0;0
FR;12;2022-12-20;0;0;0;0;0;0;0;0;0;0;0;0;0;0;0;0;0;0
FR;12;2022-12-21;0;0;0;0;0;0;0;0;0;0;0;0;0;0;0;0;0;0
FR;12;2022-12-22;0;0;0;0;0;0;0;0;0;0;0;0;0;0;0;0;0;0
FR;12;2022-12-23;0;0;0;0;0;0;0;0;0;0;0;0;0;0;0;0;0;0
FR;12;2022-12-24;0;0;0;0;0;0;0;0;0;0;0;0;0;0;0;0;0;0
FR;12;2022-12-25;0;0;0;0;0;0;0;0;0;0;0;0;0;0;0;0;0;0
FR;12;2022-12-26;0;0;0;0;0;0;0;0;0;0;0;0;0;0;0;0;0;0
FR;12;2022-12-27;0;0;0;0;0;0;0;0;0;0;0;0;0;0;0;0;0;0
FR;12;2022-12-28;0;0;0;0;0;0;0;0;0;0;0;0;0;0;0;0;0;0
FR;12;2022-12-29;0;0;0;0;0;0;0;0;0;0;0;0;0;0;0;0;0;0
FR;12;2022-12-30;0;0;0;0;0;0;0;0;0;0;0;0;0;0;0;0;0;0
FR;12;2022-12-31;0;0;0;0;0;0;0;0;0;0;0;0;0;0;0;0;0;0
FR;12;2023-01-01;0;0;0;0;0;0;0;0;0;0;0;0;0;0;0;0;0;0
FR;12;2023-01-02;0;0;0;0;0;0;0;0;0;0;0;0;0;0;0;0;0;0
FR;12;2023-01-03;0;0;0;0;0;0;0;0;0;0;0;0;0;0;0;0;0;0
FR;12;2023-01-04;0;0;0;0;0;0;0;0;0;0;0;0;0;0;0;0;0;0
FR;12;2023-01-05;0;0;0;0;0;0;0;0;0;0;0;0;0;0;0;0;0;0
FR;12;2023-01-06;0;0;0;0;0;0;0;0;0;0;0;0;0;0;0;0;0;0
FR;12;2023-01-07;0;0;0;0;0;0;0;0;0;0;0;0;0;0;0;0;0;0
FR;12;2023-01-08;0;0;0;0;0;0;0;0;0;0;0;0;0;0;0;0;0;0
FR;12;2023-01-09;0;0;0;0;0;0;0;0;0;0;0;0;0;0;0;0;0;0
FR;12;2023-01-10;0;0;0;0;0;0;0;0;0;0;0;0;0;0;0;0;0;0
FR;12;2023-01-11;0;0;0;0;0;0;0;0;0;0;0;0;0;0;0;0;0;0
FR;12;2023-01-12;0;0;0;0;0;0;0;0;0;0;0;0;0;0;0;0;0;0
FR;12;2023-01-13;0;0;0;0;0;0;0;0;0;0;0;0;0;0;0;0;0;0
FR;12;2023-01-14;0;0;0;0;0;0;0;0;0;0;0;0;0;0;0;0;0;0
FR;12;2023-01-15;0;0;0;0;0;0;0;0;0;0;0;0;0;0;0;0;0;0
FR;12;2023-01-16;0;0;0;0;0;0;0;0;0;0;0;0;0;0;0;0;0;0
FR;12;2023-01-17;0;0;0;0;0;0;0;0;0;0;0;0;0;0;0;0;0;0
FR;12;2023-01-18;0;0;0;0;0;0;0;0;0;0;0;0;0;0;0;0;0;0
FR;12;2023-01-19;0;0;0;0;0;0;0;0;0;0;0;0;0;0;0;0;0;0
FR;12;2023-01-20;0;0;0;0;0;0;0;0;0;0;0;0;0;0;0;0;0;0
FR;12;2023-01-21;0;0;0;0;0;0;0;0;0;0;0;0;0;0;0;0;0;0
FR;12;2023-01-22;0;0;0;0;0;0;0;0;0;0;0;0;0;0;0;0;0;0
FR;12;2023-01-23;0;0;0;0;0;0;0;0;0;0;0;0;0;0;0;0;0;0
FR;12;2023-01-24;0;0;0;0;0;0;0;0;0;0;0;0;0;0;0;0;0;0
FR;12;2023-01-25;0;0;0;0;0;0;0;0;0;0;0;0;0;0;0;0;0;0
FR;12;2023-01-26;0;0;0;0;0;0;0;0;0;0;0;0;0;0;0;0;0;0
FR;12;2023-01-27;0;0;0;0;0;0;0;0;0;0;0;0;0;0;0;0;0;0
FR;12;2023-01-28;0;0;0;0;0;0;0;0;0;0;0;0;0;0;0;0;0;0
FR;12;2023-01-29;0;0;0;0;0;0;0;0;0;0;0;0;0;0;0;0;0;0
FR;12;2023-01-30;0;0;0;0;0;0;0;0;0;0;0;0;0;0;0;0;0;0
FR;12;2023-01-31;0;0;0;0;0;0;0;0;0;0;0;0;0;0;0;0;0;0
FR;12;2023-02-01;0;0;0;0;0;0;0;0;0;0;0;0;0;0;0;0;0;0
FR;12;2023-02-02;0;0;0;1;0;0;0;2;2;0;0;0;1;0;0;0;2;2
FR;12;2023-02-03;0;1;6;57;0;4;58;141;77;0;1;6;58;0;4;58;143;79
FR;12;2023-02-04;1;3;6;51;1;5;52;110;52;1;4;12;109;1;9;110;253;131
FR;12;2023-02-05;0;0;0;0;0;0;0;1;1;1;4;12;109;1;9;110;254;132
FR;12;2023-02-06;3;2;13;63;0;11;69;154;69;4;6;25;172;1;20;179;408;201
FR;12;2023-02-07;2;7;18;95;4;13;98;237;121;6;13;43;267;5;33;277;645;322
FR;12;2023-02-08;1;3;10;62;1;10;69;170;89;7;16;53;329;6;43;346;815;411
FR;12;2023-02-09;5;3;12;75;2;13;78;284;190;12;19;65;404;8;56;424;1099;601
FR;12;2023-02-10;4;2;22;140;4;12;150;327;162;16;21;87;544;12;68;574;1426;763
FR;12;2023-02-11;0;2;8;59;1;3;58;123;60;16;23;95;603;13;71;632;1549;823
FR;12;2023-02-12;0;0;0;3;0;0;3;7;3;16;23;95;606;13;71;635;1556;826
FR;12;2023-02-13;0;0;17;78;0;8;85;217;114;16;23;112;684;13;79;720;1773;940
FR;12;2023-02-14;3;5;17;96;5;14;99;229;108;19;28;129;780;18;93;819;2002;1048
FR;12;2023-02-15;3;5;19;85;0;13;86;236;132;22;33;148;865;18;106;905;2238;1180
FR;12;2023-02-16;5;3;16;107;3;13;103;247;129;27;36;164;972;21;119;1008;2485;1309
FR;12;2023-02-17;2;4;12;115;3;11;110;280;153;29;40;176;1087;24;130;1118;2765;1462
FR;12;2023-02-18;1;4;10;51;2;12;52;102;36;30;44;186;1138;26;142;1170;2867;1498
FR;12;2023-02-19;0;0;0;2;0;0;1;2;1;30;44;186;1140;26;142;1171;2869;1499
FR;12;2023-02-20;10;2;11;65;6;11;69;219;132;40;46;197;1205;32;153;1240;3088;1631
FR;12;2023-02-21;6;6;19;98;4;14;94;280;167;46;52;216;1303;36;167;1334;3368;1798
FR;12;2023-02-22;2;4;19;74;2;20;78;231;125;48;56;235;1377;38;187;1412;3599;1923
FR;12;2023-02-23;4;3;20;88;2;16;87;265;155;52;59;255;1465;40;203;1499;3864;2078
FR;12;2023-02-24;3;7;20;135;3;17;142;360;189;55;66;275;1600;43;220;1641;4224;2267
FR;12;2023-02-25;7;1;19;92;1;10;106;200;77;62;67;294;1692;44;230;1747;4424;2344
FR;12;2023-02-26;0;0;0;0;0;0;0;2;2;62;67;294;1692;44;230;1747;4426;2346
FR;12;2023-02-27;6;10;20;92;8;16;95;270;156;68;77;314;1784;52;246;1842;4696;2502
FR;12;2023-02-28;6;9;21;125;0;23;128;385;227;74;86;335;1909;52;269;1970;5081;2729
FR;12;2023-03-01;3;7;23;78;2;18;91;292;175;77;93;358;1987;54;287;2061;5373;2904
FR;12;2023-03-02;9;9;21;110;6;18;117;304;163;86;102;379;2097;60;305;2178;5677;3067
FR;12;2023-03-03;10;8;45;142;7;39;148;418;220;96;110;424;2239;67;344;2326;6095;3287
FR;12;2023-03-04;3;2;12;55;0;10;53;119;49;99;112;436;2294;67;354;2379;6214;3336
FR;12;2023-03-05;0;1;1;2;1;1;2;8;5;99;113;437;2296;68;355;2381;6222;3341
FR;12;2023-03-06;4;5;27;74;2;20;82;268;157;103;118;464;2370;70;375;2463;6490;3498
FR;12;2023-03-07;6;10;29;130;9;24;132;356;191;109;128;493;2500;79;399;2595;6846;3689
FR;12;2023-03-08;4;7;27;71;5;22;77;249;137;113;135;520;2571;84;421;2672;7095;3826
FR;12;2023-03-09;4;8;18;91;4;22;85;323;197;117;143;538;2662;88;443;2757;7418;4023
FR;12;2023-03-10;11;7;23;137;9;23;133;368;209;128;150;561;2799;97;466;2890;7786;4232
FR;12;2023-03-11;1;4;15;45;4;9;50;132;72;129;154;576;2844;101;475;2940;7918;4304
FR;12;2023-03-12;0;2;0;2;0;2;1;5;2;129;156;576;2846;101;477;2941;7923;4306
FR;12;2023-03-13;3;4;32;102;1;28;104;297;158;132;160;608;2948;102;505;3045;8220;4464
FR;12;2023-03-14;3;7;16;85;2;15;83;322;210;135;167;624;3033;104;520;3128;8542;4674
FR;12;2023-03-15;1;4;20;66;2;19;69;225;124;136;171;644;3099;106;539;3197;8767;4798
FR;12;2023-03-16;5;5;20;100;5;13;116;300;157;141;176;664;3199;111;552;3313;9067;4955
FR;12;2023-03-17;4;11;30;112;4;28;113;388;224;145;187;694;3311;115;580;3426;9455;5179
FR;12;2023-03-18;1;4;21;53;4;17;59;144;64;146;191;715;3364;119;597;3485;9599;5243
FR;12;2023-03-19;0;0;0;6;0;0;5;10;5;146;191;715;3370;119;597;3490;9609;5248
FR;12;2023-03-20;9;8;27;87;7;23;90;258;134;155;199;742;3457;126;620;3580;9867;5382
FR;12;2023-03-21;2;7;42;81;3;36;93;355;209;157;206;784;3538;129;656;3673;10222;5591
FR;12;2023-03-22;6;4;36;50;5;29;58;241;139;163;210;820;3588;134;685;3731;10463;5730
FR;12;2023-03-23;3;8;26;80;5;25;82;264;147;166;218;846;3668;139;710;3813;10727;5877
FR;12;2023-03-24;6;2;25;99;3;22;109;347;203;172;220;871;3767;142;732;3922;11074;6080
FR;12;2023-03-25;7;8;25;61;3;14;75;162;62;179;228;896;3828;145;746;3997;11236;6142
FR;12;2023-03-26;0;1;0;1;1;0;1;7;6;179;229;896;3829;146;746;3998;11243;6148
FR;12;2023-03-27;5;10;28;77;7;23;85;283;159;184;239;924;3906;153;769;4083;11526;6307
FR;12;2023-03-28;2;5;29;95;2;25;91;344;207;186;244;953;4001;155;794;4174;11870;6514
FR;12;2023-03-29;4;8;18;52;5;20;56;201;105;190;252;971;4053;160;814;4230;12071;6619
FR;12;2023-03-30;9;2;27;65;4;19;81;281;168;199;254;998;4118;164;833;4311;12352;6787
FR;12;2023-03-31;4;14;41;120;4;39;126;424;233;203;268;1039;4238;168;872;4437;12776;7020
FR;12;2023-04-01;1;8;17;44;4;13;48;139;63;204;276;1056;4282;172;885;4485;12915;7083
FR;12;2023-04-02;0;2;1;0;0;3;0;6;3;204;278;1057;4282;172;888;4485;12921;7086
FR;12;2023-04-03;5;3;35;90;3;18;112;300;159;209;281;1092;4372;175;906;4597;13221;7245
FR;12;2023-04-04;4;7;22;85;0;26;87;383;247;213;288;1114;4457;175;932;4684;13604;7492
FR;12;2023-04-05;4;9;21;60;5;23;57;229;136;217;297;1135;4517;180;955;4741;13833;7628
FR;12;2023-04-06;10;8;25;57;3;23;67;280;164;227;305;1160;4574;183;978;4808;14113;7792
FR;12;2023-04-07;4;11;29;98;8;25;110;389;221;231;316;1189;4672;191;1003;4918;14502;8013
FR;12;2023-04-08;1;5;11;38;3;9;38;117;56;232;321;1200;4710;194;1012;4956;14619;8069
FR;12;2023-04-09;0;0;2;1;0;1;2;5;2;232;321;1202;4711;194;1013;4958;14624;8071
FR;12;2023-04-10;0;1;2;2;1;0;5;9;4;232;322;1204;4713;195;1013;4963;14633;8075
FR;12;2023-04-11;5;8;27;87;6;16;98;297;161;237;330;1231;4800;201;1029;5061;14930;8236
FR;12;2023-04-12;5;12;16;52;5;23;60;260;154;242;342;1247;4852;206;1052;5121;15190;8390
FR;12;2023-04-13;3;5;22;58;2;17;64;251;140;245;347;1269;4910;208;1069;5185;15441;8530
FR;12;2023-04-14;6;15;21;91;9;18;97;397;248;251;362;1290;5001;217;1087;5282;15838;8778
FR;12;2023-04-15;5;0;14;34;0;8;40;110;49;256;362;1304;5035;217;1095;5322;15948;8827
FR;12;2023-04-16;0;0;1;2;0;0;2;4;2;256;362;1305;5037;217;1095;5324;15952;8829
FR;12;2023-04-17;3;2;18;40;2;19;40;181;97;259;364;1323;5077;219;1114;5364;16133;8926
FR;12;2023-04-18;6;6;18;56;2;14;63;273;145;265;370;1341;5133;221;1128;5427;16406;9071
FR;12;2023-04-19;3;7;11;40;2;11;38;149;81;268;377;1352;5173;223;1139;5465;16555;9152
FR;12;2023-04-20;2;3;15;51;1;11;58;212;117;270;380;1367;5224;224;1150;5523;16767;9269
FR;12;2023-04-21;4;6;25;60;5;19;68;255;148;274;386;1392;5284;229;1169;5591;17022;9417
FR;12;2023-04-22;3;8;11;22;6;9;29;94;36;277;394;1403;5306;235;1178;5620;17116;9453
FR;12;2023-04-23;0;0;1;0;0;1;1;3;1;277;394;1404;5306;235;1179;5621;17119;9454
FR;12;2023-04-24;2;6;11;42;5;11;49;172;99;279;400;1415;5348;240;1190;5670;17291;9553
FR;12;2023-04-25;1;3;15;46;1;15;51;207;120;280;403;1430;5394;241;1205;5721;17498;9673
FR;12;2023-04-26;3;4;16;36;2;14;42;170;88;283;407;1446;5430;243;1219;5763;17668;9761
FR;12;2023-04-27;4;4;13;46;3;13;46;193;108;287;411;1459;5476;246;1232;5809;17861;9869
FR;12;2023-04-28;5;9;24;63;3;24;74;317;181;292;420;1483;5539;249;1256;5883;18178;10050
FR;12;2023-04-29;2;4;10;25;4;6;30;94;44;294;424;1493;5564;253;1262;5913;18272;10094
FR;12;2023-04-30;0;0;0;0;0;0;0;0;0;294;424;1493;5564;253;1262;5913;18272;10094
FR;12;2023-05-01;0;0;0;0;0;0;0;4;3;294;424;1493;5564;253;1262;5913;18276;10097
FR;12;2023-05-02;8;3;12;48;2;15;48;248;128;302;427;1505;5612;255;1277;5961;18524;10225
FR;12;2023-05-03;7;6;10;44;7;9;47;228;122;309;433;1515;5656;262;1286;6008;18752;10347
FR;12;2023-05-04;5;4;20;37;1;17;51;222;110;314;437;1535;5693;263;1303;6059;18974;10457
FR;12;2023-05-05;4;12;18;49;5;19;48;284;151;318;449;1553;5742;268;1322;6107;19258;10608
FR;12;2023-05-06;2;5;7;15;2;11;15;69;29;320;454;1560;5757;270;1333;6122;19327;10637
FR;12;2023-05-07;2;0;1;0;2;1;2;3;0;322;454;1561;5757;272;1334;6124;19330;10637
FR;12;2023-05-08;0;1;1;0;1;0;1;5;2;322;455;1562;5757;273;1334;6125;19335;10639
FR;12;2023-05-09;1;6;11;46;3;14;53;246;119;323;461;1573;5803;276;1348;6178;19581;10758
FR;12;2023-05-10;5;8;10;39;7;13;42;208;105;328;469;1583;5842;283;1361;6220;19789;10863
FR;12;2023-05-11;4;6;8;43;4;8;45;208;108;332;475;1591;5885;287;1369;6265;19997;10971
FR;12;2023-05-12;3;3;8;58;1;7;56;308;165;335;478;1599;5943;288;1376;6321;20305;11136
FR;12;2023-05-13;3;3;4;18;1;7;20;75;39;338;481;1603;5961;289;1383;6341;20380;11175
FR;12;2023-05-14;0;0;0;0;0;0;0;1;1;338;481;1603;5961;289;1383;6341;20381;11176
FR;12;2023-05-15;2;1;6;35;2;4;40;203;99;340;482;1609;5996;291;1387;6381;20584;11275
FR;12;2023-05-16;5;9;7;39;4;11;42;268;142;345;491;1616;6035;295;1398;6423;20852;11417
FR;12;2023-05-17;3;7;10;31;5;8;34;194;86;348;498;1626;6066;300;1406;6457;21046;11503
FR;12;2023-05-18;1;0;1;2;0;0;3;4;1;349;498;1627;6068;300;1406;6460;21050;11504
FR;12;2023-05-19;1;4;11;32;3;10;39;175;82;350;502;1638;6100;303;1416;6499;21225;11586
FR;12;2023-05-20;1;3;3;6;2;2;9;51;20;351;505;1641;6106;305;1418;6508;21276;11606
FR;12;2023-05-21;0;3;0;2;0;3;2;10;1;351;508;1641;6108;305;1421;6510;21286;11607
FR;12;2023-05-22;3;5;9;23;1;13;26;135;61;354;513;1650;6131;306;1434;6536;21421;11668
FR;12;2023-05-23;4;5;12;67;4;13;72;251;102;358;518;1662;6198;310;1447;6608;21672;11770
FR;12;2023-05-24;4;5;5;32;4;6;37;169;77;362;523;1667;6230;314;1453;6645;21841;11847
FR;12;2023-05-25;5;3;8;17;2;10;24;173;79;367;526;1675;6247;316;1463;6669;22014;11926
FR;12;2023-05-26;5;9;11;29;9;10;33;248;107;372;535;1686;6276;325;1473;6702;22262;12033
FR;12;2023-05-27;3;2;7;9;1;4;13;68;36;375;537;1693;6285;326;1477;6715;22330;12069
FR;12;2023-05-28;0;0;0;0;0;0;0;1;0;375;537;1693;6285;326;1477;6715;22331;12069
FR;12;2023-05-29;0;2;0;0;1;1;0;1;0;375;539;1693;6285;327;1478;6715;22332;12069
FR;12;2023-05-30;6;5;10;28;2;12;33;240;104;381;544;1703;6313;329;1490;6748;22572;12173
FR;12;2023-05-31;2;5;6;24;6;6;25;167;77;383;549;1709;6337;335;1496;6773;22739;12250
FR;12;2023-06-01;1;2;12;22;2;7;32;220;94;384;551;1721;6359;337;1503;6805;22959;12344
FR;12;2023-06-02;7;2;9;34;1;9;35;312;151;391;553;1730;6393;338;1512;6840;23271;12495
FR;12;2023-06-03;2;2;3;11;1;3;15;87;25;393;555;1733;6404;339;1515;6855;23358;12520
FR;12;2023-06-04;0;0;0;2;0;0;1;8;5;393;555;1733;6406;339;1515;6856;23366;12525
FR;12;2023-06-05;5;4;3;25;2;7;28;238;110;398;559;1736;6431;341;1522;6884;23604;12635
FR;12;2023-06-06;2;7;15;24;4;11;33;278;127;400;566;1751;6455;345;1533;6917;23882;12762
FR;12;2023-06-07;2;5;7;16;1;12;22;189;73;402;571;1758;6471;346;1545;6939;24071;12835
FR;12;2023-06-08;4;6;8;16;5;10;18;184;84;406;577;1766;6487;351;1555;6957;24255;12919
FR;12;2023-06-09;5;2;8;25;1;7;31;269;127;411;579;1774;6512;352;1562;6988;24524;13046
FR;12;2023-06-10;1;3;1;11;4;1;12;81;32;412;582;1775;6523;356;1563;7000;24605;13078
FR;12;2023-06-11;0;1;0;0;0;1;0;2;0;412;583;1775;6523;356;1564;7000;24607;13078
FR;12;2023-06-12;2;2;2;22;0;3;21;164;78;414;585;1777;6545;356;1567;7021;24771;13156
FR;0;2020-12-27;616;0;0;0;55;0;0;0;0;616;0;0;0;55;0;0;0;0
FR;0;2020-12-28;710;1;0;0;44;0;0;0;0;1326;1;0;0;99;0;0;0;0
FR;0;2020-12-29;389;0;0;0;19;0;0;0;0;1715;1;0;0;118;0;0;0;0
FR;0;2020-12-30;456;0;0;0;20;0;0;0;0;2171;1;0;0;138;0;0;0;0
FR;0;2020-12-31;451;1;0;0;21;0;0;0;0;2622;2;0;0;159;0;0;0;0
FR;0;2021-01-01;1199;2;0;0;66;0;0;0;0;3821;4;0;0;225;0;0;0;0
FR;0;2021-01-02;370;4;0;0;29;0;0;0;0;4191;8;0;0;254;0;0;0;0
FR;0;2021-01-03;419;0;0;0;23;0;0;0;0;4610;8;0;0;277;0;0;0;0
FR;0;2021-01-04;2152;5;0;0;51;0;0;0;0;6762;13;0;0;328;0;0;0;0
FR;0;2021-01-05;7794;6;0;0;128;0;0;0;0;14556;19;0;0;456;0;0;0;0
FR;0;2021-01-06;12491;23;0;0;128;0;0;0;0;27047;42;0;0;584;0;0;0;0
FR;0;2021-01-07;29480;24;0;0;159;0;0;0;0;56527;66;0;0;743;0;0;0;0
FR;0;2021-01-08;37170;36;0;0;205;0;0;0;0;93697;102;0;0;948;0;0;0;0
FR;0;2021-01-09;11221;9;0;0;77;0;0;0;0;104918;111;0;0;1025;0;0;0;0
FR;0;2021-01-10;6017;8;0;0;28;0;0;0;0;110935;119;0;0;1053;0;0;0;0
FR;0;2021-01-11;39956;39;0;0;232;0;0;0;0;150891;158;0;0;1285;0;0;0;0
FR;0;2021-01-12;62165;31;0;0;299;0;0;0;0;213056;189;0;0;1584;0;0;0;0
FR;0;2021-01-13;65150;62;0;0;433;0;0;0;0;278206;251;0;0;2017;0;0;0;0
FR;0;2021-01-14;83109;263;0;0;1171;0;0;0;0;361315;514;0;0;3188;0;0;0;0
FR;0;2021-01-15;69039;103;1;0;555;0;0;0;0;430354;617;1;0;3743;0;0;0;0
FR;0;2021-01-16;20219;73;0;0;183;0;0;0;0;450573;690;1;0;3926;0;0;0;0
FR;0;2021-01-17;10993;54;0;0;137;0;0;0;0;461566;744;1;0;4063;0;0;0;0
FR;0;2021-01-18;85924;179;0;0;614;0;0;0;0;547490;923;1;0;4677;0;0;0;0
FR;0;2021-01-19;130615;211;0;0;868;0;0;0;0;678105;1134;1;0;5545;0;0;0;0
FR;0;2021-01-20;137578;197;0;0;837;0;0;0;0;815683;1331;1;0;6382;0;0;0;0
FR;0;2021-01-21;158435;205;0;0;951;0;0;0;0;974118;1536;1;0;7333;0;0;0;0
FR;0;2021-01-22;121090;259;0;0;846;0;0;0;0;1095208;1795;1;0;8179;0;0;0;0
FR;0;2021-01-23;38494;86;0;0;223;0;0;0;0;1133702;1881;1;0;8402;0;0;0;0
FR;0;2021-01-24;9752;131;0;0;196;0;0;0;0;1143454;2012;1;0;8598;0;0;0;0
FR;0;2021-01-25;78257;1458;0;0;1808;0;0;0;0;1221711;3470;1;0;10406;0;0;0;0
FR;0;2021-01-26;100401;3712;1;0;4189;0;0;0;0;1322112;7182;2;0;14595;0;0;0;0
FR;0;2021-01-27;107266;6446;0;0;7162;0;0;0;0;1429378;13628;2;0;21757;0;0;0;0
FR;0;2021-01-28;124384;16427;0;0;17249;0;0;0;0;1553762;30055;2;0;39006;0;0;0;0
FR;0;2021-01-29;92204;18803;0;0;19380;0;0;0;0;1645966;48858;2;0;58386;0;0;0;0
FR;0;2021-01-30;29128;4541;0;0;4678;0;0;0;0;1675094;53399;2;0;63064;0;0;0;0
FR;0;2021-01-31;5241;1900;0;0;1945;0;0;0;0;1680335;55299;2;0;65009;0;0;0;0
FR;0;2021-02-01;53161;23062;0;0;23336;0;0;0;0;1733496;78361;2;0;88345;0;0;0;0
FR;0;2021-02-02;72337;38239;0;0;38731;0;0;0;0;1805833;116600;2;0;127076;0;0;0;0
FR;0;2021-02-03;72329;40304;0;0;40810;0;0;0;0;1878162;156904;2;0;167886;0;0;0;0
FR;0;2021-02-04;82100;55145;0;0;55740;0;0;0;0;1960262;212049;2;0;223626;0;0;0;0
FR;0;2021-02-05;68252;48256;0;0;48694;0;0;0;0;2028514;260305;2;0;272320;0;0;0;0
FR;0;2021-02-06;22949;11436;0;0;11674;0;0;0;0;2051463;271741;2;0;283994;0;0;0;0
FR;0;2021-02-07;5195;6080;0;0;6206;0;0;0;0;2056658;277821;2;0;290200;0;0;0;0
FR;0;2021-02-08;46857;48818;0;0;49307;0;0;0;0;2103515;326639;2;0;339507;0;0;0;0
FR;0;2021-02-09;66051;78479;0;0;79577;0;0;0;0;2169566;405118;2;0;419084;0;0;0;0
FR;0;2021-02-10;71049;83546;0;0;84845;0;0;0;0;2240615;488664;2;0;503929;0;0;0;0
FR;0;2021-02-11;87309;105733;0;0;107682;0;0;0;0;2327924;594397;2;0;611611;0;0;0;0
FR;0;2021-02-12;79358;76078;0;0;77825;0;0;0;0;2407282;670475;2;0;689436;0;0;0;0
FR;0;2021-02-13;22391;19532;0;0;19899;0;0;0;0;2429673;690007;2;0;709335;0;0;0;0
FR;0;2021-02-14;5080;7324;0;0;7452;0;0;0;0;2434753;697331;2;0;716787;0;0;0;0
FR;0;2021-02-15;38132;76800;0;0;77823;0;0;0;0;2472885;774131;2;0;794610;0;0;0;0
FR;0;2021-02-16;50420;99690;0;0;101044;0;0;0;0;2523305;873821;2;0;895654;0;0;0;0
FR;0;2021-02-17;50560;106934;20;0;108386;0;0;0;0;2573865;980755;22;0;1004040;0;0;0;0
FR;0;2021-02-18;69815;123787;0;0;125837;0;0;0;0;2643680;1104542;22;0;1129877;0;0;0;0
FR;0;2021-02-19;65093;92326;1;0;94216;0;0;0;0;2708773;1196868;23;0;1224093;0;0;0;0
FR;0;2021-02-20;18602;28547;0;0;28918;0;0;0;0;2727375;1225415;23;0;1253011;0;0;0;0
FR;0;2021-02-21;3335;6038;0;0;6143;0;0;0;0;2730710;1231453;23;0;1259154;0;0;0;0
FR;0;2021-02-22;37511;73174;2;0;74190;0;0;0;0;2768221;1304627;25;0;1333344;0;0;0;0
FR;0;2021-02-23;53803;85297;1;0;86821;0;0;0;0;2822024;1389924;26;0;1420165;0;0;0;0
FR;0;2021-02-24;60039;82937;1;0;84518;0;0;0;0;2882063;1472861;27;0;1504683;0;0;0;0
FR;0;2021-02-25;100613;91200;1;0;94200;0;0;0;0;2982676;1564061;28;0;1598883;0;0;0;0
FR;0;2021-02-26;113492;70747;1;0;73898;0;0;0;0;3096168;1634808;29;0;1672781;0;0;0;0
FR;0;2021-02-27;52131;22440;1;0;23686;0;0;0;0;3148299;1657248;30;0;1696467;0;0;0;0
FR;0;2021-02-28;6209;4109;2;0;4307;0;0;0;0;3154508;1661357;32;0;1700774;0;0;0;0
FR;0;2021-03-01;65946;54080;1;0;55953;0;0;0;0;3220454;1715437;33;0;1756727;0;0;0;0
FR;0;2021-03-02;101417;67182;3;0;70228;0;0;0;0;3321871;1782619;36;0;1826955;0;0;0;0
FR;0;2021-03-03;116567;65473;0;0;69167;0;0;0;0;3438438;1848092;36;0;1896122;0;0;0;0
FR;0;2021-03-04;163664;72640;3;0;78214;0;0;0;0;3602102;1920732;39;0;1974336;0;0;0;0
FR;0;2021-03-05;200962;62703;3;0;69437;0;0;0;0;3803064;1983435;42;0;2043773;0;0;0;0
FR;0;2021-03-06;207994;17479;3;0;22782;0;0;0;0;4011058;2000914;45;0;2066555;0;0;0;0
FR;0;2021-03-07;121293;3969;1;0;7264;0;0;0;0;4132351;2004883;46;0;2073819;0;0;0;0
FR;0;2021-03-08;107180;49548;2;0;53038;0;0;0;0;4239531;2054431;48;0;2126857;0;0;0;0
FR;0;2021-03-09;172489;56020;2;0;61521;0;0;0;0;4412020;2110451;50;0;2188378;0;0;0;0
FR;0;2021-03-10;179044;57057;5;0;62734;0;0;0;0;4591064;2167508;55;0;2251112;0;0;0;0
FR;0;2021-03-11;242934;64037;2;0;72134;0;0;0;0;4833998;2231545;57;0;2323246;0;0;0;0
FR;0;2021-03-12;294876;53376;1;0;62834;0;0;0;0;5128874;2284921;58;0;2386080;0;0;0;0
FR;0;2021-03-13;231445;15262;1;0;21241;0;0;0;0;5360319;2300183;59;0;2407321;0;0;0;0
FR;0;2021-03-14;63365;3032;1;0;5068;0;0;0;0;5423684;2303215;60;0;2412389;0;0;0;0
FR;0;2021-03-15;158700;31491;3;0;36147;0;0;0;0;5582384;2334706;63;0;2448536;0;0;0;0
FR;0;2021-03-16;141599;38812;6;0;42964;0;0;0;0;5723983;2373518;69;0;2491500;0;0;0;0
FR;0;2021-03-17;150519;37566;4;0;42335;0;0;0;0;5874502;2411084;73;0;2533835;0;0;0;0
FR;0;2021-03-18;167873;44323;5;0;49890;0;0;0;0;6042375;2455407;78;0;2583725;0;0;0;0
FR;0;2021-03-19;230056;36746;2;0;44107;0;0;0;0;6272431;2492153;80;0;2627832;0;0;0;0
FR;0;2021-03-20;166722;11384;1;0;16009;0;0;0;0;6439153;2503537;81;0;2643841;0;0;0;0
FR;0;2021-03-21;49959;2128;1;0;3887;0;0;0;0;6489112;2505665;82;0;2647728;0;0;0;0
FR;0;2021-03-22;170085;33534;2;0;39039;0;0;0;0;6659197;2539199;84;0;2686767;0;0;0;0
FR;0;2021-03-23;250442;42369;1;0;50216;0;0;0;0;6909639;2581568;85;0;2736983;0;0;0;0
FR;0;2021-03-24;256953;43601;0;0;51704;0;0;0;0;7166592;2625169;85;0;2788687;0;0;0;0
FR;0;2021-03-25;341875;45291;5;0;56292;0;0;0;0;7508467;2670460;90;0;2844979;0;0;0;0
FR;0;2021-03-26;358850;41803;5;1;53561;0;0;0;0;7867317;2712263;95;1;2898540;0;0;0;0
FR;0;2021-03-27;195297;16951;1;0;23395;0;0;0;0;8062614;2729214;96;1;2921935;0;0;0;0
FR;0;2021-03-28;59361;4586;3;0;6651;0;0;0;0;8121975;2733800;99;1;2928586;0;0;0;0
FR;0;2021-03-29;203028;53399;4;0;60164;0;0;0;0;8325003;2787199;103;1;2988750;0;0;0;0
FR;0;2021-03-30;285550;70044;5;0;80458;0;0;0;0;8610553;2857243;108;1;3069208;0;0;0;0
FR;0;2021-03-31;263083;74063;4;0;84735;0;0;0;0;8873636;2931306;112;1;3153943;0;0;0;0
FR;0;2021-04-01;315587;92821;11;0;106405;0;0;0;0;9189223;3024127;123;1;3260348;0;0;0;0
FR;0;2021-04-02;281385;94824;7;0;106658;0;0;0;0;9470608;3118951;130;1;3367006;0;0;0;0
FR;0;2021-04-03;141097;62619;6;0;67881;0;0;0;0;9611705;3181570;136;1;3434887;0;0;0;0
FR;0;2021-04-04;46552;19022;2;0;21076;0;0;0;0;9658257;3200592;138;1;3455963;0;0;0;0
FR;0;2021-04-05;63373;10402;11;0;13059;0;0;0;0;9721630;3210994;149;1;3469022;0;0;0;0
FR;0;2021-04-06;217276;113150;17;0;122021;0;0;0;0;9938906;3324144;166;1;3591043;0;0;0;0
FR;0;2021-04-07;260325;115283;17;0;126638;0;0;0;0;10199231;3439427;183;1;3717681;0;0;0;0
FR;0;2021-04-08;337917;123223;15;0;138856;0;0;0;0;10537148;3562650;198;1;3856537;0;0;0;0
FR;0;2021-04-09;410245;116883;50;0;134294;0;0;0;0;10947393;3679533;248;1;3990831;0;0;0;0
FR;0;2021-04-10;212666;82878;15;0;91272;0;0;0;0;11160059;3762411;263;1;4082103;0;0;0;0
FR;0;2021-04-11;56162;34179;7;0;36705;0;0;0;0;11216221;3796590;270;1;4118808;0;0;0;0
FR;0;2021-04-12;237130;115832;46;0;125444;0;0;0;0;11453351;3912422;316;1;4244252;0;0;0;0
FR;0;2021-04-13;309558;144150;98;1;157113;0;0;0;0;11762909;4056572;414;2;4401365;0;0;0;0
FR;0;2021-04-14;294609;139861;215;0;153241;0;0;0;0;12057518;4196433;629;2;4554606;0;0;0;0
FR;0;2021-04-15;337206;150549;340;0;166092;0;0;0;0;12394724;4346982;969;2;4720698;0;0;0;0
FR;0;2021-04-16;339363;147042;354;0;161701;0;0;0;0;12734087;4494024;1323;2;4882399;0;0;0;0
FR;0;2021-04-17;188689;89985;109;0;97685;0;0;0;0;12922776;4584009;1432;2;4980084;0;0;0;0
FR;0;2021-04-18;51645;35461;48;0;37883;0;0;0;0;12974421;4619470;1480;2;5017967;0;0;0;0
FR;0;2021-04-19;205751;138300;457;0;147460;0;0;0;0;13180172;4757770;1937;2;5165427;0;0;0;0
FR;0;2021-04-20;254496;172047;569;0;183708;0;0;0;0;13434668;4929817;2506;2;5349135;0;0;0;0
FR;0;2021-04-21;253346;170238;837;0;182261;0;0;0;0;13688014;5100055;3343;2;5531396;0;0;0;0
FR;0;2021-04-22;287635;190457;820;0;205053;0;0;0;0;13975649;5290512;4163;2;5736449;0;0;0;0
FR;0;2021-04-23;297686;184746;747;0;203508;0;0;0;0;14273335;5475258;4910;2;5939957;0;0;0;0
FR;0;2021-04-24;190483;112059;252;0;122514;0;0;0;0;14463818;5587317;5162;2;6062471;0;0;0;0
FR;0;2021-04-25;69578;38865;51;0;42596;0;0;0;0;14533396;5626182;5213;2;6105067;0;0;0;0
FR;0;2021-04-26;221007;158711;564;0;171912;0;0;0;0;14754403;5784893;5777;2;6276979;0;0;0;0
FR;0;2021-04-27;284658;188077;941;0;211392;0;0;0;0;15039061;5972970;6718;2;6488371;0;0;0;0
FR;0;2021-04-28;299598;184733;1427;1;209813;1;0;0;0;15338659;6157703;8145;3;6698184;1;0;0;0
FR;0;2021-04-29;357220;198331;1281;0;233417;0;0;0;0;15695879;6356034;9426;3;6931601;1;0;0;0
FR;0;2021-04-30;372271;186154;1124;1;225493;0;0;0;0;16068150;6542188;10550;4;7157094;1;0;0;0
FR;0;2021-05-01;167680;52538;179;0;63784;0;0;0;0;16235830;6594726;10729;4;7220878;1;0;0;0
FR;0;2021-05-02;91771;37869;83;0;43598;0;0;0;0;16327601;6632595;10812;4;7264476;1;0;0;0
FR;0;2021-05-03;288988;165108;843;0;185633;0;0;0;0;16616589;6797703;11655;4;7450109;1;0;0;0
FR;0;2021-05-04;315761;225643;1237;0;251817;0;0;0;0;16932350;7023346;12892;4;7701926;1;0;0;0
FR;0;2021-05-05;327323;226691;1316;0;251771;0;0;0;0;17259673;7250037;14208;4;7953697;1;0;0;0
FR;0;2021-05-06;379657;241297;1634;0;275545;0;0;0;0;17639330;7491334;15842;4;8229242;1;0;0;0
FR;0;2021-05-07;372837;258920;1225;0;299976;0;0;0;0;18012167;7750254;17067;4;8529218;1;0;0;0
FR;0;2021-05-08;222192;71528;300;0;86737;0;0;0;0;18234359;7821782;17367;4;8615955;1;0;0;0
FR;0;2021-05-09;129735;44488;243;0;53126;0;0;0;0;18364094;7866270;17610;4;8669081;1;0;0;0
FR;0;2021-05-10;313436;229742;1239;0;255523;0;0;0;0;18677530;8096012;18849;4;8924604;1;0;0;0
FR;0;2021-05-11;403987;258456;1566;0;296885;0;0;0;0;19081517;8354468;20415;4;9221489;1;0;0;0
FR;0;2021-05-12;434232;233895;1545;0;270183;0;0;0;0;19515749;8588363;21960;4;9491672;1;0;0;0
FR;0;2021-05-13;338644;56436;432;0;77928;0;0;0;0;19854393;8644799;22392;4;9569600;1;0;0;0
FR;0;2021-05-14;454194;167503;1130;0;203114;0;0;0;0;20308587;8812302;23522;4;9772714;1;0;0;0
FR;0;2021-05-15;375022;94403;445;0;120802;0;0;0;0;20683609;8906705;23967;4;9893516;1;0;0;0
FR;0;2021-05-16;202779;20694;168;0;34095;0;0;0;0;20886388;8927399;24135;4;9927611;1;0;0;0
FR;0;2021-05-17;376170;148883;1555;0;178673;0;0;0;0;21262558;9076282;25690;4;10106284;1;0;0;0
FR;0;2021-05-18;460232;154150;1991;0;193304;0;0;0;0;21722790;9230432;27681;4;10299588;1;0;0;0
FR;0;2021-05-19;467483;142581;2466;0;179844;0;0;0;0;22190273;9373013;30147;4;10479432;1;0;0;0
FR;0;2021-05-20;507610;160259;2340;0;204214;0;0;0;0;22697883;9533272;32487;4;10683646;1;0;0;0
FR;0;2021-05-21;489737;175274;1997;0;221820;0;0;0;0;23187620;9708546;34484;4;10905466;1;0;0;0
FR;0;2021-05-22;347231;80251;670;0;108682;0;0;0;0;23534851;9788797;35154;4;11014148;1;0;0;0
FR;0;2021-05-23;161720;14211;246;0;26680;0;0;0;0;23696571;9803008;35400;4;11040828;1;0;0;0
FR;0;2021-05-24;263223;33111;604;0;52946;0;0;0;0;23959794;9836119;36004;4;11093774;1;0;0;0
FR;0;2021-05-25;400322;190464;2357;1;227031;0;0;0;0;24360116;10026583;38361;5;11320805;1;0;0;0
FR;0;2021-05-26;413524;191300;2227;0;229351;0;0;0;0;24773640;10217883;40588;5;11550156;1;0;0;0
FR;0;2021-05-27;449888;220135;2163;0;267274;0;0;0;0;25223528;10438018;42751;5;11817430;1;0;0;0
FR;0;2021-05-28;429618;261174;1895;0;319274;0;0;0;0;25653146;10699192;44646;5;12136704;1;0;0;0
FR;0;2021-05-29;299011;150536;586;0;183389;0;0;0;0;25952157;10849728;45232;5;12320093;1;0;0;0
FR;0;2021-05-30;107156;32505;164;0;42088;0;0;0;0;26059313;10882233;45396;5;12362181;1;0;0;0
FR;0;2021-05-31;358084;203494;1474;1;241776;1;0;0;0;26417397;11085727;46870;6;12603957;2;0;0;0
FR;0;2021-06-01;431164;251295;1969;1;302940;1;0;0;0;26848561;11337022;48839;7;12906897;3;0;0;0
FR;0;2021-06-02;420194;232819;1986;0;280207;0;0;0;0;27268755;11569841;50825;7;13187104;3;0;0;0
FR;0;2021-06-03;465723;257780;1826;0;312555;0;0;0;0;27734478;11827621;52651;7;13499659;3;0;0;0
FR;0;2021-06-04;456312;305908;1735;1;363320;1;0;0;0;28190790;12133529;54386;8;13862979;4;0;0;0
FR;0;2021-06-05;304841;189571;653;0;222794;0;0;0;0;28495631;12323100;55039;8;14085773;4;0;0;0
FR;0;2021-06-06;133344;49020;227;0;61159;0;0;0;0;28628975;12372120;55266;8;14146932;4;0;0;0
FR;0;2021-06-07;340027;261517;1529;0;298609;0;0;0;0;28969002;12633637;56795;8;14445541;4;0;0;0
FR;0;2021-06-08;393974;291419;1806;0;338285;0;0;0;0;29362976;12925056;58601;8;14783826;4;0;0;0
FR;0;2021-06-09;384976;273771;1734;0;318166;0;0;0;0;29747952;13198827;60335;8;15101992;4;0;0;0
FR;0;2021-06-10;404262;286271;1728;1;335722;0;0;0;0;30152214;13485098;62063;9;15437714;4;0;0;0
FR;0;2021-06-11;386737;356531;1468;1;406978;0;0;0;0;30538951;13841629;63531;10;15844692;4;0;0;0
FR;0;2021-06-12;283300;210996;497;0;243140;0;0;0;0;30822251;14052625;64028;10;16087832;4;0;0;0
FR;0;2021-06-13;104907;73842;204;0;84835;0;0;0;0;30927158;14126467;64232;10;16172667;4;0;0;0
FR;0;2021-06-14;240892;354029;1429;1;383225;0;0;0;0;31168050;14480496;65661;11;16555892;4;0;0;0
FR;0;2021-06-15;308239;384325;1574;1;423100;0;0;0;0;31476289;14864821;67235;12;16978992;4;0;0;0
FR;0;2021-06-16;314028;357603;1419;1;395369;0;0;0;0;31790317;15222424;68654;13;17374361;4;0;0;0
FR;0;2021-06-17;317743;373167;1432;1;414366;0;0;0;0;32108060;15595591;70086;14;17788727;4;0;0;0
FR;0;2021-06-18;321786;442590;1342;2;485998;0;0;0;0;32429846;16038181;71428;16;18274725;4;0;0;0
FR;0;2021-06-19;224368;274028;449;0;301221;0;0;0;0;32654214;16312209;71877;16;18575946;4;0;0;0
FR;0;2021-06-20;74459;102286;131;0;111479;0;0;0;0;32728673;16414495;72008;16;18687425;4;0;0;0
FR;0;2021-06-21;195820;401759;1038;1;427725;1;0;0;0;32924493;16816254;73046;17;19115150;5;0;0;0
FR;0;2021-06-22;223247;467826;1266;10;500500;1;0;0;0;33147740;17284080;74312;27;19615650;6;0;0;0
FR;0;2021-06-23;234087;440149;1198;1;474260;1;0;0;0;33381827;17724229;75510;28;20089910;7;0;0;0
FR;0;2021-06-24;241909;409772;1359;0;447265;0;0;0;0;33623736;18134001;76869;28;20537175;7;0;0;0
FR;0;2021-06-25;227678;523085;1404;0;562086;0;0;0;0;33851414;18657086;78273;28;21099261;7;0;0;0
FR;0;2021-06-26;153296;371100;589;1;395907;0;0;0;0;34004710;19028186;78862;29;21495168;7;0;0;0
FR;0;2021-06-27;55925;155943;169;1;164853;0;0;0;0;34060635;19184129;79031;30;21660021;7;0;0;0
FR;0;2021-06-28;154813;452529;1178;0;478128;0;0;0;0;34215448;19636658;80209;30;22138149;7;0;0;0
FR;0;2021-06-29;182753;507867;2124;0;539236;0;0;0;0;34398201;20144525;82333;30;22677385;7;0;0;0
FR;0;2021-06-30;204047;485260;2016;21;519524;2;0;0;0;34602248;20629785;84349;51;23196909;9;0;0;0
FR;0;2021-07-01;231467;458576;2226;5;498514;0;0;0;0;34833715;21088361;86575;56;23695423;9;0;0;0
FR;0;2021-07-02;228707;520028;2120;5;562336;2;0;0;0;35062422;21608389;88695;61;24257759;11;0;0;0
FR;0;2021-07-03;142058;368760;908;3;395248;1;0;0;0;35204480;21977149;89603;64;24653007;12;0;0;0
FR;0;2021-07-04;56765;141008;265;0;150698;0;0;0;0;35261245;22118157;89868;64;24803705;12;0;0;0
FR;0;2021-07-05;168554;418643;1668;8;448585;0;0;0;0;35429799;22536800;91536;72;25252290;12;0;0;0
FR;0;2021-07-06;196812;474522;1830;45;511112;8;0;0;0;35626611;23011322;93366;117;25763402;20;0;0;0
FR;0;2021-07-07;213258;438969;1881;25;477429;2;0;0;0;35839869;23450291;95247;142;26240831;22;0;0;0
FR;0;2021-07-08;231680;424141;2090;20;468070;2;0;0;0;36071549;23874432;97337;162;26708901;24;0;0;0
FR;0;2021-07-09;228644;511068;2185;4;557353;1;0;0;0;36300193;24385500;99522;166;27266254;25;0;0;0
FR;0;2021-07-10;148640;339926;986;1;368867;0;0;0;0;36448833;24725426;100508;167;27635121;25;0;0;0
FR;0;2021-07-11;60217;110049;284;0;120958;0;0;0;0;36509050;24835475;100792;167;27756079;25;0;0;0
FR;0;2021-07-12;169444;477698;1766;4;512424;0;0;0;0;36678494;25313173;102558;171;28268503;25;0;0;0
FR;0;2021-07-13;287312;526600;2050;8;585619;0;0;0;0;36965806;25839773;104608;179;28854122;25;0;0;0
FR;0;2021-07-14;181123;157330;435;0;186638;0;0;0;0;37146929;25997103;105043;179;29040760;25;0;0;0
FR;0;2021-07-15;347131;501596;2100;1;571555;0;0;0;0;37494060;26498699;107143;180;29612315;25;0;0;0
FR;0;2021-07-16;380125;494960;2023;3;574128;1;0;0;0;37874185;26993659;109166;183;30186443;26;0;0;0
FR;0;2021-07-17;259757;319632;877;1;368588;0;0;0;0;38133942;27313291;110043;184;30555031;26;0;0;0
FR;0;2021-07-18;109747;114565;310;0;133002;0;0;0;0;38243689;27427856;110353;184;30688033;26;0;0;0
FR;0;2021-07-19;285528;423871;1631;3;478874;0;0;0;0;38529217;27851727;111984;187;31166907;26;0;0;0
FR;0;2021-07-20;376945;451203;1725;0;523533;0;0;0;0;38906162;28302930;113709;187;31690440;26;0;0;0
FR;0;2021-07-21;395847;406822;1550;4;481803;1;0;0;0;39302009;28709752;115259;191;32172243;27;0;0;0
FR;0;2021-07-22;441092;387300;1715;4;471767;1;0;0;0;39743101;29097052;116974;195;32644010;28;0;0;0
FR;0;2021-07-23;440353;421956;1883;4;509913;1;0;0;0;40183454;29519008;118857;199;33153923;29;0;0;0
FR;0;2021-07-24;285264;269308;804;1;321988;0;0;0;0;40468718;29788316;119661;200;33475911;29;0;0;0
FR;0;2021-07-25;121130;79919;234;0;100272;0;0;0;0;40589848;29868235;119895;200;33576183;29;0;0;0
FR;0;2021-07-26;347454;322126;1614;3;384679;1;0;0;0;40937302;30190361;121509;203;33960862;30;0;0;0
FR;0;2021-07-27;464124;319259;1699;4;400407;1;0;0;0;41401426;30509620;123208;207;34361269;31;0;0;0
FR;0;2021-07-28;459483;289370;1637;4;366980;1;0;0;0;41860909;30798990;124845;211;34728249;32;0;0;0
FR;0;2021-07-29;489868;276100;1797;2;356968;0;0;0;0;42350777;31075090;126642;213;35085217;32;0;0;0
FR;0;2021-07-30;461863;302329;1942;5;380808;1;0;0;0;42812640;31377419;128584;218;35466025;33;0;0;0
FR;0;2021-07-31;285426;185023;916;1;231508;0;0;0;0;43098066;31562442;129500;219;35697533;33;0;0;0
FR;0;2021-08-01;112056;49908;257;0;65685;0;0;0;0;43210122;31612350;129757;219;35763218;33;0;0;0
FR;0;2021-08-02;341681;234025;1603;2;284713;0;0;0;0;43551803;31846375;131360;221;36047931;33;0;0;0
FR;0;2021-08-03;398648;244429;1729;2;304497;1;0;0;0;43950451;32090804;133089;223;36352428;34;0;0;0
FR;0;2021-08-04;384887;209510;1594;6;265630;3;0;0;0;44335338;32300314;134683;229;36618058;37;0;0;0
FR;0;2021-08-05;366205;228338;1711;0;281711;0;0;0;0;44701543;32528652;136394;229;36899769;37;0;0;0
FR;0;2021-08-06;359762;271207;1835;4;326583;0;0;0;0;45061305;32799859;138229;233;37226352;37;0;0;0
FR;0;2021-08-07;213152;178315;756;5;210040;1;0;0;0;45274457;32978174;138985;238;37436392;38;0;0;0
FR;0;2021-08-08;74213;63190;276;0;73623;0;0;0;0;45348670;33041364;139261;238;37510015;38;0;0;0
FR;0;2021-08-09;258779;258571;1549;4;297481;2;0;0;0;45607449;33299935;140810;242;37807496;40;0;0;0
FR;0;2021-08-10;306900;277040;1662;2;323423;0;0;0;0;45914349;33576975;142472;244;38130919;40;0;0;0
FR;0;2021-08-11;279770;259535;1442;5;301603;0;0;0;0;46194119;33836510;143914;249;38432522;40;0;0;0
FR;0;2021-08-12;271575;277997;1669;3;320250;0;0;0;0;46465694;34114507;145583;252;38752772;40;0;0;0
FR;0;2021-08-13;252181;278120;1595;3;316952;2;0;0;0;46717875;34392627;147178;255;39069724;42;0;0;0
FR;0;2021-08-14;145366;197058;740;0;218979;0;0;0;0;46863241;34589685;147918;255;39288703;42;0;0;0
FR;0;2021-08-15;39403;50088;218;1;55668;0;0;0;0;46902644;34639773;148136;256;39344371;42;0;0;0
FR;0;2021-08-16;186198;317464;1543;0;345382;0;0;0;0;47088842;34957237;149679;256;39689753;42;0;0;0
FR;0;2021-08-17;215721;335791;1638;7;368823;0;0;0;0;47304563;35293028;151317;263;40058576;42;0;0;0
FR;0;2021-08-18;199083;324369;1599;7;354530;3;0;0;0;47503646;35617397;152916;270;40413106;45;0;0;0
FR;0;2021-08-19;192053;325392;1642;1;355948;0;0;0;0;47695699;35942789;154558;271;40769054;45;0;0;0
FR;0;2021-08-20;186495;366174;1823;3;396600;2;0;0;0;47882194;36308963;156381;274;41165654;47;0;0;0
FR;0;2021-08-21;104815;238131;709;0;254561;0;0;0;0;47987009;36547094;157090;274;41420215;47;0;0;0
FR;0;2021-08-22;31950;87209;256;1;92161;1;0;0;0;48018959;36634303;157346;275;41512376;48;0;0;0
FR;0;2021-08-23;141003;356996;1561;3;379585;0;0;0;0;48159962;36991299;158907;278;41891961;48;0;0;0
FR;0;2021-08-24;162524;376573;1850;5;402819;0;0;0;0;48322486;37367872;160757;283;42294780;48;0;0;0
FR;0;2021-08-25;151165;350711;2038;8;375397;2;0;0;0;48473651;37718583;162795;291;42670177;50;0;0;0
FR;0;2021-08-26;142899;342773;2564;10;367562;0;0;0;0;48616550;38061356;165359;301;43037739;50;0;0;0
FR;0;2021-08-27;148457;388233;2791;11;414866;1;0;0;0;48765007;38449589;168150;312;43452605;51;0;0;0
FR;0;2021-08-28;90682;249640;1407;0;264964;0;0;0;0;48855689;38699229;169557;312;43717569;51;0;0;0
FR;0;2021-08-29;27325;83357;518;1;88273;0;0;0;0;48883014;38782586;170075;313;43805842;51;0;0;0
FR;0;2021-08-30;117432;324581;4714;6;342386;5848;0;0;0;49000446;39107167;174789;319;44148228;5899;0;0;0
FR;0;2021-08-31;128834;334449;10189;19;353926;11767;2;0;0;49129280;39441616;184978;338;44502154;17666;2;0;0
FR;0;2021-09-01;136168;285662;22437;8;302401;24415;1;0;0;49265448;39727278;207415;346;44804555;42081;3;0;0
FR;0;2021-09-02;114653;247198;26525;20;262096;29009;0;0;0;49380101;39974476;233940;366;45066651;71090;3;0;0
FR;0;2021-09-03;118330;292648;29968;24;309305;33076;1;0;0;49498431;40267124;263908;390;45375956;104166;4;0;0
FR;0;2021-09-04;89894;217797;12587;12;230490;14157;7;0;0;49588325;40484921;276495;402;45606446;118323;11;0;0
FR;0;2021-09-05;21365;44794;4397;2;48279;4714;0;0;0;49609690;40529715;280892;404;45654725;123037;11;0;0
FR;0;2021-09-06;75701;180486;31957;16;190661;34306;2;0;0;49685391;40710201;312849;420;45845386;157343;13;0;0
FR;0;2021-09-07;80317;181181;33251;43;191039;36322;2;0;0;49765708;40891382;346100;463;46036425;193665;15;0;0
FR;0;2021-09-08;91014;206087;29666;28;216567;32572;4;0;0;49856722;41097469;375766;491;46252992;226237;19;0;0
FR;0;2021-09-09;76984;165313;33085;27;174116;36699;5;0;0;49933706;41262782;408851;518;46427108;262936;24;0;0
FR;0;2021-09-10;96051;203817;35743;28;214895;40788;7;0;0;50029757;41466599;444594;546;46642003;303724;31;0;0
FR;0;2021-09-11;67169;169343;12140;19;178186;14414;0;0;0;50096926;41635942;456734;565;46820189;318138;31;0;0
FR;0;2021-09-12;12830;32092;2784;1;34138;3190;2;0;0;50109756;41668034;459518;566;46854327;321328;33;0;0
FR;0;2021-09-13;64582;126154;41249;35;134170;44268;17;0;0;50174338;41794188;500767;601;46988497;365596;50;0;0
FR;0;2021-09-14;73504;129008;56393;80;135747;62449;44;0;0;50247842;41923196;557160;681;47124244;428045;94;0;0
FR;0;2021-09-15;76668;167733;55671;58;174675;54852;76;0;0;50324510;42090929;612831;739;47298919;482897;170;0;0
FR;0;2021-09-16;63898;114503;60099;82;117879;60174;64;0;0;50388408;42205432;672930;821;47416798;543071;234;0;0
FR;0;2021-09-17;75093;156855;53871;71;159731;57367;67;0;0;50463501;42362287;726801;892;47576529;600438;301;0;0
FR;0;2021-09-18;48244;139637;15603;25;144317;17321;20;0;0;50511745;42501924;742404;917;47720846;617759;321;0;0
FR;0;2021-09-19;7908;23646;2443;1;24876;2619;1;0;0;50519653;42525570;744847;918;47745722;620378;322;0;0
FR;0;2021-09-20;44580;93753;50086;72;96243;50346;34;0;0;50564233;42619323;794933;990;47841965;670724;356;0;0
FR;0;2021-09-21;45918;98366;62772;77;98383;63506;79;0;0;50610151;42717689;857705;1067;47940348;734230;435;0;0
FR;0;2021-09-22;48710;142400;55384;82;144845;55484;47;0;0;50658861;42860089;913089;1149;48085193;789714;482;0;0
FR;0;2021-09-23;43298;92069;62408;95;91276;63589;86;0;0;50702159;42952158;975497;1244;48176469;853303;568;0;0
FR;0;2021-09-24;52324;133292;54570;107;132389;59232;78;0;0;50754483;43085450;1030067;1351;48308858;912535;646;0;0
FR;0;2021-09-25;35225;115666;16277;36;118647;18318;22;0;0;50789708;43201116;1046344;1387;48427505;930853;668;0;0
FR;0;2021-09-26;5561;17803;2273;5;18690;2331;5;0;0;50795269;43218919;1048617;1392;48446195;933184;673;0;0
FR;0;2021-09-27;33986;76900;47221;97;78786;48207;80;0;1;50829255;43295819;1095838;1489;48524981;981391;753;0;1
FR;0;2021-09-28;36524;75244;54983;90;74325;56599;47;0;0;50865779;43371063;1150821;1579;48599306;1037990;800;0;1
FR;0;2021-09-29;44426;100688;53375;113;102847;54911;41;0;0;50910205;43471751;1204196;1692;48702153;1092901;841;0;1
FR;0;2021-09-30;36349;72980;57047;96;71482;59612;58;0;0;50946554;43544731;1261243;1788;48773635;1152513;899;0;1
FR;0;2021-10-01;61719;102864;57836;108;101414;64019;23;0;0;51008273;43647595;1319079;1896;48875049;1216532;922;0;1
FR;0;2021-10-02;39473;78459;20965;39;81736;23386;12;0;0;51047746;43726054;1340044;1935;48956785;1239918;934;0;1
FR;0;2021-10-03;5289;10491;2536;4;11257;2542;4;0;0;51053035;43736545;1342580;1939;48968042;1242460;938;0;1
FR;0;2021-10-04;35208;58502;52638;84;59501;54860;37;0;0;51088243;43795047;1395218;2023;49027543;1297320;975;0;1
FR;0;2021-10-05;33937;64380;61032;135;62110;65121;47;0;0;51122180;43859427;1456250;2158;49089653;1362441;1022;0;1
FR;0;2021-10-06;42728;79309;65764;112;80182;68385;28;0;0;51164908;43938736;1522014;2270;49169835;1430826;1050;0;1
FR;0;2021-10-07;30576;62283;65450;88;59500;68899;38;0;0;51195484;44001019;1587464;2358;49229335;1499725;1088;0;1
FR;0;2021-10-08;49486;91947;77773;111;89888;84807;39;0;0;51244970;44092966;1665237;2469;49319223;1584532;1127;0;1
FR;0;2021-10-09;33677;60950;31549;35;64140;33933;17;0;0;51278647;44153916;1696786;2504;49383363;1618465;1144;0;1
FR;0;2021-10-10;4722;7423;3199;9;7939;3475;2;0;0;51283369;44161339;1699985;2513;49391302;1621940;1146;0;1
FR;0;2021-10-11;30735;49886;61050;105;50601;64120;46;0;0;51314104;44211225;1761035;2618;49441903;1686060;1192;0;1
FR;0;2021-10-12;31651;54483;70635;141;51309;76050;27;0;0;51345755;44265708;1831670;2759;49493212;1762110;1219;0;1
FR;0;2021-10-13;40168;62851;74443;137;62799;79398;29;0;1;51385923;44328559;1906113;2896;49556011;1841508;1248;0;2
FR;0;2021-10-14;30364;52874;68779;116;49695;73871;31;0;0;51416287;44381433;1974892;3012;49605706;1915379;1279;0;2
FR;0;2021-10-15;44961;75237;93255;191;70331;103056;26;0;0;51461248;44456670;2068147;3203;49676037;2018435;1305;0;2
FR;0;2021-10-16;31335;44083;36701;45;46701;39652;15;0;0;51492583;44500753;2104848;3248;49722738;2058087;1320;0;2
FR;0;2021-10-17;3898;5230;3603;2;5677;3674;4;0;0;51496481;44505983;2108451;3250;49728415;2061761;1324;0;2
FR;0;2021-10-18;29217;42343;67522;134;42560;71384;27;0;0;51525698;44548326;2175973;3384;49770975;2133145;1351;0;2
FR;0;2021-10-19;27196;45547;76431;140;43205;81677;45;0;0;51552894;44593873;2252404;3524;49814180;2214822;1396;0;2
FR;0;2021-10-20;35347;52406;96960;181;51812;101579;45;0;0;51588241;44646279;2349364;3705;49865992;2316401;1441;0;2
FR;0;2021-10-21;26169;45173;83999;112;41969;89196;30;0;0;51614410;44691452;2433363;3817;49907961;2405597;1471;0;2
FR;0;2021-10-22;38450;62488;104928;200;59355;112654;61;0;0;51652860;44753940;2538291;4017;49967316;2518251;1532;0;2
FR;0;2021-10-23;27034;41204;45467;57;42426;48637;14;0;0;51679894;44795144;2583758;4074;50009742;2566888;1546;0;2
FR;0;2021-10-24;2947;4763;3686;6;5014;3923;1;0;0;51682841;44799907;2587444;4080;50014756;2570811;1547;0;2
FR;0;2021-10-25;26109;36208;82347;144;35481;86681;38;0;0;51708950;44836115;2669791;4224;50050237;2657492;1585;0;2
FR;0;2021-10-26;23770;34990;87283;166;32157;92411;35;0;0;51732720;44871105;2757074;4390;50082394;2749903;1620;0;2
FR;0;2021-10-27;30115;46297;109035;257;44036;114753;48;0;0;51762835;44917402;2866109;4647;50126430;2864656;1668;0;2
FR;0;2021-10-28;23611;34928;88745;153;31195;94543;35;0;0;51786446;44952330;2954854;4800;50157625;2959199;1703;0;2
FR;0;2021-10-29;31589;51451;117349;206;46498;125438;52;0;0;51818035;45003781;3072203;5006;50204123;3084637;1755;0;2
FR;0;2021-10-30;20578;33238;50361;76;32920;53430;20;0;0;51838613;45037019;3122564;5082;50237043;3138067;1775;0;2
FR;0;2021-10-31;2519;3732;3595;3;3844;3881;3;0;0;51841132;45040751;3126159;5085;50240887;3141948;1778;0;2
FR;0;2021-11-01;8544;4869;3224;3;5020;3587;10;0;0;51849676;45045620;3129383;5088;50245907;3145535;1788;0;2
FR;0;2021-11-02;26387;40099;93612;156;36237;99674;44;0;1;51876063;45085719;3222995;5244;50282144;3245209;1832;0;3
FR;0;2021-11-03;30134;47901;118933;222;43554;125910;64;0;0;51906197;45133620;3341928;5466;50325698;3371119;1896;0;3
FR;0;2021-11-04;23824;37460;107603;217;31573;114483;46;0;0;51930021;45171080;3449531;5683;50357271;3485602;1942;0;3
FR;0;2021-11-05;32420;52938;141679;236;44652;151469;54;0;0;51962441;45224018;3591210;5919;50401923;3637071;1996;0;3
FR;0;2021-11-06;21554;34551;64912;123;32384;68354;26;0;0;51983995;45258569;3656122;6042;50434307;3705425;2022;0;3
FR;0;2021-11-07;2430;4154;5209;6;4000;5598;7;0;0;51986425;45262723;3661331;6048;50438307;3711023;2029;0;3
FR;0;2021-11-08;20634;37742;127237;227;30950;134365;50;0;0;52007059;45300465;3788568;6275;50469257;3845388;2079;0;3
FR;0;2021-11-09;22444;44652;161745;339;32855;172360;65;0;0;52029503;45345117;3950313;6614;50502112;4017748;2144;0;3
FR;0;2021-11-10;31621;54875;187071;447;44022;198891;91;0;0;52061124;45399992;4137384;7061;50546134;4216639;2235;0;3
FR;0;2021-11-11;4750;6743;12999;28;5905;13982;17;0;0;52065874;45406735;4150383;7089;50552039;4230621;2252;0;3
FR;0;2021-11-12;29103;55051;183838;252;41714;197505;86;0;0;52094977;45461786;4334221;7341;50593753;4428126;2338;0;3
FR;0;2021-11-13;20357;32599;80730;118;28229;86354;44;0;0;52115334;45494385;4414951;7459;50621982;4514480;2382;0;3
FR;0;2021-11-14;2367;3854;7184;6;3362;7847;9;0;0;52117701;45498239;4422135;7465;50625344;4522327;2391;0;3
FR;0;2021-11-15;20525;38546;160911;314;27780;171651;77;0;0;52138226;45536785;4583046;7779;50653124;4693978;2468;0;3
FR;0;2021-11-16;23675;43824;200492;394;27699;215192;115;0;1;52161901;45580609;4783538;8173;50680823;4909170;2583;0;4
FR;0;2021-11-17;30545;50237;199905;406;36445;212972;98;0;0;52192446;45630846;4983443;8579;50717268;5122142;2681;0;4
FR;0;2021-11-18;23460;45680;191758;469;29389;205745;94;0;0;52215906;45676526;5175201;9048;50746657;5327887;2775;0;4
FR;0;2021-11-19;33696;61269;243294;551;39905;262314;147;0;0;52249602;45737795;5418495;9599;50786562;5590201;2922;0;4
FR;0;2021-11-20;25426;36658;102195;207;29266;109768;43;0;0;52275028;45774453;5520690;9806;50815828;5699969;2965;0;4
FR;0;2021-11-21;2666;4444;9683;19;3443;10609;19;0;0;52277694;45778897;5530373;9825;50819271;5710578;2984;0;4
FR;0;2021-11-22;22824;33111;180437;472;18912;194923;90;0;0;52300518;45812008;5710810;10297;50838183;5905501;3074;0;4
FR;0;2021-11-23;25738;45457;229495;549;24111;247986;85;0;0;52326256;45857465;5940305;10846;50862294;6153487;3159;0;4
FR;0;2021-11-24;31821;53590;224910;715;34471;243363;80;0;0;52358077;45911055;6165215;11561;50896765;6396850;3239;0;4
FR;0;2021-11-25;25654;49132;256032;739;25045;277943;112;0;0;52383731;45960187;6421247;12300;50921810;6674793;3351;0;4
FR;0;2021-11-26;33255;74667;379566;867;37390;414800;172;0;0;52416986;46034854;6800813;13167;50959200;7089593;3523;0;4
FR;0;2021-11-27;23508;49551;214980;391;28440;236786;135;0;0;52440494;46084405;7015793;13558;50987640;7326379;3658;0;4
FR;0;2021-11-28;3528;10442;56787;66;4057;63333;42;0;0;52444022;46094847;7072580;13624;50991697;7389712;3700;0;4
FR;0;2021-11-29;19449;54063;341575;864;23090;371914;178;0;0;52463471;46148910;7414155;14488;51014787;7761626;3878;0;4
FR;0;2021-11-30;24789;71792;457493;988;26789;500936;291;0;0;52488260;46220702;7871648;15476;51041576;8262562;4169;0;4
FR;0;2021-12-01;27401;75418;469225;1162;31307;511449;304;0;0;52515661;46296120;8340873;16638;51072883;8774011;4473;0;4
FR;0;2021-12-02;22133;71459;527255;1282;20994;575057;309;0;0;52537794;46367579;8868128;17920;51093877;9349068;4782;0;4
FR;0;2021-12-03;25581;92766;596539;1421;34325;651332;343;0;0;52563375;46460345;9464667;19341;51128202;10000400;5125;0;4
FR;0;2021-12-04;18342;60285;336314;692;25660;369891;197;0;0;52581717;46520630;9800981;20033;51153862;10370291;5322;0;4
FR;0;2021-12-05;4158;16083;95820;157;4852;107050;92;0;0;52585875;46536713;9896801;20190;51158714;10477341;5414;0;4
FR;0;2021-12-06;28452;72657;493295;1175;25214;540115;386;0;0;52614327;46609370;10390096;21365;51183928;11017456;5800;0;4
FR;0;2021-12-07;23569;91187;645589;1774;28504;706602;416;0;0;52637896;46700557;11035685;23139;51212432;11724058;6216;0;4
FR;0;2021-12-08;25526;91862;591910;1875;34933;647778;439;0;0;52663422;46792419;11627595;25014;51247365;12371836;6655;0;4
FR;0;2021-12-09;24088;94005;663383;2179;28949;726828;463;0;0;52687510;46886424;12290978;27193;51276314;13098664;7118;0;4
FR;0;2021-12-10;28080;110828;736224;2075;37928;806401;471;0;1;52715590;46997252;13027202;29268;51314242;13905065;7589;0;5
FR;0;2021-12-11;20254;76039;435258;990;29933;480485;343;0;0;52735844;47073291;13462460;30258;51344175;14385550;7932;0;5
FR;0;2021-12-12;5685;23105;142363;262;6385;159236;108;0;0;52741529;47096396;13604823;30520;51350560;14544786;8040;0;5
FR;0;2021-12-13;21371;90672;587854;1699;29628;649469;397;0;0;52762900;47187068;14192677;32219;51380188;15194255;8437;0;5
FR;0;2021-12-14;27991;118200;765826;2658;35393;847808;701;0;1;52790891;47305268;14958503;34877;51415581;16042063;9138;0;6
FR;0;2021-12-15;28458;114129;694534;2267;39484;769316;503;0;1;52819349;47419397;15653037;37144;51455065;16811379;9641;0;7
FR;0;2021-12-16;28059;115561;764276;2559;35076;844700;516;0;0;52847408;47534958;16417313;39703;51490141;17656079;10157;0;7
FR;0;2021-12-17;31665;128217;808044;2713;43318;892196;612;0;0;52879073;47663175;17225357;42416;51533459;18548275;10769;0;7
FR;0;2021-12-18;24945;81471;470066;1179;30039;522270;353;0;0;52904018;47744646;17695423;43595;51563498;19070545;11122;0;7
FR;0;2021-12-19;8771;28504;169449;376;7834;191055;143;0;0;52912789;47773150;17864872;43971;51571332;19261600;11265;0;7
FR;0;2021-12-20;31785;97013;591633;1789;33808;658848;503;0;0;52944574;47870163;18456505;45760;51605140;19920448;11768;0;7
FR;0;2021-12-21;39484;111839;682566;2391;38746;759701;607;0;0;52984058;47982002;19139071;48151;51643886;20680149;12375;0;7
FR;0;2021-12-22;39566;99105;575909;2169;37075;642227;687;0;2;53023624;48081107;19714980;50320;51680961;21322376;13062;0;9
FR;0;2021-12-23;33794;79317;441114;1659;30090;494450;589;0;0;53057418;48160424;20156094;51979;51711051;21816826;13651;0;9
FR;0;2021-12-24;10701;26011;111060;398;11636;126675;236;0;1;53068119;48186435;20267154;52377;51722687;21943501;13887;0;10
FR;0;2021-12-25;779;3565;7603;25;2046;9022;72;0;0;53068898;48190000;20274757;52402;51724733;21952523;13959;0;10
FR;0;2021-12-26;4699;11876;52128;142;4735;60172;170;0;0;53073597;48201876;20326885;52544;51729468;22012695;14129;0;10
FR;0;2021-12-27;30511;83907;453632;1364;33014;509281;665;0;0;53104108;48285783;20780517;53908;51762482;22521976;14794;0;10
FR;0;2021-12-28;38369;98787;564242;1769;35082;632338;1558;0;2;53142477;48384570;21344759;55677;51797564;23154314;16352;0;12
FR;0;2021-12-29;39882;88133;501292;1687;33081;561058;1738;0;1;53182359;48472703;21846051;57364;51830645;23715372;18090;0;13
FR;0;2021-12-30;35928;75050;421076;1521;29499;471184;1880;0;0;53218287;48547753;22267127;58885;51860144;24186556;19970;0;13
FR;0;2021-12-31;12053;25072;116896;405;11262;131680;741;0;0;53230340;48572825;22384023;59290;51871406;24318236;20711;0;13
FR;0;2022-01-01;1597;3214;8533;37;1805;9942;103;0;0;53231937;48576039;22392556;59327;51873211;24328178;20814;0;13
FR;0;2022-01-02;6131;13015;58437;126;5110;66975;408;0;0;53238068;48589054;22450993;59453;51878321;24395153;21222;0;13
FR;0;2022-01-03;39744;90135;494909;1597;36875;551788;2650;0;1;53277812;48679189;22945902;61050;51915196;24946941;23872;0;14
FR;0;2022-01-04;42316;110969;641488;2309;40640;714498;3836;0;3;53320128;48790158;23587390;63359;51955836;25661439;27708;0;17
FR;0;2022-01-05;61226;103578;569286;1985;43796;634321;3429;0;2;53381354;48893736;24156676;65344;51999632;26295760;31137;0;19
FR;0;2022-01-06;44321;110306;639068;2702;40220;711590;4557;0;2;53425675;49004042;24795744;68046;52039852;27007350;35694;0;21
FR;0;2022-01-07;50847;123275;711079;2811;46836;790563;4995;0;2;53476522;49127317;25506823;70857;52086688;27797913;40689;0;23
FR;0;2022-01-08;45015;80264;423847;1213;35043;472911;2447;0;3;53521537;49207581;25930670;72070;52121731;28270824;43136;0;26
FR;0;2022-01-09;15614;26592;128585;300;11482;145663;829;0;0;53537151;49234173;26059255;72370;52133213;28416487;43965;0;26
FR;0;2022-01-10;35425;93245;469403;1816;43020;522789;3722;0;1;53572576;49327418;26528658;74186;52176233;28939276;47687;0;27
FR;0;2022-01-11;41956;100433;548347;2311;42392;608595;5220;0;2;53614532;49427851;27077005;76497;52218625;29547871;52907;0;29
FR;0;2022-01-12;60425;95682;452752;1969;49482;504416;4497;0;8;53674957;49523533;27529757;78466;52268107;30052287;57404;0;37
FR;0;2022-01-13;38275;92511;487422;2084;40547;541103;5467;0;8;53713232;49616044;28017179;80550;52308654;30593390;62871;0;45
FR;0;2022-01-14;42590;103288;568676;2286;43497;629063;6463;0;2;53755822;49719332;28585855;82836;52352151;31222453;69334;0;47
FR;0;2022-01-15;39433;65880;340169;985;31449;377582;3296;0;1;53795255;49785212;28926024;83821;52383600;31600035;72630;0;48
FR;0;2022-01-16;11415;19193;87447;216;9017;99403;764;0;0;53806670;49804405;29013471;84037;52392617;31699438;73394;0;48
FR;0;2022-01-17;24755;59978;320338;1384;28036;354175;3960;0;4;53831425;49864383;29333809;85421;52420653;32053613;77354;0;52
FR;0;2022-01-18;28332;68679;361152;1802;32013;397600;5771;0;1;53859757;49933062;29694961;87223;52452666;32451213;83125;0;53
FR;0;2022-01-19;43231;67008;281355;1452;40384;311093;4392;0;5;53902988;50000070;29976316;88675;52493050;32762306;87517;0;58
FR;0;2022-01-20;23681;59591;299074;1750;29562;328542;5637;0;4;53926669;50059661;30275390;90425;52522612;33090848;93154;0;62
FR;0;2022-01-21;28216;68764;366413;2086;33072;401219;6580;0;3;53954885;50128425;30641803;92511;52555684;33492067;99734;0;65
FR;0;2022-01-22;27630;47971;218811;840;27302;241796;2838;0;2;53982515;50176396;30860614;93351;52582986;33733863;102572;0;67
FR;0;2022-01-23;6740;12963;48695;173;7502;55170;591;0;1;53989255;50189359;30909309;93524;52590488;33789033;103163;0;68
FR;0;2022-01-24;16287;47438;217357;1149;25400;239357;4103;0;3;54005542;50236797;31126666;94673;52615888;34028390;107266;0;71
FR;0;2022-01-25;19034;54317;243104;1548;28808;267104;6067;0;5;54024576;50291114;31369770;96221;52644696;34295494;113333;0;76
FR;0;2022-01-26;28148;60550;209319;1299;41362;229548;4479;0;3;54052724;50351664;31579089;97520;52686058;34525042;117812;0;79
FR;0;2022-01-27;16338;46486;207675;1287;26147;226065;5693;0;4;54069062;50398150;31786764;98807;52712205;34751107;123505;0;83
FR;0;2022-01-28;21594;78648;290091;1574;44968;321349;7411;0;4;54090656;50476798;32076855;100381;52757173;35072456;130916;0;87
FR;0;2022-01-29;18424;52844;184145;689;32751;204575;3255;0;2;54109080;50529642;32261000;101070;52789924;35277031;134171;0;89
FR;0;2022-01-30;4477;14462;39152;124;9129;45056;637;0;1;54113557;50544104;32300152;101194;52799053;35322087;134808;0;90
FR;0;2022-01-31;11261;43903;148219;742;26128;164721;4230;0;5;54124818;50588007;32448371;101936;52825181;35486808;139038;0;95
FR;0;2022-02-01;13652;48291;174148;1145;27329;191335;7036;0;1;54138470;50636298;32622519;103081;52852510;35678143;146074;0;96
FR;0;2022-02-02;20761;66294;171561;1035;46158;190079;5969;0;10;54159231;50702592;32794080;104116;52898668;35868222;152043;0;106
FR;0;2022-02-03;11760;44789;157585;990;25345;173286;6933;0;6;54170991;50747381;32951665;105106;52924013;36041508;158976;0;112
FR;0;2022-02-04;14647;67978;239263;1267;37602;264081;9153;0;6;54185638;50815359;33190928;106373;52961615;36305589;168129;0;118
FR;0;2022-02-05;12903;51439;153565;523;31977;172293;3784;0;3;54198541;50866798;33344493;106896;52993592;36477882;171913;0;121
FR;0;2022-02-06;2726;12168;28898;103;7289;33830;663;0;0;54201267;50878966;33373391;106999;53000881;36511712;172576;0;121
FR;0;2022-02-07;9619;46620;156905;594;24515;176303;5294;0;6;54210886;50925586;33530296;107593;53025396;36688015;177870;0;127
FR;0;2022-02-08;9817;43101;166663;870;20967;184458;7054;0;6;54220703;50968687;33696959;108463;53046363;36872473;184924;0;133
FR;0;2022-02-09;14463;58262;172360;876;35361;193068;5788;0;9;54235166;51026949;33869319;109339;53081724;37065541;190712;0;142
FR;0;2022-02-10;8731;39229;150244;881;18706;166722;6503;0;2;54243897;51066178;34019563;110220;53100430;37232263;197215;0;144
FR;0;2022-02-11;10864;55704;218522;1101;25847;243117;8322;0;3;54254761;51121882;34238085;111321;53126277;37475380;205537;0;147
FR;0;2022-02-12;8409;40970;134740;465;22637;151768;3509;0;4;54263170;51162852;34372825;111786;53148914;37627148;209046;0;151
FR;0;2022-02-13;1940;8605;26568;86;4411;30930;544;0;3;54265110;51171457;34399393;111872;53153325;37658078;209590;0;154
FR;0;2022-02-14;6998;35260;148389;487;14672;166385;4789;0;5;54272108;51206717;34547782;112359;53167997;37824463;214379;0;159
FR;0;2022-02-15;7070;36238;147003;751;16008;162588;6849;0;3;54279178;51242955;34694785;113110;53184005;37987051;221228;0;162
FR;0;2022-02-16;9417;42994;132550;722;25985;146769;5727;0;6;54288595;51285949;34827335;113832;53209990;38133820;226955;0;168
FR;0;2022-02-17;5582;24348;87320;587;13147;94895;5408;0;5;54294177;51310297;34914655;114419;53223137;38228715;232363;0;173
FR;0;2022-02-18;7003;33597;119673;807;18769;129339;7416;0;2;54301180;51343894;35034328;115226;53241906;38358054;239779;0;175
FR;0;2022-02-19;5372;24558;70030;371;15910;77340;3020;0;2;54306552;51368452;35104358;115597;53257816;38435394;242799;0;177
FR;0;2022-02-20;1152;4661;12175;39;2916;13957;460;0;1;54307704;51373113;35116533;115636;53260732;38449351;243259;0;178
FR;0;2022-02-21;4100;17896;61958;351;10173;67188;4059;0;2;54311804;51391009;35178491;115987;53270905;38516539;247318;0;180
FR;0;2022-02-22;4468;18668;60840;577;11270;64481;5255;0;1;54316272;51409677;35239331;116564;53282175;38581020;252573;0;181
FR;0;2022-02-23;6593;27365;66512;593;19633;71911;4595;0;3;54322865;51437042;35305843;117157;53301808;38652931;257168;0;184
FR;0;2022-02-24;3852;15564;50435;519;9524;53259;4531;0;2;54326717;51452606;35356278;117676;53311332;38706190;261699;0;186
FR;0;2022-02-25;5287;24299;76372;804;15274;80104;7336;0;7;54332004;51476905;35432650;118480;53326606;38786294;269035;0;193
FR;0;2022-02-26;3995;17772;47421;359;12174;51488;3083;0;3;54335999;51494677;35480071;118839;53338780;38837782;272118;0;196
FR;0;2022-02-27;881;3011;8040;47;1980;8949;531;0;0;54336880;51497688;35488111;118886;53340760;38846731;272649;0;196
FR;0;2022-02-28;3127;12563;40496;359;7597;42930;3857;0;0;54340007;51510251;35528607;119245;53348357;38889661;276506;0;196
FR;0;2022-03-01;4013;12615;44203;437;7639;44875;5518;0;6;54344020;51522866;35572810;119682;53355996;38934536;282024;0;202
FR;0;2022-03-02;5338;17901;47155;448;12961;49087;4931;0;2;54349358;51540767;35619965;120130;53368957;38983623;286955;0;204
FR;0;2022-03-03;2830;9362;29902;371;6260;30025;4050;0;2;54352188;51550129;35649867;120501;53375217;39013648;291005;0;206
FR;0;2022-03-04;3230;12522;40343;669;8521;39492;6235;0;4;54355418;51562651;35690210;121170;53383738;39053140;297240;0;210
FR;0;2022-03-05;3074;9291;24962;314;7133;25126;3135;0;1;54358492;51571942;35715172;121484;53390871;39078266;300375;0;211
FR;0;2022-03-06;522;1410;3199;43;1031;3444;379;0;0;54359014;51573352;35718371;121527;53391902;39081710;300754;0;211
FR;0;2022-03-07;2499;5636;18439;315;3853;17710;3308;0;4;54361513;51578988;35736810;121842;53395755;39099420;304062;0;215
FR;0;2022-03-08;2155;6082;19452;363;4336;17925;4093;0;3;54363668;51585070;35756262;122205;53400091;39117345;308155;0;218
FR;0;2022-03-09;3583;10572;22200;408;8799;21295;4042;0;4;54367251;51595642;35778462;122613;53408890;39138640;312197;0;222
FR;0;2022-03-10;1833;5848;17013;345;4397;15839;3408;0;3;54369084;51601490;35795475;122958;53413287;39154479;315605;0;225
FR;0;2022-03-11;2422;7568;24511;545;5446;22280;5479;0;2;54371506;51609058;35819986;123503;53418733;39176759;321084;0;227
FR;0;2022-03-12;2699;6776;17168;309;5494;16522;3137;0;2;54374205;51615834;35837154;123812;53424227;39193281;324221;0;229
FR;0;2022-03-13;407;795;2323;150;605;2272;538;0;0;54374612;51616629;35839477;123962;53424832;39195553;324759;0;229
FR;0;2022-03-14;1563;4278;14990;4412;2813;13843;7295;0;8;54376175;51620907;35854467;128374;53427645;39209396;332054;0;237
FR;0;2022-03-15;1751;6295;16387;7556;4810;14618;11036;0;9;54377926;51627202;35870854;135930;53432455;39224014;343090;0;246
FR;0;2022-03-16;3041;7415;19436;13142;6217;18113;16299;0;8;54380967;51634617;35890290;149072;53438672;39242127;359389;0;254
FR;0;2022-03-17;1466;3988;13156;10846;2809;11996;13314;0;9;54382433;51638605;35903446;159918;53441481;39254123;372703;0;263
FR;0;2022-03-18;2268;5758;20019;18307;4099;18115;22039;0;15;54384701;51644363;35923465;178225;53445580;39272238;394742;0;278
FR;0;2022-03-19;2294;4806;13116;9406;4142;12421;11409;0;6;54386995;51649169;35936581;187631;53449722;39284659;406151;0;284
FR;0;2022-03-20;302;738;1920;1074;530;1933;1340;0;2;54387297;51649907;35938501;188705;53450252;39286592;407491;0;286
FR;0;2022-03-21;1395;3222;12736;14951;2157;11962;16910;0;11;54388692;51653129;35951237;203656;53452409;39298554;424401;0;297
FR;0;2022-03-22;1557;3743;13808;20553;2581;12564;22845;0;5;54390249;51656872;35965045;224209;53454990;39311118;447246;0;302
FR;0;2022-03-23;2691;6300;17743;23152;5232;17251;25269;0;40;54392940;51663172;35982788;247361;53460222;39328369;472515;0;342
FR;0;2022-03-24;1411;3160;11600;17619;2248;10685;19394;0;23;54394351;51666332;35994388;264980;53462470;39339054;491909;0;365
FR;0;2022-03-25;2089;5160;18583;27775;3691;16920;30810;0;31;54396440;51671492;36012971;292755;53466161;39355974;522719;0;396
FR;0;2022-03-26;2232;4418;12080;12680;3866;11521;14402;0;26;54398672;51675910;36025051;305435;53470027;39367495;537121;0;422
FR;0;2022-03-27;365;693;1909;1483;515;1943;1740;0;1;54399037;51676603;36026960;306918;53470542;39369438;538861;0;423
FR;0;2022-03-28;1468;3082;11133;17490;2120;10621;19070;0;16;54400505;51679685;36038093;324408;53472662;39380059;557931;0;439
FR;0;2022-03-29;1452;3284;12913;27586;2098;12055;29285;0;34;54401957;51682969;36051006;351994;53474760;39392114;587216;0;473
FR;0;2022-03-30;2854;5589;15691;27435;4773;15091;29341;0;21;54404811;51688558;36066697;379429;53479533;39407205;616557;0;494
FR;0;2022-03-31;1615;3585;12992;25041;2570;12331;26651;0;43;54406426;51692143;36079689;404470;53482103;39419536;643208;0;537
FR;0;2022-04-01;2690;4588;20083;30896;2974;18725;33489;0;62;54409116;51696731;36099772;435366;53485077;39438261;676697;0;599
FR;0;2022-04-02;1532;2649;9054;10135;2009;8728;11297;0;29;54410648;51699380;36108826;445501;53487086;39446989;687994;0;628
FR;0;2022-04-03;294;516;1562;1171;360;1580;1382;0;2;54410942;51699896;36110388;446672;53487446;39448569;689376;0;630
FR;0;2022-04-04;4568;3032;12390;19132;2053;11598;20605;0;35;54415510;51702928;36122778;465804;53489499;39460167;709981;0;665
FR;0;2022-04-05;2608;3178;14354;34151;2055;13207;35769;0;85;54418118;51706106;36137132;499955;53491554;39473374;745750;0;750
FR;0;2022-04-06;2613;3964;13545;26546;3030;12820;28015;0;72;54420731;51710070;36150677;526501;53494584;39486194;773765;0;822
FR;0;2022-04-07;1989;3151;13687;33822;1999;12901;35178;0;76;54422720;51713221;36164364;560323;53496583;39499095;808943;0;898
FR;0;2022-04-08;2310;4345;19236;44016;2675;17862;46369;0;89;54425030;51717566;36183600;604339;53499258;39516957;855312;0;987
FR;0;2022-04-09;1374;2682;9315;13568;1905;8869;14800;0;30;54426404;51720248;36192915;617907;53501163;39525826;870112;0;1017
FR;0;2022-04-10;296;757;1985;2017;555;2007;2279;0;7;54426700;51721005;36194900;619924;53501718;39527833;872391;0;1024
FR;0;2022-04-11;1351;2634;11876;23935;1655;11483;25207;0;74;54428051;51723639;36206776;643859;53503373;39539316;897598;0;1098
FR;0;2022-04-12;1729;3083;14023;40929;1967;13395;41819;0;127;54429780;51726722;36220799;684788;53505340;39552711;939417;0;1225
FR;0;2022-04-13;1980;3723;13416;33118;2720;13038;34087;0;96;54431760;51730445;36234215;717906;53508060;39565749;973504;0;1321
FR;0;2022-04-14;1510;3016;13216;36354;1944;13074;37023;0;105;54433270;51733461;36247431;754260;53510004;39578823;1010527;0;1426
FR;0;2022-04-15;1883;3880;15645;35584;2622;14926;37235;0;115;54435153;51737341;36263076;789844;53512626;39593749;1047762;0;1541
FR;0;2022-04-16;1046;1834;6400;8553;1263;6263;9435;0;40;54436199;51739175;36269476;798397;53513889;39600012;1057197;0;1581
FR;0;2022-04-17;195;340;993;1174;224;1036;1242;0;7;54436394;51739515;36270469;799571;53514113;39601048;1058439;0;1588
FR;0;2022-04-18;201;561;2768;1072;358;2787;1287;0;5;54436595;51740076;36273237;800643;53514471;39603835;1059726;0;1593
FR;0;2022-04-19;1547;3031;12919;29690;1879;12480;30737;0;78;54438142;51743107;36286156;830333;53516350;39616315;1090463;0;1671
FR;0;2022-04-20;2008;3499;13308;29072;2612;12996;30088;0;96;54440150;51746606;36299464;859405;53518962;39629311;1120551;0;1767
FR;0;2022-04-21;1516;2857;12554;35212;1828;12647;35786;0;117;54441666;51749463;36312018;894617;53520790;39641958;1156337;0;1884
FR;0;2022-04-22;1880;3627;16483;37646;2402;15847;39179;0;132;54443546;51753090;36328501;932263;53523192;39657805;1195516;0;2016
FR;0;2022-04-23;1151;2072;7391;10659;1482;7242;11444;0;38;54444697;51755162;36335892;942922;53524674;39665047;1206960;0;2054
FR;0;2022-04-24;249;467;1478;1592;326;1414;1850;0;7;54444946;51755629;36337370;944514;53525000;39666461;1208810;0;2061
FR;0;2022-04-25;1308;2535;10687;21074;1614;10492;22096;0;79;54446254;51758164;36348057;965588;53526614;39676953;1230906;0;2140
FR;0;2022-04-26;1627;3008;13671;38665;1967;13114;39462;0;181;54447881;51761172;36361728;1004253;53528581;39690067;1270368;0;2321
FR;0;2022-04-27;1965;3068;11539;31089;2283;11596;31507;0;131;54449846;51764240;36373267;1035342;53530864;39701663;1301875;0;2452
FR;0;2022-04-28;1571;2783;12530;36269;1865;12271;36586;0;139;54451417;51767023;36385797;1071611;53532729;39713934;1338461;0;2591
FR;0;2022-04-29;2011;4834;15561;37281;3639;14938;38751;0;164;54453428;51771857;36401358;1108892;53536368;39728872;1377212;0;2755
FR;0;2022-04-30;1225;4702;6929;9717;4196;6758;10608;0;44;54454653;51776559;36408287;1118609;53540564;39735630;1387820;0;2799
FR;0;2022-05-01;221;325;916;1000;229;911;1141;0;6;54454874;51776884;36409203;1119609;53540793;39736541;1388961;0;2805
FR;0;2022-05-02;2364;2969;11160;18182;2065;10994;19026;0;69;54457238;51779853;36420363;1137791;53542858;39747535;1407987;0;2874
FR;0;2022-05-03;2067;3269;13726;34703;2130;13567;35624;0;163;54459305;51783122;36434089;1172494;53544988;39761102;1443611;0;3037
FR;0;2022-05-04;1926;3304;12188;25651;2304;12305;26203;0;110;54461231;51786426;36446277;1198145;53547292;39773407;1469814;0;3147
FR;0;2022-05-05;1796;3041;13070;33602;2019;12916;34270;0;180;54463027;51789467;36459347;1231747;53549311;39786323;1504084;0;3327
FR;0;2022-05-06;2218;3667;15359;36819;2326;14870;38280;0;182;54465245;51793134;36474706;1268566;53551637;39801193;1542364;0;3509
FR;0;2022-05-07;1210;1783;6464;9614;1255;6456;10339;0;48;54466455;51794917;36481170;1278180;53552892;39807649;1552703;0;3557
FR;0;2022-05-08;267;400;1175;1548;288;1236;1654;0;8;54466722;51795317;36482345;1279728;53553180;39808885;1554357;0;3565
FR;0;2022-05-09;1404;2307;9927;20259;1414;9798;21175;0;102;54468126;51797624;36492272;1299987;53554594;39818683;1575532;0;3667
FR;0;2022-05-10;1803;3432;13572;38999;2296;13128;40026;0;200;54469929;51801056;36505844;1338986;53556890;39831811;1615558;0;3867
FR;0;2022-05-11;2004;3022;10756;27942;2326;10701;28446;0;146;54471933;51804078;36516600;1366928;53559216;39842512;1644004;0;4013
FR;0;2022-05-12;1595;2746;11386;35758;1816;11055;36523;0;211;54473528;51806824;36527986;1402686;53561032;39853567;1680527;0;4224
FR;0;2022-05-13;1985;3224;13761;37981;2068;13350;39246;0;162;54475513;51810048;36541747;1440667;53563100;39866917;1719773;0;4386
FR;0;2022-05-14;1150;1647;5938;10778;1205;5801;11366;0;58;54476663;51811695;36547685;1451445;53564305;39872718;1731139;0;4444
FR;0;2022-05-15;283;479;1278;1440;302;1361;1593;0;6;54476946;51812174;36548963;1452885;53564607;39874079;1732732;0;4450
FR;0;2022-05-16;1196;2047;8695;21070;1248;8701;21597;0;128;54478142;51814221;36557658;1473955;53565855;39882780;1754329;0;4578
FR;0;2022-05-17;1592;2605;11828;37881;1671;11404;38723;0;180;54479734;51816826;36569486;1511836;53567526;39894184;1793052;0;4758
FR;0;2022-05-18;1816;2655;9694;27166;1957;9667;27785;0;109;54481550;51819481;36579180;1539002;53569483;39903851;1820837;0;4867
FR;0;2022-05-19;1451;2660;10580;35846;1636;10720;36037;0;162;54483001;51822141;36589760;1574848;53571119;39914571;1856874;0;5029
FR;0;2022-05-20;1876;3118;13426;39369;2080;12913;40389;0;168;54484877;51825259;36603186;1614217;53573199;39927484;1897263;0;5197
FR;0;2022-05-21;1159;1718;5662;9897;1314;5533;10534;0;45;54486036;51826977;36608848;1624114;53574513;39933017;1907797;0;5242
FR;0;2022-05-22;241;341;1031;1440;263;1017;1584;0;10;54486277;51827318;36609879;1625554;53574776;39934034;1909381;0;5252
FR;0;2022-05-23;1176;2127;8880;20375;1411;8830;21030;0;86;54487453;51829445;36618759;1645929;53576187;39942864;1930411;0;5338
FR;0;2022-05-24;1542;2759;11367;38882;1736;11239;39511;0;190;54488995;51832204;36630126;1684811;53577923;39954103;1969922;0;5528
FR;0;2022-05-25;1814;2839;9343;24847;2077;9481;25323;0;116;54490809;51835043;36639469;1709658;53580000;39963584;1995245;0;5644
FR;0;2022-05-26;216;430;1666;1201;293;1677;1344;0;26;54491025;51835473;36641135;1710859;53580293;39965261;1996589;0;5670
FR;0;2022-05-27;1390;2477;9266;21291;1670;9006;22325;0;94;54492415;51837950;36650401;1732150;53581963;39974267;2018914;0;5764
FR;0;2022-05-28;669;1272;3919;6795;852;3968;7204;0;38;54493084;51839222;36654320;1738945;53582815;39978235;2026118;0;5802
FR;0;2022-05-29;157;315;753;921;200;774;1033;0;4;54493241;51839537;36655073;1739866;53583015;39979009;2027151;0;5806
FR;0;2022-05-30;1026;1969;6995;19296;1249;7013;19808;0;91;54494267;51841506;36662068;1759162;53584264;39986022;2046959;0;5897
FR;0;2022-05-31;1488;2522;9823;35664;1649;9645;36295;0;171;54495755;51844028;36671891;1794826;53585913;39995667;2083254;0;6068
FR;0;2022-06-01;1754;3106;11029;24538;2256;10896;25491;0;122;54497509;51847134;36682920;1819364;53588169;40006563;2108745;0;6190
FR;0;2022-06-02;1480;2615;11312;35606;1718;10867;36552;0;174;54498989;51849749;36694232;1854970;53589887;40017430;2145297;0;6364
FR;0;2022-06-03;1728;3085;13424;38731;2054;12789;40001;0;176;54500717;51852834;36707656;1893701;53591941;40030219;2185298;0;6540
FR;0;2022-06-04;975;1517;5046;9114;1077;5117;9650;0;73;54501692;51854351;36712702;1902815;53593018;40035336;2194948;0;6613
FR;0;2022-06-05;181;336;876;1108;207;887;1230;0;4;54501873;51854687;36713578;1903923;53593225;40036223;2196178;0;6617
FR;0;2022-06-06;893;1255;2124;1329;1081;2141;1510;0;13;54502766;51855942;36715702;1905252;53594306;40038364;2197688;0;6630
FR;0;2022-06-07;1499;2713;9857;35598;1794;9435;36825;0;153;54504265;51858655;36725559;1940850;53596100;40047799;2234513;0;6783
FR;0;2022-06-08;1585;2698;9178;28790;1941;9021;29756;0;112;54505850;51861353;36734737;1969640;53598041;40056820;2264269;0;6895
FR;0;2022-06-09;1297;2443;10622;39505;1556;10267;40280;0;167;54507147;51863796;36745359;2009145;53599597;40067087;2304549;0;7062
FR;0;2022-06-10;1631;3195;13106;44828;2161;12668;46153;0;223;54508778;51866991;36758465;2053973;53601758;40079755;2350702;0;7285
FR;0;2022-06-11;962;1739;5432;11627;1125;5465;12212;0;55;54509740;51868730;36763897;2065600;53602883;40085220;2362914;0;7340
FR;0;2022-06-12;203;446;1079;1765;255;1143;1866;0;11;54509943;51869176;36764976;2067365;53603138;40086363;2364780;0;7351
FR;0;2022-06-13;1127;2070;7440;23183;1344;7270;24099;0;90;54511070;51871246;36772416;2090548;53604482;40093633;2388879;0;7441
FR;0;2022-06-14;1346;2550;10449;44949;1598;9808;46144;0;200;54512416;51873796;36782865;2135497;53606080;40103441;2435023;0;7641
FR;0;2022-06-15;1529;2465;9326;30909;1934;8965;31599;0;179;54513945;51876261;36792191;2166406;53608014;40112406;2466622;0;7820
FR;0;2022-06-16;1189;2041;9918;39932;1277;9327;40953;0;201;54515134;51878302;36802109;2206338;53609291;40121733;2507575;0;8021
FR;0;2022-06-17;1494;2859;12513;46699;1788;11920;47935;0;240;54516628;51881161;36814622;2253037;53611079;40133653;2555510;0;8261
FR;0;2022-06-18;857;1527;4567;11125;1038;4501;11720;0;67;54517485;51882688;36819189;2264162;53612117;40138154;2567230;0;8328
FR;0;2022-06-19;183;363;1059;1615;208;1131;1701;0;14;54517668;51883051;36820248;2265777;53612325;40139285;2568931;0;8342
FR;0;2022-06-20;1027;1928;8908;26080;1204;8569;27021;0;156;54518695;51884979;36829156;2291857;53613529;40147854;2595952;0;8498
FR;0;2022-06-21;1329;2404;10310;49898;1539;9339;51283;0;264;54520024;51887383;36839466;2341755;53615068;40157193;2647235;0;8762
FR;0;2022-06-22;1398;2519;8920;39065;1809;8430;40007;0;256;54521422;51889902;36848386;2380820;53616877;40165623;2687242;0;9018
FR;0;2022-06-23;1229;2371;10681;55113;1366;9887;56245;0;320;54522651;51892273;36859067;2435933;53618243;40175510;2743487;0;9338
FR;0;2022-06-24;1493;2997;13647;69186;1751;12309;71005;0;405;54524144;51895270;36872714;2505119;53619994;40187819;2814492;0;9743
FR;0;2022-06-25;939;1781;6236;19923;1112;5989;20778;0;177;54525083;51897051;36878950;2525042;53621106;40193808;2835270;0;9920
FR;0;2022-06-26;229;459;1953;3688;259;1818;3966;0;39;54525312;51897510;36880903;2528730;53621365;40195626;2839236;0;9959
FR;0;2022-06-27;1134;2026;10493;48488;1179;9636;49756;0;339;54526446;51899536;36891396;2577218;53622544;40205262;2888992;0;10298
FR;0;2022-06-28;1464;2816;14672;91413;1585;13090;93183;0;623;54527910;51902352;36906068;2668631;53624129;40218352;2982175;0;10921
FR;0;2022-06-29;1713;2835;12294;71899;1848;11242;73040;0;548;54529623;51905187;36918362;2740530;53625977;40229594;3055215;0;11469
FR;0;2022-06-30;1538;2737;14395;95168;1661;12477;97185;0;724;54531161;51907924;36932757;2835698;53627638;40242071;3152400;0;12193
FR;0;2022-07-01;2017;3807;21509;115937;2310;18861;118587;0;954;54533178;51911731;36954266;2951635;53629948;40260932;3270987;0;13147
FR;0;2022-07-02;1088;1859;8529;35755;1108;7705;36876;0;342;54534266;51913590;36962795;2987390;53631056;40268637;3307863;0;13489
FR;0;2022-07-03;294;539;2095;6456;319;1898;6805;0;79;54534560;51914129;36964890;2993846;53631375;40270535;3314668;0;13568
FR;0;2022-07-04;1971;3471;14716;79234;2337;12995;81306;0;639;54536531;51917600;36979606;3073080;53633712;40283530;3395974;0;14207
FR;0;2022-07-05;1799;3172;18842;133280;1804;16025;135571;0;1146;54538330;51920772;36998448;3206360;53635516;40299555;3531545;0;15353
FR;0;2022-07-06;1849;2791;15858;99604;1853;13651;101172;0;900;54540179;51923563;37014306;3305964;53637369;40313206;3632717;0;16253
FR;0;2022-07-07;1714;2872;18011;126041;1712;14790;128368;0;1179;54541893;51926435;37032317;3432005;53639081;40327996;3761085;0;17432
FR;0;2022-07-08;1894;3153;20756;137093;1857;16769;140085;0;1347;54543787;51929588;37053073;3569098;53640938;40344765;3901170;0;18779
FR;0;2022-07-09;868;1464;7746;37928;883;6693;38769;0;426;54544655;51931052;37060819;3607026;53641821;40351458;3939939;0;19205
FR;0;2022-07-10;272;687;2346;7004;441;2125;7395;0;94;54544927;51931739;37063165;3614030;53642262;40353583;3947334;0;19299
FR;0;2022-07-11;1459;2482;15020;88290;1404;12514;90477;0;801;54546386;51934221;37078185;3702320;53643666;40366097;4037811;0;20100
FR;0;2022-07-12;1844;3121;20538;143974;1717;16735;146678;0;1604;54548230;51937342;37098723;3846294;53645383;40382832;4184489;0;21704
FR;0;2022-07-13;1784;2755;15697;94543;1666;13278;96402;0;1080;54550014;51940097;37114420;3940837;53647049;40396110;4280891;0;22784
FR;0;2022-07-14;187;371;1957;5540;221;1836;5707;0;82;54550201;51940468;37116377;3946377;53647270;40397946;4286598;0;22866
FR;0;2022-07-15;1486;2575;15117;84465;1441;12600;86624;0;1035;54551687;51943043;37131494;4030842;53648711;40410546;4373222;0;23901
FR;0;2022-07-16;628;1193;5949;24982;699;5155;25674;0;327;54552315;51944236;37137443;4055824;53649410;40415701;4398896;0;24228
FR;0;2022-07-17;182;395;1738;4666;218;1570;4938;0;66;54552497;51944631;37139181;4060490;53649628;40417271;4403834;0;24294
FR;0;2022-07-18;1132;2252;11829;61810;1342;9979;63673;0;780;54553629;51946883;37151010;4122300;53650970;40427250;4467507;0;25074
FR;0;2022-07-19;1423;2355;15475;103709;1396;12296;105898;0;1459;54555052;51949238;37166485;4226009;53652366;40439546;4573405;0;26533
FR;0;2022-07-20;1429;2302;12970;77586;1470;10744;79173;0;1051;54556481;51951540;37179455;4303595;53653836;40450290;4652578;0;27584
FR;0;2022-07-21;1289;2172;13098;88244;1372;10500;89729;0;1316;54557770;51953712;37192553;4391839;53655208;40460790;4742307;0;28900
FR;0;2022-07-22;1433;2490;14832;89553;1470;11973;91419;0;1347;54559203;51956202;37207385;4481392;53656678;40472763;4833726;0;30247
FR;0;2022-07-23;685;1310;5536;22482;821;4858;23081;0;411;54559888;51957512;37212921;4503874;53657499;40477621;4856807;0;30658
FR;0;2022-07-24;186;353;1401;3905;204;1243;4132;0;72;54560074;51957865;37214322;4507779;53657703;40478864;4860939;0;30730
FR;0;2022-07-25;1061;1797;9493;48082;1149;7845;49519;0;737;54561135;51959662;37223815;4555861;53658852;40486709;4910458;0;31467
FR;0;2022-07-26;1301;2213;13307;85438;1322;10828;87136;0;1311;54562436;51961875;37237122;4641299;53660174;40497537;4997594;0;32778
FR;0;2022-07-27;1226;2008;10236;61318;1341;8530;62522;0;971;54563662;51963883;37247358;4702617;53661515;40506067;5060116;0;33749
FR;0;2022-07-28;1094;1864;10313;64420;1261;8226;65648;0;1046;54564756;51965747;37257671;4767037;53662776;40514293;5125764;0;34795
FR;0;2022-07-29;1282;2078;11011;65900;1387;8765;67330;0;1140;54566038;51967825;37268682;4832937;53664163;40523058;5193094;0;35935
FR;0;2022-07-30;503;867;3523;15283;604;2974;15666;0;303;54566541;51968692;37272205;4848220;53664767;40526032;5208760;0;36238
FR;0;2022-07-31;154;289;929;2439;185;788;2588;0;49;54566695;51968981;37273134;4850659;53664952;40526820;5211348;0;36287
FR;0;2022-08-01;1005;1670;7600;30240;1262;6399;31314;0;549;54567700;51970651;37280734;4880899;53666214;40533219;5242662;0;36836
FR;0;2022-08-02;1056;1650;8582;56131;1157;6895;56808;0;1170;54568756;51972301;37289316;4937030;53667371;40540114;5299470;0;38006
FR;0;2022-08-03;852;1266;6430;38683;903;5150;39421;0;702;54569608;51973567;37295746;4975713;53668274;40545264;5338891;0;38708
FR;0;2022-08-04;741;1187;6575;43161;783;5307;43726;0;917;54570349;51974754;37302321;5018874;53669057;40550571;5382617;0;39625
FR;0;2022-08-05;859;1364;7099;44976;972;5681;45631;0;993;54571208;51976118;37309420;5063850;53670029;40556252;5428248;0;40618
FR;0;2022-08-06;341;559;2101;9368;400;1759;9568;0;228;54571549;51976677;37311521;5073218;53670429;40558011;5437816;0;40846
FR;0;2022-08-07;104;160;536;1627;117;453;1703;0;38;54571653;51976837;37312057;5074845;53670546;40558464;5439519;0;40884
FR;0;2022-08-08;674;1165;4030;22109;921;3293;22544;0;490;54572327;51978002;37316087;5096954;53671467;40561757;5462063;0;41374
FR;0;2022-08-09;748;1167;5973;39963;854;4804;40446;0;844;54573075;51979169;37322060;5136917;53672321;40566561;5502509;0;42218
FR;0;2022-08-10;673;1292;4656;28058;1007;3797;28392;0;652;54573748;51980461;37326716;5164975;53673328;40570358;5530901;0;42870
FR;0;2022-08-11;640;1030;4493;29253;742;3713;29589;0;676;54574388;51981491;37331209;5194228;53674070;40574071;5560490;0;43546
FR;0;2022-08-12;849;1167;4747;28219;851;3920;28656;0;704;54575237;51982658;37335956;5222447;53674921;40577991;5589146;0;44250
FR;0;2022-08-13;362;428;1295;5260;325;1120;5419;0;121;54575599;51983086;37337251;5227707;53675246;40579111;5594565;0;44371
FR;0;2022-08-14;74;121;289;923;104;247;995;0;25;54575673;51983207;37337540;5228630;53675350;40579358;5595560;0;44396
FR;0;2022-08-15;117;232;610;564;198;558;618;0;19;54575790;51983439;37338150;5229194;53675548;40579916;5596178;0;44415
FR;0;2022-08-16;646;1078;3961;22179;840;3355;22372;0;615;54576436;51984517;37342111;5251373;53676388;40583271;5618550;0;45030
FR;0;2022-08-17;653;1041;3890;22900;816;3294;23141;0;620;54577089;51985558;37346001;5274273;53677204;40586565;5641691;0;45650
FR;0;2022-08-18;637;1002;4124;26312;806;3262;26545;0;673;54577726;51986560;37350125;5300585;53678010;40589827;5668236;0;46323
FR;0;2022-08-19;607;1167;4493;27259;875;3694;27565;0;766;54578333;51987727;37354618;5327844;53678885;40593521;5695801;0;47089
FR;0;2022-08-20;311;504;1356;5569;402;1171;5728;0;146;54578644;51988231;37355974;5333413;53679287;40594692;5701529;0;47235
FR;0;2022-08-21;97;135;305;1009;96;267;1044;0;27;54578741;51988366;37356279;5334422;53679383;40594959;5702573;0;47262
FR;0;2022-08-22;584;1002;3274;15358;781;2798;15688;0;425;54579325;51989368;37359553;5349780;53680164;40597757;5718261;0;47687
FR;0;2022-08-23;732;1180;4299;29002;853;3610;29091;0;870;54580057;51990548;37363852;5378782;53681017;40601367;5747352;0;48557
FR;0;2022-08-24;670;940;3498;19539;786;2860;19729;0;608;54580727;51991488;37367350;5398321;53681803;40604227;5767081;0;49165
FR;0;2022-08-25;626;1025;3947;23402;731;3295;23666;0;673;54581353;51992513;37371297;5421723;53682534;40607522;5790747;0;49838
FR;0;2022-08-26;862;1266;4478;25884;961;3671;26257;0;777;54582215;51993779;37375775;5447607;53683495;40611193;5817004;0;50615
FR;0;2022-08-27;299;500;1379;5469;362;1244;5533;0;194;54582514;51994279;37377154;5453076;53683857;40612437;5822537;0;50809
FR;0;2022-08-28;125;163;303;921;117;288;966;0;38;54582639;51994442;37377457;5453997;53683974;40612725;5823503;0;50847
FR;0;2022-08-29;623;970;3076;14679;770;2614;14985;0;433;54583262;51995412;37380533;5468676;53684744;40615339;5838488;0;51280
FR;0;2022-08-30;855;1224;4796;28553;900;3914;28883;0;823;54584117;51996636;37385329;5497229;53685644;40619253;5867371;0;52103
FR;0;2022-08-31;697;958;3207;17647;745;2718;17911;0;508;54584814;51997594;37388536;5514876;53686389;40621971;5885282;0;52611
FR;0;2022-09-01;761;997;4480;22502;709;3827;22768;0;623;54585575;51998591;37393016;5537378;53687098;40625798;5908050;0;53234
FR;0;2022-09-02;992;1159;5045;28615;847;4258;28909;0;914;54586567;51999750;37398061;5565993;53687945;40630056;5936959;0;54148
FR;0;2022-09-03;421;571;1920;6086;425;1667;6323;0;181;54586988;52000321;37399981;5572079;53688370;40631723;5943282;0;54329
FR;0;2022-09-04;135;150;351;876;85;347;945;0;24;54587123;52000471;37400332;5572955;53688455;40632070;5944227;0;54353
FR;0;2022-09-05;779;918;3178;16065;739;2658;16379;0;523;54587902;52001389;37403510;5589020;53689194;40634728;5960606;0;54876
FR;0;2022-09-06;925;1051;4740;31853;681;3873;32082;0;1040;54588827;52002440;37408250;5620873;53689875;40638601;5992688;0;55916
FR;0;2022-09-07;713;791;3000;16822;573;2482;16972;0;573;54589540;52003231;37411250;5637695;53690448;40641083;6009660;0;56489
FR;0;2022-09-08;635;862;3810;24866;597;3142;24957;0;818;54590175;52004093;37415060;5662561;53691045;40644225;6034617;0;57307
FR;0;2022-09-09;852;1039;4444;27660;681;3686;27836;0;951;54591027;52005132;37419504;5690221;53691726;40647911;6062453;0;58258
FR;0;2022-09-10;408;654;1739;5711;480;1539;5917;0;207;54591435;52005786;37421243;5695932;53692206;40649450;6068370;0;58465
FR;0;2022-09-11;124;131;324;657;93;307;716;0;17;54591559;52005917;37421567;5696589;53692299;40649757;6069086;0;58482
FR;0;2022-09-12;523;646;2691;13297;463;2296;13590;0;478;54592082;52006563;37424258;5709886;53692762;40652053;6082676;0;58960
FR;0;2022-09-13;682;873;4000;26521;562;3489;26398;0;875;54592764;52007436;37428258;5736407;53693324;40655542;6109074;0;59835
FR;0;2022-09-14;710;802;2968;16188;594;2485;16421;0;573;54593474;52008238;37431226;5752595;53693918;40658027;6125495;0;60408
FR;0;2022-09-15;578;849;3478;23587;601;2967;23656;0;728;54594052;52009087;37434704;5776182;53694519;40660994;6149151;0;61136
FR;0;2022-09-16;799;1050;4147;25919;733;3489;26139;0;932;54594851;52010137;37438851;5802101;53695252;40664483;6175290;0;62068
FR;0;2022-09-17;395;513;1454;6146;392;1284;6238;0;243;54595246;52010650;37440305;5808247;53695644;40665767;6181528;0;62311
FR;0;2022-09-18;117;144;323;962;123;291;1017;0;37;54595363;52010794;37440628;5809209;53695767;40666058;6182545;0;62348
FR;0;2022-09-19;482;648;2262;13219;451;1936;13402;0;436;54595845;52011442;37442890;5822428;53696218;40667994;6195947;0;62784
FR;0;2022-09-20;646;904;3791;26462;659;3158;26516;0;893;54596491;52012346;37446681;5848890;53696877;40671152;6222463;0;63677
FR;0;2022-09-21;591;776;2740;16259;580;2355;16250;0;587;54597082;52013122;37449421;5865149;53697457;40673507;6238713;0;64264
FR;0;2022-09-22;601;852;3426;23625;575;2809;23839;0;775;54597683;52013974;37452847;5888774;53698032;40676316;6262552;0;65039
FR;0;2022-09-23;838;1053;4495;28732;776;3764;28903;0;1021;54598521;52015027;37457342;5917506;53698808;40680080;6291455;0;66060
FR;0;2022-09-24;427;615;1648;6906;474;1422;7091;0;307;54598948;52015642;37458990;5924412;53699282;40681502;6298546;0;66367
FR;0;2022-09-25;99;194;336;1101;149;307;1143;0;37;54599047;52015836;37459326;5925513;53699431;40681809;6299689;0;66404
FR;0;2022-09-26;438;715;2300;13545;485;2019;13650;0;435;54599485;52016551;37461626;5939058;53699916;40683828;6313339;0;66839
FR;0;2022-09-27;615;845;3627;25944;615;2910;26099;0;959;54600100;52017396;37465253;5965002;53700531;40686738;6339438;0;67798
FR;0;2022-09-28;635;828;2557;15403;635;2305;15516;0;622;54600735;52018224;37467810;5980405;53701166;40689043;6354954;0;68420
FR;0;2022-09-29;566;770;3138;21057;547;2651;21087;43;810;54601301;52018994;37470948;6001462;53701713;40691694;6376041;43;69230
FR;0;2022-09-30;787;1125;3958;25563;845;3303;25831;715;1052;54602088;52020119;37474906;6027025;53702558;40694997;6401872;758;70282
FR;0;2022-10-01;431;713;2009;5975;561;1737;6212;396;318;54602519;52020832;37476915;6033000;53703119;40696734;6408084;1154;70600
FR;0;2022-10-02;63;136;218;639;97;215;665;66;42;54602582;52020968;37477133;6033639;53703216;40696949;6408749;1220;70642
FR;0;2022-10-03;632;951;2469;12053;785;2195;12231;2074;745;54603214;52021919;37479602;6045692;53704001;40699144;6420980;3294;71387
FR;0;2022-10-04;756;832;3394;23508;579;2785;23685;4704;1585;54603970;52022751;37482996;6069200;53704580;40701929;6444665;7998;72972
FR;0;2022-10-05;605;854;2448;14609;633;2163;14750;3658;1210;54604575;52023605;37485444;6083809;53705213;40704092;6459415;11656;74182
FR;0;2022-10-06;552;741;3090;21689;542;2522;21898;6668;1910;54605127;52024346;37488534;6105498;53705755;40706614;6481313;18324;76092
FR;0;2022-10-07;735;1014;4128;30310;741;3477;30398;16874;3207;54605862;52025360;37492662;6135808;53706496;40710091;6511711;35198;79299
FR;0;2022-10-08;356;521;1651;8432;383;1410;8601;6699;1171;54606218;52025881;37494313;6144240;53706879;40711501;6520312;41897;80470
FR;0;2022-10-09;109;143;337;1587;117;312;1650;1511;297;54606327;52026024;37494650;6145827;53706996;40711813;6521962;43408;80767
FR;0;2022-10-10;506;842;2932;20565;658;2523;20887;19597;3272;54606833;52026866;37497582;6166392;53707654;40714336;6542849;63005;84039
FR;0;2022-10-11;620;814;4269;40322;555;3572;40666;40163;6381;54607453;52027680;37501851;6206714;53708209;40717908;6583515;103168;90420
FR;0;2022-10-12;603;858;3268;26759;639;2776;27089;27304;4691;54608056;52028538;37505119;6233473;53708848;40720684;6610604;130472;95111
FR;0;2022-10-13;627;818;4017;38465;609;3138;38924;40609;6607;54608683;52029356;37509136;6271938;53709457;40723822;6649528;171081;101718
FR;0;2022-10-14;761;1074;4873;47668;784;3959;48143;51136;7863;54609444;52030430;37514009;6319606;53710241;40727781;6697671;222217;109581
FR;0;2022-10-15;368;589;1868;11851;428;1630;11965;13091;2274;54609812;52031019;37515877;6331457;53710669;40729411;6709636;235308;111855
FR;0;2022-10-16;94;136;372;1967;86;356;2012;2347;479;54609906;52031155;37516249;6333424;53710755;40729767;6711648;237655;112334
FR;0;2022-10-17;440;712;3044;26466;497;2487;26838;30793;5409;54610346;52031867;37519293;6359890;53711252;40732254;6738486;268448;117743
FR;0;2022-10-18;610;736;4706;46102;535;3762;46667;55450;11701;54610956;52032603;37523999;6405992;53711787;40736016;6785153;323898;129444
FR;0;2022-10-19;570;820;3645;34378;625;3075;34749;42474;9262;54611526;52033423;37527644;6440370;53712412;40739091;6819902;366372;138706
FR;0;2022-10-20;617;807;4843;49466;595;3730;50123;60535;12937;54612143;52034230;37532487;6489836;53713007;40742821;6870025;426907;151643
FR;0;2022-10-21;690;995;5710;57044;710;4519;57714;70966;14299;54612833;52035225;37538197;6546880;53713717;40747340;6927739;497873;165942
FR;0;2022-10-22;335;413;1654;12950;334;1320;13107;15939;3386;54613168;52035638;37539851;6559830;53714051;40748660;6940846;513812;169328
FR;0;2022-10-23;98;107;350;2064;102;266;2166;2758;631;54613266;52035745;37540201;6561894;53714153;40748926;6943012;516570;169959
FR;0;2022-10-24;552;599;3137;27137;424;2687;27565;35497;7810;54613818;52036344;37543338;6589031;53714577;40751613;6970577;552067;177769
FR;0;2022-10-25;598;726;4873;49117;535;3805;49791;65255;15450;54614416;52037070;37548211;6638148;53715112;40755418;7020368;617322;193219
FR;0;2022-10-26;535;645;3475;32622;485;2901;32928;43999;11024;54614951;52037715;37551686;6670770;53715597;40758319;7053296;661321;204243
FR;0;2022-10-27;592;698;4081;40795;499;3348;41272;54476;13137;54615543;52038413;37555767;6711565;53716096;40761667;7094568;715797;217380
FR;0;2022-10-28;705;872;4610;44190;637;3505;45009;58279;13188;54616248;52039285;37560377;6755755;53716733;40765172;7139577;774076;230568
FR;0;2022-10-29;260;364;1328;9499;262;1082;9633;12523;3012;54616508;52039649;37561705;6765254;53716995;40766254;7149210;786599;233580
FR;0;2022-10-30;87;121;287;1598;97;249;1646;2145;540;54616595;52039770;37561992;6766852;53717092;40766503;7150856;788744;234120
FR;0;2022-10-31;381;489;2075;16062;358;1626;16427;22205;5503;54616976;52040259;37564067;6782914;53717450;40768129;7167283;810949;239623
FR;0;2022-11-01;134;196;929;1123;153;963;1166;1697;504;54617110;52040455;37564996;6784037;53717603;40769092;7168449;812646;240127
FR;0;2022-11-02;520;676;3038;25403;506;2584;25881;36653;10142;54617630;52041131;37568034;6809440;53718109;40771676;7194330;849299;250269
FR;0;2022-11-03;645;703;4114;40066;537;3119;40799;57042;15379;54618275;52041834;37572148;6849506;53718646;40774795;7235129;906341;265648
FR;0;2022-11-04;660;831;4426;43660;578;3518;44280;60539;15251;54618935;52042665;37576574;6893166;53719224;40778313;7279409;966880;280899
FR;0;2022-11-05;255;389;1450;9718;312;1166;9927;13466;3295;54619190;52043054;37578024;6902884;53719536;40779479;7289336;980346;284194
FR;0;2022-11-06;94;119;263;1604;102;246;1633;2340;654;54619284;52043173;37578287;6904488;53719638;40779725;7290969;982686;284848
FR;0;2022-11-07;557;608;2763;26770;524;2249;27402;39125;11011;54619841;52043781;37581050;6931258;53720162;40781974;7318371;1021811;295859
FR;0;2022-11-08;677;819;5004;52022;605;3848;53028;74326;20084;54620518;52044600;37586054;6983280;53720767;40785822;7371399;1096137;315943
FR;0;2022-11-09;532;699;3363;31611;523;2691;32387;46364;13233;54621050;52045299;37589417;7014891;53721290;40788513;7403786;1142501;329176
FR;0;2022-11-10;629;1001;4581;43692;751;3639;44591;62882;17360;54621679;52046300;37593998;7058583;53722041;40792152;7448377;1205383;346536
FR;0;2022-11-11;82;123;370;1666;91;313;1729;2800;1012;54621761;52046423;37594368;7060249;53722132;40792465;7450106;1208183;347548
FR;0;2022-11-12;212;353;1195;7102;261;979;7337;10289;2765;54621973;52046776;37595563;7067351;53722393;40793444;7457443;1218472;350313
FR;0;2022-11-13;73;118;249;1208;97;213;1262;1978;628;54622046;52046894;37595812;7068559;53722490;40793657;7458705;1220450;350941
FR;0;2022-11-14;451;531;2590;24005;378;2067;24630;36226;10908;54622497;52047425;37598402;7092564;53722868;40795724;7483335;1256676;361849
FR;0;2022-11-15;625;894;4329;45071;719;3377;46020;66948;19635;54623122;52048319;37602731;7137635;53723587;40799101;7529355;1323624;381484
FR;0;2022-11-16;570;681;3073;28599;553;2579;29137;43274;13324;54623692;52049000;37605804;7166234;53724140;40801680;7558492;1366898;394808
FR;0;2022-11-17;571;691;3830;39264;538;2990;39873;58393;17425;54624263;52049691;37609634;7205498;53724678;40804670;7598365;1425291;412233
FR;0;2022-11-18;628;786;4608;45147;601;3458;46054;65727;18358;54624891;52050477;37614242;7250645;53725279;40808128;7644419;1491018;430591
FR;0;2022-11-19;270;345;1502;9806;278;1098;10001;14329;4015;54625161;52050822;37615744;7260451;53725557;40809226;7654420;1505347;434606
FR;0;2022-11-20;79;190;305;1698;172;262;1772;2717;859;54625240;52051012;37616049;7262149;53725729;40809488;7656192;1508064;435465
FR;0;2022-11-21;437;516;2425;21453;354;1956;22024;33159;10369;54625677;52051528;37618474;7283602;53726083;40811444;7678216;1541223;445834
FR;0;2022-11-22;541;611;4036;39838;438;3171;40414;59804;18268;54626218;52052139;37622510;7323440;53726521;40814615;7718630;1601027;464102
FR;0;2022-11-23;476;569;2759;26031;416;2325;26523;40424;12911;54626694;52052708;37625269;7349471;53726937;40816940;7745153;1641451;477013
FR;0;2022-11-24;517;609;3768;37177;432;2965;37887;56857;17962;54627211;52053317;37629037;7386648;53727369;40819905;7783040;1698308;494975
FR;0;2022-11-25;581;735;4190;40153;589;3151;40996;59639;17481;54627792;52054052;37633227;7426801;53727958;40823056;7824036;1757947;512456
FR;0;2022-11-26;301;339;1335;9371;263;1064;9512;13999;3971;54628093;52054391;37634562;7436172;53728221;40824120;7833548;1771946;516427
FR;0;2022-11-27;74;88;268;1661;70;228;1689;2554;805;54628167;52054479;37634830;7437833;53728291;40824348;7835237;1774500;517232
FR;0;2022-11-28;420;483;2638;24805;364;1982;25545;38472;12203;54628587;52054962;37637468;7462638;53728655;40826330;7860782;1812972;529435
FR;0;2022-11-29;500;613;4401;46527;382;3292;47255;71110;22325;54629087;52055575;37641869;7509165;53729037;40829622;7908037;1884082;551760
FR;0;2022-11-30;509;706;3741;36931;508;2899;37737;56333;17235;54629596;52056281;37645610;7546096;53729545;40832521;7945774;1940415;568995
FR;0;2022-12-01;553;685;5323;51908;464;3915;52719;79733;25272;54630149;52056966;37650933;7598004;53730009;40836436;7998493;2020148;594267
FR;0;2022-12-02;646;751;6174;61545;536;4384;62777;92449;27457;54630795;52057717;37657107;7659549;53730545;40840820;8061270;2112597;621724
FR;0;2022-12-03;305;349;2289;18052;227;1630;18482;26731;7618;54631100;52058066;37659396;7677601;53730772;40842450;8079752;2139328;629342
FR;0;2022-12-04;98;125;524;4305;92;434;4356;6441;1856;54631198;52058191;37659920;7681906;53730864;40842884;8084108;2145769;631198
FR;0;2022-12-05;486;619;4317;44706;455;2928;45675;69053;21915;54631684;52058810;37664237;7726612;53731319;40845812;8129783;2214822;653113
FR;0;2022-12-06;638;777;6858;78307;515;4661;79832;121777;39608;54632322;52059587;37671095;7804919;53731834;40850473;8209615;2336599;692721
FR;0;2022-12-07;560;657;5367;58171;491;3613;59322;90543;29581;54632882;52060244;37676462;7863090;53732325;40854086;8268937;2427142;722302
FR;0;2022-12-08;611;725;6990;79677;465;4594;81370;124181;40873;54633493;52060969;37683452;7942767;53732790;40858680;8350307;2551323;763175
FR;0;2022-12-09;784;848;8684;95694;560;5739;97589;147385;46828;54634277;52061817;37692136;8038461;53733350;40864419;8447896;2698708;810003
FR;0;2022-12-10;410;553;3827;33958;397;2481;34855;50557;14712;54634687;52062370;37695963;8072419;53733747;40866900;8482751;2749265;824715
FR;0;2022-12-11;133;143;994;8364;102;688;8570;12258;3276;54634820;52062513;37696957;8080783;53733849;40867588;8491321;2761523;827991
FR;0;2022-12-12;523;598;6385;67488;389;4139;69081;106299;34850;54635343;52063111;37703342;8148271;53734238;40871727;8560402;2867822;862841
FR;0;2022-12-13;712;795;9054;103614;506;5645;106203;164945;55108;54636055;52063906;37712396;8251885;53734744;40877372;8666605;3032767;917949
FR;0;2022-12-14;594;726;6826;73348;489;4558;75031;117011;38773;54636649;52064632;37719222;8325233;53735233;40881930;8741636;3149778;956722
FR;0;2022-12-15;662;893;8902;95933;582;5727;98248;153333;51776;54637311;52065525;37728124;8421166;53735815;40887657;8839884;3303111;1008498
FR;0;2022-12-16;826;981;9783;104831;655;6464;107073;166541;55330;54638137;52066506;37737907;8525997;53736470;40894121;8946957;3469652;1063828
FR;0;2022-12-17;346;430;3504;31808;295;2296;32598;48448;14450;54638483;52066936;37741411;8557805;53736765;40896417;8979555;3518100;1078278
FR;0;2022-12-18;93;127;791;6335;81;544;6486;9642;2763;54638576;52067063;37742202;8564140;53736846;40896961;8986041;3527742;1081041
FR;0;2022-12-19;593;619;5757;56226;435;3684;57858;90285;30101;54639169;52067682;37747959;8620366;53737281;40900645;9043899;3618027;1111142
FR;0;2022-12-20;746;796;7954;79863;532;5249;82009;130834;45061;54639915;52068478;37755913;8700229;53737813;40905894;9125908;3748861;1156203
FR;0;2022-12-21;602;629;5341;50981;441;3592;52333;84194;29343;54640517;52069107;37761254;8751210;53738254;40909486;9178241;3833055;1185546
FR;0;2022-12-22;647;668;4917;46292;466;3437;47529;76915;26914;54641164;52069775;37766171;8797502;53738720;40912923;9225770;3909970;1212460
FR;0;2022-12-23;479;588;3450;26235;425;2633;26896;43425;14918;54641643;52070363;37769621;8823737;53739145;40915556;9252666;3953395;1227378
FR;0;2022-12-24;105;108;447;2708;80;338;2832;4289;1231;54641748;52070471;37770068;8826445;53739225;40915894;9255498;3957684;1228609
FR;0;2022-12-25;34;43;134;566;34;106;592;926;273;54641782;52070514;37770202;8827011;53739259;40916000;9256090;3958610;1228882
FR;0;2022-12-26;370;393;2500;16947;293;1830;17577;27641;8843;54642152;52070907;37772702;8843958;53739552;40917830;9273667;3986251;1237725
FR;0;2022-12-27;540;662;4220;33739;447;2956;34889;56755;19759;54642692;52071569;37776922;8877697;53739999;40920786;9308556;4043006;1257484
FR;0;2022-12-28;480;523;3242;25722;357;2318;26343;42953;14847;54643172;52072092;37780164;8903419;53740356;40923104;9334899;4085959;1272331
FR;0;2022-12-29;431;549;3424;26589;361;2408;27596;45108;15660;54643603;52072641;37783588;8930008;53740717;40925512;9362495;4131067;1287991
FR;0;2022-12-30;464;506;2632;19576;364;1868;20248;32641;11003;54644067;52073147;37786220;8949584;53741081;40927380;9382743;4163708;1298994
FR;0;2022-12-31;137;157;508;3189;121;413;3333;4945;1338;54644204;52073304;37786728;8952773;53741202;40927793;9386076;4168653;1300332
FR;0;2023-01-01;25;46;177;711;27;150;737;1026;246;54644229;52073350;37786905;8953484;53741229;40927943;9386813;4169679;1300578
FR;0;2023-01-02;905;602;3019;19048;428;2335;19528;33029;12101;54645134;52073952;37789924;8972532;53741657;40930278;9406341;4202708;1312679
FR;0;2023-01-03;672;696;4767;44191;476;3378;45136;82800;34831;54645806;52074648;37794691;9016723;53742133;40933656;9451477;4285508;1347510
FR;0;2023-01-04;546;613;3878;31105;421;2771;31919;59890;25826;54646352;52075261;37798569;9047828;53742554;40936427;9483396;4345398;1373336
FR;0;2023-01-05;668;769;4693;43317;568;3197;44249;84060;37184;54647020;52076030;37803262;9091145;53743122;40939624;9527645;4429458;1410520
FR;0;2023-01-06;753;861;5530;48579;582;3670;49637;92105;39512;54647773;52076891;37808792;9139724;53743704;40943294;9577282;4521563;1450032
FR;0;2023-01-07;350;412;1949;12936;301;1415;13257;23036;8767;54648123;52077303;37810741;9152660;53744005;40944709;9590539;4544599;1458799
FR;0;2023-01-08;105;144;496;2918;100;357;3015;5231;1992;54648228;52077447;37811237;9155578;53744105;40945066;9593554;4549830;1460791
FR;0;2023-01-09;585;640;2866;22351;463;2072;22932;45860;21215;54648813;52078087;37814103;9177929;53744568;40947138;9616486;4595690;1482006
FR;0;2023-01-10;618;809;4825;41577;565;3459;42408;87031;41788;54649431;52078896;37818928;9219506;53745133;40950597;9658894;4682721;1523794
FR;0;2023-01-11;505;604;3147;25104;440;2290;25638;52869;25240;54649936;52079500;37822075;9244610;53745573;40952887;9684532;4735590;1549034
FR;0;2023-01-12;606;697;3985;34351;475;2886;34977;72510;35102;54650542;52080197;37826060;9278961;53746048;40955773;9719509;4808100;1584136
FR;0;2023-01-13;798;815;4385;36237;570;3158;36904;74668;35223;54651340;52081012;37830445;9315198;53746618;40958931;9756413;4882768;1619359
FR;0;2023-01-14;354;346;1590;9310;237;1201;9503;17773;7419;54651694;52081358;37832035;9324508;53746855;40960132;9765916;4900541;1626778
FR;0;2023-01-15;100;136;378;1571;92;290;1682;3268;1415;54651794;52081494;37832413;9326079;53746947;40960422;9767598;4903809;1628193
FR;0;2023-01-16;425;480;2382;16348;333;1789;16610;35994;18105;54652219;52081974;37834795;9342427;53747280;40962211;9784208;4939803;1646298
FR;0;2023-01-17;504;597;3540;29064;412;2568;29627;65751;33910;54652723;52082571;37838335;9371491;53747692;40964779;9813835;5005554;1680208
FR;0;2023-01-18;471;562;2372;17448;409;1840;17763;39175;19886;54653194;52083133;37840707;9388939;53748101;40966619;9831598;5044729;1700094
FR;0;2023-01-19;506;522;2877;23075;356;2142;23420;52307;27018;54653700;52083655;37843584;9412014;53748457;40968761;9855018;5097036;1727112
FR;0;2023-01-20;637;708;3473;25811;508;2628;26296;57784;29431;54654337;52084363;37847057;9437825;53748965;40971389;9881314;5154820;1756543
FR;0;2023-01-21;261;306;1143;6423;221;881;6533;13246;6020;54654598;52084669;37848200;9444248;53749186;40972270;9887847;5168066;1762563
FR;0;2023-01-22;47;65;181;880;34;156;931;1922;874;54654645;52084734;37848381;9445128;53749220;40972426;9888778;5169988;1763437
FR;0;2023-01-23;324;415;1739;11043;273;1304;11268;27228;14820;54654969;52085149;37850120;9456171;53749493;40973730;9900046;5197216;1778257
FR;0;2023-01-24;478;533;2597;20753;377;1945;21056;51080;28342;54655447;52085682;37852717;9476924;53749870;40975675;9921102;5248296;1806599
FR;0;2023-01-25;408;555;1954;12616;398;1483;13047;30758;16453;54655855;52086237;37854671;9489540;53750268;40977158;9934149;5279054;1823052
FR;0;2023-01-26;435;531;2393;17197;385;1796;17510;42508;23429;54656290;52086768;37857064;9506737;53750653;40978954;9951659;5321562;1846481
FR;0;2023-01-27;528;1126;2657;18540;950;2018;18789;45089;24585;54656818;52087894;37859721;9525277;53751603;40980972;9970448;5366651;1871066
FR;0;2023-01-28;237;291;868;4521;234;693;4640;9987;4751;54657055;52088185;37860589;9529798;53751837;40981665;9975088;5376638;1875817
FR;0;2023-01-29;42;72;124;466;55;102;504;1098;548;54657097;52088257;37860713;9530264;53751892;40981767;9975592;5377736;1876365
FR;0;2023-01-30;367;450;1346;8297;322;1113;8491;20958;11438;54657464;52088707;37862059;9538561;53752214;40982880;9984083;5398694;1887803
FR;0;2023-01-31;426;493;2056;14133;335;1536;14385;36907;21265;54657890;52089200;37864115;9552694;53752549;40984416;9998468;5435601;1909068
FR;0;2023-02-01;412;543;1727;8351;416;1472;8511;22222;12614;54658302;52089743;37865842;9561045;53752965;40985888;10006979;5457823;1921682
FR;0;2023-02-02;370;513;1730;11936;355;1438;12145;31724;18274;54658672;52090256;37867572;9572981;53753320;40987326;10019124;5489547;1939956
FR;0;2023-02-03;480;658;2064;12631;492;1648;12809;33770;19458;54659152;52090914;37869636;9585612;53753812;40988974;10031933;5523317;1959414
FR;0;2023-02-04;200;278;672;3138;240;565;3183;7458;3826;54659352;52091192;37870308;9588750;53754052;40989539;10035116;5530775;1963240
FR;0;2023-02-05;25;65;91;245;42;89;261;590;284;54659377;52091257;37870399;9588995;53754094;40989628;10035377;5531365;1963524
FR;0;2023-02-06;312;360;1105;5429;291;868;5615;15395;9057;54659689;52091617;37871504;9594424;53754385;40990496;10040992;5546760;1972581
FR;0;2023-02-07;351;499;1611;9766;368;1323;9937;28261;16935;54660040;52092116;37873115;9604190;53754753;40991819;10050929;5575021;1989516
FR;0;2023-02-08;302;394;1135;6068;312;921;6237;16997;9763;54660342;52092510;37874250;9610258;53755065;40992740;10057166;5592018;1999279
FR;0;2023-02-09;339;475;1308;7926;346;1115;8107;22867;13709;54660681;52092985;37875558;9618184;53755411;40993855;10065273;5614885;2012988
FR;0;2023-02-10;468;550;1522;8361;436;1279;8508;23773;13966;54661149;52093535;37877080;9626545;53755847;40995134;10073781;5638658;2026954
FR;0;2023-02-11;169;225;583;2149;182;512;2237;5435;2770;54661318;52093760;37877663;9628694;53756029;40995646;10076018;5644093;2029724
FR;0;2023-02-12;42;49;62;175;48;56;197;440;208;54661360;52093809;37877725;9628869;53756077;40995702;10076215;5644533;2029932
FR;0;2023-02-13;245;346;756;3358;271;688;3450;9626;5506;54661605;52094155;37878481;9632227;53756348;40996390;10079665;5654159;2035438
FR;0;2023-02-14;300;381;1185;5984;278;1011;6129;17570;10421;54661905;52094536;37879666;9638211;53756626;40997401;10085794;5671729;2045859
FR;0;2023-02-15;293;406;970;4078;301;846;4255;12220;7169;54662198;52094942;37880636;9642289;53756927;40998247;10090049;5683949;2053028
FR;0;2023-02-16;266;404;1163;5206;268;1019;5350;15066;8765;54662464;52095346;37881799;9647495;53757195;40999266;10095399;5699015;2061793
FR;0;2023-02-17;372;476;1320;5481;386;1159;5703;16396;9638;54662836;52095822;37883119;9652976;53757581;41000425;10101102;5715411;2071431
FR;0;2023-02-18;162;218;565;1627;173;494;1697;4063;2051;54662998;52096040;37883684;9654603;53757754;41000919;10102799;5719474;2073482
FR;0;2023-02-19;37;38;49;139;35;40;141;338;167;54663035;52096078;37883733;9654742;53757789;41000959;10102940;5719812;2073649
FR;0;2023-02-20;249;350;719;2861;263;677;2981;8544;4895;54663284;52096428;37884452;9657603;53758052;41001636;10105921;5728356;2078544
FR;0;2023-02-21;270;413;1075;4539;268;939;4747;14014;8281;54663554;52096841;37885527;9662142;53758320;41002575;10110668;5742370;2086825
FR;0;2023-02-22;246;375;741;2948;287;702;2996;9092;5317;54663800;52097216;37886268;9665090;53758607;41003277;10113664;5751462;2092142
FR;0;2023-02-23;227;365;936;4003;251;847;4192;12280;7174;54664027;52097581;37887204;9669093;53758858;41004124;10117856;5763742;2099316
FR;0;2023-02-24;291;472;1049;4414;350;922;4613;13009;7450;54664318;52098053;37888253;9673507;53759208;41005046;10122469;5776751;2106766
FR;0;2023-02-25;126;169;448;1192;148;364;1272;3188;1624;54664444;52098222;37888701;9674699;53759356;41005410;10123741;5779939;2108390
FR;0;2023-02-26;20;28;34;101;28;35;113;256;111;54664464;52098250;37888735;9674800;53759384;41005445;10123854;5780195;2108501
FR;0;2023-02-27;213;329;602;1995;256;584;2066;6560;3945;54664677;52098579;37889337;9676795;53759640;41006029;10125920;5786755;2112446
FR;0;2023-02-28;270;370;841;3587;252;808;3731;12182;7493;54664947;52098949;37890178;9680382;53759892;41006837;10129651;5798937;2119939
FR;0;2023-03-01;227;345;834;1997;284;762;2179;6608;3928;54665174;52099294;37891012;9682379;53760176;41007599;10131830;5805545;2123867
FR;0;2023-03-02;223;318;852;2986;231;730;3203;10080;6261;54665397;52099612;37891864;9685365;53760407;41008329;10135033;5815625;2130128
FR;0;2023-03-03;333;468;1039;3686;356;931;3825;11847;7014;54665730;52100080;37892903;9689051;53760763;41009260;10138858;5827472;2137142
FR;0;2023-03-04;131;218;409;1081;158;392;1096;2792;1372;54665861;52100298;37893312;9690132;53760921;41009652;10139954;5830264;2138514
FR;0;2023-03-05;23;26;29;52;23;32;53;201;113;54665884;52100324;37893341;9690184;53760944;41009684;10140007;5830465;2138627
FR;0;2023-03-06;226;268;539;1418;192;520;1495;4729;2725;54666110;52100592;37893880;9691602;53761136;41010204;10141502;5835194;2141352
FR;0;2023-03-07;190;316;656;2362;220;612;2453;7945;4882;54666300;52100908;37894536;9693964;53761356;41010816;10143955;5843139;2146234
FR;0;2023-03-08;161;286;525;1442;221;465;1551;5005;2922;54666461;52101194;37895061;9695406;53761577;41011281;10145506;5848144;2149156
FR;0;2023-03-09;169;283;633;2005;190;608;2076;7148;4408;54666630;52101477;37895694;9697411;53761767;41011889;10147582;5855292;2153564
FR;0;2023-03-10;323;460;894;2645;344;821;2785;9020;5373;54666953;52101937;37896588;9700056;53762111;41012710;10150367;5864312;2158937
FR;0;2023-03-11;126;178;352;801;136;311;853;2299;1179;54667079;52102115;37896940;9700857;53762247;41013021;10151220;5866611;2160116
FR;0;2023-03-12;10;25;30;62;24;30;63;177;87;54667089;52102140;37896970;9700919;53762271;41013051;10151283;5866788;2160203
FR;0;2023-03-13;144;230;472;1149;175;427;1207;3778;2143;54667233;52102370;37897442;9702068;53762446;41013478;10152490;5870566;2162346
FR;0;2023-03-14;198;282;648;1900;193;635;1979;6801;4136;54667431;52102652;37898090;9703968;53762639;41014113;10154469;5877367;2166482
FR;0;2023-03-15;160;263;514;1254;214;483;1336;4335;2575;54667591;52102915;37898604;9705222;53762853;41014596;10155805;5881702;2169057
FR;0;2023-03-16;174;269;628;1649;200;578;1758;5954;3578;54667765;52103184;37899232;9706871;53763053;41015174;10157563;5887656;2172635
FR;0;2023-03-17;282;361;800;2047;272;720;2190;7336;4398;54668047;52103545;37900032;9708918;53763325;41015894;10159753;5894992;2177033
FR;0;2023-03-18;123;163;452;607;115;440;679;2042;1043;54668170;52103708;37900484;9709525;53763440;41016334;10160432;5897034;2178076
FR;0;2023-03-19;20;20;27;53;21;14;60;126;54;54668190;52103728;37900511;9709578;53763461;41016348;10160492;5897160;2178130
FR;0;2023-03-20;151;263;486;1083;174;490;1159;3826;2190;54668341;52103991;37900997;9710661;53763635;41016838;10161651;5900986;2180320
FR;0;2023-03-21;211;282;670;1630;200;638;1827;6529;3929;54668552;52104273;37901667;9712291;53763835;41017476;10163478;5907515;2184249
FR;0;2023-03-22;195;244;483;1039;191;462;1159;3954;2298;54668747;52104517;37902150;9713330;53764026;41017938;10164637;5911469;2186547
FR;0;2023-03-23;165;241;593;1417;167;536;1509;5203;3079;54668912;52104758;37902743;9714747;53764193;41018474;10166146;5916672;2189626
FR;0;2023-03-24;241;394;925;1787;289;869;1971;6633;3817;54669153;52105152;37903668;9716534;53764482;41019343;10168117;5923305;2193443
FR;0;2023-03-25;127;172;354;575;141;315;650;1794;840;54669280;52105324;37904022;9717109;53764623;41019658;10168767;5925099;2194283
FR;0;2023-03-26;10;18;26;31;12;26;33;92;47;54669290;52105342;37904048;9717140;53764635;41019684;10168800;5925191;2194330
FR;0;2023-03-27;230;256;515;891;209;493;992;3440;1953;54669520;52105598;37904563;9718031;53764844;41020177;10169792;5928631;2196283
FR;0;2023-03-28;186;250;592;1594;170;547;1723;6196;3715;54669706;52105848;37905155;9719625;53765014;41020724;10171515;5934827;2199998
FR;0;2023-03-29;172;253;436;980;165;440;1121;3775;2105;54669878;52106101;37905591;9720605;53765179;41021164;10172636;5938602;2202103
FR;0;2023-03-30;192;242;577;1360;163;564;1528;5389;3116;54670070;52106343;37906168;9721965;53765342;41021728;10174164;5943991;2205219
FR;0;2023-03-31;215;366;721;1795;272;647;1934;6856;4019;54670285;52106709;37906889;9723760;53765614;41022375;10176098;5950847;2209238
FR;0;2023-04-01;109;196;437;594;134;394;698;1982;949;54670394;52106905;37907326;9724354;53765748;41022769;10176796;5952829;2210187
FR;0;2023-04-02;10;26;30;34;14;38;37;116;50;54670404;52106931;37907356;9724388;53765762;41022807;10176833;5952945;2210237
FR;0;2023-04-03;183;213;551;875;158;508;997;3300;1831;54670587;52107144;37907907;9725263;53765920;41023315;10177830;5956245;2212068
FR;0;2023-04-04;131;255;536;1223;175;466;1383;5323;3198;54670718;52107399;37908443;9726486;53766095;41023781;10179213;5961568;2215266
FR;0;2023-04-05;101;199;411;837;141;392;934;3452;1984;54670819;52107598;37908854;9727323;53766236;41024173;10180147;5965020;2217250
FR;0;2023-04-06;153;184;438;1040;129;402;1169;4263;2452;54670972;52107782;37909292;9728363;53766365;41024575;10181316;5969283;2219702
FR;0;2023-04-07;192;307;558;1289;217;524;1421;5068;2849;54671164;52108089;37909850;9729652;53766582;41025099;10182737;5974351;2222551
FR;0;2023-04-08;67;142;238;399;96;237;436;1339;609;54671231;52108231;37910088;9730051;53766678;41025336;10183173;5975690;2223160
FR;0;2023-04-09;9;19;19;15;11;22;20;62;19;54671240;52108250;37910107;9730066;53766689;41025358;10183193;5975752;2223179
FR;0;2023-04-10;12;31;53;35;24;52;49;106;30;54671252;52108281;37910160;9730101;53766713;41025410;10183242;5975858;2223209
FR;0;2023-04-11;125;254;518;994;165;501;1108;4330;2391;54671377;52108535;37910678;9731095;53766878;41025911;10184350;5980188;2225600
FR;0;2023-04-12;131;207;382;740;154;381;809;3254;1865;54671508;52108742;37911060;9731835;53767032;41026292;10185159;5983442;2227465
FR;0;2023-04-13;109;215;408;946;145;400;1035;4229;2455;54671617;52108957;37911468;9732781;53767177;41026692;10186194;5987671;2229920
FR;0;2023-04-14;198;292;633;1239;231;575;1325;5273;3075;54671815;52109249;37912101;9734020;53767408;41027267;10187519;5992944;2232995
FR;0;2023-04-15;75;117;251;416;81;244;452;1483;683;54671890;52109366;37912352;9734436;53767489;41027511;10187971;5994427;2233678
FR;0;2023-04-16;18;19;13;38;15;17;34;110;47;54671908;52109385;37912365;9734474;53767504;41027528;10188005;5994537;2233725
FR;0;2023-04-17;107;192;376;649;132;388;744;3007;1611;54672015;52109577;37912741;9735123;53767636;41027916;10188749;5997544;2235336
FR;0;2023-04-18;149;189;403;872;129;417;970;4172;2381;54672164;52109766;37913144;9735995;53767765;41028333;10189719;6001716;2237717
FR;0;2023-04-19;111;166;291;604;125;274;698;2781;1481;54672275;52109932;37913435;9736599;53767890;41028607;10190417;6004497;2239198
FR;0;2023-04-20;106;190;350;808;135;343;867;3445;1896;54672381;52110122;37913785;9737407;53768025;41028950;10191284;6007942;2241094
FR;0;2023-04-21;146;257;541;989;166;541;1123;4295;2299;54672527;52110379;37914326;9738396;53768191;41029491;10192407;6012237;2243393
FR;0;2023-04-22;56;113;185;271;79;200;300;1113;540;54672583;52110492;37914511;9738667;53768270;41029691;10192707;6013350;2243933
FR;0;2023-04-23;4;8;15;17;7;16;21;64;22;54672587;52110500;37914526;9738684;53768277;41029707;10192728;6013414;2243955
FR;0;2023-04-24;135;177;292;544;124;283;628;2389;1221;54672722;52110677;37914818;9739228;53768401;41029990;10193356;6015803;2245176
FR;0;2023-04-25;120;175;366;824;121;374;887;4057;2215;54672842;52110852;37915184;9740052;53768522;41030364;10194243;6019860;2247391
FR;0;2023-04-26;102;134;275;502;109;274;567;2512;1284;54672944;52110986;37915459;9740554;53768631;41030638;10194810;6022372;2248675
FR;0;2023-04-27;132;171;337;783;117;351;879;3652;1952;54673076;52111157;37915796;9741337;53768748;41030989;10195689;6026024;2250627
FR;0;2023-04-28;191;264;411;850;157;434;978;4269;2187;54673267;52111421;37916207;9742187;53768905;41031423;10196667;6030293;2252814
FR;0;2023-04-29;82;95;155;268;78;138;320;1096;510;54673349;52111516;37916362;9742455;53768983;41031561;10196987;6031389;2253324
FR;0;2023-04-30;7;8;10;10;4;9;12;52;23;54673356;52111524;37916372;9742465;53768987;41031570;10196999;6031441;2253347
FR;0;2023-05-01;14;19;42;11;17;42;14;66;24;54673370;52111543;37916414;9742476;53769004;41031612;10197013;6031507;2253371
FR;0;2023-05-02;202;213;463;641;157;456;758;3510;1821;54673572;52111756;37916877;9743117;53769161;41032068;10197771;6035017;2255192
FR;0;2023-05-03;143;139;274;482;105;279;532;2759;1425;54673715;52111895;37917151;9743599;53769266;41032347;10198303;6037776;2256617
FR;0;2023-05-04;95;167;351;740;126;422;795;3991;2058;54673810;52112062;37917502;9744339;53769392;41032769;10199098;6041767;2258675
FR;0;2023-05-05;125;205;349;783;132;386;868;4444;2345;54673935;52112267;37917851;9745122;53769524;41033155;10199966;6046211;2261020
FR;0;2023-05-06;68;71;124;239;51;143;253;1072;501;54674003;52112338;37917975;9745361;53769575;41033298;10200219;6047283;2261521
FR;0;2023-05-07;9;9;12;21;8;12;23;87;32;54674012;52112347;37917987;9745382;53769583;41033310;10200242;6047370;2261553
FR;0;2023-05-08;20;14;27;18;12;24;42;128;63;54674032;52112361;37918014;9745400;53769595;41033334;10200284;6047498;2261616
FR;0;2023-05-09;85;126;231;557;95;243;612;3466;1741;54674117;52112487;37918245;9745957;53769690;41033577;10200896;6050964;2263357
FR;0;2023-05-10;113;130;198;517;105;240;561;3270;1545;54674230;52112617;37918443;9746474;53769795;41033817;10201457;6054234;2264902
FR;0;2023-05-11;84;108;223;658;85;213;737;3966;1973;54674314;52112725;37918666;9747132;53769880;41034030;10202194;6058200;2266875
FR;0;2023-05-12;93;142;270;773;108;278;810;4458;2133;54674407;52112867;37918936;9747905;53769988;41034308;10203004;6062658;2269008
FR;0;2023-05-13;50;75;111;210;55;123;233;1008;427;54674457;52112942;37919047;9748115;53770043;41034431;10203237;6063666;2269435
FR;0;2023-05-14;15;13;7;14;8;11;15;82;30;54674472;52112955;37919054;9748129;53770051;41034442;10203252;6063748;2269465
FR;0;2023-05-15;64;88;200;476;61;188;526;3257;1539;54674536;52113043;37919254;9748605;53770112;41034630;10203778;6067005;2271004
FR;0;2023-05-16;89;157;225;866;111;245;1015;5994;2882;54674625;52113200;37919479;9749471;53770223;41034875;10204793;6072999;2273886
FR;0;2023-05-17;95;139;203;508;107;201;563;3190;1425;54674720;52113339;37919682;9749979;53770330;41035076;10205356;6076189;2275311
FR;0;2023-05-18;4;8;9;28;6;10;29;163;67;54674724;52113347;37919691;9750007;53770336;41035086;10205385;6076352;2275378
FR;0;2023-05-19;73;133;241;485;93;241;548;2802;1207;54674797;52113480;37919932;9750492;53770429;41035327;10205933;6079154;2276585
FR;0;2023-05-20;46;43;84;122;30;76;141;814;330;54674843;52113523;37920016;9750614;53770459;41035403;10206074;6079968;2276915
FR;0;2023-05-21;11;9;5;15;7;8;16;149;44;54674854;52113532;37920021;9750629;53770466;41035411;10206090;6080117;2276959
FR;0;2023-05-22;88;68;174;465;55;177;529;3168;1435;54674942;52113600;37920195;9751094;53770521;41035588;10206619;6083285;2278394
FR;0;2023-05-23;47;84;187;658;66;171;777;4761;2177;54674989;52113684;37920382;9751752;53770587;41035759;10207396;6088046;2280571
FR;0;2023-05-24;69;87;176;527;72;171;609;3297;1494;54675058;52113771;37920558;9752279;53770659;41035930;10208005;6091343;2282065
FR;0;2023-05-25;76;84;170;560;64;167;630;4576;2090;54675134;52113855;37920728;9752839;53770723;41036097;10208635;6095919;2284155
FR;0;2023-05-26;92;133;203;631;101;209;686;4609;2135;54675226;52113988;37920931;9753470;53770824;41036306;10209321;6100528;2286290
FR;0;2023-05-27;35;64;77;139;46;79;167;858;411;54675261;52114052;37921008;9753609;53770870;41036385;10209488;6101386;2286701
FR;0;2023-05-28;4;5;4;8;7;3;14;69;32;54675265;52114057;37921012;9753617;53770877;41036388;10209502;6101455;2286733
FR;0;2023-05-29;5;7;7;32;4;10;44;304;118;54675270;52114064;37921019;9753649;53770881;41036398;10209546;6101759;2286851
FR;0;2023-05-30;93;101;160;607;70;169;698;4406;1908;54675363;52114165;37921179;9754256;53770951;41036567;10210244;6106165;2288759
FR;0;2023-05-31;69;117;127;486;81;146;577;3465;1569;54675432;52114282;37921306;9754742;53771032;41036713;10210821;6109630;2290328
FR;0;2023-06-01;66;90;184;558;66;188;623;4489;1880;54675498;52114372;37921490;9755300;53771098;41036901;10211444;6114119;2292208
FR;0;2023-06-02;71;116;178;575;76;202;686;4900;2217;54675569;52114488;37921668;9755875;53771174;41037103;10212130;6119019;2294425
FR;0;2023-06-03;26;52;71;157;33;75;181;1025;389;54675595;52114540;37921739;9756032;53771207;41037178;10212311;6120044;2294814
FR;0;2023-06-04;2;17;5;13;14;8;15;103;30;54675597;52114557;37921744;9756045;53771221;41037186;10212326;6120147;2294844
FR;0;2023-06-05;108;90;152;521;68;184;590;3915;1656;54675705;52114647;37921896;9756566;53771289;41037370;10212916;6124062;2296500
FR;0;2023-06-06;90;104;213;679;81;243;794;6296;2640;54675795;52114751;37922109;9757245;53771370;41037613;10213710;6130358;2299140
FR;0;2023-06-07;59;81;135;476;55;129;522;3511;1463;54675854;52114832;37922244;9757721;53771425;41037742;10214232;6133869;2300603
FR;0;2023-06-08;63;69;177;619;53;194;725;5420;2306;54675917;52114901;37922421;9758340;53771478;41037936;10214957;6139289;2302909
FR;0;2023-06-09;68;130;179;525;108;185;574;4637;1944;54675985;52115031;37922600;9758865;53771586;41038121;10215531;6143926;2304853
FR;0;2023-06-10;31;39;63;128;31;60;162;921;349;54676016;52115070;37922663;9758993;53771617;41038181;10215693;6144847;2305202
FR;0;2023-06-11;3;6;5;13;5;7;16;128;52;54676019;52115076;37922668;9759006;53771622;41038188;10215709;6144975;2305254
FR;0;2023-06-12;39;85;139;452;65;142;480;3766;1539;54676058;52115161;37922807;9759458;53771687;41038330;10216189;6148741;2306793
