fra;vaccin;jour;n_dose1;n_dose2;n_cum_dose1;n_cum_dose2
FR;1;2020-12-27;20;0;20;0
FR;1;2020-12-28;71;0;91;0
FR;1;2020-12-29;108;0;199;0
FR;1;2020-12-30;123;0;322;0
FR;1;2020-12-31;88;0;410;0
FR;1;2021-01-01;75;0;485;0
FR;1;2021-01-02;88;0;573;0
FR;1;2021-01-03;92;0;665;0
FR;1;2021-01-04;1479;0;2144;0
FR;1;2021-01-05;5416;0;7560;0
FR;1;2021-01-06;11325;0;18885;0
FR;1;2021-01-07;28588;0;47473;0
FR;1;2021-01-08;36306;0;83779;0
FR;1;2021-01-09;10944;0;94723;0
FR;1;2021-01-10;5640;0;100363;0
FR;1;2021-01-11;39133;0;139496;0
FR;1;2021-01-12;61018;0;200514;0
FR;1;2021-01-13;63951;0;264465;0
FR;1;2021-01-14;79886;0;344351;0
FR;1;2021-01-15;67389;0;411740;0
FR;1;2021-01-16;19568;87;431308;87
FR;1;2021-01-17;10475;42;441783;129
FR;1;2021-01-18;81598;164;523381;293
FR;1;2021-01-19;124090;128;647471;421
FR;1;2021-01-20;130473;160;777944;581
FR;1;2021-01-21;150488;141;928432;722
FR;1;2021-01-22;113963;163;1042395;885
FR;1;2021-01-23;36130;52;1078525;937
FR;1;2021-01-24;9273;28;1087798;965
FR;1;2021-01-25;73313;1219;1161111;2184
FR;1;2021-01-26;95186;3113;1256297;5297
FR;1;2021-01-27;102314;5599;1358611;10896
FR;1;2021-01-28;118982;14361;1477593;25257
FR;1;2021-01-29;87891;17293;1565484;42550
FR;1;2021-01-30;27622;4225;1593106;46775
FR;1;2021-01-31;4875;1679;1597981;48454
FR;1;2021-02-01;48382;21128;1646363;69582
FR;1;2021-02-02;66456;34568;1712819;104150
FR;1;2021-02-03;66036;36961;1778855;141111
FR;1;2021-02-04;75967;50059;1854822;191170
FR;1;2021-02-05;62599;45337;1917421;236507
FR;1;2021-02-06;19090;10396;1936511;246903
FR;1;2021-02-07;3435;5041;1939946;251944
FR;1;2021-02-08;35887;45986;1975833;297930
FR;1;2021-02-09;49977;72392;2025810;370322
FR;1;2021-02-10;50984;76646;2076794;446968
FR;1;2021-02-11;62321;99077;2139115;546045
FR;1;2021-02-12;54983;74038;2194098;620083
FR;1;2021-02-13;15187;19270;2209285;639353
FR;1;2021-02-14;3432;7190;2212717;646543
FR;1;2021-02-15;23603;73440;2236320;719983
FR;1;2021-02-16;32149;96865;2268469;816848
FR;1;2021-02-17;34422;98569;2302891;915417
FR;1;2021-02-18;48285;113473;2351176;1028890
FR;1;2021-02-19;44540;86414;2395716;1115304
FR;1;2021-02-20;13071;26920;2408787;1142224
FR;1;2021-02-21;2119;6287;2410906;1148511
FR;1;2021-02-22;24128;69415;2435034;1217926
FR;1;2021-02-23;36753;80366;2471787;1298292
FR;1;2021-02-24;39498;77662;2511285;1375954
FR;1;2021-02-25;49140;87994;2560425;1463948
FR;1;2021-02-26;46225;67888;2606650;1531836
FR;1;2021-02-27;15248;20931;2621898;1552767
FR;1;2021-02-28;3234;4386;2625132;1557153
FR;1;2021-03-01;38798;49031;2663930;1606184
FR;1;2021-03-02;54785;61506;2718715;1667690
FR;1;2021-03-03;59681;60653;2778396;1728343
FR;1;2021-03-04;71392;64895;2849788;1793238
FR;1;2021-03-05;73328;59275;2923116;1852513
FR;1;2021-03-06;81471;16094;3004587;1868607
FR;1;2021-03-07;63006;5424;3067593;1874031
FR;1;2021-03-08;58925;42480;3126518;1916511
FR;1;2021-03-09;84596;48318;3211114;1964829
FR;1;2021-03-10;89200;48067;3300314;2012896
FR;1;2021-03-11;103430;53867;3403744;2066763
FR;1;2021-03-12;102337;45269;3506081;2112032
FR;1;2021-03-13;87893;12722;3593974;2124754
FR;1;2021-03-14;43754;3031;3637728;2127785
FR;1;2021-03-15;94040;29153;3731768;2156938
FR;1;2021-03-16;122113;34908;3853881;2191846
FR;1;2021-03-17;127715;34869;3981596;2226715
FR;1;2021-03-18;141203;39756;4122799;2266471
FR;1;2021-03-19;134501;32914;4257300;2299385
FR;1;2021-03-20;75082;10212;4332382;2309597
FR;1;2021-03-21;25780;2477;4358162;2312074
FR;1;2021-03-22;113107;31191;4471269;2343265
FR;1;2021-03-23;141172;38176;4612441;2381441
FR;1;2021-03-24;140069;38791;4752510;2420232
FR;1;2021-03-25;163033;39620;4915543;2459852
FR;1;2021-03-26;164490;37500;5080033;2497352
FR;1;2021-03-27;109971;15260;5190004;2512612
FR;1;2021-03-28;41740;3624;5231744;2516236
FR;1;2021-03-29;128463;49970;5360207;2566206
FR;1;2021-03-30;165806;63600;5526013;2629806
FR;1;2021-03-31;169040;66916;5695053;2696722
FR;1;2021-04-01;191468;79256;5886521;2775978
FR;1;2021-04-02;162488;84319;6049009;2860297
FR;1;2021-04-03;87206;58188;6136215;2918485
FR;1;2021-04-04;32344;17733;6168559;2936218
FR;1;2021-04-05;42439;10178;6210998;2946396
FR;1;2021-04-06;157873;100891;6368871;3047287
FR;1;2021-04-07;194332;108272;6563203;3155559
FR;1;2021-04-08;218910;112406;6782113;3267965
FR;1;2021-04-09;211746;107520;6993859;3375485
FR;1;2021-04-10;116004;73465;7109863;3448950
FR;1;2021-04-11;40048;30288;7149911;3479238
FR;1;2021-04-12;166560;103797;7316471;3583035
FR;1;2021-04-13;201228;128263;7517699;3711298
FR;1;2021-04-14;205567;122820;7723266;3834118
FR;1;2021-04-15;218367;126766;7941633;3960884
FR;1;2021-04-16;203927;125155;8145560;4086039
FR;1;2021-04-17;120974;67490;8266534;4153529
FR;1;2021-04-18;35231;20997;8301765;4174526
FR;1;2021-04-19;161925;121935;8463690;4296461
FR;1;2021-04-20;187154;148803;8650844;4445264
FR;1;2021-04-21;191658;146761;8842502;4592025
FR;1;2021-04-22;206420;162652;9048922;4754677
FR;1;2021-04-23;196733;156940;9245655;4911617
FR;1;2021-04-24;125013;95520;9370668;5007137
FR;1;2021-04-25;52882;30144;9423550;5037281
FR;1;2021-04-26;179274;138282;9602824;5175563
FR;1;2021-04-27;219086;162011;9821910;5337574
FR;1;2021-04-28;236156;155142;10058066;5492716
FR;1;2021-04-29;267599;160093;10325665;5652809
FR;1;2021-04-30;269323;148183;10594988;5800992
FR;1;2021-05-01;138242;40719;10733230;5841711
FR;1;2021-05-02;80446;28165;10813676;5869876
FR;1;2021-05-03;247233;146549;11060909;6016425
FR;1;2021-05-04;262593;186879;11323502;6203304
FR;1;2021-05-05;279164;184602;11602666;6387906
FR;1;2021-05-06;305648;183074;11908314;6570980
FR;1;2021-05-07;280797;195760;12189111;6766740
FR;1;2021-05-08;188803;48341;12377914;6815081
FR;1;2021-05-09;113098;36234;12491012;6851315
FR;1;2021-05-10;253153;194296;12744165;7045611
FR;1;2021-05-11;314306;211458;13058471;7257069
FR;1;2021-05-12;349520;185960;13407991;7443029
FR;1;2021-05-13;278294;47678;13686285;7490707
FR;1;2021-05-14;364380;128946;14050665;7619653
FR;1;2021-05-15;292163;66179;14342828;7685832
FR;1;2021-05-16;155523;15588;14498351;7701420
FR;1;2021-05-17;313911;116749;14812262;7818169
FR;1;2021-05-18;374223;111416;15186485;7929585
FR;1;2021-05-19;388787;103021;15575272;8032606
FR;1;2021-05-20;413658;96422;15988930;8129028
FR;1;2021-05-21;392597;97536;16381527;8226564
FR;1;2021-05-22;271752;42192;16653279;8268756
FR;1;2021-05-23;121156;11255;16774435;8280011
FR;1;2021-05-24;239170;26394;17013605;8306405
FR;1;2021-05-25;358858;132082;17372463;8438487
FR;1;2021-05-26;370652;125868;17743115;8564355
FR;1;2021-05-27;399165;128457;18142280;8692812
FR;1;2021-05-28;359745;145743;18502025;8838555
FR;1;2021-05-29;250441;81092;18752466;8919647
FR;1;2021-05-30;99104;22619;18851570;8942266
FR;1;2021-05-31;309268;148973;19160838;9091239
FR;1;2021-06-01;346101;166979;19506939;9258218
FR;1;2021-06-02;347868;153500;19854807;9411718
FR;1;2021-06-03;378356;147941;20233163;9559659
FR;1;2021-06-04;351533;175825;20584696;9735484
FR;1;2021-06-05;253175;112887;20837871;9848371
FR;1;2021-06-06;123254;37572;20961125;9885943
FR;1;2021-06-07;290767;208378;21251892;10094321
FR;1;2021-06-08;324846;224281;21576738;10318602
FR;1;2021-06-09;322879;216724;21899617;10535326
FR;1;2021-06-10;328162;202541;22227779;10737867
FR;1;2021-06-11;301835;235694;22529614;10973561
FR;1;2021-06-12;237927;150986;22767541;11124547
FR;1;2021-06-13;97473;61134;22865014;11185681
FR;1;2021-06-14;198135;289338;23063149;11475019
FR;1;2021-06-15;244549;282757;23307698;11757776
FR;1;2021-06-16;263792;270778;23571490;12028554
FR;1;2021-06-17;258797;244697;23830287;12273251
FR;1;2021-06-18;248633;296343;24078920;12569594
FR;1;2021-06-19;187935;209830;24266855;12779424
FR;1;2021-06-20;67175;89251;24334030;12868675
FR;1;2021-06-21;163566;320350;24497596;13189025
FR;2;2020-12-27;0;0;0;0
FR;2;2020-12-28;0;0;0;0
FR;2;2020-12-29;0;0;0;0
FR;2;2020-12-30;0;0;0;0
FR;2;2020-12-31;0;0;0;0
FR;2;2021-01-01;0;0;0;0
FR;2;2021-01-02;0;0;0;0
FR;2;2021-01-03;0;0;0;0
FR;2;2021-01-04;0;0;0;0
FR;2;2021-01-05;0;0;0;0
FR;2;2021-01-06;0;0;0;0
FR;2;2021-01-07;0;0;0;0
FR;2;2021-01-08;0;0;0;0
FR;2;2021-01-09;0;0;0;0
FR;2;2021-01-10;0;0;0;0
FR;2;2021-01-11;0;0;0;0
FR;2;2021-01-12;0;0;0;0
FR;2;2021-01-13;0;0;0;0
FR;2;2021-01-14;152;0;152;0
FR;2;2021-01-15;218;0;370;0
FR;2;2021-01-16;186;0;556;0
FR;2;2021-01-17;3;0;559;0
FR;2;2021-01-18;2914;0;3473;0
FR;2;2021-01-19;4515;0;7988;0
FR;2;2021-01-20;4922;0;12910;0
FR;2;2021-01-21;5127;0;18037;0
FR;2;2021-01-22;4882;0;22919;0
FR;2;2021-01-23;1734;0;24653;0
FR;2;2021-01-24;102;0;24755;0
FR;2;2021-01-25;3635;0;28390;0
FR;2;2021-01-26;3752;0;32142;0
FR;2;2021-01-27;3443;0;35585;0
FR;2;2021-01-28;3514;0;39099;0
FR;2;2021-01-29;3083;0;42182;0
FR;2;2021-01-30;1064;0;43246;0
FR;2;2021-01-31;0;0;43246;0
FR;2;2021-02-01;3260;0;46506;0
FR;2;2021-02-02;4308;0;50814;0
FR;2;2021-02-03;5032;0;55846;0
FR;2;2021-02-04;4735;4;60581;4
FR;2;2021-02-05;4621;6;65202;10
FR;2;2021-02-06;1931;3;67133;13
FR;2;2021-02-07;42;0;67175;13
FR;2;2021-02-08;7428;8;74603;21
FR;2;2021-02-09;8258;16;82861;37
FR;2;2021-02-10;9142;49;92003;86
FR;2;2021-02-11;10056;67;102059;153
FR;2;2021-02-12;9815;238;111874;391
FR;2;2021-02-13;3017;222;114891;613
FR;2;2021-02-14;296;0;115187;613
FR;2;2021-02-15;3359;3067;118546;3680
FR;2;2021-02-16;4909;3881;123455;7561
FR;2;2021-02-17;4106;4403;127561;11964
FR;2;2021-02-18;5237;5089;132798;17053
FR;2;2021-02-19;5213;4323;138011;21376
FR;2;2021-02-20;1764;1509;139775;22885
FR;2;2021-02-21;197;86;139972;22971
FR;2;2021-02-22;3530;3723;143502;26694
FR;2;2021-02-23;4836;3693;148338;30387
FR;2;2021-02-24;4766;3468;153104;33855
FR;2;2021-02-25;5293;3426;158397;37281
FR;2;2021-02-26;4197;3125;162594;40406
FR;2;2021-02-27;1502;1042;164096;41448
FR;2;2021-02-28;100;28;164196;41476
FR;2;2021-03-01;4963;3764;169159;45240
FR;2;2021-03-02;6309;4727;175468;49967
FR;2;2021-03-03;6245;4883;181713;54850
FR;2;2021-03-04;8073;3967;189786;58817
FR;2;2021-03-05;7769;4060;197555;62877
FR;2;2021-03-06;4621;1682;202176;64559
FR;2;2021-03-07;2284;29;204460;64588
FR;2;2021-03-08;3976;8311;208436;72899
FR;2;2021-03-09;7268;8429;215704;81328
FR;2;2021-03-10;6862;9109;222566;90437
FR;2;2021-03-11;9086;9209;231652;99646
FR;2;2021-03-12;7722;8171;239374;107817
FR;2;2021-03-13;9873;2511;249247;110328
FR;2;2021-03-14;4754;402;254001;110730
FR;2;2021-03-15;10652;3484;264653;114214
FR;2;2021-03-16;16457;4621;281110;118835
FR;2;2021-03-17;19901;3952;301011;122787
FR;2;2021-03-18;22961;4910;323972;127697
FR;2;2021-03-19;22887;4538;346859;132235
FR;2;2021-03-20;25148;1540;372007;133775
FR;2;2021-03-21;17475;147;389482;133922
FR;2;2021-03-22;17401;3078;406883;137000
FR;2;2021-03-23;22271;4183;429154;141183
FR;2;2021-03-24;23554;4988;452708;146171
FR;2;2021-03-25;26281;5022;478989;151193
FR;2;2021-03-26;26592;4262;505581;155455
FR;2;2021-03-27;15639;1309;521220;156764
FR;2;2021-03-28;10396;94;531616;156858
FR;2;2021-03-29;18652;4281;550268;161139
FR;2;2021-03-30;24178;6002;574446;167141
FR;2;2021-03-31;28128;5958;602574;173099
FR;2;2021-04-01;33989;8496;636563;181595
FR;2;2021-04-02;29561;7662;666124;189257
FR;2;2021-04-03;16728;3582;682852;192839
FR;2;2021-04-04;9161;918;692013;193757
FR;2;2021-04-05;12122;811;704135;194568
FR;2;2021-04-06;26769;6933;730904;201501
FR;2;2021-04-07;30585;7174;761489;208675
FR;2;2021-04-08;36502;8818;797991;217493
FR;2;2021-04-09;33399;8602;831390;226095
FR;2;2021-04-10;19453;8969;850843;235064
FR;2;2021-04-11;7817;4272;858660;239336
FR;2;2021-04-12;16808;11255;875468;250591
FR;2;2021-04-13;19114;16426;894582;267017
FR;2;2021-04-14;17675;16285;912257;283302
FR;2;2021-04-15;21858;20757;934115;304059
FR;2;2021-04-16;20398;20073;954513;324132
FR;2;2021-04-17;13058;22462;967571;346594
FR;2;2021-04-18;5785;14405;973356;360999
FR;2;2021-04-19;16484;16263;989840;377262
FR;2;2021-04-20;18999;21595;1008839;398857
FR;2;2021-04-21;19795;21665;1028634;420522
FR;2;2021-04-22;23415;24863;1052049;445385
FR;2;2021-04-23;24217;25352;1076266;470737
FR;2;2021-04-24;25108;15111;1101374;485848
FR;2;2021-04-25;9496;8589;1110870;494437
FR;2;2021-04-26;16908;17196;1127778;511633
FR;2;2021-04-27;19023;24307;1146801;535940
FR;2;2021-04-28;22053;26188;1168854;562128
FR;2;2021-04-29;25212;30137;1194066;592265
FR;2;2021-04-30;25340;27782;1219406;620047
FR;2;2021-05-01;14797;9863;1234203;629910
FR;2;2021-05-02;6519;9184;1240722;639094
FR;2;2021-05-03;19645;19328;1260367;658422
FR;2;2021-05-04;18048;29057;1278415;687479
FR;2;2021-05-05;17999;29415;1296414;716894
FR;2;2021-05-06;23232;35292;1319646;752186
FR;2;2021-05-07;24878;33246;1344524;785432
FR;2;2021-05-08;21000;9705;1365524;795137
FR;2;2021-05-09;13024;7894;1378548;803031
FR;2;2021-05-10;32513;22221;1411061;825252
FR;2;2021-05-11;43069;21079;1454130;846331
FR;2;2021-05-12;49066;19907;1503196;866238
FR;2;2021-05-13;50570;5771;1553766;872009
FR;2;2021-05-14;60507;12957;1614273;884966
FR;2;2021-05-15;65232;7154;1679505;892120
FR;2;2021-05-16;43002;2576;1722507;894696
FR;2;2021-05-17;44113;12592;1766620;907288
FR;2;2021-05-18;53485;12256;1820105;919544
FR;2;2021-05-19;56273;10635;1876378;930179
FR;2;2021-05-20;62494;10900;1938872;941079
FR;2;2021-05-21;63266;11686;2002138;952765
FR;2;2021-05-22;60765;4527;2062903;957292
FR;2;2021-05-23;36963;577;2099866;957869
FR;2;2021-05-24;16832;2033;2116698;959902
FR;2;2021-05-25;20527;12246;2137225;972148
FR;2;2021-05-26;19057;11470;2156282;983618
FR;2;2021-05-27;22437;12672;2178719;996290
FR;2;2021-05-28;28764;14992;2207483;1011282
FR;2;2021-05-29;29960;8191;2237443;1019473
FR;2;2021-05-30;4475;1811;2241918;1021284
FR;2;2021-05-31;28062;18761;2269980;1040045
FR;2;2021-06-01;44469;20077;2314449;1060122
FR;2;2021-06-02;36473;19319;2350922;1079441
FR;2;2021-06-03;50277;23409;2401199;1102850
FR;2;2021-06-04;64396;24107;2465595;1126957
FR;2;2021-06-05;33826;24053;2499421;1151010
FR;2;2021-06-06;4729;6206;2504150;1157216
FR;2;2021-06-07;27488;23113;2531638;1180329
FR;2;2021-06-08;45828;23261;2577466;1203590
FR;2;2021-06-09;33023;21511;2610489;1225101
FR;2;2021-06-10;41069;19162;2651558;1244263
FR;2;2021-06-11;54208;25260;2705766;1269523
FR;2;2021-06-12;29751;19823;2735517;1289346
FR;2;2021-06-13;3108;9190;2738625;1298536
FR;2;2021-06-14;24582;24198;2763207;1322734
FR;2;2021-06-15;38076;22899;2801283;1345633
FR;2;2021-06-16;29362;21553;2830645;1367186
FR;2;2021-06-17;35943;25908;2866588;1393094
FR;2;2021-06-18;45603;28794;2912191;1421888
FR;2;2021-06-19;23820;24924;2936011;1446812
FR;2;2021-06-20;2551;10074;2938562;1456886
FR;2;2021-06-21;16425;42780;2954987;1499666
FR;3;2020-12-27;0;0;0;0
FR;3;2020-12-28;0;0;0;0
FR;3;2020-12-29;0;0;0;0
FR;3;2020-12-30;0;0;0;0
FR;3;2020-12-31;0;0;0;0
FR;3;2021-01-01;0;0;0;0
FR;3;2021-01-02;0;0;0;0
FR;3;2021-01-03;0;0;0;0
FR;3;2021-01-04;0;0;0;0
FR;3;2021-01-05;0;0;0;0
FR;3;2021-01-06;0;0;0;0
FR;3;2021-01-07;0;0;0;0
FR;3;2021-01-08;0;0;0;0
FR;3;2021-01-09;0;0;0;0
FR;3;2021-01-10;0;0;0;0
FR;3;2021-01-11;0;0;0;0
FR;3;2021-01-12;0;0;0;0
FR;3;2021-01-13;0;0;0;0
FR;3;2021-01-14;0;0;0;0
FR;3;2021-01-15;0;0;0;0
FR;3;2021-01-16;0;0;0;0
FR;3;2021-01-17;0;0;0;0
FR;3;2021-01-18;0;0;0;0
FR;3;2021-01-19;0;0;0;0
FR;3;2021-01-20;0;0;0;0
FR;3;2021-01-21;0;0;0;0
FR;3;2021-01-22;0;0;0;0
FR;3;2021-01-23;0;0;0;0
FR;3;2021-01-24;0;0;0;0
FR;3;2021-01-25;0;0;0;0
FR;3;2021-01-26;0;0;0;0
FR;3;2021-01-27;0;0;0;0
FR;3;2021-01-28;0;0;0;0
FR;3;2021-01-29;0;0;0;0
FR;3;2021-01-30;0;0;0;0
FR;3;2021-01-31;0;0;0;0
FR;3;2021-02-01;0;0;0;0
FR;3;2021-02-02;0;0;0;0
FR;3;2021-02-03;0;0;0;0
FR;3;2021-02-04;0;0;0;0
FR;3;2021-02-05;0;0;0;0
FR;3;2021-02-06;332;0;332;0
FR;3;2021-02-07;1348;0;1680;0
FR;3;2021-02-08;2635;0;4315;0
FR;3;2021-02-09;6648;0;10963;0
FR;3;2021-02-10;9246;0;20209;0
FR;3;2021-02-11;13364;0;33573;0
FR;3;2021-02-12;13055;0;46628;0
FR;3;2021-02-13;3518;0;50146;0
FR;3;2021-02-14;870;0;51016;0
FR;3;2021-02-15;10137;0;61153;0
FR;3;2021-02-16;12187;0;73340;0
FR;3;2021-02-17;10825;0;84165;0
FR;3;2021-02-18;14592;0;98757;0
FR;3;2021-02-19;14127;0;112884;0
FR;3;2021-02-20;3184;0;116068;0
FR;3;2021-02-21;544;0;116612;0
FR;3;2021-02-22;8924;0;125536;0
FR;3;2021-02-23;11121;0;136657;0
FR;3;2021-02-24;13916;0;150573;0
FR;3;2021-02-25;44436;0;195009;0
FR;3;2021-02-26;61460;0;256469;0
FR;3;2021-02-27;34505;8;290974;8
FR;3;2021-02-28;2349;0;293323;8
FR;3;2021-03-01;19957;9;313280;17
FR;3;2021-03-02;38377;14;351657;31
FR;3;2021-03-03;47965;18;399622;49
FR;3;2021-03-04;81319;22;480941;71
FR;3;2021-03-05;117210;60;598151;131
FR;3;2021-03-06;119455;51;717606;182
FR;3;2021-03-07;54675;28;772281;210
FR;3;2021-03-08;42183;20;814464;230
FR;3;2021-03-09;78163;31;892627;261
FR;3;2021-03-10;80005;39;972632;300
FR;3;2021-03-11;127407;47;1100039;347
FR;3;2021-03-12;181506;70;1281545;417
FR;3;2021-03-13;131220;56;1412765;473
FR;3;2021-03-14;13816;4;1426581;477
FR;3;2021-03-15;51552;37;1478133;514
FR;3;2021-03-16;941;13;1479074;527
FR;3;2021-03-17;673;6;1479747;533
FR;3;2021-03-18;1232;4;1480979;537
FR;3;2021-03-19;69821;36;1550800;573
FR;3;2021-03-20;64693;38;1615493;611
FR;3;2021-03-21;5523;4;1621016;615
FR;3;2021-03-22;36951;32;1657967;647
FR;3;2021-03-23;83848;50;1741815;697
FR;3;2021-03-24;90214;93;1832029;790
FR;3;2021-03-25;149152;115;1981181;905
FR;3;2021-03-26;164565;155;2145746;1060
FR;3;2021-03-27;67826;90;2213572;1150
FR;3;2021-03-28;6258;19;2219830;1169
FR;3;2021-03-29;53620;60;2273450;1229
FR;3;2021-03-30;92383;88;2365833;1317
FR;3;2021-03-31;62760;82;2428593;1399
FR;3;2021-04-01;85183;103;2513776;1502
FR;3;2021-04-02;86143;147;2599919;1649
FR;3;2021-04-03;35369;109;2635288;1758
FR;3;2021-04-04;3407;15;2638695;1773
FR;3;2021-04-05;4252;21;2642947;1794
FR;3;2021-04-06;29091;76;2672038;1870
FR;3;2021-04-07;31660;60;2703698;1930
FR;3;2021-04-08;77810;234;2781508;2164
FR;3;2021-04-09;160401;409;2941909;2573
FR;3;2021-04-10;74825;331;3016734;2904
FR;3;2021-04-11;7055;44;3023789;2948
FR;3;2021-04-12;50719;197;3074508;3145
FR;3;2021-04-13;85274;315;3159782;3460
FR;3;2021-04-14;66733;341;3226515;3801
FR;3;2021-04-15;91912;369;3318427;4170
FR;3;2021-04-16;111306;571;3429733;4741
FR;3;2021-04-17;52423;327;3482156;5068
FR;3;2021-04-18;9444;32;3491600;5100
FR;3;2021-04-19;24520;234;3516120;5334
FR;3;2021-04-20;44864;394;3560984;5728
FR;3;2021-04-21;38077;450;3599061;6178
FR;3;2021-04-22;53767;791;3652828;6969
FR;3;2021-04-23;69528;1019;3722356;7988
FR;3;2021-04-24;36543;976;3758899;8964
FR;3;2021-04-25;5912;154;3764811;9118
FR;3;2021-04-26;19113;662;3783924;9780
FR;3;2021-04-27;33731;1246;3817655;11026
FR;3;2021-04-28;28298;1925;3845953;12951
FR;3;2021-04-29;44588;5956;3890541;18907
FR;3;2021-04-30;54626;8932;3945167;27839
FR;3;2021-05-01;9187;1968;3954354;29807
FR;3;2021-05-02;2800;500;3957154;30307
FR;3;2021-05-03;12537;3881;3969691;34188
FR;3;2021-05-04;22462;8453;3992153;42641
FR;3;2021-05-05;18057;10574;4010210;53215
FR;3;2021-05-06;33879;20906;4044089;74121
FR;3;2021-05-07;43395;28410;4087484;102531
FR;3;2021-05-08;6362;8898;4093846;111429
FR;3;2021-05-09;1565;2655;4095411;114084
FR;3;2021-05-10;14434;12566;4109845;126650
FR;3;2021-05-11;26410;25737;4136255;152387
FR;3;2021-05-12;16724;27452;4152979;179839
FR;3;2021-05-13;2001;3486;4154980;183325
FR;3;2021-05-14;14066;25742;4169046;209067
FR;3;2021-05-15;6915;20734;4175961;229801
FR;3;2021-05-16;812;2679;4176773;232480
FR;3;2021-05-17;7511;19914;4184284;252394
FR;3;2021-05-18;12915;29634;4197199;282028
FR;3;2021-05-19;8804;31866;4206003;313894
FR;3;2021-05-20;12292;53220;4218295;367114
FR;3;2021-05-21;12250;65540;4230545;432654
FR;3;2021-05-22;4673;33300;4235218;465954
FR;3;2021-05-23;538;2665;4235756;468619
FR;3;2021-05-24;584;4920;4236340;473539
FR;3;2021-05-25;4959;45188;4241299;518727
FR;3;2021-05-26;4573;51055;4245872;569782
FR;3;2021-05-27;5944;77847;4251816;647629
FR;3;2021-05-28;7146;99105;4258962;746734
FR;3;2021-05-29;3073;60285;4262035;807019
FR;3;2021-05-30;381;8243;4262416;815262
FR;3;2021-05-31;2066;36000;4264482;851262
FR;3;2021-06-01;2975;64819;4267457;916081
FR;3;2021-06-02;2368;58361;4269825;974442
FR;3;2021-06-03;3179;87589;4273004;1062031
FR;3;2021-06-04;3849;105129;4276853;1167160
FR;3;2021-06-05;1772;52247;4278625;1219407
FR;3;2021-06-06;263;5400;4278888;1224807
FR;3;2021-06-07;1099;31186;4279987;1255993
FR;3;2021-06-08;2227;47883;4282214;1303876
FR;3;2021-06-09;1405;42454;4283619;1346330
FR;3;2021-06-10;1845;68014;4285464;1414344
FR;3;2021-06-11;2207;96813;4287671;1511157
FR;3;2021-06-12;1003;40841;4288674;1551998
FR;3;2021-06-13;138;3823;4288812;1555821
FR;3;2021-06-14;745;42672;4289557;1598493
FR;3;2021-06-15;1176;80705;4290733;1679198
FR;3;2021-06-16;1027;65787;4291760;1744985
FR;3;2021-06-17;1437;101862;4293197;1846847
FR;3;2021-06-18;1697;117941;4294894;1964788
FR;3;2021-06-19;694;39409;4295588;2004197
FR;3;2021-06-20;74;3384;4295662;2007581
FR;3;2021-06-21;545;39293;4296207;2046874
FR;4;2020-12-27;0;0;0;0
FR;4;2020-12-28;0;0;0;0
FR;4;2020-12-29;0;0;0;0
FR;4;2020-12-30;0;0;0;0
FR;4;2020-12-31;0;0;0;0
FR;4;2021-01-01;0;0;0;0
FR;4;2021-01-02;0;0;0;0
FR;4;2021-01-03;0;0;0;0
FR;4;2021-01-04;0;0;0;0
FR;4;2021-01-05;0;0;0;0
FR;4;2021-01-06;0;0;0;0
FR;4;2021-01-07;0;0;0;0
FR;4;2021-01-08;0;0;0;0
FR;4;2021-01-09;0;0;0;0
FR;4;2021-01-10;0;0;0;0
FR;4;2021-01-11;0;0;0;0
FR;4;2021-01-12;0;0;0;0
FR;4;2021-01-13;0;0;0;0
FR;4;2021-01-14;0;0;0;0
FR;4;2021-01-15;0;0;0;0
FR;4;2021-01-16;0;0;0;0
FR;4;2021-01-17;0;0;0;0
FR;4;2021-01-18;0;0;0;0
FR;4;2021-01-19;0;0;0;0
FR;4;2021-01-20;0;0;0;0
FR;4;2021-01-21;0;0;0;0
FR;4;2021-01-22;0;0;0;0
FR;4;2021-01-23;0;0;0;0
FR;4;2021-01-24;0;0;0;0
FR;4;2021-01-25;0;0;0;0
FR;4;2021-01-26;0;0;0;0
FR;4;2021-01-27;0;0;0;0
FR;4;2021-01-28;0;0;0;0
FR;4;2021-01-29;0;0;0;0
FR;4;2021-01-30;0;0;0;0
FR;4;2021-01-31;0;0;0;0
FR;4;2021-02-01;0;0;0;0
FR;4;2021-02-02;0;0;0;0
FR;4;2021-02-03;0;0;0;0
FR;4;2021-02-04;0;0;0;0
FR;4;2021-02-05;0;0;0;0
FR;4;2021-02-06;0;0;0;0
FR;4;2021-02-07;0;0;0;0
FR;4;2021-02-08;0;0;0;0
FR;4;2021-02-09;0;0;0;0
FR;4;2021-02-10;0;0;0;0
FR;4;2021-02-11;0;0;0;0
FR;4;2021-02-12;0;0;0;0
FR;4;2021-02-13;0;0;0;0
FR;4;2021-02-14;0;0;0;0
FR;4;2021-02-15;0;0;0;0
FR;4;2021-02-16;0;0;0;0
FR;4;2021-02-17;0;0;0;0
FR;4;2021-02-18;0;0;0;0
FR;4;2021-02-19;0;0;0;0
FR;4;2021-02-20;0;0;0;0
FR;4;2021-02-21;0;0;0;0
FR;4;2021-02-22;0;0;0;0
FR;4;2021-02-23;0;0;0;0
FR;4;2021-02-24;0;0;0;0
FR;4;2021-02-25;0;0;0;0
FR;4;2021-02-26;0;0;0;0
FR;4;2021-02-27;0;0;0;0
FR;4;2021-02-28;0;0;0;0
FR;4;2021-03-01;0;0;0;0
FR;4;2021-03-02;0;0;0;0
FR;4;2021-03-03;0;0;0;0
FR;4;2021-03-04;0;0;0;0
FR;4;2021-03-05;0;0;0;0
FR;4;2021-03-06;0;0;0;0
FR;4;2021-03-07;0;0;0;0
FR;4;2021-03-08;0;0;0;0
FR;4;2021-03-09;0;0;0;0
FR;4;2021-03-10;0;0;0;0
FR;4;2021-03-11;0;0;0;0
FR;4;2021-03-12;0;0;0;0
FR;4;2021-03-13;0;0;0;0
FR;4;2021-03-14;0;0;0;0
FR;4;2021-03-15;0;0;0;0
FR;4;2021-03-16;0;0;0;0
FR;4;2021-03-17;0;0;0;0
FR;4;2021-03-18;0;0;0;0
FR;4;2021-03-19;0;0;0;0
FR;4;2021-03-20;0;0;0;0
FR;4;2021-03-21;0;0;0;0
FR;4;2021-03-22;0;0;0;0
FR;4;2021-03-23;0;0;0;0
FR;4;2021-03-24;0;0;0;0
FR;4;2021-03-25;0;0;0;0
FR;4;2021-03-26;0;0;0;0
FR;4;2021-03-27;0;0;0;0
FR;4;2021-03-28;0;0;0;0
FR;4;2021-03-29;0;0;0;0
FR;4;2021-03-30;0;0;0;0
FR;4;2021-03-31;0;0;0;0
FR;4;2021-04-01;0;0;0;0
FR;4;2021-04-02;0;0;0;0
FR;4;2021-04-03;0;0;0;0
FR;4;2021-04-04;0;0;0;0
FR;4;2021-04-05;0;0;0;0
FR;4;2021-04-06;0;0;0;0
FR;4;2021-04-07;0;0;0;0
FR;4;2021-04-08;0;0;0;0
FR;4;2021-04-09;0;1;0;1
FR;4;2021-04-10;0;0;0;1
FR;4;2021-04-11;0;0;0;1
FR;4;2021-04-12;0;0;0;1
FR;4;2021-04-13;0;0;0;1
FR;4;2021-04-14;0;0;0;1
FR;4;2021-04-15;0;0;0;1
FR;4;2021-04-16;0;0;0;1
FR;4;2021-04-17;0;0;0;1
FR;4;2021-04-18;0;0;0;1
FR;4;2021-04-19;0;0;0;1
FR;4;2021-04-20;0;0;0;1
FR;4;2021-04-21;0;0;0;1
FR;4;2021-04-22;0;0;0;1
FR;4;2021-04-23;808;0;808;1
FR;4;2021-04-24;1552;0;2360;1
FR;4;2021-04-25;117;0;2477;1
FR;4;2021-04-26;2831;0;5308;1
FR;4;2021-04-27;9387;4;14695;5
FR;4;2021-04-28;9779;3;24474;8
FR;4;2021-04-29;15890;7;40364;15
FR;4;2021-04-30;19086;7;59450;22
FR;4;2021-05-01;1901;5;61351;27
FR;4;2021-05-02;440;0;61791;27
FR;4;2021-05-03;4928;1;66719;28
FR;4;2021-05-04;8249;8;74968;36
FR;4;2021-05-05;6008;7;80976;43
FR;4;2021-05-06;11258;11;92234;54
FR;4;2021-05-07;18908;8;111142;62
FR;4;2021-05-08;2260;5;113402;67
FR;4;2021-05-09;629;2;114031;69
FR;4;2021-05-10;7097;8;121128;77
FR;4;2021-05-11;14119;12;135247;89
FR;4;2021-05-12;9957;14;145204;103
FR;4;2021-05-13;1441;2;146645;105
FR;4;2021-05-14;7597;8;154242;113
FR;4;2021-05-15;3588;9;157830;122
FR;4;2021-05-16;359;1;158189;123
FR;4;2021-05-17;4347;2;162536;125
FR;4;2021-05-18;8583;10;171119;135
FR;4;2021-05-19;5519;5;176638;140
FR;4;2021-05-20;9221;6;185859;146
FR;4;2021-05-21;12521;27;198380;173
FR;4;2021-05-22;4928;13;203308;186
FR;4;2021-05-23;424;2;203732;188
FR;4;2021-05-24;940;3;204672;191
FR;4;2021-05-25;7396;16;212068;207
FR;4;2021-05-26;7554;12;219622;219
FR;4;2021-05-27;14097;34;233719;253
FR;4;2021-05-28;26257;77;259976;330
FR;4;2021-05-29;11132;20;271108;350
FR;4;2021-05-30;859;2;271967;352
FR;4;2021-05-31;12431;19;284398;371
FR;4;2021-06-01;19816;42;304214;413
FR;4;2021-06-02;14208;34;318422;447
FR;4;2021-06-03;19149;23;337571;470
FR;4;2021-06-04;22098;45;359669;515
FR;4;2021-06-05;9448;28;369117;543
FR;4;2021-06-06;918;0;370035;543
FR;4;2021-06-07;8898;16;378933;559
FR;4;2021-06-08;14259;49;393192;608
FR;4;2021-06-09;11539;423;404731;1031
FR;4;2021-06-10;14947;28;419678;1059
FR;4;2021-06-11;16577;53;436255;1112
FR;4;2021-06-12;7192;26;443447;1138
FR;4;2021-06-13;820;8;444267;1146
FR;4;2021-06-14;6388;22;450655;1168
FR;4;2021-06-15;10551;32;461206;1200
FR;4;2021-06-16;8557;13;469763;1213
FR;4;2021-06-17;10494;27;480257;1240
FR;4;2021-06-18;11943;38;492200;1278
FR;4;2021-06-19;5273;27;497473;1305
FR;4;2021-06-20;570;2;498043;1307
FR;4;2021-06-21;4631;7;502674;1314
FR;0;2020-12-27;20;0;20;0
FR;0;2020-12-28;71;0;91;0
FR;0;2020-12-29;108;0;199;0
FR;0;2020-12-30;123;0;322;0
FR;0;2020-12-31;88;0;410;0
FR;0;2021-01-01;75;0;485;0
FR;0;2021-01-02;88;0;573;0
FR;0;2021-01-03;92;0;665;0
FR;0;2021-01-04;1479;0;2144;0
FR;0;2021-01-05;5416;0;7560;0
FR;0;2021-01-06;11325;0;18885;0
FR;0;2021-01-07;28588;0;47473;0
FR;0;2021-01-08;36306;0;83779;0
FR;0;2021-01-09;10944;0;94723;0
FR;0;2021-01-10;5640;0;100363;0
FR;0;2021-01-11;39133;0;139496;0
FR;0;2021-01-12;61018;0;200514;0
FR;0;2021-01-13;63951;0;264465;0
FR;0;2021-01-14;80038;0;344503;0
FR;0;2021-01-15;67607;0;412110;0
FR;0;2021-01-16;19754;87;431864;87
FR;0;2021-01-17;10478;42;442342;129
FR;0;2021-01-18;84512;164;526854;293
FR;0;2021-01-19;128605;128;655459;421
FR;0;2021-01-20;135395;160;790854;581
FR;0;2021-01-21;155615;141;946469;722
FR;0;2021-01-22;118845;163;1065314;885
FR;0;2021-01-23;37864;52;1103178;937
FR;0;2021-01-24;9375;28;1112553;965
FR;0;2021-01-25;76948;1219;1189501;2184
FR;0;2021-01-26;98938;3113;1288439;5297
FR;0;2021-01-27;105757;5599;1394196;10896
FR;0;2021-01-28;122496;14361;1516692;25257
FR;0;2021-01-29;90974;17293;1607666;42550
FR;0;2021-01-30;28686;4225;1636352;46775
FR;0;2021-01-31;4875;1679;1641227;48454
FR;0;2021-02-01;51642;21128;1692869;69582
FR;0;2021-02-02;70764;34568;1763633;104150
FR;0;2021-02-03;71068;36961;1834701;141111
FR;0;2021-02-04;80702;50063;1915403;191174
FR;0;2021-02-05;67220;45343;1982623;236517
FR;0;2021-02-06;21353;10399;2003976;246916
FR;0;2021-02-07;4825;5041;2008801;251957
FR;0;2021-02-08;45950;45994;2054751;297951
FR;0;2021-02-09;64883;72408;2119634;370359
FR;0;2021-02-10;69372;76695;2189006;447054
FR;0;2021-02-11;85741;99144;2274747;546198
FR;0;2021-02-12;77853;74276;2352600;620474
FR;0;2021-02-13;21722;19492;2374322;639966
FR;0;2021-02-14;4598;7190;2378920;647156
FR;0;2021-02-15;37099;76507;2416019;723663
FR;0;2021-02-16;49245;100746;2465264;824409
FR;0;2021-02-17;49353;102972;2514617;927381
FR;0;2021-02-18;68114;118562;2582731;1045943
FR;0;2021-02-19;63880;90737;2646611;1136680
FR;0;2021-02-20;18019;28429;2664630;1165109
FR;0;2021-02-21;2860;6373;2667490;1171482
FR;0;2021-02-22;36582;73138;2704072;1244620
FR;0;2021-02-23;52710;84059;2756782;1328679
FR;0;2021-02-24;58180;81130;2814962;1409809
FR;0;2021-02-25;98869;91420;2913831;1501229
FR;0;2021-02-26;111882;71013;3025713;1572242
FR;0;2021-02-27;51255;21981;3076968;1594223
FR;0;2021-02-28;5683;4414;3082651;1598637
FR;0;2021-03-01;63718;52804;3146369;1651441
FR;0;2021-03-02;99471;66247;3245840;1717688
FR;0;2021-03-03;113891;65554;3359731;1783242
FR;0;2021-03-04;160784;68884;3520515;1852126
FR;0;2021-03-05;198307;63395;3718822;1915521
FR;0;2021-03-06;205547;17827;3924369;1933348
FR;0;2021-03-07;119965;5481;4044334;1938829
FR;0;2021-03-08;105084;50811;4149418;1989640
FR;0;2021-03-09;170027;56778;4319445;2046418
FR;0;2021-03-10;176067;57215;4495512;2103633
FR;0;2021-03-11;239923;63123;4735435;2166756
FR;0;2021-03-12;291565;53510;5027000;2220266
FR;0;2021-03-13;228986;15289;5255986;2235555
FR;0;2021-03-14;62324;3437;5318310;2238992
FR;0;2021-03-15;156244;32674;5474554;2271666
FR;0;2021-03-16;139511;39542;5614065;2311208
FR;0;2021-03-17;148289;38827;5762354;2350035
FR;0;2021-03-18;165396;44670;5927750;2394705
FR;0;2021-03-19;227209;37488;6154959;2432193
FR;0;2021-03-20;164923;11790;6319882;2443983
FR;0;2021-03-21;48778;2628;6368660;2446611
FR;0;2021-03-22;167459;34301;6536119;2480912
FR;0;2021-03-23;247291;42409;6783410;2523321
FR;0;2021-03-24;253837;43872;7037247;2567193
FR;0;2021-03-25;338466;44757;7375713;2611950
FR;0;2021-03-26;355647;41917;7731360;2653867
FR;0;2021-03-27;193436;16659;7924796;2670526
FR;0;2021-03-28;58394;3737;7983190;2674263
FR;0;2021-03-29;200735;54311;8183925;2728574
FR;0;2021-03-30;282367;69690;8466292;2798264
FR;0;2021-03-31;259928;72956;8726220;2871220
FR;0;2021-04-01;310640;87855;9036860;2959075
FR;0;2021-04-02;278192;92128;9315052;3051203
FR;0;2021-04-03;139303;61879;9454355;3113082
FR;0;2021-04-04;44912;18666;9499267;3131748
FR;0;2021-04-05;58813;11010;9558080;3142758
FR;0;2021-04-06;213733;107900;9771813;3250658
FR;0;2021-04-07;256577;115506;10028390;3366164
FR;0;2021-04-08;333222;121458;10361612;3487622
FR;0;2021-04-09;405546;116532;10767158;3604154
FR;0;2021-04-10;210282;82765;10977440;3686919
FR;0;2021-04-11;54920;34604;11032360;3721523
FR;0;2021-04-12;234087;115249;11266447;3836772
FR;0;2021-04-13;305616;145004;11572063;3981776
FR;0;2021-04-14;289975;139446;11862038;4121222
FR;0;2021-04-15;332137;147892;12194175;4269114
FR;0;2021-04-16;335631;145799;12529806;4414913
FR;0;2021-04-17;186455;90279;12716261;4505192
FR;0;2021-04-18;50460;35434;12766721;4540626
FR;0;2021-04-19;202929;138432;12969650;4679058
FR;0;2021-04-20;251017;170792;13220667;4849850
FR;0;2021-04-21;249530;168876;13470197;5018726
FR;0;2021-04-22;283602;188306;13753799;5207032
FR;0;2021-04-23;291286;183311;14045085;5390343
FR;0;2021-04-24;188216;111607;14233301;5501950
FR;0;2021-04-25;68407;38887;14301708;5540837
FR;0;2021-04-26;218126;156140;14519834;5696977
FR;0;2021-04-27;281227;187568;14801061;5884545
FR;0;2021-04-28;296286;183258;15097347;6067803
FR;0;2021-04-29;353289;196193;15450636;6263996
FR;0;2021-04-30;368375;184904;15819011;6448900
FR;0;2021-05-01;164127;52555;15983138;6501455
FR;0;2021-05-02;90205;37849;16073343;6539304
FR;0;2021-05-03;284343;169759;16357686;6709063
FR;0;2021-05-04;311352;224397;16669038;6933460
FR;0;2021-05-05;321228;224598;16990266;7158058
FR;0;2021-05-06;374017;239283;17364283;7397341
FR;0;2021-05-07;367978;257424;17732261;7654765
FR;0;2021-05-08;218425;66949;17950686;7721714
FR;0;2021-05-09;128316;46785;18079002;7768499
FR;0;2021-05-10;307197;229091;18386199;7997590
FR;0;2021-05-11;397904;258286;18784103;8255876
FR;0;2021-05-12;425267;233333;19209370;8489209
FR;0;2021-05-13;332306;56937;19541676;8546146
FR;0;2021-05-14;446550;167653;19988226;8713799
FR;0;2021-05-15;367898;94076;20356124;8807875
FR;0;2021-05-16;199696;20844;20555820;8828719
FR;0;2021-05-17;369882;149257;20925702;8977976
FR;0;2021-05-18;449206;153316;21374908;9131292
FR;0;2021-05-19;459383;145527;21834291;9276819
FR;0;2021-05-20;497665;160548;22331956;9437367
FR;0;2021-05-21;480634;174789;22812590;9612156
FR;0;2021-05-22;342118;80032;23154708;9692188
FR;0;2021-05-23;159081;14499;23313789;9706687
FR;0;2021-05-24;257526;33350;23571315;9740037
FR;0;2021-05-25;391740;189532;23963055;9929569
FR;0;2021-05-26;401836;188405;24364891;10117974
FR;0;2021-05-27;441643;219010;24806534;10336984
FR;0;2021-05-28;421912;259917;25228446;10596901
FR;0;2021-05-29;294606;149588;25523052;10746489
FR;0;2021-05-30;104819;32675;25627871;10779164
FR;0;2021-05-31;351827;203753;25979698;10982917
FR;0;2021-06-01;413361;251917;26393059;11234834
FR;0;2021-06-02;400917;231214;26793976;11466048
FR;0;2021-06-03;450961;258962;27244937;11725010
FR;0;2021-06-04;441876;305106;27686813;12030116
FR;0;2021-06-05;298221;189215;27985034;12219331
FR;0;2021-06-06;129164;49178;28114198;12268509
FR;0;2021-06-07;328252;262693;28442450;12531202
FR;0;2021-06-08;387160;295474;28829610;12826676
FR;0;2021-06-09;368846;281112;29198456;13107788
FR;0;2021-06-10;386023;289745;29584479;13397533
FR;0;2021-06-11;374827;357820;29959306;13755353
FR;0;2021-06-12;275873;211676;30235179;13967029
FR;0;2021-06-13;101539;74155;30336718;14041184
FR;0;2021-06-14;229850;356230;30566568;14397414
FR;0;2021-06-15;294352;386393;30860920;14783807
FR;0;2021-06-16;302738;358131;31163658;15141938
FR;0;2021-06-17;306671;372494;31470329;15514432
FR;0;2021-06-18;307876;443116;31778205;15957548
FR;0;2021-06-19;217722;274190;31995927;16231738
FR;0;2021-06-20;70370;102711;32066297;16334449
FR;0;2021-06-21;185167;402430;32251464;16736879
