fra;vaccin;jour;n_dose1;n_dose2;n_cum_dose1;n_cum_dose2
FR;1;2020-12-27;21;0;21;0
FR;1;2020-12-28;77;0;98;0
FR;1;2020-12-29;108;0;206;0
FR;1;2020-12-30;126;0;332;0
FR;1;2020-12-31;88;0;420;0
FR;1;2021-01-01;76;0;496;0
FR;1;2021-01-02;93;0;589;0
FR;1;2021-01-03;99;0;688;0
FR;1;2021-01-04;1483;0;2171;0
FR;1;2021-01-05;5445;0;7616;0
FR;1;2021-01-06;11342;0;18958;0
FR;1;2021-01-07;28711;0;47669;0
FR;1;2021-01-08;36381;0;84050;0
FR;1;2021-01-09;10967;0;95017;0
FR;1;2021-01-10;5653;0;100670;0
FR;1;2021-01-11;39193;0;139863;0
FR;1;2021-01-12;61118;0;200981;0
FR;1;2021-01-13;64064;0;265045;0
FR;1;2021-01-14;80013;0;345058;0
FR;1;2021-01-15;67504;0;412562;0
FR;1;2021-01-16;19573;78;432135;78
FR;1;2021-01-17;10484;42;442619;120
FR;1;2021-01-18;81694;162;524313;282
FR;1;2021-01-19;124218;125;648531;407
FR;1;2021-01-20;130646;157;779177;564
FR;1;2021-01-21;150700;135;929877;699
FR;1;2021-01-22;114203;162;1044080;861
FR;1;2021-01-23;36170;50;1080250;911
FR;1;2021-01-24;9285;27;1089535;938
FR;1;2021-01-25;73426;1219;1162961;2157
FR;1;2021-01-26;95255;3110;1258216;5267
FR;1;2021-01-27;102407;5596;1360623;10863
FR;1;2021-01-28;119143;14360;1479766;25223
FR;1;2021-01-29;87989;17282;1567755;42505
FR;1;2021-01-30;27650;4225;1595405;46730
FR;1;2021-01-31;4884;1679;1600289;48409
FR;1;2021-02-01;48441;21124;1648730;69533
FR;1;2021-02-02;66515;34560;1715245;104093
FR;1;2021-02-03;66089;36959;1781334;141052
FR;1;2021-02-04;76019;50046;1857353;191098
FR;1;2021-02-05;62655;45332;1920008;236430
FR;1;2021-02-06;19104;10398;1939112;246828
FR;1;2021-02-07;3439;5042;1942551;251870
FR;1;2021-02-08;35918;45971;1978469;297841
FR;1;2021-02-09;50018;72394;2028487;370235
FR;1;2021-02-10;51015;76682;2079502;446917
FR;1;2021-02-11;62408;99079;2141910;545996
FR;1;2021-02-12;55050;73981;2196960;619977
FR;1;2021-02-13;15198;19270;2212158;639247
FR;1;2021-02-14;3437;7191;2215595;646438
FR;1;2021-02-15;23670;73447;2239265;719885
FR;1;2021-02-16;32193;96861;2271458;816746
FR;1;2021-02-17;34494;98591;2305952;915337
FR;1;2021-02-18;48372;113444;2354324;1028781
FR;1;2021-02-19;44641;86436;2398965;1115217
FR;1;2021-02-20;13081;26920;2412046;1142137
FR;1;2021-02-21;2125;6286;2414171;1148423
FR;1;2021-02-22;24141;69427;2438312;1217850
FR;1;2021-02-23;36788;80371;2475100;1298221
FR;1;2021-02-24;39544;77655;2514644;1375876
FR;1;2021-02-25;49181;87974;2563825;1463850
FR;1;2021-02-26;46307;67890;2610132;1531740
FR;1;2021-02-27;15257;20932;2625389;1552672
FR;1;2021-02-28;3239;4386;2628628;1557058
FR;1;2021-03-01;38869;49018;2667497;1606076
FR;1;2021-03-02;54833;61513;2722330;1667589
FR;1;2021-03-03;59753;60654;2782083;1728243
FR;1;2021-03-04;71485;64900;2853568;1793143
FR;1;2021-03-05;73394;59249;2926962;1852392
FR;1;2021-03-06;81546;16090;3008508;1868482
FR;1;2021-03-07;63030;5415;3071538;1873897
FR;1;2021-03-08;58996;42469;3130534;1916366
FR;1;2021-03-09;84664;48320;3215198;1964686
FR;1;2021-03-10;89295;48072;3304493;2012758
FR;1;2021-03-11;103489;53857;3407982;2066615
FR;1;2021-03-12;102480;45291;3510462;2111906
FR;1;2021-03-13;87966;12745;3598428;2124651
FR;1;2021-03-14;43765;3031;3642193;2127682
FR;1;2021-03-15;94110;29128;3736303;2156810
FR;1;2021-03-16;122204;34895;3858507;2191705
FR;1;2021-03-17;127853;34836;3986360;2226541
FR;1;2021-03-18;141317;39719;4127677;2266260
FR;1;2021-03-19;134634;32908;4262311;2299168
FR;1;2021-03-20;75116;10209;4337427;2309377
FR;1;2021-03-21;25802;2476;4363229;2311853
FR;1;2021-03-22;113197;31182;4476426;2343035
FR;1;2021-03-23;141326;38178;4617752;2381213
FR;1;2021-03-24;140260;38777;4758012;2419990
FR;1;2021-03-25;163238;39629;4921250;2459619
FR;1;2021-03-26;164920;37498;5086170;2497117
FR;1;2021-03-27;110035;15255;5196205;2512372
FR;1;2021-03-28;41762;3621;5237967;2515993
FR;1;2021-03-29;128600;49962;5366567;2565955
FR;1;2021-03-30;165996;63598;5532563;2629553
FR;1;2021-03-31;169255;66904;5701818;2696457
FR;1;2021-04-01;191783;79267;5893601;2775724
FR;1;2021-04-02;162772;84323;6056373;2860047
FR;1;2021-04-03;87265;58177;6143638;2918224
FR;1;2021-04-04;32376;17733;6176014;2935957
FR;1;2021-04-05;42476;10176;6218490;2946133
FR;1;2021-04-06;158062;100892;6376552;3047025
FR;1;2021-04-07;194611;108264;6571163;3155289
FR;1;2021-04-08;219263;112391;6790426;3267680
FR;1;2021-04-09;212086;107512;7002512;3375192
FR;1;2021-04-10;116049;73458;7118561;3448650
FR;1;2021-04-11;40072;30286;7158633;3478936
FR;1;2021-04-12;166734;103792;7325367;3582728
FR;1;2021-04-13;201518;128254;7526885;3710982
FR;1;2021-04-14;205860;122813;7732745;3833795
FR;1;2021-04-15;218623;126761;7951368;3960556
FR;1;2021-04-16;204166;125147;8155534;4085703
FR;1;2021-04-17;121066;67485;8276600;4153188
FR;1;2021-04-18;35267;20993;8311867;4174181
FR;1;2021-04-19;162059;121926;8473926;4296107
FR;1;2021-04-20;187383;148781;8661309;4444888
FR;1;2021-04-21;191889;146720;8853198;4591608
FR;1;2021-04-22;206697;162653;9059895;4754261
FR;1;2021-04-23;197041;156935;9256936;4911196
FR;1;2021-04-24;125127;95511;9382063;5006707
FR;1;2021-04-25;52925;30140;9434988;5036847
FR;1;2021-04-26;179474;138283;9614462;5175130
FR;1;2021-04-27;219275;161996;9833737;5337126
FR;1;2021-04-28;236352;155123;10070089;5492249
FR;1;2021-04-29;267863;160079;10337952;5652328
FR;1;2021-04-30;269593;148162;10607545;5800490
FR;1;2021-05-01;138523;40713;10746068;5841203
FR;1;2021-05-02;80564;28155;10826632;5869358
FR;1;2021-05-03;247601;146483;11074233;6015841
FR;1;2021-05-04;262878;186853;11337111;6202694
FR;1;2021-05-05;279752;184584;11616863;6387278
FR;1;2021-05-06;306267;183047;11923130;6570325
FR;1;2021-05-07;281323;195744;12204453;6766069
FR;1;2021-05-08;189688;48342;12394141;6814411
FR;1;2021-05-09;113217;36221;12507358;6850632
FR;1;2021-05-10;253742;194280;12761100;7044912
FR;1;2021-05-11;315519;211418;13076619;7256330
FR;1;2021-05-12;352281;185920;13428900;7442250
FR;1;2021-05-13;279928;47655;13708828;7489905
FR;1;2021-05-14;366561;128909;14075389;7618814
FR;1;2021-05-15;294362;66157;14369751;7684971
FR;1;2021-05-16;156397;15583;14526148;7700554
FR;1;2021-05-17;315919;116709;14842067;7817263
FR;1;2021-05-18;378637;111350;15220704;7928613
FR;1;2021-05-19;391443;102930;15612147;8031543
FR;1;2021-05-20;416697;96330;16028844;8127873
FR;1;2021-05-21;395576;97399;16424420;8225272
FR;1;2021-05-22;273646;42109;16698066;8267381
FR;1;2021-05-23;122048;11216;16820114;8278597
FR;1;2021-05-24;241527;26325;17061641;8304922
FR;1;2021-05-25;362235;131962;17423876;8436884
FR;1;2021-05-26;376519;125724;17800395;8562608
FR;1;2021-05-27;402341;128248;18202736;8690856
FR;1;2021-05-28;362071;145608;18564807;8836464
FR;1;2021-05-29;252113;80997;18816920;8917461
FR;1;2021-05-30;99884;22579;18916804;8940040
FR;1;2021-05-31;310568;148899;19227372;9088939
FR;1;2021-06-01;348518;166891;19575890;9255830
FR;1;2021-06-02;350718;153424;19926608;9409254
FR;1;2021-06-03;380112;147862;20306720;9557116
FR;1;2021-06-04;352954;175767;20659674;9732883
FR;1;2021-06-05;254086;112842;20913760;9845725
FR;1;2021-06-06;123824;37562;21037584;9883287
FR;1;2021-06-07;292177;208331;21329761;10091618
FR;1;2021-06-08;321618;221220;21651379;10312838
FR;1;2021-06-09;327578;212792;21978957;10525630
FR;1;2021-06-10;330446;202468;22309403;10728098
FR;1;2021-06-11;303472;235649;22612875;10963747
FR;1;2021-06-12;239076;150957;22851951;11114704
FR;1;2021-06-13;97717;61118;22949668;11175822
FR;1;2021-06-14;199523;289303;23149191;11465125
FR;1;2021-06-15;245965;282715;23395156;11747840
FR;1;2021-06-16;265140;270710;23660296;12018550
FR;1;2021-06-17;260074;244647;23920370;12263197
FR;1;2021-06-18;249927;296290;24170297;12559487
FR;1;2021-06-19;189104;209788;24359401;12769275
FR;1;2021-06-20;67474;89237;24426875;12858512
FR;1;2021-06-21;164717;320301;24591592;13178813
FR;1;2021-06-22;178262;347954;24769854;13526767
FR;1;2021-06-23;196288;339710;24966142;13866477
FR;1;2021-06-24;194074;282054;25160216;14148531
FR;1;2021-06-25;175009;372227;25335225;14520758
FR;1;2021-06-26;128036;278615;25463261;14799373
FR;1;2021-06-27;50934;123100;25514195;14922473
FR;1;2021-06-28;130291;368678;25644486;15291151
FR;1;2021-06-29;148270;389770;25792756;15680921
FR;1;2021-06-30;171741;378503;25964497;16059424
FR;1;2021-07-01;179845;332486;26144342;16391910
FR;1;2021-07-02;173998;368101;26318340;16760011
FR;1;2021-07-03;120221;280796;26438561;17040807
FR;1;2021-07-04;51848;113829;26490409;17154636
FR;1;2021-07-05;142121;356484;26632530;17511120
FR;1;2021-07-06;163902;382992;26796432;17894112
FR;1;2021-07-07;178404;363074;26974836;18257186
FR;1;2021-07-08;191583;323428;27166419;18580614
FR;1;2021-07-09;791;16;27167210;18580630
FR;1;2021-07-10;124957;281226;27292167;18861856
FR;1;2021-07-11;55696;102569;27347863;18964425
FR;2;2020-12-27;0;0;0;0
FR;2;2020-12-28;0;0;0;0
FR;2;2020-12-29;0;0;0;0
FR;2;2020-12-30;0;0;0;0
FR;2;2020-12-31;0;0;0;0
FR;2;2021-01-01;0;0;0;0
FR;2;2021-01-02;0;0;0;0
FR;2;2021-01-03;0;0;0;0
FR;2;2021-01-04;0;0;0;0
FR;2;2021-01-05;0;0;0;0
FR;2;2021-01-06;0;0;0;0
FR;2;2021-01-07;0;0;0;0
FR;2;2021-01-08;0;0;0;0
FR;2;2021-01-09;0;0;0;0
FR;2;2021-01-10;0;0;0;0
FR;2;2021-01-11;0;0;0;0
FR;2;2021-01-12;0;0;0;0
FR;2;2021-01-13;0;0;0;0
FR;2;2021-01-14;154;0;154;0
FR;2;2021-01-15;218;0;372;0
FR;2;2021-01-16;185;0;557;0
FR;2;2021-01-17;4;0;561;0
FR;2;2021-01-18;2917;0;3478;0
FR;2;2021-01-19;4527;0;8005;0
FR;2;2021-01-20;4924;0;12929;0
FR;2;2021-01-21;5132;0;18061;0
FR;2;2021-01-22;4885;0;22946;0
FR;2;2021-01-23;1737;0;24683;0
FR;2;2021-01-24;102;0;24785;0
FR;2;2021-01-25;3643;0;28428;0
FR;2;2021-01-26;3756;0;32184;0
FR;2;2021-01-27;3446;0;35630;0
FR;2;2021-01-28;3518;0;39148;0
FR;2;2021-01-29;3083;0;42231;0
FR;2;2021-01-30;1064;0;43295;0
FR;2;2021-01-31;0;0;43295;0
FR;2;2021-02-01;3265;0;46560;0
FR;2;2021-02-02;4310;0;50870;0
FR;2;2021-02-03;5034;0;55904;0
FR;2;2021-02-04;4735;3;60639;3
FR;2;2021-02-05;4622;6;65261;9
FR;2;2021-02-06;1932;3;67193;12
FR;2;2021-02-07;42;0;67235;12
FR;2;2021-02-08;7429;8;74664;20
FR;2;2021-02-09;8265;15;82929;35
FR;2;2021-02-10;9144;49;92073;84
FR;2;2021-02-11;10062;67;102135;151
FR;2;2021-02-12;9819;238;111954;389
FR;2;2021-02-13;3021;222;114975;611
FR;2;2021-02-14;296;0;115271;611
FR;2;2021-02-15;3359;3067;118630;3678
FR;2;2021-02-16;4927;3881;123557;7559
FR;2;2021-02-17;4110;4402;127667;11961
FR;2;2021-02-18;5244;5089;132911;17050
FR;2;2021-02-19;5220;4323;138131;21373
FR;2;2021-02-20;1765;1509;139896;22882
FR;2;2021-02-21;199;86;140095;22968
FR;2;2021-02-22;3539;3722;143634;26690
FR;2;2021-02-23;4838;3693;148472;30383
FR;2;2021-02-24;4781;3468;153253;33851
FR;2;2021-02-25;5292;3426;158545;37277
FR;2;2021-02-26;4197;3125;162742;40402
FR;2;2021-02-27;1504;1042;164246;41444
FR;2;2021-02-28;101;28;164347;41472
FR;2;2021-03-01;4967;3764;169314;45236
FR;2;2021-03-02;6313;4727;175627;49963
FR;2;2021-03-03;6249;4883;181876;54846
FR;2;2021-03-04;8080;3966;189956;58812
FR;2;2021-03-05;7774;4060;197730;62872
FR;2;2021-03-06;4622;1683;202352;64555
FR;2;2021-03-07;2285;29;204637;64584
FR;2;2021-03-08;3978;8311;208615;72895
FR;2;2021-03-09;7274;8430;215889;81325
FR;2;2021-03-10;6864;9108;222753;90433
FR;2;2021-03-11;9094;9208;231847;99641
FR;2;2021-03-12;7727;8162;239574;107803
FR;2;2021-03-13;9880;2511;249454;110314
FR;2;2021-03-14;4754;402;254208;110716
FR;2;2021-03-15;10654;3484;264862;114200
FR;2;2021-03-16;16467;4621;281329;118821
FR;2;2021-03-17;19907;3953;301236;122774
FR;2;2021-03-18;22964;4910;324200;127684
FR;2;2021-03-19;22899;4537;347099;132221
FR;2;2021-03-20;25163;1540;372262;133761
FR;2;2021-03-21;17478;147;389740;133908
FR;2;2021-03-22;17415;3079;407155;136987
FR;2;2021-03-23;22289;4184;429444;141171
FR;2;2021-03-24;23563;4987;453007;146158
FR;2;2021-03-25;26295;5020;479302;151178
FR;2;2021-03-26;26597;4262;505899;155440
FR;2;2021-03-27;15641;1308;521540;156748
FR;2;2021-03-28;10400;92;531940;156840
FR;2;2021-03-29;18666;4281;550606;161121
FR;2;2021-03-30;24191;6019;574797;167140
FR;2;2021-03-31;28152;5954;602949;173094
FR;2;2021-04-01;34015;8479;636964;181573
FR;2;2021-04-02;29575;7686;666539;189259
FR;2;2021-04-03;16739;3583;683278;192842
FR;2;2021-04-04;9165;919;692443;193761
FR;2;2021-04-05;12136;811;704579;194572
FR;2;2021-04-06;26785;6927;731364;201499
FR;2;2021-04-07;30603;7157;761967;208656
FR;2;2021-04-08;36513;8819;798480;217475
FR;2;2021-04-09;33409;8597;831889;226072
FR;2;2021-04-10;19466;8969;851355;235041
FR;2;2021-04-11;7819;4271;859174;239312
FR;2;2021-04-12;16817;11254;875991;250566
FR;2;2021-04-13;19136;16426;895127;266992
FR;2;2021-04-14;17681;16280;912808;283272
FR;2;2021-04-15;21871;20757;934679;304029
FR;2;2021-04-16;20409;20078;955088;324107
FR;2;2021-04-17;13062;22462;968150;346569
FR;2;2021-04-18;5792;14403;973942;360972
FR;2;2021-04-19;16497;16254;990439;377226
FR;2;2021-04-20;18995;21590;1009434;398816
FR;2;2021-04-21;19869;21666;1029303;420482
FR;2;2021-04-22;23428;24858;1052731;445340
FR;2;2021-04-23;24232;25351;1076963;470691
FR;2;2021-04-24;25105;15106;1102068;485797
FR;2;2021-04-25;9502;8589;1111570;494386
FR;2;2021-04-26;16923;17199;1128493;511585
FR;2;2021-04-27;19033;24308;1147526;535893
FR;2;2021-04-28;22073;26184;1169599;562077
FR;2;2021-04-29;25214;30133;1194813;592210
FR;2;2021-04-30;25351;27778;1220164;619988
FR;2;2021-05-01;14820;9861;1234984;629849
FR;2;2021-05-02;6535;9184;1241519;639033
FR;2;2021-05-03;19691;19323;1261210;658356
FR;2;2021-05-04;18066;29058;1279276;687414
FR;2;2021-05-05;18023;29410;1297299;716824
FR;2;2021-05-06;23250;35289;1320549;752113
FR;2;2021-05-07;24914;33226;1345463;785339
FR;2;2021-05-08;21057;9701;1366520;795040
FR;2;2021-05-09;13036;7893;1379556;802933
FR;2;2021-05-10;32576;22218;1412132;825151
FR;2;2021-05-11;43202;21073;1455334;846224
FR;2;2021-05-12;49448;19901;1504782;866125
FR;2;2021-05-13;50842;5768;1555624;871893
FR;2;2021-05-14;60906;12954;1616530;884847
FR;2;2021-05-15;65503;7151;1682033;891998
FR;2;2021-05-16;43275;2576;1725308;894574
FR;2;2021-05-17;44334;12588;1769642;907162
FR;2;2021-05-18;54136;12245;1823778;919407
FR;2;2021-05-19;56688;10619;1880466;930026
FR;2;2021-05-20;62864;10876;1943330;940902
FR;2;2021-05-21;63749;11667;2007079;952569
FR;2;2021-05-22;61139;4514;2068218;957083
FR;2;2021-05-23;37204;570;2105422;957653
FR;2;2021-05-24;16929;2028;2122351;959681
FR;2;2021-05-25;20702;12240;2143053;971921
FR;2;2021-05-26;19410;11463;2162463;983384
FR;2;2021-05-27;22568;12665;2185031;996049
FR;2;2021-05-28;28937;14983;2213968;1011032
FR;2;2021-05-29;30145;8183;2244113;1019215
FR;2;2021-05-30;4513;1812;2248626;1021027
FR;2;2021-05-31;28201;18758;2276827;1039785
FR;2;2021-06-01;44795;20076;2321622;1059861
FR;2;2021-06-02;36782;19314;2358404;1079175
FR;2;2021-06-03;50526;23396;2408930;1102571
FR;2;2021-06-04;64719;24102;2473649;1126673
FR;2;2021-06-05;34087;24045;2507736;1150718
FR;2;2021-06-06;4763;6204;2512499;1156922
FR;2;2021-06-07;27658;23105;2540157;1180027
FR;2;2021-06-08;45555;22964;2585712;1202991
FR;2;2021-06-09;33691;20915;2619403;1223906
FR;2;2021-06-10;41628;19159;2661031;1243065
FR;2;2021-06-11;54379;25254;2715410;1268319
FR;2;2021-06-12;30050;19820;2745460;1288139
FR;2;2021-06-13;3139;9190;2748599;1297329
FR;2;2021-06-14;24707;24197;2773306;1321526
FR;2;2021-06-15;38269;22897;2811575;1344423
FR;2;2021-06-16;29571;21545;2841146;1365968
FR;2;2021-06-17;36199;25909;2877345;1391877
FR;2;2021-06-18;45979;28800;2923324;1420677
FR;2;2021-06-19;24108;24923;2947432;1445600
FR;2;2021-06-20;2616;10074;2950048;1455674
FR;2;2021-06-21;16865;42781;2966913;1498455
FR;2;2021-06-22;27751;49632;2994664;1548087
FR;2;2021-06-23;21216;49635;3015880;1597722
FR;2;2021-06-24;27750;50324;3043630;1648046
FR;2;2021-06-25;32709;60445;3076339;1708491
FR;2;2021-06-26;15997;59314;3092336;1767805
FR;2;2021-06-27;2434;29367;3094770;1797172
FR;2;2021-06-28;12215;54393;3106985;1851565
FR;2;2021-06-29;19379;59888;3126364;1911453
FR;2;2021-06-30;15881;57788;3142245;1969241
FR;2;2021-07-01;19319;59927;3161564;2029168
FR;2;2021-07-02;23054;62230;3184618;2091398
FR;2;2021-07-03;11616;57119;3196234;2148517
FR;2;2021-07-04;1833;23336;3198067;2171853
FR;2;2021-07-05;8435;29378;3206502;2201231
FR;2;2021-07-06;13924;36221;3220426;2237452
FR;2;2021-07-07;13482;33699;3233908;2271151
FR;2;2021-07-08;18430;40305;3252338;2311456
FR;2;2021-07-09;389;6;3252727;2311462
FR;2;2021-07-10;12485;33690;3265212;2345152
FR;2;2021-07-11;1459;4331;3266671;2349483
FR;3;2020-12-27;0;0;0;0
FR;3;2020-12-28;0;0;0;0
FR;3;2020-12-29;0;0;0;0
FR;3;2020-12-30;0;0;0;0
FR;3;2020-12-31;0;0;0;0
FR;3;2021-01-01;0;0;0;0
FR;3;2021-01-02;0;0;0;0
FR;3;2021-01-03;0;0;0;0
FR;3;2021-01-04;0;0;0;0
FR;3;2021-01-05;0;0;0;0
FR;3;2021-01-06;0;0;0;0
FR;3;2021-01-07;0;0;0;0
FR;3;2021-01-08;0;0;0;0
FR;3;2021-01-09;0;0;0;0
FR;3;2021-01-10;0;0;0;0
FR;3;2021-01-11;0;0;0;0
FR;3;2021-01-12;0;0;0;0
FR;3;2021-01-13;0;0;0;0
FR;3;2021-01-14;0;0;0;0
FR;3;2021-01-15;0;0;0;0
FR;3;2021-01-16;0;0;0;0
FR;3;2021-01-17;0;0;0;0
FR;3;2021-01-18;0;0;0;0
FR;3;2021-01-19;0;0;0;0
FR;3;2021-01-20;0;0;0;0
FR;3;2021-01-21;0;0;0;0
FR;3;2021-01-22;0;0;0;0
FR;3;2021-01-23;0;0;0;0
FR;3;2021-01-24;0;0;0;0
FR;3;2021-01-25;0;0;0;0
FR;3;2021-01-26;0;0;0;0
FR;3;2021-01-27;0;0;0;0
FR;3;2021-01-28;0;0;0;0
FR;3;2021-01-29;0;0;0;0
FR;3;2021-01-30;0;0;0;0
FR;3;2021-01-31;0;0;0;0
FR;3;2021-02-01;0;0;0;0
FR;3;2021-02-02;0;0;0;0
FR;3;2021-02-03;0;0;0;0
FR;3;2021-02-04;0;0;0;0
FR;3;2021-02-05;0;0;0;0
FR;3;2021-02-06;354;0;354;0
FR;3;2021-02-07;1349;0;1703;0
FR;3;2021-02-08;2634;0;4337;0
FR;3;2021-02-09;6652;0;10989;0
FR;3;2021-02-10;9267;0;20256;0
FR;3;2021-02-11;13386;0;33642;0
FR;3;2021-02-12;13076;0;46718;0
FR;3;2021-02-13;3526;0;50244;0
FR;3;2021-02-14;870;0;51114;0
FR;3;2021-02-15;10151;0;61265;0
FR;3;2021-02-16;12211;0;73476;0
FR;3;2021-02-17;10848;0;84324;0
FR;3;2021-02-18;14624;0;98948;0
FR;3;2021-02-19;14153;0;113101;0
FR;3;2021-02-20;3189;0;116290;0
FR;3;2021-02-21;549;0;116839;0
FR;3;2021-02-22;8936;0;125775;0
FR;3;2021-02-23;11133;0;136908;0
FR;3;2021-02-24;13952;0;150860;0
FR;3;2021-02-25;44513;0;195373;0
FR;3;2021-02-26;61512;0;256885;0
FR;3;2021-02-27;34543;7;291428;7
FR;3;2021-02-28;2362;0;293790;7
FR;3;2021-03-01;20004;9;313794;16
FR;3;2021-03-02;38452;13;352246;29
FR;3;2021-03-03;48078;16;400324;45
FR;3;2021-03-04;81495;19;481819;64
FR;3;2021-03-05;117360;56;599179;120
FR;3;2021-03-06;119731;49;718910;169
FR;3;2021-03-07;54761;27;773671;196
FR;3;2021-03-08;42290;20;815961;216
FR;3;2021-03-09;78298;30;894259;246
FR;3;2021-03-10;80119;38;974378;284
FR;3;2021-03-11;127624;46;1102002;330
FR;3;2021-03-12;181772;67;1283774;397
FR;3;2021-03-13;131428;53;1415202;450
FR;3;2021-03-14;13845;4;1429047;454
FR;3;2021-03-15;51660;37;1480707;491
FR;3;2021-03-16;953;13;1481660;504
FR;3;2021-03-17;701;6;1482361;510
FR;3;2021-03-18;1250;4;1483611;514
FR;3;2021-03-19;69915;36;1553526;550
FR;3;2021-03-20;64787;35;1618313;585
FR;3;2021-03-21;5544;4;1623857;589
FR;3;2021-03-22;37051;32;1660908;621
FR;3;2021-03-23;84014;49;1744922;670
FR;3;2021-03-24;90364;91;1835286;761
FR;3;2021-03-25;149375;114;1984661;875
FR;3;2021-03-26;164754;154;2149415;1029
FR;3;2021-03-27;68016;88;2217431;1117
FR;3;2021-03-28;6284;19;2223715;1136
FR;3;2021-03-29;53750;59;2277465;1195
FR;3;2021-03-30;92685;87;2370150;1282
FR;3;2021-03-31;63025;82;2433175;1364
FR;3;2021-04-01;85526;102;2518701;1466
FR;3;2021-04-02;86460;143;2605161;1609
FR;3;2021-04-03;35559;109;2640720;1718
FR;3;2021-04-04;3436;15;2644156;1733
FR;3;2021-04-05;4315;21;2648471;1754
FR;3;2021-04-06;29305;75;2677776;1829
FR;3;2021-04-07;31864;59;2709640;1888
FR;3;2021-04-08;78283;233;2787923;2121
FR;3;2021-04-09;161105;405;2949028;2526
FR;3;2021-04-10;75252;330;3024280;2856
FR;3;2021-04-11;7119;42;3031399;2898
FR;3;2021-04-12;50970;195;3082369;3093
FR;3;2021-04-13;85679;312;3168048;3405
FR;3;2021-04-14;67217;339;3235265;3744
FR;3;2021-04-15;92423;364;3327688;4108
FR;3;2021-04-16;111791;569;3439479;4677
FR;3;2021-04-17;52845;320;3492324;4997
FR;3;2021-04-18;9537;32;3501861;5029
FR;3;2021-04-19;24657;231;3526518;5260
FR;3;2021-04-20;45076;392;3571594;5652
FR;3;2021-04-21;38347;445;3609941;6097
FR;3;2021-04-22;54079;786;3664020;6883
FR;3;2021-04-23;69819;1014;3733839;7897
FR;3;2021-04-24;36786;971;3770625;8868
FR;3;2021-04-25;5963;153;3776588;9021
FR;3;2021-04-26;19246;656;3795834;9677
FR;3;2021-04-27;33892;1244;3829726;10921
FR;3;2021-04-28;28420;1926;3858146;12847
FR;3;2021-04-29;44751;5953;3902897;18800
FR;3;2021-04-30;54797;8929;3957694;27729
FR;3;2021-05-01;9225;1967;3966919;29696
FR;3;2021-05-02;2827;498;3969746;30194
FR;3;2021-05-03;12593;3881;3982339;34075
FR;3;2021-05-04;22566;8442;4004905;42517
FR;3;2021-05-05;18147;10571;4023052;53088
FR;3;2021-05-06;33968;20905;4057020;73993
FR;3;2021-05-07;43492;28401;4100512;102394
FR;3;2021-05-08;6408;8892;4106920;111286
FR;3;2021-05-09;1607;2653;4108527;113939
FR;3;2021-05-10;14472;12562;4122999;126501
FR;3;2021-05-11;26479;25730;4149478;152231
FR;3;2021-05-12;16765;27450;4166243;179681
FR;3;2021-05-13;2035;3485;4168278;183166
FR;3;2021-05-14;14107;25741;4182385;208907
FR;3;2021-05-15;6929;20731;4189314;229638
FR;3;2021-05-16;832;2678;4190146;232316
FR;3;2021-05-17;7540;19911;4197686;252227
FR;3;2021-05-18;12949;29632;4210635;281859
FR;3;2021-05-19;8843;31862;4219478;313721
FR;3;2021-05-20;12331;53218;4231809;366939
FR;3;2021-05-21;12304;65536;4244113;432475
FR;3;2021-05-22;4681;33298;4248794;465773
FR;3;2021-05-23;542;2665;4249336;468438
FR;3;2021-05-24;601;4918;4249937;473356
FR;3;2021-05-25;4978;45173;4254915;518529
FR;3;2021-05-26;4600;51054;4259515;569583
FR;3;2021-05-27;5959;77844;4265474;647427
FR;3;2021-05-28;7170;99106;4272644;746533
FR;3;2021-05-29;3086;60285;4275730;806818
FR;3;2021-05-30;382;8243;4276112;815061
FR;3;2021-05-31;2086;35996;4278198;851057
FR;3;2021-06-01;2982;64817;4281180;915874
FR;3;2021-06-02;2379;58357;4283559;974231
FR;3;2021-06-03;3192;87583;4286751;1061814
FR;3;2021-06-04;3858;105128;4290609;1166942
FR;3;2021-06-05;1785;52247;4292394;1219189
FR;3;2021-06-06;261;5399;4292655;1224588
FR;3;2021-06-07;1102;31182;4293757;1255770
FR;3;2021-06-08;1727;47284;4295484;1303054
FR;3;2021-06-09;1440;42397;4296924;1345451
FR;3;2021-06-10;1850;68008;4298774;1413459
FR;3;2021-06-11;2233;96806;4301007;1510265
FR;3;2021-06-12;1007;40840;4302014;1551105
FR;3;2021-06-13;141;3823;4302155;1554928
FR;3;2021-06-14;757;42669;4302912;1597597
FR;3;2021-06-15;1172;80698;4304084;1678295
FR;3;2021-06-16;1040;65788;4305124;1744083
FR;3;2021-06-17;1443;101860;4306567;1845943
FR;3;2021-06-18;1727;117931;4308294;1963874
FR;3;2021-06-19;706;39407;4309000;2003281
FR;3;2021-06-20;76;3384;4309076;2006665
FR;3;2021-06-21;558;39289;4309634;2045954
FR;3;2021-06-22;894;70024;4310528;2115978
FR;3;2021-06-23;768;50854;4311296;2166832
FR;3;2021-06-24;1147;77224;4312443;2244056
FR;3;2021-06-25;1257;89980;4313700;2334036
FR;3;2021-06-26;545;33139;4314245;2367175
FR;3;2021-06-27;91;4029;4314336;2371204
FR;3;2021-06-28;467;30463;4314803;2401667
FR;3;2021-06-29;731;56145;4315534;2457812
FR;3;2021-06-30;735;45062;4316269;2502874
FR;3;2021-07-01;993;65671;4317262;2568545
FR;3;2021-07-02;1177;90454;4318439;2658999
FR;3;2021-07-03;547;31195;4318986;2690194
FR;3;2021-07-04;80;4275;4319066;2694469
FR;3;2021-07-05;478;33937;4319544;2728406
FR;3;2021-07-06;792;56137;4320336;2784543
FR;3;2021-07-07;721;43094;4321057;2827637
FR;3;2021-07-08;971;60770;4322028;2888407
FR;3;2021-07-09;17;1;4322045;2888408
FR;3;2021-07-10;527;25058;4322572;2913466
FR;3;2021-07-11;62;3312;4322634;2916778
FR;4;2020-12-27;0;0;0;0
FR;4;2020-12-28;0;0;0;0
FR;4;2020-12-29;0;0;0;0
FR;4;2020-12-30;0;0;0;0
FR;4;2020-12-31;0;0;0;0
FR;4;2021-01-01;0;0;0;0
FR;4;2021-01-02;0;0;0;0
FR;4;2021-01-03;0;0;0;0
FR;4;2021-01-04;0;0;0;0
FR;4;2021-01-05;0;0;0;0
FR;4;2021-01-06;0;0;0;0
FR;4;2021-01-07;0;0;0;0
FR;4;2021-01-08;0;0;0;0
FR;4;2021-01-09;0;0;0;0
FR;4;2021-01-10;0;0;0;0
FR;4;2021-01-11;0;0;0;0
FR;4;2021-01-12;0;0;0;0
FR;4;2021-01-13;0;0;0;0
FR;4;2021-01-14;0;0;0;0
FR;4;2021-01-15;0;0;0;0
FR;4;2021-01-16;0;0;0;0
FR;4;2021-01-17;0;0;0;0
FR;4;2021-01-18;0;0;0;0
FR;4;2021-01-19;0;0;0;0
FR;4;2021-01-20;0;0;0;0
FR;4;2021-01-21;0;0;0;0
FR;4;2021-01-22;0;0;0;0
FR;4;2021-01-23;0;0;0;0
FR;4;2021-01-24;0;0;0;0
FR;4;2021-01-25;0;0;0;0
FR;4;2021-01-26;0;0;0;0
FR;4;2021-01-27;0;0;0;0
FR;4;2021-01-28;0;0;0;0
FR;4;2021-01-29;0;0;0;0
FR;4;2021-01-30;0;0;0;0
FR;4;2021-01-31;0;0;0;0
FR;4;2021-02-01;0;0;0;0
FR;4;2021-02-02;0;0;0;0
FR;4;2021-02-03;0;0;0;0
FR;4;2021-02-04;0;0;0;0
FR;4;2021-02-05;0;0;0;0
FR;4;2021-02-06;0;0;0;0
FR;4;2021-02-07;0;0;0;0
FR;4;2021-02-08;0;0;0;0
FR;4;2021-02-09;0;0;0;0
FR;4;2021-02-10;0;0;0;0
FR;4;2021-02-11;0;0;0;0
FR;4;2021-02-12;0;0;0;0
FR;4;2021-02-13;0;0;0;0
FR;4;2021-02-14;0;0;0;0
FR;4;2021-02-15;0;0;0;0
FR;4;2021-02-16;0;0;0;0
FR;4;2021-02-17;0;0;0;0
FR;4;2021-02-18;0;0;0;0
FR;4;2021-02-19;0;0;0;0
FR;4;2021-02-20;0;0;0;0
FR;4;2021-02-21;0;0;0;0
FR;4;2021-02-22;0;0;0;0
FR;4;2021-02-23;0;0;0;0
FR;4;2021-02-24;0;0;0;0
FR;4;2021-02-25;0;0;0;0
FR;4;2021-02-26;0;0;0;0
FR;4;2021-02-27;0;0;0;0
FR;4;2021-02-28;0;0;0;0
FR;4;2021-03-01;0;0;0;0
FR;4;2021-03-02;0;0;0;0
FR;4;2021-03-03;0;0;0;0
FR;4;2021-03-04;0;0;0;0
FR;4;2021-03-05;0;0;0;0
FR;4;2021-03-06;0;0;0;0
FR;4;2021-03-07;0;0;0;0
FR;4;2021-03-08;0;0;0;0
FR;4;2021-03-09;0;0;0;0
FR;4;2021-03-10;0;0;0;0
FR;4;2021-03-11;0;0;0;0
FR;4;2021-03-12;0;0;0;0
FR;4;2021-03-13;0;0;0;0
FR;4;2021-03-14;0;0;0;0
FR;4;2021-03-15;0;0;0;0
FR;4;2021-03-16;0;0;0;0
FR;4;2021-03-17;0;0;0;0
FR;4;2021-03-18;0;0;0;0
FR;4;2021-03-19;0;0;0;0
FR;4;2021-03-20;0;0;0;0
FR;4;2021-03-21;0;0;0;0
FR;4;2021-03-22;0;0;0;0
FR;4;2021-03-23;0;0;0;0
FR;4;2021-03-24;0;0;0;0
FR;4;2021-03-25;0;0;0;0
FR;4;2021-03-26;0;0;0;0
FR;4;2021-03-27;0;0;0;0
FR;4;2021-03-28;0;0;0;0
FR;4;2021-03-29;0;0;0;0
FR;4;2021-03-30;0;0;0;0
FR;4;2021-03-31;0;0;0;0
FR;4;2021-04-01;0;0;0;0
FR;4;2021-04-02;0;0;0;0
FR;4;2021-04-03;0;0;0;0
FR;4;2021-04-04;0;0;0;0
FR;4;2021-04-05;0;0;0;0
FR;4;2021-04-06;0;0;0;0
FR;4;2021-04-07;0;0;0;0
FR;4;2021-04-08;0;0;0;0
FR;4;2021-04-09;0;2;0;2
FR;4;2021-04-10;0;0;0;2
FR;4;2021-04-11;0;0;0;2
FR;4;2021-04-12;0;1;0;3
FR;4;2021-04-13;0;0;0;3
FR;4;2021-04-14;0;0;0;3
FR;4;2021-04-15;0;0;0;3
FR;4;2021-04-16;0;0;0;3
FR;4;2021-04-17;0;0;0;3
FR;4;2021-04-18;0;0;0;3
FR;4;2021-04-19;0;0;0;3
FR;4;2021-04-20;0;0;0;3
FR;4;2021-04-21;0;0;0;3
FR;4;2021-04-22;0;0;0;3
FR;4;2021-04-23;887;0;887;3
FR;4;2021-04-24;1552;0;2439;3
FR;4;2021-04-25;117;0;2556;3
FR;4;2021-04-26;2835;0;5391;3
FR;4;2021-04-27;9401;4;14792;7
FR;4;2021-04-28;9792;3;24584;10
FR;4;2021-04-29;15898;7;40482;17
FR;4;2021-04-30;19095;7;59577;24
FR;4;2021-05-01;1906;5;61483;29
FR;4;2021-05-02;443;0;61926;29
FR;4;2021-05-03;4936;1;66862;30
FR;4;2021-05-04;8266;8;75128;38
FR;4;2021-05-05;6013;6;81141;44
FR;4;2021-05-06;11263;11;92404;55
FR;4;2021-05-07;18922;8;111326;63
FR;4;2021-05-08;2264;6;113590;69
FR;4;2021-05-09;629;2;114219;71
FR;4;2021-05-10;7099;8;121318;79
FR;4;2021-05-11;14142;12;135460;91
FR;4;2021-05-12;9976;14;145436;105
FR;4;2021-05-13;1449;3;146885;108
FR;4;2021-05-14;7599;8;154484;116
FR;4;2021-05-15;3599;9;158083;125
FR;4;2021-05-16;363;1;158446;126
FR;4;2021-05-17;4354;2;162800;128
FR;4;2021-05-18;8602;10;171402;138
FR;4;2021-05-19;5532;5;176934;143
FR;4;2021-05-20;9247;6;186181;149
FR;4;2021-05-21;12538;27;198719;176
FR;4;2021-05-22;4935;12;203654;188
FR;4;2021-05-23;429;2;204083;190
FR;4;2021-05-24;949;3;205032;193
FR;4;2021-05-25;7415;16;212447;209
FR;4;2021-05-26;7565;13;220012;222
FR;4;2021-05-27;14134;34;234146;256
FR;4;2021-05-28;26295;77;260441;333
FR;4;2021-05-29;11171;20;271612;353
FR;4;2021-05-30;859;2;272471;355
FR;4;2021-05-31;12449;19;284920;374
FR;4;2021-06-01;19883;40;304803;414
FR;4;2021-06-02;14245;33;319048;447
FR;4;2021-06-03;19177;23;338225;470
FR;4;2021-06-04;22160;45;360385;515
FR;4;2021-06-05;9527;28;369912;543
FR;4;2021-06-06;922;0;370834;543
FR;4;2021-06-07;8943;16;379777;559
FR;4;2021-06-08;14344;26;394121;585
FR;4;2021-06-09;11933;24;406054;609
FR;4;2021-06-10;15065;25;421119;634
FR;4;2021-06-11;16658;51;437777;685
FR;4;2021-06-12;7248;26;445025;711
FR;4;2021-06-13;840;8;445865;719
FR;4;2021-06-14;6438;22;452303;741
FR;4;2021-06-15;10636;31;462939;772
FR;4;2021-06-16;8667;13;471606;785
FR;4;2021-06-17;10597;27;482203;812
FR;4;2021-06-18;12103;38;494306;850
FR;4;2021-06-19;5390;24;499696;874
FR;4;2021-06-20;593;2;500289;876
FR;4;2021-06-21;4823;10;505112;886
FR;4;2021-06-22;7644;18;512756;904
FR;4;2021-06-23;6841;33;519597;937
FR;4;2021-06-24;8374;31;527971;968
FR;4;2021-06-25;9807;36;537778;1004
FR;4;2021-06-26;4567;18;542345;1022
FR;4;2021-06-27;569;2;542914;1024
FR;4;2021-06-28;4474;14;547388;1038
FR;4;2021-06-29;6642;15;554030;1053
FR;4;2021-06-30;6258;35;560288;1088
FR;4;2021-07-01;7572;21;567860;1109
FR;4;2021-07-02;8928;44;576788;1153
FR;4;2021-07-03;4530;17;581318;1170
FR;4;2021-07-04;545;5;581863;1175
FR;4;2021-07-05;4420;17;586283;1192
FR;4;2021-07-06;7312;20;593595;1212
FR;4;2021-07-07;6544;27;600139;1239
FR;4;2021-07-08;8562;35;608701;1274
FR;4;2021-07-09;129;0;608830;1274
FR;4;2021-07-10;4213;10;613043;1284
FR;4;2021-07-11;434;0;613477;1284
FR;0;2020-12-27;21;0;21;0
FR;0;2020-12-28;77;0;98;0
FR;0;2020-12-29;108;0;206;0
FR;0;2020-12-30;126;0;332;0
FR;0;2020-12-31;88;0;420;0
FR;0;2021-01-01;76;0;496;0
FR;0;2021-01-02;93;0;589;0
FR;0;2021-01-03;99;0;688;0
FR;0;2021-01-04;1483;0;2171;0
FR;0;2021-01-05;5445;0;7616;0
FR;0;2021-01-06;11342;0;18958;0
FR;0;2021-01-07;28711;0;47669;0
FR;0;2021-01-08;36381;0;84050;0
FR;0;2021-01-09;10967;0;95017;0
FR;0;2021-01-10;5653;0;100670;0
FR;0;2021-01-11;39193;0;139863;0
FR;0;2021-01-12;61118;0;200981;0
FR;0;2021-01-13;64064;0;265045;0
FR;0;2021-01-14;80167;0;345212;0
FR;0;2021-01-15;67722;0;412934;0
FR;0;2021-01-16;19758;78;432692;78
FR;0;2021-01-17;10488;42;443180;120
FR;0;2021-01-18;84611;162;527791;282
FR;0;2021-01-19;128745;125;656536;407
FR;0;2021-01-20;135570;157;792106;564
FR;0;2021-01-21;155832;135;947938;699
FR;0;2021-01-22;119088;162;1067026;861
FR;0;2021-01-23;37907;50;1104933;911
FR;0;2021-01-24;9387;27;1114320;938
FR;0;2021-01-25;77069;1219;1191389;2157
FR;0;2021-01-26;99011;3110;1290400;5267
FR;0;2021-01-27;105853;5596;1396253;10863
FR;0;2021-01-28;122661;14360;1518914;25223
FR;0;2021-01-29;91072;17282;1609986;42505
FR;0;2021-01-30;28714;4225;1638700;46730
FR;0;2021-01-31;4884;1679;1643584;48409
FR;0;2021-02-01;51706;21124;1695290;69533
FR;0;2021-02-02;70825;34560;1766115;104093
FR;0;2021-02-03;71123;36959;1837238;141052
FR;0;2021-02-04;80754;50049;1917992;191101
FR;0;2021-02-05;67277;45338;1985269;236439
FR;0;2021-02-06;21390;10401;2006659;246840
FR;0;2021-02-07;4830;5042;2011489;251882
FR;0;2021-02-08;45981;45979;2057470;297861
FR;0;2021-02-09;64935;72409;2122405;370270
FR;0;2021-02-10;69426;76731;2191831;447001
FR;0;2021-02-11;85856;99146;2277687;546147
FR;0;2021-02-12;77945;74219;2355632;620366
FR;0;2021-02-13;21745;19492;2377377;639858
FR;0;2021-02-14;4603;7191;2381980;647049
FR;0;2021-02-15;37180;76514;2419160;723563
FR;0;2021-02-16;49331;100742;2468491;824305
FR;0;2021-02-17;49452;102993;2517943;927298
FR;0;2021-02-18;68240;118533;2586183;1045831
FR;0;2021-02-19;64014;90759;2650197;1136590
FR;0;2021-02-20;18035;28429;2668232;1165019
FR;0;2021-02-21;2873;6372;2671105;1171391
FR;0;2021-02-22;36616;73149;2707721;1244540
FR;0;2021-02-23;52759;84064;2760480;1328604
FR;0;2021-02-24;58277;81123;2818757;1409727
FR;0;2021-02-25;98986;91400;2917743;1501127
FR;0;2021-02-26;112016;71015;3029759;1572142
FR;0;2021-02-27;51304;21981;3081063;1594123
FR;0;2021-02-28;5702;4414;3086765;1598537
FR;0;2021-03-01;63840;52791;3150605;1651328
FR;0;2021-03-02;99598;66253;3250203;1717581
FR;0;2021-03-03;114080;65553;3364283;1783134
FR;0;2021-03-04;161060;68885;3525343;1852019
FR;0;2021-03-05;198528;63365;3723871;1915384
FR;0;2021-03-06;205899;17822;3929770;1933206
FR;0;2021-03-07;120076;5471;4049846;1938677
FR;0;2021-03-08;105264;50800;4155110;1989477
FR;0;2021-03-09;170236;56780;4325346;2046257
FR;0;2021-03-10;176278;57218;4501624;2103475
FR;0;2021-03-11;240207;63111;4741831;2166586
FR;0;2021-03-12;291979;53520;5033810;2220106
FR;0;2021-03-13;229274;15309;5263084;2235415
FR;0;2021-03-14;62364;3437;5325448;2238852
FR;0;2021-03-15;156424;32649;5481872;2271501
FR;0;2021-03-16;139624;39529;5621496;2311030
FR;0;2021-03-17;148461;38795;5769957;2349825
FR;0;2021-03-18;165531;44633;5935488;2394458
FR;0;2021-03-19;227448;37481;6162936;2431939
FR;0;2021-03-20;165066;11784;6328002;2443723
FR;0;2021-03-21;48824;2627;6376826;2446350
FR;0;2021-03-22;167663;34293;6544489;2480643
FR;0;2021-03-23;247629;42411;6792118;2523054
FR;0;2021-03-24;254187;43855;7046305;2566909
FR;0;2021-03-25;338908;44763;7385213;2611672
FR;0;2021-03-26;356271;41914;7741484;2653586
FR;0;2021-03-27;193692;16651;7935176;2670237
FR;0;2021-03-28;58446;3732;7993622;2673969
FR;0;2021-03-29;201016;54302;8194638;2728271
FR;0;2021-03-30;282872;69704;8477510;2797975
FR;0;2021-03-31;260432;72940;8737942;2870915
FR;0;2021-04-01;311324;87848;9049266;2958763
FR;0;2021-04-02;278807;92152;9328073;3050915
FR;0;2021-04-03;139563;61869;9467636;3112784
FR;0;2021-04-04;44977;18667;9512613;3131451
FR;0;2021-04-05;58927;11008;9571540;3142459
FR;0;2021-04-06;214152;107894;9785692;3250353
FR;0;2021-04-07;257078;115480;10042770;3365833
FR;0;2021-04-08;334059;121443;10376829;3487276
FR;0;2021-04-09;406600;116516;10783429;3603792
FR;0;2021-04-10;210767;82757;10994196;3686549
FR;0;2021-04-11;55010;34599;11049206;3721148
FR;0;2021-04-12;234521;115242;11283727;3836390
FR;0;2021-04-13;306333;144992;11590060;3981382
FR;0;2021-04-14;290758;139432;11880818;4120814
FR;0;2021-04-15;332917;147882;12213735;4268696
FR;0;2021-04-16;336366;145794;12550101;4414490
FR;0;2021-04-17;186973;90267;12737074;4504757
FR;0;2021-04-18;50596;35428;12787670;4540185
FR;0;2021-04-19;203213;138411;12990883;4678596
FR;0;2021-04-20;251454;170763;13242337;4849359
FR;0;2021-04-21;250105;168831;13492442;5018190
FR;0;2021-04-22;284204;188297;13776646;5206487
FR;0;2021-04-23;291979;183300;14068625;5389787
FR;0;2021-04-24;188570;111588;14257195;5501375
FR;0;2021-04-25;68507;38882;14325702;5540257
FR;0;2021-04-26;218478;156138;14544180;5696395
FR;0;2021-04-27;281601;187552;14825781;5883947
FR;0;2021-04-28;296637;183236;15122418;6067183
FR;0;2021-04-29;353726;196172;15476144;6263355
FR;0;2021-04-30;368836;184876;15844980;6448231
FR;0;2021-05-01;164474;52546;16009454;6500777
FR;0;2021-05-02;90369;37837;16099823;6538614
FR;0;2021-05-03;284821;169688;16384644;6708302
FR;0;2021-05-04;311776;224361;16696420;6932663
FR;0;2021-05-05;321935;224571;17018355;7157234
FR;0;2021-05-06;374748;239252;17393103;7396486
FR;0;2021-05-07;368651;257379;17761754;7653865
FR;0;2021-05-08;219417;66941;17981171;7720806
FR;0;2021-05-09;128489;46769;18109660;7767575
FR;0;2021-05-10;307889;229068;18417549;7996643
FR;0;2021-05-11;399342;258233;18816891;8254876
FR;0;2021-05-12;428470;233285;19245361;8488161
FR;0;2021-05-13;334254;56911;19579615;8545072
FR;0;2021-05-14;449173;167612;20028788;8712684
FR;0;2021-05-15;370393;94048;20399181;8806732
FR;0;2021-05-16;200867;20838;20600048;8827570
FR;0;2021-05-17;372147;149210;20972195;8976780
FR;0;2021-05-18;454324;153237;21426519;9130017
FR;0;2021-05-19;462506;145416;21889025;9275433
FR;0;2021-05-20;501139;160430;22390164;9435863
FR;0;2021-05-21;484167;174629;22874331;9610492
FR;0;2021-05-22;344401;79933;23218732;9690425
FR;0;2021-05-23;160223;14453;23378955;9704878
FR;0;2021-05-24;260006;33274;23638961;9738152
FR;0;2021-05-25;395330;189391;24034291;9927543
FR;0;2021-05-26;408094;188254;24442385;10115797
FR;0;2021-05-27;445002;218791;24887387;10334588
FR;0;2021-05-28;424473;259774;25311860;10594362
FR;0;2021-05-29;296515;149485;25608375;10743847
FR;0;2021-05-30;105638;32636;25714013;10776483
FR;0;2021-05-31;353304;203672;26067317;10980155
FR;0;2021-06-01;416178;251824;26483495;11231979
FR;0;2021-06-02;404124;231128;26887619;11463107
FR;0;2021-06-03;453007;258864;27340626;11721971
FR;0;2021-06-04;443691;305042;27784317;12027013
FR;0;2021-06-05;299485;189162;28083802;12216175
FR;0;2021-06-06;129770;49165;28213572;12265340
FR;0;2021-06-07;329880;262634;28543452;12527974
FR;0;2021-06-08;383244;291494;28926696;12819468
FR;0;2021-06-09;374642;276128;29301338;13095596
FR;0;2021-06-10;388989;289660;29690327;13385256
FR;0;2021-06-11;376742;357760;30067069;13743016
FR;0;2021-06-12;277381;211643;30344450;13954659
FR;0;2021-06-13;101837;74139;30446287;14028798
FR;0;2021-06-14;231425;356191;30677712;14384989
FR;0;2021-06-15;296042;386341;30973754;14771330
FR;0;2021-06-16;304418;358056;31278172;15129386
FR;0;2021-06-17;308313;372443;31586485;15501829
FR;0;2021-06-18;309736;443059;31896221;15944888
FR;0;2021-06-19;219308;274142;32115529;16219030
FR;0;2021-06-20;70759;102697;32186288;16321727
FR;0;2021-06-21;186963;402381;32373251;16724108
FR;0;2021-06-22;214551;467628;32587802;17191736
FR;0;2021-06-23;225113;440232;32812915;17631968
FR;0;2021-06-24;231345;409633;33044260;18041601
FR;0;2021-06-25;218782;522688;33263042;18564289
FR;0;2021-06-26;149145;371086;33412187;18935375
FR;0;2021-06-27;54028;156498;33466215;19091873
FR;0;2021-06-28;147447;453548;33613662;19545421
FR;0;2021-06-29;175022;505818;33788684;20051239
FR;0;2021-06-30;194615;481388;33983299;20532627
FR;0;2021-07-01;207729;458105;34191028;20990732
FR;0;2021-07-02;207157;520829;34398185;21511561
FR;0;2021-07-03;136914;369127;34535099;21880688
FR;0;2021-07-04;54306;141445;34589405;22022133
FR;0;2021-07-05;155454;419816;34744859;22441949
FR;0;2021-07-06;185930;475370;34930789;22917319
FR;0;2021-07-07;199151;439894;35129940;23357213
FR;0;2021-07-08;219546;424538;35349486;23781751
FR;0;2021-07-09;1326;23;35350812;23781774
FR;0;2021-07-10;142182;339984;35492994;24121758
FR;0;2021-07-11;57651;110212;35550645;24231970
