fra;vaccin;jour;n_dose1;n_dose2;n_dose3;n_dose4;n_rappel;n_cum_dose1;n_cum_dose2;n_cum_dose3;n_cum_dose4;n_cum_rappel
FR;1;2020-12-27;602;0;0;0;0;602;0;0;0;0
FR;1;2020-12-28;663;1;0;0;0;1265;1;0;0;0
FR;1;2020-12-29;373;0;0;0;0;1638;1;0;0;0
FR;1;2020-12-30;439;0;0;0;0;2077;1;0;0;0
FR;1;2020-12-31;415;0;0;0;0;2492;1;0;0;0
FR;1;2021-01-01;1135;1;0;0;0;3627;2;0;0;0
FR;1;2021-01-02;356;3;0;0;0;3983;5;0;0;0
FR;1;2021-01-03;399;0;0;0;0;4382;5;0;0;0
FR;1;2021-01-04;2087;2;0;0;0;6469;7;0;0;0
FR;1;2021-01-05;7562;3;0;0;0;14031;10;0;0;0
FR;1;2021-01-06;12412;10;0;0;0;26443;20;0;0;0
FR;1;2021-01-07;29446;9;0;0;0;55889;29;0;0;0
FR;1;2021-01-08;37121;9;0;0;0;93010;38;0;0;0
FR;1;2021-01-09;11209;4;0;0;0;104219;42;0;0;0
FR;1;2021-01-10;5996;3;0;0;0;110215;45;0;0;0
FR;1;2021-01-11;39922;17;0;0;0;150137;62;0;0;0
FR;1;2021-01-12;62119;15;0;0;0;212256;77;0;0;0
FR;1;2021-01-13;65096;28;0;0;0;277352;105;0;0;0
FR;1;2021-01-14;81434;74;0;0;0;358786;179;0;0;0
FR;1;2021-01-15;68593;28;0;0;0;427379;207;0;0;0
FR;1;2021-01-16;19893;70;0;0;0;447272;277;0;0;0
FR;1;2021-01-17;10896;46;0;0;0;458168;323;0;0;0
FR;1;2021-01-18;82805;162;0;0;0;540973;485;0;0;0
FR;1;2021-01-19;125896;171;0;0;0;666869;656;0;0;0
FR;1;2021-01-20;132389;168;0;0;0;799258;824;0;0;0
FR;1;2021-01-21;153032;160;0;0;0;952290;984;0;0;0
FR;1;2021-01-22;115923;194;0;0;0;1068213;1178;0;0;0
FR;1;2021-01-23;36598;63;0;0;0;1104811;1241;0;0;0
FR;1;2021-01-24;9580;68;0;0;0;1114391;1309;0;0;0
FR;1;2021-01-25;74406;1260;0;0;0;1188797;2569;0;0;0
FR;1;2021-01-26;96441;3283;1;0;0;1285238;5852;1;0;0
FR;1;2021-01-27;103625;5895;0;0;0;1388863;11747;1;0;0
FR;1;2021-01-28;120579;14936;0;0;0;1509442;26683;1;0;0
FR;1;2021-01-29;88877;17705;0;0;0;1598319;44388;1;0;0
FR;1;2021-01-30;27980;4257;0;0;0;1626299;48645;1;0;0
FR;1;2021-01-31;5180;1734;0;0;0;1631479;50379;1;0;0
FR;1;2021-02-01;49704;21501;0;0;0;1681183;71880;1;0;0
FR;1;2021-02-02;67788;35644;0;0;0;1748971;107524;1;0;0
FR;1;2021-02-03;67068;37910;0;0;0;1816039;145434;1;0;0
FR;1;2021-02-04;77116;51430;0;0;0;1893155;196864;1;0;0
FR;1;2021-02-05;63406;46107;0;0;0;1956561;242971;1;0;0
FR;1;2021-02-06;19403;10742;0;0;0;1975964;253713;1;0;0
FR;1;2021-02-07;3658;5256;0;0;0;1979622;258969;1;0;0
FR;1;2021-02-08;36480;46851;0;0;0;2016102;305820;1;0;0
FR;1;2021-02-09;50788;74282;0;0;0;2066890;380102;1;0;0
FR;1;2021-02-10;52042;79096;0;0;0;2118932;459198;1;0;0
FR;1;2021-02-11;63347;100955;0;0;0;2182279;560153;1;0;0
FR;1;2021-02-12;55837;74640;0;0;0;2238116;634793;1;0;0
FR;1;2021-02-13;15450;19242;0;0;0;2253566;654035;1;0;0
FR;1;2021-02-14;3744;7186;0;0;0;2257310;661221;1;0;0
FR;1;2021-02-15;24128;73497;0;0;0;2281438;734718;1;0;0
FR;1;2021-02-16;32754;96510;0;0;0;2314192;831228;1;0;0
FR;1;2021-02-17;35094;100090;1;0;0;2349286;931318;2;0;0
FR;1;2021-02-18;49422;115182;0;0;0;2398708;1046500;2;0;0
FR;1;2021-02-19;45365;86627;1;0;0;2444073;1133127;3;0;0
FR;1;2021-02-20;13376;27065;0;0;0;2457449;1160192;3;0;0
FR;1;2021-02-21;2454;6223;0;0;0;2459903;1166415;3;0;0
FR;1;2021-02-22;24703;69402;2;0;0;2484606;1235817;5;0;0
FR;1;2021-02-23;37413;80723;1;0;0;2522019;1316540;6;0;0
FR;1;2021-02-24;40670;78179;1;0;0;2562689;1394719;7;0;0
FR;1;2021-02-25;50131;87974;1;0;0;2612820;1482693;8;0;0
FR;1;2021-02-26;47186;67588;1;0;0;2660006;1550281;9;0;0
FR;1;2021-02-27;15667;21081;0;0;0;2675673;1571362;9;0;0
FR;1;2021-02-28;3551;4254;1;0;0;2679224;1575616;10;0;0
FR;1;2021-03-01;40143;49551;1;0;0;2719367;1625167;11;0;0
FR;1;2021-03-02;55955;61820;2;0;0;2775322;1686987;13;0;0
FR;1;2021-03-03;61200;60580;0;0;0;2836522;1747567;13;0;0
FR;1;2021-03-04;72970;66087;3;0;0;2909492;1813654;16;0;0
FR;1;2021-03-05;74732;59019;3;0;0;2984224;1872673;19;0;0
FR;1;2021-03-06;82431;15994;2;0;0;3066655;1888667;21;0;0
FR;1;2021-03-07;63702;4948;1;0;0;3130357;1893615;22;0;0
FR;1;2021-03-08;60140;42026;2;0;0;3190497;1935641;24;0;0
FR;1;2021-03-09;85958;47973;1;0;0;3276455;1983614;25;0;0
FR;1;2021-03-10;90869;47939;5;0;0;3367324;2031553;30;0;0
FR;1;2021-03-11;105032;54144;1;0;0;3472356;2085697;31;0;0
FR;1;2021-03-12;104080;45093;1;0;0;3576436;2130790;32;0;0
FR;1;2021-03-13;89179;12705;1;0;0;3665615;2143495;33;0;0
FR;1;2021-03-14;44442;2886;1;0;0;3710057;2146381;34;0;0
FR;1;2021-03-15;95472;28640;3;0;0;3805529;2175021;37;0;0
FR;1;2021-03-16;123569;34472;5;0;0;3929098;2209493;42;0;0
FR;1;2021-03-17;129277;34189;4;0;0;4058375;2243682;46;0;0
FR;1;2021-03-18;142852;39552;5;0;0;4201227;2283234;51;0;0
FR;1;2021-03-19;136212;32552;2;0;0;4337439;2315786;53;0;0
FR;1;2021-03-20;75972;10005;1;0;0;4413411;2325791;54;0;0
FR;1;2021-03-21;26494;2363;1;0;0;4439905;2328154;55;0;0
FR;1;2021-03-22;114716;30819;2;0;0;4554621;2358973;57;0;0
FR;1;2021-03-23;142993;38123;1;0;0;4697614;2397096;58;0;0
FR;1;2021-03-24;141958;38606;0;0;0;4839572;2435702;58;0;0
FR;1;2021-03-25;164966;39602;4;0;0;5004538;2475304;62;0;0
FR;1;2021-03-26;166357;37486;4;1;0;5170895;2512790;66;1;0
FR;1;2021-03-27;110865;15276;1;0;0;5281760;2528066;67;1;0
FR;1;2021-03-28;42291;3861;3;0;0;5324051;2531927;70;1;0
FR;1;2021-03-29;129784;49677;4;0;0;5453835;2581604;74;1;0
FR;1;2021-03-30;167672;63514;4;0;0;5621507;2645118;78;1;0
FR;1;2021-03-31;170886;67203;4;0;0;5792393;2712321;82;1;0
FR;1;2021-04-01;194715;80572;11;0;0;5987108;2792893;93;1;0
FR;1;2021-04-02;164409;84913;7;0;0;6151517;2877806;100;1;0
FR;1;2021-04-03;88223;58032;5;0;0;6239740;2935838;105;1;0
FR;1;2021-04-04;33574;17698;0;0;0;6273314;2953536;105;1;0
FR;1;2021-04-05;46374;9975;11;0;0;6319688;2963511;116;1;0
FR;1;2021-04-06;160256;102080;17;0;0;6479944;3065591;133;1;0
FR;1;2021-04-07;196927;108165;16;0;0;6676871;3173756;149;1;0
FR;1;2021-04-08;222044;112710;13;0;0;6898915;3286466;162;1;0
FR;1;2021-04-09;214498;107331;21;0;0;7113413;3393797;183;1;0
FR;1;2021-04-10;117148;73237;14;0;0;7230561;3467034;197;1;0
FR;1;2021-04-11;40872;30137;6;0;0;7271433;3497171;203;1;0
FR;1;2021-04-12;168409;103870;45;0;0;7439842;3601041;248;1;0
FR;1;2021-04-13;203749;128019;97;1;0;7643591;3729060;345;2;0
FR;1;2021-04-14;208537;122656;206;0;0;7852128;3851716;551;2;0
FR;1;2021-04-15;221600;127012;311;0;0;8073728;3978728;862;2;0
FR;1;2021-04-16;206001;125153;307;0;0;8279729;4103881;1169;2;0
FR;1;2021-04-17;122057;67282;103;0;0;8401786;4171163;1272;2;0
FR;1;2021-04-18;35953;20940;41;0;0;8437739;4192103;1313;2;0
FR;1;2021-04-19;163706;121710;430;0;0;8601445;4313813;1743;2;0
FR;1;2021-04-20;189354;148806;530;0;0;8790799;4462619;2273;2;0
FR;1;2021-04-21;193928;146881;758;0;0;8984727;4609500;3031;2;0
FR;1;2021-04-22;208976;163032;777;0;0;9193703;4772532;3808;2;0
FR;1;2021-04-23;198911;157027;671;0;0;9392614;4929559;4479;2;0
FR;1;2021-04-24;126298;95461;147;0;0;9518912;5025020;4626;2;0
FR;1;2021-04-25;53616;30011;46;0;0;9572528;5055031;4672;2;0
FR;1;2021-04-26;181082;138315;539;0;0;9753610;5193346;5211;2;0
FR;1;2021-04-27;221315;161833;900;0;0;9974925;5355179;6111;2;0
FR;1;2021-04-28;238232;155019;1310;1;1;10213157;5510198;7421;3;1
FR;1;2021-04-29;270220;160338;1207;0;0;10483377;5670536;8628;3;1
FR;1;2021-04-30;271922;148084;1069;0;0;10755299;5818620;9697;3;1
FR;1;2021-05-01;141113;40635;172;0;0;10896412;5859255;9869;3;1
FR;1;2021-05-02;81519;28088;81;0;0;10977931;5887343;9950;3;1
FR;1;2021-05-03;250724;145334;799;0;0;11228655;6032677;10749;3;1
FR;1;2021-05-04;265798;186878;1197;0;0;11494453;6219555;11946;3;1
FR;1;2021-05-05;283798;184709;1264;0;0;11778251;6404264;13210;3;1
FR;1;2021-05-06;309884;183198;1498;0;0;12088135;6587462;14708;3;1
FR;1;2021-05-07;284033;195630;1125;0;0;12372168;6783092;15833;3;1
FR;1;2021-05-08;191635;48574;283;0;0;12563803;6831666;16116;3;1
FR;1;2021-05-09;114045;35909;236;0;0;12677848;6867575;16352;3;1
FR;1;2021-05-10;258127;193966;1182;0;0;12935975;7061541;17534;3;1
FR;1;2021-05-11;318814;210987;1462;0;0;13254789;7272528;18996;3;1
FR;1;2021-05-12;356557;185657;1399;0;0;13611346;7458185;20395;3;1
FR;1;2021-05-13;283398;47709;399;0;0;13894744;7505894;20794;3;1
FR;1;2021-05-14;370437;128571;990;0;0;14265181;7634465;21784;3;1
FR;1;2021-05-15;298044;66093;402;0;0;14563225;7700558;22186;3;1
FR;1;2021-05-16;157745;15541;158;0;0;14720970;7716099;22344;3;1
FR;1;2021-05-17;318878;116321;1436;0;0;15039848;7832420;23780;3;1
FR;1;2021-05-18;383261;111177;1795;0;0;15423109;7943597;25575;3;1
FR;1;2021-05-19;395202;102599;2174;0;0;15818311;8046196;27749;3;1
FR;1;2021-05-20;421745;96108;2041;0;0;16240056;8142304;29790;3;1
FR;1;2021-05-21;399730;97163;1755;0;0;16639786;8239467;31545;3;1
FR;1;2021-05-22;275642;42019;602;0;0;16915428;8281486;32147;3;1
FR;1;2021-05-23;122962;11151;224;0;0;17038390;8292637;32371;3;1
FR;1;2021-05-24;243962;26215;565;0;0;17282352;8318852;32936;3;1
FR;1;2021-05-25;366122;131622;2108;1;0;17648474;8450474;35044;4;1
FR;1;2021-05-26;380732;125839;1987;0;0;18029206;8576313;37031;4;1
FR;1;2021-05-27;406050;127974;1973;0;0;18435256;8704287;39004;4;1
FR;1;2021-05-28;365932;145266;1697;0;0;18801188;8849553;40701;4;1
FR;1;2021-05-29;253799;80827;525;0;0;19054987;8930380;41226;4;1
FR;1;2021-05-30;100934;22541;157;0;0;19155921;8952921;41383;4;1
FR;1;2021-05-31;314213;148741;1279;1;1;19470134;9101662;42662;5;2
FR;1;2021-06-01;361474;166445;1724;1;1;19831608;9268107;44386;6;3
FR;1;2021-06-02;364591;153152;1791;0;0;20196199;9421259;46177;6;3
FR;1;2021-06-03;390418;147549;1647;0;0;20586617;9568808;47824;6;3
FR;1;2021-06-04;363559;175506;1492;1;1;20950176;9744314;49316;7;4
FR;1;2021-06-05;258457;112644;596;0;0;21208633;9856958;49912;7;4
FR;1;2021-06-06;126739;37544;215;0;0;21335372;9894502;50127;7;4
FR;1;2021-06-07;300116;207787;1361;0;0;21635488;10102289;51488;7;4
FR;1;2021-06-08;330538;220762;1636;0;0;21966026;10323051;53124;7;4
FR;1;2021-06-09;336387;212213;1607;0;0;22302413;10535264;54731;7;4
FR;1;2021-06-10;343681;201883;1608;0;0;22646094;10737147;56339;7;4
FR;1;2021-06-11;311726;235264;1291;0;0;22957820;10972411;57630;7;4
FR;1;2021-06-12;244025;150652;431;0;0;23201845;11123063;58061;7;4
FR;1;2021-06-13;100315;60992;188;0;0;23302160;11184055;58249;7;4
FR;1;2021-06-14;207667;288790;1316;1;0;23509827;11472845;59565;8;4
FR;1;2021-06-15;256699;282122;1390;1;0;23766526;11754967;60955;9;4
FR;1;2021-06-16;273518;270574;1262;1;0;24040044;12025541;62217;10;4
FR;1;2021-06-17;268093;244719;1231;1;0;24308137;12270260;63448;11;4
FR;1;2021-06-18;260418;295651;1149;1;0;24568555;12565911;64597;12;4
FR;1;2021-06-19;193413;209485;387;0;0;24761968;12775396;64984;12;4
FR;1;2021-06-20;69649;89152;117;0;0;24831617;12864548;65101;12;4
FR;1;2021-06-21;172195;319781;929;1;1;25003812;13184329;66030;13;5
FR;1;2021-06-22;185682;347847;1096;10;2;25189494;13532176;67126;23;7
FR;1;2021-06-23;204043;339484;1048;0;0;25393537;13871660;68174;23;7
FR;1;2021-06-24;203400;282094;1166;0;0;25596937;14153754;69340;23;7
FR;1;2021-06-25;182494;371819;1196;0;0;25779431;14525573;70536;23;7
FR;1;2021-06-26;131346;278306;502;0;0;25910777;14803879;71038;23;7
FR;1;2021-06-27;52372;122905;145;0;0;25963149;14926784;71183;23;7
FR;1;2021-06-28;136506;368129;1057;0;0;26099655;15294913;72240;23;7
FR;1;2021-06-29;154748;390699;1849;0;0;26254403;15685612;74089;23;7
FR;1;2021-06-30;179905;379415;1662;4;2;26434308;16065027;75751;27;9
FR;1;2021-07-01;201269;332194;1886;5;1;26635577;16397221;77637;32;10
FR;1;2021-07-02;193525;367667;1764;5;3;26829102;16764888;79401;37;13
FR;1;2021-07-03;124376;280452;704;3;1;26953478;17045340;80105;40;14
FR;1;2021-07-04;53906;113693;244;0;0;27007384;17159033;80349;40;14
FR;1;2021-07-05;153664;356027;1500;8;2;27161048;17515060;81849;48;16
FR;1;2021-07-06;173300;382521;1601;45;8;27334348;17897581;83450;93;24
FR;1;2021-07-07;190582;362569;1656;24;5;27524930;18260150;85106;117;29
FR;1;2021-07-08;201383;323116;1825;20;7;27726313;18583266;86931;137;36
FR;1;2021-07-09;189712;387572;1851;3;2;27916025;18970838;88782;140;38
FR;1;2021-07-10;129874;281131;814;1;1;28045899;19251969;89596;141;39
FR;1;2021-07-11;57626;102502;261;0;0;28103525;19354471;89857;141;39
FR;1;2021-07-12;149468;417026;1579;4;0;28252993;19771497;91436;145;39
FR;1;2021-07-13;234074;439481;1805;8;2;28487067;20210978;93241;153;41
FR;1;2021-07-14;171731;151539;416;0;0;28658798;20362517;93657;153;41
FR;1;2021-07-15;279467;424766;1856;1;0;28938265;20787283;95513;154;41
FR;1;2021-07-16;290260;401240;1710;3;1;29228525;21188523;97223;157;42
FR;1;2021-07-17;217275;282117;754;1;0;29445800;21470640;97977;158;42
FR;1;2021-07-18;101960;107308;288;0;0;29547760;21577948;98265;158;42
FR;1;2021-07-19;238072;379182;1495;3;0;29785832;21957130;99760;161;42
FR;1;2021-07-20;305577;380749;1467;0;0;30091409;22337879;101227;161;42
FR;1;2021-07-21;333130;353441;1412;4;2;30424539;22691320;102639;165;44
FR;1;2021-07-22;364518;319265;1501;3;2;30789057;23010585;104140;168;46
FR;1;2021-07-23;348941;343616;1586;4;2;31137998;23354201;105726;172;48
FR;1;2021-07-24;238909;240986;696;1;0;31376907;23595187;106422;173;48
FR;1;2021-07-25;112748;76058;215;0;0;31489655;23671245;106637;173;48
FR;1;2021-07-26;299015;290061;1496;2;2;31788670;23961306;108133;175;50
FR;1;2021-07-27;385701;268711;1457;4;2;32174371;24230017;109590;179;52
FR;1;2021-07-28;390084;251451;1460;4;2;32564455;24481468;111050;183;54
FR;1;2021-07-29;406017;228252;1538;2;1;32970472;24709720;112588;185;55
FR;1;2021-07-30;370592;246989;1632;4;1;33341064;24956709;114220;189;56
FR;1;2021-07-31;243351;165123;793;1;0;33584415;25121832;115013;190;56
FR;1;2021-08-01;105521;47235;232;0;0;33689936;25169067;115245;190;56
FR;1;2021-08-02;297026;213219;1475;2;0;33986962;25382286;116720;192;56
FR;1;2021-08-03;331161;209222;1545;2;1;34318123;25591508;118265;194;57
FR;1;2021-08-04;327833;184347;1436;5;3;34645956;25775855;119701;199;60
FR;1;2021-08-05;301116;193568;1482;0;0;34947072;25969423;121183;199;60
FR;1;2021-08-06;290831;224525;1558;3;1;35237903;26193948;122741;202;61
FR;1;2021-08-07;182599;158829;654;4;3;35420502;26352777;123395;206;64
FR;1;2021-08-08;68834;59132;247;0;0;35489336;26411909;123642;206;64
FR;1;2021-08-09;222628;235886;1438;4;3;35711964;26647795;125080;210;67
FR;1;2021-08-10;252503;240641;1486;2;1;35964467;26888436;126566;212;68
FR;1;2021-08-11;236039;232375;1270;5;1;36200506;27120811;127836;217;69
FR;1;2021-08-12;220618;240222;1484;3;1;36421124;27361033;129320;220;70
FR;1;2021-08-13;201621;238543;1355;2;2;36622745;27599576;130675;222;72
FR;1;2021-08-14;122812;174163;645;0;0;36745557;27773739;131320;222;72
FR;1;2021-08-15;34657;46117;198;1;0;36780214;27819856;131518;223;72
FR;1;2021-08-16;156834;289852;1421;0;0;36937048;28109708;132939;223;72
FR;1;2021-08-17;171502;291587;1420;5;1;37108550;28401295;134359;228;73
FR;1;2021-08-18;161313;286999;1389;6;3;37269863;28688294;135748;234;76
FR;1;2021-08-19;148813;277716;1396;1;0;37418676;28966010;137144;235;76
FR;1;2021-08-20;140409;309066;1524;2;2;37559085;29275076;138668;237;78
FR;1;2021-08-21;84234;213250;586;0;0;37643319;29488326;139254;237;78
FR;1;2021-08-22;28543;82693;230;0;0;37671862;29571019;139484;237;78
FR;1;2021-08-23;118581;321169;1420;2;1;37790443;29892188;140904;239;79
FR;1;2021-08-24;126593;319898;1599;5;1;37917036;30212086;142503;244;80
FR;1;2021-08-25;121457;306582;1776;8;3;38038493;30518668;144279;252;83
FR;1;2021-08-26;106512;286194;2155;10;1;38145005;30804862;146434;262;84
FR;1;2021-08-27;107591;321531;2300;8;3;38252596;31126393;148734;270;87
FR;1;2021-08-28;70968;220704;1100;0;0;38323564;31347097;149834;270;87
FR;1;2021-08-29;24136;78153;467;1;0;38347700;31425250;150301;271;87
FR;1;2021-08-30;96805;286529;4307;6;5123;38444505;31711779;154608;277;5210
FR;1;2021-08-31;98029;276449;9285;15;10176;38542534;31988228;163893;292;15386
FR;1;2021-09-01;111959;245337;21103;7;22074;38654493;32233565;184996;299;37460
FR;1;2021-09-02;84707;198007;24521;11;25427;38739200;32431572;209517;310;62887
FR;1;2021-09-03;82310;227612;26943;20;27973;38821510;32659184;236460;330;90860
FR;1;2021-09-04;71544;189713;11138;11;11651;38893054;32848897;247598;341;102511
FR;1;2021-09-05;18594;41191;4121;2;4288;38911648;32890088;251719;343;106799
FR;1;2021-09-06;59466;151636;30171;15;31151;38971114;33041724;281890;358;137950
FR;1;2021-09-07;57167;139712;30200;27;31101;39028281;33181436;312090;385;169051
FR;1;2021-09-08;71056;173874;26916;20;27863;39099337;33355310;339006;405;196914
FR;1;2021-09-09;54199;124552;28599;23;29645;39153536;33479862;367605;428;226559
FR;1;2021-09-10;65779;152095;30429;22;31562;39219315;33631957;398034;450;258121
FR;1;2021-09-11;52265;146617;9727;14;10301;39271580;33778574;407761;464;268422
FR;1;2021-09-12;10766;29240;2481;1;2635;39282346;33807814;410242;465;271057
FR;1;2021-09-13;51325;104600;38726;28;39906;39333671;33912414;448968;493;310963
FR;1;2021-09-14;53169;96054;51251;65;52868;39386840;34008468;500219;558;363831
FR;1;2021-09-15;60344;139291;50458;55;46963;39447184;34147759;550677;613;410794
FR;1;2021-09-16;46529;81417;53285;71;49465;39493713;34229176;603962;684;460259
FR;1;2021-09-17;53108;109384;45045;60;42632;39546821;34338560;649007;744;502891
FR;1;2021-09-18;37832;118491;11789;19;11254;39584653;34457051;660796;763;514145
FR;1;2021-09-19;6492;21035;2037;1;1973;39591145;34478086;662833;764;516118
FR;1;2021-09-20;36426;74920;46170;66;44084;39627571;34553006;709003;830;560202
FR;1;2021-09-21;34119;68142;56226;71;52609;39661690;34621148;765229;901;612811
FR;1;2021-09-22;38742;118505;49832;76;46812;39700432;34739653;815061;977;659623
FR;1;2021-09-23;31922;62829;54458;85;50808;39732354;34802482;869519;1062;710431
FR;1;2021-09-24;36700;90046;43638;91;41868;39769054;34892528;913157;1153;752299
FR;1;2021-09-25;27624;96605;12297;27;12161;39796678;34989133;925454;1180;764460
FR;1;2021-09-26;4357;15204;1770;5;1696;39801035;35004337;927224;1185;766156
FR;1;2021-09-27;27306;60231;42880;89;41558;39828341;35064568;970104;1274;807714
FR;1;2021-09-28;26841;49453;47155;75;44371;39855182;35114021;1017259;1349;852085
FR;1;2021-09-29;35825;80390;47244;87;45518;39891007;35194411;1064503;1436;897603
FR;1;2021-09-30;26008;46761;47490;79;45361;39917015;35241172;1111993;1515;942964
FR;1;2021-10-01;47124;64983;44853;83;44397;39964139;35306155;1156846;1598;987361
FR;1;2021-10-02;32330;62339;16104;32;16294;39996469;35368494;1172950;1630;1003655
FR;1;2021-10-03;4318;8574;2031;3;2024;40000787;35377068;1174981;1633;1005679
FR;1;2021-10-04;28742;44409;47088;79;46897;40029529;35421477;1222069;1712;1052576
FR;1;2021-10-05;24205;41624;49827;116;49172;40053734;35463101;1271896;1828;1101748
FR;1;2021-10-06;34360;61304;57440;102;57114;40088094;35524405;1329336;1930;1158862
FR;1;2021-10-07;20924;39799;52988;76;51806;40109018;35564204;1382324;2006;1210668
FR;1;2021-10-08;34941;59580;60356;83;61046;40143959;35623784;1442680;2089;1271714
FR;1;2021-10-09;27419;47963;25473;30;25969;40171378;35671747;1468153;2119;1297683
FR;1;2021-10-10;3597;5778;2746;7;2845;40174975;35677525;1470899;2126;1300528
FR;1;2021-10-11;24690;38165;54559;88;55166;40199665;35715690;1525458;2214;1355694
FR;1;2021-10-12;23080;36573;58019;126;59078;40222745;35752263;1583477;2340;1414772
FR;1;2021-10-13;32792;47797;64142;124;65611;40255537;35800060;1647619;2464;1480383
FR;1;2021-10-14;21589;34748;53723;103;54283;40277126;35834808;1701342;2567;1534666
FR;1;2021-10-15;32544;48786;72292;165;74903;40309670;35883594;1773634;2732;1609569
FR;1;2021-10-16;25955;35277;34857;44;36390;40335625;35918871;1808491;2776;1645959
FR;1;2021-10-17;3096;4065;3407;2;3318;40338721;35922936;1811898;2778;1649277
FR;1;2021-10-18;23432;34902;66803;131;69643;40362153;35957838;1878701;2909;1718920
FR;1;2021-10-19;20583;34404;75625;136;79511;40382736;35992242;1954326;3045;1798431
FR;1;2021-10-20;29793;44188;96136;177;99751;40412529;36036430;2050462;3222;1898182
FR;1;2021-10-21;19574;35075;83117;107;86972;40432103;36071505;2133579;3329;1985154
FR;1;2021-10-22;29511;47629;103697;195;109560;40461614;36119134;2237276;3524;2094714
FR;1;2021-10-23;22996;35151;44846;57;47344;40484610;36154285;2282122;3581;2142058
FR;1;2021-10-24;2373;3878;3579;6;3732;40486983;36158163;2285701;3587;2145790
FR;1;2021-10-25;22385;30821;81990;143;85755;40509368;36188984;2367691;3730;2231545
FR;1;2021-10-26;19293;27700;86058;162;90275;40528661;36216684;2453749;3892;2321820
FR;1;2021-10-27;26128;39654;107751;252;112588;40554789;36256338;2561500;4144;2434408
FR;1;2021-10-28;18582;27039;86890;150;91560;40573371;36283377;2648390;4294;2525968
FR;1;2021-10-29;25865;40130;114782;200;121505;40599236;36323507;2763172;4494;2647473
FR;1;2021-10-30;17663;28600;49339;75;51914;40616899;36352107;2812511;4569;2699387
FR;1;2021-10-31;2053;3203;3442;2;3677;40618952;36355310;2815953;4571;2703064
FR;1;2021-11-01;7695;4198;3019;3;3261;40626647;36359508;2818972;4574;2706325
FR;1;2021-11-02;21824;33193;92338;157;97674;40648471;36392701;2911310;4731;2803999
FR;1;2021-11-03;26270;41520;117434;215;123781;40674741;36434221;3028744;4946;2927780
FR;1;2021-11-04;19483;30286;105729;213;111812;40694224;36464507;3134473;5159;3039592
FR;1;2021-11-05;26897;42238;138712;227;147286;40721121;36506745;3273185;5386;3186878
FR;1;2021-11-06;18801;29821;63439;123;66404;40739922;36536566;3336624;5509;3253282
FR;1;2021-11-07;1787;3354;4952;6;5292;40741709;36539920;3341576;5515;3258574
FR;1;2021-11-08;17650;32307;125898;224;132449;40759359;36572227;3467474;5739;3391023
FR;1;2021-11-09;19211;37710;159208;335;168906;40778570;36609937;3626682;6074;3559929
FR;1;2021-11-10;28652;49135;181811;440;192350;40807222;36659072;3808493;6514;3752279
FR;1;2021-11-11;3769;5925;12188;26;12994;40810991;36664997;3820681;6540;3765273
FR;1;2021-11-12;25928;46871;174735;243;186330;40836919;36711868;3995416;6783;3951603
FR;1;2021-11-13;18678;29247;76800;111;81738;40855597;36741115;4072216;6894;4033341
FR;1;2021-11-14;2016;3317;6812;5;7386;40857613;36744432;4079028;6899;4040727
FR;1;2021-11-15;18565;34892;156330;303;166088;40876178;36779324;4235358;7202;4206815
FR;1;2021-11-16;21050;37920;191997;376;204768;40897228;36817244;4427355;7578;4411583
FR;1;2021-11-17;28487;45726;193140;399;204911;40925715;36862970;4620495;7977;4616494
FR;1;2021-11-18;21044;38815;182381;457;194348;40946759;36901785;4802876;8434;4810842
FR;1;2021-11-19;30769;53371;230136;529;246547;40977528;36955156;5033012;8963;5057389
FR;1;2021-11-20;23675;33317;96935;201;103571;41001203;36988473;5129947;9164;5160960
FR;1;2021-11-21;2312;4016;9095;18;9969;41003515;36992489;5139042;9182;5170929
FR;1;2021-11-22;21351;30460;175786;465;189296;41024866;37022949;5314828;9647;5360225
FR;1;2021-11-23;23869;41175;221085;538;237788;41048735;37064124;5535913;10185;5598013
FR;1;2021-11-24;30252;49736;217250;703;234350;41078987;37113860;5753163;10888;5832363
FR;1;2021-11-25;23477;43938;244336;719;263887;41102464;37157798;5997499;11607;6096250
FR;1;2021-11-26;30579;66551;356665;832;388356;41133043;37224349;6354164;12439;6484606
FR;1;2021-11-27;21754;45360;202546;371;222518;41154797;37269709;6556710;12810;6707124
FR;1;2021-11-28;3137;9675;54751;63;61026;41157934;37279384;6611461;12873;6768150
FR;1;2021-11-29;17853;49509;326260;840;354234;41175787;37328893;6937721;13713;7122384
FR;1;2021-11-30;22706;64983;431022;948;470588;41198493;37393876;7368743;14661;7592972
FR;1;2021-12-01;24839;69359;442733;1130;481569;41223332;37463235;7811476;15791;8074541
FR;1;2021-12-02;19955;64421;489238;1227;532672;41243287;37527656;8300714;17018;8607213
FR;1;2021-12-03;22822;81820;542594;1307;591572;41266109;37609476;8843308;18325;9198785
FR;1;2021-12-04;16365;53935;299018;652;328848;41282474;37663411;9142326;18977;9527633
FR;1;2021-12-05;3622;13920;81495;143;91051;41286096;37677331;9223821;19120;9618684
FR;1;2021-12-06;20127;62785;415294;1065;455010;41306223;37740116;9639115;20185;10073694
FR;1;2021-12-07;19784;75824;522795;1531;572390;41326007;37815940;10161910;21716;10646084
FR;1;2021-12-08;21545;75797;458207;1543;501883;41347552;37891737;10620117;23259;11147967
FR;1;2021-12-09;19386;74109;492748;1625;540608;41366938;37965846;11112865;24884;11688575
FR;1;2021-12-10;22914;87630;547255;1584;599843;41389852;38053476;11660120;26468;12288418
FR;1;2021-12-11;16510;59019;302671;747;335421;41406362;38112495;11962791;27215;12623839
FR;1;2021-12-12;4343;16026;83178;179;94081;41410705;38128521;12045969;27394;12717920
FR;1;2021-12-13;15464;63828;366821;1094;406187;41426169;38192349;12412790;28488;13124107
FR;1;2021-12-14;20456;80296;464532;1738;515005;41446625;38272645;12877322;30226;13639112
FR;1;2021-12-15;21371;77491;408908;1307;452984;41467996;38350136;13286230;31533;14092096
FR;1;2021-12-16;19952;77388;451670;1574;500455;41487948;38427524;13737900;33107;14592551
FR;1;2021-12-17;22510;86716;479780;1732;530919;41510458;38514240;14217680;34839;15123470
FR;1;2021-12-18;17581;54712;257554;730;288462;41528039;38568952;14475234;35569;15411932
FR;1;2021-12-19;5536;17136;79129;194;90741;41533575;38586088;14554363;35763;15502673
FR;1;2021-12-20;20769;63158;316092;1081;355160;41554344;38649246;14870455;36844;15857833
FR;1;2021-12-21;26094;73217;372616;1421;417970;41580438;38722463;15243071;38265;16275803
FR;1;2021-12-22;24890;65991;310499;1215;349471;41605328;38788454;15553570;39480;16625274
FR;1;2021-12-23;21230;52351;241382;954;272978;41626558;38840805;15794952;40434;16898252
FR;1;2021-12-24;7098;18243;67104;256;77023;41633656;38859048;15862056;40690;16975275
FR;1;2021-12-25;499;2765;5566;15;6526;41634155;38861813;15867622;40705;16981801
FR;1;2021-12-26;2747;7597;26922;70;31447;41636902;38869410;15894544;40775;17013248
FR;1;2021-12-27;18172;53570;235010;707;265697;41655074;38922980;16129554;41482;17278945
FR;1;2021-12-28;23239;61997;291944;1025;330128;41678313;38984977;16421498;42507;17609073
FR;1;2021-12-29;22191;55556;254909;918;288125;41700504;39040533;16676407;43425;17897198
FR;1;2021-12-30;21218;46319;212091;857;239558;41721722;39086852;16888498;44282;18136756
FR;1;2021-12-31;7455;16613;61831;229;70356;41729177;39103465;16950329;44511;18207112
FR;1;2022-01-01;907;2476;5643;29;6573;41730084;39105941;16955972;44540;18213685
FR;1;2022-01-02;3040;8062;28869;50;33521;41733124;39114003;16984841;44590;18247206
FR;1;2022-01-03;19920;53834;228101;786;257505;41753044;39167837;17212942;45376;18504711
FR;1;2022-01-04;24967;64825;299143;1235;337180;41778011;39232662;17512085;46611;18841891
FR;1;2022-01-05;29668;63894;274761;1098;310107;41807679;39296556;17786846;47709;19151998
FR;1;2022-01-06;26485;65981;306792;1395;346425;41834164;39362537;18093638;49104;19498423
FR;1;2022-01-07;31291;74652;349751;1534;393828;41865455;39437189;18443389;50638;19892251
FR;1;2022-01-08;23340;51381;222457;695;251090;41888795;39488570;18665846;51333;20143341
FR;1;2022-01-09;7075;17197;66010;163;76154;41895870;39505767;18731856;51496;20219495
FR;1;2022-01-10;21411;55569;236681;952;267045;41917281;39561336;18968537;52448;20486540
FR;1;2022-01-11;26477;63052;282192;1277;317739;41943758;39624388;19250729;53725;20804279
FR;1;2022-01-12;28701;62232;246140;1102;277911;41972459;39686620;19496869;54827;21082190
FR;1;2022-01-13;24424;59914;262698;1253;296043;41996883;39746534;19759567;56080;21378233
FR;1;2022-01-14;27774;66521;313898;1366;351177;42024657;39813055;20073465;57446;21729410
FR;1;2022-01-15;19257;44311;199266;619;223839;42043914;39857366;20272731;58065;21953249
FR;1;2022-01-16;5133;12986;51495;135;59568;42049047;39870352;20324226;58200;22012817
FR;1;2022-01-17;16734;39711;184771;779;206823;42065781;39910063;20508997;58979;22219640
FR;1;2022-01-18;19237;45686;212349;1151;236973;42085018;39955749;20721346;60130;22456613
FR;1;2022-01-19;20137;43908;176031;894;197161;42105155;39999657;20897377;61024;22653774
FR;1;2022-01-20;16587;40376;183576;1137;204668;42121742;40040033;21080953;62161;22858442
FR;1;2022-01-21;19704;46946;228879;1405;253293;42141446;40086979;21309832;63566;23111735
FR;1;2022-01-22;13826;33210;144465;578;161363;42155272;40120189;21454297;64144;23273098
FR;1;2022-01-23;3344;8803;33400;130;38327;42158616;40128992;21487697;64274;23311425
FR;1;2022-01-24;11725;32638;142155;706;158240;42170341;40161630;21629852;64980;23469665
FR;1;2022-01-25;14091;37976;163333;1049;181516;42184432;40199606;21793185;66029;23651181
FR;1;2022-01-26;14820;37358;150193;931;166254;42199252;40236964;21943378;66960;23817435
FR;1;2022-01-27;12278;32859;143383;882;157864;42211530;40269823;22086761;67842;23975299
FR;1;2022-01-28;16247;53843;198242;1143;222450;42227777;40323666;22285003;68985;24197749
FR;1;2022-01-29;10257;35435;135172;522;151541;42238034;40359101;22420175;69507;24349290
FR;1;2022-01-30;2475;9303;29667;86;34465;42240509;40368404;22449842;69593;24383755
FR;1;2022-01-31;8725;32349;104297;530;117389;42249234;40400753;22554139;70123;24501144
FR;1;2022-02-01;10172;36253;127014;862;141222;42259406;40437006;22681153;70985;24642366
FR;1;2022-02-02;11411;41098;130288;780;145836;42270817;40478104;22811441;71765;24788202
FR;1;2022-02-03;8729;33378;116949;780;130347;42279546;40511482;22928390;72545;24918549
FR;1;2022-02-04;11377;48085;172518;965;192779;42290923;40559567;23100908;73510;25111328
FR;1;2022-02-05;7881;33900;117549;391;133050;42298804;40593467;23218457;73901;25244378
FR;1;2022-02-06;1689;8054;22734;83;26906;42300493;40601521;23241191;73984;25271284
FR;1;2022-02-07;7059;35332;119037;452;134961;42307552;40636853;23360228;74436;25406245
FR;1;2022-02-08;7554;31534;125597;693;140571;42315106;40668387;23485825;75129;25546816
FR;1;2022-02-09;8443;36104;135200;694;152413;42323549;40704491;23621025;75823;25699229
FR;1;2022-02-10;6574;29262;116290;674;130031;42330123;40733753;23737315;76497;25829260
FR;1;2022-02-11;8544;41315;165071;875;185277;42338667;40775068;23902386;77372;26014537
FR;1;2022-02-12;5288;27523;106671;378;120842;42343955;40802591;24009057;77750;26135379
FR;1;2022-02-13;1222;5698;21703;62;25315;42345177;40808289;24030760;77812;26160694
FR;1;2022-02-14;5362;27069;118031;388;133051;42350539;40835358;24148791;78200;26293745
FR;1;2022-02-15;5581;28084;118841;609;132429;42356120;40863442;24267632;78809;26426174
FR;1;2022-02-16;5638;28104;110369;592;122963;42361758;40891546;24378001;79401;26549137
FR;1;2022-02-17;4406;19109;73087;486;80132;42366164;40910655;24451088;79887;26629269
FR;1;2022-02-18;5487;26438;99139;668;108078;42371651;40937093;24550227;80555;26737347
FR;1;2022-02-19;3523;17076;59457;304;66027;42375174;40954169;24609684;80859;26803374
FR;1;2022-02-20;780;3223;10690;35;12311;42375954;40957392;24620374;80894;26815685
FR;1;2022-02-21;3354;14464;52790;286;57634;42379308;40971856;24673164;81180;26873319
FR;1;2022-02-22;3710;15353;51869;499;55590;42383018;40987209;24725033;81679;26928909
FR;1;2022-02-23;4153;17596;57440;508;62538;42387171;41004805;24782473;82187;26991447
FR;1;2022-02-24;3240;12739;43566;436;46344;42390411;41017544;24826039;82623;27037791
FR;1;2022-02-25;4389;19385;64838;695;68699;42394800;41036929;24890877;83318;27106490
FR;1;2022-02-26;2677;12682;41342;308;45095;42397477;41049611;24932219;83626;27151585
FR;1;2022-02-27;637;2167;7115;42;7980;42398114;41051778;24939334;83668;27159565
FR;1;2022-02-28;2560;10097;34918;300;37339;42400674;41061875;24974252;83968;27196904
FR;1;2022-03-01;2710;10373;38639;389;39561;42403384;41072248;25012891;84357;27236465
FR;1;2022-03-02;3430;11854;41806;390;43853;42406814;41084102;25054697;84747;27280318
FR;1;2022-03-03;2286;7521;26116;319;26427;42409100;41091623;25080813;85066;27306745
FR;1;2022-03-04;2645;10205;35385;575;34863;42411745;41101828;25116198;85641;27341608
FR;1;2022-03-05;1671;6289;21940;277;22325;42413416;41108117;25138138;85918;27363933
FR;1;2022-03-06;349;936;2914;37;3112;42413765;41109053;25141052;85955;27367045
FR;1;2022-03-07;1363;4558;16404;244;15858;42415128;41113611;25157456;86199;27382903
FR;1;2022-03-08;1533;5080;17123;307;15941;42416661;41118691;25174579;86506;27398844
FR;1;2022-03-09;1859;6455;19772;366;19119;42418520;41125146;25194351;86872;27417963
FR;1;2022-03-10;1296;4366;15185;305;14192;42419816;41129512;25209536;87177;27432155
FR;1;2022-03-11;1690;6142;21670;480;19819;42421506;41135654;25231206;87657;27451974
FR;1;2022-03-12;1227;4589;15350;276;14894;42422733;41140243;25246556;87933;27466868
FR;1;2022-03-13;239;601;2102;115;2049;42422972;41140844;25248658;88048;27468917
FR;1;2022-03-14;1062;3539;13361;3873;12484;42424034;41144383;25262019;91921;27481401
FR;1;2022-03-15;1254;3821;14516;6861;12993;42425288;41148204;25276535;98782;27494394
FR;1;2022-03-16;1600;4724;17323;11513;16372;42426888;41152928;25293858;110295;27510766
FR;1;2022-03-17;1092;3148;11675;9637;10769;42427980;41156076;25305533;119932;27521535
FR;1;2022-03-18;1660;4678;17906;16484;16333;42429640;41160754;25323439;136416;27537868
FR;1;2022-03-19;1109;3165;11878;8450;11342;42430749;41163919;25335317;144866;27549210
FR;1;2022-03-20;216;531;1714;1006;1746;42430965;41164450;25337031;145872;27550956
FR;1;2022-03-21;1035;2672;11468;13442;10813;42432000;41167122;25348499;159314;27561769
FR;1;2022-03-22;1184;3048;12216;18681;11202;42433184;41170170;25360715;177995;27572971
FR;1;2022-03-23;1459;4147;15952;20090;15631;42434643;41174317;25376667;198085;27588602
FR;1;2022-03-24;1068;2508;10348;16012;9599;42435711;41176825;25387015;214097;27598201
FR;1;2022-03-25;1496;4006;16660;25278;15307;42437207;41180831;25403675;239375;27613508
FR;1;2022-03-26;1095;2836;10836;11429;10494;42438302;41183667;25414511;250804;27624002
FR;1;2022-03-27;227;536;1722;1376;1774;42438529;41184203;25416233;252180;27625776
FR;1;2022-03-28;1031;2330;9909;15859;9527;42439560;41186533;25426142;268039;27635303
FR;1;2022-03-29;1109;2693;11509;25059;10875;42440669;41189226;25437651;293098;27646178
FR;1;2022-03-30;1590;3449;14087;24144;13616;42442259;41192675;25451738;317242;27659794
FR;1;2022-03-31;1258;2590;11564;22540;11069;42443517;41195265;25463302;339782;27670863
FR;1;2022-04-01;1642;3717;18389;28446;17235;42445159;41198982;25481691;368228;27688098
FR;1;2022-04-02;880;1850;8160;9203;7907;42446039;41200832;25489851;377431;27696005
FR;1;2022-04-03;185;362;1426;1056;1426;42446224;41201194;25491277;378487;27697431
FR;1;2022-04-04;1037;2120;11158;17615;10528;42447261;41203314;25502435;396102;27707959
FR;1;2022-04-05;1236;2466;12898;31089;11916;42448497;41205780;25515333;427191;27719875
FR;1;2022-04-06;1308;2679;12073;23737;11484;42449805;41208459;25527406;450928;27731359
FR;1;2022-04-07;1123;2457;12251;30836;11706;42450928;41210916;25539657;481764;27743065
FR;1;2022-04-08;1551;3449;17451;40386;16363;42452479;41214365;25557108;522150;27759428
FR;1;2022-04-09;798;1969;8378;12470;8072;42453277;41216334;25565486;534620;27767500
FR;1;2022-04-10;180;454;1816;1831;1848;42453457;41216788;25567302;536451;27769348
FR;1;2022-04-11;932;2093;10907;22103;10616;42454389;41218881;25578209;558554;27779964
FR;1;2022-04-12;1189;2372;12687;37765;12171;42455578;41221253;25590896;596319;27792135
FR;1;2022-04-13;1149;2576;12142;30254;11858;42456727;41223829;25603038;626573;27803993
FR;1;2022-04-14;1163;2274;11931;33196;11912;42457890;41226103;25614969;659769;27815905
FR;1;2022-04-15;1401;2762;14260;32909;13634;42459291;41228865;25629229;692678;27829539
FR;1;2022-04-16;646;1387;5810;7966;5731;42459937;41230252;25635039;700644;27835270
FR;1;2022-04-17;148;270;927;1101;969;42460085;41230522;25635966;701745;27836239
FR;1;2022-04-18;113;365;2592;968;2615;42460198;41230887;25638558;702713;27838854
FR;1;2022-04-19;1178;2470;11689;27571;11363;42461376;41233357;25650247;730284;27850217
FR;1;2022-04-20;1244;2501;12012;26506;11837;42462620;41235858;25662259;756790;27862054
FR;1;2022-04-21;1197;2320;11391;32786;11553;42463817;41238178;25673650;789576;27873607
FR;1;2022-04-22;1464;2931;15113;35241;14692;42465281;41241109;25688763;824817;27888299
FR;1;2022-04-23;728;1551;6695;9861;6597;42466009;41242660;25695458;834678;27894896
FR;1;2022-04-24;180;353;1361;1504;1314;42466189;41243013;25696819;836182;27896210
FR;1;2022-04-25;977;2024;9774;19476;9660;42467166;41245037;25706593;855658;27905870
FR;1;2022-04-26;1274;2556;12498;36113;12085;42468440;41247593;25719091;891771;27917955
FR;1;2022-04-27;1258;2344;10530;28695;10637;42469698;41249937;25729621;920466;27928592
FR;1;2022-04-28;1235;2263;11403;33686;11225;42470933;41252200;25741024;954152;27939817
FR;1;2022-04-29;1551;2871;14193;35050;13611;42472484;41255071;25755217;989202;27953428
FR;1;2022-04-30;795;1424;6271;9083;6102;42473279;41256495;25761488;998285;27959530
FR;1;2022-05-01;137;257;783;909;781;42473416;41256752;25762271;999194;27960311
FR;1;2022-05-02;866;1762;9750;16515;9630;42474282;41258514;25772021;1015709;27969941
FR;1;2022-05-03;1335;2479;12157;32217;12061;42475617;41260993;25784178;1047926;27982002
FR;1;2022-05-04;1250;2349;10325;23229;10466;42476867;41263342;25794503;1071155;27992468
FR;1;2022-05-05;1290;2290;11079;31020;10881;42478157;41265632;25805582;1102175;28003349
FR;1;2022-05-06;1634;3048;13700;34471;13262;42479791;41268680;25819282;1136646;28016611
FR;1;2022-05-07;808;1422;5665;9024;5712;42480599;41270102;25824947;1145670;28022323
FR;1;2022-05-08;179;303;975;1437;1042;42480778;41270405;25825922;1147107;28023365
FR;1;2022-05-09;979;1774;8154;18762;8086;42481757;41272179;25834076;1165869;28031451
FR;1;2022-05-10;1320;2400;11294;36189;10970;42483077;41274579;25845370;1202058;28042421
FR;1;2022-05-11;1340;2104;9079;25321;8985;42484417;41276683;25854449;1227379;28051406
FR;1;2022-05-12;1221;2158;9915;32656;9556;42485638;41278841;25864364;1260035;28060962
FR;1;2022-05-13;1527;2619;12030;35011;11689;42487165;41281460;25876394;1295046;28072651
FR;1;2022-05-14;746;1236;5016;10063;4900;42487911;41282696;25881410;1305109;28077551
FR;1;2022-05-15;199;336;1013;1312;1095;42488110;41283032;25882423;1306421;28078646
FR;1;2022-05-16;887;1543;6664;19253;6723;42488997;41284575;25889087;1325674;28085369
FR;1;2022-05-17;1200;2082;9663;34814;9328;42490197;41286657;25898750;1360488;28094697
FR;1;2022-05-18;1194;1880;7766;24619;7709;42491391;41288537;25906516;1385107;28102406
FR;1;2022-05-19;1097;2094;8607;31763;8570;42492488;41290631;25915123;1416870;28110976
FR;1;2022-05-20;1443;2421;10779;35737;10385;42493931;41293052;25925902;1452607;28121361
FR;1;2022-05-21;729;1244;4497;8909;4480;42494660;41294296;25930399;1461516;28125841
FR;1;2022-05-22;155;230;843;1141;837;42494815;41294526;25931242;1462657;28126678
FR;2;2020-12-27;0;0;0;0;0;0;0;0;0;0
FR;2;2020-12-28;0;0;0;0;0;0;0;0;0;0
FR;2;2020-12-29;0;0;0;0;0;0;0;0;0;0
FR;2;2020-12-30;0;0;0;0;0;0;0;0;0;0
FR;2;2020-12-31;0;0;0;0;0;0;0;0;0;0
FR;2;2021-01-01;0;0;0;0;0;0;0;0;0;0
FR;2;2021-01-02;0;0;0;0;0;0;0;0;0;0
FR;2;2021-01-03;0;0;0;0;0;0;0;0;0;0
FR;2;2021-01-04;0;0;0;0;0;0;0;0;0;0
FR;2;2021-01-05;0;0;0;0;0;0;0;0;0;0
FR;2;2021-01-06;0;0;0;0;0;0;0;0;0;0
FR;2;2021-01-07;0;0;0;0;0;0;0;0;0;0
FR;2;2021-01-08;0;0;0;0;0;0;0;0;0;0
FR;2;2021-01-09;0;0;0;0;0;0;0;0;0;0
FR;2;2021-01-10;0;0;0;0;0;0;0;0;0;0
FR;2;2021-01-11;0;0;0;0;0;0;0;0;0;0
FR;2;2021-01-12;0;0;0;0;0;0;0;0;0;0
FR;2;2021-01-13;0;0;0;0;0;0;0;0;0;0
FR;2;2021-01-14;1689;0;0;0;0;1689;0;0;0;0
FR;2;2021-01-15;394;0;0;0;0;2083;0;0;0;0
FR;2;2021-01-16;315;0;0;0;0;2398;0;0;0;0
FR;2;2021-01-17;80;0;0;0;0;2478;0;0;0;0
FR;2;2021-01-18;3073;2;0;0;0;5551;2;0;0;0
FR;2;2021-01-19;4675;0;0;0;0;10226;2;0;0;0
FR;2;2021-01-20;5135;4;0;0;0;15361;6;0;0;0
FR;2;2021-01-21;5336;8;0;0;0;20697;14;0;0;0
FR;2;2021-01-22;5115;6;0;0;0;25812;20;0;0;0
FR;2;2021-01-23;1866;0;0;0;0;27678;20;0;0;0
FR;2;2021-01-24;160;1;0;0;0;27838;21;0;0;0
FR;2;2021-01-25;3811;3;0;0;0;31649;24;0;0;0
FR;2;2021-01-26;3918;1;0;0;0;35567;25;0;0;0
FR;2;2021-01-27;3598;2;0;0;0;39165;27;0;0;0
FR;2;2021-01-28;3745;7;0;0;0;42910;34;0;0;0
FR;2;2021-01-29;3291;2;0;0;0;46201;36;0;0;0
FR;2;2021-01-30;1130;1;0;0;0;47331;37;0;0;0
FR;2;2021-01-31;45;1;0;0;0;47376;38;0;0;0
FR;2;2021-02-01;3399;3;0;0;0;50775;41;0;0;0
FR;2;2021-02-02;4487;10;0;0;0;55262;51;0;0;0
FR;2;2021-02-03;5216;6;0;0;0;60478;57;0;0;0
FR;2;2021-02-04;4931;10;0;0;0;65409;67;0;0;0
FR;2;2021-02-05;4810;13;0;0;0;70219;80;0;0;0
FR;2;2021-02-06;2040;12;0;0;0;72259;92;0;0;0
FR;2;2021-02-07;101;4;0;0;0;72360;96;0;0;0
FR;2;2021-02-08;7553;19;0;0;0;79913;115;0;0;0
FR;2;2021-02-09;8420;27;0;0;0;88333;142;0;0;0
FR;2;2021-02-10;9337;56;0;0;0;97670;198;0;0;0
FR;2;2021-02-11;10279;95;0;0;0;107949;293;0;0;0
FR;2;2021-02-12;10053;260;0;0;0;118002;553;0;0;0
FR;2;2021-02-13;3118;225;0;0;0;121120;778;0;0;0
FR;2;2021-02-14;355;8;0;0;0;121475;786;0;0;0
FR;2;2021-02-15;3454;3094;0;0;0;124929;3880;0;0;0
FR;2;2021-02-16;5067;4021;0;0;0;129996;7901;0;0;0
FR;2;2021-02-17;4251;4466;0;0;0;134247;12367;0;0;0
FR;2;2021-02-18;5399;5116;0;0;0;139646;17483;0;0;0
FR;2;2021-02-19;5324;4394;0;0;0;144970;21877;0;0;0
FR;2;2021-02-20;1868;1508;0;0;0;146838;23385;0;0;0
FR;2;2021-02-21;242;88;0;0;0;147080;23473;0;0;0
FR;2;2021-02-22;3611;3745;0;0;0;150691;27218;0;0;0
FR;2;2021-02-23;4952;3695;0;0;0;155643;30913;0;0;0
FR;2;2021-02-24;5010;3495;0;0;0;160653;34408;0;0;0
FR;2;2021-02-25;5481;3452;0;0;0;166134;37860;0;0;0
FR;2;2021-02-26;4360;3146;0;0;0;170494;41006;0;0;0
FR;2;2021-02-27;1623;1053;0;0;0;172117;42059;0;0;0
FR;2;2021-02-28;176;29;0;0;0;172293;42088;0;0;0
FR;2;2021-03-01;5177;3728;0;0;0;177470;45816;0;0;0
FR;2;2021-03-02;6528;4724;0;0;0;183998;50540;0;0;0
FR;2;2021-03-03;6533;4919;0;0;0;190531;55459;0;0;0
FR;2;2021-03-04;8395;4052;0;0;0;198926;59511;0;0;0
FR;2;2021-03-05;8026;4060;0;0;0;206952;63571;0;0;0
FR;2;2021-03-06;4783;1683;0;0;0;211735;65254;0;0;0
FR;2;2021-03-07;2372;30;0;0;0;214107;65284;0;0;0
FR;2;2021-03-08;4164;8331;0;0;0;218271;73615;0;0;0
FR;2;2021-03-09;7485;8494;1;0;0;225756;82109;1;0;0
FR;2;2021-03-10;7098;9140;0;0;0;232854;91249;1;0;0
FR;2;2021-03-11;9372;9239;1;0;0;242226;100488;2;0;0
FR;2;2021-03-12;7972;8221;0;0;0;250198;108709;2;0;0
FR;2;2021-03-13;10046;2555;0;0;0;260244;111264;2;0;0
FR;2;2021-03-14;4838;404;0;0;0;265082;111668;2;0;0
FR;2;2021-03-15;10905;3487;0;0;0;275987;115155;2;0;0
FR;2;2021-03-16;16760;4646;1;0;0;292747;119801;3;0;0
FR;2;2021-03-17;20224;3973;0;0;0;312971;123774;3;0;0
FR;2;2021-03-18;23364;4970;0;0;0;336335;128744;3;0;0
FR;2;2021-03-19;23301;4575;0;0;0;359636;133319;3;0;0
FR;2;2021-03-20;25441;1547;0;0;0;385077;134866;3;0;0
FR;2;2021-03-21;17669;150;0;0;0;402746;135016;3;0;0
FR;2;2021-03-22;17782;3138;0;0;0;420528;138154;3;0;0
FR;2;2021-03-23;22686;4202;0;0;0;443214;142356;3;0;0
FR;2;2021-03-24;23954;5015;0;0;0;467168;147371;3;0;0
FR;2;2021-03-25;26736;5137;1;0;0;493904;152508;4;0;0
FR;2;2021-03-26;26975;4203;0;0;0;520879;156711;4;0;0
FR;2;2021-03-27;15917;1329;0;0;0;536796;158040;4;0;0
FR;2;2021-03-28;10561;119;0;0;0;547357;158159;4;0;0
FR;2;2021-03-29;18984;4286;0;0;0;566341;162445;4;0;0
FR;2;2021-03-30;24575;6029;0;0;0;590916;168474;4;0;0
FR;2;2021-03-31;28553;5929;0;0;0;619469;174403;4;0;0
FR;2;2021-04-01;34544;8495;1;0;0;654013;182898;5;0;0
FR;2;2021-04-02;29976;7668;0;0;0;683989;190566;5;0;0
FR;2;2021-04-03;16953;3772;0;0;0;700942;194338;5;0;0
FR;2;2021-04-04;9305;1021;2;0;0;710247;195359;7;0;0
FR;2;2021-04-05;12443;806;0;0;0;722690;196165;7;0;0
FR;2;2021-04-06;27142;7023;0;0;0;749832;203188;7;0;0
FR;2;2021-04-07;30926;7142;1;0;0;780758;210330;8;0;0
FR;2;2021-04-08;36879;8732;1;0;0;817637;219062;9;0;0
FR;2;2021-04-09;33834;8548;28;0;0;851471;227610;37;0;0
FR;2;2021-04-10;19678;9053;1;0;0;871149;236663;38;0;0
FR;2;2021-04-11;7941;4256;1;0;0;879090;240919;39;0;0
FR;2;2021-04-12;17121;11143;0;0;0;896211;252062;39;0;0
FR;2;2021-04-13;19448;16204;1;0;0;915659;268266;40;0;0
FR;2;2021-04-14;18060;16301;7;0;0;933719;284567;47;0;0
FR;2;2021-04-15;22186;20962;27;0;0;955905;305529;74;0;0
FR;2;2021-04-16;20704;20135;45;0;0;976609;325664;119;0;0
FR;2;2021-04-17;13253;22428;5;0;0;989862;348092;124;0;0
FR;2;2021-04-18;5907;14394;6;0;0;995769;362486;130;0;0
FR;2;2021-04-19;16830;16273;24;0;0;1012599;378759;154;0;0
FR;2;2021-04-20;19317;21587;38;0;0;1031916;400346;192;0;0
FR;2;2021-04-21;20280;21701;76;0;0;1052196;422047;268;0;0
FR;2;2021-04-22;23809;24864;41;0;0;1076005;446911;309;0;0
FR;2;2021-04-23;24516;25349;76;0;0;1100521;472260;385;0;0
FR;2;2021-04-24;25300;15090;104;0;0;1125821;487350;489;0;0
FR;2;2021-04-25;9592;8600;5;0;0;1135413;495950;494;0;0
FR;2;2021-04-26;17157;17246;21;0;0;1152570;513196;515;0;0
FR;2;2021-04-27;19240;24220;40;0;0;1171810;537416;555;0;0
FR;2;2021-04-28;22331;26215;112;0;0;1194141;563631;667;0;0
FR;2;2021-04-29;25465;30150;69;0;0;1219606;593781;736;0;0
FR;2;2021-04-30;25529;27740;49;1;0;1245135;621521;785;1;0
FR;2;2021-05-01;14980;9875;6;0;0;1260115;631396;791;1;0
FR;2;2021-05-02;6635;9172;2;0;0;1266750;640568;793;1;0
FR;2;2021-05-03;20012;19252;40;0;0;1286762;659820;833;1;0
FR;2;2021-05-04;18280;29038;33;0;0;1305042;688858;866;1;0
FR;2;2021-05-05;18359;29386;48;0;0;1323401;718244;914;1;0
FR;2;2021-05-06;23538;35236;131;0;0;1346939;753480;1045;1;0
FR;2;2021-05-07;25322;33197;97;0;0;1372261;786677;1142;1;0
FR;2;2021-05-08;21337;9807;14;0;0;1393598;796484;1156;1;0
FR;2;2021-05-09;13162;7842;7;0;0;1406760;804326;1163;1;0
FR;2;2021-05-10;32937;22119;49;0;0;1439697;826445;1212;1;0
FR;2;2021-05-11;43596;21030;101;0;0;1483293;847475;1313;1;0
FR;2;2021-05-12;50039;19841;143;0;0;1533332;867316;1456;1;0
FR;2;2021-05-13;51289;5747;31;0;0;1584621;873063;1487;1;0
FR;2;2021-05-14;61343;12918;132;0;0;1645964;885981;1619;1;0
FR;2;2021-05-15;65925;7137;39;0;0;1711889;893118;1658;1;0
FR;2;2021-05-16;43580;2566;10;0;0;1755469;895684;1668;1;0
FR;2;2021-05-17;44742;12567;113;0;0;1800211;908251;1781;1;0
FR;2;2021-05-18;54633;12238;191;0;0;1854844;920489;1972;1;0
FR;2;2021-05-19;57163;10595;281;0;0;1912007;931084;2253;1;0
FR;2;2021-05-20;63430;10836;287;0;0;1975437;941920;2540;1;0
FR;2;2021-05-21;64288;11636;230;0;0;2039725;953556;2770;1;0
FR;2;2021-05-22;61478;4505;65;0;0;2101203;958061;2835;1;0
FR;2;2021-05-23;37531;570;22;0;0;2138734;958631;2857;1;0
FR;2;2021-05-24;17235;2034;34;0;0;2155969;960665;2891;1;0
FR;2;2021-05-25;21103;12224;240;0;0;2177072;972889;3131;1;0
FR;2;2021-05-26;19933;11454;229;0;0;2197005;984343;3360;1;0
FR;2;2021-05-27;22993;12663;182;0;0;2219998;997006;3542;1;0
FR;2;2021-05-28;29387;14946;190;0;0;2249385;1011952;3732;1;0
FR;2;2021-05-29;30416;8175;57;0;0;2279801;1020127;3789;1;0
FR;2;2021-05-30;4646;1814;6;0;0;2284447;1021941;3795;1;0
FR;2;2021-05-31;28584;18716;183;0;0;2313031;1040657;3978;1;0
FR;2;2021-06-01;45710;20006;224;0;0;2358741;1060663;4202;1;0
FR;2;2021-06-02;37461;19291;181;0;0;2396202;1079954;4383;1;0
FR;2;2021-06-03;51270;23319;161;0;0;2447472;1103273;4544;1;0
FR;2;2021-06-04;65508;24054;215;0;0;2512980;1127327;4759;1;0
FR;2;2021-06-05;34598;24032;51;0;0;2547578;1151359;4810;1;0
FR;2;2021-06-06;4953;6198;10;0;0;2552531;1157557;4820;1;0
FR;2;2021-06-07;28165;23039;146;0;0;2580696;1180596;4966;1;0
FR;2;2021-06-08;46368;22919;143;0;0;2627064;1203515;5109;1;0
FR;2;2021-06-09;34284;20917;107;0;0;2661348;1224432;5216;1;0
FR;2;2021-06-10;42635;19133;95;1;0;2703983;1243565;5311;2;0
FR;2;2021-06-11;55287;25221;134;0;0;2759270;1268786;5445;2;0
FR;2;2021-06-12;30559;19776;53;0;0;2789829;1288562;5498;2;0
FR;2;2021-06-13;3329;9186;13;0;0;2793158;1297748;5511;2;0
FR;2;2021-06-14;25295;24156;92;0;0;2818453;1321904;5603;2;0
FR;2;2021-06-15;39033;22842;154;0;0;2857486;1344746;5757;2;0
FR;2;2021-06-16;30159;21437;134;0;0;2887645;1366183;5891;2;0
FR;2;2021-06-17;36904;25858;150;0;0;2924549;1392041;6041;2;0
FR;2;2021-06-18;46845;28815;122;0;0;2971394;1420856;6163;2;0
FR;2;2021-06-19;24524;24890;39;0;0;2995918;1445746;6202;2;0
FR;2;2021-06-20;3740;10065;10;0;0;2999658;1455811;6212;2;0
FR;2;2021-06-21;17521;42838;87;0;0;3017179;1498649;6299;2;0
FR;2;2021-06-22;28353;49561;110;0;0;3045532;1548210;6409;2;0
FR;2;2021-06-23;21788;49556;106;1;1;3067320;1597766;6515;3;1
FR;2;2021-06-24;28375;50279;133;0;0;3095695;1648045;6648;3;1
FR;2;2021-06-25;33398;60396;127;0;0;3129093;1708441;6775;3;1
FR;2;2021-06-26;16379;59247;54;1;0;3145472;1767688;6829;4;1
FR;2;2021-06-27;2564;29322;22;1;0;3148036;1797010;6851;5;1
FR;2;2021-06-28;12637;54339;82;0;0;3160673;1851349;6933;5;1
FR;2;2021-06-29;19841;59886;178;0;0;3180514;1911235;7111;5;1
FR;2;2021-06-30;16321;57870;252;17;0;3196835;1969105;7363;22;1
FR;2;2021-07-01;20482;59891;227;0;0;3217317;2028996;7590;22;1
FR;2;2021-07-02;24069;62137;184;0;0;3241386;2091133;7774;22;1
FR;2;2021-07-03;12111;57086;153;0;0;3253497;2148219;7927;22;1
FR;2;2021-07-04;1958;23308;18;0;0;3255455;2171527;7945;22;1
FR;2;2021-07-05;9170;29365;106;0;0;3264625;2200892;8051;22;1
FR;2;2021-07-06;14574;36203;135;0;0;3279199;2237095;8186;22;1
FR;2;2021-07-07;14403;33672;139;0;0;3293602;2270767;8325;22;1
FR;2;2021-07-08;19713;40295;162;0;0;3313315;2311062;8487;22;1
FR;2;2021-07-09;27093;54275;202;1;0;3340408;2365337;8689;23;1
FR;2;2021-07-10;13384;33667;107;0;0;3353792;2399004;8796;23;1
FR;2;2021-07-11;1805;4350;16;0;0;3355597;2403354;8812;23;1
FR;2;2021-07-12;12960;37278;118;0;0;3368557;2440632;8930;23;1
FR;2;2021-07-13;37109;53219;150;0;0;3405666;2493851;9080;23;1
FR;2;2021-07-14;6607;3559;15;0;0;3412273;2497410;9095;23;1
FR;2;2021-07-15;47232;47028;156;0;0;3459505;2544438;9251;23;1
FR;2;2021-07-16;64306;55814;187;0;0;3523811;2600252;9438;23;1
FR;2;2021-07-17;31592;23931;96;0;0;3555403;2624183;9534;23;1
FR;2;2021-07-18;6087;4881;19;0;0;3561490;2629064;9553;23;1
FR;2;2021-07-19;32987;28678;94;0;0;3594477;2657742;9647;23;1
FR;2;2021-07-20;51989;44567;155;0;0;3646466;2702309;9802;23;1
FR;2;2021-07-21;45243;34753;93;0;0;3691709;2737062;9895;23;1
FR;2;2021-07-22;56272;41092;128;1;0;3747981;2778154;10023;24;1
FR;2;2021-07-23;68276;49084;170;0;0;3816257;2827238;10193;24;1
FR;2;2021-07-24;36165;21591;82;0;0;3852422;2848829;10275;24;1
FR;2;2021-07-25;6742;2654;10;0;0;3859164;2851483;10285;24;1
FR;2;2021-07-26;36296;22450;91;1;0;3895460;2873933;10376;25;1
FR;2;2021-07-27;62354;34620;180;0;0;3957814;2908553;10556;25;1
FR;2;2021-07-28;55297;26457;132;0;0;4013111;2935010;10688;25;1
FR;2;2021-07-29;68455;32786;189;0;0;4081566;2967796;10877;25;1
FR;2;2021-07-30;74431;37775;222;1;1;4155997;3005571;11099;26;2
FR;2;2021-07-31;34750;16190;104;0;0;4190747;3021761;11203;26;2
FR;2;2021-08-01;5397;2280;19;0;0;4196144;3024041;11222;26;2
FR;2;2021-08-02;35860;16204;101;0;0;4232004;3040245;11323;26;2
FR;2;2021-08-03;55959;28287;142;0;0;4287963;3068532;11465;26;2
FR;2;2021-08-04;46623;20863;128;1;0;4334586;3089395;11593;27;2
FR;2;2021-08-05;54617;31584;215;0;0;4389203;3120979;11808;27;2
FR;2;2021-08-06;58081;42392;242;1;0;4447284;3163371;12050;28;2
FR;2;2021-08-07;25134;17603;89;0;0;4472418;3180974;12139;28;2
FR;2;2021-08-08;3832;3668;21;0;0;4476250;3184642;12160;28;2
FR;2;2021-08-09;29295;21132;91;0;0;4505545;3205774;12251;28;2
FR;2;2021-08-10;44988;33514;154;0;0;4550533;3239288;12405;28;2
FR;2;2021-08-11;35264;25171;151;0;0;4585797;3264459;12556;28;2
FR;2;2021-08-12;41893;35730;162;0;0;4627690;3300189;12718;28;2
FR;2;2021-08-13;42585;37062;218;0;0;4670275;3337251;12936;28;2
FR;2;2021-08-14;18508;22251;93;0;0;4688783;3359502;13029;28;2
FR;2;2021-08-15;3818;3814;17;0;0;4692601;3363316;13046;28;2
FR;2;2021-08-16;25079;27197;110;0;0;4717680;3390513;13156;28;2
FR;2;2021-08-17;38249;43486;205;2;0;4755929;3433999;13361;30;2
FR;2;2021-08-18;32246;36367;195;1;1;4788175;3470366;13556;31;3
FR;2;2021-08-19;37427;46584;224;0;0;4825602;3516950;13780;31;3
FR;2;2021-08-20;40556;55605;269;1;0;4866158;3572555;14049;32;3
FR;2;2021-08-21;18116;24307;114;0;0;4884274;3596862;14163;32;3
FR;2;2021-08-22;2902;4318;22;1;1;4887176;3601180;14185;33;4
FR;2;2021-08-23;19239;35161;131;1;1;4906415;3636341;14316;34;5
FR;2;2021-08-24;31941;56032;235;0;0;4938356;3692373;14551;34;5
FR;2;2021-08-25;25926;43428;250;0;0;4964282;3735801;14801;34;5
FR;2;2021-08-26;32350;55789;387;0;0;4996632;3791590;15188;34;5
FR;2;2021-08-27;36992;65593;478;2;0;5033624;3857183;15666;36;5
FR;2;2021-08-28;17814;28475;300;0;0;5051438;3885658;15966;36;5
FR;2;2021-08-29;2655;5038;47;0;0;5054093;3890696;16013;36;5
FR;2;2021-08-30;18409;37747;399;0;754;5072502;3928443;16412;36;759
FR;2;2021-08-31;28077;57490;885;4;1537;5100579;3985933;17297;40;2296
FR;2;2021-09-01;21589;39840;1307;0;2091;5122168;4025773;18604;40;4387
FR;2;2021-09-02;25476;48613;1960;2;3291;5147644;4074386;20564;42;7678
FR;2;2021-09-03;33404;64475;2986;3;4826;5181048;4138861;23550;45;12504
FR;2;2021-09-04;16826;27703;1442;1;2355;5197874;4166564;24992;46;14859
FR;2;2021-09-05;2259;3608;265;0;413;5200133;4170172;25257;46;15272
FR;2;2021-09-06;14034;28731;1769;1;2930;5214167;4198903;27026;47;18202
FR;2;2021-09-07;21102;41049;3020;13;4854;5235269;4239952;30046;60;23056
FR;2;2021-09-08;17241;31935;2732;6;4468;5252510;4271887;32778;66;27524
FR;2;2021-09-09;20973;40431;4432;3;6754;5273483;4312318;37210;69;34278
FR;2;2021-09-10;28195;51154;5282;4;8827;5301678;4363472;42492;73;43105
FR;2;2021-09-11;13652;22355;2403;5;3938;5315330;4385827;44895;78;47043
FR;2;2021-09-12;1822;2786;284;0;506;5317152;4388613;45179;78;47549
FR;2;2021-09-13;11656;21448;2468;4;4010;5328808;4410061;47647;82;51559
FR;2;2021-09-14;18567;32770;5084;13;9037;5347375;4442831;52731;95;60596
FR;2;2021-09-15;14910;28283;5164;3;7780;5362285;4471114;57895;98;68376
FR;2;2021-09-16;16071;32766;6735;14;10530;5378356;4503880;64630;112;78906
FR;2;2021-09-17;20911;47090;8775;10;14573;5399267;4550970;73405;122;93479
FR;2;2021-09-18;9855;20922;3803;6;6020;5409122;4571892;77208;128;99499
FR;2;2021-09-19;1165;2648;395;0;645;5410287;4574540;77603;128;100144
FR;2;2021-09-20;7491;18783;3851;7;6153;5417778;4593323;81454;135;106297
FR;2;2021-09-21;11205;30001;6494;5;10740;5428983;4623324;87948;140;117037
FR;2;2021-09-22;9406;23544;5491;7;8512;5438389;4646868;93439;147;125549
FR;2;2021-09-23;10722;28872;7879;9;12636;5449111;4675740;101318;156;138185
FR;2;2021-09-24;15065;42865;10874;18;17192;5464176;4718605;112192;174;155377
FR;2;2021-09-25;7257;18736;3962;10;6085;5471433;4737341;116154;184;161462
FR;2;2021-09-26;1079;2555;494;0;631;5472512;4739896;116648;184;162093
FR;2;2021-09-27;6313;16452;4286;8;6552;5478825;4756348;120934;192;168645
FR;2;2021-09-28;9239;25546;7768;13;12068;5488064;4781894;128702;205;180713
FR;2;2021-09-29;8080;20212;6066;25;9261;5496144;4802106;134768;230;189974
FR;2;2021-09-30;9862;25784;9503;16;14076;5506006;4827890;144271;246;204050
FR;2;2021-10-01;13967;35635;12912;25;19230;5519973;4863525;157183;271;223280
FR;2;2021-10-02;6873;15880;4845;6;7009;5526846;4879405;162028;277;230289
FR;2;2021-10-03;841;1938;491;1;513;5527687;4881343;162519;278;230802
FR;2;2021-10-04;5818;13930;5516;5;7859;5533505;4895273;168035;283;238661
FR;2;2021-10-05;9052;22547;11121;19;15714;5542557;4917820;179156;302;254375
FR;2;2021-10-06;7778;17736;8239;11;11069;5550335;4935556;187395;313;265444
FR;2;2021-10-07;9194;22172;12378;15;16833;5559529;4957728;199773;328;282277
FR;2;2021-10-08;13423;32053;17346;27;23535;5572952;4989781;217119;355;305812
FR;2;2021-10-09;5998;12822;6041;6;7875;5578950;5002603;223160;361;313687
FR;2;2021-10-10;883;1635;436;2;633;5579833;5004238;223596;363;314320
FR;2;2021-10-11;5604;11603;6454;17;8837;5585437;5015841;230050;380;323157
FR;2;2021-10-12;8034;17756;12537;13;16730;5593471;5033597;242587;393;339887
FR;2;2021-10-13;6944;14848;10245;11;13608;5600415;5048445;252832;404;353495
FR;2;2021-10-14;8310;17938;14989;13;19448;5608725;5066383;267821;417;372943
FR;2;2021-10-15;11845;26276;20901;26;27943;5620570;5092659;288722;443;400886
FR;2;2021-10-16;5137;8723;1816;0;3204;5625707;5101382;290538;443;404090
FR;2;2021-10-17;651;1186;184;0;373;5626358;5102568;290722;443;404463
FR;2;2021-10-18;4558;7416;661;2;1672;5630916;5109984;291383;445;406135
FR;2;2021-10-19;6238;9901;729;5;2055;5637154;5119885;292112;450;408190
FR;2;2021-10-20;5162;8099;756;3;1684;5642316;5127984;292868;453;409874
FR;2;2021-10-21;6088;9968;779;5;2101;5648404;5137952;293647;458;411975
FR;2;2021-10-22;8446;14576;1147;4;2874;5656850;5152528;294794;462;414849
FR;2;2021-10-23;3840;5997;584;0;1234;5660690;5158525;295378;462;416083
FR;2;2021-10-24;494;888;100;0;203;5661184;5159413;295478;462;416286
FR;2;2021-10-25;3357;5369;301;1;823;5664541;5164782;295779;463;417109
FR;2;2021-10-26;4173;7257;1124;4;2005;5668714;5172039;296903;467;419114
FR;2;2021-10-27;3673;6627;1193;5;1997;5672387;5178666;298096;472;421111
FR;2;2021-10-28;4596;7695;1727;3;2746;5676983;5186361;299823;475;423857
FR;2;2021-10-29;5405;11077;2430;4;3666;5682388;5197438;302253;479;427523
FR;2;2021-10-30;2748;4433;972;1;1428;5685136;5201871;303225;480;428951
FR;2;2021-10-31;363;535;139;1;186;5685499;5202406;303364;481;429137
FR;2;2021-11-01;416;558;175;0;267;5685915;5202964;303539;481;429404
FR;2;2021-11-02;3287;6760;1179;0;1756;5689202;5209724;304718;481;431160
FR;2;2021-11-03;3338;6249;1383;2;1965;5692540;5215973;306101;483;433125
FR;2;2021-11-04;3985;7098;1761;4;2491;5696525;5223071;307862;487;435616
FR;2;2021-11-05;5226;10510;2863;5;3944;5701751;5233581;310725;492;439560
FR;2;2021-11-06;2594;4670;1397;0;1809;5704345;5238251;312122;492;441369
FR;2;2021-11-07;508;864;216;0;285;5704853;5239115;312338;492;441654
FR;2;2021-11-08;2575;5360;1201;3;1677;5707428;5244475;313539;495;443331
FR;2;2021-11-09;2749;6946;2392;6;3173;5710177;5251421;315931;501;446504
FR;2;2021-11-10;2584;5712;5093;6;6272;5712761;5257133;321024;507;452776
FR;2;2021-11-11;433;743;732;2;914;5713194;5257876;321756;509;453690
FR;2;2021-11-12;2951;8110;8963;8;10901;5716145;5265986;330719;517;464591
FR;2;2021-11-13;1534;3382;3865;7;4528;5717679;5269368;334584;524;469119
FR;2;2021-11-14;254;603;348;1;485;5717933;5269971;334932;525;469604
FR;2;2021-11-15;1622;3694;4434;9;5318;5719555;5273665;339366;534;474922
FR;2;2021-11-16;2184;5944;8293;14;10070;5721739;5279609;347659;548;484992
FR;2;2021-11-17;1740;4564;6619;8;7835;5723479;5284173;354278;556;492827
FR;2;2021-11-18;2189;5948;9168;11;10993;5725668;5290121;363446;567;503820
FR;2;2021-11-19;2697;7802;12958;19;15464;5728365;5297923;376404;586;519284
FR;2;2021-11-20;1563;3333;5170;5;6074;5729928;5301256;381574;591;525358
FR;2;2021-11-21;246;518;540;0;663;5730174;5301774;382114;591;526021
FR;2;2021-11-22;1275;2622;4469;5;5400;5731449;5304396;386583;596;531421
FR;2;2021-11-23;1613;4313;8186;9;9895;5733062;5308709;394769;605;541316
FR;2;2021-11-24;1418;3798;7462;14;8720;5734480;5312507;402231;619;550036
FR;2;2021-11-25;1812;4893;11447;21;13642;5736292;5317400;413678;640;563678
FR;2;2021-11-26;2537;7779;22652;31;26067;5738829;5325179;436330;671;589745
FR;2;2021-11-27;1497;4130;12255;18;13991;5740326;5329309;448585;689;603736
FR;2;2021-11-28;291;840;1965;3;2285;5740617;5330149;450550;692;606021
FR;2;2021-11-29;1444;4390;15073;23;17246;5742061;5334539;465623;715;623267
FR;2;2021-11-30;1913;6749;26220;36;29971;5743974;5341288;491843;751;653238
FR;2;2021-12-01;1904;6100;26182;29;29502;5745878;5347388;518025;780;682740
FR;2;2021-12-02;1908;6830;37684;52;41928;5747786;5354218;555709;832;724668
FR;2;2021-12-03;2550;10110;53586;112;59309;5750336;5364328;609295;944;783977
FR;2;2021-12-04;1849;6304;37089;38;40764;5752185;5370632;646384;982;824741
FR;2;2021-12-05;458;2263;14252;14;15988;5752643;5372895;660636;996;840729
FR;2;2021-12-06;2464;9895;77682;109;84731;5755107;5382790;738318;1105;925460
FR;2;2021-12-07;3445;15331;122407;238;133690;5758552;5398121;860725;1343;1059150
FR;2;2021-12-08;3717;16056;133169;330;145369;5762269;5414177;993894;1673;1204519
FR;2;2021-12-09;4543;19629;170143;554;185500;5766812;5433806;1164037;2227;1390019
FR;2;2021-12-10;4672;22811;188607;490;206037;5771484;5456617;1352644;2717;1596056
FR;2;2021-12-11;3682;16626;132420;239;144856;5775166;5473243;1485064;2956;1740912
FR;2;2021-12-12;1257;7128;59082;83;65129;5776423;5480371;1544146;3039;1806041
FR;2;2021-12-13;5525;26860;220652;604;242932;5781948;5507231;1764798;3643;2048973
FR;2;2021-12-14;7017;37532;300712;910;332181;5788965;5544763;2065510;4553;2381154
FR;2;2021-12-15;6557;36241;285172;955;315771;5795522;5581004;2350682;5508;2696925
FR;2;2021-12-16;7762;37923;312101;981;343684;5803284;5618927;2662783;6489;3040609
FR;2;2021-12-17;8680;41245;327828;975;360907;5811964;5660172;2990611;7464;3401516
FR;2;2021-12-18;6515;26561;212316;448;233615;5818479;5686733;3202927;7912;3635131
FR;2;2021-12-19;2600;11491;90201;183;100378;5821079;5698224;3293128;8095;3735509
FR;2;2021-12-20;9549;33605;275152;706;303318;5830628;5731829;3568280;8801;4038827
FR;2;2021-12-21;11555;38324;309587;969;341373;5842183;5770153;3877867;9770;4380200
FR;2;2021-12-22;10457;32858;265080;952;292467;5852640;5803011;4142947;10722;4672667
FR;2;2021-12-23;9427;26712;199457;700;221259;5862067;5829723;4342404;11422;4893926
FR;2;2021-12-24;2781;7493;43845;140;49559;5864848;5837216;4386249;11562;4943485
FR;2;2021-12-25;201;699;2000;10;2494;5865049;5837915;4388249;11572;4945979
FR;2;2021-12-26;1322;4216;25146;71;28677;5866371;5842131;4413395;11643;4974656
FR;2;2021-12-27;8077;29943;218378;659;243303;5874448;5872074;4631773;12302;5217959
FR;2;2021-12-28;9840;36339;272062;741;301948;5884288;5908413;4903835;13043;5519907
FR;2;2021-12-29;9494;32289;246104;766;272678;5893782;5940702;5149939;13809;5792585
FR;2;2021-12-30;9453;28139;208807;662;231464;5903235;5968841;5358746;14471;6024049
FR;2;2021-12-31;3007;8378;54980;177;61237;5906242;5977219;5413726;14648;6085286
FR;2;2022-01-01;227;692;2849;7;3344;5906469;5977911;5416575;14655;6088630
FR;2;2022-01-02;1505;4855;29505;75;33390;5907974;5982766;5446080;14730;6122020
FR;2;2022-01-03;9583;35373;266501;806;293863;5917557;6018139;5712581;15536;6415883
FR;2;2022-01-04;12842;45373;342060;1067;376941;5930399;6063512;6054641;16603;6792824
FR;2;2022-01-05;11268;38664;294152;885;323809;5941667;6102176;6348793;17488;7116633
FR;2;2022-01-06;13649;43489;331927;1298;364700;5955316;6145665;6680720;18786;7481333
FR;2;2022-01-07;14220;47637;361073;1270;396404;5969536;6193302;7041793;20056;7877737
FR;2;2022-01-08;7946;28148;201255;515;221683;5977482;6221450;7243048;20571;8099420
FR;2;2022-01-09;2749;8995;62519;137;69522;5980231;6230445;7305567;20708;8168942
FR;2;2022-01-10;10086;31924;232448;858;255036;5990317;6262369;7538015;21566;8423978
FR;2;2022-01-11;11470;36253;265881;1030;290570;6001787;6298622;7803896;22596;8714548
FR;2;2022-01-12;8758;29839;206299;862;226177;6010545;6328461;8010195;23458;8940725
FR;2;2022-01-13;9387;31344;224463;831;244810;6019932;6359805;8234658;24289;9185535
FR;2;2022-01-14;9743;35665;254516;920;277680;6029675;6395470;8489174;25209;9463215
FR;2;2022-01-15;5355;19454;140766;363;153634;6035030;6414924;8629940;25572;9616849
FR;2;2022-01-16;1512;5523;35871;80;39850;6036542;6420447;8665811;25652;9656699
FR;2;2022-01-17;5545;19300;135384;601;147246;6042087;6439747;8801195;26253;9803945
FR;2;2022-01-18;6417;21527;148608;648;160467;6048504;6461274;8949803;26901;9964412
FR;2;2022-01-19;4389;16363;105081;552;113701;6052893;6477637;9054884;27453;10078113
FR;2;2022-01-20;4866;17600;115275;603;123675;6057759;6495237;9170159;28056;10201788
FR;2;2022-01-21;5194;20062;137323;678;147744;6062953;6515299;9307482;28734;10349532
FR;2;2022-01-22;3027;10962;74255;259;80326;6065980;6526261;9381737;28993;10429858
FR;2;2022-01-23;722;2736;15236;41;16837;6066702;6528997;9396973;29034;10446695
FR;2;2022-01-24;3293;12824;75057;430;81017;6069995;6541821;9472030;29464;10527712
FR;2;2022-01-25;3570;14438;79612;495;85448;6073565;6556259;9551642;29959;10613160
FR;2;2022-01-26;2515;10659;58958;363;62981;6076080;6566918;9610600;30322;10676141
FR;2;2022-01-27;2682;11270;64164;388;67903;6078762;6578188;9674764;30710;10744044
FR;2;2022-01-28;3543;18383;91710;430;98958;6082305;6596571;9766474;31140;10843002
FR;2;2022-01-29;1892;9251;48836;164;52922;6084197;6605822;9815310;31304;10895924
FR;2;2022-01-30;466;2242;9452;38;10605;6084663;6608064;9824762;31342;10906529
FR;2;2022-01-31;1887;9587;43817;208;47340;6086550;6617651;9868579;31550;10953869
FR;2;2022-02-01;1912;10050;47018;278;50099;6088462;6627701;9915597;31828;11003968
FR;2;2022-02-02;1606;9033;41100;251;44174;6090068;6636734;9956697;32079;11048142
FR;2;2022-02-03;1723;8942;40508;204;42907;6091791;6645676;9997205;32283;11091049
FR;2;2022-02-04;2152;15217;66626;297;71345;6093943;6660893;10063831;32580;11162394
FR;2;2022-02-05;1362;8534;35935;131;39232;6095305;6669427;10099766;32711;11201626
FR;2;2022-02-06;274;1780;6124;16;6899;6095579;6671207;10105890;32727;11208525
FR;2;2022-02-07;1350;9608;37747;134;41304;6096929;6680815;10143637;32861;11249829
FR;2;2022-02-08;1298;9811;40926;173;43710;6098227;6690626;10184563;33034;11293539
FR;2;2022-02-09;1160;8813;37032;174;40451;6099387;6699439;10221595;33208;11333990
FR;2;2022-02-10;1024;7985;33831;204;36498;6100411;6707424;10255426;33412;11370488
FR;2;2022-02-11;1388;12077;53338;222;57683;6101799;6719501;10308764;33634;11428171
FR;2;2022-02-12;749;6529;27985;83;30802;6102548;6726030;10336749;33717;11458973
FR;2;2022-02-13;200;1335;4833;20;5574;6102748;6727365;10341582;33737;11464547
FR;2;2022-02-14;834;6726;30263;89;33226;6103582;6734091;10371845;33826;11497773
FR;2;2022-02-15;771;6447;28044;141;29981;6104353;6740538;10399889;33967;11527754
FR;2;2022-02-16;656;5340;22049;123;23608;6105009;6745878;10421938;34090;11551362
FR;2;2022-02-17;515;3770;14144;98;14608;6105524;6749648;10436082;34188;11565970
FR;2;2022-02-18;721;5361;20428;134;21124;6106245;6755009;10456510;34322;11587094
FR;2;2022-02-19;430;3047;10527;66;11241;6106675;6758056;10467037;34388;11598335
FR;2;2022-02-20;101;512;1456;3;1604;6106776;6758568;10468493;34391;11599939
FR;2;2022-02-21;421;2682;9117;65;9493;6107197;6761250;10477610;34456;11609432
FR;2;2022-02-22;389;2565;8887;76;8791;6107586;6763815;10486497;34532;11618223
FR;2;2022-02-23;432;2600;8985;82;9264;6108018;6766415;10495482;34614;11627487
FR;2;2022-02-24;313;2028;6796;81;6824;6108331;6768443;10502278;34695;11634311
FR;2;2022-02-25;455;3194;11414;108;11277;6108786;6771637;10513692;34803;11645588
FR;2;2022-02-26;294;1889;6035;49;6340;6109080;6773526;10519727;34852;11651928
FR;2;2022-02-27;75;312;905;5;948;6109155;6773838;10520632;34857;11652876
FR;2;2022-02-28;330;1680;5519;53;5527;6109485;6775518;10526151;34910;11658403
FR;2;2022-03-01;274;1558;5474;44;5191;6109759;6777076;10531625;34954;11663594
FR;2;2022-03-02;296;1429;5242;45;5082;6110055;6778505;10536867;34999;11668676
FR;2;2022-03-03;225;1101;3703;42;3478;6110280;6779606;10540570;35041;11672154
FR;2;2022-03-04;240;1462;4852;73;4498;6110520;6781068;10545422;35114;11676652
FR;2;2022-03-05;172;903;2973;32;2716;6110692;6781971;10548395;35146;11679368
FR;2;2022-03-06;40;181;277;5;316;6110732;6782152;10548672;35151;11679684
FR;2;2022-03-07;155;652;1981;69;1772;6110887;6782804;10550653;35220;11681456
FR;2;2022-03-08;143;652;2270;51;1902;6111030;6783456;10552923;35271;11683358
FR;2;2022-03-09;152;695;2341;37;2042;6111182;6784151;10555264;35308;11685400
FR;2;2022-03-10;119;595;1686;35;1458;6111301;6784746;10556950;35343;11686858
FR;2;2022-03-11;169;752;2767;57;2365;6111470;6785498;10559717;35400;11689223
FR;2;2022-03-12;143;480;1784;27;1553;6111613;6785978;10561501;35427;11690776
FR;2;2022-03-13;25;75;201;29;202;6111638;6786053;10561702;35456;11690978
FR;2;2022-03-14;124;464;1560;529;1289;6111762;6786517;10563262;35985;11692267
FR;2;2022-03-15;138;417;1705;688;1321;6111900;6786934;10564967;36673;11693588
FR;2;2022-03-16;141;463;2010;1611;1588;6112041;6787397;10566977;38284;11695176
FR;2;2022-03-17;93;412;1404;1192;1141;6112134;6787809;10568381;39476;11696317
FR;2;2022-03-18;144;489;2017;1787;1659;6112278;6788298;10570398;41263;11697976
FR;2;2022-03-19;108;318;1209;940;1013;6112386;6788616;10571607;42203;11698989
FR;2;2022-03-20;12;76;190;59;166;6112398;6788692;10571797;42262;11699155
FR;2;2022-03-21;96;301;1209;1481;1073;6112494;6788993;10573006;43743;11700228
FR;2;2022-03-22;116;382;1528;1828;1290;6112610;6789375;10574534;45571;11701518
FR;2;2022-03-23;137;343;1665;3031;1455;6112747;6789718;10576199;48602;11702973
FR;2;2022-03-24;115;290;1180;1546;996;6112862;6790008;10577379;50148;11703969
FR;2;2022-03-25;119;360;1801;2449;1471;6112981;6790368;10579180;52597;11705440
FR;2;2022-03-26;76;246;1202;1220;952;6113057;6790614;10580382;53817;11706392
FR;2;2022-03-27;19;36;150;98;130;6113076;6790650;10580532;53915;11706522
FR;2;2022-03-28;93;285;1133;1588;992;6113169;6790935;10581665;55503;11707514
FR;2;2022-03-29;106;257;1324;2462;1104;6113275;6791192;10582989;57965;11708618
FR;2;2022-03-30;91;312;1482;3183;1315;6113366;6791504;10584471;61148;11709933
FR;2;2022-03-31;103;279;1268;2312;1082;6113469;6791783;10585739;63460;11711015
FR;2;2022-04-01;119;313;1562;2340;1313;6113588;6792096;10587301;65800;11712328
FR;2;2022-04-02;72;160;845;889;737;6113660;6792256;10588146;66689;11713065
FR;2;2022-04-03;16;53;128;112;142;6113676;6792309;10588274;66801;11713207
FR;2;2022-04-04;106;224;982;1434;789;6113782;6792533;10589256;68235;11713996
FR;2;2022-04-05;142;286;1302;2870;1130;6113924;6792819;10590558;71105;11715126
FR;2;2022-04-06;87;242;1302;2498;1112;6114011;6793061;10591860;73603;11716238
FR;2;2022-04-07;118;214;1295;2681;1034;6114129;6793275;10593155;76284;11717272
FR;2;2022-04-08;123;327;1621;3207;1318;6114252;6793602;10594776;79491;11718590
FR;2;2022-04-09;90;218;896;1045;731;6114342;6793820;10595672;80536;11719321
FR;2;2022-04-10;37;44;143;161;116;6114379;6793864;10595815;80697;11719437
FR;2;2022-04-11;85;184;878;1518;769;6114464;6794048;10596693;82215;11720206
FR;2;2022-04-12;176;260;1169;2704;1042;6114640;6794308;10597862;84919;11721248
FR;2;2022-04-13;140;222;1113;2405;971;6114780;6794530;10598975;87324;11722219
FR;2;2022-04-14;114;216;1078;2653;907;6114894;6794746;10600053;89977;11723126
FR;2;2022-04-15;111;240;1186;2248;1043;6115005;6794986;10601239;92225;11724169
FR;2;2022-04-16;64;108;538;543;450;6115069;6795094;10601777;92768;11724619
FR;2;2022-04-17;14;26;57;53;53;6115083;6795120;10601834;92821;11724672
FR;2;2022-04-18;11;35;118;65;113;6115094;6795155;10601952;92886;11724785
FR;2;2022-04-19;108;235;1113;1700;945;6115202;6795390;10603065;94586;11725730
FR;2;2022-04-20;94;236;1090;2099;918;6115296;6795626;10604155;96685;11726648
FR;2;2022-04-21;109;228;971;1822;828;6115405;6795854;10605126;98507;11727476
FR;2;2022-04-22;96;265;1228;2055;1008;6115501;6796119;10606354;100562;11728484
FR;2;2022-04-23;66;153;644;762;573;6115567;6796272;10606998;101324;11729057
FR;2;2022-04-24;10;28;99;68;77;6115577;6796300;10607097;101392;11729134
FR;2;2022-04-25;101;200;815;1312;705;6115678;6796500;10607912;102704;11729839
FR;2;2022-04-26;104;182;1028;1897;868;6115782;6796682;10608940;104601;11730707
FR;2;2022-04-27;93;175;851;1665;755;6115875;6796857;10609791;106266;11731462
FR;2;2022-04-28;90;208;942;1891;836;6115965;6797065;10610733;108157;11732298
FR;2;2022-04-29;74;277;1120;1685;1030;6116039;6797342;10611853;109842;11733328
FR;2;2022-04-30;63;124;462;534;421;6116102;6797466;10612315;110376;11733749
FR;2;2022-05-01;14;22;79;42;80;6116116;6797488;10612394;110418;11733829
FR;2;2022-05-02;111;206;727;1201;628;6116227;6797694;10613121;111619;11734457
FR;2;2022-05-03;145;221;968;1728;907;6116372;6797915;10614089;113347;11735364
FR;2;2022-05-04;84;217;894;1754;840;6116456;6798132;10614983;115101;11736204
FR;2;2022-05-05;118;189;821;1653;730;6116574;6798321;10615804;116754;11736934
FR;2;2022-05-06;125;232;1082;1844;996;6116699;6798553;10616886;118598;11737930
FR;2;2022-05-07;39;95;462;501;399;6116738;6798648;10617348;119099;11738329
FR;2;2022-05-08;42;45;103;70;91;6116780;6798693;10617451;119169;11738420
FR;2;2022-05-09;100;162;620;959;570;6116880;6798855;10618071;120128;11738990
FR;2;2022-05-10;110;228;871;1731;823;6116990;6799083;10618942;121859;11739813
FR;2;2022-05-11;94;160;771;1821;754;6117084;6799243;10619713;123680;11740567
FR;2;2022-05-12;105;165;819;2035;780;6117189;6799408;10620532;125715;11741347
FR;2;2022-05-13;93;224;925;1903;863;6117282;6799632;10621457;127618;11742210
FR;2;2022-05-14;75;114;425;546;384;6117357;6799746;10621882;128164;11742594
FR;2;2022-05-15;23;34;89;86;100;6117380;6799780;10621971;128250;11742694
FR;2;2022-05-16;101;156;537;903;479;6117481;6799936;10622508;129153;11743173
FR;2;2022-05-17;94;176;637;1650;610;6117575;6800112;10623145;130803;11743783
FR;2;2022-05-18;80;163;584;1288;563;6117655;6800275;10623729;132091;11744346
FR;2;2022-05-19;67;149;663;1588;594;6117722;6800424;10624392;133679;11744940
FR;2;2022-05-20;95;152;775;1566;669;6117817;6800576;10625167;135245;11745609
FR;2;2022-05-21;43;71;355;495;288;6117860;6800647;10625522;135740;11745897
FR;2;2022-05-22;7;18;57;37;51;6117867;6800665;10625579;135777;11745948
FR;3;2020-12-27;0;0;0;0;0;0;0;0;0;0
FR;3;2020-12-28;0;0;0;0;0;0;0;0;0;0
FR;3;2020-12-29;0;0;0;0;0;0;0;0;0;0
FR;3;2020-12-30;0;0;0;0;0;0;0;0;0;0
FR;3;2020-12-31;0;0;0;0;0;0;0;0;0;0
FR;3;2021-01-01;0;0;0;0;0;0;0;0;0;0
FR;3;2021-01-02;0;0;0;0;0;0;0;0;0;0
FR;3;2021-01-03;0;0;0;0;0;0;0;0;0;0
FR;3;2021-01-04;0;0;0;0;0;0;0;0;0;0
FR;3;2021-01-05;0;0;0;0;0;0;0;0;0;0
FR;3;2021-01-06;0;0;0;0;0;0;0;0;0;0
FR;3;2021-01-07;0;0;0;0;0;0;0;0;0;0
FR;3;2021-01-08;0;0;0;0;0;0;0;0;0;0
FR;3;2021-01-09;0;0;0;0;0;0;0;0;0;0
FR;3;2021-01-10;0;0;0;0;0;0;0;0;0;0
FR;3;2021-01-11;0;0;0;0;0;0;0;0;0;0
FR;3;2021-01-12;0;0;0;0;0;0;0;0;0;0
FR;3;2021-01-13;0;0;0;0;0;0;0;0;0;0
FR;3;2021-01-14;0;0;0;0;0;0;0;0;0;0
FR;3;2021-01-15;0;0;0;0;0;0;0;0;0;0
FR;3;2021-01-16;0;0;0;0;0;0;0;0;0;0
FR;3;2021-01-17;0;0;0;0;0;0;0;0;0;0
FR;3;2021-01-18;0;0;0;0;0;0;0;0;0;0
FR;3;2021-01-19;0;0;0;0;0;0;0;0;0;0
FR;3;2021-01-20;0;0;0;0;0;0;0;0;0;0
FR;3;2021-01-21;0;0;0;0;0;0;0;0;0;0
FR;3;2021-01-22;0;0;0;0;0;0;0;0;0;0
FR;3;2021-01-23;0;0;0;0;0;0;0;0;0;0
FR;3;2021-01-24;0;0;0;0;0;0;0;0;0;0
FR;3;2021-01-25;0;0;0;0;0;0;0;0;0;0
FR;3;2021-01-26;0;0;0;0;0;0;0;0;0;0
FR;3;2021-01-27;0;0;0;0;0;0;0;0;0;0
FR;3;2021-01-28;0;0;0;0;0;0;0;0;0;0
FR;3;2021-01-29;0;0;0;0;0;0;0;0;0;0
FR;3;2021-01-30;0;0;0;0;0;0;0;0;0;0
FR;3;2021-01-31;0;0;0;0;0;0;0;0;0;0
FR;3;2021-02-01;0;0;0;0;0;0;0;0;0;0
FR;3;2021-02-02;0;0;0;0;0;0;0;0;0;0
FR;3;2021-02-03;0;0;0;0;0;0;0;0;0;0
FR;3;2021-02-04;0;0;0;0;0;0;0;0;0;0
FR;3;2021-02-05;0;0;0;0;0;0;0;0;0;0
FR;3;2021-02-06;1666;0;0;0;0;1666;0;0;0;0
FR;3;2021-02-07;1423;0;0;0;0;3089;0;0;0;0
FR;3;2021-02-08;2782;1;0;0;0;5871;1;0;0;0
FR;3;2021-02-09;6782;0;0;0;0;12653;1;0;0;0
FR;3;2021-02-10;9603;0;0;0;0;22256;1;0;0;0
FR;3;2021-02-11;13611;0;0;0;0;35867;1;0;0;0
FR;3;2021-02-12;13397;0;0;0;0;49264;1;0;0;0
FR;3;2021-02-13;3783;1;0;0;0;53047;2;0;0;0
FR;3;2021-02-14;972;0;0;0;0;54019;2;0;0;0
FR;3;2021-02-15;10486;0;0;0;0;64505;2;0;0;0
FR;3;2021-02-16;12542;1;0;0;0;77047;3;0;0;0
FR;3;2021-02-17;11151;0;0;0;0;88198;3;0;0;0
FR;3;2021-02-18;14934;2;0;0;0;103132;5;0;0;0
FR;3;2021-02-19;14359;1;0;0;0;117491;6;0;0;0
FR;3;2021-02-20;3329;0;0;0;0;120820;6;0;0;0
FR;3;2021-02-21;618;0;0;0;0;121438;6;0;0;0
FR;3;2021-02-22;9162;0;0;0;0;130600;6;0;0;0
FR;3;2021-02-23;11394;1;0;0;0;141994;7;0;0;0
FR;3;2021-02-24;14298;0;0;0;0;156292;7;0;0;0
FR;3;2021-02-25;44929;1;0;0;0;201221;8;0;0;0
FR;3;2021-02-26;61883;3;0;0;0;263104;11;0;0;0
FR;3;2021-02-27;34801;5;0;0;0;297905;16;0;0;0
FR;3;2021-02-28;2463;0;0;0;0;300368;16;0;0;0
FR;3;2021-03-01;20510;10;0;0;0;320878;26;0;0;0
FR;3;2021-03-02;38862;18;0;0;0;359740;44;0;0;0
FR;3;2021-03-03;48729;16;0;0;0;408469;60;0;0;0
FR;3;2021-03-04;82217;20;0;0;0;490686;80;0;0;0
FR;3;2021-03-05;118123;40;0;0;0;608809;120;0;0;0
FR;3;2021-03-06;120709;54;1;0;0;729518;174;1;0;0
FR;3;2021-03-07;55176;27;0;0;0;784694;201;1;0;0
FR;3;2021-03-08;42806;24;0;0;0;827500;225;1;0;0
FR;3;2021-03-09;78966;42;0;0;0;906466;267;1;0;0
FR;3;2021-03-10;80965;47;0;0;0;987431;314;1;0;0
FR;3;2021-03-11;128418;54;0;0;0;1115849;368;1;0;0
FR;3;2021-03-12;182720;90;0;0;0;1298569;458;1;0;0
FR;3;2021-03-13;132144;63;0;0;0;1430713;521;1;0;0
FR;3;2021-03-14;14054;4;0;0;0;1444767;525;1;0;0
FR;3;2021-03-15;52223;46;0;0;0;1496990;571;1;0;0
FR;3;2021-03-16;1209;24;0;0;0;1498199;595;1;0;0
FR;3;2021-03-17;942;30;0;0;0;1499141;625;1;0;0
FR;3;2021-03-18;1564;12;0;0;0;1500705;637;1;0;0
FR;3;2021-03-19;70448;48;0;0;0;1571153;685;1;0;0
FR;3;2021-03-20;65226;44;0;0;0;1636379;729;1;0;0
FR;3;2021-03-21;5755;6;0;0;0;1642134;735;1;0;0
FR;3;2021-03-22;37495;38;0;0;0;1679629;773;1;0;0
FR;3;2021-03-23;84650;61;0;0;0;1764279;834;1;0;0
FR;3;2021-03-24;90935;92;0;0;0;1855214;926;1;0;0
FR;3;2021-03-25;150043;126;0;0;0;2005257;1052;1;0;0
FR;3;2021-03-26;165412;152;0;0;0;2170669;1204;1;0;0
FR;3;2021-03-27;68456;100;0;0;0;2239125;1304;1;0;0
FR;3;2021-03-28;6469;19;0;0;0;2245594;1323;1;0;0
FR;3;2021-03-29;54159;75;0;0;0;2299753;1398;1;0;0
FR;3;2021-03-30;93159;100;0;0;0;2392912;1498;1;0;0
FR;3;2021-03-31;63522;93;0;0;0;2456434;1591;1;0;0
FR;3;2021-04-01;86121;103;0;0;0;2542555;1694;1;0;0
FR;3;2021-04-02;86891;153;0;0;0;2629446;1847;1;0;0
FR;3;2021-04-03;35871;115;0;0;0;2665317;1962;1;0;0
FR;3;2021-04-04;3570;18;0;0;0;2668887;1980;1;0;0
FR;3;2021-04-05;4487;28;0;0;0;2673374;2008;1;0;0
FR;3;2021-04-06;29742;83;0;0;0;2703116;2091;1;0;0
FR;3;2021-04-07;32334;79;0;0;0;2735450;2170;1;0;0
FR;3;2021-04-08;78808;242;0;0;0;2814258;2412;1;0;0
FR;3;2021-04-09;161746;415;0;0;0;2976004;2827;1;0;0
FR;3;2021-04-10;75755;331;0;0;0;3051759;3158;1;0;0
FR;3;2021-04-11;7309;45;0;0;0;3059068;3203;1;0;0
FR;3;2021-04-12;51467;206;0;0;0;3110535;3409;1;0;0
FR;3;2021-04-13;86218;318;0;0;0;3196753;3727;1;0;0
FR;3;2021-04-14;67834;341;0;0;0;3264587;4068;1;0;0
FR;3;2021-04-15;93219;370;0;0;0;3357806;4438;1;0;0
FR;3;2021-04-16;112516;581;0;0;0;3470322;5019;1;0;0
FR;3;2021-04-17;53311;324;1;0;0;3523633;5343;2;0;0
FR;3;2021-04-18;9741;35;0;0;0;3533374;5378;2;0;0
FR;3;2021-04-19;25103;240;0;0;0;3558477;5618;2;0;0
FR;3;2021-04-20;45670;398;0;0;0;3604147;6016;2;0;0
FR;3;2021-04-21;38967;466;0;0;0;3643114;6482;2;0;0
FR;3;2021-04-22;54701;786;0;0;0;3697815;7268;2;0;0
FR;3;2021-04-23;70479;1021;0;0;0;3768294;8289;2;0;0
FR;3;2021-04-24;37240;996;0;0;0;3805534;9285;2;0;0
FR;3;2021-04-25;6204;156;0;0;0;3811738;9441;2;0;0
FR;3;2021-04-26;19781;652;0;0;0;3831519;10093;2;0;0
FR;3;2021-04-27;34470;1259;0;0;0;3865989;11352;2;0;0
FR;3;2021-04-28;28964;1943;0;0;0;3894953;13295;2;0;0
FR;3;2021-04-29;45376;5958;0;0;0;3940329;19253;2;0;0
FR;3;2021-04-30;55451;8931;1;0;0;3995780;28184;3;0;0
FR;3;2021-05-01;9510;1977;0;0;0;4005290;30161;3;0;0
FR;3;2021-05-02;3070;489;0;0;0;4008360;30650;3;0;0
FR;3;2021-05-03;13057;3884;0;0;0;4021417;34534;3;0;0
FR;3;2021-05-04;23109;8412;0;0;0;4044526;42946;3;0;0
FR;3;2021-05-05;18753;10615;0;0;0;4063279;53561;3;0;0
FR;3;2021-05-06;34618;20906;0;0;0;4097897;74467;3;0;0
FR;3;2021-05-07;44202;28445;0;0;0;4142099;102912;3;0;0
FR;3;2021-05-08;6784;8929;0;0;0;4148883;111841;3;0;0
FR;3;2021-05-09;1792;2659;0;0;0;4150675;114500;3;0;0
FR;3;2021-05-10;14989;12603;0;0;0;4165664;127103;3;0;0
FR;3;2021-05-11;27092;25777;0;0;0;4192756;152880;3;0;0
FR;3;2021-05-12;17266;27506;0;0;0;4210022;180386;3;0;0
FR;3;2021-05-13;2277;3472;0;0;0;4212299;183858;3;0;0
FR;3;2021-05-14;14513;25758;0;0;0;4226812;209616;3;0;0
FR;3;2021-05-15;7230;20791;0;0;0;4234042;230407;3;0;0
FR;3;2021-05-16;975;2672;0;0;0;4235017;233079;3;0;0
FR;3;2021-05-17;7960;19945;0;0;0;4242977;253024;3;0;0
FR;3;2021-05-18;13409;29649;0;0;0;4256386;282673;3;0;0
FR;3;2021-05-19;9262;31560;0;0;0;4265648;314233;3;0;0
FR;3;2021-05-20;12801;53222;3;0;0;4278449;367455;6;0;0
FR;3;2021-05-21;12759;65532;2;0;0;4291208;432987;8;0;0
FR;3;2021-05-22;4960;33313;1;0;0;4296168;466300;9;0;0
FR;3;2021-05-23;649;2667;0;0;0;4296817;468967;9;0;0
FR;3;2021-05-24;879;4918;0;0;0;4297696;473885;9;0;0
FR;3;2021-05-25;5296;45221;1;0;0;4302992;519106;10;0;0
FR;3;2021-05-26;4969;51092;1;0;0;4307961;570198;11;0;0
FR;3;2021-05-27;6325;77876;3;0;0;4314286;648074;14;0;0
FR;3;2021-05-28;7540;99090;2;0;0;4321826;747164;16;0;0
FR;3;2021-05-29;3345;60317;1;0;0;4325171;807481;17;0;0
FR;3;2021-05-30;545;8220;0;0;0;4325716;815701;17;0;0
FR;3;2021-05-31;2434;35896;3;0;0;4328150;851597;20;0;0
FR;3;2021-06-01;3400;64750;10;0;0;4331550;916347;30;0;0
FR;3;2021-06-02;2726;58326;6;0;0;4334276;974673;36;0;0
FR;3;2021-06-03;3491;87492;10;0;0;4337767;1062165;46;0;0
FR;3;2021-06-04;4110;105093;22;0;0;4341877;1167258;68;0;0
FR;3;2021-06-05;1978;52233;4;0;0;4343855;1219491;72;0;0
FR;3;2021-06-06;505;5387;1;0;0;4344360;1224878;73;0;0
FR;3;2021-06-07;1468;31091;11;0;0;4345828;1255969;84;0;0
FR;3;2021-06-08;2047;47233;18;0;0;4347875;1303202;102;0;0
FR;3;2021-06-09;1787;42319;13;0;0;4349662;1345521;115;0;0
FR;3;2021-06-10;2242;67884;17;0;0;4351904;1413405;132;0;0
FR;3;2021-06-11;2471;96694;34;0;0;4354375;1510099;166;0;0
FR;3;2021-06-12;1174;40830;6;0;0;4355549;1550929;172;0;0
FR;3;2021-06-13;278;3803;3;0;0;4355827;1554732;175;0;0
FR;3;2021-06-14;1038;42601;17;0;0;4356865;1597333;192;0;0
FR;3;2021-06-15;1363;80607;20;0;0;4358228;1677940;212;0;0
FR;3;2021-06-16;1255;65694;19;0;0;4359483;1743634;231;0;0
FR;3;2021-06-17;1659;101809;41;0;0;4361142;1845443;272;0;0
FR;3;2021-06-18;1868;117926;61;0;0;4363010;1963369;333;0;0
FR;3;2021-06-19;801;39386;22;0;0;4363811;2002755;355;0;0
FR;3;2021-06-20;158;3373;0;0;0;4363969;2006128;355;0;0
FR;3;2021-06-21;768;39244;16;0;0;4364737;2045372;371;0;0
FR;3;2021-06-22;1060;69945;52;0;0;4365797;2115317;423;0;0
FR;3;2021-06-23;942;50821;39;0;0;4366739;2166138;462;0;0
FR;3;2021-06-24;1305;77151;48;0;0;4368044;2243289;510;0;0
FR;3;2021-06-25;1399;89970;73;0;0;4369443;2333259;583;0;0
FR;3;2021-06-26;625;33117;29;0;0;4370068;2366376;612;0;0
FR;3;2021-06-27;165;3990;1;0;0;4370233;2370366;613;0;0
FR;3;2021-06-28;648;30397;27;0;0;4370881;2400763;640;0;0
FR;3;2021-06-29;853;56171;95;0;0;4371734;2456934;735;0;0
FR;3;2021-06-30;901;45079;93;0;0;4372635;2502013;828;0;0
FR;3;2021-07-01;1160;65677;108;0;0;4373795;2567690;936;0;0
FR;3;2021-07-02;1299;90360;170;0;0;4375094;2658050;1106;0;0
FR;3;2021-07-03;600;31187;52;0;0;4375694;2689237;1158;0;0
FR;3;2021-07-04;141;4258;3;0;0;4375835;2693495;1161;0;0
FR;3;2021-07-05;608;33902;60;0;0;4376443;2727397;1221;0;0
FR;3;2021-07-06;956;56049;88;0;0;4377399;2783446;1309;0;0
FR;3;2021-07-07;870;43033;79;0;0;4378269;2826479;1388;0;0
FR;3;2021-07-08;1123;60725;99;0;0;4379392;2887204;1487;0;0
FR;3;2021-07-09;1258;68811;128;0;0;4380650;2956015;1615;0;0
FR;3;2021-07-10;640;25064;59;0;0;4381290;2981079;1674;0;0
FR;3;2021-07-11;127;3288;4;0;0;4381417;2984367;1678;0;0
FR;3;2021-07-12;659;23877;59;0;0;4382076;3008244;1737;0;0
FR;3;2021-07-13;1645;34724;90;0;0;4383721;3042968;1827;0;0
FR;3;2021-07-14;261;2628;2;0;0;4383982;3045596;1829;0;0
FR;3;2021-07-15;1932;30656;85;0;0;4385914;3076252;1914;0;0
FR;3;2021-07-16;2520;38861;122;0;0;4388434;3115113;2036;0;0
FR;3;2021-07-17;1046;13750;26;0;0;4389480;3128863;2062;0;0
FR;3;2021-07-18;262;2605;3;0;0;4389742;3131468;2065;0;0
FR;3;2021-07-19;1273;17190;37;0;0;4391015;3148658;2102;0;0
FR;3;2021-07-20;1823;27136;98;0;0;4392838;3175794;2200;0;0
FR;3;2021-07-21;1647;19707;44;0;0;4394485;3195501;2244;0;0
FR;3;2021-07-22;1848;27746;82;0;0;4396333;3223247;2326;0;0
FR;3;2021-07-23;2212;30447;117;0;0;4398545;3253694;2443;0;0
FR;3;2021-07-24;822;7003;25;0;0;4399367;3260697;2468;0;0
FR;3;2021-07-25;210;1340;1;0;0;4399577;3262037;2469;0;0
FR;3;2021-07-26;921;10704;28;0;0;4400498;3272741;2497;0;0
FR;3;2021-07-27;1165;16947;56;0;0;4401663;3289688;2553;0;0
FR;3;2021-07-28;988;12099;40;0;0;4402651;3301787;2593;0;0
FR;3;2021-07-29;1126;15843;63;0;0;4403777;3317630;2656;0;0
FR;3;2021-07-30;1125;18095;79;0;0;4404902;3335725;2735;0;0
FR;3;2021-07-31;406;3747;15;0;0;4405308;3339472;2750;0;0
FR;3;2021-08-01;113;486;1;0;0;4405421;3339958;2751;0;0
FR;3;2021-08-02;418;5155;22;0;0;4405839;3345113;2773;0;0
FR;3;2021-08-03;488;7585;27;0;0;4406327;3352698;2800;0;0
FR;3;2021-08-04;435;4886;26;0;0;4406762;3357584;2826;0;0
FR;3;2021-08-05;428;3738;12;0;0;4407190;3361322;2838;0;0
FR;3;2021-08-06;452;4789;30;0;0;4407642;3366111;2868;0;0
FR;3;2021-08-07;214;1922;11;0;0;4407856;3368033;2879;0;0
FR;3;2021-08-08;247;432;2;0;0;4408103;3368465;2881;0;0
FR;3;2021-08-09;313;2503;11;0;0;4408416;3370968;2892;0;0
FR;3;2021-08-10;363;3879;15;0;0;4408779;3374847;2907;0;0
FR;3;2021-08-11;285;2723;15;0;0;4409064;3377570;2922;0;0
FR;3;2021-08-12;276;2638;12;0;0;4409340;3380208;2934;0;0
FR;3;2021-08-13;277;2267;16;0;0;4409617;3382475;2950;0;0
FR;3;2021-08-14;169;916;1;0;0;4409786;3383391;2951;0;0
FR;3;2021-08-15;55;170;0;0;0;4409841;3383561;2951;0;0
FR;3;2021-08-16;123;1086;8;0;0;4409964;3384647;2959;0;0
FR;3;2021-08-17;186;1503;8;0;0;4410150;3386150;2967;0;0
FR;3;2021-08-18;200;1369;10;0;0;4410350;3387519;2977;0;0
FR;3;2021-08-19;165;1411;10;0;0;4410515;3388930;2987;0;0
FR;3;2021-08-20;166;1633;16;0;0;4410681;3390563;3003;0;0
FR;3;2021-08-21;93;587;2;0;0;4410774;3391150;3005;0;0
FR;3;2021-08-22;39;189;1;0;0;4410813;3391339;3006;0;0
FR;3;2021-08-23;140;928;7;0;0;4410953;3392267;3013;0;0
FR;3;2021-08-24;124;966;10;0;0;4411077;3393233;3023;0;0
FR;3;2021-08-25;136;843;2;0;0;4411213;3394076;3025;0;0
FR;3;2021-08-26;170;874;9;0;0;4411383;3394950;3034;0;0
FR;3;2021-08-27;172;964;9;0;0;4411555;3395914;3043;0;0
FR;3;2021-08-28;98;372;4;0;0;4411653;3396286;3047;0;0
FR;3;2021-08-29;127;133;1;0;0;4411780;3396419;3048;0;0
FR;3;2021-08-30;98;599;0;0;135;4411878;3397018;3048;0;135
FR;3;2021-08-31;127;712;7;0;154;4412005;3397730;3055;0;289
FR;3;2021-09-01;113;480;5;0;124;4412118;3398210;3060;0;413
FR;3;2021-09-02;99;633;22;0;120;4412217;3398843;3082;0;533
FR;3;2021-09-03;115;586;17;0;128;4412332;3399429;3099;0;661
FR;3;2021-09-04;51;301;3;0;58;4412383;3399730;3102;0;719
FR;3;2021-09-05;51;68;5;0;28;4412434;3399798;3107;0;747
FR;3;2021-09-06;113;394;4;0;144;4412547;3400192;3111;0;891
FR;3;2021-09-07;123;473;14;0;128;4412670;3400665;3125;0;1019
FR;3;2021-09-08;115;371;2;0;103;4412785;3401036;3127;0;1122
FR;3;2021-09-09;92;397;8;0;114;4412877;3401433;3135;0;1236
FR;3;2021-09-10;100;422;3;0;104;4412977;3401855;3138;0;1340
FR;3;2021-09-11;74;239;4;0;66;4413051;3402094;3142;0;1406
FR;3;2021-09-12;36;48;1;0;17;4413087;3402142;3143;0;1423
FR;3;2021-09-13;70;322;7;0;109;4413157;3402464;3150;0;1532
FR;3;2021-09-14;70;293;6;0;107;4413227;3402757;3156;0;1639
FR;3;2021-09-15;59;264;3;0;6;4413286;3403021;3159;0;1645
FR;3;2021-09-16;59;339;5;0;5;4413345;3403360;3164;0;1650
FR;3;2021-09-17;50;348;3;0;7;4413395;3403708;3167;0;1657
FR;3;2021-09-18;36;172;1;0;1;4413431;3403880;3168;0;1658
FR;3;2021-09-19;27;32;2;0;1;4413458;3403912;3170;0;1659
FR;3;2021-09-20;79;212;0;0;1;4413537;3404124;3170;0;1660
FR;3;2021-09-21;58;288;6;0;7;4413595;3404412;3176;0;1667
FR;3;2021-09-22;63;229;6;0;7;4413658;3404641;3182;0;1674
FR;3;2021-09-23;36;274;11;0;7;4413694;3404915;3193;0;1681
FR;3;2021-09-24;25;323;12;0;19;4413719;3405238;3205;0;1700
FR;3;2021-09-25;29;152;3;0;3;4413748;3405390;3208;0;1703
FR;3;2021-09-26;15;55;1;0;1;4413763;3405445;3209;0;1704
FR;3;2021-09-27;39;290;3;0;5;4413802;3405735;3212;0;1709
FR;3;2021-09-28;49;255;6;0;10;4413851;3405990;3218;0;1719
FR;3;2021-09-29;34;223;10;0;13;4413885;3406213;3228;0;1732
FR;3;2021-09-30;38;199;8;0;10;4413923;3406412;3236;0;1742
FR;3;2021-10-01;17;169;6;0;7;4413940;3406581;3242;0;1749
FR;3;2021-10-02;14;91;0;0;0;4413954;3406672;3242;0;1749
FR;3;2021-10-03;18;20;1;0;2;4413972;3406692;3243;0;1751
FR;3;2021-10-04;30;161;4;0;4;4414002;3406853;3247;0;1755
FR;3;2021-10-05;16;153;10;0;13;4414018;3407006;3257;0;1768
FR;3;2021-10-06;31;157;7;0;8;4414049;3407163;3264;0;1776
FR;3;2021-10-07;18;142;6;0;6;4414067;3407305;3270;0;1782
FR;3;2021-10-08;22;144;10;0;9;4414089;3407449;3280;0;1791
FR;3;2021-10-09;12;73;1;0;1;4414101;3407522;3281;0;1792
FR;3;2021-10-10;11;16;2;0;2;4414112;3407538;3283;0;1794
FR;3;2021-10-11;14;124;4;0;5;4414126;3407662;3287;0;1799
FR;3;2021-10-12;17;116;5;0;5;4414143;3407778;3292;0;1804
FR;3;2021-10-13;23;120;7;0;5;4414166;3407898;3299;0;1809
FR;3;2021-10-14;16;160;3;0;4;4414182;3408058;3302;0;1813
FR;3;2021-10-15;21;157;8;0;11;4414203;3408215;3310;0;1824
FR;3;2021-10-16;11;79;6;0;8;4414214;3408294;3316;0;1832
FR;3;2021-10-17;9;24;0;0;0;4414223;3408318;3316;0;1832
FR;3;2021-10-18;17;128;2;0;1;4414240;3408446;3318;0;1833
FR;3;2021-10-19;16;125;19;0;21;4414256;3408571;3337;0;1854
FR;3;2021-10-20;20;133;5;0;6;4414276;3408704;3342;0;1860
FR;3;2021-10-21;24;137;17;0;13;4414300;3408841;3359;0;1873
FR;3;2021-10-22;18;128;16;0;20;4414318;3408969;3375;0;1893
FR;3;2021-10-23;12;58;2;0;1;4414330;3409027;3377;0;1894
FR;3;2021-10-24;7;31;0;0;0;4414337;3409058;3377;0;1894
FR;3;2021-10-25;22;150;7;0;7;4414359;3409208;3384;0;1901
FR;3;2021-10-26;18;113;22;0;19;4414377;3409321;3406;0;1920
FR;3;2021-10-27;15;118;9;0;9;4414392;3409439;3415;0;1929
FR;3;2021-10-28;20;126;33;0;36;4414412;3409565;3448;0;1965
FR;3;2021-10-29;10;123;64;0;54;4414422;3409688;3512;0;2019
FR;3;2021-10-30;8;66;11;1;10;4414430;3409754;3523;1;2029
FR;3;2021-10-31;5;22;1;0;1;4414435;3409776;3524;1;2030
FR;3;2021-11-01;7;22;2;0;1;4414442;3409798;3526;1;2031
FR;3;2021-11-02;9;108;8;0;10;4414451;3409906;3534;1;2041
FR;3;2021-11-03;19;119;10;0;10;4414470;3410025;3544;1;2051
FR;3;2021-11-04;18;98;4;0;3;4414488;3410123;3548;1;2054
FR;3;2021-11-05;17;142;8;1;5;4414505;3410265;3556;2;2059
FR;3;2021-11-06;6;67;3;0;3;4414511;3410332;3559;2;2062
FR;3;2021-11-07;6;21;1;0;1;4414517;3410353;3560;2;2063
FR;3;2021-11-08;11;140;7;0;5;4414528;3410493;3567;2;2068
FR;3;2021-11-09;12;151;5;0;5;4414540;3410644;3572;2;2073
FR;3;2021-11-10;12;180;13;0;14;4414552;3410824;3585;2;2087
FR;3;2021-11-11;8;53;3;0;3;4414560;3410877;3588;2;2090
FR;3;2021-11-12;10;155;6;0;4;4414570;3411032;3594;2;2094
FR;3;2021-11-13;7;77;8;0;10;4414577;3411109;3602;2;2104
FR;3;2021-11-14;2;21;0;0;0;4414579;3411130;3602;2;2104
FR;3;2021-11-15;4;190;9;0;9;4414583;3411320;3611;2;2113
FR;3;2021-11-16;2;166;11;0;10;4414585;3411486;3622;2;2123
FR;3;2021-11-17;5;180;10;0;7;4414590;3411666;3632;2;2130
FR;3;2021-11-18;13;178;10;0;11;4414603;3411844;3642;2;2141
FR;3;2021-11-19;8;228;22;0;27;4414611;3412072;3664;2;2168
FR;3;2021-11-20;6;117;5;0;5;4414617;3412189;3669;2;2173
FR;3;2021-11-21;3;26;3;0;3;4414620;3412215;3672;2;2176
FR;3;2021-11-22;10;237;10;0;10;4414630;3412452;3682;2;2186
FR;3;2021-11-23;6;233;15;0;14;4414636;3412685;3697;2;2200
FR;3;2021-11-24;5;240;9;0;17;4414641;3412925;3706;2;2217
FR;3;2021-11-25;9;284;11;0;10;4414650;3413209;3717;2;2227
FR;3;2021-11-26;5;368;35;0;32;4414655;3413577;3752;2;2259
FR;3;2021-11-27;8;173;20;0;21;4414663;3413750;3772;2;2280
FR;3;2021-11-28;3;65;7;0;7;4414666;3413815;3779;2;2287
FR;3;2021-11-29;4;325;19;0;20;4414670;3414140;3798;2;2307
FR;3;2021-11-30;5;416;26;0;29;4414675;3414556;3824;2;2336
FR;3;2021-12-01;18;462;32;0;33;4414693;3415018;3856;2;2369
FR;3;2021-12-02;9;496;33;0;36;4414702;3415514;3889;2;2405
FR;3;2021-12-03;3;566;37;0;38;4414705;3416080;3926;2;2443
FR;3;2021-12-04;3;282;26;0;28;4414708;3416362;3952;2;2471
FR;3;2021-12-05;1;81;5;0;5;4414709;3416443;3957;2;2476
FR;3;2021-12-06;5;507;14;0;16;4414714;3416950;3971;2;2492
FR;3;2021-12-07;4;609;20;0;24;4414718;3417559;3991;2;2516
FR;3;2021-12-08;3;537;29;0;30;4414721;3418096;4020;2;2546
FR;3;2021-12-09;3;587;17;0;22;4414724;3418683;4037;2;2568
FR;3;2021-12-10;9;624;29;0;25;4414733;3419307;4066;2;2593
FR;3;2021-12-11;4;385;10;0;9;4414737;3419692;4076;2;2602
FR;3;2021-12-12;1;121;3;0;3;4414738;3419813;4079;2;2605
FR;3;2021-12-13;2;599;19;0;21;4414740;3420412;4098;2;2626
FR;3;2021-12-14;7;754;18;0;21;4414747;3421166;4116;2;2647
FR;3;2021-12-15;9;720;17;0;21;4414756;3421886;4133;2;2668
FR;3;2021-12-16;9;727;19;0;18;4414765;3422613;4152;2;2686
FR;3;2021-12-17;4;793;18;0;19;4414769;3423406;4170;2;2705
FR;3;2021-12-18;4;413;4;0;5;4414773;3423819;4174;2;2710
FR;3;2021-12-19;3;207;2;0;2;4414776;3424026;4176;2;2712
FR;3;2021-12-20;8;719;23;0;28;4414784;3424745;4199;2;2740
FR;3;2021-12-21;3;808;10;0;13;4414787;3425553;4209;2;2753
FR;3;2021-12-22;6;755;9;0;10;4414793;3426308;4218;2;2763
FR;3;2021-12-23;1;650;9;0;8;4414794;3426958;4227;2;2771
FR;3;2021-12-24;2;271;3;0;6;4414796;3427229;4230;2;2777
FR;3;2021-12-25;0;25;0;0;0;4414796;3427254;4230;2;2777
FR;3;2021-12-26;0;95;1;0;1;4414796;3427349;4231;2;2778
FR;3;2021-12-27;7;542;17;0;19;4414803;3427891;4248;2;2797
FR;3;2021-12-28;1;690;6;0;5;4414804;3428581;4254;2;2802
FR;3;2021-12-29;4;574;14;0;16;4414808;3429155;4268;2;2818
FR;3;2021-12-30;1;599;7;0;10;4414809;3429754;4275;2;2828
FR;3;2021-12-31;0;204;5;0;6;4414809;3429958;4280;2;2834
FR;3;2022-01-01;0;27;0;0;2;4414809;3429985;4280;2;2836
FR;3;2022-01-02;0;82;0;0;0;4414809;3430067;4280;2;2836
FR;3;2022-01-03;3;564;17;0;20;4414812;3430631;4297;2;2856
FR;3;2022-01-04;6;623;9;0;8;4414818;3431254;4306;2;2864
FR;3;2022-01-05;4;552;10;0;14;4414822;3431806;4316;2;2878
FR;3;2022-01-06;5;547;9;0;12;4414827;3432353;4325;2;2890
FR;3;2022-01-07;2;576;11;0;14;4414829;3432929;4336;2;2904
FR;3;2022-01-08;2;283;4;0;5;4414831;3433212;4340;2;2909
FR;3;2022-01-09;0;118;0;0;0;4414831;3433330;4340;2;2909
FR;3;2022-01-10;2;479;12;0;12;4414833;3433809;4352;2;2921
FR;3;2022-01-11;2;531;1;0;1;4414835;3434340;4353;2;2922
FR;3;2022-01-12;2;445;9;0;10;4414837;3434785;4362;2;2932
FR;3;2022-01-13;3;423;11;0;12;4414840;3435208;4373;2;2944
FR;3;2022-01-14;3;474;10;0;13;4414843;3435682;4383;2;2957
FR;3;2022-01-15;0;298;2;0;3;4414843;3435980;4385;2;2960
FR;3;2022-01-16;0;116;1;0;1;4414843;3436096;4386;2;2961
FR;3;2022-01-17;2;349;8;0;10;4414845;3436445;4394;2;2971
FR;3;2022-01-18;2;413;1;0;2;4414847;3436858;4395;2;2973
FR;3;2022-01-19;1;349;5;0;10;4414848;3437207;4400;2;2983
FR;3;2022-01-20;1;379;5;0;3;4414849;3437586;4405;2;2986
FR;3;2022-01-21;3;373;5;0;7;4414852;3437959;4410;2;2993
FR;3;2022-01-22;2;231;1;0;2;4414854;3438190;4411;2;2995
FR;3;2022-01-23;0;82;0;0;1;4414854;3438272;4411;2;2996
FR;3;2022-01-24;2;348;1;0;6;4414856;3438620;4412;2;3002
FR;3;2022-01-25;0;192;0;0;0;4414856;3438812;4412;2;3002
FR;3;2022-01-26;0;88;0;0;0;4414856;3438900;4412;2;3002
FR;3;2022-01-27;0;58;0;0;0;4414856;3438958;4412;2;3002
FR;3;2022-01-28;0;133;0;0;0;4414856;3439091;4412;2;3002
FR;3;2022-01-29;0;110;0;0;0;4414856;3439201;4412;2;3002
FR;3;2022-01-30;0;51;0;0;0;4414856;3439252;4412;2;3002
FR;3;2022-01-31;0;97;0;0;0;4414856;3439349;4412;2;3002
FR;3;2022-02-01;0;108;0;0;1;4414856;3439457;4412;2;3003
FR;3;2022-02-02;0;95;0;0;0;4414856;3439552;4412;2;3003
FR;3;2022-02-03;0;101;0;0;0;4414856;3439653;4412;2;3003
FR;3;2022-02-04;0;124;0;0;0;4414856;3439777;4412;2;3003
FR;3;2022-02-05;0;73;0;0;0;4414856;3439850;4412;2;3003
FR;3;2022-02-06;0;11;0;0;0;4414856;3439861;4412;2;3003
FR;3;2022-02-07;0;89;0;0;1;4414856;3439950;4412;2;3004
FR;3;2022-02-08;0;0;0;0;0;4414856;3439950;4412;2;3004
FR;3;2022-02-09;0;0;0;0;0;4414856;3439950;4412;2;3004
FR;3;2022-02-10;0;0;0;0;0;4414856;3439950;4412;2;3004
FR;3;2022-02-11;0;0;0;0;0;4414856;3439950;4412;2;3004
FR;3;2022-02-12;0;0;0;0;0;4414856;3439950;4412;2;3004
FR;3;2022-02-13;0;0;0;0;0;4414856;3439950;4412;2;3004
FR;3;2022-02-14;0;0;0;0;0;4414856;3439950;4412;2;3004
FR;3;2022-02-15;0;0;0;0;0;4414856;3439950;4412;2;3004
FR;3;2022-02-16;0;0;0;0;0;4414856;3439950;4412;2;3004
FR;3;2022-02-17;0;0;0;0;0;4414856;3439950;4412;2;3004
FR;3;2022-02-18;0;0;0;0;0;4414856;3439950;4412;2;3004
FR;3;2022-02-19;0;0;0;0;0;4414856;3439950;4412;2;3004
FR;3;2022-02-20;0;0;0;0;0;4414856;3439950;4412;2;3004
FR;3;2022-02-21;2;0;0;0;0;4414858;3439950;4412;2;3004
FR;3;2022-02-22;0;0;0;0;0;4414858;3439950;4412;2;3004
FR;3;2022-02-23;0;0;0;0;0;4414858;3439950;4412;2;3004
FR;3;2022-02-24;0;0;0;0;0;4414858;3439950;4412;2;3004
FR;3;2022-02-25;0;0;0;0;0;4414858;3439950;4412;2;3004
FR;3;2022-02-26;0;0;0;0;0;4414858;3439950;4412;2;3004
FR;3;2022-02-27;0;0;0;0;0;4414858;3439950;4412;2;3004
FR;3;2022-02-28;1;0;0;0;0;4414859;3439950;4412;2;3004
FR;3;2022-03-01;1;0;0;0;0;4414860;3439950;4412;2;3004
FR;3;2022-03-02;0;0;0;0;0;4414860;3439950;4412;2;3004
FR;3;2022-03-03;0;0;0;0;0;4414860;3439950;4412;2;3004
FR;3;2022-03-04;0;0;0;0;0;4414860;3439950;4412;2;3004
FR;3;2022-03-05;0;0;0;0;0;4414860;3439950;4412;2;3004
FR;3;2022-03-06;1;0;0;0;0;4414861;3439950;4412;2;3004
FR;3;2022-03-07;0;0;0;0;0;4414861;3439950;4412;2;3004
FR;3;2022-03-08;1;0;0;0;0;4414862;3439950;4412;2;3004
FR;3;2022-03-09;0;0;0;0;0;4414862;3439950;4412;2;3004
FR;3;2022-03-10;0;0;0;0;0;4414862;3439950;4412;2;3004
FR;3;2022-03-11;0;0;0;0;0;4414862;3439950;4412;2;3004
FR;3;2022-03-12;0;0;0;0;0;4414862;3439950;4412;2;3004
FR;3;2022-03-13;0;0;0;0;0;4414862;3439950;4412;2;3004
FR;3;2022-03-14;0;0;0;0;0;4414862;3439950;4412;2;3004
FR;3;2022-03-15;0;0;0;0;0;4414862;3439950;4412;2;3004
FR;3;2022-03-16;0;0;0;0;0;4414862;3439950;4412;2;3004
FR;3;2022-03-17;0;0;0;0;0;4414862;3439950;4412;2;3004
FR;3;2022-03-18;0;0;0;0;0;4414862;3439950;4412;2;3004
FR;3;2022-03-19;0;0;0;0;0;4414862;3439950;4412;2;3004
FR;3;2022-03-20;1;0;0;0;0;4414863;3439950;4412;2;3004
FR;3;2022-03-21;0;0;0;0;0;4414863;3439950;4412;2;3004
FR;3;2022-03-22;0;0;0;0;0;4414863;3439950;4412;2;3004
FR;3;2022-03-23;1;0;0;0;0;4414864;3439950;4412;2;3004
FR;3;2022-03-24;0;0;0;0;0;4414864;3439950;4412;2;3004
FR;3;2022-03-25;1;0;0;0;0;4414865;3439950;4412;2;3004
FR;3;2022-03-26;0;0;0;0;0;4414865;3439950;4412;2;3004
FR;3;2022-03-27;0;0;0;0;0;4414865;3439950;4412;2;3004
FR;3;2022-03-28;0;0;0;0;0;4414865;3439950;4412;2;3004
FR;3;2022-03-29;0;0;0;0;0;4414865;3439950;4412;2;3004
FR;3;2022-03-30;0;0;0;0;0;4414865;3439950;4412;2;3004
FR;3;2022-03-31;0;0;0;0;0;4414865;3439950;4412;2;3004
FR;3;2022-04-01;0;0;0;0;0;4414865;3439950;4412;2;3004
FR;3;2022-04-02;0;0;0;0;0;4414865;3439950;4412;2;3004
FR;3;2022-04-03;0;0;0;0;0;4414865;3439950;4412;2;3004
FR;3;2022-04-04;0;0;0;0;0;4414865;3439950;4412;2;3004
FR;3;2022-04-05;0;0;0;0;0;4414865;3439950;4412;2;3004
FR;3;2022-04-06;0;0;0;0;0;4414865;3439950;4412;2;3004
FR;3;2022-04-07;0;0;0;0;0;4414865;3439950;4412;2;3004
FR;3;2022-04-08;0;0;0;0;0;4414865;3439950;4412;2;3004
FR;3;2022-04-09;0;0;0;0;0;4414865;3439950;4412;2;3004
FR;3;2022-04-10;0;0;0;0;0;4414865;3439950;4412;2;3004
FR;3;2022-04-11;0;0;0;0;0;4414865;3439950;4412;2;3004
FR;3;2022-04-12;0;0;0;0;0;4414865;3439950;4412;2;3004
FR;3;2022-04-13;0;0;0;0;0;4414865;3439950;4412;2;3004
FR;3;2022-04-14;0;0;0;0;0;4414865;3439950;4412;2;3004
FR;3;2022-04-15;1;0;0;0;0;4414866;3439950;4412;2;3004
FR;3;2022-04-16;0;0;0;0;0;4414866;3439950;4412;2;3004
FR;3;2022-04-17;0;0;0;0;0;4414866;3439950;4412;2;3004
FR;3;2022-04-18;0;0;0;0;0;4414866;3439950;4412;2;3004
FR;3;2022-04-19;0;0;0;0;0;4414866;3439950;4412;2;3004
FR;3;2022-04-20;0;0;0;0;0;4414866;3439950;4412;2;3004
FR;3;2022-04-21;0;0;0;0;0;4414866;3439950;4412;2;3004
FR;3;2022-04-22;0;0;0;0;0;4414866;3439950;4412;2;3004
FR;3;2022-04-23;0;0;0;0;0;4414866;3439950;4412;2;3004
FR;3;2022-04-24;0;0;0;0;0;4414866;3439950;4412;2;3004
FR;3;2022-04-25;0;0;0;0;0;4414866;3439950;4412;2;3004
FR;3;2022-04-26;0;0;0;0;0;4414866;3439950;4412;2;3004
FR;3;2022-04-27;0;0;0;0;0;4414866;3439950;4412;2;3004
FR;3;2022-04-28;0;0;0;0;0;4414866;3439950;4412;2;3004
FR;3;2022-04-29;0;0;0;0;0;4414866;3439950;4412;2;3004
FR;3;2022-04-30;0;0;0;0;0;4414866;3439950;4412;2;3004
FR;3;2022-05-01;0;0;0;0;0;4414866;3439950;4412;2;3004
FR;3;2022-05-02;0;0;0;0;0;4414866;3439950;4412;2;3004
FR;3;2022-05-03;0;0;0;0;0;4414866;3439950;4412;2;3004
FR;3;2022-05-04;0;0;0;0;0;4414866;3439950;4412;2;3004
FR;3;2022-05-05;0;0;0;0;0;4414866;3439950;4412;2;3004
FR;3;2022-05-06;0;0;0;0;0;4414866;3439950;4412;2;3004
FR;3;2022-05-07;0;0;0;0;0;4414866;3439950;4412;2;3004
FR;3;2022-05-08;0;0;0;0;0;4414866;3439950;4412;2;3004
FR;3;2022-05-09;0;0;0;0;0;4414866;3439950;4412;2;3004
FR;3;2022-05-10;0;0;0;0;0;4414866;3439950;4412;2;3004
FR;3;2022-05-11;0;0;0;0;0;4414866;3439950;4412;2;3004
FR;3;2022-05-12;0;0;0;0;0;4414866;3439950;4412;2;3004
FR;3;2022-05-13;0;0;0;0;0;4414866;3439950;4412;2;3004
FR;3;2022-05-14;1;0;0;0;0;4414867;3439950;4412;2;3004
FR;3;2022-05-15;0;0;0;0;0;4414867;3439950;4412;2;3004
FR;3;2022-05-16;0;0;0;0;0;4414867;3439950;4412;2;3004
FR;3;2022-05-17;0;0;0;0;0;4414867;3439950;4412;2;3004
FR;3;2022-05-18;0;0;0;0;0;4414867;3439950;4412;2;3004
FR;3;2022-05-19;0;0;0;0;0;4414867;3439950;4412;2;3004
FR;3;2022-05-20;0;0;0;0;0;4414867;3439950;4412;2;3004
FR;3;2022-05-21;0;0;0;0;0;4414867;3439950;4412;2;3004
FR;3;2022-05-22;0;0;0;0;0;4414867;3439950;4412;2;3004
FR;4;2020-12-27;0;0;0;0;0;0;0;0;0;0
FR;4;2020-12-28;0;0;0;0;0;0;0;0;0;0
FR;4;2020-12-29;0;0;0;0;0;0;0;0;0;0
FR;4;2020-12-30;0;0;0;0;0;0;0;0;0;0
FR;4;2020-12-31;0;0;0;0;0;0;0;0;0;0
FR;4;2021-01-01;0;0;0;0;0;0;0;0;0;0
FR;4;2021-01-02;0;0;0;0;0;0;0;0;0;0
FR;4;2021-01-03;0;0;0;0;0;0;0;0;0;0
FR;4;2021-01-04;0;0;0;0;0;0;0;0;0;0
FR;4;2021-01-05;0;0;0;0;0;0;0;0;0;0
FR;4;2021-01-06;0;0;0;0;0;0;0;0;0;0
FR;4;2021-01-07;0;0;0;0;0;0;0;0;0;0
FR;4;2021-01-08;0;0;0;0;0;0;0;0;0;0
FR;4;2021-01-09;0;0;0;0;0;0;0;0;0;0
FR;4;2021-01-10;0;0;0;0;0;0;0;0;0;0
FR;4;2021-01-11;0;0;0;0;0;0;0;0;0;0
FR;4;2021-01-12;0;0;0;0;0;0;0;0;0;0
FR;4;2021-01-13;0;0;0;0;0;0;0;0;0;0
FR;4;2021-01-14;0;0;0;0;0;0;0;0;0;0
FR;4;2021-01-15;0;0;0;0;0;0;0;0;0;0
FR;4;2021-01-16;0;0;0;0;0;0;0;0;0;0
FR;4;2021-01-17;0;0;0;0;0;0;0;0;0;0
FR;4;2021-01-18;0;0;0;0;0;0;0;0;0;0
FR;4;2021-01-19;0;0;0;0;0;0;0;0;0;0
FR;4;2021-01-20;0;0;0;0;0;0;0;0;0;0
FR;4;2021-01-21;0;0;0;0;0;0;0;0;0;0
FR;4;2021-01-22;0;0;0;0;0;0;0;0;0;0
FR;4;2021-01-23;0;0;0;0;0;0;0;0;0;0
FR;4;2021-01-24;0;0;0;0;0;0;0;0;0;0
FR;4;2021-01-25;0;0;0;0;0;0;0;0;0;0
FR;4;2021-01-26;0;0;0;0;0;0;0;0;0;0
FR;4;2021-01-27;0;0;0;0;0;0;0;0;0;0
FR;4;2021-01-28;0;0;0;0;0;0;0;0;0;0
FR;4;2021-01-29;0;0;0;0;0;0;0;0;0;0
FR;4;2021-01-30;0;0;0;0;0;0;0;0;0;0
FR;4;2021-01-31;0;0;0;0;0;0;0;0;0;0
FR;4;2021-02-01;0;0;0;0;0;0;0;0;0;0
FR;4;2021-02-02;0;0;0;0;0;0;0;0;0;0
FR;4;2021-02-03;0;0;0;0;0;0;0;0;0;0
FR;4;2021-02-04;0;0;0;0;0;0;0;0;0;0
FR;4;2021-02-05;0;0;0;0;0;0;0;0;0;0
FR;4;2021-02-06;0;0;0;0;0;0;0;0;0;0
FR;4;2021-02-07;0;0;0;0;0;0;0;0;0;0
FR;4;2021-02-08;0;0;0;0;0;0;0;0;0;0
FR;4;2021-02-09;0;0;0;0;0;0;0;0;0;0
FR;4;2021-02-10;0;0;0;0;0;0;0;0;0;0
FR;4;2021-02-11;0;0;0;0;0;0;0;0;0;0
FR;4;2021-02-12;0;0;0;0;0;0;0;0;0;0
FR;4;2021-02-13;0;0;0;0;0;0;0;0;0;0
FR;4;2021-02-14;0;0;0;0;0;0;0;0;0;0
FR;4;2021-02-15;0;0;0;0;0;0;0;0;0;0
FR;4;2021-02-16;0;0;0;0;0;0;0;0;0;0
FR;4;2021-02-17;0;0;0;0;0;0;0;0;0;0
FR;4;2021-02-18;0;0;0;0;0;0;0;0;0;0
FR;4;2021-02-19;0;0;0;0;0;0;0;0;0;0
FR;4;2021-02-20;0;0;0;0;0;0;0;0;0;0
FR;4;2021-02-21;0;0;0;0;0;0;0;0;0;0
FR;4;2021-02-22;0;0;0;0;0;0;0;0;0;0
FR;4;2021-02-23;0;0;0;0;0;0;0;0;0;0
FR;4;2021-02-24;0;0;0;0;0;0;0;0;0;0
FR;4;2021-02-25;0;0;0;0;0;0;0;0;0;0
FR;4;2021-02-26;0;0;0;0;0;0;0;0;0;0
FR;4;2021-02-27;0;0;0;0;0;0;0;0;0;0
FR;4;2021-02-28;0;0;0;0;0;0;0;0;0;0
FR;4;2021-03-01;0;0;0;0;0;0;0;0;0;0
FR;4;2021-03-02;0;0;0;0;0;0;0;0;0;0
FR;4;2021-03-03;0;0;0;0;0;0;0;0;0;0
FR;4;2021-03-04;0;0;0;0;0;0;0;0;0;0
FR;4;2021-03-05;0;0;0;0;0;0;0;0;0;0
FR;4;2021-03-06;0;0;0;0;0;0;0;0;0;0
FR;4;2021-03-07;0;0;0;0;0;0;0;0;0;0
FR;4;2021-03-08;0;0;0;0;0;0;0;0;0;0
FR;4;2021-03-09;0;0;0;0;0;0;0;0;0;0
FR;4;2021-03-10;0;0;0;0;0;0;0;0;0;0
FR;4;2021-03-11;0;0;0;0;0;0;0;0;0;0
FR;4;2021-03-12;0;0;0;0;0;0;0;0;0;0
FR;4;2021-03-13;0;0;0;0;0;0;0;0;0;0
FR;4;2021-03-14;0;0;0;0;0;0;0;0;0;0
FR;4;2021-03-15;0;0;0;0;0;0;0;0;0;0
FR;4;2021-03-16;0;0;0;0;0;0;0;0;0;0
FR;4;2021-03-17;0;0;0;0;0;0;0;0;0;0
FR;4;2021-03-18;0;0;0;0;0;0;0;0;0;0
FR;4;2021-03-19;0;0;0;0;0;0;0;0;0;0
FR;4;2021-03-20;0;0;0;0;0;0;0;0;0;0
FR;4;2021-03-21;0;0;0;0;0;0;0;0;0;0
FR;4;2021-03-22;0;0;0;0;0;0;0;0;0;0
FR;4;2021-03-23;0;0;0;0;0;0;0;0;0;0
FR;4;2021-03-24;0;0;0;0;0;0;0;0;0;0
FR;4;2021-03-25;0;0;0;0;0;0;0;0;0;0
FR;4;2021-03-26;0;0;0;0;0;0;0;0;0;0
FR;4;2021-03-27;0;0;0;0;0;0;0;0;0;0
FR;4;2021-03-28;0;0;0;0;0;0;0;0;0;0
FR;4;2021-03-29;0;0;0;0;0;0;0;0;0;0
FR;4;2021-03-30;0;0;0;0;0;0;0;0;0;0
FR;4;2021-03-31;0;0;0;0;0;0;0;0;0;0
FR;4;2021-04-01;0;0;0;0;0;0;0;0;0;0
FR;4;2021-04-02;0;0;0;0;0;0;0;0;0;0
FR;4;2021-04-03;0;0;0;0;0;0;0;0;0;0
FR;4;2021-04-04;0;0;0;0;0;0;0;0;0;0
FR;4;2021-04-05;0;0;0;0;0;0;0;0;0;0
FR;4;2021-04-06;0;0;0;0;0;0;0;0;0;0
FR;4;2021-04-07;0;0;0;0;0;0;0;0;0;0
FR;4;2021-04-08;0;0;0;0;0;0;0;0;0;0
FR;4;2021-04-09;0;0;0;0;0;0;0;0;0;0
FR;4;2021-04-10;0;0;0;0;0;0;0;0;0;0
FR;4;2021-04-11;0;0;0;0;0;0;0;0;0;0
FR;4;2021-04-12;0;0;0;0;0;0;0;0;0;0
FR;4;2021-04-13;0;0;0;0;0;0;0;0;0;0
FR;4;2021-04-14;0;0;0;0;0;0;0;0;0;0
FR;4;2021-04-15;0;0;0;0;0;0;0;0;0;0
FR;4;2021-04-16;0;0;0;0;0;0;0;0;0;0
FR;4;2021-04-17;0;0;0;0;0;0;0;0;0;0
FR;4;2021-04-18;0;0;0;0;0;0;0;0;0;0
FR;4;2021-04-19;0;0;0;0;0;0;0;0;0;0
FR;4;2021-04-20;0;0;0;0;0;0;0;0;0;0
FR;4;2021-04-21;0;0;0;0;0;0;0;0;0;0
FR;4;2021-04-22;0;0;0;0;0;0;0;0;0;0
FR;4;2021-04-23;4019;0;0;0;0;4019;0;0;0;0
FR;4;2021-04-24;1569;0;0;0;0;5588;0;0;0;0
FR;4;2021-04-25;125;0;0;0;0;5713;0;0;0;0
FR;4;2021-04-26;2869;1;0;0;0;8582;1;0;0;0
FR;4;2021-04-27;9519;3;0;0;0;18101;4;0;0;0
FR;4;2021-04-28;9904;6;0;0;0;28005;10;0;0;0
FR;4;2021-04-29;15991;8;0;0;0;43996;18;0;0;0
FR;4;2021-04-30;19228;10;0;0;0;63224;28;0;0;0
FR;4;2021-05-01;1993;6;0;0;0;65217;34;0;0;0
FR;4;2021-05-02;482;0;0;0;0;65699;34;0;0;0
FR;4;2021-05-03;5058;2;0;0;0;70757;36;0;0;0
FR;4;2021-05-04;8397;10;0;0;0;79154;46;0;0;0
FR;4;2021-05-05;6182;7;0;0;0;85336;53;0;0;0
FR;4;2021-05-06;11378;11;0;0;0;96714;64;0;0;0
FR;4;2021-05-07;19121;9;0;0;0;115835;73;0;0;0
FR;4;2021-05-08;2377;6;0;0;0;118212;79;0;0;0
FR;4;2021-05-09;685;3;0;0;0;118897;82;0;0;0
FR;4;2021-05-10;7239;5;1;0;0;126136;87;1;0;0
FR;4;2021-05-11;14313;12;0;0;0;140449;99;1;0;0
FR;4;2021-05-12;10161;15;0;0;0;150610;114;1;0;0
FR;4;2021-05-13;1579;3;0;0;0;152189;117;1;0;0
FR;4;2021-05-14;7758;6;0;0;0;159947;123;1;0;0
FR;4;2021-05-15;3717;8;1;0;0;163664;131;2;0;0
FR;4;2021-05-16;417;1;0;0;0;164081;132;2;0;0
FR;4;2021-05-17;4475;6;0;0;0;168556;138;2;0;0
FR;4;2021-05-18;8751;10;0;0;0;177307;148;2;0;0
FR;4;2021-05-19;5690;7;0;0;0;182997;155;2;0;0
FR;4;2021-05-20;9478;7;0;0;0;192475;162;2;0;0
FR;4;2021-05-21;12790;30;0;0;0;205265;192;2;0;0
FR;4;2021-05-22;5057;15;0;0;0;210322;207;2;0;0
FR;4;2021-05-23;494;4;0;0;0;210816;211;2;0;0
FR;4;2021-05-24;1054;7;0;0;0;211870;218;2;0;0
FR;4;2021-05-25;7620;16;0;0;0;219490;234;2;0;0
FR;4;2021-05-26;7723;16;0;0;0;227213;250;2;0;0
FR;4;2021-05-27;14327;35;0;0;0;241540;285;2;0;0
FR;4;2021-05-28;26583;82;1;0;0;268123;367;3;0;0
FR;4;2021-05-29;11380;18;0;0;0;279503;385;3;0;0
FR;4;2021-05-30;971;6;0;0;0;280474;391;3;0;0
FR;4;2021-05-31;12686;21;0;0;0;293160;412;3;0;0
FR;4;2021-06-01;20248;46;1;0;0;313408;458;4;0;0
FR;4;2021-06-02;14517;33;0;0;0;327925;491;4;0;0
FR;4;2021-06-03;19409;24;1;0;0;347334;515;5;0;0
FR;4;2021-06-04;22509;47;0;0;0;369843;562;5;0;0
FR;4;2021-06-05;9712;32;0;0;0;379555;594;5;0;0
FR;4;2021-06-06;1039;1;0;0;0;380594;595;5;0;0
FR;4;2021-06-07;9225;19;0;0;0;389819;614;5;0;0
FR;4;2021-06-08;14605;31;0;0;0;404424;645;5;0;0
FR;4;2021-06-09;12202;25;0;0;0;416626;670;5;0;0
FR;4;2021-06-10;15397;30;0;0;0;432023;700;5;0;0
FR;4;2021-06-11;16979;56;0;0;0;449002;756;5;0;0
FR;4;2021-06-12;7445;27;0;0;0;456447;783;5;0;0
FR;4;2021-06-13;906;2;0;0;0;457353;785;5;0;0
FR;4;2021-06-14;6646;25;0;0;0;463999;810;5;0;0
FR;4;2021-06-15;10882;37;0;0;0;474881;847;5;0;0
FR;4;2021-06-16;8904;15;0;0;0;483785;862;5;0;0
FR;4;2021-06-17;10897;36;0;0;0;494682;898;5;0;0
FR;4;2021-06-18;12420;45;0;0;0;507102;943;5;0;0
FR;4;2021-06-19;5567;25;0;0;0;512669;968;5;0;0
FR;4;2021-06-20;817;5;0;0;0;513486;973;5;0;0
FR;4;2021-06-21;5081;20;0;0;0;518567;993;5;0;0
FR;4;2021-06-22;7905;28;2;0;0;526472;1021;7;0;0
FR;4;2021-06-23;7092;39;2;0;0;533564;1060;9;0;0
FR;4;2021-06-24;8645;45;1;0;0;542209;1105;10;0;0
FR;4;2021-06-25;10172;39;2;0;0;552381;1144;12;0;0
FR;4;2021-06-26;4841;21;0;0;0;557222;1165;12;0;0
FR;4;2021-06-27;760;3;0;0;0;557982;1168;12;0;0
FR;4;2021-06-28;4820;16;1;0;0;562802;1184;13;0;0
FR;4;2021-06-29;7097;27;2;0;0;569899;1211;15;0;0
FR;4;2021-06-30;6707;39;2;0;0;576606;1250;17;0;0
FR;4;2021-07-01;8191;40;0;0;0;584797;1290;17;0;0
FR;4;2021-07-02;9412;52;1;0;0;594209;1342;18;0;0
FR;4;2021-07-03;4843;19;0;0;0;599052;1361;18;0;0
FR;4;2021-07-04;686;5;0;0;0;599738;1366;18;0;0
FR;4;2021-07-05;4765;19;2;0;0;604503;1385;20;0;0
FR;4;2021-07-06;7717;28;4;0;0;612220;1413;24;0;0
FR;4;2021-07-07;7067;34;2;0;0;619287;1447;26;0;0
FR;4;2021-07-08;9218;40;2;0;0;628505;1487;28;0;0
FR;4;2021-07-09;10275;34;1;0;0;638780;1521;29;0;0
FR;4;2021-07-10;4634;14;2;0;0;643414;1535;31;0;0
FR;4;2021-07-11;582;4;1;0;0;643996;1539;32;0;0
FR;4;2021-07-12;5867;29;0;0;0;649863;1568;32;0;0
FR;4;2021-07-13;14230;29;0;0;0;664093;1597;32;0;0
FR;4;2021-07-14;2282;14;0;0;0;666375;1611;32;0;0
FR;4;2021-07-15;18231;36;0;0;0;684606;1647;32;0;0
FR;4;2021-07-16;22815;70;2;0;0;707421;1717;34;0;0
FR;4;2021-07-17;9735;20;0;0;0;717156;1737;34;0;0
FR;4;2021-07-18;1354;4;0;0;0;718510;1741;34;0;0
FR;4;2021-07-19;12978;28;1;0;0;731488;1769;35;0;0
FR;4;2021-07-20;17330;26;1;0;0;748818;1795;36;0;0
FR;4;2021-07-21;15604;33;0;0;0;764422;1828;36;0;0
FR;4;2021-07-22;18237;44;2;0;0;782659;1872;38;0;0
FR;4;2021-07-23;20404;57;7;0;0;803063;1929;45;0;0
FR;4;2021-07-24;9282;32;0;0;0;812345;1961;45;0;0
FR;4;2021-07-25;1350;8;0;0;0;813695;1969;45;0;0
FR;4;2021-07-26;11030;20;0;0;0;824725;1989;45;0;0
FR;4;2021-07-27;14660;35;3;0;0;839385;2024;48;0;0
FR;4;2021-07-28;12921;26;2;0;0;852306;2050;50;0;0
FR;4;2021-07-29;14079;54;4;0;0;866385;2104;54;0;0
FR;4;2021-07-30;15478;45;2;0;0;881863;2149;56;0;0
FR;4;2021-07-31;6830;14;2;0;0;888693;2163;58;0;0
FR;4;2021-08-01;904;1;0;0;0;889597;2164;58;0;0
FR;4;2021-08-02;7902;29;0;0;0;897499;2193;58;0;0
FR;4;2021-08-03;10788;32;2;0;0;908287;2225;60;0;0
FR;4;2021-08-04;9731;29;0;0;0;918018;2254;60;0;0
FR;4;2021-08-05;9812;41;0;0;0;927830;2295;60;0;0
FR;4;2021-08-06;10182;30;3;0;0;938012;2325;63;0;0
FR;4;2021-08-07;5088;30;1;0;0;943100;2355;64;0;0
FR;4;2021-08-08;1217;13;0;0;0;944317;2368;64;0;0
FR;4;2021-08-09;6334;31;0;0;0;950651;2399;64;0;0
FR;4;2021-08-10;8741;18;0;0;0;959392;2417;64;0;0
FR;4;2021-08-11;7929;33;4;0;0;967321;2450;68;0;0
FR;4;2021-08-12;8579;29;1;0;0;975900;2479;69;0;0
FR;4;2021-08-13;7546;24;0;1;0;983446;2503;69;1;0
FR;4;2021-08-14;3786;20;0;0;0;987232;2523;69;1;0
FR;4;2021-08-15;769;5;0;0;0;988001;2528;69;1;0
FR;4;2021-08-16;4003;16;0;0;0;992004;2544;69;1;0
FR;4;2021-08-17;5615;16;1;0;0;997619;2560;70;1;0
FR;4;2021-08-18;5162;34;0;0;0;1002781;2594;70;1;0
FR;4;2021-08-19;5474;33;3;0;0;1008255;2627;73;1;0
FR;4;2021-08-20;5210;24;1;0;0;1013465;2651;74;1;0
FR;4;2021-08-21;2307;21;1;0;0;1015772;2672;75;1;0
FR;4;2021-08-22;401;2;0;0;0;1016173;2674;75;1;0
FR;4;2021-08-23;2924;19;1;0;0;1019097;2693;76;1;0
FR;4;2021-08-24;3744;15;0;0;0;1022841;2708;76;1;0
FR;4;2021-08-25;3538;25;0;0;0;1026379;2733;76;1;0
FR;4;2021-08-26;3701;20;2;0;0;1030080;2753;78;1;0
FR;4;2021-08-27;3605;31;2;0;0;1033685;2784;80;1;0
FR;4;2021-08-28;1723;9;1;0;0;1035408;2793;81;1;0
FR;4;2021-08-29;387;7;1;0;0;1035795;2800;82;1;0
FR;4;2021-08-30;2008;24;0;0;14;1037803;2824;82;1;14
FR;4;2021-08-31;2480;20;0;0;13;1040283;2844;82;1;27
FR;4;2021-09-01;2078;38;1;0;21;1042361;2882;83;1;48
FR;4;2021-09-02;2301;31;4;0;18;1044662;2913;87;1;66
FR;4;2021-09-03;2356;44;5;0;32;1047018;2957;92;1;98
FR;4;2021-09-04;1374;17;0;0;7;1048392;2974;92;1;105
FR;4;2021-09-05;430;2;0;0;2;1048822;2976;92;1;107
FR;4;2021-09-06;1705;62;0;0;23;1050527;3038;92;1;130
FR;4;2021-09-07;1672;18;1;0;9;1052199;3056;93;1;139
FR;4;2021-09-08;1279;27;3;1;20;1053478;3083;96;2;159
FR;4;2021-09-09;1385;23;2;0;9;1054863;3106;98;2;168
FR;4;2021-09-10;1516;31;2;0;23;1056379;3137;100;2;191
FR;4;2021-09-11;738;11;0;0;3;1057117;3148;100;2;194
FR;4;2021-09-12;168;4;0;0;2;1057285;3152;100;2;196
FR;4;2021-09-13;1315;22;1;0;16;1058600;3174;101;2;212
FR;4;2021-09-14;1497;9;2;0;6;1060097;3183;103;2;218
FR;4;2021-09-15;1091;27;1;0;24;1061188;3210;104;2;242
FR;4;2021-09-16;1095;22;2;0;15;1062283;3232;106;2;257
FR;4;2021-09-17;892;21;1;0;12;1063175;3253;107;2;269
FR;4;2021-09-18;462;6;1;0;5;1063637;3259;108;2;274
FR;4;2021-09-19;182;3;0;0;2;1063819;3262;108;2;276
FR;4;2021-09-20;445;18;0;0;12;1064264;3280;108;2;288
FR;4;2021-09-21;422;11;0;0;7;1064686;3291;108;2;295
FR;4;2021-09-22;372;19;2;0;13;1065058;3310;110;2;308
FR;4;2021-09-23;477;16;1;0;15;1065535;3326;111;2;323
FR;4;2021-09-24;409;13;2;0;9;1065944;3339;113;2;332
FR;4;2021-09-25;281;9;1;0;4;1066225;3348;114;2;336
FR;4;2021-09-26;73;2;0;0;1;1066298;3350;114;2;337
FR;4;2021-09-27;261;10;1;0;8;1066559;3360;115;2;345
FR;4;2021-09-28;315;8;0;0;8;1066874;3368;115;2;353
FR;4;2021-09-29;372;18;1;0;12;1067246;3386;116;2;365
FR;4;2021-09-30;359;40;0;0;21;1067605;3426;116;2;386
FR;4;2021-10-01;407;49;0;0;43;1068012;3475;116;2;429
FR;4;2021-10-02;195;22;1;0;13;1068207;3497;117;2;442
FR;4;2021-10-03;84;1;0;0;0;1068291;3498;117;2;442
FR;4;2021-10-04;355;19;1;0;15;1068646;3517;118;2;457
FR;4;2021-10-05;275;19;2;0;15;1068921;3536;120;2;472
FR;4;2021-10-06;243;21;1;0;17;1069164;3557;121;2;489
FR;4;2021-10-07;254;25;2;0;13;1069418;3582;123;2;502
FR;4;2021-10-08;352;23;2;0;19;1069770;3605;125;2;521
FR;4;2021-10-09;192;6;6;0;7;1069962;3611;131;2;528
FR;4;2021-10-10;95;3;2;0;3;1070057;3614;133;2;531
FR;4;2021-10-11;246;15;1;0;14;1070303;3629;134;2;545
FR;4;2021-10-12;204;14;0;0;13;1070507;3643;134;2;558
FR;4;2021-10-13;218;27;1;0;24;1070725;3670;135;2;582
FR;4;2021-10-14;307;22;4;0;16;1071032;3692;139;2;598
FR;4;2021-10-15;322;24;5;0;25;1071354;3716;144;2;623
FR;4;2021-10-16;166;6;2;0;6;1071520;3722;146;2;629
FR;4;2021-10-17;70;2;0;0;1;1071590;3724;146;2;630
FR;4;2021-10-18;278;16;1;0;12;1071868;3740;147;2;642
FR;4;2021-10-19;210;14;2;0;15;1072078;3754;149;2;657
FR;4;2021-10-20;224;27;4;0;15;1072302;3781;153;2;672
FR;4;2021-10-21;235;17;0;0;13;1072537;3798;153;2;685
FR;4;2021-10-22;211;25;2;0;20;1072748;3823;155;2;705
FR;4;2021-10-23;115;16;1;0;15;1072863;3839;156;2;720
FR;4;2021-10-24;38;4;0;0;1;1072901;3843;156;2;721
FR;4;2021-10-25;209;7;2;0;9;1073110;3850;158;2;730
FR;4;2021-10-26;196;14;0;0;12;1073306;3864;158;2;742
FR;4;2021-10-27;190;11;4;0;11;1073496;3875;162;2;753
FR;4;2021-10-28;182;18;4;0;21;1073678;3893;166;2;774
FR;4;2021-10-29;220;15;2;0;13;1073898;3908;168;2;787
FR;4;2021-10-30;102;2;1;0;2;1074000;3910;169;2;789
FR;4;2021-10-31;56;3;2;0;3;1074056;3913;171;2;792
FR;4;2021-11-01;75;27;4;0;24;1074131;3940;175;2;816
FR;4;2021-11-02;153;20;2;0;21;1074284;3960;177;2;837
FR;4;2021-11-03;127;20;8;1;18;1074411;3980;185;3;855
FR;4;2021-11-04;175;14;1;0;11;1074586;3994;186;3;866
FR;4;2021-11-05;126;17;1;0;16;1074712;4011;187;3;882
FR;4;2021-11-06;77;6;1;0;6;1074789;4017;188;3;888
FR;4;2021-11-07;76;2;2;0;4;1074865;4019;190;3;892
FR;4;2021-11-08;158;20;1;0;20;1075023;4039;191;3;912
FR;4;2021-11-09;151;14;3;0;16;1075174;4053;194;3;928
FR;4;2021-11-10;114;29;6;0;31;1075288;4082;200;3;959
FR;4;2021-11-11;86;10;0;0;10;1075374;4092;200;3;969
FR;4;2021-11-12;97;18;2;0;17;1075471;4110;202;3;986
FR;4;2021-11-13;73;15;2;0;14;1075544;4125;204;3;1000
FR;4;2021-11-14;53;5;3;0;7;1075597;4130;207;3;1007
FR;4;2021-11-15;97;26;2;0;24;1075694;4156;209;3;1031
FR;4;2021-11-16;99;12;2;0;14;1075793;4168;211;3;1045
FR;4;2021-11-17;116;29;4;0;29;1075909;4197;215;3;1074
FR;4;2021-11-18;99;34;12;0;41;1076008;4231;227;3;1115
FR;4;2021-11-19;79;19;3;0;20;1076087;4250;230;3;1135
FR;4;2021-11-20;75;8;1;0;8;1076162;4258;231;3;1143
FR;4;2021-11-21;61;7;2;0;9;1076223;4265;233;3;1152
FR;4;2021-11-22;101;27;6;0;29;1076324;4292;239;3;1181
FR;4;2021-11-23;73;29;5;0;26;1076397;4321;244;3;1207
FR;4;2021-11-24;85;23;9;0;22;1076482;4344;253;3;1229
FR;4;2021-11-25;84;28;14;0;30;1076566;4372;267;3;1259
FR;4;2021-11-26;80;43;12;0;45;1076646;4415;279;3;1304
FR;4;2021-11-27;35;22;14;0;24;1076681;4437;293;3;1328
FR;4;2021-11-28;48;8;0;0;7;1076729;4445;293;3;1335
FR;4;2021-11-29;83;31;15;0;39;1076812;4476;308;3;1374
FR;4;2021-11-30;72;36;12;0;40;1076884;4512;320;3;1414
FR;4;2021-12-01;78;59;19;0;66;1076962;4571;339;3;1480
FR;4;2021-12-02;98;47;19;0;52;1077060;4618;358;3;1532
FR;4;2021-12-03;98;36;15;0;44;1077158;4654;373;3;1576
FR;4;2021-12-04;69;31;18;0;44;1077227;4685;391;3;1620
FR;4;2021-12-05;60;5;1;0;6;1077287;4690;392;3;1626
FR;4;2021-12-06;96;45;20;0;59;1077383;4735;412;3;1685
FR;4;2021-12-07;77;33;9;0;33;1077460;4768;421;3;1718
FR;4;2021-12-08;66;29;16;0;34;1077526;4797;437;3;1752
FR;4;2021-12-09;59;32;10;0;38;1077585;4829;447;3;1790
FR;4;2021-12-10;60;62;21;0;66;1077645;4891;468;3;1856
FR;4;2021-12-11;24;33;7;0;33;1077669;4924;475;3;1889
FR;4;2021-12-12;23;10;3;0;13;1077692;4934;478;3;1902
FR;4;2021-12-13;68;38;13;0;47;1077760;4972;491;3;1949
FR;4;2021-12-14;56;43;15;0;52;1077816;5015;506;3;2001
FR;4;2021-12-15;59;63;28;0;83;1077875;5078;534;3;2084
FR;4;2021-12-16;30;44;18;0;56;1077905;5122;552;3;2140
FR;4;2021-12-17;38;55;12;0;60;1077943;5177;564;3;2200
FR;4;2021-12-18;48;29;2;0;30;1077991;5206;566;3;2230
FR;4;2021-12-19;15;4;1;0;4;1078006;5210;567;3;2234
FR;4;2021-12-20;35;38;10;0;41;1078041;5248;577;3;2275
FR;4;2021-12-21;26;30;15;0;36;1078067;5278;592;3;2311
FR;4;2021-12-22;35;35;10;0;36;1078102;5313;602;3;2347
FR;4;2021-12-23;39;43;8;0;47;1078141;5356;610;3;2394
FR;4;2021-12-24;23;25;10;0;29;1078164;5381;620;3;2423
FR;4;2021-12-25;6;3;3;0;4;1078170;5384;623;3;2427
FR;4;2021-12-26;4;3;1;0;2;1078174;5387;624;3;2429
FR;4;2021-12-27;26;41;8;0;42;1078200;5428;632;3;2471
FR;4;2021-12-28;24;28;8;0;29;1078224;5456;640;3;2500
FR;4;2021-12-29;48;24;10;0;28;1078272;5480;650;3;2528
FR;4;2021-12-30;40;16;12;0;19;1078312;5496;662;3;2547
FR;4;2021-12-31;18;5;8;0;10;1078330;5501;670;3;2557
FR;4;2022-01-01;5;4;4;0;6;1078335;5505;674;3;2563
FR;4;2022-01-02;40;4;14;0;17;1078375;5509;688;3;2580
FR;4;2022-01-03;37;52;20;1;57;1078412;5561;708;4;2637
FR;4;2022-01-04;28;26;13;0;29;1078440;5587;721;4;2666
FR;4;2022-01-05;46;19;16;0;20;1078486;5606;737;4;2686
FR;4;2022-01-06;43;20;21;0;33;1078529;5626;758;4;2719
FR;4;2022-01-07;24;19;15;0;19;1078553;5645;773;4;2738
FR;4;2022-01-08;8;5;9;0;11;1078561;5650;782;4;2749
FR;4;2022-01-09;17;2;1;0;2;1078578;5652;783;4;2751
FR;4;2022-01-10;39;22;16;0;33;1078617;5674;799;4;2784
FR;4;2022-01-11;23;30;12;0;34;1078640;5704;811;4;2818
FR;4;2022-01-12;30;18;12;0;19;1078670;5722;823;4;2837
FR;4;2022-01-13;48;18;26;0;35;1078718;5740;849;4;2872
FR;4;2022-01-14;21;28;13;0;31;1078739;5768;862;4;2903
FR;4;2022-01-15;10;6;7;0;11;1078749;5774;869;4;2914
FR;4;2022-01-16;9;9;11;0;19;1078758;5783;880;4;2933
FR;4;2022-01-17;23;17;11;0;22;1078781;5800;891;4;2955
FR;4;2022-01-18;15;13;7;0;17;1078796;5813;898;4;2972
FR;4;2022-01-19;28;22;9;0;29;1078824;5835;907;4;3001
FR;4;2022-01-20;31;33;11;0;36;1078855;5868;918;4;3037
FR;4;2022-01-21;9;12;18;1;15;1078864;5880;936;5;3052
FR;4;2022-01-22;30;9;2;0;9;1078894;5889;938;5;3061
FR;4;2022-01-23;6;2;4;0;6;1078900;5891;942;5;3067
FR;4;2022-01-24;14;21;8;0;27;1078914;5912;950;5;3094
FR;4;2022-01-25;20;30;8;1;34;1078934;5942;958;6;3128
FR;4;2022-01-26;18;15;6;1;16;1078952;5957;964;7;3144
FR;4;2022-01-27;19;18;5;0;21;1078971;5975;969;7;3165
FR;4;2022-01-28;12;23;7;0;25;1078983;5998;976;7;3190
FR;4;2022-01-29;15;6;4;0;9;1078998;6004;980;7;3199
FR;4;2022-01-30;16;2;0;0;2;1079014;6006;980;7;3201
FR;4;2022-01-31;19;27;6;0;29;1079033;6033;986;7;3230
FR;4;2022-02-01;9;19;11;0;19;1079042;6052;997;7;3249
FR;4;2022-02-02;16;11;10;2;16;1079058;6063;1007;9;3265
FR;4;2022-02-03;12;21;9;0;24;1079070;6084;1016;9;3289
FR;4;2022-02-04;6;5;7;0;9;1079076;6089;1023;9;3298
FR;4;2022-02-05;6;14;1;0;13;1079082;6103;1024;9;3311
FR;4;2022-02-06;5;2;1;0;2;1079087;6105;1025;9;3313
FR;4;2022-02-07;12;19;6;0;19;1079099;6124;1031;9;3332
FR;4;2022-02-08;14;19;13;1;20;1079113;6143;1044;10;3352
FR;4;2022-02-09;14;10;7;0;13;1079127;6153;1051;10;3365
FR;4;2022-02-10;18;23;9;0;24;1079145;6176;1060;10;3389
FR;4;2022-02-11;17;14;8;0;19;1079162;6190;1068;10;3408
FR;4;2022-02-12;23;7;1;0;6;1079185;6197;1069;10;3414
FR;4;2022-02-13;7;3;3;0;6;1079192;6200;1072;10;3420
FR;4;2022-02-14;18;10;7;0;13;1079210;6210;1079;10;3433
FR;4;2022-02-15;16;7;1;0;7;1079226;6217;1080;10;3440
FR;4;2022-02-16;11;9;10;0;15;1079237;6226;1090;10;3455
FR;4;2022-02-17;10;4;4;0;6;1079247;6230;1094;10;3461
FR;4;2022-02-18;17;13;6;0;17;1079264;6243;1100;10;3478
FR;4;2022-02-19;16;2;2;0;4;1079280;6245;1102;10;3482
FR;4;2022-02-20;7;2;0;0;1;1079287;6247;1102;10;3483
FR;4;2022-02-21;22;3;2;0;3;1079309;6250;1104;10;3486
FR;4;2022-02-22;8;4;8;0;8;1079317;6254;1112;10;3494
FR;4;2022-02-23;16;6;8;0;8;1079333;6260;1120;10;3502
FR;4;2022-02-24;9;3;2;0;3;1079342;6263;1122;10;3505
FR;4;2022-02-25;15;5;7;0;6;1079357;6268;1129;10;3511
FR;4;2022-02-26;26;3;0;0;3;1079383;6271;1129;10;3514
FR;4;2022-02-27;9;0;1;0;1;1079392;6271;1130;10;3515
FR;4;2022-02-28;14;3;2;0;3;1079406;6274;1132;10;3518
FR;4;2022-03-01;6;2;7;0;3;1079412;6276;1139;10;3521
FR;4;2022-03-02;9;2;3;0;4;1079421;6278;1142;10;3525
FR;4;2022-03-03;14;5;1;0;4;1079435;6283;1143;10;3529
FR;4;2022-03-04;6;7;2;1;5;1079441;6290;1145;11;3534
FR;4;2022-03-05;8;2;0;0;2;1079449;6292;1145;11;3536
FR;4;2022-03-06;4;0;1;0;1;1079453;6292;1146;11;3537
FR;4;2022-03-07;10;4;1;0;3;1079463;6296;1147;11;3540
FR;4;2022-03-08;13;2;0;0;2;1079476;6298;1147;11;3542
FR;4;2022-03-09;7;3;2;0;4;1079483;6301;1149;11;3546
FR;4;2022-03-10;5;1;5;0;2;1079488;6302;1154;11;3548
FR;4;2022-03-11;7;2;5;0;1;1079495;6304;1159;11;3549
FR;4;2022-03-12;9;2;0;0;0;1079504;6306;1159;11;3549
FR;4;2022-03-13;5;0;1;0;1;1079509;6306;1160;11;3550
FR;4;2022-03-14;4;1;0;0;1;1079513;6307;1160;11;3551
FR;4;2022-03-15;5;3;1;0;1;1079518;6310;1161;11;3552
FR;4;2022-03-16;6;3;3;0;3;1079524;6313;1164;11;3555
FR;4;2022-03-17;1;4;1;0;5;1079525;6317;1165;11;3560
FR;4;2022-03-18;7;2;0;0;2;1079532;6319;1165;11;3562
FR;4;2022-03-19;1;1;0;0;1;1079533;6320;1165;11;3563
FR;4;2022-03-20;2;0;2;0;1;1079535;6320;1167;11;3564
FR;4;2022-03-21;5;3;0;0;3;1079540;6323;1167;11;3567
FR;4;2022-03-22;3;2;1;0;2;1079543;6325;1168;11;3569
FR;4;2022-03-23;6;3;3;0;5;1079549;6328;1171;11;3574
FR;4;2022-03-24;2;4;3;1;5;1079551;6332;1174;12;3579
FR;4;2022-03-25;3;1;2;0;1;1079554;6333;1176;12;3580
FR;4;2022-03-26;5;5;0;0;5;1079559;6338;1176;12;3585
FR;4;2022-03-27;1;0;1;0;0;1079560;6338;1177;12;3585
FR;4;2022-03-28;4;1;1;0;1;1079564;6339;1178;12;3586
FR;4;2022-03-29;7;0;4;1;0;1079571;6339;1182;13;3586
FR;4;2022-03-30;1;4;0;0;4;1079572;6343;1182;13;3590
FR;4;2022-03-31;1;3;1;1;3;1079573;6346;1183;14;3593
FR;4;2022-04-01;13;3;5;0;6;1079586;6349;1188;14;3599
FR;4;2022-04-02;4;4;0;0;3;1079590;6353;1188;14;3602
FR;4;2022-04-03;0;0;0;0;0;1079590;6353;1188;14;3602
FR;4;2022-04-04;3;3;4;0;3;1079593;6356;1192;14;3605
FR;4;2022-04-05;3;4;1;1;2;1079596;6360;1193;15;3607
FR;4;2022-04-06;3;0;0;0;0;1079599;6360;1193;15;3607
FR;4;2022-04-07;3;2;1;2;3;1079602;6362;1194;17;3610
FR;4;2022-04-08;4;1;1;0;1;1079606;6363;1195;17;3611
FR;4;2022-04-09;0;0;1;1;1;1079606;6363;1196;18;3612
FR;4;2022-04-10;1;2;0;0;2;1079607;6365;1196;18;3614
FR;4;2022-04-11;2;2;4;0;4;1079609;6367;1200;18;3618
FR;4;2022-04-12;2;1;3;0;2;1079611;6368;1203;18;3620
FR;4;2022-04-13;3;6;1;0;7;1079614;6374;1204;18;3627
FR;4;2022-04-14;3;2;0;1;2;1079617;6376;1204;19;3629
FR;4;2022-04-15;1;7;1;0;8;1079618;6383;1205;19;3637
FR;4;2022-04-16;0;0;0;0;0;1079618;6383;1205;19;3637
FR;4;2022-04-17;1;0;0;0;0;1079619;6383;1205;19;3637
FR;4;2022-04-18;1;2;4;0;2;1079620;6385;1209;19;3639
FR;4;2022-04-19;2;0;1;0;0;1079622;6385;1210;19;3639
FR;4;2022-04-20;13;4;1;0;2;1079635;6389;1211;19;3641
FR;4;2022-04-21;5;0;0;0;0;1079640;6389;1211;19;3641
FR;4;2022-04-22;1;0;1;0;0;1079641;6389;1212;19;3641
FR;4;2022-04-23;1;3;1;0;4;1079642;6392;1213;19;3645
FR;4;2022-04-24;0;2;0;0;2;1079642;6394;1213;19;3647
FR;4;2022-04-25;2;4;2;0;6;1079644;6398;1215;19;3653
FR;4;2022-04-26;2;4;1;0;4;1079646;6402;1216;19;3657
FR;4;2022-04-27;4;0;0;0;0;1079650;6402;1216;19;3657
FR;4;2022-04-28;2;3;5;0;4;1079652;6405;1221;19;3661
FR;4;2022-04-29;2;2;0;0;1;1079654;6407;1221;19;3662
FR;4;2022-04-30;0;1;1;0;2;1079654;6408;1222;19;3664
FR;4;2022-05-01;0;0;0;0;0;1079654;6408;1222;19;3664
FR;4;2022-05-02;4;5;2;0;5;1079658;6413;1224;19;3669
FR;4;2022-05-03;0;3;1;0;3;1079658;6416;1225;19;3672
FR;4;2022-05-04;3;2;1;0;2;1079661;6418;1226;19;3674
FR;4;2022-05-05;2;1;1;0;1;1079663;6419;1227;19;3675
FR;4;2022-05-06;2;0;0;0;0;1079665;6419;1227;19;3675
FR;4;2022-05-07;0;0;0;0;0;1079665;6419;1227;19;3675
FR;4;2022-05-08;1;1;0;0;1;1079666;6420;1227;19;3676
FR;4;2022-05-09;2;0;0;0;0;1079668;6420;1227;19;3676
FR;4;2022-05-10;0;2;0;2;4;1079668;6422;1227;21;3680
FR;4;2022-05-11;2;0;0;0;0;1079670;6422;1227;21;3680
FR;4;2022-05-12;5;1;0;1;1;1079675;6423;1227;22;3681
FR;4;2022-05-13;0;0;1;0;1;1079675;6423;1228;22;3682
FR;4;2022-05-14;0;1;0;0;1;1079675;6424;1228;22;3683
FR;4;2022-05-15;0;0;0;0;0;1079675;6424;1228;22;3683
FR;4;2022-05-16;3;0;0;0;0;1079678;6424;1228;22;3683
FR;4;2022-05-17;2;0;0;0;0;1079680;6424;1228;22;3683
FR;4;2022-05-18;0;0;0;0;0;1079680;6424;1228;22;3683
FR;4;2022-05-19;2;1;1;0;2;1079682;6425;1229;22;3685
FR;4;2022-05-20;1;0;0;0;0;1079683;6425;1229;22;3685
FR;4;2022-05-21;2;0;0;0;0;1079685;6425;1229;22;3685
FR;4;2022-05-22;0;0;1;0;1;1079685;6425;1230;22;3686
FR;5;2020-12-27;0;0;0;0;0;0;0;0;0;0
FR;5;2020-12-28;0;0;0;0;0;0;0;0;0;0
FR;5;2020-12-29;0;0;0;0;0;0;0;0;0;0
FR;5;2020-12-30;0;0;0;0;0;0;0;0;0;0
FR;5;2020-12-31;0;0;0;0;0;0;0;0;0;0
FR;5;2021-01-01;0;0;0;0;0;0;0;0;0;0
FR;5;2021-01-02;0;0;0;0;0;0;0;0;0;0
FR;5;2021-01-03;0;0;0;0;0;0;0;0;0;0
FR;5;2021-01-04;0;0;0;0;0;0;0;0;0;0
FR;5;2021-01-05;0;0;0;0;0;0;0;0;0;0
FR;5;2021-01-06;0;0;0;0;0;0;0;0;0;0
FR;5;2021-01-07;0;0;0;0;0;0;0;0;0;0
FR;5;2021-01-08;0;0;0;0;0;0;0;0;0;0
FR;5;2021-01-09;0;0;0;0;0;0;0;0;0;0
FR;5;2021-01-10;0;0;0;0;0;0;0;0;0;0
FR;5;2021-01-11;0;0;0;0;0;0;0;0;0;0
FR;5;2021-01-12;0;0;0;0;0;0;0;0;0;0
FR;5;2021-01-13;0;0;0;0;0;0;0;0;0;0
FR;5;2021-01-14;0;0;0;0;0;0;0;0;0;0
FR;5;2021-01-15;0;0;0;0;0;0;0;0;0;0
FR;5;2021-01-16;0;0;0;0;0;0;0;0;0;0
FR;5;2021-01-17;0;0;0;0;0;0;0;0;0;0
FR;5;2021-01-18;0;0;0;0;0;0;0;0;0;0
FR;5;2021-01-19;0;0;0;0;0;0;0;0;0;0
FR;5;2021-01-20;0;0;0;0;0;0;0;0;0;0
FR;5;2021-01-21;0;0;0;0;0;0;0;0;0;0
FR;5;2021-01-22;0;0;0;0;0;0;0;0;0;0
FR;5;2021-01-23;0;0;0;0;0;0;0;0;0;0
FR;5;2021-01-24;0;0;0;0;0;0;0;0;0;0
FR;5;2021-01-25;0;0;0;0;0;0;0;0;0;0
FR;5;2021-01-26;0;0;0;0;0;0;0;0;0;0
FR;5;2021-01-27;0;0;0;0;0;0;0;0;0;0
FR;5;2021-01-28;0;0;0;0;0;0;0;0;0;0
FR;5;2021-01-29;0;0;0;0;0;0;0;0;0;0
FR;5;2021-01-30;0;0;0;0;0;0;0;0;0;0
FR;5;2021-01-31;0;0;0;0;0;0;0;0;0;0
FR;5;2021-02-01;0;0;0;0;0;0;0;0;0;0
FR;5;2021-02-02;0;0;0;0;0;0;0;0;0;0
FR;5;2021-02-03;0;0;0;0;0;0;0;0;0;0
FR;5;2021-02-04;0;0;0;0;0;0;0;0;0;0
FR;5;2021-02-05;0;0;0;0;0;0;0;0;0;0
FR;5;2021-02-06;0;0;0;0;0;0;0;0;0;0
FR;5;2021-02-07;0;0;0;0;0;0;0;0;0;0
FR;5;2021-02-08;0;0;0;0;0;0;0;0;0;0
FR;5;2021-02-09;0;0;0;0;0;0;0;0;0;0
FR;5;2021-02-10;0;0;0;0;0;0;0;0;0;0
FR;5;2021-02-11;0;0;0;0;0;0;0;0;0;0
FR;5;2021-02-12;0;0;0;0;0;0;0;0;0;0
FR;5;2021-02-13;0;0;0;0;0;0;0;0;0;0
FR;5;2021-02-14;0;0;0;0;0;0;0;0;0;0
FR;5;2021-02-15;0;0;0;0;0;0;0;0;0;0
FR;5;2021-02-16;0;0;0;0;0;0;0;0;0;0
FR;5;2021-02-17;0;0;0;0;0;0;0;0;0;0
FR;5;2021-02-18;0;0;0;0;0;0;0;0;0;0
FR;5;2021-02-19;0;0;0;0;0;0;0;0;0;0
FR;5;2021-02-20;0;0;0;0;0;0;0;0;0;0
FR;5;2021-02-21;0;0;0;0;0;0;0;0;0;0
FR;5;2021-02-22;0;0;0;0;0;0;0;0;0;0
FR;5;2021-02-23;0;0;0;0;0;0;0;0;0;0
FR;5;2021-02-24;0;0;0;0;0;0;0;0;0;0
FR;5;2021-02-25;0;0;0;0;0;0;0;0;0;0
FR;5;2021-02-26;0;0;0;0;0;0;0;0;0;0
FR;5;2021-02-27;0;0;0;0;0;0;0;0;0;0
FR;5;2021-02-28;0;0;0;0;0;0;0;0;0;0
FR;5;2021-03-01;0;0;0;0;0;0;0;0;0;0
FR;5;2021-03-02;0;0;0;0;0;0;0;0;0;0
FR;5;2021-03-03;0;0;0;0;0;0;0;0;0;0
FR;5;2021-03-04;0;0;0;0;0;0;0;0;0;0
FR;5;2021-03-05;0;0;0;0;0;0;0;0;0;0
FR;5;2021-03-06;0;0;0;0;0;0;0;0;0;0
FR;5;2021-03-07;0;0;0;0;0;0;0;0;0;0
FR;5;2021-03-08;0;0;0;0;0;0;0;0;0;0
FR;5;2021-03-09;0;0;0;0;0;0;0;0;0;0
FR;5;2021-03-10;0;0;0;0;0;0;0;0;0;0
FR;5;2021-03-11;0;0;0;0;0;0;0;0;0;0
FR;5;2021-03-12;0;0;0;0;0;0;0;0;0;0
FR;5;2021-03-13;0;0;0;0;0;0;0;0;0;0
FR;5;2021-03-14;0;0;0;0;0;0;0;0;0;0
FR;5;2021-03-15;0;0;0;0;0;0;0;0;0;0
FR;5;2021-03-16;0;0;0;0;0;0;0;0;0;0
FR;5;2021-03-17;0;0;0;0;0;0;0;0;0;0
FR;5;2021-03-18;0;0;0;0;0;0;0;0;0;0
FR;5;2021-03-19;0;0;0;0;0;0;0;0;0;0
FR;5;2021-03-20;0;0;0;0;0;0;0;0;0;0
FR;5;2021-03-21;0;0;0;0;0;0;0;0;0;0
FR;5;2021-03-22;0;0;0;0;0;0;0;0;0;0
FR;5;2021-03-23;0;0;0;0;0;0;0;0;0;0
FR;5;2021-03-24;0;0;0;0;0;0;0;0;0;0
FR;5;2021-03-25;0;0;0;0;0;0;0;0;0;0
FR;5;2021-03-26;0;0;0;0;0;0;0;0;0;0
FR;5;2021-03-27;0;0;0;0;0;0;0;0;0;0
FR;5;2021-03-28;0;0;0;0;0;0;0;0;0;0
FR;5;2021-03-29;0;0;0;0;0;0;0;0;0;0
FR;5;2021-03-30;0;0;0;0;0;0;0;0;0;0
FR;5;2021-03-31;0;0;0;0;0;0;0;0;0;0
FR;5;2021-04-01;0;0;0;0;0;0;0;0;0;0
FR;5;2021-04-02;0;0;0;0;0;0;0;0;0;0
FR;5;2021-04-03;0;0;0;0;0;0;0;0;0;0
FR;5;2021-04-04;0;0;0;0;0;0;0;0;0;0
FR;5;2021-04-05;0;0;0;0;0;0;0;0;0;0
FR;5;2021-04-06;0;0;0;0;0;0;0;0;0;0
FR;5;2021-04-07;0;0;0;0;0;0;0;0;0;0
FR;5;2021-04-08;0;0;0;0;0;0;0;0;0;0
FR;5;2021-04-09;0;0;0;0;0;0;0;0;0;0
FR;5;2021-04-10;0;0;0;0;0;0;0;0;0;0
FR;5;2021-04-11;0;0;0;0;0;0;0;0;0;0
FR;5;2021-04-12;0;0;0;0;0;0;0;0;0;0
FR;5;2021-04-13;0;0;0;0;0;0;0;0;0;0
FR;5;2021-04-14;0;0;0;0;0;0;0;0;0;0
FR;5;2021-04-15;0;0;0;0;0;0;0;0;0;0
FR;5;2021-04-16;0;0;0;0;0;0;0;0;0;0
FR;5;2021-04-17;0;0;0;0;0;0;0;0;0;0
FR;5;2021-04-18;0;0;0;0;0;0;0;0;0;0
FR;5;2021-04-19;0;0;0;0;0;0;0;0;0;0
FR;5;2021-04-20;0;0;0;0;0;0;0;0;0;0
FR;5;2021-04-21;0;0;0;0;0;0;0;0;0;0
FR;5;2021-04-22;0;0;0;0;0;0;0;0;0;0
FR;5;2021-04-23;0;0;0;0;0;0;0;0;0;0
FR;5;2021-04-24;0;0;0;0;0;0;0;0;0;0
FR;5;2021-04-25;0;0;0;0;0;0;0;0;0;0
FR;5;2021-04-26;0;0;0;0;0;0;0;0;0;0
FR;5;2021-04-27;0;0;0;0;0;0;0;0;0;0
FR;5;2021-04-28;0;0;0;0;0;0;0;0;0;0
FR;5;2021-04-29;0;0;0;0;0;0;0;0;0;0
FR;5;2021-04-30;0;0;0;0;0;0;0;0;0;0
FR;5;2021-05-01;0;0;0;0;0;0;0;0;0;0
FR;5;2021-05-02;0;0;0;0;0;0;0;0;0;0
FR;5;2021-05-03;0;0;0;0;0;0;0;0;0;0
FR;5;2021-05-04;0;0;0;0;0;0;0;0;0;0
FR;5;2021-05-05;0;0;0;0;0;0;0;0;0;0
FR;5;2021-05-06;0;0;0;0;0;0;0;0;0;0
FR;5;2021-05-07;0;0;0;0;0;0;0;0;0;0
FR;5;2021-05-08;0;0;0;0;0;0;0;0;0;0
FR;5;2021-05-09;0;0;0;0;0;0;0;0;0;0
FR;5;2021-05-10;0;0;0;0;0;0;0;0;0;0
FR;5;2021-05-11;0;0;0;0;0;0;0;0;0;0
FR;5;2021-05-12;0;0;0;0;0;0;0;0;0;0
FR;5;2021-05-13;0;0;0;0;0;0;0;0;0;0
FR;5;2021-05-14;0;0;0;0;0;0;0;0;0;0
FR;5;2021-05-15;0;0;0;0;0;0;0;0;0;0
FR;5;2021-05-16;0;0;0;0;0;0;0;0;0;0
FR;5;2021-05-17;0;0;0;0;0;0;0;0;0;0
FR;5;2021-05-18;0;0;0;0;0;0;0;0;0;0
FR;5;2021-05-19;0;0;0;0;0;0;0;0;0;0
FR;5;2021-05-20;0;0;0;0;0;0;0;0;0;0
FR;5;2021-05-21;0;0;0;0;0;0;0;0;0;0
FR;5;2021-05-22;0;0;0;0;0;0;0;0;0;0
FR;5;2021-05-23;0;0;0;0;0;0;0;0;0;0
FR;5;2021-05-24;0;0;0;0;0;0;0;0;0;0
FR;5;2021-05-25;0;0;0;0;0;0;0;0;0;0
FR;5;2021-05-26;0;0;0;0;0;0;0;0;0;0
FR;5;2021-05-27;0;0;0;0;0;0;0;0;0;0
FR;5;2021-05-28;0;0;0;0;0;0;0;0;0;0
FR;5;2021-05-29;0;0;0;0;0;0;0;0;0;0
FR;5;2021-05-30;0;0;0;0;0;0;0;0;0;0
FR;5;2021-05-31;0;0;0;0;0;0;0;0;0;0
FR;5;2021-06-01;0;0;0;0;0;0;0;0;0;0
FR;5;2021-06-02;0;0;0;0;0;0;0;0;0;0
FR;5;2021-06-03;0;0;0;0;0;0;0;0;0;0
FR;5;2021-06-04;0;0;0;0;0;0;0;0;0;0
FR;5;2021-06-05;0;0;0;0;0;0;0;0;0;0
FR;5;2021-06-06;0;0;0;0;0;0;0;0;0;0
FR;5;2021-06-07;0;0;0;0;0;0;0;0;0;0
FR;5;2021-06-08;0;0;0;0;0;0;0;0;0;0
FR;5;2021-06-09;0;0;0;0;0;0;0;0;0;0
FR;5;2021-06-10;0;0;0;0;0;0;0;0;0;0
FR;5;2021-06-11;0;0;0;0;0;0;0;0;0;0
FR;5;2021-06-12;0;0;0;0;0;0;0;0;0;0
FR;5;2021-06-13;0;0;0;0;0;0;0;0;0;0
FR;5;2021-06-14;0;0;0;0;0;0;0;0;0;0
FR;5;2021-06-15;0;0;0;0;0;0;0;0;0;0
FR;5;2021-06-16;0;0;0;0;0;0;0;0;0;0
FR;5;2021-06-17;0;0;0;0;0;0;0;0;0;0
FR;5;2021-06-18;0;0;0;0;0;0;0;0;0;0
FR;5;2021-06-19;0;0;0;0;0;0;0;0;0;0
FR;5;2021-06-20;0;0;0;0;0;0;0;0;0;0
FR;5;2021-06-21;0;0;0;0;0;0;0;0;0;0
FR;5;2021-06-22;0;0;0;0;0;0;0;0;0;0
FR;5;2021-06-23;0;0;0;0;0;0;0;0;0;0
FR;5;2021-06-24;0;0;0;0;0;0;0;0;0;0
FR;5;2021-06-25;0;0;0;0;0;0;0;0;0;0
FR;5;2021-06-26;0;0;0;0;0;0;0;0;0;0
FR;5;2021-06-27;0;0;0;0;0;0;0;0;0;0
FR;5;2021-06-28;0;0;0;0;0;0;0;0;0;0
FR;5;2021-06-29;0;0;0;0;0;0;0;0;0;0
FR;5;2021-06-30;0;0;0;0;0;0;0;0;0;0
FR;5;2021-07-01;0;0;0;0;0;0;0;0;0;0
FR;5;2021-07-02;0;0;0;0;0;0;0;0;0;0
FR;5;2021-07-03;0;0;0;0;0;0;0;0;0;0
FR;5;2021-07-04;0;0;0;0;0;0;0;0;0;0
FR;5;2021-07-05;0;0;0;0;0;0;0;0;0;0
FR;5;2021-07-06;0;0;0;0;0;0;0;0;0;0
FR;5;2021-07-07;0;0;0;0;0;0;0;0;0;0
FR;5;2021-07-08;0;0;0;0;0;0;0;0;0;0
FR;5;2021-07-09;0;0;0;0;0;0;0;0;0;0
FR;5;2021-07-10;0;0;0;0;0;0;0;0;0;0
FR;5;2021-07-11;0;0;0;0;0;0;0;0;0;0
FR;5;2021-07-12;0;0;0;0;0;0;0;0;0;0
FR;5;2021-07-13;0;0;0;0;0;0;0;0;0;0
FR;5;2021-07-14;0;0;0;0;0;0;0;0;0;0
FR;5;2021-07-15;0;0;0;0;0;0;0;0;0;0
FR;5;2021-07-16;0;0;0;0;0;0;0;0;0;0
FR;5;2021-07-17;0;0;0;0;0;0;0;0;0;0
FR;5;2021-07-18;0;0;0;0;0;0;0;0;0;0
FR;5;2021-07-19;0;0;0;0;0;0;0;0;0;0
FR;5;2021-07-20;0;0;0;0;0;0;0;0;0;0
FR;5;2021-07-21;0;0;0;0;0;0;0;0;0;0
FR;5;2021-07-22;0;0;0;0;0;0;0;0;0;0
FR;5;2021-07-23;0;0;0;0;0;0;0;0;0;0
FR;5;2021-07-24;0;0;0;0;0;0;0;0;0;0
FR;5;2021-07-25;0;0;0;0;0;0;0;0;0;0
FR;5;2021-07-26;0;0;0;0;0;0;0;0;0;0
FR;5;2021-07-27;0;0;0;0;0;0;0;0;0;0
FR;5;2021-07-28;0;0;0;0;0;0;0;0;0;0
FR;5;2021-07-29;0;0;0;0;0;0;0;0;0;0
FR;5;2021-07-30;0;0;0;0;0;0;0;0;0;0
FR;5;2021-07-31;0;0;0;0;0;0;0;0;0;0
FR;5;2021-08-01;0;0;0;0;0;0;0;0;0;0
FR;5;2021-08-02;0;0;0;0;0;0;0;0;0;0
FR;5;2021-08-03;0;0;0;0;0;0;0;0;0;0
FR;5;2021-08-04;0;0;0;0;0;0;0;0;0;0
FR;5;2021-08-05;0;0;0;0;0;0;0;0;0;0
FR;5;2021-08-06;0;0;0;0;0;0;0;0;0;0
FR;5;2021-08-07;0;0;0;0;0;0;0;0;0;0
FR;5;2021-08-08;0;0;0;0;0;0;0;0;0;0
FR;5;2021-08-09;0;0;0;0;0;0;0;0;0;0
FR;5;2021-08-10;0;0;0;0;0;0;0;0;0;0
FR;5;2021-08-11;0;0;0;0;0;0;0;0;0;0
FR;5;2021-08-12;0;0;0;0;0;0;0;0;0;0
FR;5;2021-08-13;0;0;0;0;0;0;0;0;0;0
FR;5;2021-08-14;0;0;0;0;0;0;0;0;0;0
FR;5;2021-08-15;0;0;0;0;0;0;0;0;0;0
FR;5;2021-08-16;0;0;0;0;0;0;0;0;0;0
FR;5;2021-08-17;0;0;0;0;0;0;0;0;0;0
FR;5;2021-08-18;0;0;0;0;0;0;0;0;0;0
FR;5;2021-08-19;0;0;0;0;0;0;0;0;0;0
FR;5;2021-08-20;0;0;0;0;0;0;0;0;0;0
FR;5;2021-08-21;0;0;0;0;0;0;0;0;0;0
FR;5;2021-08-22;0;0;0;0;0;0;0;0;0;0
FR;5;2021-08-23;0;0;0;0;0;0;0;0;0;0
FR;5;2021-08-24;0;0;0;0;0;0;0;0;0;0
FR;5;2021-08-25;0;0;0;0;0;0;0;0;0;0
FR;5;2021-08-26;0;0;0;0;0;0;0;0;0;0
FR;5;2021-08-27;0;0;0;0;0;0;0;0;0;0
FR;5;2021-08-28;0;0;0;0;0;0;0;0;0;0
FR;5;2021-08-29;0;0;0;0;0;0;0;0;0;0
FR;5;2021-08-30;0;0;0;0;0;0;0;0;0;0
FR;5;2021-08-31;0;0;0;0;0;0;0;0;0;0
FR;5;2021-09-01;0;0;0;0;0;0;0;0;0;0
FR;5;2021-09-02;0;0;0;0;0;0;0;0;0;0
FR;5;2021-09-03;0;0;0;0;0;0;0;0;0;0
FR;5;2021-09-04;0;0;0;0;0;0;0;0;0;0
FR;5;2021-09-05;0;0;0;0;0;0;0;0;0;0
FR;5;2021-09-06;0;0;0;0;0;0;0;0;0;0
FR;5;2021-09-07;0;0;0;0;0;0;0;0;0;0
FR;5;2021-09-08;0;0;0;0;0;0;0;0;0;0
FR;5;2021-09-09;0;0;0;0;0;0;0;0;0;0
FR;5;2021-09-10;0;0;0;0;0;0;0;0;0;0
FR;5;2021-09-11;0;0;0;0;0;0;0;0;0;0
FR;5;2021-09-12;0;0;0;0;0;0;0;0;0;0
FR;5;2021-09-13;0;0;0;0;0;0;0;0;0;0
FR;5;2021-09-14;0;0;0;0;0;0;0;0;0;0
FR;5;2021-09-15;0;0;0;0;0;0;0;0;0;0
FR;5;2021-09-16;0;0;0;0;0;0;0;0;0;0
FR;5;2021-09-17;0;0;0;0;0;0;0;0;0;0
FR;5;2021-09-18;0;0;0;0;0;0;0;0;0;0
FR;5;2021-09-19;0;0;0;0;0;0;0;0;0;0
FR;5;2021-09-20;0;0;0;0;0;0;0;0;0;0
FR;5;2021-09-21;0;0;0;0;0;0;0;0;0;0
FR;5;2021-09-22;0;0;0;0;0;0;0;0;0;0
FR;5;2021-09-23;0;0;0;0;0;0;0;0;0;0
FR;5;2021-09-24;0;0;0;0;0;0;0;0;0;0
FR;5;2021-09-25;0;0;0;0;0;0;0;0;0;0
FR;5;2021-09-26;0;0;0;0;0;0;0;0;0;0
FR;5;2021-09-27;0;0;0;0;0;0;0;0;0;0
FR;5;2021-09-28;0;0;0;0;0;0;0;0;0;0
FR;5;2021-09-29;0;0;0;0;0;0;0;0;0;0
FR;5;2021-09-30;0;0;0;0;0;0;0;0;0;0
FR;5;2021-10-01;0;0;0;0;0;0;0;0;0;0
FR;5;2021-10-02;0;0;0;0;0;0;0;0;0;0
FR;5;2021-10-03;0;0;0;0;0;0;0;0;0;0
FR;5;2021-10-04;0;0;0;0;0;0;0;0;0;0
FR;5;2021-10-05;0;0;0;0;0;0;0;0;0;0
FR;5;2021-10-06;0;0;0;0;0;0;0;0;0;0
FR;5;2021-10-07;0;0;0;0;0;0;0;0;0;0
FR;5;2021-10-08;0;0;0;0;0;0;0;0;0;0
FR;5;2021-10-09;0;0;0;0;0;0;0;0;0;0
FR;5;2021-10-10;0;0;0;0;0;0;0;0;0;0
FR;5;2021-10-11;0;0;0;0;0;0;0;0;0;0
FR;5;2021-10-12;0;0;0;0;0;0;0;0;0;0
FR;5;2021-10-13;0;0;0;0;0;0;0;0;0;0
FR;5;2021-10-14;0;0;0;0;0;0;0;0;0;0
FR;5;2021-10-15;0;0;0;0;0;0;0;0;0;0
FR;5;2021-10-16;0;0;0;0;0;0;0;0;0;0
FR;5;2021-10-17;0;0;0;0;0;0;0;0;0;0
FR;5;2021-10-18;0;0;0;0;0;0;0;0;0;0
FR;5;2021-10-19;0;0;0;0;0;0;0;0;0;0
FR;5;2021-10-20;0;0;0;0;0;0;0;0;0;0
FR;5;2021-10-21;0;0;0;0;0;0;0;0;0;0
FR;5;2021-10-22;0;0;0;0;0;0;0;0;0;0
FR;5;2021-10-23;0;0;0;0;0;0;0;0;0;0
FR;5;2021-10-24;0;0;0;0;0;0;0;0;0;0
FR;5;2021-10-25;0;0;0;0;0;0;0;0;0;0
FR;5;2021-10-26;0;0;0;0;0;0;0;0;0;0
FR;5;2021-10-27;0;0;0;0;0;0;0;0;0;0
FR;5;2021-10-28;0;0;0;0;0;0;0;0;0;0
FR;5;2021-10-29;0;0;0;0;0;0;0;0;0;0
FR;5;2021-10-30;0;0;0;0;0;0;0;0;0;0
FR;5;2021-10-31;0;0;0;0;0;0;0;0;0;0
FR;5;2021-11-01;0;0;0;0;0;0;0;0;0;0
FR;5;2021-11-02;0;0;0;0;0;0;0;0;0;0
FR;5;2021-11-03;0;0;0;0;0;0;0;0;0;0
FR;5;2021-11-04;0;0;0;0;0;0;0;0;0;0
FR;5;2021-11-05;0;0;0;0;0;0;0;0;0;0
FR;5;2021-11-06;0;0;0;0;0;0;0;0;0;0
FR;5;2021-11-07;0;0;0;0;0;0;0;0;0;0
FR;5;2021-11-08;0;0;0;0;0;0;0;0;0;0
FR;5;2021-11-09;0;0;0;0;0;0;0;0;0;0
FR;5;2021-11-10;0;0;0;0;0;0;0;0;0;0
FR;5;2021-11-11;0;0;0;0;0;0;0;0;0;0
FR;5;2021-11-12;0;0;0;0;0;0;0;0;0;0
FR;5;2021-11-13;0;0;0;0;0;0;0;0;0;0
FR;5;2021-11-14;0;0;0;0;0;0;0;0;0;0
FR;5;2021-11-15;0;0;0;0;0;0;0;0;0;0
FR;5;2021-11-16;0;0;0;0;0;0;0;0;0;0
FR;5;2021-11-17;0;0;0;0;0;0;0;0;0;0
FR;5;2021-11-18;0;0;0;0;0;0;0;0;0;0
FR;5;2021-11-19;0;0;0;0;0;0;0;0;0;0
FR;5;2021-11-20;0;0;0;0;0;0;0;0;0;0
FR;5;2021-11-21;0;0;0;0;0;0;0;0;0;0
FR;5;2021-11-22;0;0;0;0;0;0;0;0;0;0
FR;5;2021-11-23;0;0;0;0;0;0;0;0;0;0
FR;5;2021-11-24;0;0;0;0;0;0;0;0;0;0
FR;5;2021-11-25;0;0;0;0;0;0;0;0;0;0
FR;5;2021-11-26;0;0;0;0;0;0;0;0;0;0
FR;5;2021-11-27;0;0;0;0;0;0;0;0;0;0
FR;5;2021-11-28;0;0;0;0;0;0;0;0;0;0
FR;5;2021-11-29;0;0;0;0;0;0;0;0;0;0
FR;5;2021-11-30;0;0;0;0;0;0;0;0;0;0
FR;5;2021-12-01;0;0;0;0;0;0;0;0;0;0
FR;5;2021-12-02;0;0;0;0;0;0;0;0;0;0
FR;5;2021-12-03;0;0;0;0;0;0;0;0;0;0
FR;5;2021-12-04;0;0;0;0;0;0;0;0;0;0
FR;5;2021-12-05;0;0;0;0;0;0;0;0;0;0
FR;5;2021-12-06;0;0;0;0;0;0;0;0;0;0
FR;5;2021-12-07;0;0;0;0;0;0;0;0;0;0
FR;5;2021-12-08;0;0;0;0;0;0;0;0;0;0
FR;5;2021-12-09;0;0;0;0;0;0;0;0;0;0
FR;5;2021-12-10;0;0;0;0;0;0;0;0;0;0
FR;5;2021-12-11;0;0;0;0;0;0;0;0;0;0
FR;5;2021-12-12;0;0;0;0;0;0;0;0;0;0
FR;5;2021-12-13;0;0;0;0;0;0;0;0;0;0
FR;5;2021-12-14;29;45;77;0;88;29;45;77;0;88
FR;5;2021-12-15;196;44;37;0;49;225;89;114;0;137
FR;5;2021-12-16;180;21;44;0;48;405;110;158;0;185
FR;5;2021-12-17;310;16;72;0;74;715;126;230;0;259
FR;5;2021-12-18;764;24;22;0;29;1479;150;252;0;288
FR;5;2021-12-19;586;15;15;0;17;2065;165;267;0;305
FR;5;2021-12-20;1223;31;35;0;38;3288;196;302;0;343
FR;5;2021-12-21;1535;22;54;1;60;4823;218;356;1;403
FR;5;2021-12-22;4069;40;37;0;46;8892;258;393;1;449
FR;5;2021-12-23;3042;16;21;0;25;11934;274;414;1;474
FR;5;2021-12-24;759;18;9;0;15;12693;292;423;1;489
FR;5;2021-12-25;61;5;1;0;2;12754;297;424;1;491
FR;5;2021-12-26;623;6;3;0;4;13377;303;427;1;495
FR;5;2021-12-27;4080;25;21;0;23;17457;328;448;1;518
FR;5;2021-12-28;5202;23;41;1;43;22659;351;489;2;561
FR;5;2021-12-29;8104;34;65;2;68;30763;385;554;4;629
FR;5;2021-12-30;5172;18;33;0;39;35935;403;587;4;668
FR;5;2021-12-31;1553;8;10;0;11;37488;411;597;4;679
FR;5;2022-01-01;185;2;2;0;3;37673;413;599;4;682
FR;5;2022-01-02;1489;1;1;0;1;39162;414;600;4;683
FR;5;2022-01-03;3058;36;33;0;32;42220;450;633;4;715
FR;5;2022-01-04;3034;39;33;0;42;45254;489;666;4;757
FR;5;2022-01-05;19323;203;97;1;108;64577;692;763;5;865
FR;5;2022-01-06;3742;133;122;0;142;68319;825;885;5;1007
FR;5;2022-01-07;5007;200;48;2;56;73326;1025;933;7;1063
FR;5;2022-01-08;13654;514;45;0;52;86980;1539;978;7;1115
FR;5;2022-01-09;5755;399;15;0;20;92735;1938;993;7;1135
FR;5;2022-01-10;3453;326;25;0;29;96188;2264;1018;7;1164
FR;5;2022-01-11;3668;284;38;0;41;99856;2548;1056;7;1205
FR;5;2022-01-12;22652;3003;90;0;113;122508;5551;1146;7;1318
FR;5;2022-01-13;4035;622;30;0;32;126543;6173;1176;7;1350
FR;5;2022-01-14;4843;581;44;0;51;131386;6754;1220;7;1401
FR;5;2022-01-15;14681;1746;38;3;49;146067;8500;1258;10;1450
FR;5;2022-01-16;4727;666;3;0;5;150794;9166;1261;10;1455
FR;5;2022-01-17;2293;715;26;0;29;153087;9881;1287;10;1484
FR;5;2022-01-18;2430;870;30;0;40;155517;10751;1317;10;1524
FR;5;2022-01-19;18481;6422;74;2;142;173998;17173;1391;12;1666
FR;5;2022-01-20;1920;1067;25;0;34;175918;18240;1416;12;1700
FR;5;2022-01-21;3076;1371;47;1;59;178994;19611;1463;13;1759
FR;5;2022-01-22;10722;3454;33;1;43;189716;23065;1496;14;1802
FR;5;2022-01-23;2629;1415;5;0;9;192345;24480;1501;14;1811
FR;5;2022-01-24;1159;1340;19;0;23;193504;25820;1520;14;1834
FR;5;2022-01-25;1219;1548;19;2;29;194723;27368;1539;16;1863
FR;5;2022-01-26;10751;12024;50;1;89;205474;39392;1589;17;1952
FR;5;2022-01-27;1291;1693;10;0;17;206765;41085;1599;17;1969
FR;5;2022-01-28;1695;3347;16;0;19;208460;44432;1615;17;1988
FR;5;2022-01-29;6237;8040;68;0;96;214697;52472;1683;17;2084
FR;5;2022-01-30;1509;2950;5;0;18;216206;55422;1688;17;2102
FR;5;2022-01-31;588;1773;23;0;24;216794;57195;1711;17;2126
FR;5;2022-02-01;712;1702;10;0;15;217506;58897;1721;17;2141
FR;5;2022-02-02;6957;15654;52;0;94;224463;74551;1773;17;2235
FR;5;2022-02-03;488;1690;14;0;13;224951;76241;1787;17;2248
FR;5;2022-02-04;943;3001;19;0;31;225894;79242;1806;17;2279
FR;5;2022-02-05;3532;8916;23;0;37;229426;88158;1829;17;2316
FR;5;2022-02-06;737;2397;10;0;19;230163;90555;1839;17;2335
FR;5;2022-02-07;883;1595;22;0;24;231046;92150;1861;17;2359
FR;5;2022-02-08;722;1285;18;0;20;231768;93435;1879;17;2379
FR;5;2022-02-09;4535;12876;44;0;76;236303;106311;1923;17;2455
FR;5;2022-02-10;646;1058;14;0;15;236949;107369;1937;17;2470
FR;5;2022-02-11;793;2026;16;0;21;237742;109395;1953;17;2491
FR;5;2022-02-12;2285;6811;33;0;53;240027;116206;1986;17;2544
FR;5;2022-02-13;465;1540;8;0;8;240492;117746;1994;17;2552
FR;5;2022-02-14;678;1288;10;0;13;241170;119034;2004;17;2565
FR;5;2022-02-15;482;885;9;0;14;241652;119919;2013;17;2579
FR;5;2022-02-16;2980;9123;41;1;58;244632;129042;2054;18;2637
FR;5;2022-02-17;435;805;6;0;7;245067;129847;2060;18;2644
FR;5;2022-02-18;650;1407;13;0;17;245717;131254;2073;18;2661
FR;5;2022-02-19;1371;4314;16;0;28;247088;135568;2089;18;2689
FR;5;2022-02-20;247;879;6;0;8;247335;136447;2095;18;2697
FR;5;2022-02-21;221;607;2;0;4;247556;137054;2097;18;2701
FR;5;2022-02-22;259;545;17;0;17;247815;137599;2114;18;2718
FR;5;2022-02-23;1907;6923;22;1;42;249722;144522;2136;19;2760
FR;5;2022-02-24;182;374;5;1;6;249904;144896;2141;20;2766
FR;5;2022-02-25;336;949;13;0;12;250240;145845;2154;20;2778
FR;5;2022-02-26;972;3069;10;0;14;251212;148914;2164;20;2792
FR;5;2022-02-27;147;506;0;0;3;251359;149420;2164;20;2795
FR;5;2022-02-28;161;369;1;0;1;251520;149789;2165;20;2796
FR;5;2022-03-01;128;279;6;0;7;251648;150068;2171;20;2803
FR;5;2022-03-02;1240;4150;28;3;40;252888;154218;2199;23;2843
FR;5;2022-03-03;121;250;6;0;9;253009;154468;2205;23;2852
FR;5;2022-03-04;193;488;13;0;14;253202;154956;2218;23;2866
FR;5;2022-03-05;676;1990;8;0;16;253878;156946;2226;23;2882
FR;5;2022-03-06;108;260;0;0;0;253986;157206;2226;23;2882
FR;5;2022-03-07;71;228;5;0;3;254057;157434;2231;23;2885
FR;5;2022-03-08;46;130;7;1;7;254103;157564;2238;24;2892
FR;5;2022-03-09;909;3076;24;0;36;255012;160640;2262;24;2928
FR;5;2022-03-10;82;200;8;0;11;255094;160840;2270;24;2939
FR;5;2022-03-11;147;369;13;1;15;255241;161209;2283;25;2954
FR;5;2022-03-12;758;1613;13;1;30;255999;162822;2296;26;2984
FR;5;2022-03-13;76;100;0;0;0;256075;162922;2296;26;2984
FR;5;2022-03-14;67;118;7;1;7;256142;163040;2303;27;2991
FR;5;2022-03-15;83;99;3;0;6;256225;163139;2306;27;2997
FR;5;2022-03-16;884;1822;15;3;34;257109;164961;2321;30;3031
FR;5;2022-03-17;66;123;8;4;10;257175;165084;2329;34;3041
FR;5;2022-03-18;172;318;13;4;18;257347;165402;2342;38;3059
FR;5;2022-03-19;749;1162;12;5;33;258096;166564;2354;43;3092
FR;5;2022-03-20;45;93;1;0;1;258141;166657;2355;43;3093
FR;5;2022-03-21;71;120;10;6;15;258212;166777;2365;49;3108
FR;5;2022-03-22;56;119;8;8;9;258268;166896;2373;57;3117
FR;5;2022-03-23;803;1461;14;8;36;259071;168357;2387;65;3153
FR;5;2022-03-24;68;93;8;7;7;259139;168450;2395;72;3160
FR;5;2022-03-25;222;290;14;8;18;259361;168740;2409;80;3178
FR;5;2022-03-26;706;853;12;5;26;260067;169593;2421;85;3204
FR;5;2022-03-27;74;78;0;0;3;260141;169671;2421;85;3207
FR;5;2022-03-28;81;91;1;2;3;260222;169762;2422;87;3210
FR;5;2022-03-29;71;82;10;4;12;260293;169844;2432;91;3222
FR;5;2022-03-30;820;1115;16;13;29;261113;170959;2448;104;3251
FR;5;2022-03-31;102;124;1;4;6;261215;171083;2449;108;3257
FR;5;2022-04-01;107;86;7;12;11;261322;171169;2456;120;3268
FR;5;2022-04-02;329;348;3;3;14;261651;171517;2459;123;3282
FR;5;2022-04-03;54;59;1;0;1;261705;171576;2460;123;3283
FR;5;2022-04-04;36;57;4;1;8;261741;171633;2464;124;3291
FR;5;2022-04-05;51;60;6;7;9;261792;171693;2470;131;3300
FR;5;2022-04-06;421;439;7;15;16;262213;172132;2477;146;3316
FR;5;2022-04-07;45;68;5;7;7;262258;172200;2482;153;3323
FR;5;2022-04-08;130;110;12;14;15;262388;172310;2494;167;3338
FR;5;2022-04-09;309;321;2;5;16;262697;172631;2496;172;3354
FR;5;2022-04-10;43;31;2;0;2;262740;172662;2498;172;3356
FR;5;2022-04-11;50;60;3;2;4;262790;172722;2501;174;3360
FR;5;2022-04-12;57;54;3;3;5;262847;172776;2504;177;3365
FR;5;2022-04-13;382;413;3;8;16;263229;173189;2507;185;3381
FR;5;2022-04-14;47;48;5;5;9;263276;173237;2512;190;3390
FR;5;2022-04-15;91;109;3;5;5;263367;173346;2515;195;3395
FR;5;2022-04-16;188;183;2;1;13;263555;173529;2517;196;3408
FR;5;2022-04-17;12;10;1;0;1;263567;173539;2518;196;3409
FR;5;2022-04-18;8;9;2;0;2;263575;173548;2520;196;3411
FR;5;2022-04-19;73;70;6;1;6;263648;173618;2526;197;3417
FR;5;2022-04-20;360;349;9;6;12;264008;173967;2535;203;3429
FR;5;2022-04-21;42;64;9;10;12;264050;174031;2544;213;3441
FR;5;2022-04-22;113;96;5;4;5;264163;174127;2549;217;3446
FR;5;2022-04-23;209;192;3;2;10;264372;174319;2552;219;3456
FR;5;2022-04-24;37;35;0;0;3;264409;174354;2552;219;3459
FR;5;2022-04-25;67;65;1;1;4;264476;174419;2553;220;3463
FR;5;2022-04-26;60;61;2;1;5;264536;174480;2555;221;3468
FR;5;2022-04-27;332;316;2;7;14;264868;174796;2557;228;3482
FR;5;2022-04-28;75;54;4;5;8;264943;174850;2561;233;3490
FR;5;2022-04-29;117;79;5;18;12;265060;174929;2566;251;3502
FR;5;2022-04-30;182;115;1;3;10;265242;175044;2567;254;3512
FR;5;2022-05-01;10;7;0;0;0;265252;175051;2567;254;3512
FR;5;2022-05-02;46;27;4;5;2;265298;175078;2571;259;3514
FR;5;2022-05-03;83;55;2;5;11;265381;175133;2573;264;3525
FR;5;2022-05-04;276;204;1;2;7;265657;175337;2574;266;3532
FR;5;2022-05-05;62;32;2;4;4;265719;175369;2576;270;3536
FR;5;2022-05-06;103;64;2;3;5;265822;175433;2578;273;3541
FR;5;2022-05-07;170;115;3;10;13;265992;175548;2581;283;3554
FR;5;2022-05-08;7;8;0;0;2;265999;175556;2581;283;3556
FR;5;2022-05-09;44;32;15;3;16;266043;175588;2596;286;3572
FR;5;2022-05-10;54;48;3;4;5;266097;175636;2599;290;3577
FR;5;2022-05-11;324;236;12;7;21;266421;175872;2611;297;3598
FR;5;2022-05-12;46;34;1;3;2;266467;175906;2612;300;3600
FR;5;2022-05-13;108;83;2;8;8;266575;175989;2614;308;3608
FR;5;2022-05-14;203;129;0;1;8;266778;176118;2614;309;3616
FR;5;2022-05-15;22;7;2;0;1;266800;176125;2616;309;3617
FR;5;2022-05-16;49;31;2;4;4;266849;176156;2618;313;3621
FR;5;2022-05-17;72;40;5;0;2;266921;176196;2623;313;3623
FR;5;2022-05-18;288;213;4;4;8;267209;176409;2627;317;3631
FR;5;2022-05-19;44;35;4;3;2;267253;176444;2631;320;3633
FR;5;2022-05-20;72;62;2;3;1;267325;176506;2633;323;3634
FR;5;2022-05-21;241;163;1;3;15;267566;176669;2634;326;3649
FR;5;2022-05-22;20;14;2;5;2;267586;176683;2636;331;3651
FR;6;2020-12-27;0;0;0;0;0;0;0;0;0;0
FR;6;2020-12-28;0;0;0;0;0;0;0;0;0;0
FR;6;2020-12-29;0;0;0;0;0;0;0;0;0;0
FR;6;2020-12-30;0;0;0;0;0;0;0;0;0;0
FR;6;2020-12-31;0;0;0;0;0;0;0;0;0;0
FR;6;2021-01-01;0;0;0;0;0;0;0;0;0;0
FR;6;2021-01-02;0;0;0;0;0;0;0;0;0;0
FR;6;2021-01-03;0;0;0;0;0;0;0;0;0;0
FR;6;2021-01-04;0;0;0;0;0;0;0;0;0;0
FR;6;2021-01-05;0;0;0;0;0;0;0;0;0;0
FR;6;2021-01-06;0;0;0;0;0;0;0;0;0;0
FR;6;2021-01-07;0;0;0;0;0;0;0;0;0;0
FR;6;2021-01-08;0;0;0;0;0;0;0;0;0;0
FR;6;2021-01-09;0;0;0;0;0;0;0;0;0;0
FR;6;2021-01-10;0;0;0;0;0;0;0;0;0;0
FR;6;2021-01-11;0;0;0;0;0;0;0;0;0;0
FR;6;2021-01-12;0;0;0;0;0;0;0;0;0;0
FR;6;2021-01-13;0;0;0;0;0;0;0;0;0;0
FR;6;2021-01-14;0;0;0;0;0;0;0;0;0;0
FR;6;2021-01-15;0;0;0;0;0;0;0;0;0;0
FR;6;2021-01-16;0;0;0;0;0;0;0;0;0;0
FR;6;2021-01-17;0;0;0;0;0;0;0;0;0;0
FR;6;2021-01-18;0;0;0;0;0;0;0;0;0;0
FR;6;2021-01-19;0;0;0;0;0;0;0;0;0;0
FR;6;2021-01-20;0;0;0;0;0;0;0;0;0;0
FR;6;2021-01-21;0;0;0;0;0;0;0;0;0;0
FR;6;2021-01-22;0;0;0;0;0;0;0;0;0;0
FR;6;2021-01-23;0;0;0;0;0;0;0;0;0;0
FR;6;2021-01-24;0;0;0;0;0;0;0;0;0;0
FR;6;2021-01-25;0;0;0;0;0;0;0;0;0;0
FR;6;2021-01-26;0;0;0;0;0;0;0;0;0;0
FR;6;2021-01-27;0;0;0;0;0;0;0;0;0;0
FR;6;2021-01-28;0;0;0;0;0;0;0;0;0;0
FR;6;2021-01-29;0;0;0;0;0;0;0;0;0;0
FR;6;2021-01-30;0;0;0;0;0;0;0;0;0;0
FR;6;2021-01-31;0;0;0;0;0;0;0;0;0;0
FR;6;2021-02-01;0;0;0;0;0;0;0;0;0;0
FR;6;2021-02-02;0;0;0;0;0;0;0;0;0;0
FR;6;2021-02-03;0;0;0;0;0;0;0;0;0;0
FR;6;2021-02-04;0;0;0;0;0;0;0;0;0;0
FR;6;2021-02-05;0;0;0;0;0;0;0;0;0;0
FR;6;2021-02-06;0;0;0;0;0;0;0;0;0;0
FR;6;2021-02-07;0;0;0;0;0;0;0;0;0;0
FR;6;2021-02-08;0;0;0;0;0;0;0;0;0;0
FR;6;2021-02-09;0;0;0;0;0;0;0;0;0;0
FR;6;2021-02-10;0;0;0;0;0;0;0;0;0;0
FR;6;2021-02-11;0;0;0;0;0;0;0;0;0;0
FR;6;2021-02-12;0;0;0;0;0;0;0;0;0;0
FR;6;2021-02-13;0;0;0;0;0;0;0;0;0;0
FR;6;2021-02-14;0;0;0;0;0;0;0;0;0;0
FR;6;2021-02-15;0;0;0;0;0;0;0;0;0;0
FR;6;2021-02-16;0;0;0;0;0;0;0;0;0;0
FR;6;2021-02-17;0;0;0;0;0;0;0;0;0;0
FR;6;2021-02-18;0;0;0;0;0;0;0;0;0;0
FR;6;2021-02-19;0;0;0;0;0;0;0;0;0;0
FR;6;2021-02-20;0;0;0;0;0;0;0;0;0;0
FR;6;2021-02-21;0;0;0;0;0;0;0;0;0;0
FR;6;2021-02-22;0;0;0;0;0;0;0;0;0;0
FR;6;2021-02-23;0;0;0;0;0;0;0;0;0;0
FR;6;2021-02-24;0;0;0;0;0;0;0;0;0;0
FR;6;2021-02-25;0;0;0;0;0;0;0;0;0;0
FR;6;2021-02-26;0;0;0;0;0;0;0;0;0;0
FR;6;2021-02-27;0;0;0;0;0;0;0;0;0;0
FR;6;2021-02-28;0;0;0;0;0;0;0;0;0;0
FR;6;2021-03-01;0;0;0;0;0;0;0;0;0;0
FR;6;2021-03-02;0;0;0;0;0;0;0;0;0;0
FR;6;2021-03-03;0;0;0;0;0;0;0;0;0;0
FR;6;2021-03-04;0;0;0;0;0;0;0;0;0;0
FR;6;2021-03-05;0;0;0;0;0;0;0;0;0;0
FR;6;2021-03-06;0;0;0;0;0;0;0;0;0;0
FR;6;2021-03-07;0;0;0;0;0;0;0;0;0;0
FR;6;2021-03-08;0;0;0;0;0;0;0;0;0;0
FR;6;2021-03-09;0;0;0;0;0;0;0;0;0;0
FR;6;2021-03-10;0;0;0;0;0;0;0;0;0;0
FR;6;2021-03-11;0;0;0;0;0;0;0;0;0;0
FR;6;2021-03-12;0;0;0;0;0;0;0;0;0;0
FR;6;2021-03-13;0;0;0;0;0;0;0;0;0;0
FR;6;2021-03-14;0;0;0;0;0;0;0;0;0;0
FR;6;2021-03-15;0;0;0;0;0;0;0;0;0;0
FR;6;2021-03-16;0;0;0;0;0;0;0;0;0;0
FR;6;2021-03-17;0;0;0;0;0;0;0;0;0;0
FR;6;2021-03-18;0;0;0;0;0;0;0;0;0;0
FR;6;2021-03-19;0;0;0;0;0;0;0;0;0;0
FR;6;2021-03-20;0;0;0;0;0;0;0;0;0;0
FR;6;2021-03-21;0;0;0;0;0;0;0;0;0;0
FR;6;2021-03-22;0;0;0;0;0;0;0;0;0;0
FR;6;2021-03-23;0;0;0;0;0;0;0;0;0;0
FR;6;2021-03-24;0;0;0;0;0;0;0;0;0;0
FR;6;2021-03-25;0;0;0;0;0;0;0;0;0;0
FR;6;2021-03-26;0;0;0;0;0;0;0;0;0;0
FR;6;2021-03-27;0;0;0;0;0;0;0;0;0;0
FR;6;2021-03-28;0;0;0;0;0;0;0;0;0;0
FR;6;2021-03-29;0;0;0;0;0;0;0;0;0;0
FR;6;2021-03-30;0;0;0;0;0;0;0;0;0;0
FR;6;2021-03-31;0;0;0;0;0;0;0;0;0;0
FR;6;2021-04-01;0;0;0;0;0;0;0;0;0;0
FR;6;2021-04-02;0;0;0;0;0;0;0;0;0;0
FR;6;2021-04-03;0;0;0;0;0;0;0;0;0;0
FR;6;2021-04-04;0;0;0;0;0;0;0;0;0;0
FR;6;2021-04-05;0;0;0;0;0;0;0;0;0;0
FR;6;2021-04-06;0;0;0;0;0;0;0;0;0;0
FR;6;2021-04-07;0;0;0;0;0;0;0;0;0;0
FR;6;2021-04-08;0;0;0;0;0;0;0;0;0;0
FR;6;2021-04-09;0;0;0;0;0;0;0;0;0;0
FR;6;2021-04-10;0;0;0;0;0;0;0;0;0;0
FR;6;2021-04-11;0;0;0;0;0;0;0;0;0;0
FR;6;2021-04-12;0;0;0;0;0;0;0;0;0;0
FR;6;2021-04-13;0;0;0;0;0;0;0;0;0;0
FR;6;2021-04-14;0;0;0;0;0;0;0;0;0;0
FR;6;2021-04-15;0;0;0;0;0;0;0;0;0;0
FR;6;2021-04-16;0;0;0;0;0;0;0;0;0;0
FR;6;2021-04-17;0;0;0;0;0;0;0;0;0;0
FR;6;2021-04-18;0;0;0;0;0;0;0;0;0;0
FR;6;2021-04-19;0;0;0;0;0;0;0;0;0;0
FR;6;2021-04-20;0;0;0;0;0;0;0;0;0;0
FR;6;2021-04-21;0;0;0;0;0;0;0;0;0;0
FR;6;2021-04-22;0;0;0;0;0;0;0;0;0;0
FR;6;2021-04-23;0;0;0;0;0;0;0;0;0;0
FR;6;2021-04-24;0;0;0;0;0;0;0;0;0;0
FR;6;2021-04-25;0;0;0;0;0;0;0;0;0;0
FR;6;2021-04-26;0;0;0;0;0;0;0;0;0;0
FR;6;2021-04-27;0;0;0;0;0;0;0;0;0;0
FR;6;2021-04-28;0;0;0;0;0;0;0;0;0;0
FR;6;2021-04-29;0;0;0;0;0;0;0;0;0;0
FR;6;2021-04-30;0;0;0;0;0;0;0;0;0;0
FR;6;2021-05-01;0;0;0;0;0;0;0;0;0;0
FR;6;2021-05-02;0;0;0;0;0;0;0;0;0;0
FR;6;2021-05-03;0;0;0;0;0;0;0;0;0;0
FR;6;2021-05-04;0;0;0;0;0;0;0;0;0;0
FR;6;2021-05-05;0;0;0;0;0;0;0;0;0;0
FR;6;2021-05-06;0;0;0;0;0;0;0;0;0;0
FR;6;2021-05-07;0;0;0;0;0;0;0;0;0;0
FR;6;2021-05-08;0;0;0;0;0;0;0;0;0;0
FR;6;2021-05-09;0;0;0;0;0;0;0;0;0;0
FR;6;2021-05-10;0;0;0;0;0;0;0;0;0;0
FR;6;2021-05-11;0;0;0;0;0;0;0;0;0;0
FR;6;2021-05-12;0;0;0;0;0;0;0;0;0;0
FR;6;2021-05-13;0;0;0;0;0;0;0;0;0;0
FR;6;2021-05-14;0;0;0;0;0;0;0;0;0;0
FR;6;2021-05-15;0;0;0;0;0;0;0;0;0;0
FR;6;2021-05-16;0;0;0;0;0;0;0;0;0;0
FR;6;2021-05-17;0;0;0;0;0;0;0;0;0;0
FR;6;2021-05-18;0;0;0;0;0;0;0;0;0;0
FR;6;2021-05-19;0;0;0;0;0;0;0;0;0;0
FR;6;2021-05-20;0;0;0;0;0;0;0;0;0;0
FR;6;2021-05-21;0;0;0;0;0;0;0;0;0;0
FR;6;2021-05-22;0;0;0;0;0;0;0;0;0;0
FR;6;2021-05-23;0;0;0;0;0;0;0;0;0;0
FR;6;2021-05-24;0;0;0;0;0;0;0;0;0;0
FR;6;2021-05-25;0;0;0;0;0;0;0;0;0;0
FR;6;2021-05-26;0;0;0;0;0;0;0;0;0;0
FR;6;2021-05-27;0;0;0;0;0;0;0;0;0;0
FR;6;2021-05-28;0;0;0;0;0;0;0;0;0;0
FR;6;2021-05-29;0;0;0;0;0;0;0;0;0;0
FR;6;2021-05-30;0;0;0;0;0;0;0;0;0;0
FR;6;2021-05-31;0;0;0;0;0;0;0;0;0;0
FR;6;2021-06-01;0;0;0;0;0;0;0;0;0;0
FR;6;2021-06-02;0;0;0;0;0;0;0;0;0;0
FR;6;2021-06-03;0;0;0;0;0;0;0;0;0;0
FR;6;2021-06-04;0;0;0;0;0;0;0;0;0;0
FR;6;2021-06-05;0;0;0;0;0;0;0;0;0;0
FR;6;2021-06-06;0;0;0;0;0;0;0;0;0;0
FR;6;2021-06-07;0;0;0;0;0;0;0;0;0;0
FR;6;2021-06-08;0;0;0;0;0;0;0;0;0;0
FR;6;2021-06-09;0;0;0;0;0;0;0;0;0;0
FR;6;2021-06-10;0;0;0;0;0;0;0;0;0;0
FR;6;2021-06-11;0;0;0;0;0;0;0;0;0;0
FR;6;2021-06-12;0;0;0;0;0;0;0;0;0;0
FR;6;2021-06-13;0;0;0;0;0;0;0;0;0;0
FR;6;2021-06-14;0;0;0;0;0;0;0;0;0;0
FR;6;2021-06-15;0;0;0;0;0;0;0;0;0;0
FR;6;2021-06-16;0;0;0;0;0;0;0;0;0;0
FR;6;2021-06-17;0;0;0;0;0;0;0;0;0;0
FR;6;2021-06-18;0;0;0;0;0;0;0;0;0;0
FR;6;2021-06-19;0;0;0;0;0;0;0;0;0;0
FR;6;2021-06-20;0;0;0;0;0;0;0;0;0;0
FR;6;2021-06-21;0;0;0;0;0;0;0;0;0;0
FR;6;2021-06-22;0;0;0;0;0;0;0;0;0;0
FR;6;2021-06-23;0;0;0;0;0;0;0;0;0;0
FR;6;2021-06-24;0;0;0;0;0;0;0;0;0;0
FR;6;2021-06-25;0;0;0;0;0;0;0;0;0;0
FR;6;2021-06-26;0;0;0;0;0;0;0;0;0;0
FR;6;2021-06-27;0;0;0;0;0;0;0;0;0;0
FR;6;2021-06-28;0;0;0;0;0;0;0;0;0;0
FR;6;2021-06-29;0;0;0;0;0;0;0;0;0;0
FR;6;2021-06-30;0;0;0;0;0;0;0;0;0;0
FR;6;2021-07-01;0;0;0;0;0;0;0;0;0;0
FR;6;2021-07-02;0;0;0;0;0;0;0;0;0;0
FR;6;2021-07-03;0;0;0;0;0;0;0;0;0;0
FR;6;2021-07-04;0;0;0;0;0;0;0;0;0;0
FR;6;2021-07-05;0;0;0;0;0;0;0;0;0;0
FR;6;2021-07-06;0;0;0;0;0;0;0;0;0;0
FR;6;2021-07-07;0;0;0;0;0;0;0;0;0;0
FR;6;2021-07-08;0;0;0;0;0;0;0;0;0;0
FR;6;2021-07-09;0;0;0;0;0;0;0;0;0;0
FR;6;2021-07-10;0;0;0;0;0;0;0;0;0;0
FR;6;2021-07-11;0;0;0;0;0;0;0;0;0;0
FR;6;2021-07-12;0;0;0;0;0;0;0;0;0;0
FR;6;2021-07-13;0;0;0;0;0;0;0;0;0;0
FR;6;2021-07-14;0;0;0;0;0;0;0;0;0;0
FR;6;2021-07-15;0;0;0;0;0;0;0;0;0;0
FR;6;2021-07-16;0;0;0;0;0;0;0;0;0;0
FR;6;2021-07-17;0;0;0;0;0;0;0;0;0;0
FR;6;2021-07-18;0;0;0;0;0;0;0;0;0;0
FR;6;2021-07-19;0;0;0;0;0;0;0;0;0;0
FR;6;2021-07-20;0;0;0;0;0;0;0;0;0;0
FR;6;2021-07-21;0;0;0;0;0;0;0;0;0;0
FR;6;2021-07-22;0;0;0;0;0;0;0;0;0;0
FR;6;2021-07-23;0;0;0;0;0;0;0;0;0;0
FR;6;2021-07-24;0;0;0;0;0;0;0;0;0;0
FR;6;2021-07-25;0;0;0;0;0;0;0;0;0;0
FR;6;2021-07-26;0;0;0;0;0;0;0;0;0;0
FR;6;2021-07-27;0;0;0;0;0;0;0;0;0;0
FR;6;2021-07-28;0;0;0;0;0;0;0;0;0;0
FR;6;2021-07-29;0;0;0;0;0;0;0;0;0;0
FR;6;2021-07-30;0;0;0;0;0;0;0;0;0;0
FR;6;2021-07-31;0;0;0;0;0;0;0;0;0;0
FR;6;2021-08-01;0;0;0;0;0;0;0;0;0;0
FR;6;2021-08-02;0;0;0;0;0;0;0;0;0;0
FR;6;2021-08-03;0;0;0;0;0;0;0;0;0;0
FR;6;2021-08-04;0;0;0;0;0;0;0;0;0;0
FR;6;2021-08-05;0;0;0;0;0;0;0;0;0;0
FR;6;2021-08-06;0;0;0;0;0;0;0;0;0;0
FR;6;2021-08-07;0;0;0;0;0;0;0;0;0;0
FR;6;2021-08-08;0;0;0;0;0;0;0;0;0;0
FR;6;2021-08-09;0;0;0;0;0;0;0;0;0;0
FR;6;2021-08-10;0;0;0;0;0;0;0;0;0;0
FR;6;2021-08-11;0;0;0;0;0;0;0;0;0;0
FR;6;2021-08-12;0;0;0;0;0;0;0;0;0;0
FR;6;2021-08-13;0;0;0;0;0;0;0;0;0;0
FR;6;2021-08-14;0;0;0;0;0;0;0;0;0;0
FR;6;2021-08-15;0;0;0;0;0;0;0;0;0;0
FR;6;2021-08-16;0;0;0;0;0;0;0;0;0;0
FR;6;2021-08-17;0;0;0;0;0;0;0;0;0;0
FR;6;2021-08-18;0;0;0;0;0;0;0;0;0;0
FR;6;2021-08-19;0;0;0;0;0;0;0;0;0;0
FR;6;2021-08-20;0;0;0;0;0;0;0;0;0;0
FR;6;2021-08-21;0;0;0;0;0;0;0;0;0;0
FR;6;2021-08-22;0;0;0;0;0;0;0;0;0;0
FR;6;2021-08-23;0;0;0;0;0;0;0;0;0;0
FR;6;2021-08-24;0;0;0;0;0;0;0;0;0;0
FR;6;2021-08-25;0;0;0;0;0;0;0;0;0;0
FR;6;2021-08-26;0;0;0;0;0;0;0;0;0;0
FR;6;2021-08-27;0;0;0;0;0;0;0;0;0;0
FR;6;2021-08-28;0;0;0;0;0;0;0;0;0;0
FR;6;2021-08-29;0;0;0;0;0;0;0;0;0;0
FR;6;2021-08-30;0;0;0;0;0;0;0;0;0;0
FR;6;2021-08-31;0;0;0;0;0;0;0;0;0;0
FR;6;2021-09-01;0;0;0;0;0;0;0;0;0;0
FR;6;2021-09-02;0;0;0;0;0;0;0;0;0;0
FR;6;2021-09-03;0;0;0;0;0;0;0;0;0;0
FR;6;2021-09-04;0;0;0;0;0;0;0;0;0;0
FR;6;2021-09-05;0;0;0;0;0;0;0;0;0;0
FR;6;2021-09-06;0;0;0;0;0;0;0;0;0;0
FR;6;2021-09-07;0;0;0;0;0;0;0;0;0;0
FR;6;2021-09-08;0;0;0;0;0;0;0;0;0;0
FR;6;2021-09-09;0;0;0;0;0;0;0;0;0;0
FR;6;2021-09-10;0;0;0;0;0;0;0;0;0;0
FR;6;2021-09-11;0;0;0;0;0;0;0;0;0;0
FR;6;2021-09-12;0;0;0;0;0;0;0;0;0;0
FR;6;2021-09-13;0;0;0;0;0;0;0;0;0;0
FR;6;2021-09-14;0;0;0;0;0;0;0;0;0;0
FR;6;2021-09-15;0;0;0;0;0;0;0;0;0;0
FR;6;2021-09-16;0;0;0;0;0;0;0;0;0;0
FR;6;2021-09-17;0;0;0;0;0;0;0;0;0;0
FR;6;2021-09-18;0;0;0;0;0;0;0;0;0;0
FR;6;2021-09-19;0;0;0;0;0;0;0;0;0;0
FR;6;2021-09-20;0;0;0;0;0;0;0;0;0;0
FR;6;2021-09-21;0;0;0;0;0;0;0;0;0;0
FR;6;2021-09-22;0;0;0;0;0;0;0;0;0;0
FR;6;2021-09-23;0;0;0;0;0;0;0;0;0;0
FR;6;2021-09-24;0;0;0;0;0;0;0;0;0;0
FR;6;2021-09-25;0;0;0;0;0;0;0;0;0;0
FR;6;2021-09-26;0;0;0;0;0;0;0;0;0;0
FR;6;2021-09-27;0;0;0;0;0;0;0;0;0;0
FR;6;2021-09-28;0;0;0;0;0;0;0;0;0;0
FR;6;2021-09-29;0;0;0;0;0;0;0;0;0;0
FR;6;2021-09-30;0;0;0;0;0;0;0;0;0;0
FR;6;2021-10-01;0;0;0;0;0;0;0;0;0;0
FR;6;2021-10-02;0;0;0;0;0;0;0;0;0;0
FR;6;2021-10-03;0;0;0;0;0;0;0;0;0;0
FR;6;2021-10-04;0;0;0;0;0;0;0;0;0;0
FR;6;2021-10-05;0;0;0;0;0;0;0;0;0;0
FR;6;2021-10-06;0;0;0;0;0;0;0;0;0;0
FR;6;2021-10-07;0;0;0;0;0;0;0;0;0;0
FR;6;2021-10-08;0;0;0;0;0;0;0;0;0;0
FR;6;2021-10-09;0;0;0;0;0;0;0;0;0;0
FR;6;2021-10-10;0;0;0;0;0;0;0;0;0;0
FR;6;2021-10-11;0;0;0;0;0;0;0;0;0;0
FR;6;2021-10-12;0;0;0;0;0;0;0;0;0;0
FR;6;2021-10-13;0;0;0;0;0;0;0;0;0;0
FR;6;2021-10-14;0;0;0;0;0;0;0;0;0;0
FR;6;2021-10-15;0;0;0;0;0;0;0;0;0;0
FR;6;2021-10-16;0;0;0;0;0;0;0;0;0;0
FR;6;2021-10-17;0;0;0;0;0;0;0;0;0;0
FR;6;2021-10-18;0;0;0;0;0;0;0;0;0;0
FR;6;2021-10-19;0;0;0;0;0;0;0;0;0;0
FR;6;2021-10-20;0;0;0;0;0;0;0;0;0;0
FR;6;2021-10-21;0;0;0;0;0;0;0;0;0;0
FR;6;2021-10-22;0;0;0;0;0;0;0;0;0;0
FR;6;2021-10-23;0;0;0;0;0;0;0;0;0;0
FR;6;2021-10-24;0;0;0;0;0;0;0;0;0;0
FR;6;2021-10-25;0;0;0;0;0;0;0;0;0;0
FR;6;2021-10-26;0;0;0;0;0;0;0;0;0;0
FR;6;2021-10-27;0;0;0;0;0;0;0;0;0;0
FR;6;2021-10-28;0;0;0;0;0;0;0;0;0;0
FR;6;2021-10-29;0;0;0;0;0;0;0;0;0;0
FR;6;2021-10-30;0;0;0;0;0;0;0;0;0;0
FR;6;2021-10-31;0;0;0;0;0;0;0;0;0;0
FR;6;2021-11-01;0;0;0;0;0;0;0;0;0;0
FR;6;2021-11-02;0;0;0;0;0;0;0;0;0;0
FR;6;2021-11-03;0;0;0;0;0;0;0;0;0;0
FR;6;2021-11-04;0;0;0;0;0;0;0;0;0;0
FR;6;2021-11-05;0;0;0;0;0;0;0;0;0;0
FR;6;2021-11-06;0;0;0;0;0;0;0;0;0;0
FR;6;2021-11-07;0;0;0;0;0;0;0;0;0;0
FR;6;2021-11-08;0;0;0;0;0;0;0;0;0;0
FR;6;2021-11-09;0;0;0;0;0;0;0;0;0;0
FR;6;2021-11-10;0;0;0;0;0;0;0;0;0;0
FR;6;2021-11-11;0;0;0;0;0;0;0;0;0;0
FR;6;2021-11-12;0;0;0;0;0;0;0;0;0;0
FR;6;2021-11-13;0;0;0;0;0;0;0;0;0;0
FR;6;2021-11-14;0;0;0;0;0;0;0;0;0;0
FR;6;2021-11-15;0;0;0;0;0;0;0;0;0;0
FR;6;2021-11-16;0;0;0;0;0;0;0;0;0;0
FR;6;2021-11-17;0;0;0;0;0;0;0;0;0;0
FR;6;2021-11-18;0;0;0;0;0;0;0;0;0;0
FR;6;2021-11-19;0;0;0;0;0;0;0;0;0;0
FR;6;2021-11-20;0;0;0;0;0;0;0;0;0;0
FR;6;2021-11-21;0;0;0;0;0;0;0;0;0;0
FR;6;2021-11-22;0;0;0;0;0;0;0;0;0;0
FR;6;2021-11-23;0;0;0;0;0;0;0;0;0;0
FR;6;2021-11-24;0;0;0;0;0;0;0;0;0;0
FR;6;2021-11-25;0;0;0;0;0;0;0;0;0;0
FR;6;2021-11-26;0;0;0;0;0;0;0;0;0;0
FR;6;2021-11-27;0;0;0;0;0;0;0;0;0;0
FR;6;2021-11-28;0;0;0;0;0;0;0;0;0;0
FR;6;2021-11-29;0;0;0;0;0;0;0;0;0;0
FR;6;2021-11-30;0;0;0;0;0;0;0;0;0;0
FR;6;2021-12-01;0;0;0;0;0;0;0;0;0;0
FR;6;2021-12-02;0;0;0;0;0;0;0;0;0;0
FR;6;2021-12-03;0;0;0;0;0;0;0;0;0;0
FR;6;2021-12-04;0;0;0;0;0;0;0;0;0;0
FR;6;2021-12-05;0;0;0;0;0;0;0;0;0;0
FR;6;2021-12-06;0;0;0;0;0;0;0;0;0;0
FR;6;2021-12-07;0;0;0;0;0;0;0;0;0;0
FR;6;2021-12-08;0;0;0;0;0;0;0;0;0;0
FR;6;2021-12-09;0;0;0;0;0;0;0;0;0;0
FR;6;2021-12-10;0;0;0;0;0;0;0;0;0;0
FR;6;2021-12-11;0;0;0;0;0;0;0;0;0;0
FR;6;2021-12-12;0;0;0;0;0;0;0;0;0;0
FR;6;2021-12-13;0;0;0;0;0;0;0;0;0;0
FR;6;2021-12-14;0;0;0;0;0;0;0;0;0;0
FR;6;2021-12-15;0;0;0;0;0;0;0;0;0;0
FR;6;2021-12-16;0;0;0;0;0;0;0;0;0;0
FR;6;2021-12-17;0;0;0;0;0;0;0;0;0;0
FR;6;2021-12-18;0;0;0;0;0;0;0;0;0;0
FR;6;2021-12-19;0;0;0;0;0;0;0;0;0;0
FR;6;2021-12-20;0;0;0;0;0;0;0;0;0;0
FR;6;2021-12-21;0;0;0;0;0;0;0;0;0;0
FR;6;2021-12-22;0;0;0;0;0;0;0;0;0;0
FR;6;2021-12-23;0;0;0;0;0;0;0;0;0;0
FR;6;2021-12-24;0;0;0;0;0;0;0;0;0;0
FR;6;2021-12-25;0;0;0;0;0;0;0;0;0;0
FR;6;2021-12-26;0;0;0;0;0;0;0;0;0;0
FR;6;2021-12-27;0;0;0;0;0;0;0;0;0;0
FR;6;2021-12-28;0;0;0;0;0;0;0;0;0;0
FR;6;2021-12-29;0;0;0;0;0;0;0;0;0;0
FR;6;2021-12-30;0;0;0;0;0;0;0;0;0;0
FR;6;2021-12-31;0;0;0;0;0;0;0;0;0;0
FR;6;2022-01-01;0;0;0;0;0;0;0;0;0;0
FR;6;2022-01-02;0;0;0;0;0;0;0;0;0;0
FR;6;2022-01-03;0;0;0;0;0;0;0;0;0;0
FR;6;2022-01-04;0;0;0;0;0;0;0;0;0;0
FR;6;2022-01-05;0;0;0;0;0;0;0;0;0;0
FR;6;2022-01-06;0;0;0;0;0;0;0;0;0;0
FR;6;2022-01-07;0;0;0;0;0;0;0;0;0;0
FR;6;2022-01-08;0;0;0;0;0;0;0;0;0;0
FR;6;2022-01-09;0;0;0;0;0;0;0;0;0;0
FR;6;2022-01-10;0;0;0;0;0;0;0;0;0;0
FR;6;2022-01-11;0;0;0;0;0;0;0;0;0;0
FR;6;2022-01-12;0;0;0;0;0;0;0;0;0;0
FR;6;2022-01-13;0;0;0;0;0;0;0;0;0;0
FR;6;2022-01-14;0;0;0;0;0;0;0;0;0;0
FR;6;2022-01-15;0;0;0;0;0;0;0;0;0;0
FR;6;2022-01-16;0;0;0;0;0;0;0;0;0;0
FR;6;2022-01-17;0;0;0;0;0;0;0;0;0;0
FR;6;2022-01-18;0;0;0;0;0;0;0;0;0;0
FR;6;2022-01-19;0;0;0;0;0;0;0;0;0;0
FR;6;2022-01-20;0;0;0;0;0;0;0;0;0;0
FR;6;2022-01-21;0;0;0;0;0;0;0;0;0;0
FR;6;2022-01-22;0;0;0;0;0;0;0;0;0;0
FR;6;2022-01-23;0;0;0;0;0;0;0;0;0;0
FR;6;2022-01-24;0;0;0;0;0;0;0;0;0;0
FR;6;2022-01-25;0;0;0;0;0;0;0;0;0;0
FR;6;2022-01-26;0;0;0;0;0;0;0;0;0;0
FR;6;2022-01-27;0;0;0;0;0;0;0;0;0;0
FR;6;2022-01-28;0;0;0;0;0;0;0;0;0;0
FR;6;2022-01-29;0;0;0;0;0;0;0;0;0;0
FR;6;2022-01-30;0;0;0;0;0;0;0;0;0;0
FR;6;2022-01-31;0;0;0;0;0;0;0;0;0;0
FR;6;2022-02-01;0;0;0;0;0;0;0;0;0;0
FR;6;2022-02-02;0;0;0;0;0;0;0;0;0;0
FR;6;2022-02-03;0;0;0;0;0;0;0;0;0;0
FR;6;2022-02-04;0;0;0;0;0;0;0;0;0;0
FR;6;2022-02-05;0;0;0;0;0;0;0;0;0;0
FR;6;2022-02-06;0;0;0;0;0;0;0;0;0;0
FR;6;2022-02-07;0;0;0;0;0;0;0;0;0;0
FR;6;2022-02-08;0;0;0;0;0;0;0;0;0;0
FR;6;2022-02-09;0;0;0;0;0;0;0;0;0;0
FR;6;2022-02-10;0;0;0;0;0;0;0;0;0;0
FR;6;2022-02-11;0;0;0;0;0;0;0;0;0;0
FR;6;2022-02-12;0;0;0;0;0;0;0;0;0;0
FR;6;2022-02-13;0;0;0;0;0;0;0;0;0;0
FR;6;2022-02-14;0;0;0;0;0;0;0;0;0;0
FR;6;2022-02-15;0;0;0;0;0;0;0;0;0;0
FR;6;2022-02-16;0;0;0;0;0;0;0;0;0;0
FR;6;2022-02-17;0;0;0;0;0;0;0;0;0;0
FR;6;2022-02-18;0;0;0;0;0;0;0;0;0;0
FR;6;2022-02-19;0;0;0;0;0;0;0;0;0;0
FR;6;2022-02-20;0;0;0;0;0;0;0;0;0;0
FR;6;2022-02-21;0;0;0;0;0;0;0;0;0;0
FR;6;2022-02-22;0;0;0;0;0;0;0;0;0;0
FR;6;2022-02-23;0;0;0;0;0;0;0;0;0;0
FR;6;2022-02-24;0;0;0;0;0;0;0;0;0;0
FR;6;2022-02-25;0;0;0;0;0;0;0;0;0;0
FR;6;2022-02-26;1;0;0;0;0;1;0;0;0;0
FR;6;2022-02-27;0;0;0;0;0;1;0;0;0;0
FR;6;2022-02-28;0;0;0;0;0;1;0;0;0;0
FR;6;2022-03-01;3;0;0;0;0;4;0;0;0;0
FR;6;2022-03-02;97;9;2;0;7;101;9;2;0;7
FR;6;2022-03-03;0;0;0;0;0;101;9;2;0;7
FR;6;2022-03-04;91;4;0;0;4;192;13;2;0;11
FR;6;2022-03-05;391;23;2;0;14;583;36;4;0;25
FR;6;2022-03-06;7;1;0;0;0;590;37;4;0;25
FR;6;2022-03-07;337;19;0;0;13;927;56;4;0;38
FR;6;2022-03-08;230;14;0;0;5;1157;70;4;0;43
FR;6;2022-03-09;519;29;2;0;21;1676;99;6;0;64
FR;6;2022-03-10;207;18;0;1;12;1883;117;6;1;76
FR;6;2022-03-11;328;21;6;0;21;2211;138;12;1;97
FR;6;2022-03-12;518;25;1;0;20;2729;163;13;1;117
FR;6;2022-03-13;40;2;0;0;1;2769;165;13;1;118
FR;6;2022-03-14;201;4;2;0;3;2970;169;15;1;121
FR;6;2022-03-15;112;11;2;0;9;3082;180;17;1;130
FR;6;2022-03-16;310;17;1;1;14;3392;197;18;2;144
FR;6;2022-03-17;117;6;1;2;4;3509;203;19;4;148
FR;6;2022-03-18;214;11;0;0;6;3723;214;19;4;154
FR;6;2022-03-19;307;19;2;0;9;4030;233;21;4;163
FR;6;2022-03-20;15;5;0;0;1;4045;238;21;4;164
FR;6;2022-03-21;132;23;1;0;4;4177;261;22;4;168
FR;6;2022-03-22;97;15;0;0;4;4274;276;22;4;172
FR;6;2022-03-23;226;108;3;0;14;4500;384;25;4;186
FR;6;2022-03-24;99;15;1;3;4;4599;399;26;7;190
FR;6;2022-03-25;203;141;2;1;15;4802;540;28;8;205
FR;6;2022-03-26;332;295;7;1;19;5134;835;35;9;224
FR;6;2022-03-27;32;30;1;0;1;5166;865;36;9;225
FR;6;2022-03-28;200;208;8;1;17;5366;1073;44;10;242
FR;6;2022-03-29;126;189;12;2;12;5492;1262;56;12;254
FR;6;2022-03-30;305;476;10;2;22;5797;1738;66;14;276
FR;6;2022-03-31;124;140;9;0;13;5921;1878;75;14;289
FR;6;2022-04-01;194;150;11;2;23;6115;2028;86;16;312
FR;6;2022-04-02;205;241;9;1;13;6320;2269;95;17;325
FR;6;2022-04-03;17;21;0;0;1;6337;2290;95;17;326
FR;6;2022-04-04;130;114;6;1;9;6467;2404;101;18;335
FR;6;2022-04-05;145;88;15;1;11;6612;2492;116;19;346
FR;6;2022-04-06;203;245;22;26;27;6815;2737;138;45;373
FR;6;2022-04-07;127;96;15;5;17;6942;2833;153;50;390
FR;6;2022-04-08;199;170;16;3;17;7141;3003;169;53;407
FR;6;2022-04-09;145;139;6;12;13;7286;3142;175;65;420
FR;6;2022-04-10;10;20;3;0;1;7296;3162;178;65;421
FR;6;2022-04-11;101;106;4;0;5;7397;3268;182;65;426
FR;6;2022-04-12;135;75;5;8;10;7532;3343;187;73;436
FR;6;2022-04-13;160;175;7;5;13;7692;3518;194;78;449
FR;6;2022-04-14;100;103;5;10;8;7792;3621;199;88;457
FR;6;2022-04-15;160;148;11;7;19;7952;3769;210;95;476
FR;6;2022-04-16;127;132;5;0;14;8079;3901;215;95;490
FR;6;2022-04-17;8;9;4;0;4;8087;3910;219;95;494
FR;6;2022-04-18;8;15;3;0;4;8095;3925;222;95;498
FR;6;2022-04-19;97;112;4;3;3;8192;4037;226;98;501
FR;6;2022-04-20;172;227;8;7;15;8364;4264;234;105;516
FR;6;2022-04-21;111;93;8;4;11;8475;4357;242;109;527
FR;6;2022-04-22;136;160;13;12;13;8611;4517;255;121;540
FR;6;2022-04-23;104;129;1;1;7;8715;4646;256;122;547
FR;6;2022-04-24;5;21;1;0;0;8720;4667;257;122;547
FR;6;2022-04-25;90;128;3;8;11;8810;4795;260;130;558
FR;6;2022-04-26;101;128;18;2;16;8911;4923;278;132;574
FR;6;2022-04-27;197;159;21;1;27;9108;5082;299;133;601
FR;6;2022-04-28;108;87;6;1;8;9216;5169;305;134;609
FR;6;2022-04-29;187;168;16;2;20;9403;5337;321;136;629
FR;6;2022-04-30;131;125;7;1;24;9534;5462;328;137;653
FR;6;2022-05-01;7;6;0;0;0;9541;5468;328;137;653
FR;6;2022-05-02;94;65;3;4;3;9635;5533;331;141;656
FR;6;2022-05-03;136;92;11;2;7;9771;5625;342;143;663
FR;6;2022-05-04;165;118;25;12;29;9936;5743;367;155;692
FR;6;2022-05-05;101;70;8;3;12;10037;5813;375;158;704
FR;6;2022-05-06;150;110;10;9;16;10187;5923;385;167;720
FR;6;2022-05-07;138;93;13;3;23;10325;6016;398;170;743
FR;6;2022-05-08;20;8;6;5;7;10345;6024;404;175;750
FR;6;2022-05-09;83;70;9;7;13;10428;6094;413;182;763
FR;6;2022-05-10;109;80;15;7;12;10537;6174;428;189;775
FR;6;2022-05-11;130;120;11;14;20;10667;6294;439;203;795
FR;6;2022-05-12;105;75;6;5;13;10772;6369;445;208;808
FR;6;2022-05-13;154;95;17;21;20;10926;6464;462;229;828
FR;6;2022-05-14;81;59;6;7;15;11007;6523;468;236;843
FR;6;2022-05-15;12;7;1;0;1;11019;6530;469;236;844
FR;6;2022-05-16;64;52;7;2;12;11083;6582;476;238;856
FR;6;2022-05-17;123;76;4;7;10;11206;6658;480;245;866
FR;6;2022-05-18;130;116;6;1;14;11336;6774;486;246;880
FR;6;2022-05-19;123;56;6;8;9;11459;6830;492;254;889
FR;6;2022-05-20;128;117;13;3;18;11587;6947;505;257;907
FR;6;2022-05-21;89;66;13;3;12;11676;7013;518;260;919
FR;6;2022-05-22;18;11;5;0;4;11694;7024;523;260;923
FR;0;2020-12-27;602;0;0;0;0;602;0;0;0;0
FR;0;2020-12-28;663;1;0;0;0;1265;1;0;0;0
FR;0;2020-12-29;373;0;0;0;0;1638;1;0;0;0
FR;0;2020-12-30;439;0;0;0;0;2077;1;0;0;0
FR;0;2020-12-31;415;0;0;0;0;2492;1;0;0;0
FR;0;2021-01-01;1135;1;0;0;0;3627;2;0;0;0
FR;0;2021-01-02;356;3;0;0;0;3983;5;0;0;0
FR;0;2021-01-03;399;0;0;0;0;4382;5;0;0;0
FR;0;2021-01-04;2087;2;0;0;0;6469;7;0;0;0
FR;0;2021-01-05;7562;3;0;0;0;14031;10;0;0;0
FR;0;2021-01-06;12412;10;0;0;0;26443;20;0;0;0
FR;0;2021-01-07;29446;9;0;0;0;55889;29;0;0;0
FR;0;2021-01-08;37121;9;0;0;0;93010;38;0;0;0
FR;0;2021-01-09;11209;4;0;0;0;104219;42;0;0;0
FR;0;2021-01-10;5996;3;0;0;0;110215;45;0;0;0
FR;0;2021-01-11;39922;17;0;0;0;150137;62;0;0;0
FR;0;2021-01-12;62119;15;0;0;0;212256;77;0;0;0
FR;0;2021-01-13;65096;28;0;0;0;277352;105;0;0;0
FR;0;2021-01-14;83123;74;0;0;0;360475;179;0;0;0
FR;0;2021-01-15;68987;28;0;0;0;429462;207;0;0;0
FR;0;2021-01-16;20208;70;0;0;0;449670;277;0;0;0
FR;0;2021-01-17;10976;46;0;0;0;460646;323;0;0;0
FR;0;2021-01-18;85878;164;0;0;0;546524;487;0;0;0
FR;0;2021-01-19;130571;171;0;0;0;677095;658;0;0;0
FR;0;2021-01-20;137524;172;0;0;0;814619;830;0;0;0
FR;0;2021-01-21;158368;168;0;0;0;972987;998;0;0;0
FR;0;2021-01-22;121038;200;0;0;0;1094025;1198;0;0;0
FR;0;2021-01-23;38464;63;0;0;0;1132489;1261;0;0;0
FR;0;2021-01-24;9740;69;0;0;0;1142229;1330;0;0;0
FR;0;2021-01-25;78217;1263;0;0;0;1220446;2593;0;0;0
FR;0;2021-01-26;100359;3284;1;0;0;1320805;5877;1;0;0
FR;0;2021-01-27;107223;5897;0;0;0;1428028;11774;1;0;0
FR;0;2021-01-28;124324;14943;0;0;0;1552352;26717;1;0;0
FR;0;2021-01-29;92168;17707;0;0;0;1644520;44424;1;0;0
FR;0;2021-01-30;29110;4258;0;0;0;1673630;48682;1;0;0
FR;0;2021-01-31;5225;1735;0;0;0;1678855;50417;1;0;0
FR;0;2021-02-01;53103;21504;0;0;0;1731958;71921;1;0;0
FR;0;2021-02-02;72275;35654;0;0;0;1804233;107575;1;0;0
FR;0;2021-02-03;72284;37916;0;0;0;1876517;145491;1;0;0
FR;0;2021-02-04;82047;51440;0;0;0;1958564;196931;1;0;0
FR;0;2021-02-05;68216;46120;0;0;0;2026780;243051;1;0;0
FR;0;2021-02-06;23109;10754;0;0;0;2049889;253805;1;0;0
FR;0;2021-02-07;5182;5260;0;0;0;2055071;259065;1;0;0
FR;0;2021-02-08;46815;46871;0;0;0;2101886;305936;1;0;0
FR;0;2021-02-09;65990;74309;0;0;0;2167876;380245;1;0;0
FR;0;2021-02-10;70982;79152;0;0;0;2238858;459397;1;0;0
FR;0;2021-02-11;87237;101050;0;0;0;2326095;560447;1;0;0
FR;0;2021-02-12;79287;74900;0;0;0;2405382;635347;1;0;0
FR;0;2021-02-13;22351;19468;0;0;0;2427733;654815;1;0;0
FR;0;2021-02-14;5071;7194;0;0;0;2432804;662009;1;0;0
FR;0;2021-02-15;38068;76591;0;0;0;2470872;738600;1;0;0
FR;0;2021-02-16;50363;100532;0;0;0;2521235;839132;1;0;0
FR;0;2021-02-17;50496;104556;1;0;0;2571731;943688;2;0;0
FR;0;2021-02-18;69755;120300;0;0;0;2641486;1063988;2;0;0
FR;0;2021-02-19;65048;91022;1;0;0;2706534;1155010;3;0;0
FR;0;2021-02-20;18573;28573;0;0;0;2725107;1183583;3;0;0
FR;0;2021-02-21;3314;6311;0;0;0;2728421;1189894;3;0;0
FR;0;2021-02-22;37476;73147;2;0;0;2765897;1263041;5;0;0
FR;0;2021-02-23;53759;84419;1;0;0;2819656;1347460;6;0;0
FR;0;2021-02-24;59978;81674;1;0;0;2879634;1429134;7;0;0
FR;0;2021-02-25;100541;91427;1;0;0;2980175;1520561;8;0;0
FR;0;2021-02-26;113429;70737;1;0;0;3093604;1591298;9;0;0
FR;0;2021-02-27;52091;22139;0;0;0;3145695;1613437;9;0;0
FR;0;2021-02-28;6190;4283;1;0;0;3151885;1617720;10;0;0
FR;0;2021-03-01;65830;53289;1;0;0;3217715;1671009;11;0;0
FR;0;2021-03-02;101345;66562;2;0;0;3319060;1737571;13;0;0
FR;0;2021-03-03;116462;65515;0;0;0;3435522;1803086;13;0;0
FR;0;2021-03-04;163582;70159;3;0;0;3599104;1873245;16;0;0
FR;0;2021-03-05;200881;63119;3;0;0;3799985;1936364;19;0;0
FR;0;2021-03-06;207923;17731;3;0;0;4007908;1954095;22;0;0
FR;0;2021-03-07;121250;5005;1;0;0;4129158;1959100;23;0;0
FR;0;2021-03-08;107110;50381;2;0;0;4236268;2009481;25;0;0
FR;0;2021-03-09;172409;56509;2;0;0;4408677;2065990;27;0;0
FR;0;2021-03-10;178932;57126;5;0;0;4587609;2123116;32;0;0
FR;0;2021-03-11;242822;63437;2;0;0;4830431;2186553;34;0;0
FR;0;2021-03-12;294772;53404;1;0;0;5125203;2239957;35;0;0
FR;0;2021-03-13;231370;15323;1;0;0;5356573;2255280;36;0;0
FR;0;2021-03-14;63334;3294;1;0;0;5419907;2258574;37;0;0
FR;0;2021-03-15;158600;32173;3;0;0;5578507;2290747;40;0;0
FR;0;2021-03-16;141538;39142;6;0;0;5720045;2329889;46;0;0
FR;0;2021-03-17;150443;38192;4;0;0;5870488;2368081;50;0;0
FR;0;2021-03-18;167780;44534;5;0;0;6038268;2412615;55;0;0
FR;0;2021-03-19;229961;37175;2;0;0;6268229;2449790;57;0;0
FR;0;2021-03-20;166639;11596;1;0;0;6434868;2461386;58;0;0
FR;0;2021-03-21;49918;2519;1;0;0;6484786;2463905;59;0;0
FR;0;2021-03-22;169993;33995;2;0;0;6654779;2497900;61;0;0
FR;0;2021-03-23;250329;42386;1;0;0;6905108;2540286;62;0;0
FR;0;2021-03-24;256847;43713;0;0;0;7161955;2583999;62;0;0
FR;0;2021-03-25;341745;44865;5;0;0;7503700;2628864;67;0;0
FR;0;2021-03-26;358744;41841;4;1;0;7862444;2670705;71;1;0
FR;0;2021-03-27;195238;16705;1;0;0;8057682;2687410;72;1;0
FR;0;2021-03-28;59321;3999;3;0;0;8117003;2691409;75;1;0
FR;0;2021-03-29;202927;54038;4;0;0;8319930;2745447;79;1;0
FR;0;2021-03-30;285406;69643;4;0;0;8605336;2815090;83;1;0
FR;0;2021-03-31;262961;73225;4;0;0;8868297;2888315;87;1;0
FR;0;2021-04-01;315380;89170;12;0;0;9183677;2977485;99;1;0
FR;0;2021-04-02;281276;92734;7;0;0;9464953;3070219;106;1;0
FR;0;2021-04-03;141047;61919;5;0;0;9606000;3132138;111;1;0
FR;0;2021-04-04;46449;18737;2;0;0;9652449;3150875;113;1;0
FR;0;2021-04-05;63304;10809;11;0;0;9715753;3161684;124;1;0
FR;0;2021-04-06;217140;109186;17;0;0;9932893;3270870;141;1;0
FR;0;2021-04-07;260187;115386;17;0;0;10193080;3386256;158;1;0
FR;0;2021-04-08;337731;121684;14;0;0;10530811;3507940;172;1;0
FR;0;2021-04-09;410078;116295;49;0;0;10940889;3624235;221;1;0
FR;0;2021-04-10;212581;82621;15;0;0;11153470;3706856;236;1;0
FR;0;2021-04-11;56122;34438;7;0;0;11209592;3741294;243;1;0
FR;0;2021-04-12;236997;115219;45;0;0;11446589;3856513;288;1;0
FR;0;2021-04-13;309415;144541;98;1;0;11756004;4001054;386;2;0
FR;0;2021-04-14;294431;139298;213;0;0;12050435;4140352;599;2;0
FR;0;2021-04-15;337005;148344;338;0;0;12387440;4288696;937;2;0
FR;0;2021-04-16;339221;145869;352;0;0;12726661;4434565;1289;2;0
FR;0;2021-04-17;188621;90034;109;0;0;12915282;4524599;1398;2;0
FR;0;2021-04-18;51601;35369;47;0;0;12966883;4559968;1445;2;0
FR;0;2021-04-19;205639;138223;454;0;0;13172522;4698191;1899;2;0
FR;0;2021-04-20;254341;170791;568;0;0;13426863;4868982;2467;2;0
FR;0;2021-04-21;253175;169048;834;0;0;13680038;5038030;3301;2;0
FR;0;2021-04-22;287486;188682;818;0;0;13967524;5226712;4119;2;0
FR;0;2021-04-23;297925;183397;747;0;0;14265449;5410109;4866;2;0
FR;0;2021-04-24;190407;111547;251;0;0;14455856;5521656;5117;2;0
FR;0;2021-04-25;69537;38767;51;0;0;14525393;5560423;5168;2;0
FR;0;2021-04-26;220889;156214;560;0;0;14746282;5716637;5728;2;0
FR;0;2021-04-27;284544;187315;940;0;0;15030826;5903952;6668;2;0
FR;0;2021-04-28;299431;183183;1422;1;1;15330257;6087135;8090;3;1
FR;0;2021-04-29;357052;196454;1276;0;0;15687309;6283589;9366;3;1
FR;0;2021-04-30;372130;184765;1119;1;0;16059439;6468354;10485;4;1
FR;0;2021-05-01;167596;52493;178;0;0;16227035;6520847;10663;4;1
FR;0;2021-05-02;91706;37749;83;0;0;16318741;6558596;10746;4;1
FR;0;2021-05-03;288851;168472;839;0;0;16607592;6727068;11585;4;1
FR;0;2021-05-04;315584;224338;1230;0;0;16923176;6951406;12815;4;1
FR;0;2021-05-05;327092;224717;1312;0;0;17250268;7176123;14127;4;1
FR;0;2021-05-06;379418;239351;1629;0;0;17629686;7415474;15756;4;1
FR;0;2021-05-07;372678;257282;1222;0;0;18002364;7672756;16978;4;1
FR;0;2021-05-08;222133;67316;297;0;0;18224497;7740072;17275;4;1
FR;0;2021-05-09;129684;46413;243;0;0;18354181;7786485;17518;4;1
FR;0;2021-05-10;313292;228693;1232;0;0;18667473;8015178;18750;4;1
FR;0;2021-05-11;403815;257806;1563;0;0;19071288;8272984;20313;4;1
FR;0;2021-05-12;434023;233019;1542;0;0;19505311;8506003;21855;4;1
FR;0;2021-05-13;338543;56931;430;0;0;19843854;8562934;22285;4;1
FR;0;2021-05-14;454051;167253;1122;0;0;20297905;8730187;23407;4;1
FR;0;2021-05-15;374916;94029;442;0;0;20672821;8824216;23849;4;1
FR;0;2021-05-16;202717;20780;168;0;0;20875538;8844996;24017;4;1
FR;0;2021-05-17;376055;148839;1549;0;0;21251593;8993835;25566;4;1
FR;0;2021-05-18;460054;153074;1986;0;0;21711647;9146909;27552;4;1
FR;0;2021-05-19;467317;144761;2455;0;0;22178964;9291670;30007;4;1
FR;0;2021-05-20;507454;160173;2331;0;0;22686418;9451843;32338;4;1
FR;0;2021-05-21;489567;174361;1987;0;0;23175985;9626204;34325;4;1
FR;0;2021-05-22;347137;79852;668;0;0;23523122;9706056;34993;4;1
FR;0;2021-05-23;161636;14392;246;0;0;23684758;9720448;35239;4;1
FR;0;2021-05-24;263130;33174;599;0;0;23947888;9753622;35838;4;1
FR;0;2021-05-25;400141;189083;2349;1;0;24348029;9942705;38187;5;1
FR;0;2021-05-26;413357;188401;2217;0;0;24761386;10131106;40404;5;1
FR;0;2021-05-27;449695;218549;2158;0;0;25211081;10349655;42562;5;1
FR;0;2021-05-28;429442;259384;1890;0;0;25640523;10609039;44452;5;1
FR;0;2021-05-29;298940;149337;583;0;0;25939463;10758376;45035;5;1
FR;0;2021-05-30;107096;32581;163;0;0;26046559;10790957;45198;5;1
FR;0;2021-05-31;357917;203374;1465;1;1;26404476;10994331;46663;6;2
FR;0;2021-06-01;430832;251247;1959;1;1;26835308;11245578;48622;7;3
FR;0;2021-06-02;419295;230802;1978;0;0;27254603;11476380;50600;7;3
FR;0;2021-06-03;464588;258384;1819;0;0;27719191;11734764;52419;7;3
FR;0;2021-06-04;455686;304700;1729;1;1;28174877;12039464;54148;8;4
FR;0;2021-06-05;304745;188941;651;0;0;28479622;12228405;54799;8;4
FR;0;2021-06-06;133236;49130;226;0;0;28612858;12277535;55025;8;4
FR;0;2021-06-07;338974;261936;1518;0;0;28951832;12539471;56543;8;4
FR;0;2021-06-08;393558;290945;1797;0;0;29345390;12830416;58340;8;4
FR;0;2021-06-09;384660;275474;1727;0;0;29730050;13105890;60067;8;4
FR;0;2021-06-10;403955;288930;1720;1;0;30134005;13394820;61787;9;4
FR;0;2021-06-11;386463;357235;1459;0;0;30520468;13752055;63246;9;4
FR;0;2021-06-12;283203;211285;490;0;0;30803671;13963340;63736;9;4
FR;0;2021-06-13;104828;73983;204;0;0;30908499;14037323;63940;9;4
FR;0;2021-06-14;240646;355572;1425;1;0;31149145;14392895;65365;10;4
FR;0;2021-06-15;307977;385608;1564;1;0;31457122;14778503;66929;11;4
FR;0;2021-06-16;313836;357720;1415;1;0;31770958;15136223;68344;12;4
FR;0;2021-06-17;317553;372422;1422;1;0;32088511;15508645;69766;13;4
FR;0;2021-06-18;321551;442437;1332;1;0;32410062;15951082;71098;14;4
FR;0;2021-06-19;224305;273786;448;0;0;32634367;16224868;71546;14;4
FR;0;2021-06-20;74364;102595;127;0;0;32708731;16327463;71673;14;4
FR;0;2021-06-21;195565;401883;1032;1;1;32904296;16729346;72705;15;5
FR;0;2021-06-22;223000;467381;1260;10;2;33127296;17196727;73965;25;7
FR;0;2021-06-23;233865;439900;1195;1;1;33361161;17636627;75160;26;8
FR;0;2021-06-24;241725;409569;1348;0;0;33602886;18046196;76508;26;8
FR;0;2021-06-25;227463;522224;1398;0;0;33830349;18568420;77906;26;8
FR;0;2021-06-26;153191;370691;585;1;0;33983540;18939111;78491;27;8
FR;0;2021-06-27;55861;156220;168;1;0;34039401;19095331;78659;28;8
FR;0;2021-06-28;154611;452881;1167;0;0;34194012;19548212;79826;28;8
FR;0;2021-06-29;182539;506783;2124;0;0;34376551;20054995;81950;28;8
FR;0;2021-06-30;203834;482403;2009;21;2;34580385;20537398;83959;49;10
FR;0;2021-07-01;231102;457802;2221;5;1;34811487;20995200;86180;54;11
FR;0;2021-07-02;228305;520216;2119;5;3;35039792;21515416;88299;59;14
FR;0;2021-07-03;141930;368744;909;3;1;35181722;21884160;89208;62;15
FR;0;2021-07-04;56691;141264;265;0;0;35238413;22025424;89473;62;15
FR;0;2021-07-05;168207;419313;1668;8;2;35406620;22444737;91141;70;17
FR;0;2021-07-06;196547;474801;1828;45;8;35603167;22919538;92969;115;25
FR;0;2021-07-07;212922;439308;1876;24;5;35816089;23358846;94845;139;30
FR;0;2021-07-08;231437;424176;2088;20;7;36047526;23783022;96933;159;37
FR;0;2021-07-09;228338;510692;2182;4;2;36275864;24293714;99115;163;39
FR;0;2021-07-10;148532;339876;982;1;1;36424396;24633590;100097;164;40
FR;0;2021-07-11;60140;110144;282;0;0;36484536;24743734;100379;164;40
FR;0;2021-07-12;168954;478210;1756;4;0;36653490;25221944;102135;168;40
FR;0;2021-07-13;287058;527453;2045;8;2;36940548;25749397;104180;176;42
FR;0;2021-07-14;180881;157740;433;0;0;37121429;25907137;104613;176;42
FR;0;2021-07-15;346862;502486;2097;1;0;37468291;26409623;106710;177;42
FR;0;2021-07-16;379901;495985;2021;3;1;37848192;26905608;108731;180;43
FR;0;2021-07-17;259648;319818;876;1;0;38107840;27225426;109607;181;43
FR;0;2021-07-18;109663;114798;310;0;0;38217503;27340224;109917;181;43
FR;0;2021-07-19;285310;425078;1627;3;0;38502813;27765302;111544;184;43
FR;0;2021-07-20;376719;452478;1721;0;0;38879532;28217780;113265;184;43
FR;0;2021-07-21;395624;407934;1549;4;2;39275156;28625714;114814;188;45
FR;0;2021-07-22;440875;388147;1713;4;2;39716031;29013861;116527;192;47
FR;0;2021-07-23;439833;423204;1880;4;2;40155864;29437065;118407;196;49
FR;0;2021-07-24;285178;269612;803;1;0;40441042;29706677;119210;197;49
FR;0;2021-07-25;121050;80060;226;0;0;40562092;29786737;119436;197;49
FR;0;2021-07-26;347262;323235;1615;3;2;40909354;30109972;121051;200;51
FR;0;2021-07-27;463880;320313;1696;4;2;41373234;30430285;122747;204;53
FR;0;2021-07-28;459290;290033;1634;4;2;41832524;30720318;124381;208;55
FR;0;2021-07-29;489677;276935;1794;2;1;42322201;30997253;126175;210;56
FR;0;2021-07-30;461626;302904;1935;5;2;42783827;31300157;128110;215;58
FR;0;2021-07-31;285337;185074;914;1;0;43069164;31485231;129024;216;58
FR;0;2021-08-01;111935;50002;252;0;0;43181099;31535233;129276;216;58
FR;0;2021-08-02;341206;234607;1598;2;0;43522305;31769840;130874;218;58
FR;0;2021-08-03;398396;245126;1716;2;1;43920701;32014966;132590;220;59
FR;0;2021-08-04;384622;210125;1590;6;3;44305323;32225091;134180;226;62
FR;0;2021-08-05;365973;228931;1709;0;0;44671296;32454022;135889;226;62
FR;0;2021-08-06;359546;271736;1833;4;1;45030842;32725758;137722;230;63
FR;0;2021-08-07;213035;178384;755;4;3;45243877;32904142;138477;234;66
FR;0;2021-08-08;74130;63245;270;0;0;45318007;32967387;138747;234;66
FR;0;2021-08-09;258570;259552;1540;4;3;45576577;33226939;140287;238;69
FR;0;2021-08-10;306595;278052;1655;2;1;45883172;33504991;141942;240;70
FR;0;2021-08-11;279517;260302;1440;5;1;46162689;33765293;143382;245;71
FR;0;2021-08-12;271366;278619;1659;3;1;46434055;34043912;145041;248;72
FR;0;2021-08-13;252029;277896;1589;3;2;46686084;34321808;146630;251;74
FR;0;2021-08-14;145275;197350;739;0;0;46831359;34519158;147369;251;74
FR;0;2021-08-15;39299;50106;215;1;0;46870658;34569264;147584;252;74
FR;0;2021-08-16;186039;318151;1539;0;0;47056697;34887415;149123;252;74
FR;0;2021-08-17;215552;336592;1634;7;1;47272249;35224007;150757;259;75
FR;0;2021-08-18;198921;324769;1594;7;4;47471170;35548776;152351;266;79
FR;0;2021-08-19;191879;325744;1633;1;0;47663049;35874520;153984;267;79
FR;0;2021-08-20;186341;366328;1810;3;2;47849390;36240848;155794;270;81
FR;0;2021-08-21;104750;238165;703;0;0;47954140;36479013;156497;270;81
FR;0;2021-08-22;31885;87202;253;1;1;47986025;36566215;156750;271;82
FR;0;2021-08-23;140884;357277;1559;3;2;48126909;36923492;158309;274;84
FR;0;2021-08-24;162402;376911;1844;5;1;48289311;37300403;160153;279;85
FR;0;2021-08-25;151057;350878;2028;8;3;48440368;37651281;162181;287;88
FR;0;2021-08-26;142733;342877;2553;10;1;48583101;37994158;164734;297;89
FR;0;2021-08-27;148360;388119;2789;10;3;48731461;38382277;167523;307;92
FR;0;2021-08-28;90603;249560;1405;0;0;48822064;38631837;168928;307;92
FR;0;2021-08-29;27305;83331;516;1;0;48849369;38715168;169444;308;92
FR;0;2021-08-30;117320;324899;4706;6;6026;48966689;39040067;174150;314;6118
FR;0;2021-08-31;128713;334671;10177;19;11880;49095402;39374738;184327;333;17998
FR;0;2021-09-01;135739;285695;22416;7;24310;49231141;39660433;206743;340;42308
FR;0;2021-09-02;112583;247284;26507;13;28856;49343724;39907717;233250;353;71164
FR;0;2021-09-03;118185;292717;29951;23;32959;49461909;40200434;263201;376;104123
FR;0;2021-09-04;89795;217734;12583;12;14071;49551704;40418168;275784;388;118194
FR;0;2021-09-05;21334;44869;4391;2;4731;49573038;40463037;280175;390;122925
FR;0;2021-09-06;75318;180823;31944;16;34248;49648356;40643860;312119;406;157173
FR;0;2021-09-07;80064;181252;33235;40;36092;49728420;40825112;345354;446;193265
FR;0;2021-09-08;89691;206207;29653;27;32454;49818111;41031319;375007;473;225719
FR;0;2021-09-09;76649;165403;33041;26;36522;49894760;41196722;408048;499;262241
FR;0;2021-09-10;95590;203702;35716;26;40516;49990350;41400424;443764;525;302757
FR;0;2021-09-11;66729;169222;12134;19;14308;50057079;41569646;455898;544;317065
FR;0;2021-09-12;12792;32078;2766;1;3160;50069871;41601724;458664;545;320225
FR;0;2021-09-13;64366;126392;41202;32;44041;50134237;41728116;499866;577;364266
FR;0;2021-09-14;73303;129126;56343;78;62018;50207540;41857242;556209;655;426284
FR;0;2021-09-15;76404;167865;55626;58;54773;50283944;42025107;611835;713;481057
FR;0;2021-09-16;63754;114544;60027;85;60015;50347698;42139651;671862;798;541072
FR;0;2021-09-17;74961;156843;53824;70;57224;50422659;42296494;725686;868;598296
FR;0;2021-09-18;48185;139591;15594;25;17280;50470844;42436085;741280;893;615576
FR;0;2021-09-19;7866;23718;2434;1;2621;50478710;42459803;743714;894;618197
FR;0;2021-09-20;44441;93933;50021;73;50250;50523151;42553736;793735;967;668447
FR;0;2021-09-21;45804;98442;62726;76;63363;50568955;42652178;856461;1043;731810
FR;0;2021-09-22;48583;142297;55331;83;55344;50617538;42794475;911792;1126;787154
FR;0;2021-09-23;43157;91991;62349;94;63466;50660695;42886466;974141;1220;850620
FR;0;2021-09-24;52199;133247;54526;109;59088;50712894;43019713;1028667;1329;909708
FR;0;2021-09-25;35191;115502;16263;37;18253;50748085;43135215;1044930;1366;927961
FR;0;2021-09-26;5524;17816;2265;5;2329;50753609;43153031;1047195;1371;930290
FR;0;2021-09-27;33919;76983;47170;97;48123;50787528;43230014;1094365;1468;978413
FR;0;2021-09-28;36444;75262;54929;88;56457;50823972;43305276;1149294;1556;1034870
FR;0;2021-09-29;44311;100843;53321;112;54804;50868283;43406119;1202615;1668;1089674
FR;0;2021-09-30;36267;72784;57001;95;59468;50904550;43478903;1259616;1763;1149142
FR;0;2021-10-01;61515;100836;57771;108;63677;50966065;43579739;1317387;1871;1212819
FR;0;2021-10-02;39412;78332;20950;38;23316;51005477;43658071;1338337;1909;1236135
FR;0;2021-10-03;5261;10533;2523;4;2539;51010738;43668604;1340860;1913;1238674
FR;0;2021-10-04;34945;58519;52609;84;54775;51045683;43727123;1393469;1997;1293449
FR;0;2021-10-05;33548;64343;60960;135;64914;51079231;43791466;1454429;2132;1358363
FR;0;2021-10-06;42412;79218;65687;113;68208;51121643;43870684;1520116;2245;1426571
FR;0;2021-10-07;30390;62138;65374;91;68658;51152033;43932822;1585490;2336;1495229
FR;0;2021-10-08;48738;91800;77714;110;84609;51200771;44024622;1663204;2446;1579838
FR;0;2021-10-09;33621;60864;31521;36;33852;51234392;44085486;1694725;2482;1613690
FR;0;2021-10-10;4586;7432;3186;9;3483;51238978;44092918;1697911;2491;1617173
FR;0;2021-10-11;30554;49907;61018;105;64022;51269532;44142825;1758929;2596;1681195
FR;0;2021-10-12;31335;54459;70561;139;75826;51300867;44197284;1829490;2735;1757021
FR;0;2021-10-13;39977;62792;74395;135;79248;51340844;44260076;1903885;2870;1836269
FR;0;2021-10-14;30222;52868;68719;116;73751;51371066;44312944;1972604;2986;1910020
FR;0;2021-10-15;44732;75243;93206;191;102882;51415798;44388187;2065810;3177;2012902
FR;0;2021-10-16;31269;44085;36681;44;39608;51447067;44432272;2102491;3221;2052510
FR;0;2021-10-17;3826;5277;3591;2;3692;51450893;44437549;2106082;3223;2056202
FR;0;2021-10-18;28285;42462;67467;133;71328;51479178;44480011;2173549;3356;2127530
FR;0;2021-10-19;27047;44444;76375;141;81602;51506225;44524455;2249924;3497;2209132
FR;0;2021-10-20;35199;52447;96901;180;101456;51541424;44576902;2346825;3677;2310588
FR;0;2021-10-21;25921;45197;83913;112;89099;51567345;44622099;2430738;3789;2399687
FR;0;2021-10-22;38186;62358;104862;199;112474;51605531;44684457;2535600;3988;2512161
FR;0;2021-10-23;26963;41222;45433;57;48594;51632494;44725679;2581033;4045;2560755
FR;0;2021-10-24;2912;4801;3679;6;3936;51635406;44730480;2584712;4051;2564691
FR;0;2021-10-25;25973;36347;82300;144;86594;51661379;44766827;2667012;4195;2651285
FR;0;2021-10-26;23680;35084;87204;166;92311;51685059;44801911;2754216;4361;2743596
FR;0;2021-10-27;30006;46410;108957;257;114605;51715065;44848321;2863173;4618;2858201
FR;0;2021-10-28;23380;34878;88654;153;94363;51738445;44883199;2951827;4771;2952564
FR;0;2021-10-29;31500;51345;117278;204;125238;51769945;44934544;3069105;4975;3077802
FR;0;2021-10-30;20521;33101;50323;77;53354;51790466;44967645;3119428;5052;3131156
FR;0;2021-10-31;2477;3763;3584;3;3867;51792943;44971408;3123012;5055;3135023
FR;0;2021-11-01;8193;4805;3200;3;3553;51801136;44976213;3126212;5058;3138576
FR;0;2021-11-02;25273;40081;93527;157;99461;51826409;45016294;3219739;5215;3238037
FR;0;2021-11-03;29754;47908;118835;218;125774;51856163;45064202;3338574;5433;3363811
FR;0;2021-11-04;23661;37496;107495;217;114317;51879824;45101698;3446069;5650;3478128
FR;0;2021-11-05;32266;52907;141584;233;151251;51912090;45154605;3587653;5883;3629379
FR;0;2021-11-06;21478;34564;64840;123;68222;51933568;45189169;3652493;6006;3697601
FR;0;2021-11-07;2377;4241;5171;6;5582;51935945;45193410;3657664;6012;3703183
FR;0;2021-11-08;20394;37827;127107;227;134151;51956339;45231237;3784771;6239;3837334
FR;0;2021-11-09;22123;44821;161608;341;172100;51978462;45276058;3946379;6580;4009434
FR;0;2021-11-10;31362;55056;186923;446;198667;52009824;45331114;4133302;7026;4208101
FR;0;2021-11-11;4296;6731;12923;28;13921;52014120;45337845;4146225;7054;4222022
FR;0;2021-11-12;28986;55154;183706;251;197252;52043106;45392999;4329931;7305;4419274
FR;0;2021-11-13;20292;32721;80675;118;86290;52063398;45425720;4410606;7423;4505564
FR;0;2021-11-14;2325;3946;7163;6;7878;52065723;45429666;4417769;7429;4513442
FR;0;2021-11-15;20288;38802;160775;312;171439;52086011;45468468;4578544;7741;4684881
FR;0;2021-11-16;23335;44042;200303;390;214862;52109346;45512510;4778847;8131;4899743
FR;0;2021-11-17;30348;50499;199773;407;212782;52139694;45563009;4978620;8538;5112525
FR;0;2021-11-18;23345;44975;191571;468;205393;52163039;45607984;5170191;9006;5317918
FR;0;2021-11-19;33553;61420;243119;548;262058;52196592;45669404;5413310;9554;5579976
FR;0;2021-11-20;25319;36775;102111;206;109658;52221911;45706179;5515421;9760;5689634
FR;0;2021-11-21;2622;4567;9640;18;10644;52224533;45710746;5525061;9778;5700278
FR;0;2021-11-22;22737;33346;180271;470;194735;52247270;45744092;5705332;10248;5895013
FR;0;2021-11-23;25561;45750;229291;547;247723;52272831;45789842;5934623;10795;6142736
FR;0;2021-11-24;31760;53797;224730;717;243109;52304591;45843639;6159353;11512;6385845
FR;0;2021-11-25;25382;49143;255808;740;277569;52329973;45892782;6415161;12252;6663414
FR;0;2021-11-26;33201;74741;379364;863;414500;52363174;45967523;6794525;13115;7077914
FR;0;2021-11-27;23294;49685;214835;389;236554;52386468;46017208;7009360;13504;7314468
FR;0;2021-11-28;3479;10588;56723;66;63325;52389947;46027796;7066083;13570;7377793
FR;0;2021-11-29;19384;54255;341367;863;371539;52409331;46082051;7407450;14433;7749332
FR;0;2021-11-30;24696;72184;457280;984;500628;52434027;46154235;7864730;15417;8249960
FR;0;2021-12-01;26839;75980;468966;1159;511170;52460866;46230215;8333696;16576;8761130
FR;0;2021-12-02;21970;71794;526974;1279;574688;52482836;46302009;8860670;17855;9335818
FR;0;2021-12-03;25473;92532;596232;1419;650963;52508309;46394541;9456902;19274;9986781
FR;0;2021-12-04;18286;60552;336151;690;369684;52526595;46455093;9793053;19964;10356465
FR;0;2021-12-05;4141;16269;95753;157;107050;52530736;46471362;9888806;20121;10463515
FR;0;2021-12-06;22692;73232;493010;1174;539816;52553428;46544594;10381816;21295;11003331
FR;0;2021-12-07;23310;91797;645231;1769;706137;52576738;46636391;11027047;23064;11709468
FR;0;2021-12-08;25331;92419;591421;1873;647316;52602069;46728810;11618468;24937;12356784
FR;0;2021-12-09;23991;94357;662918;2179;726168;52626060;46823167;12281386;27116;13082952
FR;0;2021-12-10;27655;111127;735912;2074;805971;52653715;46934294;13017298;29190;13888923
FR;0;2021-12-11;20220;76063;435108;986;480319;52673935;47010357;13452406;30176;14369242
FR;0;2021-12-12;5624;23285;142266;262;159226;52679559;47033642;13594672;30438;14528468
FR;0;2021-12-13;21059;91325;587505;1698;649187;52700618;47124967;14182177;32136;15177655
FR;0;2021-12-14;27565;118670;765354;2648;847347;52728183;47243637;14947531;34784;16025002
FR;0;2021-12-15;28192;114559;694162;2262;768908;52756375;47358196;15641693;37046;16793910
FR;0;2021-12-16;27933;116103;763852;2555;844261;52784308;47474299;16405545;39601;17638171
FR;0;2021-12-17;31542;128825;807710;2707;891979;52815850;47603124;17213255;42308;18530150
FR;0;2021-12-18;24912;81739;469898;1178;522141;52840762;47684863;17683153;43486;19052291
FR;0;2021-12-19;8740;28853;169348;377;191142;52849502;47713716;17852501;43863;19243433
FR;0;2021-12-20;31584;97551;591312;1787;658585;52881086;47811267;18443813;45650;19902018
FR;0;2021-12-21;39213;112401;682282;2391;759452;52920299;47923668;19126095;48041;20661470
FR;0;2021-12-22;39457;99679;575635;2167;642030;52959756;48023347;19701730;50208;21303500
FR;0;2021-12-23;33739;79772;440877;1654;494317;52993495;48103119;20142607;51862;21797817
FR;0;2021-12-24;10663;26050;110971;396;126632;53004158;48129169;20253578;52258;21924449
FR;0;2021-12-25;767;3497;7570;25;9026;53004925;48132666;20261148;52283;21933475
FR;0;2021-12-26;4696;11917;52073;141;60131;53009621;48144583;20313221;52424;21993606
FR;0;2021-12-27;30362;84121;453434;1366;509084;53039983;48228704;20766655;53790;22502690
FR;0;2021-12-28;38306;99077;564061;1767;632153;53078289;48327781;21330716;55557;23134843
FR;0;2021-12-29;39841;88477;501102;1686;560915;53118130;48416258;21831818;57243;23695758
FR;0;2021-12-30;35884;75091;420950;1519;471090;53154014;48491349;22252768;58762;24166848
FR;0;2021-12-31;12033;25208;116834;406;131620;53166047;48516557;22369602;59168;24298468
FR;0;2022-01-01;1324;3201;8498;36;9928;53167371;48519758;22378100;59204;24308396
FR;0;2022-01-02;6074;13004;58389;125;66929;53173445;48532762;22436489;59329;24375325
FR;0;2022-01-03;32601;89859;494672;1593;551477;53206046;48622621;22931161;60922;24926802
FR;0;2022-01-04;40877;110886;641258;2302;714200;53246923;48733507;23572419;63224;25641002
FR;0;2022-01-05;60309;103332;569036;1984;634058;53307232;48836839;24141455;65208;26275060
FR;0;2022-01-06;43924;110170;638871;2693;711312;53351156;48947009;24780326;67901;26986372
FR;0;2022-01-07;50544;123084;710898;2806;790321;53401700;49070093;25491224;70707;27776693
FR;0;2022-01-08;44950;80331;423770;1210;472841;53446650;49150424;25914994;71917;28249534
FR;0;2022-01-09;15596;26711;128545;300;145698;53462246;49177135;26043539;72217;28395232
FR;0;2022-01-10;34991;88320;469182;1810;522155;53497237;49265455;26512721;74027;28917387
FR;0;2022-01-11;41640;100150;548124;2307;608385;53538877;49365605;27060845;76334;29525772
FR;0;2022-01-12;60143;95537;452550;1964;504230;53599020;49461142;27513395;78298;30030002
FR;0;2022-01-13;37897;92321;487228;2084;540932;53636917;49553463;28000623;80382;30570934
FR;0;2022-01-14;42384;103269;568481;2286;628952;53679301;49656732;28569104;82668;31199886
FR;0;2022-01-15;39303;65815;340079;985;377536;53718604;49722547;28909183;83653;31577422
FR;0;2022-01-16;11381;19300;87381;215;99443;53729985;49741847;28996564;83868;31676865
FR;0;2022-01-17;24597;60092;320200;1380;354130;53754582;49801939;29316764;85248;32030995
FR;0;2022-01-18;28101;68509;360995;1799;397499;53782683;49870448;29677759;87047;32428494
FR;0;2022-01-19;43036;67064;281200;1448;311043;53825719;49937512;29958959;88495;32739537
FR;0;2022-01-20;23405;59455;298892;1740;328416;53849124;49996967;30257851;90235;33067953
FR;0;2022-01-21;27986;68764;366272;2085;401118;53877110;50065731;30624123;92320;33469071
FR;0;2022-01-22;27607;47866;218756;838;241743;53904717;50113597;30842879;93158;33710814
FR;0;2022-01-23;6701;13038;48645;171;55180;53911418;50126635;30891524;93329;33765994
FR;0;2022-01-24;16193;47171;217240;1136;239313;53927611;50173806;31108764;94465;34005307
FR;0;2022-01-25;18900;54184;242972;1547;267027;53946511;50227990;31351736;96012;34272334
FR;0;2022-01-26;28104;60144;209207;1296;229340;53974615;50288134;31560943;97308;34501674
FR;0;2022-01-27;16270;45898;207562;1270;225805;53990885;50334032;31768505;98578;34727479
FR;0;2022-01-28;21497;75729;289975;1573;321452;54012382;50409761;32058480;100151;35048931
FR;0;2022-01-29;18401;52842;184080;686;204568;54030783;50462603;32242560;100837;35253499
FR;0;2022-01-30;4466;14548;39124;124;45090;54035249;50477151;32281684;100961;35298589
FR;0;2022-01-31;11219;43833;148143;738;164782;54046468;50520984;32429827;101699;35463371
FR;0;2022-02-01;12805;48132;174053;1140;191356;54059273;50569116;32603880;102839;35654727
FR;0;2022-02-02;19990;65891;171450;1033;190120;54079263;50635007;32775330;103872;35844847
FR;0;2022-02-03;10952;44132;157480;984;173291;54090215;50679139;32932810;104856;36018138
FR;0;2022-02-04;14478;66432;239170;1262;264164;54104693;50745571;33171980;106118;36282302
FR;0;2022-02-05;12781;51437;153508;522;172332;54117474;50797008;33325488;106640;36454634
FR;0;2022-02-06;2705;12244;28869;99;33826;54120179;50809252;33354357;106739;36488460
FR;0;2022-02-07;9304;46643;156812;586;176309;54129483;50855895;33511169;107325;36664769
FR;0;2022-02-08;9588;42649;166554;867;184321;54139071;50898544;33677723;108192;36849090
FR;0;2022-02-09;14152;57803;172283;868;192953;54153223;50956347;33850006;109060;37042043
FR;0;2022-02-10;8262;38328;150144;878;166568;54161485;50994675;34000150;109938;37208611
FR;0;2022-02-11;10742;55432;218433;1097;243000;54172227;51050107;34218583;111035;37451611
FR;0;2022-02-12;8345;40870;134690;461;151703;54180572;51090977;34353273;111496;37603314
FR;0;2022-02-13;1894;8576;26547;82;30903;54182466;51099553;34379820;111578;37634217
FR;0;2022-02-14;6892;35093;148311;477;166303;54189358;51134646;34528131;112055;37800520
FR;0;2022-02-15;6850;35423;146895;750;162431;54196208;51170069;34675026;112805;37962951
FR;0;2022-02-16;9285;42576;132469;716;146644;54205493;51212645;34807495;113521;38109595
FR;0;2022-02-17;5366;23688;87241;584;94753;54210859;51236333;34894736;114105;38204348
FR;0;2022-02-18;6875;33219;119586;802;129236;54217734;51269552;35014322;114907;38333584
FR;0;2022-02-19;5340;24439;70002;370;77300;54223074;51293991;35084324;115277;38410884
FR;0;2022-02-20;1135;4616;12152;38;13924;54224209;51298607;35096476;115315;38424808
FR;0;2022-02-21;4020;17756;61911;351;67134;54228229;51316363;35158387;115666;38491942
FR;0;2022-02-22;4366;18467;60781;575;64406;54232595;51334830;35219168;116241;38556348
FR;0;2022-02-23;6508;27125;66455;591;71852;54239103;51361955;35285623;116832;38628200
FR;0;2022-02-24;3744;15144;50369;518;53177;54242847;51377099;35335992;117350;38681377
FR;0;2022-02-25;5195;23533;76272;803;79994;54248042;51400632;35412264;118153;38761371
FR;0;2022-02-26;3970;17643;47387;357;51452;54252012;51418275;35459651;118510;38812823
FR;0;2022-02-27;868;2985;8021;47;8932;54252880;51421260;35467672;118557;38821755
FR;0;2022-02-28;3066;12149;40440;353;42870;54255946;51433409;35508112;118910;38864625
FR;0;2022-03-01;3122;12212;44126;433;44762;54259068;51445621;35552238;119343;38909387
FR;0;2022-03-02;5072;17444;47081;438;48986;54264140;51463065;35599319;119781;38958373
FR;0;2022-03-03;2646;8877;29826;361;29918;54266786;51471942;35629145;120142;38988291
FR;0;2022-03-04;3175;12166;40252;649;39384;54269961;51484108;35669397;120791;39027675
FR;0;2022-03-05;2918;9207;24923;309;25073;54272879;51493315;35694320;121100;39052748
FR;0;2022-03-06;509;1378;3192;42;3429;54273388;51494693;35697512;121142;39056177
FR;0;2022-03-07;1936;5461;18391;313;17649;54275324;51500154;35715903;121455;39073826
FR;0;2022-03-08;1966;5878;19400;359;17857;54277290;51506032;35735303;121814;39091683
FR;0;2022-03-09;3446;10258;22141;403;21222;54280736;51516290;35757444;122217;39112905
FR;0;2022-03-10;1709;5180;16884;341;15675;54282445;51521470;35774328;122558;39128580
FR;0;2022-03-11;2341;7286;24461;538;22221;54284786;51528756;35798789;123096;39150801
FR;0;2022-03-12;2655;6709;17148;304;16497;54287441;51535465;35815937;123400;39167298
FR;0;2022-03-13;385;778;2304;144;2253;54287826;51536243;35818241;123544;39169551
FR;0;2022-03-14;1458;4126;14930;4403;13784;54289284;51540369;35833171;127947;39183335
FR;0;2022-03-15;1592;4351;16227;7549;14330;54290876;51544720;35849398;135496;39197665
FR;0;2022-03-16;2941;7029;19352;13128;18011;54293817;51551749;35868750;148624;39215676
FR;0;2022-03-17;1369;3693;13089;10835;11929;54295186;51555442;35881839;159459;39227605
FR;0;2022-03-18;2197;5498;19936;18275;18018;54297383;51560940;35901775;177734;39245623
FR;0;2022-03-19;2274;4665;13101;9395;12398;54299657;51565605;35914876;187129;39258021
FR;0;2022-03-20;291;705;1907;1065;1915;54299948;51566310;35916783;188194;39259936
FR;0;2022-03-21;1339;3119;12688;14929;11908;54301287;51569429;35929471;203123;39271844
FR;0;2022-03-22;1456;3566;13753;20517;12507;54302743;51572995;35943224;223640;39284351
FR;0;2022-03-23;2632;6062;17637;23129;17141;54305375;51579057;35960861;246769;39301492
FR;0;2022-03-24;1352;2910;11540;17569;10611;54306727;51581967;35972401;264338;39312103
FR;0;2022-03-25;2044;4798;18479;27736;16812;54308771;51586765;35990880;292074;39328915
FR;0;2022-03-26;2214;4235;12057;12655;11496;54310985;51591000;36002937;304729;39340411
FR;0;2022-03-27;353;680;1874;1474;1908;54311338;51591680;36004811;306203;39342319
FR;0;2022-03-28;1409;2915;11052;17450;10540;54312747;51594595;36015863;323653;39352859
FR;0;2022-03-29;1419;3221;12859;27528;12003;54314166;51597816;36028722;351181;39364862
FR;0;2022-03-30;2807;5356;15595;27342;14986;54316973;51603172;36044317;378523;39379848
FR;0;2022-03-31;1588;3136;12843;24857;12173;54318561;51606308;36057160;403380;39392021
FR;0;2022-04-01;2075;4269;19974;30800;18588;54320636;51610577;36077134;434180;39410609
FR;0;2022-04-02;1490;2603;9017;10096;8674;54322126;51613180;36086151;444276;39419283
FR;0;2022-04-03;272;495;1555;1168;1570;54322398;51613675;36087706;445444;39420853
FR;0;2022-04-04;1312;2518;12154;19051;11337;54323710;51616193;36099860;464495;39432190
FR;0;2022-04-05;1577;2904;14222;33968;13068;54325287;51619097;36114082;498463;39445258
FR;0;2022-04-06;2022;3605;13404;26276;12639;54327309;51622702;36127486;524739;39457897
FR;0;2022-04-07;1416;2837;13567;33531;12767;54328725;51625539;36141053;558270;39470664
FR;0;2022-04-08;2007;4057;19101;43610;17714;54330732;51629596;36160154;601880;39488378
FR;0;2022-04-09;1342;2647;9283;13533;8833;54332074;51632243;36169437;615413;39497211
FR;0;2022-04-10;271;551;1964;1992;1969;54332345;51632794;36171401;617405;39499180
FR;0;2022-04-11;1170;2445;11796;23623;11398;54333515;51635239;36183197;641028;39510578
FR;0;2022-04-12;1559;2762;13867;40480;13230;54335074;51638001;36197064;681508;39523808
FR;0;2022-04-13;1834;3392;13266;32672;12865;54336908;51641393;36210330;714180;39536673
FR;0;2022-04-14;1427;2643;13019;35865;12838;54338335;51644036;36223349;750045;39549511
FR;0;2022-04-15;1765;3266;15461;35169;14709;54340100;51647302;36238810;785214;39564220
FR;0;2022-04-16;1025;1810;6355;8510;6208;54341125;51649112;36245165;793724;39570428
FR;0;2022-04-17;183;315;989;1154;1027;54341308;51649427;36246154;794878;39571455
FR;0;2022-04-18;141;426;2719;1033;2736;54341449;51649853;36248873;795911;39574191
FR;0;2022-04-19;1458;2887;12813;29275;12317;54342907;51652740;36261686;825186;39586508
FR;0;2022-04-20;1883;3317;13120;28618;12784;54344790;51656057;36274806;853804;39599292
FR;0;2022-04-21;1464;2705;12379;34622;12404;54346254;51658762;36287185;888426;39611696
FR;0;2022-04-22;1810;3452;16360;37312;15718;54348064;51662214;36303545;925738;39627414
FR;0;2022-04-23;1108;2028;7344;10626;7191;54349172;51664242;36310889;936364;39634605
FR;0;2022-04-24;232;439;1461;1572;1396;54349404;51664681;36312350;937936;39636001
FR;0;2022-04-25;1237;2421;10595;20797;10386;54350641;51667102;36322945;958733;39646387
FR;0;2022-04-26;1541;2931;13547;38013;12978;54352182;51670033;36336492;996746;39659365
FR;0;2022-04-27;1884;2994;11404;30368;11433;54354066;51673027;36347896;1027114;39670798
FR;0;2022-04-28;1510;2615;12360;35583;12081;54355576;51675642;36360256;1062697;39682879
FR;0;2022-04-29;1931;3397;15334;36755;14674;54357507;51679039;36375590;1099452;39697553
FR;0;2022-04-30;1171;1789;6742;9621;6559;54358678;51680828;36382332;1109073;39704112
FR;0;2022-05-01;168;292;862;951;861;54358846;51681120;36383194;1110024;39704973
FR;0;2022-05-02;1121;2065;10486;17725;10268;54359967;51683185;36393680;1127749;39715241
FR;0;2022-05-03;1699;2850;13139;33952;12989;54361666;51686035;36406819;1161701;39728230
FR;0;2022-05-04;1778;2890;11246;24997;11344;54363444;51688925;36418065;1186698;39739574
FR;0;2022-05-05;1573;2582;11911;32680;11628;54365017;51691507;36429976;1219378;39751202
FR;0;2022-05-06;2014;3454;14794;36327;14279;54367031;51694961;36444770;1255705;39765481
FR;0;2022-05-07;1155;1725;6143;9538;6147;54368186;51696686;36450913;1265243;39771628
FR;0;2022-05-08;249;365;1084;1512;1143;54368435;51697051;36451997;1266755;39772771
FR;0;2022-05-09;1208;2038;8798;19731;8685;54369643;51699089;36460795;1286486;39781456
FR;0;2022-05-10;1593;2758;12183;37933;11814;54371236;51701847;36472978;1324419;39793270
FR;0;2022-05-11;1890;2620;9873;27163;9780;54373126;51704467;36482851;1351582;39803050
FR;0;2022-05-12;1482;2433;10741;34700;10352;54374608;51706900;36493592;1386282;39813402
FR;0;2022-05-13;1882;3021;12975;36943;12581;54376490;51709921;36506567;1423225;39825983
FR;0;2022-05-14;1106;1539;5447;10617;5308;54377596;51711460;36512014;1433842;39831291
FR;0;2022-05-15;256;384;1105;1398;1197;54377852;51711844;36513119;1435240;39832488
FR;0;2022-05-16;1104;1782;7210;20162;7218;54378956;51713626;36520329;1455402;39839706
FR;0;2022-05-17;1491;2374;10309;36471;9950;54380447;51716000;36530638;1491873;39849656
FR;0;2022-05-18;1692;2372;8360;25912;8294;54382139;51718372;36538998;1517785;39857950
FR;0;2022-05-19;1333;2335;9281;33362;9177;54383472;51720707;36548279;1551147;39867127
FR;0;2022-05-20;1739;2752;11569;37309;11073;54385211;51723459;36559848;1588456;39878200
FR;0;2022-05-21;1104;1544;4866;9410;4795;54386315;51725003;36564714;1597866;39882995
FR;0;2022-05-22;200;273;908;1183;895;54386515;51725276;36565622;1599049;39883890
