fra;vaccin;jour;n_dose1;n_dose2;n_dose3;n_dose4;n_rappel;n_cum_dose1;n_cum_dose2;n_cum_dose3;n_cum_dose4;n_cum_rappel
FR;1;2020-12-27;602;0;0;0;0;602;0;0;0;0
FR;1;2020-12-28;663;1;0;0;0;1265;1;0;0;0
FR;1;2020-12-29;371;0;0;0;0;1636;1;0;0;0
FR;1;2020-12-30;437;0;0;0;0;2073;1;0;0;0
FR;1;2020-12-31;413;0;0;0;0;2486;1;0;0;0
FR;1;2021-01-01;1135;1;0;0;0;3621;2;0;0;0
FR;1;2021-01-02;356;3;0;0;0;3977;5;0;0;0
FR;1;2021-01-03;399;0;0;0;0;4376;5;0;0;0
FR;1;2021-01-04;2086;2;0;0;0;6462;7;0;0;0
FR;1;2021-01-05;7558;2;0;0;0;14020;9;0;0;0
FR;1;2021-01-06;12410;10;0;0;0;26430;19;0;0;0
FR;1;2021-01-07;29445;9;0;0;0;55875;28;0;0;0
FR;1;2021-01-08;37121;9;0;0;0;92996;37;0;0;0
FR;1;2021-01-09;11209;4;0;0;0;104205;41;0;0;0
FR;1;2021-01-10;5996;3;0;0;0;110201;44;0;0;0
FR;1;2021-01-11;39922;16;0;0;0;150123;60;0;0;0
FR;1;2021-01-12;62119;15;0;0;0;212242;75;0;0;0
FR;1;2021-01-13;65096;28;0;0;0;277338;103;0;0;0
FR;1;2021-01-14;81433;71;0;0;0;358771;174;0;0;0
FR;1;2021-01-15;68592;27;0;0;0;427363;201;0;0;0
FR;1;2021-01-16;19893;70;0;0;0;447256;271;0;0;0
FR;1;2021-01-17;10896;46;0;0;0;458152;317;0;0;0
FR;1;2021-01-18;82801;163;0;0;0;540953;480;0;0;0
FR;1;2021-01-19;125896;170;0;0;0;666849;650;0;0;0
FR;1;2021-01-20;132388;166;0;0;0;799237;816;0;0;0
FR;1;2021-01-21;153032;160;0;0;0;952269;976;0;0;0
FR;1;2021-01-22;115923;194;0;0;0;1068192;1170;0;0;0
FR;1;2021-01-23;36598;63;0;0;0;1104790;1233;0;0;0
FR;1;2021-01-24;9580;68;0;0;0;1114370;1301;0;0;0
FR;1;2021-01-25;74405;1260;0;0;0;1188775;2561;0;0;0
FR;1;2021-01-26;96440;3281;1;0;0;1285215;5842;1;0;0
FR;1;2021-01-27;103625;5894;0;0;0;1388840;11736;1;0;0
FR;1;2021-01-28;120577;14919;0;0;0;1509417;26655;1;0;0
FR;1;2021-01-29;88877;17701;0;0;0;1598294;44356;1;0;0
FR;1;2021-01-30;27980;4257;0;0;0;1626274;48613;1;0;0
FR;1;2021-01-31;5180;1731;0;0;0;1631454;50344;1;0;0
FR;1;2021-02-01;49704;21504;0;0;0;1681158;71848;1;0;0
FR;1;2021-02-02;67787;35639;0;0;0;1748945;107487;1;0;0
FR;1;2021-02-03;67068;37896;0;0;0;1816013;145383;1;0;0
FR;1;2021-02-04;77116;51409;0;0;0;1893129;196792;1;0;0
FR;1;2021-02-05;63406;46052;0;0;0;1956535;242844;1;0;0
FR;1;2021-02-06;19401;10740;0;0;0;1975936;253584;1;0;0
FR;1;2021-02-07;3658;5251;0;0;0;1979594;258835;1;0;0
FR;1;2021-02-08;36480;46833;0;0;0;2016074;305668;1;0;0
FR;1;2021-02-09;50788;74209;0;0;0;2066862;379877;1;0;0
FR;1;2021-02-10;52041;79056;0;0;0;2118903;458933;1;0;0
FR;1;2021-02-11;63346;100903;0;0;0;2182249;559836;1;0;0
FR;1;2021-02-12;55836;74657;0;0;0;2238085;634493;1;0;0
FR;1;2021-02-13;15450;19252;0;0;0;2253535;653745;1;0;0
FR;1;2021-02-14;3744;7185;0;0;0;2257279;660930;1;0;0
FR;1;2021-02-15;24128;73492;0;0;0;2281407;734422;1;0;0
FR;1;2021-02-16;32753;96505;0;0;0;2314160;830927;1;0;0
FR;1;2021-02-17;35094;100074;1;0;0;2349254;931001;2;0;0
FR;1;2021-02-18;49422;115089;0;0;0;2398676;1046090;2;0;0
FR;1;2021-02-19;45365;86628;1;0;0;2444041;1132718;3;0;0
FR;1;2021-02-20;13376;27074;0;0;0;2457417;1159792;3;0;0
FR;1;2021-02-21;2454;6226;0;0;0;2459871;1166018;3;0;0
FR;1;2021-02-22;24703;69380;2;0;0;2484574;1235398;5;0;0
FR;1;2021-02-23;37412;80734;1;0;0;2521986;1316132;6;0;0
FR;1;2021-02-24;40670;78139;1;0;0;2562656;1394271;7;0;0
FR;1;2021-02-25;50131;87968;1;0;0;2612787;1482239;8;0;0
FR;1;2021-02-26;47183;67600;1;0;0;2659970;1549839;9;0;0
FR;1;2021-02-27;15667;21076;0;0;0;2675637;1570915;9;0;0
FR;1;2021-02-28;3551;4254;1;0;0;2679188;1575169;10;0;0
FR;1;2021-03-01;40142;49559;1;0;0;2719330;1624728;11;0;0
FR;1;2021-03-02;55955;61811;2;0;0;2775285;1686539;13;0;0
FR;1;2021-03-03;61197;60578;0;0;0;2836482;1747117;13;0;0
FR;1;2021-03-04;72969;66072;3;0;0;2909451;1813189;16;0;0
FR;1;2021-03-05;74732;59034;3;0;0;2984183;1872223;19;0;0
FR;1;2021-03-06;82429;15999;2;0;0;3066612;1888222;21;0;0
FR;1;2021-03-07;63702;4951;1;0;0;3130314;1893173;22;0;0
FR;1;2021-03-08;60140;42040;2;0;0;3190454;1935213;24;0;0
FR;1;2021-03-09;85958;47996;1;0;0;3276412;1983209;25;0;0
FR;1;2021-03-10;90869;47947;5;0;0;3367281;2031156;30;0;0
FR;1;2021-03-11;105030;54120;1;0;0;3472311;2085276;31;0;0
FR;1;2021-03-12;104080;45097;1;0;0;3576391;2130373;32;0;0
FR;1;2021-03-13;89179;12700;1;0;0;3665570;2143073;33;0;0
FR;1;2021-03-14;44442;2892;1;0;0;3710012;2145965;34;0;0
FR;1;2021-03-15;95471;28649;3;0;0;3805483;2174614;37;0;0
FR;1;2021-03-16;123569;34470;5;0;0;3929052;2209084;42;0;0
FR;1;2021-03-17;129275;34197;4;0;0;4058327;2243281;46;0;0
FR;1;2021-03-18;142850;39548;5;0;0;4201177;2282829;51;0;0
FR;1;2021-03-19;136212;32549;2;0;0;4337389;2315378;53;0;0
FR;1;2021-03-20;75972;10008;1;0;0;4413361;2325386;54;0;0
FR;1;2021-03-21;26494;2366;1;0;0;4439855;2327752;55;0;0
FR;1;2021-03-22;114715;30829;2;0;0;4554570;2358581;57;0;0
FR;1;2021-03-23;142993;38125;1;0;0;4697563;2396706;58;0;0
FR;1;2021-03-24;141957;38609;0;0;0;4839520;2435315;58;0;0
FR;1;2021-03-25;164966;39592;4;0;0;5004486;2474907;62;0;0
FR;1;2021-03-26;166357;37475;4;1;0;5170843;2512382;66;1;0
FR;1;2021-03-27;110865;15278;1;0;0;5281708;2527660;67;1;0
FR;1;2021-03-28;42291;3854;3;0;0;5323999;2531514;70;1;0
FR;1;2021-03-29;129784;49673;4;0;0;5453783;2581187;74;1;0
FR;1;2021-03-30;167672;63527;4;0;0;5621455;2644714;78;1;0
FR;1;2021-03-31;170887;67189;4;0;0;5792342;2711903;82;1;0
FR;1;2021-04-01;194714;80542;11;0;0;5987056;2792445;93;1;0
FR;1;2021-04-02;164409;84910;7;0;0;6151465;2877355;100;1;0
FR;1;2021-04-03;88223;58032;5;0;0;6239688;2935387;105;1;0
FR;1;2021-04-04;33573;17699;0;0;0;6273261;2953086;105;1;0
FR;1;2021-04-05;46374;9983;11;0;0;6319635;2963069;116;1;0
FR;1;2021-04-06;160256;102046;17;0;0;6479891;3065115;133;1;0
FR;1;2021-04-07;196925;108170;16;0;0;6676816;3173285;149;1;0
FR;1;2021-04-08;222042;112688;13;0;0;6898858;3285973;162;1;0
FR;1;2021-04-09;214497;107325;21;0;0;7113355;3393298;183;1;0
FR;1;2021-04-10;117148;73232;14;0;0;7230503;3466530;197;1;0
FR;1;2021-04-11;40872;30138;6;0;0;7271375;3496668;203;1;0
FR;1;2021-04-12;168407;103862;45;0;0;7439782;3600530;248;1;0
FR;1;2021-04-13;203749;128024;97;1;0;7643531;3728554;345;2;0
FR;1;2021-04-14;208536;122650;206;0;0;7852067;3851204;551;2;0
FR;1;2021-04-15;221599;127005;311;0;0;8073666;3978209;862;2;0
FR;1;2021-04-16;206001;125150;307;0;0;8279667;4103359;1169;2;0
FR;1;2021-04-17;122055;67286;103;0;0;8401722;4170645;1272;2;0
FR;1;2021-04-18;35953;20941;41;0;0;8437675;4191586;1313;2;0
FR;1;2021-04-19;163706;121702;430;0;0;8601381;4313288;1743;2;0
FR;1;2021-04-20;189353;148785;530;0;0;8790734;4462073;2273;2;0
FR;1;2021-04-21;193926;146879;758;0;0;8984660;4608952;3031;2;0
FR;1;2021-04-22;208975;163000;777;0;0;9193635;4771952;3808;2;0
FR;1;2021-04-23;198911;157022;671;0;0;9392546;4928974;4479;2;0
FR;1;2021-04-24;126298;95458;147;0;0;9518844;5024432;4626;2;0
FR;1;2021-04-25;53615;30028;46;0;0;9572459;5054460;4672;2;0
FR;1;2021-04-26;181082;138315;539;0;0;9753541;5192775;5211;2;0
FR;1;2021-04-27;221314;161824;899;0;0;9974855;5354599;6110;2;0
FR;1;2021-04-28;238232;154997;1310;1;1;10213087;5509596;7420;3;1
FR;1;2021-04-29;270219;160318;1207;0;0;10483306;5669914;8627;3;1
FR;1;2021-04-30;271922;148073;1069;0;0;10755228;5817987;9696;3;1
FR;1;2021-05-01;141112;40639;172;0;0;10896340;5858626;9868;3;1
FR;1;2021-05-02;81512;28088;81;0;0;10977852;5886714;9949;3;1
FR;1;2021-05-03;250721;145356;799;0;0;11228573;6032070;10748;3;1
FR;1;2021-05-04;265796;186886;1197;0;0;11494369;6218956;11945;3;1
FR;1;2021-05-05;283795;184690;1264;0;0;11778164;6403646;13209;3;1
FR;1;2021-05-06;309883;183191;1498;0;0;12088047;6586837;14707;3;1
FR;1;2021-05-07;284031;195613;1125;0;0;12372078;6782450;15832;3;1
FR;1;2021-05-08;191635;48571;283;0;0;12563713;6831021;16115;3;1
FR;1;2021-05-09;114045;35912;236;0;0;12677758;6866933;16351;3;1
FR;1;2021-05-10;258127;193950;1182;0;0;12935885;7060883;17533;3;1
FR;1;2021-05-11;318806;210978;1462;0;0;13254691;7271861;18995;3;1
FR;1;2021-05-12;356558;185659;1399;0;0;13611249;7457520;20394;3;1
FR;1;2021-05-13;283397;47711;399;0;0;13894646;7505231;20793;3;1
FR;1;2021-05-14;370435;128571;990;0;0;14265081;7633802;21783;3;1
FR;1;2021-05-15;298046;66089;402;0;0;14563127;7699891;22185;3;1
FR;1;2021-05-16;157745;15543;158;0;0;14720872;7715434;22343;3;1
FR;1;2021-05-17;318877;116321;1436;0;0;15039749;7831755;23779;3;1
FR;1;2021-05-18;383261;111164;1795;0;0;15423010;7942919;25574;3;1
FR;1;2021-05-19;395199;102605;2174;0;0;15818209;8045524;27748;3;1
FR;1;2021-05-20;421685;96117;2041;0;0;16239894;8141641;29789;3;1
FR;1;2021-05-21;399714;97157;1755;0;0;16639608;8238798;31544;3;1
FR;1;2021-05-22;275642;42022;602;0;0;16915250;8280820;32146;3;1
FR;1;2021-05-23;122962;11156;224;0;0;17038212;8291976;32370;3;1
FR;1;2021-05-24;243961;26214;565;0;0;17282173;8318190;32935;3;1
FR;1;2021-05-25;366118;131633;2108;1;0;17648291;8449823;35043;4;1
FR;1;2021-05-26;380732;125816;1987;0;0;18029023;8575639;37030;4;1
FR;1;2021-05-27;406049;127970;1973;0;0;18435072;8703609;39003;4;1
FR;1;2021-05-28;365933;145278;1697;0;0;18801005;8848887;40700;4;1
FR;1;2021-05-29;253798;80818;525;0;0;19054803;8929705;41225;4;1
FR;1;2021-05-30;100933;22540;157;0;0;19155736;8952245;41382;4;1
FR;1;2021-05-31;314207;148749;1279;1;1;19469943;9100994;42661;5;2
FR;1;2021-06-01;361472;166460;1724;1;1;19831415;9267454;44385;6;3
FR;1;2021-06-02;364580;153153;1791;0;0;20195995;9420607;46176;6;3
FR;1;2021-06-03;390370;147555;1647;0;0;20586365;9568162;47823;6;3
FR;1;2021-06-04;363556;175508;1492;1;1;20949921;9743670;49315;7;4
FR;1;2021-06-05;258456;112639;596;0;0;21208377;9856309;49911;7;4
FR;1;2021-06-06;126738;37544;215;0;0;21335115;9893853;50126;7;4
FR;1;2021-06-07;300106;207792;1361;0;0;21635221;10101645;51487;7;4
FR;1;2021-06-08;330537;220771;1636;0;0;21965758;10322416;53123;7;4
FR;1;2021-06-09;336383;212222;1607;0;0;22302141;10534638;54730;7;4
FR;1;2021-06-10;343681;201884;1607;0;0;22645822;10736522;56337;7;4
FR;1;2021-06-11;311724;235269;1291;0;0;22957546;10971791;57628;7;4
FR;1;2021-06-12;244024;150651;431;0;0;23201570;11122442;58059;7;4
FR;1;2021-06-13;100315;60994;188;0;0;23301885;11183436;58247;7;4
FR;1;2021-06-14;207667;288798;1316;1;0;23509552;11472234;59563;8;4
FR;1;2021-06-15;256693;282131;1390;1;0;23766245;11754365;60953;9;4
FR;1;2021-06-16;273515;270578;1261;1;0;24039760;12024943;62214;10;4
FR;1;2021-06-17;268092;244705;1231;1;0;24307852;12269648;63445;11;4
FR;1;2021-06-18;260418;295636;1149;1;0;24568270;12565284;64594;12;4
FR;1;2021-06-19;193413;209482;387;0;0;24761683;12774766;64981;12;4
FR;1;2021-06-20;69649;89149;117;0;0;24831332;12863915;65098;12;4
FR;1;2021-06-21;172192;319772;929;1;1;25003524;13183687;66027;13;5
FR;1;2021-06-22;185680;347863;1096;10;2;25189204;13531550;67123;23;7
FR;1;2021-06-23;204043;339491;1048;0;0;25393247;13871041;68171;23;7
FR;1;2021-06-24;203398;282098;1166;0;0;25596645;14153139;69337;23;7
FR;1;2021-06-25;182491;371819;1196;0;0;25779136;14524958;70533;23;7
FR;1;2021-06-26;131346;278308;502;0;0;25910482;14803266;71035;23;7
FR;1;2021-06-27;52372;122904;145;0;0;25962854;14926170;71180;23;7
FR;1;2021-06-28;136505;368134;1057;0;0;26099359;15294304;72237;23;7
FR;1;2021-06-29;154746;390693;1849;0;0;26254105;15684997;74086;23;7
FR;1;2021-06-30;179904;379365;1662;4;2;26434009;16064362;75748;27;9
FR;1;2021-07-01;201262;332207;1886;5;1;26635271;16396569;77634;32;10
FR;1;2021-07-02;193511;367666;1764;5;3;26828782;16764235;79398;37;13
FR;1;2021-07-03;124374;280450;704;3;1;26953156;17044685;80102;40;14
FR;1;2021-07-04;53904;113693;244;0;0;27007060;17158378;80346;40;14
FR;1;2021-07-05;153659;356033;1500;8;2;27160719;17514411;81846;48;16
FR;1;2021-07-06;173295;382522;1601;45;8;27334014;17896933;83447;93;24
FR;1;2021-07-07;190576;362568;1656;24;5;27524590;18259501;85103;117;29
FR;1;2021-07-08;201379;323110;1825;20;7;27725969;18582611;86928;137;36
FR;1;2021-07-09;189712;387573;1851;3;2;27915681;18970184;88779;140;38
FR;1;2021-07-10;129873;281132;814;1;1;28045554;19251316;89593;141;39
FR;1;2021-07-11;57626;102498;261;0;0;28103180;19353814;89854;141;39
FR;1;2021-07-12;149465;417027;1579;4;0;28252645;19770841;91433;145;39
FR;1;2021-07-13;234063;439471;1805;8;2;28486708;20210312;93238;153;41
FR;1;2021-07-14;171725;151540;416;0;0;28658433;20361852;93654;153;41
FR;1;2021-07-15;279458;424757;1856;1;0;28937891;20786609;95510;154;41
FR;1;2021-07-16;290257;401231;1710;3;1;29228148;21187840;97220;157;42
FR;1;2021-07-17;217275;282117;754;1;0;29445423;21469957;97974;158;42
FR;1;2021-07-18;101960;107308;288;0;0;29547383;21577265;98262;158;42
FR;1;2021-07-19;238070;379204;1495;3;0;29785453;21956469;99757;161;42
FR;1;2021-07-20;305570;380753;1467;0;0;30091023;22337222;101224;161;42
FR;1;2021-07-21;333126;353446;1412;4;2;30424149;22690668;102636;165;44
FR;1;2021-07-22;364516;319271;1501;3;2;30788665;23009939;104137;168;46
FR;1;2021-07-23;348918;343616;1586;4;2;31137583;23353555;105723;172;48
FR;1;2021-07-24;238908;240990;696;1;0;31376491;23594545;106419;173;48
FR;1;2021-07-25;112749;76060;215;0;0;31489240;23670605;106634;173;48
FR;1;2021-07-26;299001;290061;1495;2;2;31788241;23960666;108129;175;50
FR;1;2021-07-27;385699;268726;1457;4;2;32173940;24229392;109586;179;52
FR;1;2021-07-28;390082;251453;1460;4;2;32564022;24480845;111046;183;54
FR;1;2021-07-29;406016;228255;1538;2;1;32970038;24709100;112584;185;55
FR;1;2021-07-30;370590;246993;1632;4;1;33340628;24956093;114216;189;56
FR;1;2021-07-31;243352;165119;793;1;0;33583980;25121212;115009;190;56
FR;1;2021-08-01;105519;47240;232;0;0;33689499;25168452;115241;190;56
FR;1;2021-08-02;297022;213221;1475;2;0;33986521;25381673;116716;192;56
FR;1;2021-08-03;331152;209220;1545;2;1;34317673;25590893;118261;194;57
FR;1;2021-08-04;327825;184353;1436;5;3;34645498;25775246;119697;199;60
FR;1;2021-08-05;301115;193556;1482;0;0;34946613;25968802;121179;199;60
FR;1;2021-08-06;290829;224528;1558;3;1;35237442;26193330;122737;202;61
FR;1;2021-08-07;182598;158828;654;4;3;35420040;26352158;123391;206;64
FR;1;2021-08-08;68833;59132;247;0;0;35488873;26411290;123638;206;64
FR;1;2021-08-09;222627;235897;1438;4;3;35711500;26647187;125076;210;67
FR;1;2021-08-10;252496;240643;1486;2;1;35963996;26887830;126562;212;68
FR;1;2021-08-11;236036;232380;1270;5;1;36200032;27120210;127832;217;69
FR;1;2021-08-12;220616;240227;1484;3;1;36420648;27360437;129316;220;70
FR;1;2021-08-13;201621;238535;1355;2;2;36622269;27598972;130671;222;72
FR;1;2021-08-14;122811;174161;645;0;0;36745080;27773133;131316;222;72
FR;1;2021-08-15;34657;46118;198;1;0;36779737;27819251;131514;223;72
FR;1;2021-08-16;156830;289861;1421;0;0;36936567;28109112;132935;223;72
FR;1;2021-08-17;171501;291603;1419;5;1;37108068;28400715;134354;228;73
FR;1;2021-08-18;161309;287001;1389;6;3;37269377;28687716;135743;234;76
FR;1;2021-08-19;148810;277712;1396;1;0;37418187;28965428;137139;235;76
FR;1;2021-08-20;140405;309061;1524;2;2;37558592;29274489;138663;237;78
FR;1;2021-08-21;84230;213253;586;0;0;37642822;29487742;139249;237;78
FR;1;2021-08-22;28543;82691;230;0;0;37671365;29570433;139479;237;78
FR;1;2021-08-23;118580;321168;1419;2;1;37789945;29891601;140898;239;79
FR;1;2021-08-24;126591;319909;1599;5;1;37916536;30211510;142497;244;80
FR;1;2021-08-25;121457;306586;1776;8;3;38037993;30518096;144273;252;83
FR;1;2021-08-26;106511;286199;2155;10;1;38144504;30804295;146428;262;84
FR;1;2021-08-27;107590;321513;2300;8;3;38252094;31125808;148728;270;87
FR;1;2021-08-28;70966;220704;1100;0;0;38323060;31346512;149828;270;87
FR;1;2021-08-29;24135;78153;467;1;0;38347195;31424665;150295;271;87
FR;1;2021-08-30;96806;286531;4307;6;5124;38444001;31711196;154602;277;5211
FR;1;2021-08-31;98029;276454;9285;15;10180;38542030;31987650;163887;292;15391
FR;1;2021-09-01;111948;245333;21101;7;22069;38653978;32232983;184988;299;37460
FR;1;2021-09-02;84701;198006;24521;11;25421;38738679;32430989;209509;310;62881
FR;1;2021-09-03;82289;227619;26943;20;27975;38820968;32658608;236452;330;90856
FR;1;2021-09-04;71542;189711;11138;11;11650;38892510;32848319;247590;341;102506
FR;1;2021-09-05;18594;41191;4121;2;4288;38911104;32889510;251711;343;106794
FR;1;2021-09-06;59462;151635;30171;15;31143;38970566;33041145;281882;358;137937
FR;1;2021-09-07;57149;139713;30199;27;31098;39027715;33180858;312081;385;169035
FR;1;2021-09-08;71022;173877;26916;20;27863;39098737;33354735;338997;405;196898
FR;1;2021-09-09;54183;124549;28598;23;29643;39152920;33479284;367595;428;226541
FR;1;2021-09-10;65752;152097;30427;22;31554;39218672;33631381;398022;450;258095
FR;1;2021-09-11;52263;146616;9727;14;10300;39270935;33777997;407749;464;268395
FR;1;2021-09-12;10765;29241;2481;1;2635;39281700;33807238;410230;465;271030
FR;1;2021-09-13;51325;104600;38726;28;39908;39333025;33911838;448956;493;310938
FR;1;2021-09-14;53161;96049;51251;65;52862;39386186;34007887;500207;558;363800
FR;1;2021-09-15;60339;139293;50458;55;46962;39446525;34147180;550665;613;410762
FR;1;2021-09-16;46528;81415;53284;71;49462;39493053;34228595;603949;684;460224
FR;1;2021-09-17;53107;109387;45042;60;42631;39546160;34337982;648991;744;502855
FR;1;2021-09-18;37832;118490;11789;19;11254;39583992;34456472;660780;763;514109
FR;1;2021-09-19;6489;21035;2037;1;1973;39590481;34477507;662817;764;516082
FR;1;2021-09-20;36423;74919;46169;66;44083;39626904;34552426;708986;830;560165
FR;1;2021-09-21;34117;68158;56224;71;52603;39661021;34620584;765210;901;612768
FR;1;2021-09-22;38739;118503;49832;76;46810;39699760;34739087;815042;977;659578
FR;1;2021-09-23;31921;62830;54458;85;50807;39731681;34801917;869500;1062;710385
FR;1;2021-09-24;36698;90042;43636;92;41867;39768379;34891959;913136;1154;752252
FR;1;2021-09-25;27624;96604;12297;27;12161;39796003;34988563;925433;1181;764413
FR;1;2021-09-26;4357;15202;1770;5;1696;39800360;35003765;927203;1186;766109
FR;1;2021-09-27;27305;60233;42880;89;41557;39827665;35063998;970083;1275;807666
FR;1;2021-09-28;26841;49447;47154;75;44367;39854506;35113445;1017237;1350;852033
FR;1;2021-09-29;35825;80392;47243;87;45516;39890331;35193837;1064480;1437;897549
FR;1;2021-09-30;26006;46753;47489;79;45361;39916337;35240590;1111969;1516;942910
FR;1;2021-10-01;47114;64976;44853;83;44399;39963451;35305566;1156822;1599;987309
FR;1;2021-10-02;32330;62333;16103;32;16293;39995781;35367899;1172925;1631;1003602
FR;1;2021-10-03;4318;8580;2031;3;2025;40000099;35376479;1174956;1634;1005627
FR;1;2021-10-04;28730;44406;47088;79;46897;40028829;35420885;1222044;1713;1052524
FR;1;2021-10-05;24195;41625;49825;116;49168;40053024;35462510;1271869;1829;1101692
FR;1;2021-10-06;34352;61301;57440;102;57113;40087376;35523811;1329309;1931;1158805
FR;1;2021-10-07;20924;39782;52988;76;51803;40108300;35563593;1382297;2007;1210608
FR;1;2021-10-08;34929;59580;60356;83;61045;40143229;35623173;1442653;2090;1271653
FR;1;2021-10-09;27417;47962;25473;30;25969;40170646;35671135;1468126;2120;1297622
FR;1;2021-10-10;3597;5777;2746;7;2845;40174243;35676912;1470872;2127;1300467
FR;1;2021-10-11;24684;38163;54558;88;55165;40198927;35715075;1525430;2215;1355632
FR;1;2021-10-12;23065;36576;58019;126;59077;40221992;35751651;1583449;2341;1414709
FR;1;2021-10-13;32790;47787;64141;124;65603;40254782;35799438;1647590;2465;1480312
FR;1;2021-10-14;21587;34742;53723;103;54284;40276369;35834180;1701313;2568;1534596
FR;1;2021-10-15;32541;48778;72292;165;74907;40308910;35882958;1773605;2733;1609503
FR;1;2021-10-16;25956;35272;34857;44;36388;40334866;35918230;1808462;2777;1645891
FR;1;2021-10-17;3096;4065;3406;2;3317;40337962;35922295;1811868;2779;1649208
FR;1;2021-10-18;23394;34913;66803;131;69649;40361356;35957208;1878671;2910;1718857
FR;1;2021-10-19;20576;34361;75624;136;79509;40381932;35991569;1954295;3046;1798366
FR;1;2021-10-20;29791;44177;96136;177;99747;40411723;36035746;2050431;3223;1898113
FR;1;2021-10-21;19573;35075;83116;107;86972;40431296;36070821;2133547;3330;1985085
FR;1;2021-10-22;29509;47623;103696;195;109560;40460805;36118444;2237243;3525;2094645
FR;1;2021-10-23;22993;35153;44846;57;47344;40483798;36153597;2282089;3582;2141989
FR;1;2021-10-24;2373;3880;3579;6;3733;40486171;36157477;2285668;3588;2145722
FR;1;2021-10-25;22384;30813;81988;143;85753;40508555;36188290;2367656;3731;2231475
FR;1;2021-10-26;19293;27685;86056;162;90268;40527848;36215975;2453712;3893;2321743
FR;1;2021-10-27;26126;39652;107751;252;112585;40553974;36255627;2561463;4145;2434328
FR;1;2021-10-28;18575;27041;86890;150;91559;40572549;36282668;2648353;4295;2525887
FR;1;2021-10-29;25863;40121;114781;200;121502;40598412;36322789;2763134;4495;2647389
FR;1;2021-10-30;17662;28597;49338;75;51912;40616074;36351386;2812472;4570;2699301
FR;1;2021-10-31;2053;3204;3442;2;3677;40618127;36354590;2815914;4572;2702978
FR;1;2021-11-01;7692;4195;3018;3;3260;40625819;36358785;2818932;4575;2706238
FR;1;2021-11-02;21814;33194;92336;157;97671;40647633;36391979;2911268;4732;2803909
FR;1;2021-11-03;26260;41507;117434;215;123777;40673893;36433486;3028702;4947;2927686
FR;1;2021-11-04;19480;30281;105726;213;111807;40693373;36463767;3134428;5160;3039493
FR;1;2021-11-05;26893;42242;138710;227;147281;40720266;36506009;3273138;5387;3186774
FR;1;2021-11-06;18800;29823;63437;123;66402;40739066;36535832;3336575;5510;3253176
FR;1;2021-11-07;1787;3356;4952;6;5293;40740853;36539188;3341527;5516;3258469
FR;1;2021-11-08;17649;32309;125896;224;132447;40758502;36571497;3467423;5740;3390916
FR;1;2021-11-09;19208;37706;159207;335;168903;40777710;36609203;3626630;6075;3559819
FR;1;2021-11-10;28640;49138;181811;440;192347;40806350;36658341;3808441;6515;3752166
FR;1;2021-11-11;3766;5920;12187;26;12996;40810116;36664261;3820628;6541;3765162
FR;1;2021-11-12;25924;46874;174735;243;186331;40836040;36711135;3995363;6784;3951493
FR;1;2021-11-13;18676;29249;76798;111;81736;40854716;36740384;4072161;6895;4033229
FR;1;2021-11-14;2014;3320;6811;5;7385;40856730;36743704;4078972;6900;4040614
FR;1;2021-11-15;18562;34896;156328;303;166086;40875292;36778600;4235300;7203;4206700
FR;1;2021-11-16;21041;37920;191996;376;204766;40896333;36816520;4427296;7579;4411466
FR;1;2021-11-17;28477;45723;193138;399;204904;40924810;36862243;4620434;7978;4616370
FR;1;2021-11-18;21040;38771;182379;457;194344;40945850;36901014;4802813;8435;4810714
FR;1;2021-11-19;30768;53372;230136;529;246549;40976618;36954386;5032949;8964;5057263
FR;1;2021-11-20;23669;33317;96935;201;103571;41000287;36987703;5129884;9165;5160834
FR;1;2021-11-21;2312;4016;9095;18;9968;41002599;36991719;5138979;9183;5170802
FR;1;2021-11-22;21345;30453;175785;465;189297;41023944;37022172;5314764;9648;5360099
FR;1;2021-11-23;23852;41148;221083;538;237766;41047796;37063320;5535847;10186;5597865
FR;1;2021-11-24;30252;49735;217248;703;234348;41078048;37113055;5753095;10889;5832213
FR;1;2021-11-25;23476;43954;244335;719;263901;41101524;37157009;5997430;11608;6096114
FR;1;2021-11-26;30579;66549;356662;832;388351;41132103;37223558;6354092;12440;6484465
FR;1;2021-11-27;21752;45358;202544;371;222510;41153855;37268916;6556636;12811;6706975
FR;1;2021-11-28;3136;9677;54750;63;61029;41156991;37278593;6611386;12874;6768004
FR;1;2021-11-29;17853;49512;326259;840;354234;41174844;37328105;6937645;13714;7122238
FR;1;2021-11-30;22685;64985;431020;948;470584;41197529;37393090;7368665;14662;7592822
FR;1;2021-12-01;24825;69357;442733;1130;481570;41222354;37462447;7811398;15792;8074392
FR;1;2021-12-02;19952;64417;489238;1227;532670;41242306;37526864;8300636;17019;8607062
FR;1;2021-12-03;22808;81815;542593;1307;591567;41265114;37608679;8843229;18326;9198629
FR;1;2021-12-04;16364;53932;299018;652;328849;41281478;37662611;9142247;18978;9527478
FR;1;2021-12-05;3622;13919;81495;143;91049;41285100;37676530;9223742;19121;9618527
FR;1;2021-12-06;19958;62784;415293;1065;455006;41305058;37739314;9639035;20186;10073533
FR;1;2021-12-07;19777;75817;522795;1531;572388;41324835;37815131;10161830;21717;10645921
FR;1;2021-12-08;21539;75786;458202;1543;501874;41346374;37890917;10620032;23260;11147795
FR;1;2021-12-09;19385;74105;492746;1625;540608;41365759;37965022;11112778;24885;11688403
FR;1;2021-12-10;22897;87631;547252;1584;599844;41388656;38052653;11660030;26469;12288247
FR;1;2021-12-11;16509;59019;302670;747;335420;41405165;38111672;11962700;27216;12623667
FR;1;2021-12-12;4343;16025;83176;179;94082;41409508;38127697;12045876;27395;12717749
FR;1;2021-12-13;15452;63817;366819;1094;406184;41424960;38191514;12412695;28489;13123933
FR;1;2021-12-14;20429;80286;464530;1738;515005;41445389;38271800;12877225;30227;13638938
FR;1;2021-12-15;21359;77480;408906;1307;452980;41466748;38349280;13286131;31534;14091918
FR;1;2021-12-16;19945;77380;451668;1574;500453;41486693;38426660;13737799;33108;14592371
FR;1;2021-12-17;22502;86716;479779;1732;530921;41509195;38513376;14217578;34840;15123292
FR;1;2021-12-18;17581;54702;257554;730;288461;41526776;38568078;14475132;35570;15411753
FR;1;2021-12-19;5536;17133;79128;194;90742;41532312;38585211;14554260;35764;15502495
FR;1;2021-12-20;20769;63158;316087;1081;355156;41553081;38648369;14870347;36845;15857651
FR;1;2021-12-21;26094;73201;372614;1421;417964;41579175;38721570;15242961;38266;16275615
FR;1;2021-12-22;24888;65986;310496;1215;349466;41604063;38787556;15553457;39481;16625081
FR;1;2021-12-23;21228;52348;241381;954;272981;41625291;38839904;15794838;40435;16898062
FR;1;2021-12-24;7098;18243;67102;256;77020;41632389;38858147;15861940;40691;16975082
FR;1;2021-12-25;499;2766;5566;15;6527;41632888;38860913;15867506;40706;16981609
FR;1;2021-12-26;2747;7597;26921;70;31446;41635635;38868510;15894427;40776;17013055
FR;1;2021-12-27;18159;53569;235010;707;265697;41653794;38922079;16129437;41483;17278752
FR;1;2021-12-28;23237;61989;291942;1025;330123;41677031;38984068;16421379;42508;17608875
FR;1;2021-12-29;22192;55549;254909;918;288127;41699223;39039617;16676288;43426;17897002
FR;1;2021-12-30;21219;46279;212083;857;239548;41720442;39085896;16888371;44283;18136550
FR;1;2021-12-31;7454;16613;61831;229;70356;41727896;39102509;16950202;44512;18206906
FR;1;2022-01-01;893;2476;5641;29;6571;41728789;39104985;16955843;44541;18213477
FR;1;2022-01-02;3040;8068;28869;50;33522;41731829;39113053;16984712;44591;18246999
FR;1;2022-01-03;19881;53812;228100;786;257497;41751710;39166865;17212812;45377;18504496
FR;1;2022-01-04;24926;64816;299143;1235;337179;41776636;39231681;17511955;46612;18841675
FR;1;2022-01-05;29657;63860;274760;1098;310102;41806293;39295541;17786715;47710;19151777
FR;1;2022-01-06;26478;65975;306791;1395;346420;41832771;39361516;18093506;49105;19498197
FR;1;2022-01-07;31289;74646;349749;1534;393827;41864060;39436162;18443255;50639;19892024
FR;1;2022-01-08;23340;51373;222457;695;251086;41887400;39487535;18665712;51334;20143110
FR;1;2022-01-09;7076;17201;66007;163;76155;41894476;39504736;18731719;51497;20219265
FR;1;2022-01-10;21400;55409;236679;952;267037;41915876;39560145;18968398;52449;20486302
FR;1;2022-01-11;26472;63006;282191;1277;317734;41942348;39623151;19250589;53726;20804036
FR;1;2022-01-12;28686;62217;246140;1102;277911;41971034;39685368;19496729;54828;21081947
FR;1;2022-01-13;24414;59884;262696;1253;296031;41995448;39745252;19759425;56081;21377978
FR;1;2022-01-14;27763;66520;313896;1366;351177;42023211;39811772;20073321;57447;21729155
FR;1;2022-01-15;19254;44310;199264;619;223836;42042465;39856082;20272585;58066;21952991
FR;1;2022-01-16;5133;12990;51495;135;59574;42047598;39869072;20324080;58201;22012565
FR;1;2022-01-17;16728;39711;184771;779;206827;42064326;39908783;20508851;58980;22219392
FR;1;2022-01-18;19237;45661;212349;1151;236973;42083563;39954444;20721200;60131;22456365
FR;1;2022-01-19;20134;43898;176031;894;197160;42103697;39998342;20897231;61025;22653525
FR;1;2022-01-20;16585;40350;183573;1137;204653;42120282;40038692;21080804;62162;22858178
FR;1;2022-01-21;19702;46944;228877;1404;253290;42139984;40085636;21309681;63566;23111468
FR;1;2022-01-22;13825;33195;144464;578;161361;42153809;40118831;21454145;64144;23272829
FR;1;2022-01-23;3344;8809;33399;130;38329;42157153;40127640;21487544;64274;23311158
FR;1;2022-01-24;11725;32628;142155;706;158241;42168878;40160268;21629699;64980;23469399
FR;1;2022-01-25;14088;37947;163332;1049;181516;42182966;40198215;21793031;66029;23650915
FR;1;2022-01-26;14819;37347;150193;931;166251;42197785;40235562;21943224;66960;23817166
FR;1;2022-01-27;12278;32836;143382;882;157863;42210063;40268398;22086606;67842;23975029
FR;1;2022-01-28;16247;53835;198239;1143;222451;42226310;40322233;22284845;68985;24197480
FR;1;2022-01-29;10257;35428;135172;522;151540;42236567;40357661;22420017;69507;24349020
FR;1;2022-01-30;2475;9309;29667;86;34466;42239042;40366970;22449684;69593;24383486
FR;1;2022-01-31;8725;32348;104297;530;117388;42247767;40399318;22553981;70123;24500874
FR;1;2022-02-01;10161;36247;127013;862;141220;42257928;40435565;22680994;70985;24642094
FR;1;2022-02-02;11393;41082;130287;780;145833;42269321;40476647;22811281;71765;24787927
FR;1;2022-02-03;8715;33372;116952;780;130350;42278036;40510019;22928233;72545;24918277
FR;1;2022-02-04;11375;48081;172516;965;192778;42289411;40558100;23100749;73510;25111055
FR;1;2022-02-05;7881;33910;117547;391;133049;42297292;40592010;23218296;73901;25244104
FR;1;2022-02-06;1690;8057;22734;83;26908;42298982;40600067;23241030;73984;25271012
FR;1;2022-02-07;7036;35337;119035;452;134966;42306018;40635404;23360065;74436;25405978
FR;1;2022-02-08;7553;31528;125595;693;140569;42313571;40666932;23485660;75129;25546547
FR;1;2022-02-09;8439;36078;135199;692;152410;42322010;40703010;23620859;75821;25698957
FR;1;2022-02-10;6571;29248;116290;673;130031;42328581;40732258;23737149;76494;25828988
FR;1;2022-02-11;8543;41310;165068;875;185273;42337124;40773568;23902217;77369;26014261
FR;1;2022-02-12;5287;27523;106671;378;120842;42342411;40801091;24008888;77747;26135103
FR;1;2022-02-13;1220;5696;21703;62;25314;42343631;40806787;24030591;77809;26160417
FR;1;2022-02-14;5357;27064;118030;388;133049;42348988;40833851;24148621;78197;26293466
FR;1;2022-02-15;5579;28077;118838;609;132426;42354567;40861928;24267459;78806;26425892
FR;1;2022-02-16;5637;28082;110368;592;122962;42360204;40890010;24377827;79398;26548854
FR;1;2022-02-17;4406;19096;73087;486;80132;42364610;40909106;24450914;79884;26628986
FR;1;2022-02-18;5486;26434;99139;668;108077;42370096;40935540;24550053;80552;26737063
FR;1;2022-02-19;3523;17076;59457;304;66027;42373619;40952616;24609510;80856;26803090
FR;1;2022-02-20;780;3223;10689;35;12310;42374399;40955839;24620199;80891;26815400
FR;1;2022-02-21;3353;14462;52790;286;57634;42377752;40970301;24672989;81177;26873034
FR;1;2022-02-22;3708;15349;51868;499;55588;42381460;40985650;24724857;81676;26928622
FR;1;2022-02-23;4152;17593;57440;508;62537;42385612;41003243;24782297;82184;26991159
FR;1;2022-02-24;3240;12732;43562;436;46339;42388852;41015975;24825859;82620;27037498
FR;1;2022-02-25;4389;19385;64837;695;68699;42393241;41035360;24890696;83315;27106197
FR;1;2022-02-26;2676;12679;41341;308;45093;42395917;41048039;24932037;83623;27151290
FR;1;2022-02-27;636;2166;7114;42;7979;42396553;41050205;24939151;83665;27159269
FR;1;2022-02-28;2560;10063;34916;300;37338;42399113;41060268;24974067;83965;27196607
FR;1;2022-03-01;2708;10364;38635;389;39556;42401821;41070632;25012702;84354;27236163
FR;1;2022-03-02;3425;11848;41804;390;43850;42405246;41082480;25054506;84744;27280013
FR;1;2022-03-03;2284;7508;26115;319;26427;42407530;41089988;25080621;85063;27306440
FR;1;2022-03-04;2645;10202;35384;575;34862;42410175;41100190;25116005;85638;27341302
FR;1;2022-03-05;1668;6289;21938;277;22323;42411843;41106479;25137943;85915;27363625
FR;1;2022-03-06;348;935;2914;37;3112;42412191;41107414;25140857;85952;27366737
FR;1;2022-03-07;1361;4554;16404;244;15857;42413552;41111968;25157261;86196;27382594
FR;1;2022-03-08;1529;5078;17121;307;15940;42415081;41117046;25174382;86503;27398534
FR;1;2022-03-09;1858;6445;19772;366;19117;42416939;41123491;25194154;86869;27417651
FR;1;2022-03-10;1293;4347;15183;304;14189;42418232;41127838;25209337;87173;27431840
FR;1;2022-03-11;1689;6139;21668;480;19815;42419921;41133977;25231005;87653;27451655
FR;1;2022-03-12;1226;4589;15350;276;14894;42421147;41138566;25246355;87929;27466549
FR;1;2022-03-13;239;601;2101;115;2048;42421386;41139167;25248456;88044;27468597
FR;1;2022-03-14;1061;3533;13357;3873;12482;42422447;41142700;25261813;91917;27481079
FR;1;2022-03-15;1253;3816;14515;6861;12992;42423700;41146516;25276328;98778;27494071
FR;1;2022-03-16;1599;4714;17312;11513;16361;42425299;41151230;25293640;110291;27510432
FR;1;2022-03-17;1090;3138;11674;9637;10768;42426389;41154368;25305314;119928;27521200
FR;1;2022-03-18;1658;4677;17901;16482;16329;42428047;41159045;25323215;136410;27537529
FR;1;2022-03-19;1109;3166;11878;8450;11343;42429156;41162211;25335093;144860;27548872
FR;1;2022-03-20;216;531;1714;1006;1746;42429372;41162742;25336807;145866;27550618
FR;1;2022-03-21;1033;2672;11462;13440;10807;42430405;41165414;25348269;159306;27561425
FR;1;2022-03-22;1184;3047;12214;18681;11200;42431589;41168461;25360483;177987;27572625
FR;1;2022-03-23;1458;4146;15944;20090;15624;42433047;41172607;25376427;198077;27588249
FR;1;2022-03-24;1068;2505;10346;16012;9597;42434115;41175112;25386773;214089;27597846
FR;1;2022-03-25;1491;4005;16643;25278;15300;42435606;41179117;25403416;239367;27613146
FR;1;2022-03-26;1095;2834;10834;11425;10492;42436701;41181951;25414250;250792;27623638
FR;1;2022-03-27;227;536;1721;1376;1773;42436928;41182487;25415971;252168;27625411
FR;1;2022-03-28;1031;2327;9902;15859;9519;42437959;41184814;25425873;268027;27634930
FR;1;2022-03-29;1109;2693;11495;25059;10861;42439068;41187507;25437368;293086;27645791
FR;1;2022-03-30;1588;3449;14082;24145;13611;42440656;41190956;25451450;317231;27659402
FR;1;2022-03-31;1254;2582;11524;22539;11029;42441910;41193538;25462974;339770;27670431
FR;1;2022-04-01;1637;3713;18385;28445;17233;42443547;41197251;25481359;368215;27687664
FR;1;2022-04-02;879;1850;8158;9203;7906;42444426;41199101;25489517;377418;27695570
FR;1;2022-04-03;183;362;1426;1056;1426;42444609;41199463;25490943;378474;27696996
FR;1;2022-04-04;1032;2111;11100;17593;10469;42445641;41201574;25502043;396067;27707465
FR;1;2022-04-05;1237;2465;12889;31088;11906;42446878;41204039;25514932;427155;27719371
FR;1;2022-04-06;1306;2678;12061;23736;11473;42448184;41206717;25526993;450891;27730844
FR;1;2022-04-07;1122;2455;12250;30814;11703;42449306;41209172;25539243;481705;27742547
FR;1;2022-04-08;1548;3448;17447;40316;16357;42450854;41212620;25556690;522021;27758904
FR;1;2022-04-09;796;1969;8376;12470;8070;42451650;41214589;25565066;534491;27766974
FR;1;2022-04-10;180;451;1815;1830;1847;42451830;41215040;25566881;536321;27768821
FR;1;2022-04-11;932;2086;10903;22101;10611;42452762;41217126;25577784;558422;27779432
FR;1;2022-04-12;1184;2369;12680;37743;12165;42453946;41219495;25590464;596165;27791597
FR;1;2022-04-13;1147;2572;12114;30231;11835;42455093;41222067;25602578;626396;27803432
FR;1;2022-04-14;1159;2273;11927;33195;11907;42456252;41224340;25614505;659591;27815339
FR;1;2022-04-15;1392;2759;14244;32878;13618;42457644;41227099;25628749;692469;27828957
FR;1;2022-04-16;644;1386;5806;7964;5727;42458288;41228485;25634555;700433;27834684
FR;1;2022-04-17;148;270;926;1101;968;42458436;41228755;25635481;701534;27835652
FR;1;2022-04-18;114;364;2589;968;2612;42458550;41229119;25638070;702502;27838264
FR;1;2022-04-19;1179;2467;11679;27520;11311;42459729;41231586;25649749;730022;27849575
FR;1;2022-04-20;1240;2496;11994;26489;11819;42460969;41234082;25661743;756511;27861394
FR;1;2022-04-21;1197;2315;11381;32737;11546;42462166;41236397;25673124;789248;27872940
FR;1;2022-04-22;1459;2929;15110;35224;14688;42463625;41239326;25688234;824472;27887628
FR;1;2022-04-23;722;1549;6693;9857;6596;42464347;41240875;25694927;834329;27894224
FR;1;2022-04-24;180;352;1362;1503;1315;42464527;41241227;25696289;835832;27895539
FR;1;2022-04-25;973;2014;9765;19475;9649;42465500;41243241;25706054;855307;27905188
FR;1;2022-04-26;1273;2553;12486;36107;12073;42466773;41245794;25718540;891414;27917261
FR;1;2022-04-27;1251;2344;10516;28645;10623;42468024;41248138;25729056;920059;27927884
FR;1;2022-04-28;1230;2260;11390;33664;11212;42469254;41250398;25740446;953723;27939096
FR;1;2022-04-29;1547;2866;14164;34999;13582;42470801;41253264;25754610;988722;27952678
FR;1;2022-04-30;795;1421;6268;9074;6098;42471596;41254685;25760878;997796;27958776
FR;1;2022-05-01;135;254;779;909;777;42471731;41254939;25761657;998705;27959553
FR;1;2022-05-02;865;1738;9515;16469;9407;42472596;41256677;25771172;1015174;27968960
FR;1;2022-05-03;1333;2465;12036;32194;11949;42473929;41259142;25783208;1047368;27980909
FR;1;2022-05-04;1247;2324;10032;23207;10172;42475176;41261466;25793240;1070575;27991081
FR;1;2022-05-05;1290;2269;10854;30950;10648;42476466;41263735;25804094;1101525;28001729
FR;1;2022-05-06;1631;3035;13569;34422;13138;42478097;41266770;25817663;1135947;28014867
FR;1;2022-05-07;804;1414;5625;9017;5665;42478901;41268184;25823288;1144964;28020532
FR;1;2022-05-08;178;292;916;1437;983;42479079;41268476;25824204;1146401;28021515
FR;1;2022-05-09;971;1753;7977;18717;7890;42480050;41270229;25832181;1165118;28029405
FR;1;2022-05-10;1316;2390;11176;36113;10859;42481366;41272619;25843357;1201231;28040264
FR;1;2022-05-11;1336;2094;8993;25220;8903;42482702;41274713;25852350;1226451;28049167
FR;1;2022-05-12;1217;2136;9799;32545;9427;42483919;41276849;25862149;1258996;28058594
FR;1;2022-05-13;1523;2583;11881;34866;11534;42485442;41279432;25874030;1293862;28070128
FR;1;2022-05-14;741;1227;4962;10023;4848;42486183;41280659;25878992;1303885;28074976
FR;1;2022-05-15;197;332;1003;1303;1083;42486380;41280991;25879995;1305188;28076059
FR;1;2022-05-16;884;1526;6611;19073;6657;42487264;41282517;25886606;1324261;28082716
FR;1;2022-05-17;1186;2061;9589;34462;9253;42488450;41284578;25896195;1358723;28091969
FR;1;2022-05-18;1165;1853;7664;24199;7602;42489615;41286431;25903859;1382922;28099571
FR;1;2022-05-19;1050;2021;8282;30740;8257;42490665;41288452;25912141;1413662;28107828
FR;2;2020-12-27;0;0;0;0;0;0;0;0;0;0
FR;2;2020-12-28;0;0;0;0;0;0;0;0;0;0
FR;2;2020-12-29;0;0;0;0;0;0;0;0;0;0
FR;2;2020-12-30;0;0;0;0;0;0;0;0;0;0
FR;2;2020-12-31;0;0;0;0;0;0;0;0;0;0
FR;2;2021-01-01;0;0;0;0;0;0;0;0;0;0
FR;2;2021-01-02;0;0;0;0;0;0;0;0;0;0
FR;2;2021-01-03;0;0;0;0;0;0;0;0;0;0
FR;2;2021-01-04;0;0;0;0;0;0;0;0;0;0
FR;2;2021-01-05;0;0;0;0;0;0;0;0;0;0
FR;2;2021-01-06;0;0;0;0;0;0;0;0;0;0
FR;2;2021-01-07;0;0;0;0;0;0;0;0;0;0
FR;2;2021-01-08;0;0;0;0;0;0;0;0;0;0
FR;2;2021-01-09;0;0;0;0;0;0;0;0;0;0
FR;2;2021-01-10;0;0;0;0;0;0;0;0;0;0
FR;2;2021-01-11;0;0;0;0;0;0;0;0;0;0
FR;2;2021-01-12;0;0;0;0;0;0;0;0;0;0
FR;2;2021-01-13;0;0;0;0;0;0;0;0;0;0
FR;2;2021-01-14;1690;0;0;0;0;1690;0;0;0;0
FR;2;2021-01-15;394;0;0;0;0;2084;0;0;0;0
FR;2;2021-01-16;315;0;0;0;0;2399;0;0;0;0
FR;2;2021-01-17;80;0;0;0;0;2479;0;0;0;0
FR;2;2021-01-18;3073;2;0;0;0;5552;2;0;0;0
FR;2;2021-01-19;4675;0;0;0;0;10227;2;0;0;0
FR;2;2021-01-20;5135;4;0;0;0;15362;6;0;0;0
FR;2;2021-01-21;5336;8;0;0;0;20698;14;0;0;0
FR;2;2021-01-22;5115;5;0;0;0;25813;19;0;0;0
FR;2;2021-01-23;1866;0;0;0;0;27679;19;0;0;0
FR;2;2021-01-24;160;1;0;0;0;27839;20;0;0;0
FR;2;2021-01-25;3811;3;0;0;0;31650;23;0;0;0
FR;2;2021-01-26;3918;1;0;0;0;35568;24;0;0;0
FR;2;2021-01-27;3597;2;0;0;0;39165;26;0;0;0
FR;2;2021-01-28;3745;6;0;0;0;42910;32;0;0;0
FR;2;2021-01-29;3291;2;0;0;0;46201;34;0;0;0
FR;2;2021-01-30;1130;1;0;0;0;47331;35;0;0;0
FR;2;2021-01-31;45;1;0;0;0;47376;36;0;0;0
FR;2;2021-02-01;3399;3;0;0;0;50775;39;0;0;0
FR;2;2021-02-02;4487;10;0;0;0;55262;49;0;0;0
FR;2;2021-02-03;5216;6;0;0;0;60478;55;0;0;0
FR;2;2021-02-04;4931;10;0;0;0;65409;65;0;0;0
FR;2;2021-02-05;4810;13;0;0;0;70219;78;0;0;0
FR;2;2021-02-06;2040;12;0;0;0;72259;90;0;0;0
FR;2;2021-02-07;101;4;0;0;0;72360;94;0;0;0
FR;2;2021-02-08;7553;19;0;0;0;79913;113;0;0;0
FR;2;2021-02-09;8420;27;0;0;0;88333;140;0;0;0
FR;2;2021-02-10;9336;56;0;0;0;97669;196;0;0;0
FR;2;2021-02-11;10279;95;0;0;0;107948;291;0;0;0
FR;2;2021-02-12;10053;260;0;0;0;118001;551;0;0;0
FR;2;2021-02-13;3118;225;0;0;0;121119;776;0;0;0
FR;2;2021-02-14;354;8;0;0;0;121473;784;0;0;0
FR;2;2021-02-15;3454;3094;0;0;0;124927;3878;0;0;0
FR;2;2021-02-16;5066;4021;0;0;0;129993;7899;0;0;0
FR;2;2021-02-17;4251;4466;0;0;0;134244;12365;0;0;0
FR;2;2021-02-18;5399;5116;0;0;0;139643;17481;0;0;0
FR;2;2021-02-19;5324;4394;0;0;0;144967;21875;0;0;0
FR;2;2021-02-20;1868;1508;0;0;0;146835;23383;0;0;0
FR;2;2021-02-21;242;88;0;0;0;147077;23471;0;0;0
FR;2;2021-02-22;3611;3745;0;0;0;150688;27216;0;0;0
FR;2;2021-02-23;4952;3694;0;0;0;155640;30910;0;0;0
FR;2;2021-02-24;5009;3491;0;0;0;160649;34401;0;0;0
FR;2;2021-02-25;5481;3452;0;0;0;166130;37853;0;0;0
FR;2;2021-02-26;4356;3146;0;0;0;170486;40999;0;0;0
FR;2;2021-02-27;1623;1053;0;0;0;172109;42052;0;0;0
FR;2;2021-02-28;176;29;0;0;0;172285;42081;0;0;0
FR;2;2021-03-01;5176;3727;0;0;0;177461;45808;0;0;0
FR;2;2021-03-02;6528;4723;0;0;0;183989;50531;0;0;0
FR;2;2021-03-03;6533;4919;0;0;0;190522;55450;0;0;0
FR;2;2021-03-04;8394;4050;0;0;0;198916;59500;0;0;0
FR;2;2021-03-05;8026;4059;0;0;0;206942;63559;0;0;0
FR;2;2021-03-06;4783;1683;0;0;0;211725;65242;0;0;0
FR;2;2021-03-07;2372;30;0;0;0;214097;65272;0;0;0
FR;2;2021-03-08;4164;8330;0;0;0;218261;73602;0;0;0
FR;2;2021-03-09;7485;8493;1;0;0;225746;82095;1;0;0
FR;2;2021-03-10;7098;9138;0;0;0;232844;91233;1;0;0
FR;2;2021-03-11;9372;9236;1;0;0;242216;100469;2;0;0
FR;2;2021-03-12;7972;8220;0;0;0;250188;108689;2;0;0
FR;2;2021-03-13;10046;2554;0;0;0;260234;111243;2;0;0
FR;2;2021-03-14;4838;404;0;0;0;265072;111647;2;0;0
FR;2;2021-03-15;10905;3485;0;0;0;275977;115132;2;0;0
FR;2;2021-03-16;16760;4647;1;0;0;292737;119779;3;0;0
FR;2;2021-03-17;20223;3973;0;0;0;312960;123752;3;0;0
FR;2;2021-03-18;23363;4970;0;0;0;336323;128722;3;0;0
FR;2;2021-03-19;23301;4574;0;0;0;359624;133296;3;0;0
FR;2;2021-03-20;25441;1547;0;0;0;385065;134843;3;0;0
FR;2;2021-03-21;17669;149;0;0;0;402734;134992;3;0;0
FR;2;2021-03-22;17782;3138;0;0;0;420516;138130;3;0;0
FR;2;2021-03-23;22686;4201;0;0;0;443202;142331;3;0;0
FR;2;2021-03-24;23954;5013;0;0;0;467156;147344;3;0;0
FR;2;2021-03-25;26736;5136;1;0;0;493892;152480;4;0;0
FR;2;2021-03-26;26975;4198;0;0;0;520867;156678;4;0;0
FR;2;2021-03-27;15917;1328;0;0;0;536784;158006;4;0;0
FR;2;2021-03-28;10561;119;0;0;0;547345;158125;4;0;0
FR;2;2021-03-29;18984;4283;0;0;0;566329;162408;4;0;0
FR;2;2021-03-30;24575;6026;0;0;0;590904;168434;4;0;0
FR;2;2021-03-31;28553;5930;0;0;0;619457;174364;4;0;0
FR;2;2021-04-01;34544;8495;1;0;0;654001;182859;5;0;0
FR;2;2021-04-02;29976;7668;0;0;0;683977;190527;5;0;0
FR;2;2021-04-03;16952;3759;0;0;0;700929;194286;5;0;0
FR;2;2021-04-04;9305;1018;2;0;0;710234;195304;7;0;0
FR;2;2021-04-05;12443;806;0;0;0;722677;196110;7;0;0
FR;2;2021-04-06;27142;7024;0;0;0;749819;203134;7;0;0
FR;2;2021-04-07;30925;7143;1;0;0;780744;210277;8;0;0
FR;2;2021-04-08;36879;8734;1;0;0;817623;219011;9;0;0
FR;2;2021-04-09;33833;8547;28;0;0;851456;227558;37;0;0
FR;2;2021-04-10;19678;9054;1;0;0;871134;236612;38;0;0
FR;2;2021-04-11;7941;4256;1;0;0;879075;240868;39;0;0
FR;2;2021-04-12;17121;11148;0;0;0;896196;252016;39;0;0
FR;2;2021-04-13;19448;16202;1;0;0;915644;268218;40;0;0
FR;2;2021-04-14;18060;16296;7;0;0;933704;284514;47;0;0
FR;2;2021-04-15;22184;20955;27;0;0;955888;305469;74;0;0
FR;2;2021-04-16;20704;20132;45;0;0;976592;325601;119;0;0
FR;2;2021-04-17;13253;22429;5;0;0;989845;348030;124;0;0
FR;2;2021-04-18;5906;14392;6;0;0;995751;362422;130;0;0
FR;2;2021-04-19;16830;16271;24;0;0;1012581;378693;154;0;0
FR;2;2021-04-20;19317;21587;38;0;0;1031898;400280;192;0;0
FR;2;2021-04-21;20280;21701;76;0;0;1052178;421981;268;0;0
FR;2;2021-04-22;23809;24862;41;0;0;1075987;446843;309;0;0
FR;2;2021-04-23;24515;25348;76;0;0;1100502;472191;385;0;0
FR;2;2021-04-24;25300;15088;104;0;0;1125802;487279;489;0;0
FR;2;2021-04-25;9592;8600;5;0;0;1135394;495879;494;0;0
FR;2;2021-04-26;17157;17245;21;0;0;1152551;513124;515;0;0
FR;2;2021-04-27;19240;24223;40;0;0;1171791;537347;555;0;0
FR;2;2021-04-28;22331;26217;112;0;0;1194122;563564;667;0;0
FR;2;2021-04-29;25465;30147;69;0;0;1219587;593711;736;0;0
FR;2;2021-04-30;25529;27739;49;1;0;1245116;621450;785;1;0
FR;2;2021-05-01;14980;9876;6;0;0;1260096;631326;791;1;0
FR;2;2021-05-02;6635;9173;2;0;0;1266731;640499;793;1;0
FR;2;2021-05-03;20012;19253;40;0;0;1286743;659752;833;1;0
FR;2;2021-05-04;18280;29035;33;0;0;1305023;688787;866;1;0
FR;2;2021-05-05;18359;29382;48;0;0;1323382;718169;914;1;0
FR;2;2021-05-06;23538;35232;131;0;0;1346920;753401;1045;1;0
FR;2;2021-05-07;25322;33196;97;0;0;1372242;786597;1142;1;0
FR;2;2021-05-08;21336;9805;14;0;0;1393578;796402;1156;1;0
FR;2;2021-05-09;13162;7843;7;0;0;1406740;804245;1163;1;0
FR;2;2021-05-10;32937;22120;49;0;0;1439677;826365;1212;1;0
FR;2;2021-05-11;43596;21034;101;0;0;1483273;847399;1313;1;0
FR;2;2021-05-12;50039;19841;143;0;0;1533312;867240;1456;1;0
FR;2;2021-05-13;51289;5748;31;0;0;1584601;872988;1487;1;0
FR;2;2021-05-14;61343;12919;132;0;0;1645944;885907;1619;1;0
FR;2;2021-05-15;65923;7136;39;0;0;1711867;893043;1658;1;0
FR;2;2021-05-16;43580;2567;10;0;0;1755447;895610;1668;1;0
FR;2;2021-05-17;44742;12567;113;0;0;1800189;908177;1781;1;0
FR;2;2021-05-18;54633;12237;191;0;0;1854822;920414;1972;1;0
FR;2;2021-05-19;57163;10598;281;0;0;1911985;931012;2253;1;0
FR;2;2021-05-20;63429;10837;287;0;0;1975414;941849;2540;1;0
FR;2;2021-05-21;64287;11638;230;0;0;2039701;953487;2770;1;0
FR;2;2021-05-22;61478;4506;65;0;0;2101179;957993;2835;1;0
FR;2;2021-05-23;37531;570;22;0;0;2138710;958563;2857;1;0
FR;2;2021-05-24;17235;2034;34;0;0;2155945;960597;2891;1;0
FR;2;2021-05-25;21102;12224;240;0;0;2177047;972821;3131;1;0
FR;2;2021-05-26;19932;11454;229;0;0;2196979;984275;3360;1;0
FR;2;2021-05-27;22993;12663;182;0;0;2219972;996938;3542;1;0
FR;2;2021-05-28;29387;14946;190;0;0;2249359;1011884;3732;1;0
FR;2;2021-05-29;30416;8175;57;0;0;2279775;1020059;3789;1;0
FR;2;2021-05-30;4646;1814;6;0;0;2284421;1021873;3795;1;0
FR;2;2021-05-31;28584;18712;183;0;0;2313005;1040585;3978;1;0
FR;2;2021-06-01;45710;20007;224;0;0;2358715;1060592;4202;1;0
FR;2;2021-06-02;37461;19293;181;0;0;2396176;1079885;4383;1;0
FR;2;2021-06-03;51269;23323;161;0;0;2447445;1103208;4544;1;0
FR;2;2021-06-04;65508;24055;215;0;0;2512953;1127263;4759;1;0
FR;2;2021-06-05;34598;24032;51;0;0;2547551;1151295;4810;1;0
FR;2;2021-06-06;4953;6198;10;0;0;2552504;1157493;4820;1;0
FR;2;2021-06-07;28165;23039;146;0;0;2580669;1180532;4966;1;0
FR;2;2021-06-08;46368;22916;143;0;0;2627037;1203448;5109;1;0
FR;2;2021-06-09;34284;20918;107;0;0;2661321;1224366;5216;1;0
FR;2;2021-06-10;42635;19131;95;1;0;2703956;1243497;5311;2;0
FR;2;2021-06-11;55287;25220;134;0;0;2759243;1268717;5445;2;0
FR;2;2021-06-12;30559;19776;53;0;0;2789802;1288493;5498;2;0
FR;2;2021-06-13;3329;9186;13;0;0;2793131;1297679;5511;2;0
FR;2;2021-06-14;25295;24156;92;0;0;2818426;1321835;5603;2;0
FR;2;2021-06-15;39033;22844;154;0;0;2857459;1344679;5757;2;0
FR;2;2021-06-16;30158;21438;134;0;0;2887617;1366117;5891;2;0
FR;2;2021-06-17;36903;25858;150;0;0;2924520;1391975;6041;2;0
FR;2;2021-06-18;46845;28814;122;0;0;2971365;1420789;6163;2;0
FR;2;2021-06-19;24524;24892;39;0;0;2995889;1445681;6202;2;0
FR;2;2021-06-20;3742;10063;10;0;0;2999631;1455744;6212;2;0
FR;2;2021-06-21;17521;42838;87;0;0;3017152;1498582;6299;2;0
FR;2;2021-06-22;28353;49561;110;0;0;3045505;1548143;6409;2;0
FR;2;2021-06-23;21787;49555;106;1;1;3067292;1597698;6515;3;1
FR;2;2021-06-24;28375;50279;133;0;0;3095667;1647977;6648;3;1
FR;2;2021-06-25;33398;60392;127;0;0;3129065;1708369;6775;3;1
FR;2;2021-06-26;16379;59246;54;1;0;3145444;1767615;6829;4;1
FR;2;2021-06-27;2564;29322;22;1;0;3148008;1796937;6851;5;1
FR;2;2021-06-28;12637;54342;82;0;0;3160645;1851279;6933;5;1
FR;2;2021-06-29;19841;59885;178;0;0;3180486;1911164;7111;5;1
FR;2;2021-06-30;16321;57870;252;17;0;3196807;1969034;7363;22;1
FR;2;2021-07-01;20482;59892;227;0;0;3217289;2028926;7590;22;1
FR;2;2021-07-02;24069;62132;184;0;0;3241358;2091058;7774;22;1
FR;2;2021-07-03;12111;57085;153;0;0;3253469;2148143;7927;22;1
FR;2;2021-07-04;1958;23308;18;0;0;3255427;2171451;7945;22;1
FR;2;2021-07-05;9170;29365;106;0;0;3264597;2200816;8051;22;1
FR;2;2021-07-06;14574;36203;135;0;0;3279171;2237019;8186;22;1
FR;2;2021-07-07;14404;33672;139;0;0;3293575;2270691;8325;22;1
FR;2;2021-07-08;19713;40295;162;0;0;3313288;2310986;8487;22;1
FR;2;2021-07-09;27093;54269;202;1;0;3340381;2365255;8689;23;1
FR;2;2021-07-10;13384;33662;107;0;0;3353765;2398917;8796;23;1
FR;2;2021-07-11;1805;4350;16;0;0;3355570;2403267;8812;23;1
FR;2;2021-07-12;12960;37278;118;0;0;3368530;2440545;8930;23;1
FR;2;2021-07-13;37108;53220;150;0;0;3405638;2493765;9080;23;1
FR;2;2021-07-14;6607;3559;15;0;0;3412245;2497324;9095;23;1
FR;2;2021-07-15;47231;47026;156;0;0;3459476;2544350;9251;23;1
FR;2;2021-07-16;64306;55814;187;0;0;3523782;2600164;9438;23;1
FR;2;2021-07-17;31592;23931;96;0;0;3555374;2624095;9534;23;1
FR;2;2021-07-18;6087;4881;19;0;0;3561461;2628976;9553;23;1
FR;2;2021-07-19;32987;28679;94;0;0;3594448;2657655;9647;23;1
FR;2;2021-07-20;51989;44565;155;0;0;3646437;2702220;9802;23;1
FR;2;2021-07-21;45243;34754;93;0;0;3691680;2736974;9895;23;1
FR;2;2021-07-22;56272;41097;128;1;0;3747952;2778071;10023;24;1
FR;2;2021-07-23;68275;49084;170;0;0;3816227;2827155;10193;24;1
FR;2;2021-07-24;36165;21590;82;0;0;3852392;2848745;10275;24;1
FR;2;2021-07-25;6742;2654;10;0;0;3859134;2851399;10285;24;1
FR;2;2021-07-26;36296;22452;91;1;0;3895430;2873851;10376;25;1
FR;2;2021-07-27;62353;34623;180;0;0;3957783;2908474;10556;25;1
FR;2;2021-07-28;55297;26455;132;0;0;4013080;2934929;10688;25;1
FR;2;2021-07-29;68455;32785;189;0;0;4081535;2967714;10877;25;1
FR;2;2021-07-30;74431;37774;222;1;1;4155966;3005488;11099;26;2
FR;2;2021-07-31;34750;16187;104;0;0;4190716;3021675;11203;26;2
FR;2;2021-08-01;5397;2284;19;0;0;4196113;3023959;11222;26;2
FR;2;2021-08-02;35860;16201;101;0;0;4231973;3040160;11323;26;2
FR;2;2021-08-03;55959;28291;142;0;0;4287932;3068451;11465;26;2
FR;2;2021-08-04;46621;20864;128;1;0;4334553;3089315;11593;27;2
FR;2;2021-08-05;54617;31585;215;0;0;4389170;3120900;11808;27;2
FR;2;2021-08-06;58080;42390;242;1;0;4447250;3163290;12050;28;2
FR;2;2021-08-07;25132;17599;89;0;0;4472382;3180889;12139;28;2
FR;2;2021-08-08;3832;3669;21;0;0;4476214;3184558;12160;28;2
FR;2;2021-08-09;29295;21131;91;0;0;4505509;3205689;12251;28;2
FR;2;2021-08-10;44988;33516;154;0;0;4550497;3239205;12405;28;2
FR;2;2021-08-11;35264;25172;151;0;0;4585761;3264377;12556;28;2
FR;2;2021-08-12;41892;35727;162;0;0;4627653;3300104;12718;28;2
FR;2;2021-08-13;42585;37055;218;0;0;4670238;3337159;12936;28;2
FR;2;2021-08-14;18508;22256;93;0;0;4688746;3359415;13029;28;2
FR;2;2021-08-15;3817;3815;17;0;0;4692563;3363230;13046;28;2
FR;2;2021-08-16;25077;27199;110;0;0;4717640;3390429;13156;28;2
FR;2;2021-08-17;38249;43486;205;2;0;4755889;3433915;13361;30;2
FR;2;2021-08-18;32246;36370;195;1;1;4788135;3470285;13556;31;3
FR;2;2021-08-19;37427;46587;224;0;0;4825562;3516872;13780;31;3
FR;2;2021-08-20;40555;55606;269;1;0;4866117;3572478;14049;32;3
FR;2;2021-08-21;18116;24306;114;0;0;4884233;3596784;14163;32;3
FR;2;2021-08-22;2902;4319;22;1;1;4887135;3601103;14185;33;4
FR;2;2021-08-23;19239;35159;131;1;1;4906374;3636262;14316;34;5
FR;2;2021-08-24;31939;56032;235;0;0;4938313;3692294;14551;34;5
FR;2;2021-08-25;25926;43430;250;0;0;4964239;3735724;14801;34;5
FR;2;2021-08-26;32350;55791;387;0;0;4996589;3791515;15188;34;5
FR;2;2021-08-27;36992;65593;478;2;0;5033581;3857108;15666;36;5
FR;2;2021-08-28;17813;28472;300;0;0;5051394;3885580;15966;36;5
FR;2;2021-08-29;2655;5038;47;0;0;5054049;3890618;16013;36;5
FR;2;2021-08-30;18409;37751;399;0;753;5072458;3928369;16412;36;758
FR;2;2021-08-31;28077;57489;884;4;1536;5100535;3985858;17296;40;2294
FR;2;2021-09-01;21589;39842;1307;0;2091;5122124;4025700;18603;40;4385
FR;2;2021-09-02;25476;48611;1960;2;3290;5147600;4074311;20563;42;7675
FR;2;2021-09-03;33404;64475;2986;3;4827;5181004;4138786;23549;45;12502
FR;2;2021-09-04;16826;27702;1442;1;2354;5197830;4166488;24991;46;14856
FR;2;2021-09-05;2259;3607;265;0;412;5200089;4170095;25256;46;15268
FR;2;2021-09-06;14034;28732;1769;1;2930;5214123;4198827;27025;47;18198
FR;2;2021-09-07;21102;41051;3020;13;4855;5235225;4239878;30045;60;23053
FR;2;2021-09-08;17240;31934;2732;6;4469;5252465;4271812;32777;66;27522
FR;2;2021-09-09;20972;40432;4432;3;6754;5273437;4312244;37209;69;34276
FR;2;2021-09-10;28196;51147;5281;4;8823;5301633;4363391;42490;73;43099
FR;2;2021-09-11;13652;22354;2403;5;3937;5315285;4385745;44893;78;47036
FR;2;2021-09-12;1822;2786;284;0;506;5317107;4388531;45177;78;47542
FR;2;2021-09-13;11656;21446;2468;4;4009;5328763;4409977;47645;82;51551
FR;2;2021-09-14;18567;32770;5084;13;9037;5347330;4442747;52729;95;60588
FR;2;2021-09-15;14910;28282;5164;3;7780;5362240;4471029;57893;98;68368
FR;2;2021-09-16;16069;32766;6735;14;10530;5378309;4503795;64628;112;78898
FR;2;2021-09-17;20911;47084;8775;10;14571;5399220;4550879;73403;122;93469
FR;2;2021-09-18;9855;20926;3803;6;6022;5409075;4571805;77206;128;99491
FR;2;2021-09-19;1165;2648;395;0;645;5410240;4574453;77601;128;100136
FR;2;2021-09-20;7490;18784;3851;7;6153;5417730;4593237;81452;135;106289
FR;2;2021-09-21;11205;29998;6494;5;10739;5428935;4623235;87946;140;117028
FR;2;2021-09-22;9406;23549;5491;7;8512;5438341;4646784;93437;147;125540
FR;2;2021-09-23;10721;28872;7879;9;12636;5449062;4675656;101316;156;138176
FR;2;2021-09-24;15063;42863;10873;18;17189;5464125;4718519;112189;174;155365
FR;2;2021-09-25;7258;18731;3962;10;6083;5471383;4737250;116151;184;161448
FR;2;2021-09-26;1079;2558;494;0;632;5472462;4739808;116645;184;162080
FR;2;2021-09-27;6312;16451;4286;8;6551;5478774;4756259;120931;192;168631
FR;2;2021-09-28;9239;25549;7768;13;12071;5488013;4781808;128699;205;180702
FR;2;2021-09-29;8080;20210;6066;25;9261;5496093;4802018;134765;230;189963
FR;2;2021-09-30;9862;25783;9503;16;14075;5505955;4827801;144268;246;204038
FR;2;2021-10-01;13967;35634;12912;25;19228;5519922;4863435;157180;271;223266
FR;2;2021-10-02;6873;15883;4845;6;7012;5526795;4879318;162025;277;230278
FR;2;2021-10-03;841;1939;491;1;512;5527636;4881257;162516;278;230790
FR;2;2021-10-04;5818;13925;5516;5;7856;5533454;4895182;168032;283;238646
FR;2;2021-10-05;9052;22546;11121;19;15712;5542506;4917728;179153;302;254358
FR;2;2021-10-06;7778;17736;8238;11;11068;5550284;4935464;187391;313;265426
FR;2;2021-10-07;9193;22174;12378;15;16832;5559477;4957638;199769;328;282258
FR;2;2021-10-08;13423;32053;17345;27;23535;5572900;4989691;217114;355;305793
FR;2;2021-10-09;5999;12824;6041;6;7875;5578899;5002515;223155;361;313668
FR;2;2021-10-10;883;1635;436;2;633;5579782;5004150;223591;363;314301
FR;2;2021-10-11;5604;11603;6454;17;8837;5585386;5015753;230045;380;323138
FR;2;2021-10-12;8035;17754;12536;13;16728;5593421;5033507;242581;393;339866
FR;2;2021-10-13;6944;14848;10245;11;13608;5600365;5048355;252826;404;353474
FR;2;2021-10-14;8310;17940;14989;13;19450;5608675;5066295;267815;417;372924
FR;2;2021-10-15;11845;26276;20901;26;27943;5620520;5092571;288716;443;400867
FR;2;2021-10-16;5137;8722;1816;0;3204;5625657;5101293;290532;443;404071
FR;2;2021-10-17;651;1187;184;0;373;5626308;5102480;290716;443;404444
FR;2;2021-10-18;4558;7417;661;2;1671;5630866;5109897;291377;445;406115
FR;2;2021-10-19;6238;9900;729;5;2055;5637104;5119797;292106;450;408170
FR;2;2021-10-20;5162;8100;756;3;1684;5642266;5127897;292862;453;409854
FR;2;2021-10-21;6088;9966;779;5;2101;5648354;5137863;293641;458;411955
FR;2;2021-10-22;8446;14573;1147;4;2873;5656800;5152436;294788;462;414828
FR;2;2021-10-23;3840;5996;584;0;1234;5660640;5158432;295372;462;416062
FR;2;2021-10-24;494;888;100;0;203;5661134;5159320;295472;462;416265
FR;2;2021-10-25;3357;5371;301;1;825;5664491;5164691;295773;463;417090
FR;2;2021-10-26;4173;7257;1124;4;2004;5668664;5171948;296897;467;419094
FR;2;2021-10-27;3672;6626;1193;5;1998;5672336;5178574;298090;472;421092
FR;2;2021-10-28;4596;7694;1727;3;2745;5676932;5186268;299817;475;423837
FR;2;2021-10-29;5405;11080;2430;4;3667;5682337;5197348;302247;479;427504
FR;2;2021-10-30;2748;4435;972;1;1428;5685085;5201783;303219;480;428932
FR;2;2021-10-31;363;534;139;1;186;5685448;5202317;303358;481;429118
FR;2;2021-11-01;416;560;174;0;266;5685864;5202877;303532;481;429384
FR;2;2021-11-02;3287;6761;1179;0;1757;5689151;5209638;304711;481;431141
FR;2;2021-11-03;3337;6251;1383;2;1965;5692488;5215889;306094;483;433106
FR;2;2021-11-04;3985;7099;1760;4;2491;5696473;5222988;307854;487;435597
FR;2;2021-11-05;5226;10509;2863;5;3944;5701699;5233497;310717;492;439541
FR;2;2021-11-06;2594;4670;1397;0;1809;5704293;5238167;312114;492;441350
FR;2;2021-11-07;508;864;216;0;285;5704801;5239031;312330;492;441635
FR;2;2021-11-08;2575;5361;1201;3;1678;5707376;5244392;313531;495;443313
FR;2;2021-11-09;2749;6946;2392;6;3173;5710125;5251338;315923;501;446486
FR;2;2021-11-10;2584;5711;5093;6;6271;5712709;5257049;321016;507;452757
FR;2;2021-11-11;433;744;732;2;915;5713142;5257793;321748;509;453672
FR;2;2021-11-12;2951;8110;8963;8;10901;5716093;5265903;330711;517;464573
FR;2;2021-11-13;1534;3381;3865;7;4528;5717627;5269284;334576;524;469101
FR;2;2021-11-14;254;603;348;1;485;5717881;5269887;334924;525;469586
FR;2;2021-11-15;1622;3693;4434;9;5318;5719503;5273580;339358;534;474904
FR;2;2021-11-16;2184;5947;8293;14;10070;5721687;5279527;347651;548;484974
FR;2;2021-11-17;1740;4566;6619;8;7835;5723427;5284093;354270;556;492809
FR;2;2021-11-18;2189;5948;9167;11;10992;5725616;5290041;363437;567;503801
FR;2;2021-11-19;2697;7804;12958;19;15464;5728313;5297845;376395;586;519265
FR;2;2021-11-20;1563;3331;5169;5;6073;5729876;5301176;381564;591;525338
FR;2;2021-11-21;246;518;540;0;663;5730122;5301694;382104;591;526001
FR;2;2021-11-22;1275;2623;4469;5;5401;5731397;5304317;386573;596;531402
FR;2;2021-11-23;1613;4314;8186;9;9895;5733010;5308631;394759;605;541297
FR;2;2021-11-24;1418;3800;7462;14;8720;5734428;5312431;402221;619;550017
FR;2;2021-11-25;1812;4893;11447;21;13642;5736240;5317324;413668;640;563659
FR;2;2021-11-26;2537;7776;22650;31;26063;5738777;5325100;436318;671;589722
FR;2;2021-11-27;1497;4130;12255;18;13992;5740274;5329230;448573;689;603714
FR;2;2021-11-28;291;842;1965;3;2286;5740565;5330072;450538;692;606000
FR;2;2021-11-29;1444;4388;15073;23;17244;5742009;5334460;465611;715;623244
FR;2;2021-11-30;1913;6752;26220;36;29973;5743922;5341212;491831;751;653217
FR;2;2021-12-01;1904;6101;26182;29;29501;5745826;5347313;518013;780;682718
FR;2;2021-12-02;1908;6830;37684;52;41928;5747734;5354143;555697;832;724646
FR;2;2021-12-03;2550;10109;53586;112;59308;5750284;5364252;609283;944;783954
FR;2;2021-12-04;1849;6303;37089;38;40764;5752133;5370555;646372;982;824718
FR;2;2021-12-05;458;2263;14252;14;15988;5752591;5372818;660624;996;840706
FR;2;2021-12-06;2464;9897;77682;109;84731;5755055;5382715;738306;1105;925437
FR;2;2021-12-07;3445;15332;122407;238;133690;5758500;5398047;860713;1343;1059127
FR;2;2021-12-08;3717;16056;133169;330;145369;5762217;5414103;993882;1673;1204496
FR;2;2021-12-09;4543;19628;170142;554;185499;5766760;5433731;1164024;2227;1389995
FR;2;2021-12-10;4672;22811;188607;490;206038;5771432;5456542;1352631;2717;1596033
FR;2;2021-12-11;3682;16625;132420;239;144854;5775114;5473167;1485051;2956;1740887
FR;2;2021-12-12;1257;7130;59080;83;65127;5776371;5480297;1544131;3039;1806014
FR;2;2021-12-13;5525;26860;220652;604;242932;5781896;5507157;1764783;3643;2048946
FR;2;2021-12-14;7016;37535;300711;910;332183;5788912;5544692;2065494;4553;2381129
FR;2;2021-12-15;6559;36239;285170;955;315768;5795471;5580931;2350664;5508;2696897
FR;2;2021-12-16;7762;37921;312099;981;343681;5803233;5618852;2662763;6489;3040578
FR;2;2021-12-17;8680;41246;327828;975;360905;5811913;5660098;2990591;7464;3401483
FR;2;2021-12-18;6516;26560;212316;448;233614;5818429;5686658;3202907;7912;3635097
FR;2;2021-12-19;2600;11492;90201;184;100379;5821029;5698150;3293108;8096;3735476
FR;2;2021-12-20;9549;33603;275152;706;303316;5830578;5731753;3568260;8802;4038792
FR;2;2021-12-21;11555;38325;309587;969;341374;5842133;5770078;3877847;9771;4380166
FR;2;2021-12-22;10458;32856;265080;952;292465;5852591;5802934;4142927;10723;4672631
FR;2;2021-12-23;9427;26710;199457;700;221259;5862018;5829644;4342384;11423;4893890
FR;2;2021-12-24;2781;7495;43845;140;49558;5864799;5837139;4386229;11563;4943448
FR;2;2021-12-25;201;700;2000;10;2495;5865000;5837839;4388229;11573;4945943
FR;2;2021-12-26;1322;4216;25146;71;28677;5866322;5842055;4413375;11644;4974620
FR;2;2021-12-27;8075;29941;218377;659;243299;5874397;5871996;4631752;12303;5217919
FR;2;2021-12-28;9840;36336;272062;741;301945;5884237;5908332;4903814;13044;5519864
FR;2;2021-12-29;9492;32293;246104;766;272680;5893729;5940625;5149918;13810;5792544
FR;2;2021-12-30;9453;28141;208807;662;231466;5903182;5968766;5358725;14472;6024010
FR;2;2021-12-31;3007;8378;54979;177;61237;5906189;5977144;5413704;14649;6085247
FR;2;2022-01-01;227;692;2849;7;3344;5906416;5977836;5416553;14656;6088591
FR;2;2022-01-02;1505;4854;29505;75;33390;5907921;5982690;5446058;14731;6121981
FR;2;2022-01-03;9583;35370;266501;806;293861;5917504;6018060;5712559;15537;6415842
FR;2;2022-01-04;12842;45374;342059;1067;376942;5930346;6063434;6054618;16604;6792784
FR;2;2022-01-05;11269;38661;294151;885;323805;5941615;6102095;6348769;17489;7116589
FR;2;2022-01-06;13649;43491;331927;1298;364701;5955264;6145586;6680696;18787;7481290
FR;2;2022-01-07;14220;47638;361072;1270;396403;5969484;6193224;7041768;20057;7877693
FR;2;2022-01-08;7946;28148;201255;515;221683;5977430;6221372;7243023;20572;8099376
FR;2;2022-01-09;2749;8995;62519;137;69522;5980179;6230367;7305542;20709;8168898
FR;2;2022-01-10;10086;31925;232448;858;255036;5990265;6262292;7537990;21567;8423934
FR;2;2022-01-11;11470;36254;265881;1030;290573;6001735;6298546;7803871;22597;8714507
FR;2;2022-01-12;8758;29841;206298;862;226176;6010493;6328387;8010169;23459;8940683
FR;2;2022-01-13;9387;31347;224461;831;244809;6019880;6359734;8234630;24290;9185492
FR;2;2022-01-14;9743;35663;254517;919;277678;6029623;6395397;8489147;25209;9463170
FR;2;2022-01-15;5355;19453;140766;359;153634;6034978;6414850;8629913;25568;9616804
FR;2;2022-01-16;1512;5522;35870;80;39849;6036490;6420372;8665783;25648;9656653
FR;2;2022-01-17;5545;19303;135384;601;147248;6042035;6439675;8801167;26249;9803901
FR;2;2022-01-18;6417;21529;148608;648;160469;6048452;6461204;8949775;26897;9964370
FR;2;2022-01-19;4389;16359;105081;552;113698;6052841;6477563;9054856;27449;10078068
FR;2;2022-01-20;4867;17595;115275;603;123672;6057708;6495158;9170131;28052;10201740
FR;2;2022-01-21;5194;20064;137324;678;147743;6062902;6515222;9307455;28730;10349483
FR;2;2022-01-22;3027;10964;74254;259;80327;6065929;6526186;9381709;28989;10429810
FR;2;2022-01-23;722;2736;15236;41;16837;6066651;6528922;9396945;29030;10446647
FR;2;2022-01-24;3293;12824;75057;430;81017;6069944;6541746;9472002;29460;10527664
FR;2;2022-01-25;3570;14437;79611;495;85447;6073514;6556183;9551613;29955;10613111
FR;2;2022-01-26;2515;10660;58958;363;62982;6076029;6566843;9610571;30318;10676093
FR;2;2022-01-27;2683;11265;64164;388;67902;6078712;6578108;9674735;30706;10743995
FR;2;2022-01-28;3543;18385;91710;430;98960;6082255;6596493;9766445;31136;10842955
FR;2;2022-01-29;1892;9252;48835;164;52921;6084147;6605745;9815280;31300;10895876
FR;2;2022-01-30;466;2242;9453;38;10606;6084613;6607987;9824733;31338;10906482
FR;2;2022-01-31;1887;9590;43817;208;47340;6086500;6617577;9868550;31546;10953822
FR;2;2022-02-01;1912;10049;47018;278;50100;6088412;6627626;9915568;31824;11003922
FR;2;2022-02-02;1605;9033;41100;251;44174;6090017;6636659;9956668;32075;11048096
FR;2;2022-02-03;1722;8943;40507;204;42906;6091739;6645602;9997175;32279;11091002
FR;2;2022-02-04;2152;15217;66626;297;71346;6093891;6660819;10063801;32576;11162348
FR;2;2022-02-05;1362;8536;35935;131;39232;6095253;6669355;10099736;32707;11201580
FR;2;2022-02-06;274;1780;6124;16;6899;6095527;6671135;10105860;32723;11208479
FR;2;2022-02-07;1350;9609;37746;133;41304;6096877;6680744;10143606;32856;11249783
FR;2;2022-02-08;1298;9811;40926;173;43710;6098175;6690555;10184532;33029;11293493
FR;2;2022-02-09;1160;8812;37032;172;40451;6099335;6699367;10221564;33201;11333944
FR;2;2022-02-10;1024;7985;33831;203;36498;6100359;6707352;10255395;33404;11370442
FR;2;2022-02-11;1388;12077;53338;222;57683;6101747;6719429;10308733;33626;11428125
FR;2;2022-02-12;749;6529;27985;83;30802;6102496;6725958;10336718;33709;11458927
FR;2;2022-02-13;200;1335;4833;20;5574;6102696;6727293;10341551;33729;11464501
FR;2;2022-02-14;834;6726;30262;89;33225;6103530;6734019;10371813;33818;11497726
FR;2;2022-02-15;771;6447;28044;141;29981;6104301;6740466;10399857;33959;11527707
FR;2;2022-02-16;656;5340;22048;123;23607;6104957;6745806;10421905;34082;11551314
FR;2;2022-02-17;513;3770;14144;98;14608;6105470;6749576;10436049;34180;11565922
FR;2;2022-02-18;721;5361;20428;134;21124;6106191;6754937;10456477;34314;11587046
FR;2;2022-02-19;430;3047;10527;66;11241;6106621;6757984;10467004;34380;11598287
FR;2;2022-02-20;101;512;1456;3;1604;6106722;6758496;10468460;34383;11599891
FR;2;2022-02-21;420;2682;9117;65;9493;6107142;6761178;10477577;34448;11609384
FR;2;2022-02-22;390;2565;8887;76;8791;6107532;6763743;10486464;34524;11618175
FR;2;2022-02-23;432;2600;8986;82;9265;6107964;6766343;10495450;34606;11627440
FR;2;2022-02-24;313;2028;6796;81;6824;6108277;6768371;10502246;34687;11634264
FR;2;2022-02-25;455;3194;11414;108;11277;6108732;6771565;10513660;34795;11645541
FR;2;2022-02-26;294;1889;6035;49;6340;6109026;6773454;10519695;34844;11651881
FR;2;2022-02-27;75;312;905;5;948;6109101;6773766;10520600;34849;11652829
FR;2;2022-02-28;330;1680;5519;53;5527;6109431;6775446;10526119;34902;11658356
FR;2;2022-03-01;274;1557;5473;44;5191;6109705;6777003;10531592;34946;11663547
FR;2;2022-03-02;296;1429;5242;43;5082;6110001;6778432;10536834;34989;11668629
FR;2;2022-03-03;225;1101;3703;42;3478;6110226;6779533;10540537;35031;11672107
FR;2;2022-03-04;240;1461;4852;73;4497;6110466;6780994;10545389;35104;11676604
FR;2;2022-03-05;172;903;2973;32;2716;6110638;6781897;10548362;35136;11679320
FR;2;2022-03-06;40;181;277;5;316;6110678;6782078;10548639;35141;11679636
FR;2;2022-03-07;155;652;1981;69;1772;6110833;6782730;10550620;35210;11681408
FR;2;2022-03-08;143;652;2270;51;1902;6110976;6783382;10552890;35261;11683310
FR;2;2022-03-09;152;695;2341;37;2042;6111128;6784077;10555231;35298;11685352
FR;2;2022-03-10;119;593;1686;34;1458;6111247;6784670;10556917;35332;11686810
FR;2;2022-03-11;169;752;2767;57;2365;6111416;6785422;10559684;35389;11689175
FR;2;2022-03-12;143;480;1784;27;1553;6111559;6785902;10561468;35416;11690728
FR;2;2022-03-13;25;75;201;29;202;6111584;6785977;10561669;35445;11690930
FR;2;2022-03-14;124;464;1560;529;1289;6111708;6786441;10563229;35974;11692219
FR;2;2022-03-15;138;417;1705;688;1321;6111846;6786858;10564934;36662;11693540
FR;2;2022-03-16;140;461;2010;1611;1587;6111986;6787319;10566944;38273;11695127
FR;2;2022-03-17;93;412;1404;1192;1141;6112079;6787731;10568348;39465;11696268
FR;2;2022-03-18;144;489;2016;1787;1659;6112223;6788220;10570364;41252;11697927
FR;2;2022-03-19;108;318;1209;940;1013;6112331;6788538;10571573;42192;11698940
FR;2;2022-03-20;12;76;190;59;166;6112343;6788614;10571763;42251;11699106
FR;2;2022-03-21;96;301;1209;1481;1073;6112439;6788915;10572972;43732;11700179
FR;2;2022-03-22;116;382;1528;1827;1290;6112555;6789297;10574500;45559;11701469
FR;2;2022-03-23;137;343;1664;3031;1455;6112692;6789640;10576164;48590;11702924
FR;2;2022-03-24;115;290;1180;1546;996;6112807;6789930;10577344;50136;11703920
FR;2;2022-03-25;119;360;1801;2449;1471;6112926;6790290;10579145;52585;11705391
FR;2;2022-03-26;76;246;1202;1220;952;6113002;6790536;10580347;53805;11706343
FR;2;2022-03-27;19;36;150;98;130;6113021;6790572;10580497;53903;11706473
FR;2;2022-03-28;93;285;1133;1588;992;6113114;6790857;10581630;55491;11707465
FR;2;2022-03-29;106;257;1324;2462;1104;6113220;6791114;10582954;57953;11708569
FR;2;2022-03-30;91;312;1482;3183;1315;6113311;6791426;10584436;61136;11709884
FR;2;2022-03-31;103;279;1268;2312;1082;6113414;6791705;10585704;63448;11710966
FR;2;2022-04-01;119;313;1559;2340;1311;6113533;6792018;10587263;65788;11712277
FR;2;2022-04-02;72;160;845;889;737;6113605;6792178;10588108;66677;11713014
FR;2;2022-04-03;16;53;128;112;142;6113621;6792231;10588236;66789;11713156
FR;2;2022-04-04;106;224;982;1434;789;6113727;6792455;10589218;68223;11713945
FR;2;2022-04-05;142;286;1301;2868;1129;6113869;6792741;10590519;71091;11715074
FR;2;2022-04-06;87;242;1301;2498;1111;6113956;6792983;10591820;73589;11716185
FR;2;2022-04-07;118;214;1295;2681;1034;6114074;6793197;10593115;76270;11717219
FR;2;2022-04-08;123;327;1617;3207;1316;6114197;6793524;10594732;79477;11718535
FR;2;2022-04-09;90;218;896;1045;731;6114287;6793742;10595628;80522;11719266
FR;2;2022-04-10;37;44;143;161;116;6114324;6793786;10595771;80683;11719382
FR;2;2022-04-11;85;184;878;1518;769;6114409;6793970;10596649;82201;11720151
FR;2;2022-04-12;177;260;1169;2700;1042;6114586;6794230;10597818;84901;11721193
FR;2;2022-04-13;139;222;1110;2405;968;6114725;6794452;10598928;87306;11722161
FR;2;2022-04-14;114;216;1077;2653;906;6114839;6794668;10600005;89959;11723067
FR;2;2022-04-15;111;238;1185;2248;1042;6114950;6794906;10601190;92207;11724109
FR;2;2022-04-16;64;108;537;543;449;6115014;6795014;10601727;92750;11724558
FR;2;2022-04-17;14;26;57;53;53;6115028;6795040;10601784;92803;11724611
FR;2;2022-04-18;11;34;118;65;113;6115039;6795074;10601902;92868;11724724
FR;2;2022-04-19;108;235;1111;1686;943;6115147;6795309;10603013;94554;11725667
FR;2;2022-04-20;94;236;1089;2099;917;6115241;6795545;10604102;96653;11726584
FR;2;2022-04-21;108;228;970;1810;828;6115349;6795773;10605072;98463;11727412
FR;2;2022-04-22;96;265;1226;2055;1006;6115445;6796038;10606298;100518;11728418
FR;2;2022-04-23;66;153;644;762;573;6115511;6796191;10606942;101280;11728991
FR;2;2022-04-24;10;28;98;68;76;6115521;6796219;10607040;101348;11729067
FR;2;2022-04-25;101;199;792;1293;700;6115622;6796418;10607832;102641;11729767
FR;2;2022-04-26;103;182;1027;1897;867;6115725;6796600;10608859;104538;11730634
FR;2;2022-04-27;93;175;851;1665;755;6115818;6796775;10609710;106203;11731389
FR;2;2022-04-28;90;208;942;1891;836;6115908;6796983;10610652;108094;11732225
FR;2;2022-04-29;74;277;1118;1685;1029;6115982;6797260;10611770;109779;11733254
FR;2;2022-04-30;63;124;462;534;421;6116045;6797384;10612232;110313;11733675
FR;2;2022-05-01;14;22;79;42;80;6116059;6797406;10612311;110355;11733755
FR;2;2022-05-02;111;206;722;1201;624;6116170;6797612;10613033;111556;11734379
FR;2;2022-05-03;144;221;956;1728;896;6116314;6797833;10613989;113284;11735275
FR;2;2022-05-04;84;215;886;1754;833;6116398;6798048;10614875;115038;11736108
FR;2;2022-05-05;118;189;814;1653;724;6116516;6798237;10615689;116691;11736832
FR;2;2022-05-06;125;231;1076;1843;990;6116641;6798468;10616765;118534;11737822
FR;2;2022-05-07;39;94;461;502;398;6116680;6798562;10617226;119036;11738220
FR;2;2022-05-08;41;45;101;70;89;6116721;6798607;10617327;119106;11738309
FR;2;2022-05-09;100;162;618;959;568;6116821;6798769;10617945;120065;11738877
FR;2;2022-05-10;110;227;866;1730;817;6116931;6798996;10618811;121795;11739694
FR;2;2022-05-11;94;159;761;1798;733;6117025;6799155;10619572;123593;11740427
FR;2;2022-05-12;103;164;801;2013;765;6117128;6799319;10620373;125606;11741192
FR;2;2022-05-13;93;221;916;1901;853;6117221;6799540;10621289;127507;11742045
FR;2;2022-05-14;75;114;424;544;384;6117296;6799654;10621713;128051;11742429
FR;2;2022-05-15;23;34;88;86;99;6117319;6799688;10621801;128137;11742528
FR;2;2022-05-16;100;155;536;902;477;6117419;6799843;10622337;129039;11743005
FR;2;2022-05-17;92;176;635;1609;609;6117511;6800019;10622972;130648;11743614
FR;2;2022-05-18;79;161;577;1227;556;6117590;6800180;10623549;131875;11744170
FR;2;2022-05-19;61;143;624;1422;548;6117651;6800323;10624173;133297;11744718
FR;3;2020-12-27;0;0;0;0;0;0;0;0;0;0
FR;3;2020-12-28;0;0;0;0;0;0;0;0;0;0
FR;3;2020-12-29;0;0;0;0;0;0;0;0;0;0
FR;3;2020-12-30;0;0;0;0;0;0;0;0;0;0
FR;3;2020-12-31;0;0;0;0;0;0;0;0;0;0
FR;3;2021-01-01;0;0;0;0;0;0;0;0;0;0
FR;3;2021-01-02;0;0;0;0;0;0;0;0;0;0
FR;3;2021-01-03;0;0;0;0;0;0;0;0;0;0
FR;3;2021-01-04;0;0;0;0;0;0;0;0;0;0
FR;3;2021-01-05;0;0;0;0;0;0;0;0;0;0
FR;3;2021-01-06;0;0;0;0;0;0;0;0;0;0
FR;3;2021-01-07;0;0;0;0;0;0;0;0;0;0
FR;3;2021-01-08;0;0;0;0;0;0;0;0;0;0
FR;3;2021-01-09;0;0;0;0;0;0;0;0;0;0
FR;3;2021-01-10;0;0;0;0;0;0;0;0;0;0
FR;3;2021-01-11;0;0;0;0;0;0;0;0;0;0
FR;3;2021-01-12;0;0;0;0;0;0;0;0;0;0
FR;3;2021-01-13;0;0;0;0;0;0;0;0;0;0
FR;3;2021-01-14;0;0;0;0;0;0;0;0;0;0
FR;3;2021-01-15;0;0;0;0;0;0;0;0;0;0
FR;3;2021-01-16;0;0;0;0;0;0;0;0;0;0
FR;3;2021-01-17;0;0;0;0;0;0;0;0;0;0
FR;3;2021-01-18;0;0;0;0;0;0;0;0;0;0
FR;3;2021-01-19;0;0;0;0;0;0;0;0;0;0
FR;3;2021-01-20;0;0;0;0;0;0;0;0;0;0
FR;3;2021-01-21;0;0;0;0;0;0;0;0;0;0
FR;3;2021-01-22;0;0;0;0;0;0;0;0;0;0
FR;3;2021-01-23;0;0;0;0;0;0;0;0;0;0
FR;3;2021-01-24;0;0;0;0;0;0;0;0;0;0
FR;3;2021-01-25;0;0;0;0;0;0;0;0;0;0
FR;3;2021-01-26;0;0;0;0;0;0;0;0;0;0
FR;3;2021-01-27;0;0;0;0;0;0;0;0;0;0
FR;3;2021-01-28;0;0;0;0;0;0;0;0;0;0
FR;3;2021-01-29;0;0;0;0;0;0;0;0;0;0
FR;3;2021-01-30;0;0;0;0;0;0;0;0;0;0
FR;3;2021-01-31;0;0;0;0;0;0;0;0;0;0
FR;3;2021-02-01;0;0;0;0;0;0;0;0;0;0
FR;3;2021-02-02;0;0;0;0;0;0;0;0;0;0
FR;3;2021-02-03;0;0;0;0;0;0;0;0;0;0
FR;3;2021-02-04;0;0;0;0;0;0;0;0;0;0
FR;3;2021-02-05;0;0;0;0;0;0;0;0;0;0
FR;3;2021-02-06;1672;0;0;0;0;1672;0;0;0;0
FR;3;2021-02-07;1422;0;0;0;0;3094;0;0;0;0
FR;3;2021-02-08;2782;1;0;0;0;5876;1;0;0;0
FR;3;2021-02-09;6782;0;0;0;0;12658;1;0;0;0
FR;3;2021-02-10;9603;0;0;0;0;22261;1;0;0;0
FR;3;2021-02-11;13610;0;0;0;0;35871;1;0;0;0
FR;3;2021-02-12;13397;0;0;0;0;49268;1;0;0;0
FR;3;2021-02-13;3783;1;0;0;0;53051;2;0;0;0
FR;3;2021-02-14;972;0;0;0;0;54023;2;0;0;0
FR;3;2021-02-15;10486;0;0;0;0;64509;2;0;0;0
FR;3;2021-02-16;12542;1;0;0;0;77051;3;0;0;0
FR;3;2021-02-17;11150;0;0;0;0;88201;3;0;0;0
FR;3;2021-02-18;14934;2;0;0;0;103135;5;0;0;0
FR;3;2021-02-19;14359;1;0;0;0;117494;6;0;0;0
FR;3;2021-02-20;3329;0;0;0;0;120823;6;0;0;0
FR;3;2021-02-21;618;0;0;0;0;121441;6;0;0;0
FR;3;2021-02-22;9162;0;0;0;0;130603;6;0;0;0
FR;3;2021-02-23;11394;1;0;0;0;141997;7;0;0;0
FR;3;2021-02-24;14298;0;0;0;0;156295;7;0;0;0
FR;3;2021-02-25;44929;1;0;0;0;201224;8;0;0;0
FR;3;2021-02-26;61883;3;0;0;0;263107;11;0;0;0
FR;3;2021-02-27;34801;5;0;0;0;297908;16;0;0;0
FR;3;2021-02-28;2463;0;0;0;0;300371;16;0;0;0
FR;3;2021-03-01;20510;10;0;0;0;320881;26;0;0;0
FR;3;2021-03-02;38862;18;0;0;0;359743;44;0;0;0
FR;3;2021-03-03;48729;16;0;0;0;408472;60;0;0;0
FR;3;2021-03-04;82217;20;0;0;0;490689;80;0;0;0
FR;3;2021-03-05;118123;40;0;0;0;608812;120;0;0;0
FR;3;2021-03-06;120709;53;1;0;0;729521;173;1;0;0
FR;3;2021-03-07;55176;27;0;0;0;784697;200;1;0;0
FR;3;2021-03-08;42806;24;0;0;0;827503;224;1;0;0
FR;3;2021-03-09;78966;42;0;0;0;906469;266;1;0;0
FR;3;2021-03-10;80965;46;0;0;0;987434;312;1;0;0
FR;3;2021-03-11;128418;54;0;0;0;1115852;366;1;0;0
FR;3;2021-03-12;182719;90;0;0;0;1298571;456;1;0;0
FR;3;2021-03-13;132144;63;0;0;0;1430715;519;1;0;0
FR;3;2021-03-14;14054;4;0;0;0;1444769;523;1;0;0
FR;3;2021-03-15;52222;45;0;0;0;1496991;568;1;0;0
FR;3;2021-03-16;1209;24;0;0;0;1498200;592;1;0;0
FR;3;2021-03-17;942;29;0;0;0;1499142;621;1;0;0
FR;3;2021-03-18;1564;12;0;0;0;1500706;633;1;0;0
FR;3;2021-03-19;70448;49;0;0;0;1571154;682;1;0;0
FR;3;2021-03-20;65226;44;0;0;0;1636380;726;1;0;0
FR;3;2021-03-21;5755;6;0;0;0;1642135;732;1;0;0
FR;3;2021-03-22;37495;38;0;0;0;1679630;770;1;0;0
FR;3;2021-03-23;84650;61;0;0;0;1764280;831;1;0;0
FR;3;2021-03-24;90935;91;0;0;0;1855215;922;1;0;0
FR;3;2021-03-25;150043;126;0;0;0;2005258;1048;1;0;0
FR;3;2021-03-26;165411;152;0;0;0;2170669;1200;1;0;0
FR;3;2021-03-27;68456;99;0;0;0;2239125;1299;1;0;0
FR;3;2021-03-28;6469;19;0;0;0;2245594;1318;1;0;0
FR;3;2021-03-29;54158;75;0;0;0;2299752;1393;1;0;0
FR;3;2021-03-30;93159;100;0;0;0;2392911;1493;1;0;0
FR;3;2021-03-31;63522;93;0;0;0;2456433;1586;1;0;0
FR;3;2021-04-01;86121;103;0;0;0;2542554;1689;1;0;0
FR;3;2021-04-02;86889;152;0;0;0;2629443;1841;1;0;0
FR;3;2021-04-03;35871;115;0;0;0;2665314;1956;1;0;0
FR;3;2021-04-04;3570;18;0;0;0;2668884;1974;1;0;0
FR;3;2021-04-05;4487;28;0;0;0;2673371;2002;1;0;0
FR;3;2021-04-06;29741;83;0;0;0;2703112;2085;1;0;0
FR;3;2021-04-07;32334;79;0;0;0;2735446;2164;1;0;0
FR;3;2021-04-08;78809;242;0;0;0;2814255;2406;1;0;0
FR;3;2021-04-09;161746;415;0;0;0;2976001;2821;1;0;0
FR;3;2021-04-10;75753;330;0;0;0;3051754;3151;1;0;0
FR;3;2021-04-11;7308;45;0;0;0;3059062;3196;1;0;0
FR;3;2021-04-12;51467;206;0;0;0;3110529;3402;1;0;0
FR;3;2021-04-13;86218;318;0;0;0;3196747;3720;1;0;0
FR;3;2021-04-14;67834;341;0;0;0;3264581;4061;1;0;0
FR;3;2021-04-15;93219;370;0;0;0;3357800;4431;1;0;0
FR;3;2021-04-16;112516;579;0;0;0;3470316;5010;1;0;0
FR;3;2021-04-17;53311;324;1;0;0;3523627;5334;2;0;0
FR;3;2021-04-18;9741;35;0;0;0;3533368;5369;2;0;0
FR;3;2021-04-19;25103;240;0;0;0;3558471;5609;2;0;0
FR;3;2021-04-20;45670;398;0;0;0;3604141;6007;2;0;0
FR;3;2021-04-21;38967;466;0;0;0;3643108;6473;2;0;0
FR;3;2021-04-22;54701;784;0;0;0;3697809;7257;2;0;0
FR;3;2021-04-23;70479;1018;0;0;0;3768288;8275;2;0;0
FR;3;2021-04-24;37240;993;0;0;0;3805528;9268;2;0;0
FR;3;2021-04-25;6204;153;0;0;0;3811732;9421;2;0;0
FR;3;2021-04-26;19781;652;0;0;0;3831513;10073;2;0;0
FR;3;2021-04-27;34470;1261;0;0;0;3865983;11334;2;0;0
FR;3;2021-04-28;28964;1942;0;0;0;3894947;13276;2;0;0
FR;3;2021-04-29;45376;5958;0;0;0;3940323;19234;2;0;0
FR;3;2021-04-30;55451;8931;1;0;0;3995774;28165;3;0;0
FR;3;2021-05-01;9510;1976;0;0;0;4005284;30141;3;0;0
FR;3;2021-05-02;3070;488;0;0;0;4008354;30629;3;0;0
FR;3;2021-05-03;13057;3883;0;0;0;4021411;34512;3;0;0
FR;3;2021-05-04;23109;8411;0;0;0;4044520;42923;3;0;0
FR;3;2021-05-05;18752;10613;0;0;0;4063272;53536;3;0;0
FR;3;2021-05-06;34618;20901;0;0;0;4097890;74437;3;0;0
FR;3;2021-05-07;44201;28436;0;0;0;4142091;102873;3;0;0
FR;3;2021-05-08;6784;8921;0;0;0;4148875;111794;3;0;0
FR;3;2021-05-09;1792;2657;0;0;0;4150667;114451;3;0;0
FR;3;2021-05-10;14989;12601;0;0;0;4165656;127052;3;0;0
FR;3;2021-05-11;27092;25773;0;0;0;4192748;152825;3;0;0
FR;3;2021-05-12;17266;27501;0;0;0;4210014;180326;3;0;0
FR;3;2021-05-13;2277;3471;0;0;0;4212291;183797;3;0;0
FR;3;2021-05-14;14513;25752;0;0;0;4226804;209549;3;0;0
FR;3;2021-05-15;7230;20784;0;0;0;4234034;230333;3;0;0
FR;3;2021-05-16;975;2674;0;0;0;4235009;233007;3;0;0
FR;3;2021-05-17;7960;19939;0;0;0;4242969;252946;3;0;0
FR;3;2021-05-18;13409;29651;0;0;0;4256378;282597;3;0;0
FR;3;2021-05-19;9262;31574;0;0;0;4265640;314171;3;0;0
FR;3;2021-05-20;12801;53213;3;0;0;4278441;367384;6;0;0
FR;3;2021-05-21;12759;65523;2;0;0;4291200;432907;8;0;0
FR;3;2021-05-22;4960;33299;1;0;0;4296160;466206;9;0;0
FR;3;2021-05-23;649;2672;0;0;0;4296809;468878;9;0;0
FR;3;2021-05-24;879;4917;0;0;0;4297688;473795;9;0;0
FR;3;2021-05-25;5296;45235;1;0;0;4302984;519030;10;0;0
FR;3;2021-05-26;4968;51088;1;0;0;4307952;570118;11;0;0
FR;3;2021-05-27;6325;77865;3;0;0;4314277;647983;14;0;0
FR;3;2021-05-28;7539;99083;2;0;0;4321816;747066;16;0;0
FR;3;2021-05-29;3345;60310;1;0;0;4325161;807376;17;0;0
FR;3;2021-05-30;545;8222;0;0;0;4325706;815598;17;0;0
FR;3;2021-05-31;2434;35896;3;0;0;4328140;851494;20;0;0
FR;3;2021-06-01;3400;64747;10;0;0;4331540;916241;30;0;0
FR;3;2021-06-02;2726;58326;6;0;0;4334266;974567;36;0;0
FR;3;2021-06-03;3491;87492;10;0;0;4337757;1062059;46;0;0
FR;3;2021-06-04;4110;105095;22;0;0;4341867;1167154;68;0;0
FR;3;2021-06-05;1978;52231;4;0;0;4343845;1219385;72;0;0
FR;3;2021-06-06;505;5387;1;0;0;4344350;1224772;73;0;0
FR;3;2021-06-07;1468;31097;11;0;0;4345818;1255869;84;0;0
FR;3;2021-06-08;2047;47232;18;0;0;4347865;1303101;102;0;0
FR;3;2021-06-09;1787;42321;13;0;0;4349652;1345422;115;0;0
FR;3;2021-06-10;2242;67889;17;0;0;4351894;1413311;132;0;0
FR;3;2021-06-11;2471;96696;34;0;0;4354365;1510007;166;0;0
FR;3;2021-06-12;1174;40833;6;0;0;4355539;1550840;172;0;0
FR;3;2021-06-13;278;3803;3;0;0;4355817;1554643;175;0;0
FR;3;2021-06-14;1038;42604;17;0;0;4356855;1597247;192;0;0
FR;3;2021-06-15;1363;80608;20;0;0;4358218;1677855;212;0;0
FR;3;2021-06-16;1255;65698;19;0;0;4359473;1743553;231;0;0
FR;3;2021-06-17;1659;101804;41;0;0;4361132;1845357;272;0;0
FR;3;2021-06-18;1868;117921;61;0;0;4363000;1963278;333;0;0
FR;3;2021-06-19;801;39390;22;0;0;4363801;2002668;355;0;0
FR;3;2021-06-20;158;3374;0;0;0;4363959;2006042;355;0;0
FR;3;2021-06-21;768;39243;16;0;0;4364727;2045285;371;0;0
FR;3;2021-06-22;1060;69949;52;0;0;4365787;2115234;423;0;0
FR;3;2021-06-23;942;50820;39;0;0;4366729;2166054;462;0;0
FR;3;2021-06-24;1305;77153;48;0;0;4368034;2243207;510;0;0
FR;3;2021-06-25;1399;89966;73;0;0;4369433;2333173;583;0;0
FR;3;2021-06-26;625;33119;29;0;0;4370058;2366292;612;0;0
FR;3;2021-06-27;165;3993;1;0;0;4370223;2370285;613;0;0
FR;3;2021-06-28;648;30397;27;0;0;4370871;2400682;640;0;0
FR;3;2021-06-29;853;56168;95;0;0;4371724;2456850;735;0;0
FR;3;2021-06-30;901;45077;93;0;0;4372625;2501927;828;0;0
FR;3;2021-07-01;1160;65679;108;0;0;4373785;2567606;936;0;0
FR;3;2021-07-02;1299;90362;170;0;0;4375084;2657968;1106;0;0
FR;3;2021-07-03;600;31185;52;0;0;4375684;2689153;1158;0;0
FR;3;2021-07-04;141;4259;3;0;0;4375825;2693412;1161;0;0
FR;3;2021-07-05;608;33903;60;0;0;4376433;2727315;1221;0;0
FR;3;2021-07-06;956;56050;88;0;0;4377389;2783365;1309;0;0
FR;3;2021-07-07;870;43035;79;0;0;4378259;2826400;1388;0;0
FR;3;2021-07-08;1123;60724;99;0;0;4379382;2887124;1487;0;0
FR;3;2021-07-09;1258;68807;128;0;0;4380640;2955931;1615;0;0
FR;3;2021-07-10;640;25056;59;0;0;4381280;2980987;1674;0;0
FR;3;2021-07-11;127;3289;4;0;0;4381407;2984276;1678;0;0
FR;3;2021-07-12;659;23879;59;0;0;4382066;3008155;1737;0;0
FR;3;2021-07-13;1645;34723;90;0;0;4383711;3042878;1827;0;0
FR;3;2021-07-14;261;2630;2;0;0;4383972;3045508;1829;0;0
FR;3;2021-07-15;1932;30659;85;0;0;4385904;3076167;1914;0;0
FR;3;2021-07-16;2520;38860;122;0;0;4388424;3115027;2036;0;0
FR;3;2021-07-17;1046;13750;26;0;0;4389470;3128777;2062;0;0
FR;3;2021-07-18;262;2607;3;0;0;4389732;3131384;2065;0;0
FR;3;2021-07-19;1273;17192;37;0;0;4391005;3148576;2102;0;0
FR;3;2021-07-20;1823;27135;98;0;0;4392828;3175711;2200;0;0
FR;3;2021-07-21;1647;19707;44;0;0;4394475;3195418;2244;0;0
FR;3;2021-07-22;1848;27749;82;0;0;4396323;3223167;2326;0;0
FR;3;2021-07-23;2212;30447;117;0;0;4398535;3253614;2443;0;0
FR;3;2021-07-24;822;7003;25;0;0;4399357;3260617;2468;0;0
FR;3;2021-07-25;210;1340;1;0;0;4399567;3261957;2469;0;0
FR;3;2021-07-26;921;10705;28;0;0;4400488;3272662;2497;0;0
FR;3;2021-07-27;1165;16947;56;0;0;4401653;3289609;2553;0;0
FR;3;2021-07-28;988;12099;40;0;0;4402641;3301708;2593;0;0
FR;3;2021-07-29;1126;15843;63;0;0;4403767;3317551;2656;0;0
FR;3;2021-07-30;1125;18093;79;0;0;4404892;3335644;2735;0;0
FR;3;2021-07-31;406;3747;15;0;0;4405298;3339391;2750;0;0
FR;3;2021-08-01;113;486;1;0;0;4405411;3339877;2751;0;0
FR;3;2021-08-02;418;5156;22;0;0;4405829;3345033;2773;0;0
FR;3;2021-08-03;488;7589;27;0;0;4406317;3352622;2800;0;0
FR;3;2021-08-04;435;4886;26;0;0;4406752;3357508;2826;0;0
FR;3;2021-08-05;428;3738;12;0;0;4407180;3361246;2838;0;0
FR;3;2021-08-06;452;4793;30;0;0;4407632;3366039;2868;0;0
FR;3;2021-08-07;214;1923;11;0;0;4407846;3367962;2879;0;0
FR;3;2021-08-08;247;432;2;0;0;4408093;3368394;2881;0;0
FR;3;2021-08-09;313;2505;11;0;0;4408406;3370899;2892;0;0
FR;3;2021-08-10;362;3881;15;0;0;4408768;3374780;2907;0;0
FR;3;2021-08-11;285;2723;15;0;0;4409053;3377503;2922;0;0
FR;3;2021-08-12;276;2635;12;0;0;4409329;3380138;2934;0;0
FR;3;2021-08-13;277;2267;16;0;0;4409606;3382405;2950;0;0
FR;3;2021-08-14;169;917;1;0;0;4409775;3383322;2951;0;0
FR;3;2021-08-15;55;170;0;0;0;4409830;3383492;2951;0;0
FR;3;2021-08-16;123;1088;8;0;0;4409953;3384580;2959;0;0
FR;3;2021-08-17;186;1504;8;0;0;4410139;3386084;2967;0;0
FR;3;2021-08-18;199;1371;10;0;0;4410338;3387455;2977;0;0
FR;3;2021-08-19;165;1415;10;0;0;4410503;3388870;2987;0;0
FR;3;2021-08-20;166;1633;16;0;0;4410669;3390503;3003;0;0
FR;3;2021-08-21;93;587;2;0;0;4410762;3391090;3005;0;0
FR;3;2021-08-22;39;188;1;0;0;4410801;3391278;3006;0;0
FR;3;2021-08-23;140;928;7;0;0;4410941;3392206;3013;0;0
FR;3;2021-08-24;124;966;10;0;0;4411065;3393172;3023;0;0
FR;3;2021-08-25;136;842;2;0;0;4411201;3394014;3025;0;0
FR;3;2021-08-26;170;872;9;0;0;4411371;3394886;3034;0;0
FR;3;2021-08-27;172;964;9;0;0;4411543;3395850;3043;0;0
FR;3;2021-08-28;98;373;4;0;0;4411641;3396223;3047;0;0
FR;3;2021-08-29;127;133;1;0;0;4411768;3396356;3048;0;0
FR;3;2021-08-30;98;599;0;0;135;4411866;3396955;3048;0;135
FR;3;2021-08-31;127;713;7;0;154;4411993;3397668;3055;0;289
FR;3;2021-09-01;113;480;5;0;124;4412106;3398148;3060;0;413
FR;3;2021-09-02;99;633;22;0;120;4412205;3398781;3082;0;533
FR;3;2021-09-03;115;587;17;0;128;4412320;3399368;3099;0;661
FR;3;2021-09-04;51;299;3;0;58;4412371;3399667;3102;0;719
FR;3;2021-09-05;51;68;5;0;28;4412422;3399735;3107;0;747
FR;3;2021-09-06;113;395;4;0;144;4412535;3400130;3111;0;891
FR;3;2021-09-07;122;476;14;0;129;4412657;3400606;3125;0;1020
FR;3;2021-09-08;115;371;2;0;103;4412772;3400977;3127;0;1123
FR;3;2021-09-09;92;397;8;0;114;4412864;3401374;3135;0;1237
FR;3;2021-09-10;100;423;3;0;104;4412964;3401797;3138;0;1341
FR;3;2021-09-11;74;239;4;0;66;4413038;3402036;3142;0;1407
FR;3;2021-09-12;36;48;1;0;17;4413074;3402084;3143;0;1424
FR;3;2021-09-13;69;322;7;0;109;4413143;3402406;3150;0;1533
FR;3;2021-09-14;70;293;6;0;107;4413213;3402699;3156;0;1640
FR;3;2021-09-15;59;264;3;0;6;4413272;3402963;3159;0;1646
FR;3;2021-09-16;59;339;5;0;5;4413331;3403302;3164;0;1651
FR;3;2021-09-17;50;348;3;0;7;4413381;3403650;3167;0;1658
FR;3;2021-09-18;36;172;1;0;1;4413417;3403822;3168;0;1659
FR;3;2021-09-19;27;32;2;0;1;4413444;3403854;3170;0;1660
FR;3;2021-09-20;79;212;0;0;1;4413523;3404066;3170;0;1661
FR;3;2021-09-21;58;288;6;0;7;4413581;3404354;3176;0;1668
FR;3;2021-09-22;63;229;6;0;7;4413644;3404583;3182;0;1675
FR;3;2021-09-23;35;274;11;0;7;4413679;3404857;3193;0;1682
FR;3;2021-09-24;25;323;12;0;19;4413704;3405180;3205;0;1701
FR;3;2021-09-25;29;152;3;0;3;4413733;3405332;3208;0;1704
FR;3;2021-09-26;15;55;1;0;1;4413748;3405387;3209;0;1705
FR;3;2021-09-27;39;290;3;0;5;4413787;3405677;3212;0;1710
FR;3;2021-09-28;49;255;6;0;10;4413836;3405932;3218;0;1720
FR;3;2021-09-29;34;224;10;0;13;4413870;3406156;3228;0;1733
FR;3;2021-09-30;38;199;8;0;10;4413908;3406355;3236;0;1743
FR;3;2021-10-01;17;170;6;0;7;4413925;3406525;3242;0;1750
FR;3;2021-10-02;14;91;0;0;0;4413939;3406616;3242;0;1750
FR;3;2021-10-03;18;20;1;0;2;4413957;3406636;3243;0;1752
FR;3;2021-10-04;30;161;4;0;4;4413987;3406797;3247;0;1756
FR;3;2021-10-05;16;153;10;0;13;4414003;3406950;3257;0;1769
FR;3;2021-10-06;31;157;7;0;8;4414034;3407107;3264;0;1777
FR;3;2021-10-07;17;143;6;0;6;4414051;3407250;3270;0;1783
FR;3;2021-10-08;22;144;10;0;9;4414073;3407394;3280;0;1792
FR;3;2021-10-09;12;73;1;0;1;4414085;3407467;3281;0;1793
FR;3;2021-10-10;11;16;2;0;2;4414096;3407483;3283;0;1795
FR;3;2021-10-11;14;124;4;0;5;4414110;3407607;3287;0;1800
FR;3;2021-10-12;17;116;5;0;5;4414127;3407723;3292;0;1805
FR;3;2021-10-13;23;120;7;0;5;4414150;3407843;3299;0;1810
FR;3;2021-10-14;16;160;3;0;4;4414166;3408003;3302;0;1814
FR;3;2021-10-15;21;157;8;0;11;4414187;3408160;3310;0;1825
FR;3;2021-10-16;11;79;6;0;8;4414198;3408239;3316;0;1833
FR;3;2021-10-17;9;24;0;0;0;4414207;3408263;3316;0;1833
FR;3;2021-10-18;17;128;2;0;1;4414224;3408391;3318;0;1834
FR;3;2021-10-19;16;126;19;0;21;4414240;3408517;3337;0;1855
FR;3;2021-10-20;20;132;5;0;6;4414260;3408649;3342;0;1861
FR;3;2021-10-21;24;138;17;0;13;4414284;3408787;3359;0;1874
FR;3;2021-10-22;18;128;16;0;20;4414302;3408915;3375;0;1894
FR;3;2021-10-23;12;58;2;0;1;4414314;3408973;3377;0;1895
FR;3;2021-10-24;7;31;0;0;0;4414321;3409004;3377;0;1895
FR;3;2021-10-25;22;150;7;0;7;4414343;3409154;3384;0;1902
FR;3;2021-10-26;18;115;22;0;19;4414361;3409269;3406;0;1921
FR;3;2021-10-27;15;118;9;0;9;4414376;3409387;3415;0;1930
FR;3;2021-10-28;20;125;33;0;36;4414396;3409512;3448;0;1966
FR;3;2021-10-29;10;124;64;0;54;4414406;3409636;3512;0;2020
FR;3;2021-10-30;8;66;11;1;10;4414414;3409702;3523;1;2030
FR;3;2021-10-31;5;22;1;0;1;4414419;3409724;3524;1;2031
FR;3;2021-11-01;7;22;2;0;1;4414426;3409746;3526;1;2032
FR;3;2021-11-02;9;108;8;0;10;4414435;3409854;3534;1;2042
FR;3;2021-11-03;19;119;10;0;10;4414454;3409973;3544;1;2052
FR;3;2021-11-04;18;99;4;0;3;4414472;3410072;3548;1;2055
FR;3;2021-11-05;17;143;8;1;5;4414489;3410215;3556;2;2060
FR;3;2021-11-06;6;67;3;0;3;4414495;3410282;3559;2;2063
FR;3;2021-11-07;6;21;1;0;1;4414501;3410303;3560;2;2064
FR;3;2021-11-08;11;141;7;0;5;4414512;3410444;3567;2;2069
FR;3;2021-11-09;12;150;5;0;5;4414524;3410594;3572;2;2074
FR;3;2021-11-10;12;180;13;0;14;4414536;3410774;3585;2;2088
FR;3;2021-11-11;8;53;3;0;3;4414544;3410827;3588;2;2091
FR;3;2021-11-12;10;158;6;0;4;4414554;3410985;3594;2;2095
FR;3;2021-11-13;5;79;8;0;10;4414559;3411064;3602;2;2105
FR;3;2021-11-14;2;20;0;0;0;4414561;3411084;3602;2;2105
FR;3;2021-11-15;4;190;9;0;9;4414565;3411274;3611;2;2114
FR;3;2021-11-16;2;166;11;0;10;4414567;3411440;3622;2;2124
FR;3;2021-11-17;5;180;10;0;7;4414572;3411620;3632;2;2131
FR;3;2021-11-18;12;179;10;0;11;4414584;3411799;3642;2;2142
FR;3;2021-11-19;6;230;22;0;27;4414590;3412029;3664;2;2169
FR;3;2021-11-20;6;117;5;0;5;4414596;3412146;3669;2;2174
FR;3;2021-11-21;3;26;3;0;3;4414599;3412172;3672;2;2177
FR;3;2021-11-22;10;238;10;0;10;4414609;3412410;3682;2;2187
FR;3;2021-11-23;6;234;15;0;14;4414615;3412644;3697;2;2201
FR;3;2021-11-24;5;240;9;0;17;4414620;3412884;3706;2;2218
FR;3;2021-11-25;9;284;11;0;10;4414629;3413168;3717;2;2228
FR;3;2021-11-26;5;369;35;0;32;4414634;3413537;3752;2;2260
FR;3;2021-11-27;8;175;20;0;21;4414642;3413712;3772;2;2281
FR;3;2021-11-28;3;65;7;0;7;4414645;3413777;3779;2;2288
FR;3;2021-11-29;4;325;19;0;20;4414649;3414102;3798;2;2308
FR;3;2021-11-30;5;417;26;0;29;4414654;3414519;3824;2;2337
FR;3;2021-12-01;18;464;32;0;33;4414672;3414983;3856;2;2370
FR;3;2021-12-02;9;497;33;0;36;4414681;3415480;3889;2;2406
FR;3;2021-12-03;3;566;37;0;38;4414684;3416046;3926;2;2444
FR;3;2021-12-04;3;282;26;0;28;4414687;3416328;3952;2;2472
FR;3;2021-12-05;1;81;5;0;5;4414688;3416409;3957;2;2477
FR;3;2021-12-06;5;507;14;0;16;4414693;3416916;3971;2;2493
FR;3;2021-12-07;4;609;20;0;24;4414697;3417525;3991;2;2517
FR;3;2021-12-08;3;537;29;0;30;4414700;3418062;4020;2;2547
FR;3;2021-12-09;3;588;17;0;22;4414703;3418650;4037;2;2569
FR;3;2021-12-10;9;625;29;0;25;4414712;3419275;4066;2;2594
FR;3;2021-12-11;4;386;10;0;9;4414716;3419661;4076;2;2603
FR;3;2021-12-12;1;121;3;0;3;4414717;3419782;4079;2;2606
FR;3;2021-12-13;2;599;19;0;21;4414719;3420381;4098;2;2627
FR;3;2021-12-14;7;756;18;0;21;4414726;3421137;4116;2;2648
FR;3;2021-12-15;9;721;17;0;21;4414735;3421858;4133;2;2669
FR;3;2021-12-16;9;729;19;0;18;4414744;3422587;4152;2;2687
FR;3;2021-12-17;4;795;18;0;19;4414748;3423382;4170;2;2706
FR;3;2021-12-18;4;413;4;0;5;4414752;3423795;4174;2;2711
FR;3;2021-12-19;3;207;2;0;2;4414755;3424002;4176;2;2713
FR;3;2021-12-20;8;719;23;0;28;4414763;3424721;4199;2;2741
FR;3;2021-12-21;3;808;10;0;13;4414766;3425529;4209;2;2754
FR;3;2021-12-22;6;755;9;0;10;4414772;3426284;4218;2;2764
FR;3;2021-12-23;1;650;9;0;8;4414773;3426934;4227;2;2772
FR;3;2021-12-24;2;272;3;0;6;4414775;3427206;4230;2;2778
FR;3;2021-12-25;0;25;0;0;0;4414775;3427231;4230;2;2778
FR;3;2021-12-26;0;95;1;0;1;4414775;3427326;4231;2;2779
FR;3;2021-12-27;7;542;17;0;19;4414782;3427868;4248;2;2798
FR;3;2021-12-28;1;690;6;0;5;4414783;3428558;4254;2;2803
FR;3;2021-12-29;4;574;14;0;16;4414787;3429132;4268;2;2819
FR;3;2021-12-30;1;599;7;0;10;4414788;3429731;4275;2;2829
FR;3;2021-12-31;0;205;5;0;6;4414788;3429936;4280;2;2835
FR;3;2022-01-01;0;27;0;0;2;4414788;3429963;4280;2;2837
FR;3;2022-01-02;0;82;0;0;0;4414788;3430045;4280;2;2837
FR;3;2022-01-03;3;564;17;0;20;4414791;3430609;4297;2;2857
FR;3;2022-01-04;6;623;9;0;8;4414797;3431232;4306;2;2865
FR;3;2022-01-05;4;552;10;0;14;4414801;3431784;4316;2;2879
FR;3;2022-01-06;5;547;9;0;12;4414806;3432331;4325;2;2891
FR;3;2022-01-07;2;576;11;0;14;4414808;3432907;4336;2;2905
FR;3;2022-01-08;2;285;4;0;5;4414810;3433192;4340;2;2910
FR;3;2022-01-09;0;118;0;0;0;4414810;3433310;4340;2;2910
FR;3;2022-01-10;2;479;12;0;12;4414812;3433789;4352;2;2922
FR;3;2022-01-11;2;531;1;0;1;4414814;3434320;4353;2;2923
FR;3;2022-01-12;2;445;9;0;10;4414816;3434765;4362;2;2933
FR;3;2022-01-13;3;424;11;0;12;4414819;3435189;4373;2;2945
FR;3;2022-01-14;3;474;10;0;13;4414822;3435663;4383;2;2958
FR;3;2022-01-15;0;298;2;0;3;4414822;3435961;4385;2;2961
FR;3;2022-01-16;0;116;1;0;1;4414822;3436077;4386;2;2962
FR;3;2022-01-17;2;349;8;0;10;4414824;3436426;4394;2;2972
FR;3;2022-01-18;2;413;1;0;2;4414826;3436839;4395;2;2974
FR;3;2022-01-19;1;349;5;0;10;4414827;3437188;4400;2;2984
FR;3;2022-01-20;1;379;5;0;3;4414828;3437567;4405;2;2987
FR;3;2022-01-21;3;373;5;0;7;4414831;3437940;4410;2;2994
FR;3;2022-01-22;2;231;1;0;2;4414833;3438171;4411;2;2996
FR;3;2022-01-23;0;82;0;0;1;4414833;3438253;4411;2;2997
FR;3;2022-01-24;2;349;1;0;6;4414835;3438602;4412;2;3003
FR;3;2022-01-25;0;192;0;0;0;4414835;3438794;4412;2;3003
FR;3;2022-01-26;0;88;0;0;0;4414835;3438882;4412;2;3003
FR;3;2022-01-27;0;58;0;0;0;4414835;3438940;4412;2;3003
FR;3;2022-01-28;0;133;0;0;0;4414835;3439073;4412;2;3003
FR;3;2022-01-29;0;110;0;0;0;4414835;3439183;4412;2;3003
FR;3;2022-01-30;0;51;0;0;0;4414835;3439234;4412;2;3003
FR;3;2022-01-31;0;97;0;0;0;4414835;3439331;4412;2;3003
FR;3;2022-02-01;0;108;0;0;1;4414835;3439439;4412;2;3004
FR;3;2022-02-02;0;95;0;0;0;4414835;3439534;4412;2;3004
FR;3;2022-02-03;0;101;0;0;0;4414835;3439635;4412;2;3004
FR;3;2022-02-04;0;124;0;0;0;4414835;3439759;4412;2;3004
FR;3;2022-02-05;0;73;0;0;0;4414835;3439832;4412;2;3004
FR;3;2022-02-06;0;11;0;0;0;4414835;3439843;4412;2;3004
FR;3;2022-02-07;0;89;0;0;1;4414835;3439932;4412;2;3005
FR;3;2022-02-08;0;0;0;0;0;4414835;3439932;4412;2;3005
FR;3;2022-02-09;0;0;0;0;0;4414835;3439932;4412;2;3005
FR;3;2022-02-10;0;0;0;0;0;4414835;3439932;4412;2;3005
FR;3;2022-02-11;0;0;0;0;0;4414835;3439932;4412;2;3005
FR;3;2022-02-12;0;0;0;0;0;4414835;3439932;4412;2;3005
FR;3;2022-02-13;0;0;0;0;0;4414835;3439932;4412;2;3005
FR;3;2022-02-14;0;0;0;0;0;4414835;3439932;4412;2;3005
FR;3;2022-02-15;0;0;0;0;0;4414835;3439932;4412;2;3005
FR;3;2022-02-16;0;0;0;0;0;4414835;3439932;4412;2;3005
FR;3;2022-02-17;0;0;0;0;0;4414835;3439932;4412;2;3005
FR;3;2022-02-18;0;0;0;0;0;4414835;3439932;4412;2;3005
FR;3;2022-02-19;0;0;0;0;0;4414835;3439932;4412;2;3005
FR;3;2022-02-20;0;0;0;0;0;4414835;3439932;4412;2;3005
FR;3;2022-02-21;2;0;0;0;0;4414837;3439932;4412;2;3005
FR;3;2022-02-22;0;0;0;0;0;4414837;3439932;4412;2;3005
FR;3;2022-02-23;0;0;0;0;0;4414837;3439932;4412;2;3005
FR;3;2022-02-24;0;0;0;0;0;4414837;3439932;4412;2;3005
FR;3;2022-02-25;0;0;0;0;0;4414837;3439932;4412;2;3005
FR;3;2022-02-26;0;0;0;0;0;4414837;3439932;4412;2;3005
FR;3;2022-02-27;0;0;0;0;0;4414837;3439932;4412;2;3005
FR;3;2022-02-28;1;0;0;0;0;4414838;3439932;4412;2;3005
FR;3;2022-03-01;1;0;0;0;0;4414839;3439932;4412;2;3005
FR;3;2022-03-02;0;0;0;0;0;4414839;3439932;4412;2;3005
FR;3;2022-03-03;0;0;0;0;0;4414839;3439932;4412;2;3005
FR;3;2022-03-04;0;0;0;0;0;4414839;3439932;4412;2;3005
FR;3;2022-03-05;0;0;0;0;0;4414839;3439932;4412;2;3005
FR;3;2022-03-06;1;0;0;0;0;4414840;3439932;4412;2;3005
FR;3;2022-03-07;0;0;0;0;0;4414840;3439932;4412;2;3005
FR;3;2022-03-08;1;0;0;0;0;4414841;3439932;4412;2;3005
FR;3;2022-03-09;0;0;0;0;0;4414841;3439932;4412;2;3005
FR;3;2022-03-10;0;0;0;0;0;4414841;3439932;4412;2;3005
FR;3;2022-03-11;0;0;0;0;0;4414841;3439932;4412;2;3005
FR;3;2022-03-12;0;0;0;0;0;4414841;3439932;4412;2;3005
FR;3;2022-03-13;0;0;0;0;0;4414841;3439932;4412;2;3005
FR;3;2022-03-14;0;0;0;0;0;4414841;3439932;4412;2;3005
FR;3;2022-03-15;0;0;0;0;0;4414841;3439932;4412;2;3005
FR;3;2022-03-16;0;0;0;0;0;4414841;3439932;4412;2;3005
FR;3;2022-03-17;0;0;0;0;0;4414841;3439932;4412;2;3005
FR;3;2022-03-18;0;0;0;0;0;4414841;3439932;4412;2;3005
FR;3;2022-03-19;0;0;0;0;0;4414841;3439932;4412;2;3005
FR;3;2022-03-20;1;0;0;0;0;4414842;3439932;4412;2;3005
FR;3;2022-03-21;0;0;0;0;0;4414842;3439932;4412;2;3005
FR;3;2022-03-22;0;0;0;0;0;4414842;3439932;4412;2;3005
FR;3;2022-03-23;1;0;0;0;0;4414843;3439932;4412;2;3005
FR;3;2022-03-24;0;0;0;0;0;4414843;3439932;4412;2;3005
FR;3;2022-03-25;1;0;0;0;0;4414844;3439932;4412;2;3005
FR;3;2022-03-26;0;0;0;0;0;4414844;3439932;4412;2;3005
FR;3;2022-03-27;0;0;0;0;0;4414844;3439932;4412;2;3005
FR;3;2022-03-28;0;0;0;0;0;4414844;3439932;4412;2;3005
FR;3;2022-03-29;0;0;0;0;0;4414844;3439932;4412;2;3005
FR;3;2022-03-30;0;0;0;0;0;4414844;3439932;4412;2;3005
FR;3;2022-03-31;0;0;0;0;0;4414844;3439932;4412;2;3005
FR;3;2022-04-01;0;0;0;0;0;4414844;3439932;4412;2;3005
FR;3;2022-04-02;0;0;0;0;0;4414844;3439932;4412;2;3005
FR;3;2022-04-03;0;0;0;0;0;4414844;3439932;4412;2;3005
FR;3;2022-04-04;0;0;0;0;0;4414844;3439932;4412;2;3005
FR;3;2022-04-05;0;0;0;0;0;4414844;3439932;4412;2;3005
FR;3;2022-04-06;0;0;0;0;0;4414844;3439932;4412;2;3005
FR;3;2022-04-07;0;0;0;0;0;4414844;3439932;4412;2;3005
FR;3;2022-04-08;0;0;0;0;0;4414844;3439932;4412;2;3005
FR;3;2022-04-09;0;0;0;0;0;4414844;3439932;4412;2;3005
FR;3;2022-04-10;0;0;0;0;0;4414844;3439932;4412;2;3005
FR;3;2022-04-11;0;0;0;0;0;4414844;3439932;4412;2;3005
FR;3;2022-04-12;0;0;0;0;0;4414844;3439932;4412;2;3005
FR;3;2022-04-13;0;0;0;0;0;4414844;3439932;4412;2;3005
FR;3;2022-04-14;0;0;0;0;0;4414844;3439932;4412;2;3005
FR;3;2022-04-15;1;0;0;0;0;4414845;3439932;4412;2;3005
FR;3;2022-04-16;0;0;0;0;0;4414845;3439932;4412;2;3005
FR;3;2022-04-17;0;0;0;0;0;4414845;3439932;4412;2;3005
FR;3;2022-04-18;0;0;0;0;0;4414845;3439932;4412;2;3005
FR;3;2022-04-19;0;0;0;0;0;4414845;3439932;4412;2;3005
FR;3;2022-04-20;0;0;0;0;0;4414845;3439932;4412;2;3005
FR;3;2022-04-21;0;0;0;0;0;4414845;3439932;4412;2;3005
FR;3;2022-04-22;0;0;0;0;0;4414845;3439932;4412;2;3005
FR;3;2022-04-23;0;0;0;0;0;4414845;3439932;4412;2;3005
FR;3;2022-04-24;0;0;0;0;0;4414845;3439932;4412;2;3005
FR;3;2022-04-25;0;0;0;0;0;4414845;3439932;4412;2;3005
FR;3;2022-04-26;0;0;0;0;0;4414845;3439932;4412;2;3005
FR;3;2022-04-27;0;0;0;0;0;4414845;3439932;4412;2;3005
FR;3;2022-04-28;0;0;0;0;0;4414845;3439932;4412;2;3005
FR;3;2022-04-29;0;0;0;0;0;4414845;3439932;4412;2;3005
FR;3;2022-04-30;0;0;0;0;0;4414845;3439932;4412;2;3005
FR;3;2022-05-01;0;0;0;0;0;4414845;3439932;4412;2;3005
FR;3;2022-05-02;0;0;0;0;0;4414845;3439932;4412;2;3005
FR;3;2022-05-03;0;0;0;0;0;4414845;3439932;4412;2;3005
FR;3;2022-05-04;0;0;0;0;0;4414845;3439932;4412;2;3005
FR;3;2022-05-05;0;0;0;0;0;4414845;3439932;4412;2;3005
FR;3;2022-05-06;0;0;0;0;0;4414845;3439932;4412;2;3005
FR;3;2022-05-07;0;0;0;0;0;4414845;3439932;4412;2;3005
FR;3;2022-05-08;0;0;0;0;0;4414845;3439932;4412;2;3005
FR;3;2022-05-09;0;0;0;0;0;4414845;3439932;4412;2;3005
FR;3;2022-05-10;0;0;0;0;0;4414845;3439932;4412;2;3005
FR;3;2022-05-11;0;0;0;0;0;4414845;3439932;4412;2;3005
FR;3;2022-05-12;0;0;0;0;0;4414845;3439932;4412;2;3005
FR;3;2022-05-13;0;0;0;0;0;4414845;3439932;4412;2;3005
FR;3;2022-05-14;1;0;0;0;0;4414846;3439932;4412;2;3005
FR;3;2022-05-15;0;0;0;0;0;4414846;3439932;4412;2;3005
FR;3;2022-05-16;0;0;0;0;0;4414846;3439932;4412;2;3005
FR;3;2022-05-17;0;0;0;0;0;4414846;3439932;4412;2;3005
FR;3;2022-05-18;0;0;0;0;0;4414846;3439932;4412;2;3005
FR;3;2022-05-19;0;0;0;0;0;4414846;3439932;4412;2;3005
FR;4;2020-12-27;0;0;0;0;0;0;0;0;0;0
FR;4;2020-12-28;0;0;0;0;0;0;0;0;0;0
FR;4;2020-12-29;0;0;0;0;0;0;0;0;0;0
FR;4;2020-12-30;0;0;0;0;0;0;0;0;0;0
FR;4;2020-12-31;0;0;0;0;0;0;0;0;0;0
FR;4;2021-01-01;0;0;0;0;0;0;0;0;0;0
FR;4;2021-01-02;0;0;0;0;0;0;0;0;0;0
FR;4;2021-01-03;0;0;0;0;0;0;0;0;0;0
FR;4;2021-01-04;0;0;0;0;0;0;0;0;0;0
FR;4;2021-01-05;0;0;0;0;0;0;0;0;0;0
FR;4;2021-01-06;0;0;0;0;0;0;0;0;0;0
FR;4;2021-01-07;0;0;0;0;0;0;0;0;0;0
FR;4;2021-01-08;0;0;0;0;0;0;0;0;0;0
FR;4;2021-01-09;0;0;0;0;0;0;0;0;0;0
FR;4;2021-01-10;0;0;0;0;0;0;0;0;0;0
FR;4;2021-01-11;0;0;0;0;0;0;0;0;0;0
FR;4;2021-01-12;0;0;0;0;0;0;0;0;0;0
FR;4;2021-01-13;0;0;0;0;0;0;0;0;0;0
FR;4;2021-01-14;0;0;0;0;0;0;0;0;0;0
FR;4;2021-01-15;0;0;0;0;0;0;0;0;0;0
FR;4;2021-01-16;0;0;0;0;0;0;0;0;0;0
FR;4;2021-01-17;0;0;0;0;0;0;0;0;0;0
FR;4;2021-01-18;0;0;0;0;0;0;0;0;0;0
FR;4;2021-01-19;0;0;0;0;0;0;0;0;0;0
FR;4;2021-01-20;0;0;0;0;0;0;0;0;0;0
FR;4;2021-01-21;0;0;0;0;0;0;0;0;0;0
FR;4;2021-01-22;0;0;0;0;0;0;0;0;0;0
FR;4;2021-01-23;0;0;0;0;0;0;0;0;0;0
FR;4;2021-01-24;0;0;0;0;0;0;0;0;0;0
FR;4;2021-01-25;0;0;0;0;0;0;0;0;0;0
FR;4;2021-01-26;0;0;0;0;0;0;0;0;0;0
FR;4;2021-01-27;0;0;0;0;0;0;0;0;0;0
FR;4;2021-01-28;0;0;0;0;0;0;0;0;0;0
FR;4;2021-01-29;0;0;0;0;0;0;0;0;0;0
FR;4;2021-01-30;0;0;0;0;0;0;0;0;0;0
FR;4;2021-01-31;0;0;0;0;0;0;0;0;0;0
FR;4;2021-02-01;0;0;0;0;0;0;0;0;0;0
FR;4;2021-02-02;0;0;0;0;0;0;0;0;0;0
FR;4;2021-02-03;0;0;0;0;0;0;0;0;0;0
FR;4;2021-02-04;0;0;0;0;0;0;0;0;0;0
FR;4;2021-02-05;0;0;0;0;0;0;0;0;0;0
FR;4;2021-02-06;0;0;0;0;0;0;0;0;0;0
FR;4;2021-02-07;0;0;0;0;0;0;0;0;0;0
FR;4;2021-02-08;0;0;0;0;0;0;0;0;0;0
FR;4;2021-02-09;0;0;0;0;0;0;0;0;0;0
FR;4;2021-02-10;0;0;0;0;0;0;0;0;0;0
FR;4;2021-02-11;0;0;0;0;0;0;0;0;0;0
FR;4;2021-02-12;0;0;0;0;0;0;0;0;0;0
FR;4;2021-02-13;0;0;0;0;0;0;0;0;0;0
FR;4;2021-02-14;0;0;0;0;0;0;0;0;0;0
FR;4;2021-02-15;0;0;0;0;0;0;0;0;0;0
FR;4;2021-02-16;0;0;0;0;0;0;0;0;0;0
FR;4;2021-02-17;0;0;0;0;0;0;0;0;0;0
FR;4;2021-02-18;0;0;0;0;0;0;0;0;0;0
FR;4;2021-02-19;0;0;0;0;0;0;0;0;0;0
FR;4;2021-02-20;0;0;0;0;0;0;0;0;0;0
FR;4;2021-02-21;0;0;0;0;0;0;0;0;0;0
FR;4;2021-02-22;0;0;0;0;0;0;0;0;0;0
FR;4;2021-02-23;0;0;0;0;0;0;0;0;0;0
FR;4;2021-02-24;0;0;0;0;0;0;0;0;0;0
FR;4;2021-02-25;0;0;0;0;0;0;0;0;0;0
FR;4;2021-02-26;0;0;0;0;0;0;0;0;0;0
FR;4;2021-02-27;0;0;0;0;0;0;0;0;0;0
FR;4;2021-02-28;0;0;0;0;0;0;0;0;0;0
FR;4;2021-03-01;0;0;0;0;0;0;0;0;0;0
FR;4;2021-03-02;0;0;0;0;0;0;0;0;0;0
FR;4;2021-03-03;0;0;0;0;0;0;0;0;0;0
FR;4;2021-03-04;0;0;0;0;0;0;0;0;0;0
FR;4;2021-03-05;0;0;0;0;0;0;0;0;0;0
FR;4;2021-03-06;0;0;0;0;0;0;0;0;0;0
FR;4;2021-03-07;0;0;0;0;0;0;0;0;0;0
FR;4;2021-03-08;0;0;0;0;0;0;0;0;0;0
FR;4;2021-03-09;0;0;0;0;0;0;0;0;0;0
FR;4;2021-03-10;0;0;0;0;0;0;0;0;0;0
FR;4;2021-03-11;0;0;0;0;0;0;0;0;0;0
FR;4;2021-03-12;0;0;0;0;0;0;0;0;0;0
FR;4;2021-03-13;0;0;0;0;0;0;0;0;0;0
FR;4;2021-03-14;0;0;0;0;0;0;0;0;0;0
FR;4;2021-03-15;0;0;0;0;0;0;0;0;0;0
FR;4;2021-03-16;0;0;0;0;0;0;0;0;0;0
FR;4;2021-03-17;0;0;0;0;0;0;0;0;0;0
FR;4;2021-03-18;0;0;0;0;0;0;0;0;0;0
FR;4;2021-03-19;0;0;0;0;0;0;0;0;0;0
FR;4;2021-03-20;0;0;0;0;0;0;0;0;0;0
FR;4;2021-03-21;0;0;0;0;0;0;0;0;0;0
FR;4;2021-03-22;0;0;0;0;0;0;0;0;0;0
FR;4;2021-03-23;0;0;0;0;0;0;0;0;0;0
FR;4;2021-03-24;0;0;0;0;0;0;0;0;0;0
FR;4;2021-03-25;0;0;0;0;0;0;0;0;0;0
FR;4;2021-03-26;0;0;0;0;0;0;0;0;0;0
FR;4;2021-03-27;0;0;0;0;0;0;0;0;0;0
FR;4;2021-03-28;0;0;0;0;0;0;0;0;0;0
FR;4;2021-03-29;0;0;0;0;0;0;0;0;0;0
FR;4;2021-03-30;0;0;0;0;0;0;0;0;0;0
FR;4;2021-03-31;0;0;0;0;0;0;0;0;0;0
FR;4;2021-04-01;0;0;0;0;0;0;0;0;0;0
FR;4;2021-04-02;0;0;0;0;0;0;0;0;0;0
FR;4;2021-04-03;0;0;0;0;0;0;0;0;0;0
FR;4;2021-04-04;0;0;0;0;0;0;0;0;0;0
FR;4;2021-04-05;0;0;0;0;0;0;0;0;0;0
FR;4;2021-04-06;0;0;0;0;0;0;0;0;0;0
FR;4;2021-04-07;0;0;0;0;0;0;0;0;0;0
FR;4;2021-04-08;0;0;0;0;0;0;0;0;0;0
FR;4;2021-04-09;0;0;0;0;0;0;0;0;0;0
FR;4;2021-04-10;0;0;0;0;0;0;0;0;0;0
FR;4;2021-04-11;0;0;0;0;0;0;0;0;0;0
FR;4;2021-04-12;0;0;0;0;0;0;0;0;0;0
FR;4;2021-04-13;0;0;0;0;0;0;0;0;0;0
FR;4;2021-04-14;0;0;0;0;0;0;0;0;0;0
FR;4;2021-04-15;0;0;0;0;0;0;0;0;0;0
FR;4;2021-04-16;0;0;0;0;0;0;0;0;0;0
FR;4;2021-04-17;0;0;0;0;0;0;0;0;0;0
FR;4;2021-04-18;0;0;0;0;0;0;0;0;0;0
FR;4;2021-04-19;0;0;0;0;0;0;0;0;0;0
FR;4;2021-04-20;0;0;0;0;0;0;0;0;0;0
FR;4;2021-04-21;0;0;0;0;0;0;0;0;0;0
FR;4;2021-04-22;0;0;0;0;0;0;0;0;0;0
FR;4;2021-04-23;4018;0;0;0;0;4018;0;0;0;0
FR;4;2021-04-24;1569;0;0;0;0;5587;0;0;0;0
FR;4;2021-04-25;125;0;0;0;0;5712;0;0;0;0
FR;4;2021-04-26;2869;1;0;0;0;8581;1;0;0;0
FR;4;2021-04-27;9519;3;0;0;0;18100;4;0;0;0
FR;4;2021-04-28;9904;6;0;0;0;28004;10;0;0;0
FR;4;2021-04-29;15991;8;0;0;0;43995;18;0;0;0
FR;4;2021-04-30;19228;10;0;0;0;63223;28;0;0;0
FR;4;2021-05-01;1993;6;0;0;0;65216;34;0;0;0
FR;4;2021-05-02;482;0;0;0;0;65698;34;0;0;0
FR;4;2021-05-03;5058;2;0;0;0;70756;36;0;0;0
FR;4;2021-05-04;8397;10;0;0;0;79153;46;0;0;0
FR;4;2021-05-05;6182;7;0;0;0;85335;53;0;0;0
FR;4;2021-05-06;11377;11;0;0;0;96712;64;0;0;0
FR;4;2021-05-07;19120;9;0;0;0;115832;73;0;0;0
FR;4;2021-05-08;2377;6;0;0;0;118209;79;0;0;0
FR;4;2021-05-09;685;3;0;0;0;118894;82;0;0;0
FR;4;2021-05-10;7239;5;1;0;0;126133;87;1;0;0
FR;4;2021-05-11;14313;12;0;0;0;140446;99;1;0;0
FR;4;2021-05-12;10161;15;0;0;0;150607;114;1;0;0
FR;4;2021-05-13;1579;3;0;0;0;152186;117;1;0;0
FR;4;2021-05-14;7758;6;0;0;0;159944;123;1;0;0
FR;4;2021-05-15;3717;8;1;0;0;163661;131;2;0;0
FR;4;2021-05-16;417;1;0;0;0;164078;132;2;0;0
FR;4;2021-05-17;4475;6;0;0;0;168553;138;2;0;0
FR;4;2021-05-18;8751;10;0;0;0;177304;148;2;0;0
FR;4;2021-05-19;5690;7;0;0;0;182994;155;2;0;0
FR;4;2021-05-20;9478;7;0;0;0;192472;162;2;0;0
FR;4;2021-05-21;12790;30;0;0;0;205262;192;2;0;0
FR;4;2021-05-22;5057;15;0;0;0;210319;207;2;0;0
FR;4;2021-05-23;494;4;0;0;0;210813;211;2;0;0
FR;4;2021-05-24;1054;7;0;0;0;211867;218;2;0;0
FR;4;2021-05-25;7619;16;0;0;0;219486;234;2;0;0
FR;4;2021-05-26;7723;16;0;0;0;227209;250;2;0;0
FR;4;2021-05-27;14330;35;0;0;0;241539;285;2;0;0
FR;4;2021-05-28;26583;82;1;0;0;268122;367;3;0;0
FR;4;2021-05-29;11380;18;0;0;0;279502;385;3;0;0
FR;4;2021-05-30;971;6;0;0;0;280473;391;3;0;0
FR;4;2021-05-31;12685;21;0;0;0;293158;412;3;0;0
FR;4;2021-06-01;20248;46;1;0;0;313406;458;4;0;0
FR;4;2021-06-02;14517;33;0;0;0;327923;491;4;0;0
FR;4;2021-06-03;19408;24;1;0;0;347331;515;5;0;0
FR;4;2021-06-04;22508;47;0;0;0;369839;562;5;0;0
FR;4;2021-06-05;9712;32;0;0;0;379551;594;5;0;0
FR;4;2021-06-06;1039;1;0;0;0;380590;595;5;0;0
FR;4;2021-06-07;9225;19;0;0;0;389815;614;5;0;0
FR;4;2021-06-08;14605;31;0;0;0;404420;645;5;0;0
FR;4;2021-06-09;12202;25;0;0;0;416622;670;5;0;0
FR;4;2021-06-10;15397;30;0;0;0;432019;700;5;0;0
FR;4;2021-06-11;16978;56;0;0;0;448997;756;5;0;0
FR;4;2021-06-12;7445;27;0;0;0;456442;783;5;0;0
FR;4;2021-06-13;906;2;0;0;0;457348;785;5;0;0
FR;4;2021-06-14;6646;25;0;0;0;463994;810;5;0;0
FR;4;2021-06-15;10882;37;0;0;0;474876;847;5;0;0
FR;4;2021-06-16;8905;15;0;0;0;483781;862;5;0;0
FR;4;2021-06-17;10897;36;0;0;0;494678;898;5;0;0
FR;4;2021-06-18;12420;45;0;0;0;507098;943;5;0;0
FR;4;2021-06-19;5567;25;0;0;0;512665;968;5;0;0
FR;4;2021-06-20;817;5;0;0;0;513482;973;5;0;0
FR;4;2021-06-21;5080;20;0;0;0;518562;993;5;0;0
FR;4;2021-06-22;7905;28;2;0;0;526467;1021;7;0;0
FR;4;2021-06-23;7091;39;2;0;0;533558;1060;9;0;0
FR;4;2021-06-24;8645;45;1;0;0;542203;1105;10;0;0
FR;4;2021-06-25;10172;39;2;0;0;552375;1144;12;0;0
FR;4;2021-06-26;4841;21;0;0;0;557216;1165;12;0;0
FR;4;2021-06-27;760;3;0;0;0;557976;1168;12;0;0
FR;4;2021-06-28;4820;16;1;0;0;562796;1184;13;0;0
FR;4;2021-06-29;7097;27;2;0;0;569893;1211;15;0;0
FR;4;2021-06-30;6706;39;2;0;0;576599;1250;17;0;0
FR;4;2021-07-01;8190;40;0;0;0;584789;1290;17;0;0
FR;4;2021-07-02;9411;52;1;0;0;594200;1342;18;0;0
FR;4;2021-07-03;4843;19;0;0;0;599043;1361;18;0;0
FR;4;2021-07-04;686;5;0;0;0;599729;1366;18;0;0
FR;4;2021-07-05;4765;19;2;0;0;604494;1385;20;0;0
FR;4;2021-07-06;7717;28;4;0;0;612211;1413;24;0;0
FR;4;2021-07-07;7067;34;2;0;0;619278;1447;26;0;0
FR;4;2021-07-08;9218;40;2;0;0;628496;1487;28;0;0
FR;4;2021-07-09;10275;34;1;0;0;638771;1521;29;0;0
FR;4;2021-07-10;4634;14;2;0;0;643405;1535;31;0;0
FR;4;2021-07-11;582;4;1;0;0;643987;1539;32;0;0
FR;4;2021-07-12;5867;29;0;0;0;649854;1568;32;0;0
FR;4;2021-07-13;14229;29;0;0;0;664083;1597;32;0;0
FR;4;2021-07-14;2282;14;0;0;0;666365;1611;32;0;0
FR;4;2021-07-15;18231;36;0;0;0;684596;1647;32;0;0
FR;4;2021-07-16;22815;70;2;0;0;707411;1717;34;0;0
FR;4;2021-07-17;9735;20;0;0;0;717146;1737;34;0;0
FR;4;2021-07-18;1354;4;0;0;0;718500;1741;34;0;0
FR;4;2021-07-19;12978;28;1;0;0;731478;1769;35;0;0
FR;4;2021-07-20;17330;26;1;0;0;748808;1795;36;0;0
FR;4;2021-07-21;15604;33;0;0;0;764412;1828;36;0;0
FR;4;2021-07-22;18237;44;2;0;0;782649;1872;38;0;0
FR;4;2021-07-23;20404;57;7;0;0;803053;1929;45;0;0
FR;4;2021-07-24;9282;32;0;0;0;812335;1961;45;0;0
FR;4;2021-07-25;1350;8;0;0;0;813685;1969;45;0;0
FR;4;2021-07-26;11030;20;0;0;0;824715;1989;45;0;0
FR;4;2021-07-27;14661;35;3;0;0;839376;2024;48;0;0
FR;4;2021-07-28;12921;26;2;0;0;852297;2050;50;0;0
FR;4;2021-07-29;14079;54;4;0;0;866376;2104;54;0;0
FR;4;2021-07-30;15478;45;2;0;0;881854;2149;56;0;0
FR;4;2021-07-31;6830;14;2;0;0;888684;2163;58;0;0
FR;4;2021-08-01;904;1;0;0;0;889588;2164;58;0;0
FR;4;2021-08-02;7902;29;0;0;0;897490;2193;58;0;0
FR;4;2021-08-03;10788;32;2;0;0;908278;2225;60;0;0
FR;4;2021-08-04;9730;29;0;0;0;918008;2254;60;0;0
FR;4;2021-08-05;9812;41;0;0;0;927820;2295;60;0;0
FR;4;2021-08-06;10181;30;3;0;0;938001;2325;63;0;0
FR;4;2021-08-07;5088;30;1;0;0;943089;2355;64;0;0
FR;4;2021-08-08;1216;13;0;0;0;944305;2368;64;0;0
FR;4;2021-08-09;6334;31;0;0;0;950639;2399;64;0;0
FR;4;2021-08-10;8741;18;0;0;0;959380;2417;64;0;0
FR;4;2021-08-11;7929;33;4;0;0;967309;2450;68;0;0
FR;4;2021-08-12;8579;29;1;0;0;975888;2479;69;0;0
FR;4;2021-08-13;7545;24;0;1;0;983433;2503;69;1;0
FR;4;2021-08-14;3784;20;0;0;0;987217;2523;69;1;0
FR;4;2021-08-15;769;5;0;0;0;987986;2528;69;1;0
FR;4;2021-08-16;4003;16;0;0;0;991989;2544;69;1;0
FR;4;2021-08-17;5615;16;1;0;0;997604;2560;70;1;0
FR;4;2021-08-18;5161;34;0;0;0;1002765;2594;70;1;0
FR;4;2021-08-19;5473;34;3;0;0;1008238;2628;73;1;0
FR;4;2021-08-20;5209;23;1;0;0;1013447;2651;74;1;0
FR;4;2021-08-21;2307;21;1;0;0;1015754;2672;75;1;0
FR;4;2021-08-22;401;2;0;0;0;1016155;2674;75;1;0
FR;4;2021-08-23;2923;19;1;0;0;1019078;2693;76;1;0
FR;4;2021-08-24;3744;15;0;0;0;1022822;2708;76;1;0
FR;4;2021-08-25;3538;25;0;0;0;1026360;2733;76;1;0
FR;4;2021-08-26;3700;20;2;0;0;1030060;2753;78;1;0
FR;4;2021-08-27;3605;31;2;0;0;1033665;2784;80;1;0
FR;4;2021-08-28;1722;9;1;0;0;1035387;2793;81;1;0
FR;4;2021-08-29;387;7;1;0;0;1035774;2800;82;1;0
FR;4;2021-08-30;2008;24;0;0;14;1037782;2824;82;1;14
FR;4;2021-08-31;2480;20;0;0;13;1040262;2844;82;1;27
FR;4;2021-09-01;2077;38;1;0;21;1042339;2882;83;1;48
FR;4;2021-09-02;2301;31;4;0;18;1044640;2913;87;1;66
FR;4;2021-09-03;2356;44;5;0;32;1046996;2957;92;1;98
FR;4;2021-09-04;1374;17;0;0;7;1048370;2974;92;1;105
FR;4;2021-09-05;430;2;0;0;2;1048800;2976;92;1;107
FR;4;2021-09-06;1706;62;0;0;23;1050506;3038;92;1;130
FR;4;2021-09-07;1672;18;1;0;9;1052178;3056;93;1;139
FR;4;2021-09-08;1279;27;3;1;20;1053457;3083;96;2;159
FR;4;2021-09-09;1387;23;2;0;9;1054844;3106;98;2;168
FR;4;2021-09-10;1516;31;2;0;23;1056360;3137;100;2;191
FR;4;2021-09-11;737;11;0;0;3;1057097;3148;100;2;194
FR;4;2021-09-12;168;4;0;0;2;1057265;3152;100;2;196
FR;4;2021-09-13;1315;22;1;0;16;1058580;3174;101;2;212
FR;4;2021-09-14;1497;9;2;0;6;1060077;3183;103;2;218
FR;4;2021-09-15;1091;27;1;0;24;1061168;3210;104;2;242
FR;4;2021-09-16;1095;22;2;0;15;1062263;3232;106;2;257
FR;4;2021-09-17;892;21;1;0;12;1063155;3253;107;2;269
FR;4;2021-09-18;462;6;1;0;5;1063617;3259;108;2;274
FR;4;2021-09-19;182;3;0;0;2;1063799;3262;108;2;276
FR;4;2021-09-20;443;18;0;0;12;1064242;3280;108;2;288
FR;4;2021-09-21;422;11;0;0;7;1064664;3291;108;2;295
FR;4;2021-09-22;372;19;2;0;13;1065036;3310;110;2;308
FR;4;2021-09-23;477;16;1;0;15;1065513;3326;111;2;323
FR;4;2021-09-24;409;13;2;0;9;1065922;3339;113;2;332
FR;4;2021-09-25;281;9;1;0;4;1066203;3348;114;2;336
FR;4;2021-09-26;73;2;0;0;1;1066276;3350;114;2;337
FR;4;2021-09-27;261;10;1;0;8;1066537;3360;115;2;345
FR;4;2021-09-28;315;8;0;0;8;1066852;3368;115;2;353
FR;4;2021-09-29;372;19;1;0;13;1067224;3387;116;2;366
FR;4;2021-09-30;359;40;0;0;21;1067583;3427;116;2;387
FR;4;2021-10-01;407;49;0;0;43;1067990;3476;116;2;430
FR;4;2021-10-02;195;22;1;0;13;1068185;3498;117;2;443
FR;4;2021-10-03;84;1;0;0;0;1068269;3499;117;2;443
FR;4;2021-10-04;355;19;1;0;15;1068624;3518;118;2;458
FR;4;2021-10-05;275;19;2;0;15;1068899;3537;120;2;473
FR;4;2021-10-06;243;21;1;0;17;1069142;3558;121;2;490
FR;4;2021-10-07;254;25;2;0;13;1069396;3583;123;2;503
FR;4;2021-10-08;352;23;2;0;19;1069748;3606;125;2;522
FR;4;2021-10-09;192;6;6;0;7;1069940;3612;131;2;529
FR;4;2021-10-10;95;3;2;0;3;1070035;3615;133;2;532
FR;4;2021-10-11;246;15;1;0;14;1070281;3630;134;2;546
FR;4;2021-10-12;203;14;0;0;13;1070484;3644;134;2;559
FR;4;2021-10-13;218;27;1;0;24;1070702;3671;135;2;583
FR;4;2021-10-14;306;22;4;0;16;1071008;3693;139;2;599
FR;4;2021-10-15;322;24;5;0;25;1071330;3717;144;2;624
FR;4;2021-10-16;165;6;2;0;6;1071495;3723;146;2;630
FR;4;2021-10-17;70;2;0;0;1;1071565;3725;146;2;631
FR;4;2021-10-18;278;16;1;0;12;1071843;3741;147;2;643
FR;4;2021-10-19;209;14;2;0;15;1072052;3755;149;2;658
FR;4;2021-10-20;224;27;4;0;15;1072276;3782;153;2;673
FR;4;2021-10-21;234;17;0;0;13;1072510;3799;153;2;686
FR;4;2021-10-22;211;26;2;0;21;1072721;3825;155;2;707
FR;4;2021-10-23;115;16;1;0;15;1072836;3841;156;2;722
FR;4;2021-10-24;38;4;0;0;1;1072874;3845;156;2;723
FR;4;2021-10-25;209;7;2;0;9;1073083;3852;158;2;732
FR;4;2021-10-26;196;14;0;0;12;1073279;3866;158;2;744
FR;4;2021-10-27;190;11;4;0;11;1073469;3877;162;2;755
FR;4;2021-10-28;182;18;4;0;21;1073651;3895;166;2;776
FR;4;2021-10-29;220;15;2;0;13;1073871;3910;168;2;789
FR;4;2021-10-30;102;2;1;0;2;1073973;3912;169;2;791
FR;4;2021-10-31;56;3;2;0;3;1074029;3915;171;2;794
FR;4;2021-11-01;75;27;4;0;24;1074104;3942;175;2;818
FR;4;2021-11-02;153;20;2;0;21;1074257;3962;177;2;839
FR;4;2021-11-03;127;20;8;1;18;1074384;3982;185;3;857
FR;4;2021-11-04;175;14;1;0;11;1074559;3996;186;3;868
FR;4;2021-11-05;126;17;1;0;16;1074685;4013;187;3;884
FR;4;2021-11-06;77;6;1;0;6;1074762;4019;188;3;890
FR;4;2021-11-07;76;2;2;0;4;1074838;4021;190;3;894
FR;4;2021-11-08;158;20;1;0;20;1074996;4041;191;3;914
FR;4;2021-11-09;151;14;3;0;16;1075147;4055;194;3;930
FR;4;2021-11-10;114;29;6;0;31;1075261;4084;200;3;961
FR;4;2021-11-11;84;10;0;0;10;1075345;4094;200;3;971
FR;4;2021-11-12;97;18;2;0;17;1075442;4112;202;3;988
FR;4;2021-11-13;73;15;2;0;14;1075515;4127;204;3;1002
FR;4;2021-11-14;53;5;3;0;7;1075568;4132;207;3;1009
FR;4;2021-11-15;97;26;2;0;24;1075665;4158;209;3;1033
FR;4;2021-11-16;99;12;2;0;14;1075764;4170;211;3;1047
FR;4;2021-11-17;115;29;4;0;29;1075879;4199;215;3;1076
FR;4;2021-11-18;99;34;12;0;41;1075978;4233;227;3;1117
FR;4;2021-11-19;79;19;3;0;20;1076057;4252;230;3;1137
FR;4;2021-11-20;75;7;1;0;7;1076132;4259;231;3;1144
FR;4;2021-11-21;61;7;2;0;9;1076193;4266;233;3;1153
FR;4;2021-11-22;101;27;6;0;29;1076294;4293;239;3;1182
FR;4;2021-11-23;73;29;5;0;26;1076367;4322;244;3;1208
FR;4;2021-11-24;85;23;9;0;22;1076452;4345;253;3;1230
FR;4;2021-11-25;84;28;14;0;30;1076536;4373;267;3;1260
FR;4;2021-11-26;80;43;12;0;45;1076616;4416;279;3;1305
FR;4;2021-11-27;35;22;16;0;24;1076651;4438;295;3;1329
FR;4;2021-11-28;48;8;0;0;7;1076699;4446;295;3;1336
FR;4;2021-11-29;83;31;15;0;39;1076782;4477;310;3;1375
FR;4;2021-11-30;72;36;12;0;40;1076854;4513;322;3;1415
FR;4;2021-12-01;78;59;19;0;66;1076932;4572;341;3;1481
FR;4;2021-12-02;97;47;19;0;52;1077029;4619;360;3;1533
FR;4;2021-12-03;98;36;15;0;44;1077127;4655;375;3;1577
FR;4;2021-12-04;69;31;18;0;44;1077196;4686;393;3;1621
FR;4;2021-12-05;60;5;1;0;6;1077256;4691;394;3;1627
FR;4;2021-12-06;96;45;20;0;59;1077352;4736;414;3;1686
FR;4;2021-12-07;77;33;9;0;33;1077429;4769;423;3;1719
FR;4;2021-12-08;66;29;16;0;34;1077495;4798;439;3;1753
FR;4;2021-12-09;59;32;10;0;38;1077554;4830;449;3;1791
FR;4;2021-12-10;60;62;21;0;66;1077614;4892;470;3;1857
FR;4;2021-12-11;24;33;7;0;33;1077638;4925;477;3;1890
FR;4;2021-12-12;23;10;3;0;13;1077661;4935;480;3;1903
FR;4;2021-12-13;68;39;13;0;48;1077729;4974;493;3;1951
FR;4;2021-12-14;56;43;15;0;52;1077785;5017;508;3;2003
FR;4;2021-12-15;58;63;28;0;83;1077843;5080;536;3;2086
FR;4;2021-12-16;30;44;18;0;56;1077873;5124;554;3;2142
FR;4;2021-12-17;38;55;12;0;60;1077911;5179;566;3;2202
FR;4;2021-12-18;48;29;2;0;30;1077959;5208;568;3;2232
FR;4;2021-12-19;15;4;1;0;4;1077974;5212;569;3;2236
FR;4;2021-12-20;35;38;11;0;42;1078009;5250;580;3;2278
FR;4;2021-12-21;25;30;15;0;36;1078034;5280;595;3;2314
FR;4;2021-12-22;35;35;10;0;36;1078069;5315;605;3;2350
FR;4;2021-12-23;39;43;8;0;47;1078108;5358;613;3;2397
FR;4;2021-12-24;23;25;10;0;29;1078131;5383;623;3;2426
FR;4;2021-12-25;6;3;3;0;4;1078137;5386;626;3;2430
FR;4;2021-12-26;4;3;1;0;2;1078141;5389;627;3;2432
FR;4;2021-12-27;26;42;8;0;43;1078167;5431;635;3;2475
FR;4;2021-12-28;24;28;8;0;29;1078191;5459;643;3;2504
FR;4;2021-12-29;48;24;10;0;28;1078239;5483;653;3;2532
FR;4;2021-12-30;40;16;12;0;19;1078279;5499;665;3;2551
FR;4;2021-12-31;18;5;8;0;10;1078297;5504;673;3;2561
FR;4;2022-01-01;5;4;4;0;6;1078302;5508;677;3;2567
FR;4;2022-01-02;40;4;14;0;17;1078342;5512;691;3;2584
FR;4;2022-01-03;37;52;20;1;57;1078379;5564;711;4;2641
FR;4;2022-01-04;28;26;12;0;28;1078407;5590;723;4;2669
FR;4;2022-01-05;46;19;16;0;20;1078453;5609;739;4;2689
FR;4;2022-01-06;43;20;21;0;33;1078496;5629;760;4;2722
FR;4;2022-01-07;24;19;15;0;19;1078520;5648;775;4;2741
FR;4;2022-01-08;8;5;9;0;11;1078528;5653;784;4;2752
FR;4;2022-01-09;17;2;1;0;2;1078545;5655;785;4;2754
FR;4;2022-01-10;39;22;16;0;33;1078584;5677;801;4;2787
FR;4;2022-01-11;23;30;14;0;34;1078607;5707;815;4;2821
FR;4;2022-01-12;30;18;12;0;19;1078637;5725;827;4;2840
FR;4;2022-01-13;48;18;27;0;35;1078685;5743;854;4;2875
FR;4;2022-01-14;21;28;13;0;31;1078706;5771;867;4;2906
FR;4;2022-01-15;10;6;7;0;11;1078716;5777;874;4;2917
FR;4;2022-01-16;9;9;11;0;19;1078725;5786;885;4;2936
FR;4;2022-01-17;23;17;11;0;22;1078748;5803;896;4;2958
FR;4;2022-01-18;15;13;7;0;17;1078763;5816;903;4;2975
FR;4;2022-01-19;28;22;9;0;29;1078791;5838;912;4;3004
FR;4;2022-01-20;30;33;11;0;36;1078821;5871;923;4;3040
FR;4;2022-01-21;9;12;18;1;15;1078830;5883;941;5;3055
FR;4;2022-01-22;30;9;2;0;9;1078860;5892;943;5;3064
FR;4;2022-01-23;6;2;4;0;6;1078866;5894;947;5;3070
FR;4;2022-01-24;14;21;8;0;27;1078880;5915;955;5;3097
FR;4;2022-01-25;20;30;8;1;34;1078900;5945;963;6;3131
FR;4;2022-01-26;18;15;6;1;16;1078918;5960;969;7;3147
FR;4;2022-01-27;19;18;5;0;21;1078937;5978;974;7;3168
FR;4;2022-01-28;12;23;7;0;25;1078949;6001;981;7;3193
FR;4;2022-01-29;15;6;4;0;9;1078964;6007;985;7;3202
FR;4;2022-01-30;16;2;0;0;2;1078980;6009;985;7;3204
FR;4;2022-01-31;19;27;6;0;29;1078999;6036;991;7;3233
FR;4;2022-02-01;9;19;11;0;19;1079008;6055;1002;7;3252
FR;4;2022-02-02;16;11;10;2;16;1079024;6066;1012;9;3268
FR;4;2022-02-03;12;21;9;0;24;1079036;6087;1021;9;3292
FR;4;2022-02-04;6;5;7;0;9;1079042;6092;1028;9;3301
FR;4;2022-02-05;6;14;1;0;13;1079048;6106;1029;9;3314
FR;4;2022-02-06;5;2;1;0;2;1079053;6108;1030;9;3316
FR;4;2022-02-07;11;19;6;0;19;1079064;6127;1036;9;3335
FR;4;2022-02-08;14;18;12;1;19;1079078;6145;1048;10;3354
FR;4;2022-02-09;14;10;7;0;13;1079092;6155;1055;10;3367
FR;4;2022-02-10;18;23;9;0;24;1079110;6178;1064;10;3391
FR;4;2022-02-11;17;14;8;0;19;1079127;6192;1072;10;3410
FR;4;2022-02-12;23;7;1;0;6;1079150;6199;1073;10;3416
FR;4;2022-02-13;7;3;3;0;6;1079157;6202;1076;10;3422
FR;4;2022-02-14;18;10;7;0;13;1079175;6212;1083;10;3435
FR;4;2022-02-15;16;7;1;0;7;1079191;6219;1084;10;3442
FR;4;2022-02-16;11;9;10;0;15;1079202;6228;1094;10;3457
FR;4;2022-02-17;10;4;4;0;6;1079212;6232;1098;10;3463
FR;4;2022-02-18;17;13;6;0;17;1079229;6245;1104;10;3480
FR;4;2022-02-19;16;2;2;0;4;1079245;6247;1106;10;3484
FR;4;2022-02-20;7;2;0;0;1;1079252;6249;1106;10;3485
FR;4;2022-02-21;22;3;2;0;3;1079274;6252;1108;10;3488
FR;4;2022-02-22;8;4;8;0;8;1079282;6256;1116;10;3496
FR;4;2022-02-23;16;6;8;0;8;1079298;6262;1124;10;3504
FR;4;2022-02-24;8;3;2;0;3;1079306;6265;1126;10;3507
FR;4;2022-02-25;15;5;7;0;6;1079321;6270;1133;10;3513
FR;4;2022-02-26;26;3;0;0;3;1079347;6273;1133;10;3516
FR;4;2022-02-27;9;0;1;0;1;1079356;6273;1134;10;3517
FR;4;2022-02-28;14;3;2;0;3;1079370;6276;1136;10;3520
FR;4;2022-03-01;6;2;7;0;3;1079376;6278;1143;10;3523
FR;4;2022-03-02;9;2;3;0;4;1079385;6280;1146;10;3527
FR;4;2022-03-03;14;5;1;0;4;1079399;6285;1147;10;3531
FR;4;2022-03-04;6;6;2;1;5;1079405;6291;1149;11;3536
FR;4;2022-03-05;8;2;0;0;2;1079413;6293;1149;11;3538
FR;4;2022-03-06;4;0;1;0;1;1079417;6293;1150;11;3539
FR;4;2022-03-07;9;4;1;0;3;1079426;6297;1151;11;3542
FR;4;2022-03-08;13;2;0;0;2;1079439;6299;1151;11;3544
FR;4;2022-03-09;7;3;2;0;4;1079446;6302;1153;11;3548
FR;4;2022-03-10;5;1;5;0;2;1079451;6303;1158;11;3550
FR;4;2022-03-11;7;2;5;0;1;1079458;6305;1163;11;3551
FR;4;2022-03-12;9;2;0;0;0;1079467;6307;1163;11;3551
FR;4;2022-03-13;5;0;1;0;1;1079472;6307;1164;11;3552
FR;4;2022-03-14;4;1;0;0;1;1079476;6308;1164;11;3553
FR;4;2022-03-15;5;3;1;0;1;1079481;6311;1165;11;3554
FR;4;2022-03-16;6;3;3;0;3;1079487;6314;1168;11;3557
FR;4;2022-03-17;1;4;1;0;5;1079488;6318;1169;11;3562
FR;4;2022-03-18;7;2;0;0;2;1079495;6320;1169;11;3564
FR;4;2022-03-19;1;1;0;0;1;1079496;6321;1169;11;3565
FR;4;2022-03-20;2;0;1;0;0;1079498;6321;1170;11;3565
FR;4;2022-03-21;5;3;0;0;3;1079503;6324;1170;11;3568
FR;4;2022-03-22;2;2;0;0;2;1079505;6326;1170;11;3570
FR;4;2022-03-23;6;3;3;0;5;1079511;6329;1173;11;3575
FR;4;2022-03-24;2;4;3;1;5;1079513;6333;1176;12;3580
FR;4;2022-03-25;3;1;2;0;1;1079516;6334;1178;12;3581
FR;4;2022-03-26;5;5;0;0;5;1079521;6339;1178;12;3586
FR;4;2022-03-27;0;0;1;0;0;1079521;6339;1179;12;3586
FR;4;2022-03-28;4;1;1;0;1;1079525;6340;1180;12;3587
FR;4;2022-03-29;7;0;4;1;0;1079532;6340;1184;13;3587
FR;4;2022-03-30;1;4;0;0;4;1079533;6344;1184;13;3591
FR;4;2022-03-31;1;3;1;1;3;1079534;6347;1185;14;3594
FR;4;2022-04-01;13;3;5;0;6;1079547;6350;1190;14;3600
FR;4;2022-04-02;4;4;0;0;3;1079551;6354;1190;14;3603
FR;4;2022-04-03;0;0;0;0;0;1079551;6354;1190;14;3603
FR;4;2022-04-04;3;3;4;0;3;1079554;6357;1194;14;3606
FR;4;2022-04-05;3;4;1;1;2;1079557;6361;1195;15;3608
FR;4;2022-04-06;3;0;0;0;0;1079560;6361;1195;15;3608
FR;4;2022-04-07;3;2;1;2;3;1079563;6363;1196;17;3611
FR;4;2022-04-08;4;1;1;0;1;1079567;6364;1197;17;3612
FR;4;2022-04-09;0;0;1;1;1;1079567;6364;1198;18;3613
FR;4;2022-04-10;1;2;0;0;2;1079568;6366;1198;18;3615
FR;4;2022-04-11;2;2;4;0;4;1079570;6368;1202;18;3619
FR;4;2022-04-12;2;1;3;0;2;1079572;6369;1205;18;3621
FR;4;2022-04-13;2;6;1;0;7;1079574;6375;1206;18;3628
FR;4;2022-04-14;3;2;0;1;2;1079577;6377;1206;19;3630
FR;4;2022-04-15;0;7;1;0;8;1079577;6384;1207;19;3638
FR;4;2022-04-16;0;0;0;0;0;1079577;6384;1207;19;3638
FR;4;2022-04-17;1;0;0;0;0;1079578;6384;1207;19;3638
FR;4;2022-04-18;1;2;4;0;2;1079579;6386;1211;19;3640
FR;4;2022-04-19;2;0;1;0;0;1079581;6386;1212;19;3640
FR;4;2022-04-20;12;4;1;0;2;1079593;6390;1213;19;3642
FR;4;2022-04-21;5;2;0;0;2;1079598;6392;1213;19;3644
FR;4;2022-04-22;1;0;1;0;0;1079599;6392;1214;19;3644
FR;4;2022-04-23;1;3;1;0;4;1079600;6395;1215;19;3648
FR;4;2022-04-24;0;2;0;0;2;1079600;6397;1215;19;3650
FR;4;2022-04-25;2;4;2;0;6;1079602;6401;1217;19;3656
FR;4;2022-04-26;2;4;1;0;4;1079604;6405;1218;19;3660
FR;4;2022-04-27;3;0;0;0;0;1079607;6405;1218;19;3660
FR;4;2022-04-28;2;3;5;0;4;1079609;6408;1223;19;3664
FR;4;2022-04-29;2;2;0;0;1;1079611;6410;1223;19;3665
FR;4;2022-04-30;0;1;1;0;2;1079611;6411;1224;19;3667
FR;4;2022-05-01;0;0;0;0;0;1079611;6411;1224;19;3667
FR;4;2022-05-02;2;5;2;0;5;1079613;6416;1226;19;3672
FR;4;2022-05-03;0;3;1;0;3;1079613;6419;1227;19;3675
FR;4;2022-05-04;3;1;0;0;1;1079616;6420;1227;19;3676
FR;4;2022-05-05;2;1;1;0;1;1079618;6421;1228;19;3677
FR;4;2022-05-06;2;0;0;0;0;1079620;6421;1228;19;3677
FR;4;2022-05-07;0;0;0;0;0;1079620;6421;1228;19;3677
FR;4;2022-05-08;1;1;0;0;1;1079621;6422;1228;19;3678
FR;4;2022-05-09;2;0;0;0;0;1079623;6422;1228;19;3678
FR;4;2022-05-10;0;1;0;2;3;1079623;6423;1228;21;3681
FR;4;2022-05-11;2;0;0;0;0;1079625;6423;1228;21;3681
FR;4;2022-05-12;5;0;0;1;0;1079630;6423;1228;22;3681
FR;4;2022-05-13;0;0;0;0;0;1079630;6423;1228;22;3681
FR;4;2022-05-14;0;1;0;0;1;1079630;6424;1228;22;3682
FR;4;2022-05-15;0;0;0;0;0;1079630;6424;1228;22;3682
FR;4;2022-05-16;3;0;0;0;0;1079633;6424;1228;22;3682
FR;4;2022-05-17;2;0;0;0;0;1079635;6424;1228;22;3682
FR;4;2022-05-18;0;0;0;0;0;1079635;6424;1228;22;3682
FR;4;2022-05-19;2;0;1;0;1;1079637;6424;1229;22;3683
FR;5;2020-12-27;0;0;0;0;0;0;0;0;0;0
FR;5;2020-12-28;0;0;0;0;0;0;0;0;0;0
FR;5;2020-12-29;0;0;0;0;0;0;0;0;0;0
FR;5;2020-12-30;0;0;0;0;0;0;0;0;0;0
FR;5;2020-12-31;0;0;0;0;0;0;0;0;0;0
FR;5;2021-01-01;0;0;0;0;0;0;0;0;0;0
FR;5;2021-01-02;0;0;0;0;0;0;0;0;0;0
FR;5;2021-01-03;0;0;0;0;0;0;0;0;0;0
FR;5;2021-01-04;0;0;0;0;0;0;0;0;0;0
FR;5;2021-01-05;0;0;0;0;0;0;0;0;0;0
FR;5;2021-01-06;0;0;0;0;0;0;0;0;0;0
FR;5;2021-01-07;0;0;0;0;0;0;0;0;0;0
FR;5;2021-01-08;0;0;0;0;0;0;0;0;0;0
FR;5;2021-01-09;0;0;0;0;0;0;0;0;0;0
FR;5;2021-01-10;0;0;0;0;0;0;0;0;0;0
FR;5;2021-01-11;0;0;0;0;0;0;0;0;0;0
FR;5;2021-01-12;0;0;0;0;0;0;0;0;0;0
FR;5;2021-01-13;0;0;0;0;0;0;0;0;0;0
FR;5;2021-01-14;0;0;0;0;0;0;0;0;0;0
FR;5;2021-01-15;0;0;0;0;0;0;0;0;0;0
FR;5;2021-01-16;0;0;0;0;0;0;0;0;0;0
FR;5;2021-01-17;0;0;0;0;0;0;0;0;0;0
FR;5;2021-01-18;0;0;0;0;0;0;0;0;0;0
FR;5;2021-01-19;0;0;0;0;0;0;0;0;0;0
FR;5;2021-01-20;0;0;0;0;0;0;0;0;0;0
FR;5;2021-01-21;0;0;0;0;0;0;0;0;0;0
FR;5;2021-01-22;0;0;0;0;0;0;0;0;0;0
FR;5;2021-01-23;0;0;0;0;0;0;0;0;0;0
FR;5;2021-01-24;0;0;0;0;0;0;0;0;0;0
FR;5;2021-01-25;0;0;0;0;0;0;0;0;0;0
FR;5;2021-01-26;0;0;0;0;0;0;0;0;0;0
FR;5;2021-01-27;0;0;0;0;0;0;0;0;0;0
FR;5;2021-01-28;0;0;0;0;0;0;0;0;0;0
FR;5;2021-01-29;0;0;0;0;0;0;0;0;0;0
FR;5;2021-01-30;0;0;0;0;0;0;0;0;0;0
FR;5;2021-01-31;0;0;0;0;0;0;0;0;0;0
FR;5;2021-02-01;0;0;0;0;0;0;0;0;0;0
FR;5;2021-02-02;0;0;0;0;0;0;0;0;0;0
FR;5;2021-02-03;0;0;0;0;0;0;0;0;0;0
FR;5;2021-02-04;0;0;0;0;0;0;0;0;0;0
FR;5;2021-02-05;0;0;0;0;0;0;0;0;0;0
FR;5;2021-02-06;0;0;0;0;0;0;0;0;0;0
FR;5;2021-02-07;0;0;0;0;0;0;0;0;0;0
FR;5;2021-02-08;0;0;0;0;0;0;0;0;0;0
FR;5;2021-02-09;0;0;0;0;0;0;0;0;0;0
FR;5;2021-02-10;0;0;0;0;0;0;0;0;0;0
FR;5;2021-02-11;0;0;0;0;0;0;0;0;0;0
FR;5;2021-02-12;0;0;0;0;0;0;0;0;0;0
FR;5;2021-02-13;0;0;0;0;0;0;0;0;0;0
FR;5;2021-02-14;0;0;0;0;0;0;0;0;0;0
FR;5;2021-02-15;0;0;0;0;0;0;0;0;0;0
FR;5;2021-02-16;0;0;0;0;0;0;0;0;0;0
FR;5;2021-02-17;0;0;0;0;0;0;0;0;0;0
FR;5;2021-02-18;0;0;0;0;0;0;0;0;0;0
FR;5;2021-02-19;0;0;0;0;0;0;0;0;0;0
FR;5;2021-02-20;0;0;0;0;0;0;0;0;0;0
FR;5;2021-02-21;0;0;0;0;0;0;0;0;0;0
FR;5;2021-02-22;0;0;0;0;0;0;0;0;0;0
FR;5;2021-02-23;0;0;0;0;0;0;0;0;0;0
FR;5;2021-02-24;0;0;0;0;0;0;0;0;0;0
FR;5;2021-02-25;0;0;0;0;0;0;0;0;0;0
FR;5;2021-02-26;0;0;0;0;0;0;0;0;0;0
FR;5;2021-02-27;0;0;0;0;0;0;0;0;0;0
FR;5;2021-02-28;0;0;0;0;0;0;0;0;0;0
FR;5;2021-03-01;0;0;0;0;0;0;0;0;0;0
FR;5;2021-03-02;0;0;0;0;0;0;0;0;0;0
FR;5;2021-03-03;0;0;0;0;0;0;0;0;0;0
FR;5;2021-03-04;0;0;0;0;0;0;0;0;0;0
FR;5;2021-03-05;0;0;0;0;0;0;0;0;0;0
FR;5;2021-03-06;0;0;0;0;0;0;0;0;0;0
FR;5;2021-03-07;0;0;0;0;0;0;0;0;0;0
FR;5;2021-03-08;0;0;0;0;0;0;0;0;0;0
FR;5;2021-03-09;0;0;0;0;0;0;0;0;0;0
FR;5;2021-03-10;0;0;0;0;0;0;0;0;0;0
FR;5;2021-03-11;0;0;0;0;0;0;0;0;0;0
FR;5;2021-03-12;0;0;0;0;0;0;0;0;0;0
FR;5;2021-03-13;0;0;0;0;0;0;0;0;0;0
FR;5;2021-03-14;0;0;0;0;0;0;0;0;0;0
FR;5;2021-03-15;0;0;0;0;0;0;0;0;0;0
FR;5;2021-03-16;0;0;0;0;0;0;0;0;0;0
FR;5;2021-03-17;0;0;0;0;0;0;0;0;0;0
FR;5;2021-03-18;0;0;0;0;0;0;0;0;0;0
FR;5;2021-03-19;0;0;0;0;0;0;0;0;0;0
FR;5;2021-03-20;0;0;0;0;0;0;0;0;0;0
FR;5;2021-03-21;0;0;0;0;0;0;0;0;0;0
FR;5;2021-03-22;0;0;0;0;0;0;0;0;0;0
FR;5;2021-03-23;0;0;0;0;0;0;0;0;0;0
FR;5;2021-03-24;0;0;0;0;0;0;0;0;0;0
FR;5;2021-03-25;0;0;0;0;0;0;0;0;0;0
FR;5;2021-03-26;0;0;0;0;0;0;0;0;0;0
FR;5;2021-03-27;0;0;0;0;0;0;0;0;0;0
FR;5;2021-03-28;0;0;0;0;0;0;0;0;0;0
FR;5;2021-03-29;0;0;0;0;0;0;0;0;0;0
FR;5;2021-03-30;0;0;0;0;0;0;0;0;0;0
FR;5;2021-03-31;0;0;0;0;0;0;0;0;0;0
FR;5;2021-04-01;0;0;0;0;0;0;0;0;0;0
FR;5;2021-04-02;0;0;0;0;0;0;0;0;0;0
FR;5;2021-04-03;0;0;0;0;0;0;0;0;0;0
FR;5;2021-04-04;0;0;0;0;0;0;0;0;0;0
FR;5;2021-04-05;0;0;0;0;0;0;0;0;0;0
FR;5;2021-04-06;0;0;0;0;0;0;0;0;0;0
FR;5;2021-04-07;0;0;0;0;0;0;0;0;0;0
FR;5;2021-04-08;0;0;0;0;0;0;0;0;0;0
FR;5;2021-04-09;0;0;0;0;0;0;0;0;0;0
FR;5;2021-04-10;0;0;0;0;0;0;0;0;0;0
FR;5;2021-04-11;0;0;0;0;0;0;0;0;0;0
FR;5;2021-04-12;0;0;0;0;0;0;0;0;0;0
FR;5;2021-04-13;0;0;0;0;0;0;0;0;0;0
FR;5;2021-04-14;0;0;0;0;0;0;0;0;0;0
FR;5;2021-04-15;0;0;0;0;0;0;0;0;0;0
FR;5;2021-04-16;0;0;0;0;0;0;0;0;0;0
FR;5;2021-04-17;0;0;0;0;0;0;0;0;0;0
FR;5;2021-04-18;0;0;0;0;0;0;0;0;0;0
FR;5;2021-04-19;0;0;0;0;0;0;0;0;0;0
FR;5;2021-04-20;0;0;0;0;0;0;0;0;0;0
FR;5;2021-04-21;0;0;0;0;0;0;0;0;0;0
FR;5;2021-04-22;0;0;0;0;0;0;0;0;0;0
FR;5;2021-04-23;0;0;0;0;0;0;0;0;0;0
FR;5;2021-04-24;0;0;0;0;0;0;0;0;0;0
FR;5;2021-04-25;0;0;0;0;0;0;0;0;0;0
FR;5;2021-04-26;0;0;0;0;0;0;0;0;0;0
FR;5;2021-04-27;0;0;0;0;0;0;0;0;0;0
FR;5;2021-04-28;0;0;0;0;0;0;0;0;0;0
FR;5;2021-04-29;0;0;0;0;0;0;0;0;0;0
FR;5;2021-04-30;0;0;0;0;0;0;0;0;0;0
FR;5;2021-05-01;0;0;0;0;0;0;0;0;0;0
FR;5;2021-05-02;0;0;0;0;0;0;0;0;0;0
FR;5;2021-05-03;0;0;0;0;0;0;0;0;0;0
FR;5;2021-05-04;0;0;0;0;0;0;0;0;0;0
FR;5;2021-05-05;0;0;0;0;0;0;0;0;0;0
FR;5;2021-05-06;0;0;0;0;0;0;0;0;0;0
FR;5;2021-05-07;0;0;0;0;0;0;0;0;0;0
FR;5;2021-05-08;0;0;0;0;0;0;0;0;0;0
FR;5;2021-05-09;0;0;0;0;0;0;0;0;0;0
FR;5;2021-05-10;0;0;0;0;0;0;0;0;0;0
FR;5;2021-05-11;0;0;0;0;0;0;0;0;0;0
FR;5;2021-05-12;0;0;0;0;0;0;0;0;0;0
FR;5;2021-05-13;0;0;0;0;0;0;0;0;0;0
FR;5;2021-05-14;0;0;0;0;0;0;0;0;0;0
FR;5;2021-05-15;0;0;0;0;0;0;0;0;0;0
FR;5;2021-05-16;0;0;0;0;0;0;0;0;0;0
FR;5;2021-05-17;0;0;0;0;0;0;0;0;0;0
FR;5;2021-05-18;0;0;0;0;0;0;0;0;0;0
FR;5;2021-05-19;0;0;0;0;0;0;0;0;0;0
FR;5;2021-05-20;0;0;0;0;0;0;0;0;0;0
FR;5;2021-05-21;0;0;0;0;0;0;0;0;0;0
FR;5;2021-05-22;0;0;0;0;0;0;0;0;0;0
FR;5;2021-05-23;0;0;0;0;0;0;0;0;0;0
FR;5;2021-05-24;0;0;0;0;0;0;0;0;0;0
FR;5;2021-05-25;0;0;0;0;0;0;0;0;0;0
FR;5;2021-05-26;0;0;0;0;0;0;0;0;0;0
FR;5;2021-05-27;0;0;0;0;0;0;0;0;0;0
FR;5;2021-05-28;0;0;0;0;0;0;0;0;0;0
FR;5;2021-05-29;0;0;0;0;0;0;0;0;0;0
FR;5;2021-05-30;0;0;0;0;0;0;0;0;0;0
FR;5;2021-05-31;0;0;0;0;0;0;0;0;0;0
FR;5;2021-06-01;0;0;0;0;0;0;0;0;0;0
FR;5;2021-06-02;0;0;0;0;0;0;0;0;0;0
FR;5;2021-06-03;0;0;0;0;0;0;0;0;0;0
FR;5;2021-06-04;0;0;0;0;0;0;0;0;0;0
FR;5;2021-06-05;0;0;0;0;0;0;0;0;0;0
FR;5;2021-06-06;0;0;0;0;0;0;0;0;0;0
FR;5;2021-06-07;0;0;0;0;0;0;0;0;0;0
FR;5;2021-06-08;0;0;0;0;0;0;0;0;0;0
FR;5;2021-06-09;0;0;0;0;0;0;0;0;0;0
FR;5;2021-06-10;0;0;0;0;0;0;0;0;0;0
FR;5;2021-06-11;0;0;0;0;0;0;0;0;0;0
FR;5;2021-06-12;0;0;0;0;0;0;0;0;0;0
FR;5;2021-06-13;0;0;0;0;0;0;0;0;0;0
FR;5;2021-06-14;0;0;0;0;0;0;0;0;0;0
FR;5;2021-06-15;0;0;0;0;0;0;0;0;0;0
FR;5;2021-06-16;0;0;0;0;0;0;0;0;0;0
FR;5;2021-06-17;0;0;0;0;0;0;0;0;0;0
FR;5;2021-06-18;0;0;0;0;0;0;0;0;0;0
FR;5;2021-06-19;0;0;0;0;0;0;0;0;0;0
FR;5;2021-06-20;0;0;0;0;0;0;0;0;0;0
FR;5;2021-06-21;0;0;0;0;0;0;0;0;0;0
FR;5;2021-06-22;0;0;0;0;0;0;0;0;0;0
FR;5;2021-06-23;0;0;0;0;0;0;0;0;0;0
FR;5;2021-06-24;0;0;0;0;0;0;0;0;0;0
FR;5;2021-06-25;0;0;0;0;0;0;0;0;0;0
FR;5;2021-06-26;0;0;0;0;0;0;0;0;0;0
FR;5;2021-06-27;0;0;0;0;0;0;0;0;0;0
FR;5;2021-06-28;0;0;0;0;0;0;0;0;0;0
FR;5;2021-06-29;0;0;0;0;0;0;0;0;0;0
FR;5;2021-06-30;0;0;0;0;0;0;0;0;0;0
FR;5;2021-07-01;0;0;0;0;0;0;0;0;0;0
FR;5;2021-07-02;0;0;0;0;0;0;0;0;0;0
FR;5;2021-07-03;0;0;0;0;0;0;0;0;0;0
FR;5;2021-07-04;0;0;0;0;0;0;0;0;0;0
FR;5;2021-07-05;0;0;0;0;0;0;0;0;0;0
FR;5;2021-07-06;0;0;0;0;0;0;0;0;0;0
FR;5;2021-07-07;0;0;0;0;0;0;0;0;0;0
FR;5;2021-07-08;0;0;0;0;0;0;0;0;0;0
FR;5;2021-07-09;0;0;0;0;0;0;0;0;0;0
FR;5;2021-07-10;0;0;0;0;0;0;0;0;0;0
FR;5;2021-07-11;0;0;0;0;0;0;0;0;0;0
FR;5;2021-07-12;0;0;0;0;0;0;0;0;0;0
FR;5;2021-07-13;0;0;0;0;0;0;0;0;0;0
FR;5;2021-07-14;0;0;0;0;0;0;0;0;0;0
FR;5;2021-07-15;0;0;0;0;0;0;0;0;0;0
FR;5;2021-07-16;0;0;0;0;0;0;0;0;0;0
FR;5;2021-07-17;0;0;0;0;0;0;0;0;0;0
FR;5;2021-07-18;0;0;0;0;0;0;0;0;0;0
FR;5;2021-07-19;0;0;0;0;0;0;0;0;0;0
FR;5;2021-07-20;0;0;0;0;0;0;0;0;0;0
FR;5;2021-07-21;0;0;0;0;0;0;0;0;0;0
FR;5;2021-07-22;0;0;0;0;0;0;0;0;0;0
FR;5;2021-07-23;0;0;0;0;0;0;0;0;0;0
FR;5;2021-07-24;0;0;0;0;0;0;0;0;0;0
FR;5;2021-07-25;0;0;0;0;0;0;0;0;0;0
FR;5;2021-07-26;0;0;0;0;0;0;0;0;0;0
FR;5;2021-07-27;0;0;0;0;0;0;0;0;0;0
FR;5;2021-07-28;0;0;0;0;0;0;0;0;0;0
FR;5;2021-07-29;0;0;0;0;0;0;0;0;0;0
FR;5;2021-07-30;0;0;0;0;0;0;0;0;0;0
FR;5;2021-07-31;0;0;0;0;0;0;0;0;0;0
FR;5;2021-08-01;0;0;0;0;0;0;0;0;0;0
FR;5;2021-08-02;0;0;0;0;0;0;0;0;0;0
FR;5;2021-08-03;0;0;0;0;0;0;0;0;0;0
FR;5;2021-08-04;0;0;0;0;0;0;0;0;0;0
FR;5;2021-08-05;0;0;0;0;0;0;0;0;0;0
FR;5;2021-08-06;0;0;0;0;0;0;0;0;0;0
FR;5;2021-08-07;0;0;0;0;0;0;0;0;0;0
FR;5;2021-08-08;0;0;0;0;0;0;0;0;0;0
FR;5;2021-08-09;0;0;0;0;0;0;0;0;0;0
FR;5;2021-08-10;0;0;0;0;0;0;0;0;0;0
FR;5;2021-08-11;0;0;0;0;0;0;0;0;0;0
FR;5;2021-08-12;0;0;0;0;0;0;0;0;0;0
FR;5;2021-08-13;0;0;0;0;0;0;0;0;0;0
FR;5;2021-08-14;0;0;0;0;0;0;0;0;0;0
FR;5;2021-08-15;0;0;0;0;0;0;0;0;0;0
FR;5;2021-08-16;0;0;0;0;0;0;0;0;0;0
FR;5;2021-08-17;0;0;0;0;0;0;0;0;0;0
FR;5;2021-08-18;0;0;0;0;0;0;0;0;0;0
FR;5;2021-08-19;0;0;0;0;0;0;0;0;0;0
FR;5;2021-08-20;0;0;0;0;0;0;0;0;0;0
FR;5;2021-08-21;0;0;0;0;0;0;0;0;0;0
FR;5;2021-08-22;0;0;0;0;0;0;0;0;0;0
FR;5;2021-08-23;0;0;0;0;0;0;0;0;0;0
FR;5;2021-08-24;0;0;0;0;0;0;0;0;0;0
FR;5;2021-08-25;0;0;0;0;0;0;0;0;0;0
FR;5;2021-08-26;0;0;0;0;0;0;0;0;0;0
FR;5;2021-08-27;0;0;0;0;0;0;0;0;0;0
FR;5;2021-08-28;0;0;0;0;0;0;0;0;0;0
FR;5;2021-08-29;0;0;0;0;0;0;0;0;0;0
FR;5;2021-08-30;0;0;0;0;0;0;0;0;0;0
FR;5;2021-08-31;0;0;0;0;0;0;0;0;0;0
FR;5;2021-09-01;0;0;0;0;0;0;0;0;0;0
FR;5;2021-09-02;0;0;0;0;0;0;0;0;0;0
FR;5;2021-09-03;0;0;0;0;0;0;0;0;0;0
FR;5;2021-09-04;0;0;0;0;0;0;0;0;0;0
FR;5;2021-09-05;0;0;0;0;0;0;0;0;0;0
FR;5;2021-09-06;0;0;0;0;0;0;0;0;0;0
FR;5;2021-09-07;0;0;0;0;0;0;0;0;0;0
FR;5;2021-09-08;0;0;0;0;0;0;0;0;0;0
FR;5;2021-09-09;0;0;0;0;0;0;0;0;0;0
FR;5;2021-09-10;0;0;0;0;0;0;0;0;0;0
FR;5;2021-09-11;0;0;0;0;0;0;0;0;0;0
FR;5;2021-09-12;0;0;0;0;0;0;0;0;0;0
FR;5;2021-09-13;0;0;0;0;0;0;0;0;0;0
FR;5;2021-09-14;0;0;0;0;0;0;0;0;0;0
FR;5;2021-09-15;0;0;0;0;0;0;0;0;0;0
FR;5;2021-09-16;0;0;0;0;0;0;0;0;0;0
FR;5;2021-09-17;0;0;0;0;0;0;0;0;0;0
FR;5;2021-09-18;0;0;0;0;0;0;0;0;0;0
FR;5;2021-09-19;0;0;0;0;0;0;0;0;0;0
FR;5;2021-09-20;0;0;0;0;0;0;0;0;0;0
FR;5;2021-09-21;0;0;0;0;0;0;0;0;0;0
FR;5;2021-09-22;0;0;0;0;0;0;0;0;0;0
FR;5;2021-09-23;0;0;0;0;0;0;0;0;0;0
FR;5;2021-09-24;0;0;0;0;0;0;0;0;0;0
FR;5;2021-09-25;0;0;0;0;0;0;0;0;0;0
FR;5;2021-09-26;0;0;0;0;0;0;0;0;0;0
FR;5;2021-09-27;0;0;0;0;0;0;0;0;0;0
FR;5;2021-09-28;0;0;0;0;0;0;0;0;0;0
FR;5;2021-09-29;0;0;0;0;0;0;0;0;0;0
FR;5;2021-09-30;0;0;0;0;0;0;0;0;0;0
FR;5;2021-10-01;0;0;0;0;0;0;0;0;0;0
FR;5;2021-10-02;0;0;0;0;0;0;0;0;0;0
FR;5;2021-10-03;0;0;0;0;0;0;0;0;0;0
FR;5;2021-10-04;0;0;0;0;0;0;0;0;0;0
FR;5;2021-10-05;0;0;0;0;0;0;0;0;0;0
FR;5;2021-10-06;0;0;0;0;0;0;0;0;0;0
FR;5;2021-10-07;0;0;0;0;0;0;0;0;0;0
FR;5;2021-10-08;0;0;0;0;0;0;0;0;0;0
FR;5;2021-10-09;0;0;0;0;0;0;0;0;0;0
FR;5;2021-10-10;0;0;0;0;0;0;0;0;0;0
FR;5;2021-10-11;0;0;0;0;0;0;0;0;0;0
FR;5;2021-10-12;0;0;0;0;0;0;0;0;0;0
FR;5;2021-10-13;0;0;0;0;0;0;0;0;0;0
FR;5;2021-10-14;0;0;0;0;0;0;0;0;0;0
FR;5;2021-10-15;0;0;0;0;0;0;0;0;0;0
FR;5;2021-10-16;0;0;0;0;0;0;0;0;0;0
FR;5;2021-10-17;0;0;0;0;0;0;0;0;0;0
FR;5;2021-10-18;0;0;0;0;0;0;0;0;0;0
FR;5;2021-10-19;0;0;0;0;0;0;0;0;0;0
FR;5;2021-10-20;0;0;0;0;0;0;0;0;0;0
FR;5;2021-10-21;0;0;0;0;0;0;0;0;0;0
FR;5;2021-10-22;0;0;0;0;0;0;0;0;0;0
FR;5;2021-10-23;0;0;0;0;0;0;0;0;0;0
FR;5;2021-10-24;0;0;0;0;0;0;0;0;0;0
FR;5;2021-10-25;0;0;0;0;0;0;0;0;0;0
FR;5;2021-10-26;0;0;0;0;0;0;0;0;0;0
FR;5;2021-10-27;0;0;0;0;0;0;0;0;0;0
FR;5;2021-10-28;0;0;0;0;0;0;0;0;0;0
FR;5;2021-10-29;0;0;0;0;0;0;0;0;0;0
FR;5;2021-10-30;0;0;0;0;0;0;0;0;0;0
FR;5;2021-10-31;0;0;0;0;0;0;0;0;0;0
FR;5;2021-11-01;0;0;0;0;0;0;0;0;0;0
FR;5;2021-11-02;0;0;0;0;0;0;0;0;0;0
FR;5;2021-11-03;0;0;0;0;0;0;0;0;0;0
FR;5;2021-11-04;0;0;0;0;0;0;0;0;0;0
FR;5;2021-11-05;0;0;0;0;0;0;0;0;0;0
FR;5;2021-11-06;0;0;0;0;0;0;0;0;0;0
FR;5;2021-11-07;0;0;0;0;0;0;0;0;0;0
FR;5;2021-11-08;0;0;0;0;0;0;0;0;0;0
FR;5;2021-11-09;0;0;0;0;0;0;0;0;0;0
FR;5;2021-11-10;0;0;0;0;0;0;0;0;0;0
FR;5;2021-11-11;0;0;0;0;0;0;0;0;0;0
FR;5;2021-11-12;0;0;0;0;0;0;0;0;0;0
FR;5;2021-11-13;0;0;0;0;0;0;0;0;0;0
FR;5;2021-11-14;0;0;0;0;0;0;0;0;0;0
FR;5;2021-11-15;0;0;0;0;0;0;0;0;0;0
FR;5;2021-11-16;0;0;0;0;0;0;0;0;0;0
FR;5;2021-11-17;0;0;0;0;0;0;0;0;0;0
FR;5;2021-11-18;0;0;0;0;0;0;0;0;0;0
FR;5;2021-11-19;0;0;0;0;0;0;0;0;0;0
FR;5;2021-11-20;0;0;0;0;0;0;0;0;0;0
FR;5;2021-11-21;0;0;0;0;0;0;0;0;0;0
FR;5;2021-11-22;0;0;0;0;0;0;0;0;0;0
FR;5;2021-11-23;0;0;0;0;0;0;0;0;0;0
FR;5;2021-11-24;0;0;0;0;0;0;0;0;0;0
FR;5;2021-11-25;0;0;0;0;0;0;0;0;0;0
FR;5;2021-11-26;0;0;0;0;0;0;0;0;0;0
FR;5;2021-11-27;0;0;0;0;0;0;0;0;0;0
FR;5;2021-11-28;0;0;0;0;0;0;0;0;0;0
FR;5;2021-11-29;0;0;0;0;0;0;0;0;0;0
FR;5;2021-11-30;0;0;0;0;0;0;0;0;0;0
FR;5;2021-12-01;0;0;0;0;0;0;0;0;0;0
FR;5;2021-12-02;0;0;0;0;0;0;0;0;0;0
FR;5;2021-12-03;0;0;0;0;0;0;0;0;0;0
FR;5;2021-12-04;0;0;0;0;0;0;0;0;0;0
FR;5;2021-12-05;0;0;0;0;0;0;0;0;0;0
FR;5;2021-12-06;0;0;0;0;0;0;0;0;0;0
FR;5;2021-12-07;0;0;0;0;0;0;0;0;0;0
FR;5;2021-12-08;0;0;0;0;0;0;0;0;0;0
FR;5;2021-12-09;0;0;0;0;0;0;0;0;0;0
FR;5;2021-12-10;0;0;0;0;0;0;0;0;0;0
FR;5;2021-12-11;0;0;0;0;0;0;0;0;0;0
FR;5;2021-12-12;0;0;0;0;0;0;0;0;0;0
FR;5;2021-12-13;0;0;0;0;0;0;0;0;0;0
FR;5;2021-12-14;29;45;77;0;88;29;45;77;0;88
FR;5;2021-12-15;196;44;37;0;49;225;89;114;0;137
FR;5;2021-12-16;180;21;44;0;48;405;110;158;0;185
FR;5;2021-12-17;310;16;72;0;74;715;126;230;0;259
FR;5;2021-12-18;764;24;22;0;29;1479;150;252;0;288
FR;5;2021-12-19;586;15;15;0;17;2065;165;267;0;305
FR;5;2021-12-20;1223;31;35;0;38;3288;196;302;0;343
FR;5;2021-12-21;1535;22;54;1;60;4823;218;356;1;403
FR;5;2021-12-22;4069;40;37;0;46;8892;258;393;1;449
FR;5;2021-12-23;3042;16;21;0;25;11934;274;414;1;474
FR;5;2021-12-24;759;18;9;0;15;12693;292;423;1;489
FR;5;2021-12-25;61;5;1;0;2;12754;297;424;1;491
FR;5;2021-12-26;623;6;3;0;4;13377;303;427;1;495
FR;5;2021-12-27;4080;25;21;0;23;17457;328;448;1;518
FR;5;2021-12-28;5202;23;41;1;43;22659;351;489;2;561
FR;5;2021-12-29;8104;34;65;2;68;30763;385;554;4;629
FR;5;2021-12-30;5172;18;33;0;39;35935;403;587;4;668
FR;5;2021-12-31;1553;8;10;0;11;37488;411;597;4;679
FR;5;2022-01-01;185;2;2;0;3;37673;413;599;4;682
FR;5;2022-01-02;1489;1;1;0;1;39162;414;600;4;683
FR;5;2022-01-03;3058;36;33;0;32;42220;450;633;4;715
FR;5;2022-01-04;3034;39;33;0;42;45254;489;666;4;757
FR;5;2022-01-05;19323;203;97;1;108;64577;692;763;5;865
FR;5;2022-01-06;3742;133;122;0;142;68319;825;885;5;1007
FR;5;2022-01-07;5007;200;48;2;56;73326;1025;933;7;1063
FR;5;2022-01-08;13654;514;45;0;52;86980;1539;978;7;1115
FR;5;2022-01-09;5755;399;15;0;20;92735;1938;993;7;1135
FR;5;2022-01-10;3453;326;25;0;29;96188;2264;1018;7;1164
FR;5;2022-01-11;3668;284;38;0;41;99856;2548;1056;7;1205
FR;5;2022-01-12;22653;3003;90;0;113;122509;5551;1146;7;1318
FR;5;2022-01-13;4035;622;30;0;32;126544;6173;1176;7;1350
FR;5;2022-01-14;4843;581;44;0;51;131387;6754;1220;7;1401
FR;5;2022-01-15;14681;1746;38;3;49;146068;8500;1258;10;1450
FR;5;2022-01-16;4727;666;3;0;5;150795;9166;1261;10;1455
FR;5;2022-01-17;2293;715;26;0;29;153088;9881;1287;10;1484
FR;5;2022-01-18;2430;870;30;0;40;155518;10751;1317;10;1524
FR;5;2022-01-19;18481;6422;74;2;142;173999;17173;1391;12;1666
FR;5;2022-01-20;1920;1067;25;0;34;175919;18240;1416;12;1700
FR;5;2022-01-21;3076;1371;47;1;59;178995;19611;1463;13;1759
FR;5;2022-01-22;10721;3454;33;1;43;189716;23065;1496;14;1802
FR;5;2022-01-23;2629;1415;5;0;9;192345;24480;1501;14;1811
FR;5;2022-01-24;1159;1340;19;0;23;193504;25820;1520;14;1834
FR;5;2022-01-25;1219;1548;19;2;29;194723;27368;1539;16;1863
FR;5;2022-01-26;10751;12024;50;1;89;205474;39392;1589;17;1952
FR;5;2022-01-27;1291;1693;10;0;17;206765;41085;1599;17;1969
FR;5;2022-01-28;1695;3347;16;0;19;208460;44432;1615;17;1988
FR;5;2022-01-29;6237;8040;68;0;96;214697;52472;1683;17;2084
FR;5;2022-01-30;1509;2950;5;0;18;216206;55422;1688;17;2102
FR;5;2022-01-31;588;1773;23;0;24;216794;57195;1711;17;2126
FR;5;2022-02-01;712;1702;10;0;15;217506;58897;1721;17;2141
FR;5;2022-02-02;6957;15654;52;0;94;224463;74551;1773;17;2235
FR;5;2022-02-03;488;1690;14;0;13;224951;76241;1787;17;2248
FR;5;2022-02-04;941;3001;19;0;31;225892;79242;1806;17;2279
FR;5;2022-02-05;3532;8916;23;0;37;229424;88158;1829;17;2316
FR;5;2022-02-06;737;2397;10;0;19;230161;90555;1839;17;2335
FR;5;2022-02-07;883;1595;22;0;24;231044;92150;1861;17;2359
FR;5;2022-02-08;722;1285;18;0;20;231766;93435;1879;17;2379
FR;5;2022-02-09;4535;12876;44;0;76;236301;106311;1923;17;2455
FR;5;2022-02-10;646;1058;14;0;15;236947;107369;1937;17;2470
FR;5;2022-02-11;793;2026;16;0;21;237740;109395;1953;17;2491
FR;5;2022-02-12;2285;6811;33;0;53;240025;116206;1986;17;2544
FR;5;2022-02-13;465;1540;8;0;8;240490;117746;1994;17;2552
FR;5;2022-02-14;678;1288;10;0;13;241168;119034;2004;17;2565
FR;5;2022-02-15;482;885;9;0;14;241650;119919;2013;17;2579
FR;5;2022-02-16;2978;9123;41;1;58;244628;129042;2054;18;2637
FR;5;2022-02-17;435;805;6;0;7;245063;129847;2060;18;2644
FR;5;2022-02-18;650;1407;13;0;17;245713;131254;2073;18;2661
FR;5;2022-02-19;1371;4314;16;0;28;247084;135568;2089;18;2689
FR;5;2022-02-20;247;879;6;0;8;247331;136447;2095;18;2697
FR;5;2022-02-21;221;607;2;0;4;247552;137054;2097;18;2701
FR;5;2022-02-22;259;545;17;0;17;247811;137599;2114;18;2718
FR;5;2022-02-23;1907;6923;22;1;42;249718;144522;2136;19;2760
FR;5;2022-02-24;182;374;5;1;6;249900;144896;2141;20;2766
FR;5;2022-02-25;335;949;13;0;12;250235;145845;2154;20;2778
FR;5;2022-02-26;972;3067;10;0;14;251207;148912;2164;20;2792
FR;5;2022-02-27;147;506;0;0;3;251354;149418;2164;20;2795
FR;5;2022-02-28;161;369;1;0;1;251515;149787;2165;20;2796
FR;5;2022-03-01;128;279;6;0;7;251643;150066;2171;20;2803
FR;5;2022-03-02;1240;4150;28;3;40;252883;154216;2199;23;2843
FR;5;2022-03-03;121;250;6;0;9;253004;154466;2205;23;2852
FR;5;2022-03-04;193;488;13;0;14;253197;154954;2218;23;2866
FR;5;2022-03-05;676;1990;8;0;16;253873;156944;2226;23;2882
FR;5;2022-03-06;108;260;0;0;0;253981;157204;2226;23;2882
FR;5;2022-03-07;70;228;5;0;3;254051;157432;2231;23;2885
FR;5;2022-03-08;46;130;7;1;7;254097;157562;2238;24;2892
FR;5;2022-03-09;909;3076;24;0;36;255006;160638;2262;24;2928
FR;5;2022-03-10;82;200;8;0;11;255088;160838;2270;24;2939
FR;5;2022-03-11;147;369;13;1;15;255235;161207;2283;25;2954
FR;5;2022-03-12;758;1613;13;1;30;255993;162820;2296;26;2984
FR;5;2022-03-13;76;100;0;0;0;256069;162920;2296;26;2984
FR;5;2022-03-14;67;118;7;1;7;256136;163038;2303;27;2991
FR;5;2022-03-15;83;99;3;0;6;256219;163137;2306;27;2997
FR;5;2022-03-16;884;1822;15;3;34;257103;164959;2321;30;3031
FR;5;2022-03-17;66;123;8;4;10;257169;165082;2329;34;3041
FR;5;2022-03-18;172;318;13;4;18;257341;165400;2342;38;3059
FR;5;2022-03-19;749;1162;12;5;33;258090;166562;2354;43;3092
FR;5;2022-03-20;45;93;1;0;1;258135;166655;2355;43;3093
FR;5;2022-03-21;71;120;10;6;15;258206;166775;2365;49;3108
FR;5;2022-03-22;56;119;8;8;9;258262;166894;2373;57;3117
FR;5;2022-03-23;803;1460;14;8;36;259065;168354;2387;65;3153
FR;5;2022-03-24;68;93;8;7;7;259133;168447;2395;72;3160
FR;5;2022-03-25;222;289;14;8;18;259355;168736;2409;80;3178
FR;5;2022-03-26;706;853;12;5;26;260061;169589;2421;85;3204
FR;5;2022-03-27;74;78;0;0;3;260135;169667;2421;85;3207
FR;5;2022-03-28;81;91;1;2;3;260216;169758;2422;87;3210
FR;5;2022-03-29;71;82;10;4;12;260287;169840;2432;91;3222
FR;5;2022-03-30;820;1115;16;13;29;261107;170955;2448;104;3251
FR;5;2022-03-31;102;124;1;4;6;261209;171079;2449;108;3257
FR;5;2022-04-01;107;86;7;12;11;261316;171165;2456;120;3268
FR;5;2022-04-02;329;348;3;3;14;261645;171513;2459;123;3282
FR;5;2022-04-03;54;59;1;0;1;261699;171572;2460;123;3283
FR;5;2022-04-04;36;57;4;1;8;261735;171629;2464;124;3291
FR;5;2022-04-05;51;60;6;7;9;261786;171689;2470;131;3300
FR;5;2022-04-06;421;439;7;15;16;262207;172128;2477;146;3316
FR;5;2022-04-07;45;68;5;7;7;262252;172196;2482;153;3323
FR;5;2022-04-08;130;110;12;14;15;262382;172306;2494;167;3338
FR;5;2022-04-09;309;321;2;5;16;262691;172627;2496;172;3354
FR;5;2022-04-10;43;31;2;0;2;262734;172658;2498;172;3356
FR;5;2022-04-11;50;60;3;2;4;262784;172718;2501;174;3360
FR;5;2022-04-12;57;54;3;3;5;262841;172772;2504;177;3365
FR;5;2022-04-13;382;413;3;8;16;263223;173185;2507;185;3381
FR;5;2022-04-14;47;48;5;5;9;263270;173233;2512;190;3390
FR;5;2022-04-15;91;107;3;5;4;263361;173340;2515;195;3394
FR;5;2022-04-16;188;183;2;1;13;263549;173523;2517;196;3407
FR;5;2022-04-17;12;10;1;0;1;263561;173533;2518;196;3408
FR;5;2022-04-18;8;9;2;0;2;263569;173542;2520;196;3410
FR;5;2022-04-19;72;70;6;1;6;263641;173612;2526;197;3416
FR;5;2022-04-20;359;349;9;6;12;264000;173961;2535;203;3428
FR;5;2022-04-21;42;64;9;10;12;264042;174025;2544;213;3440
FR;5;2022-04-22;113;96;5;4;5;264155;174121;2549;217;3445
FR;5;2022-04-23;209;192;3;2;10;264364;174313;2552;219;3455
FR;5;2022-04-24;37;35;0;0;3;264401;174348;2552;219;3458
FR;5;2022-04-25;67;65;1;1;4;264468;174413;2553;220;3462
FR;5;2022-04-26;60;61;2;1;5;264528;174474;2555;221;3467
FR;5;2022-04-27;332;316;2;7;14;264860;174790;2557;228;3481
FR;5;2022-04-28;75;54;4;5;8;264935;174844;2561;233;3489
FR;5;2022-04-29;117;79;5;18;12;265052;174923;2566;251;3501
FR;5;2022-04-30;182;115;1;1;10;265234;175038;2567;252;3511
FR;5;2022-05-01;10;7;0;0;0;265244;175045;2567;252;3511
FR;5;2022-05-02;46;27;4;5;2;265290;175072;2571;257;3513
FR;5;2022-05-03;83;55;2;5;11;265373;175127;2573;262;3524
FR;5;2022-05-04;276;204;1;2;7;265649;175331;2574;264;3531
FR;5;2022-05-05;62;32;2;4;4;265711;175363;2576;268;3535
FR;5;2022-05-06;103;64;2;3;5;265814;175427;2578;271;3540
FR;5;2022-05-07;170;115;3;10;13;265984;175542;2581;281;3553
FR;5;2022-05-08;7;8;0;0;2;265991;175550;2581;281;3555
FR;5;2022-05-09;44;31;15;3;16;266035;175581;2596;284;3571
FR;5;2022-05-10;54;48;2;4;4;266089;175629;2598;288;3575
FR;5;2022-05-11;324;235;12;7;21;266413;175864;2610;295;3596
FR;5;2022-05-12;46;34;1;3;2;266459;175898;2611;298;3598
FR;5;2022-05-13;108;82;2;8;8;266567;175980;2613;306;3606
FR;5;2022-05-14;203;129;0;1;8;266770;176109;2613;307;3614
FR;5;2022-05-15;22;7;2;0;1;266792;176116;2615;307;3615
FR;5;2022-05-16;48;31;2;4;4;266840;176147;2617;311;3619
FR;5;2022-05-17;72;40;5;0;2;266912;176187;2622;311;3621
FR;5;2022-05-18;288;213;4;4;8;267200;176400;2626;315;3629
FR;5;2022-05-19;44;35;4;2;2;267244;176435;2630;317;3631
FR;6;2020-12-27;0;0;0;0;0;0;0;0;0;0
FR;6;2020-12-28;0;0;0;0;0;0;0;0;0;0
FR;6;2020-12-29;0;0;0;0;0;0;0;0;0;0
FR;6;2020-12-30;0;0;0;0;0;0;0;0;0;0
FR;6;2020-12-31;0;0;0;0;0;0;0;0;0;0
FR;6;2021-01-01;0;0;0;0;0;0;0;0;0;0
FR;6;2021-01-02;0;0;0;0;0;0;0;0;0;0
FR;6;2021-01-03;0;0;0;0;0;0;0;0;0;0
FR;6;2021-01-04;0;0;0;0;0;0;0;0;0;0
FR;6;2021-01-05;0;0;0;0;0;0;0;0;0;0
FR;6;2021-01-06;0;0;0;0;0;0;0;0;0;0
FR;6;2021-01-07;0;0;0;0;0;0;0;0;0;0
FR;6;2021-01-08;0;0;0;0;0;0;0;0;0;0
FR;6;2021-01-09;0;0;0;0;0;0;0;0;0;0
FR;6;2021-01-10;0;0;0;0;0;0;0;0;0;0
FR;6;2021-01-11;0;0;0;0;0;0;0;0;0;0
FR;6;2021-01-12;0;0;0;0;0;0;0;0;0;0
FR;6;2021-01-13;0;0;0;0;0;0;0;0;0;0
FR;6;2021-01-14;0;0;0;0;0;0;0;0;0;0
FR;6;2021-01-15;0;0;0;0;0;0;0;0;0;0
FR;6;2021-01-16;0;0;0;0;0;0;0;0;0;0
FR;6;2021-01-17;0;0;0;0;0;0;0;0;0;0
FR;6;2021-01-18;0;0;0;0;0;0;0;0;0;0
FR;6;2021-01-19;0;0;0;0;0;0;0;0;0;0
FR;6;2021-01-20;0;0;0;0;0;0;0;0;0;0
FR;6;2021-01-21;0;0;0;0;0;0;0;0;0;0
FR;6;2021-01-22;0;0;0;0;0;0;0;0;0;0
FR;6;2021-01-23;0;0;0;0;0;0;0;0;0;0
FR;6;2021-01-24;0;0;0;0;0;0;0;0;0;0
FR;6;2021-01-25;0;0;0;0;0;0;0;0;0;0
FR;6;2021-01-26;0;0;0;0;0;0;0;0;0;0
FR;6;2021-01-27;0;0;0;0;0;0;0;0;0;0
FR;6;2021-01-28;0;0;0;0;0;0;0;0;0;0
FR;6;2021-01-29;0;0;0;0;0;0;0;0;0;0
FR;6;2021-01-30;0;0;0;0;0;0;0;0;0;0
FR;6;2021-01-31;0;0;0;0;0;0;0;0;0;0
FR;6;2021-02-01;0;0;0;0;0;0;0;0;0;0
FR;6;2021-02-02;0;0;0;0;0;0;0;0;0;0
FR;6;2021-02-03;0;0;0;0;0;0;0;0;0;0
FR;6;2021-02-04;0;0;0;0;0;0;0;0;0;0
FR;6;2021-02-05;0;0;0;0;0;0;0;0;0;0
FR;6;2021-02-06;0;0;0;0;0;0;0;0;0;0
FR;6;2021-02-07;0;0;0;0;0;0;0;0;0;0
FR;6;2021-02-08;0;0;0;0;0;0;0;0;0;0
FR;6;2021-02-09;0;0;0;0;0;0;0;0;0;0
FR;6;2021-02-10;0;0;0;0;0;0;0;0;0;0
FR;6;2021-02-11;0;0;0;0;0;0;0;0;0;0
FR;6;2021-02-12;0;0;0;0;0;0;0;0;0;0
FR;6;2021-02-13;0;0;0;0;0;0;0;0;0;0
FR;6;2021-02-14;0;0;0;0;0;0;0;0;0;0
FR;6;2021-02-15;0;0;0;0;0;0;0;0;0;0
FR;6;2021-02-16;0;0;0;0;0;0;0;0;0;0
FR;6;2021-02-17;0;0;0;0;0;0;0;0;0;0
FR;6;2021-02-18;0;0;0;0;0;0;0;0;0;0
FR;6;2021-02-19;0;0;0;0;0;0;0;0;0;0
FR;6;2021-02-20;0;0;0;0;0;0;0;0;0;0
FR;6;2021-02-21;0;0;0;0;0;0;0;0;0;0
FR;6;2021-02-22;0;0;0;0;0;0;0;0;0;0
FR;6;2021-02-23;0;0;0;0;0;0;0;0;0;0
FR;6;2021-02-24;0;0;0;0;0;0;0;0;0;0
FR;6;2021-02-25;0;0;0;0;0;0;0;0;0;0
FR;6;2021-02-26;0;0;0;0;0;0;0;0;0;0
FR;6;2021-02-27;0;0;0;0;0;0;0;0;0;0
FR;6;2021-02-28;0;0;0;0;0;0;0;0;0;0
FR;6;2021-03-01;0;0;0;0;0;0;0;0;0;0
FR;6;2021-03-02;0;0;0;0;0;0;0;0;0;0
FR;6;2021-03-03;0;0;0;0;0;0;0;0;0;0
FR;6;2021-03-04;0;0;0;0;0;0;0;0;0;0
FR;6;2021-03-05;0;0;0;0;0;0;0;0;0;0
FR;6;2021-03-06;0;0;0;0;0;0;0;0;0;0
FR;6;2021-03-07;0;0;0;0;0;0;0;0;0;0
FR;6;2021-03-08;0;0;0;0;0;0;0;0;0;0
FR;6;2021-03-09;0;0;0;0;0;0;0;0;0;0
FR;6;2021-03-10;0;0;0;0;0;0;0;0;0;0
FR;6;2021-03-11;0;0;0;0;0;0;0;0;0;0
FR;6;2021-03-12;0;0;0;0;0;0;0;0;0;0
FR;6;2021-03-13;0;0;0;0;0;0;0;0;0;0
FR;6;2021-03-14;0;0;0;0;0;0;0;0;0;0
FR;6;2021-03-15;0;0;0;0;0;0;0;0;0;0
FR;6;2021-03-16;0;0;0;0;0;0;0;0;0;0
FR;6;2021-03-17;0;0;0;0;0;0;0;0;0;0
FR;6;2021-03-18;0;0;0;0;0;0;0;0;0;0
FR;6;2021-03-19;0;0;0;0;0;0;0;0;0;0
FR;6;2021-03-20;0;0;0;0;0;0;0;0;0;0
FR;6;2021-03-21;0;0;0;0;0;0;0;0;0;0
FR;6;2021-03-22;0;0;0;0;0;0;0;0;0;0
FR;6;2021-03-23;0;0;0;0;0;0;0;0;0;0
FR;6;2021-03-24;0;0;0;0;0;0;0;0;0;0
FR;6;2021-03-25;0;0;0;0;0;0;0;0;0;0
FR;6;2021-03-26;0;0;0;0;0;0;0;0;0;0
FR;6;2021-03-27;0;0;0;0;0;0;0;0;0;0
FR;6;2021-03-28;0;0;0;0;0;0;0;0;0;0
FR;6;2021-03-29;0;0;0;0;0;0;0;0;0;0
FR;6;2021-03-30;0;0;0;0;0;0;0;0;0;0
FR;6;2021-03-31;0;0;0;0;0;0;0;0;0;0
FR;6;2021-04-01;0;0;0;0;0;0;0;0;0;0
FR;6;2021-04-02;0;0;0;0;0;0;0;0;0;0
FR;6;2021-04-03;0;0;0;0;0;0;0;0;0;0
FR;6;2021-04-04;0;0;0;0;0;0;0;0;0;0
FR;6;2021-04-05;0;0;0;0;0;0;0;0;0;0
FR;6;2021-04-06;0;0;0;0;0;0;0;0;0;0
FR;6;2021-04-07;0;0;0;0;0;0;0;0;0;0
FR;6;2021-04-08;0;0;0;0;0;0;0;0;0;0
FR;6;2021-04-09;0;0;0;0;0;0;0;0;0;0
FR;6;2021-04-10;0;0;0;0;0;0;0;0;0;0
FR;6;2021-04-11;0;0;0;0;0;0;0;0;0;0
FR;6;2021-04-12;0;0;0;0;0;0;0;0;0;0
FR;6;2021-04-13;0;0;0;0;0;0;0;0;0;0
FR;6;2021-04-14;0;0;0;0;0;0;0;0;0;0
FR;6;2021-04-15;0;0;0;0;0;0;0;0;0;0
FR;6;2021-04-16;0;0;0;0;0;0;0;0;0;0
FR;6;2021-04-17;0;0;0;0;0;0;0;0;0;0
FR;6;2021-04-18;0;0;0;0;0;0;0;0;0;0
FR;6;2021-04-19;0;0;0;0;0;0;0;0;0;0
FR;6;2021-04-20;0;0;0;0;0;0;0;0;0;0
FR;6;2021-04-21;0;0;0;0;0;0;0;0;0;0
FR;6;2021-04-22;0;0;0;0;0;0;0;0;0;0
FR;6;2021-04-23;0;0;0;0;0;0;0;0;0;0
FR;6;2021-04-24;0;0;0;0;0;0;0;0;0;0
FR;6;2021-04-25;0;0;0;0;0;0;0;0;0;0
FR;6;2021-04-26;0;0;0;0;0;0;0;0;0;0
FR;6;2021-04-27;0;0;0;0;0;0;0;0;0;0
FR;6;2021-04-28;0;0;0;0;0;0;0;0;0;0
FR;6;2021-04-29;0;0;0;0;0;0;0;0;0;0
FR;6;2021-04-30;0;0;0;0;0;0;0;0;0;0
FR;6;2021-05-01;0;0;0;0;0;0;0;0;0;0
FR;6;2021-05-02;0;0;0;0;0;0;0;0;0;0
FR;6;2021-05-03;0;0;0;0;0;0;0;0;0;0
FR;6;2021-05-04;0;0;0;0;0;0;0;0;0;0
FR;6;2021-05-05;0;0;0;0;0;0;0;0;0;0
FR;6;2021-05-06;0;0;0;0;0;0;0;0;0;0
FR;6;2021-05-07;0;0;0;0;0;0;0;0;0;0
FR;6;2021-05-08;0;0;0;0;0;0;0;0;0;0
FR;6;2021-05-09;0;0;0;0;0;0;0;0;0;0
FR;6;2021-05-10;0;0;0;0;0;0;0;0;0;0
FR;6;2021-05-11;0;0;0;0;0;0;0;0;0;0
FR;6;2021-05-12;0;0;0;0;0;0;0;0;0;0
FR;6;2021-05-13;0;0;0;0;0;0;0;0;0;0
FR;6;2021-05-14;0;0;0;0;0;0;0;0;0;0
FR;6;2021-05-15;0;0;0;0;0;0;0;0;0;0
FR;6;2021-05-16;0;0;0;0;0;0;0;0;0;0
FR;6;2021-05-17;0;0;0;0;0;0;0;0;0;0
FR;6;2021-05-18;0;0;0;0;0;0;0;0;0;0
FR;6;2021-05-19;0;0;0;0;0;0;0;0;0;0
FR;6;2021-05-20;0;0;0;0;0;0;0;0;0;0
FR;6;2021-05-21;0;0;0;0;0;0;0;0;0;0
FR;6;2021-05-22;0;0;0;0;0;0;0;0;0;0
FR;6;2021-05-23;0;0;0;0;0;0;0;0;0;0
FR;6;2021-05-24;0;0;0;0;0;0;0;0;0;0
FR;6;2021-05-25;0;0;0;0;0;0;0;0;0;0
FR;6;2021-05-26;0;0;0;0;0;0;0;0;0;0
FR;6;2021-05-27;0;0;0;0;0;0;0;0;0;0
FR;6;2021-05-28;0;0;0;0;0;0;0;0;0;0
FR;6;2021-05-29;0;0;0;0;0;0;0;0;0;0
FR;6;2021-05-30;0;0;0;0;0;0;0;0;0;0
FR;6;2021-05-31;0;0;0;0;0;0;0;0;0;0
FR;6;2021-06-01;0;0;0;0;0;0;0;0;0;0
FR;6;2021-06-02;0;0;0;0;0;0;0;0;0;0
FR;6;2021-06-03;0;0;0;0;0;0;0;0;0;0
FR;6;2021-06-04;0;0;0;0;0;0;0;0;0;0
FR;6;2021-06-05;0;0;0;0;0;0;0;0;0;0
FR;6;2021-06-06;0;0;0;0;0;0;0;0;0;0
FR;6;2021-06-07;0;0;0;0;0;0;0;0;0;0
FR;6;2021-06-08;0;0;0;0;0;0;0;0;0;0
FR;6;2021-06-09;0;0;0;0;0;0;0;0;0;0
FR;6;2021-06-10;0;0;0;0;0;0;0;0;0;0
FR;6;2021-06-11;0;0;0;0;0;0;0;0;0;0
FR;6;2021-06-12;0;0;0;0;0;0;0;0;0;0
FR;6;2021-06-13;0;0;0;0;0;0;0;0;0;0
FR;6;2021-06-14;0;0;0;0;0;0;0;0;0;0
FR;6;2021-06-15;0;0;0;0;0;0;0;0;0;0
FR;6;2021-06-16;0;0;0;0;0;0;0;0;0;0
FR;6;2021-06-17;0;0;0;0;0;0;0;0;0;0
FR;6;2021-06-18;0;0;0;0;0;0;0;0;0;0
FR;6;2021-06-19;0;0;0;0;0;0;0;0;0;0
FR;6;2021-06-20;0;0;0;0;0;0;0;0;0;0
FR;6;2021-06-21;0;0;0;0;0;0;0;0;0;0
FR;6;2021-06-22;0;0;0;0;0;0;0;0;0;0
FR;6;2021-06-23;0;0;0;0;0;0;0;0;0;0
FR;6;2021-06-24;0;0;0;0;0;0;0;0;0;0
FR;6;2021-06-25;0;0;0;0;0;0;0;0;0;0
FR;6;2021-06-26;0;0;0;0;0;0;0;0;0;0
FR;6;2021-06-27;0;0;0;0;0;0;0;0;0;0
FR;6;2021-06-28;0;0;0;0;0;0;0;0;0;0
FR;6;2021-06-29;0;0;0;0;0;0;0;0;0;0
FR;6;2021-06-30;0;0;0;0;0;0;0;0;0;0
FR;6;2021-07-01;0;0;0;0;0;0;0;0;0;0
FR;6;2021-07-02;0;0;0;0;0;0;0;0;0;0
FR;6;2021-07-03;0;0;0;0;0;0;0;0;0;0
FR;6;2021-07-04;0;0;0;0;0;0;0;0;0;0
FR;6;2021-07-05;0;0;0;0;0;0;0;0;0;0
FR;6;2021-07-06;0;0;0;0;0;0;0;0;0;0
FR;6;2021-07-07;0;0;0;0;0;0;0;0;0;0
FR;6;2021-07-08;0;0;0;0;0;0;0;0;0;0
FR;6;2021-07-09;0;0;0;0;0;0;0;0;0;0
FR;6;2021-07-10;0;0;0;0;0;0;0;0;0;0
FR;6;2021-07-11;0;0;0;0;0;0;0;0;0;0
FR;6;2021-07-12;0;0;0;0;0;0;0;0;0;0
FR;6;2021-07-13;0;0;0;0;0;0;0;0;0;0
FR;6;2021-07-14;0;0;0;0;0;0;0;0;0;0
FR;6;2021-07-15;0;0;0;0;0;0;0;0;0;0
FR;6;2021-07-16;0;0;0;0;0;0;0;0;0;0
FR;6;2021-07-17;0;0;0;0;0;0;0;0;0;0
FR;6;2021-07-18;0;0;0;0;0;0;0;0;0;0
FR;6;2021-07-19;0;0;0;0;0;0;0;0;0;0
FR;6;2021-07-20;0;0;0;0;0;0;0;0;0;0
FR;6;2021-07-21;0;0;0;0;0;0;0;0;0;0
FR;6;2021-07-22;0;0;0;0;0;0;0;0;0;0
FR;6;2021-07-23;0;0;0;0;0;0;0;0;0;0
FR;6;2021-07-24;0;0;0;0;0;0;0;0;0;0
FR;6;2021-07-25;0;0;0;0;0;0;0;0;0;0
FR;6;2021-07-26;0;0;0;0;0;0;0;0;0;0
FR;6;2021-07-27;0;0;0;0;0;0;0;0;0;0
FR;6;2021-07-28;0;0;0;0;0;0;0;0;0;0
FR;6;2021-07-29;0;0;0;0;0;0;0;0;0;0
FR;6;2021-07-30;0;0;0;0;0;0;0;0;0;0
FR;6;2021-07-31;0;0;0;0;0;0;0;0;0;0
FR;6;2021-08-01;0;0;0;0;0;0;0;0;0;0
FR;6;2021-08-02;0;0;0;0;0;0;0;0;0;0
FR;6;2021-08-03;0;0;0;0;0;0;0;0;0;0
FR;6;2021-08-04;0;0;0;0;0;0;0;0;0;0
FR;6;2021-08-05;0;0;0;0;0;0;0;0;0;0
FR;6;2021-08-06;0;0;0;0;0;0;0;0;0;0
FR;6;2021-08-07;0;0;0;0;0;0;0;0;0;0
FR;6;2021-08-08;0;0;0;0;0;0;0;0;0;0
FR;6;2021-08-09;0;0;0;0;0;0;0;0;0;0
FR;6;2021-08-10;0;0;0;0;0;0;0;0;0;0
FR;6;2021-08-11;0;0;0;0;0;0;0;0;0;0
FR;6;2021-08-12;0;0;0;0;0;0;0;0;0;0
FR;6;2021-08-13;0;0;0;0;0;0;0;0;0;0
FR;6;2021-08-14;0;0;0;0;0;0;0;0;0;0
FR;6;2021-08-15;0;0;0;0;0;0;0;0;0;0
FR;6;2021-08-16;0;0;0;0;0;0;0;0;0;0
FR;6;2021-08-17;0;0;0;0;0;0;0;0;0;0
FR;6;2021-08-18;0;0;0;0;0;0;0;0;0;0
FR;6;2021-08-19;0;0;0;0;0;0;0;0;0;0
FR;6;2021-08-20;0;0;0;0;0;0;0;0;0;0
FR;6;2021-08-21;0;0;0;0;0;0;0;0;0;0
FR;6;2021-08-22;0;0;0;0;0;0;0;0;0;0
FR;6;2021-08-23;0;0;0;0;0;0;0;0;0;0
FR;6;2021-08-24;0;0;0;0;0;0;0;0;0;0
FR;6;2021-08-25;0;0;0;0;0;0;0;0;0;0
FR;6;2021-08-26;0;0;0;0;0;0;0;0;0;0
FR;6;2021-08-27;0;0;0;0;0;0;0;0;0;0
FR;6;2021-08-28;0;0;0;0;0;0;0;0;0;0
FR;6;2021-08-29;0;0;0;0;0;0;0;0;0;0
FR;6;2021-08-30;0;0;0;0;0;0;0;0;0;0
FR;6;2021-08-31;0;0;0;0;0;0;0;0;0;0
FR;6;2021-09-01;0;0;0;0;0;0;0;0;0;0
FR;6;2021-09-02;0;0;0;0;0;0;0;0;0;0
FR;6;2021-09-03;0;0;0;0;0;0;0;0;0;0
FR;6;2021-09-04;0;0;0;0;0;0;0;0;0;0
FR;6;2021-09-05;0;0;0;0;0;0;0;0;0;0
FR;6;2021-09-06;0;0;0;0;0;0;0;0;0;0
FR;6;2021-09-07;0;0;0;0;0;0;0;0;0;0
FR;6;2021-09-08;0;0;0;0;0;0;0;0;0;0
FR;6;2021-09-09;0;0;0;0;0;0;0;0;0;0
FR;6;2021-09-10;0;0;0;0;0;0;0;0;0;0
FR;6;2021-09-11;0;0;0;0;0;0;0;0;0;0
FR;6;2021-09-12;0;0;0;0;0;0;0;0;0;0
FR;6;2021-09-13;0;0;0;0;0;0;0;0;0;0
FR;6;2021-09-14;0;0;0;0;0;0;0;0;0;0
FR;6;2021-09-15;0;0;0;0;0;0;0;0;0;0
FR;6;2021-09-16;0;0;0;0;0;0;0;0;0;0
FR;6;2021-09-17;0;0;0;0;0;0;0;0;0;0
FR;6;2021-09-18;0;0;0;0;0;0;0;0;0;0
FR;6;2021-09-19;0;0;0;0;0;0;0;0;0;0
FR;6;2021-09-20;0;0;0;0;0;0;0;0;0;0
FR;6;2021-09-21;0;0;0;0;0;0;0;0;0;0
FR;6;2021-09-22;0;0;0;0;0;0;0;0;0;0
FR;6;2021-09-23;0;0;0;0;0;0;0;0;0;0
FR;6;2021-09-24;0;0;0;0;0;0;0;0;0;0
FR;6;2021-09-25;0;0;0;0;0;0;0;0;0;0
FR;6;2021-09-26;0;0;0;0;0;0;0;0;0;0
FR;6;2021-09-27;0;0;0;0;0;0;0;0;0;0
FR;6;2021-09-28;0;0;0;0;0;0;0;0;0;0
FR;6;2021-09-29;0;0;0;0;0;0;0;0;0;0
FR;6;2021-09-30;0;0;0;0;0;0;0;0;0;0
FR;6;2021-10-01;0;0;0;0;0;0;0;0;0;0
FR;6;2021-10-02;0;0;0;0;0;0;0;0;0;0
FR;6;2021-10-03;0;0;0;0;0;0;0;0;0;0
FR;6;2021-10-04;0;0;0;0;0;0;0;0;0;0
FR;6;2021-10-05;0;0;0;0;0;0;0;0;0;0
FR;6;2021-10-06;0;0;0;0;0;0;0;0;0;0
FR;6;2021-10-07;0;0;0;0;0;0;0;0;0;0
FR;6;2021-10-08;0;0;0;0;0;0;0;0;0;0
FR;6;2021-10-09;0;0;0;0;0;0;0;0;0;0
FR;6;2021-10-10;0;0;0;0;0;0;0;0;0;0
FR;6;2021-10-11;0;0;0;0;0;0;0;0;0;0
FR;6;2021-10-12;0;0;0;0;0;0;0;0;0;0
FR;6;2021-10-13;0;0;0;0;0;0;0;0;0;0
FR;6;2021-10-14;0;0;0;0;0;0;0;0;0;0
FR;6;2021-10-15;0;0;0;0;0;0;0;0;0;0
FR;6;2021-10-16;0;0;0;0;0;0;0;0;0;0
FR;6;2021-10-17;0;0;0;0;0;0;0;0;0;0
FR;6;2021-10-18;0;0;0;0;0;0;0;0;0;0
FR;6;2021-10-19;0;0;0;0;0;0;0;0;0;0
FR;6;2021-10-20;0;0;0;0;0;0;0;0;0;0
FR;6;2021-10-21;0;0;0;0;0;0;0;0;0;0
FR;6;2021-10-22;0;0;0;0;0;0;0;0;0;0
FR;6;2021-10-23;0;0;0;0;0;0;0;0;0;0
FR;6;2021-10-24;0;0;0;0;0;0;0;0;0;0
FR;6;2021-10-25;0;0;0;0;0;0;0;0;0;0
FR;6;2021-10-26;0;0;0;0;0;0;0;0;0;0
FR;6;2021-10-27;0;0;0;0;0;0;0;0;0;0
FR;6;2021-10-28;0;0;0;0;0;0;0;0;0;0
FR;6;2021-10-29;0;0;0;0;0;0;0;0;0;0
FR;6;2021-10-30;0;0;0;0;0;0;0;0;0;0
FR;6;2021-10-31;0;0;0;0;0;0;0;0;0;0
FR;6;2021-11-01;0;0;0;0;0;0;0;0;0;0
FR;6;2021-11-02;0;0;0;0;0;0;0;0;0;0
FR;6;2021-11-03;0;0;0;0;0;0;0;0;0;0
FR;6;2021-11-04;0;0;0;0;0;0;0;0;0;0
FR;6;2021-11-05;0;0;0;0;0;0;0;0;0;0
FR;6;2021-11-06;0;0;0;0;0;0;0;0;0;0
FR;6;2021-11-07;0;0;0;0;0;0;0;0;0;0
FR;6;2021-11-08;0;0;0;0;0;0;0;0;0;0
FR;6;2021-11-09;0;0;0;0;0;0;0;0;0;0
FR;6;2021-11-10;0;0;0;0;0;0;0;0;0;0
FR;6;2021-11-11;0;0;0;0;0;0;0;0;0;0
FR;6;2021-11-12;0;0;0;0;0;0;0;0;0;0
FR;6;2021-11-13;0;0;0;0;0;0;0;0;0;0
FR;6;2021-11-14;0;0;0;0;0;0;0;0;0;0
FR;6;2021-11-15;0;0;0;0;0;0;0;0;0;0
FR;6;2021-11-16;0;0;0;0;0;0;0;0;0;0
FR;6;2021-11-17;0;0;0;0;0;0;0;0;0;0
FR;6;2021-11-18;0;0;0;0;0;0;0;0;0;0
FR;6;2021-11-19;0;0;0;0;0;0;0;0;0;0
FR;6;2021-11-20;0;0;0;0;0;0;0;0;0;0
FR;6;2021-11-21;0;0;0;0;0;0;0;0;0;0
FR;6;2021-11-22;0;0;0;0;0;0;0;0;0;0
FR;6;2021-11-23;0;0;0;0;0;0;0;0;0;0
FR;6;2021-11-24;0;0;0;0;0;0;0;0;0;0
FR;6;2021-11-25;0;0;0;0;0;0;0;0;0;0
FR;6;2021-11-26;0;0;0;0;0;0;0;0;0;0
FR;6;2021-11-27;0;0;0;0;0;0;0;0;0;0
FR;6;2021-11-28;0;0;0;0;0;0;0;0;0;0
FR;6;2021-11-29;0;0;0;0;0;0;0;0;0;0
FR;6;2021-11-30;0;0;0;0;0;0;0;0;0;0
FR;6;2021-12-01;0;0;0;0;0;0;0;0;0;0
FR;6;2021-12-02;0;0;0;0;0;0;0;0;0;0
FR;6;2021-12-03;0;0;0;0;0;0;0;0;0;0
FR;6;2021-12-04;0;0;0;0;0;0;0;0;0;0
FR;6;2021-12-05;0;0;0;0;0;0;0;0;0;0
FR;6;2021-12-06;0;0;0;0;0;0;0;0;0;0
FR;6;2021-12-07;0;0;0;0;0;0;0;0;0;0
FR;6;2021-12-08;0;0;0;0;0;0;0;0;0;0
FR;6;2021-12-09;0;0;0;0;0;0;0;0;0;0
FR;6;2021-12-10;0;0;0;0;0;0;0;0;0;0
FR;6;2021-12-11;0;0;0;0;0;0;0;0;0;0
FR;6;2021-12-12;0;0;0;0;0;0;0;0;0;0
FR;6;2021-12-13;0;0;0;0;0;0;0;0;0;0
FR;6;2021-12-14;0;0;0;0;0;0;0;0;0;0
FR;6;2021-12-15;0;0;0;0;0;0;0;0;0;0
FR;6;2021-12-16;0;0;0;0;0;0;0;0;0;0
FR;6;2021-12-17;0;0;0;0;0;0;0;0;0;0
FR;6;2021-12-18;0;0;0;0;0;0;0;0;0;0
FR;6;2021-12-19;0;0;0;0;0;0;0;0;0;0
FR;6;2021-12-20;0;0;0;0;0;0;0;0;0;0
FR;6;2021-12-21;0;0;0;0;0;0;0;0;0;0
FR;6;2021-12-22;0;0;0;0;0;0;0;0;0;0
FR;6;2021-12-23;0;0;0;0;0;0;0;0;0;0
FR;6;2021-12-24;0;0;0;0;0;0;0;0;0;0
FR;6;2021-12-25;0;0;0;0;0;0;0;0;0;0
FR;6;2021-12-26;0;0;0;0;0;0;0;0;0;0
FR;6;2021-12-27;0;0;0;0;0;0;0;0;0;0
FR;6;2021-12-28;0;0;0;0;0;0;0;0;0;0
FR;6;2021-12-29;0;0;0;0;0;0;0;0;0;0
FR;6;2021-12-30;0;0;0;0;0;0;0;0;0;0
FR;6;2021-12-31;0;0;0;0;0;0;0;0;0;0
FR;6;2022-01-01;0;0;0;0;0;0;0;0;0;0
FR;6;2022-01-02;0;0;0;0;0;0;0;0;0;0
FR;6;2022-01-03;0;0;0;0;0;0;0;0;0;0
FR;6;2022-01-04;0;0;0;0;0;0;0;0;0;0
FR;6;2022-01-05;0;0;0;0;0;0;0;0;0;0
FR;6;2022-01-06;0;0;0;0;0;0;0;0;0;0
FR;6;2022-01-07;0;0;0;0;0;0;0;0;0;0
FR;6;2022-01-08;0;0;0;0;0;0;0;0;0;0
FR;6;2022-01-09;0;0;0;0;0;0;0;0;0;0
FR;6;2022-01-10;0;0;0;0;0;0;0;0;0;0
FR;6;2022-01-11;0;0;0;0;0;0;0;0;0;0
FR;6;2022-01-12;0;0;0;0;0;0;0;0;0;0
FR;6;2022-01-13;0;0;0;0;0;0;0;0;0;0
FR;6;2022-01-14;0;0;0;0;0;0;0;0;0;0
FR;6;2022-01-15;0;0;0;0;0;0;0;0;0;0
FR;6;2022-01-16;0;0;0;0;0;0;0;0;0;0
FR;6;2022-01-17;0;0;0;0;0;0;0;0;0;0
FR;6;2022-01-18;0;0;0;0;0;0;0;0;0;0
FR;6;2022-01-19;0;0;0;0;0;0;0;0;0;0
FR;6;2022-01-20;0;0;0;0;0;0;0;0;0;0
FR;6;2022-01-21;0;0;0;0;0;0;0;0;0;0
FR;6;2022-01-22;0;0;0;0;0;0;0;0;0;0
FR;6;2022-01-23;0;0;0;0;0;0;0;0;0;0
FR;6;2022-01-24;0;0;0;0;0;0;0;0;0;0
FR;6;2022-01-25;0;0;0;0;0;0;0;0;0;0
FR;6;2022-01-26;0;0;0;0;0;0;0;0;0;0
FR;6;2022-01-27;0;0;0;0;0;0;0;0;0;0
FR;6;2022-01-28;0;0;0;0;0;0;0;0;0;0
FR;6;2022-01-29;0;0;0;0;0;0;0;0;0;0
FR;6;2022-01-30;0;0;0;0;0;0;0;0;0;0
FR;6;2022-01-31;0;0;0;0;0;0;0;0;0;0
FR;6;2022-02-01;0;0;0;0;0;0;0;0;0;0
FR;6;2022-02-02;0;0;0;0;0;0;0;0;0;0
FR;6;2022-02-03;0;0;0;0;0;0;0;0;0;0
FR;6;2022-02-04;0;0;0;0;0;0;0;0;0;0
FR;6;2022-02-05;0;0;0;0;0;0;0;0;0;0
FR;6;2022-02-06;0;0;0;0;0;0;0;0;0;0
FR;6;2022-02-07;0;0;0;0;0;0;0;0;0;0
FR;6;2022-02-08;0;0;0;0;0;0;0;0;0;0
FR;6;2022-02-09;0;0;0;0;0;0;0;0;0;0
FR;6;2022-02-10;0;0;0;0;0;0;0;0;0;0
FR;6;2022-02-11;0;0;0;0;0;0;0;0;0;0
FR;6;2022-02-12;0;0;0;0;0;0;0;0;0;0
FR;6;2022-02-13;0;0;0;0;0;0;0;0;0;0
FR;6;2022-02-14;0;0;0;0;0;0;0;0;0;0
FR;6;2022-02-15;0;0;0;0;0;0;0;0;0;0
FR;6;2022-02-16;0;0;0;0;0;0;0;0;0;0
FR;6;2022-02-17;0;0;0;0;0;0;0;0;0;0
FR;6;2022-02-18;0;0;0;0;0;0;0;0;0;0
FR;6;2022-02-19;0;0;0;0;0;0;0;0;0;0
FR;6;2022-02-20;0;0;0;0;0;0;0;0;0;0
FR;6;2022-02-21;0;0;0;0;0;0;0;0;0;0
FR;6;2022-02-22;0;0;0;0;0;0;0;0;0;0
FR;6;2022-02-23;0;0;0;0;0;0;0;0;0;0
FR;6;2022-02-24;0;0;0;0;0;0;0;0;0;0
FR;6;2022-02-25;0;0;0;0;0;0;0;0;0;0
FR;6;2022-02-26;1;0;0;0;0;1;0;0;0;0
FR;6;2022-02-27;0;0;0;0;0;1;0;0;0;0
FR;6;2022-02-28;0;0;0;0;0;1;0;0;0;0
FR;6;2022-03-01;3;0;0;0;0;4;0;0;0;0
FR;6;2022-03-02;97;9;2;0;7;101;9;2;0;7
FR;6;2022-03-03;0;0;0;0;0;101;9;2;0;7
FR;6;2022-03-04;91;4;0;0;4;192;13;2;0;11
FR;6;2022-03-05;391;23;2;0;14;583;36;4;0;25
FR;6;2022-03-06;7;1;0;0;0;590;37;4;0;25
FR;6;2022-03-07;337;19;0;0;13;927;56;4;0;38
FR;6;2022-03-08;230;14;0;0;5;1157;70;4;0;43
FR;6;2022-03-09;519;29;2;0;21;1676;99;6;0;64
FR;6;2022-03-10;207;18;0;1;12;1883;117;6;1;76
FR;6;2022-03-11;328;21;6;0;21;2211;138;12;1;97
FR;6;2022-03-12;518;25;1;0;20;2729;163;13;1;117
FR;6;2022-03-13;40;2;0;0;1;2769;165;13;1;118
FR;6;2022-03-14;201;4;2;0;3;2970;169;15;1;121
FR;6;2022-03-15;112;11;2;0;9;3082;180;17;1;130
FR;6;2022-03-16;310;17;1;1;14;3392;197;18;2;144
FR;6;2022-03-17;117;6;1;2;4;3509;203;19;4;148
FR;6;2022-03-18;214;11;0;0;6;3723;214;19;4;154
FR;6;2022-03-19;307;19;2;0;9;4030;233;21;4;163
FR;6;2022-03-20;15;5;0;0;1;4045;238;21;4;164
FR;6;2022-03-21;132;23;1;0;4;4177;261;22;4;168
FR;6;2022-03-22;97;15;0;0;4;4274;276;22;4;172
FR;6;2022-03-23;226;108;3;0;14;4500;384;25;4;186
FR;6;2022-03-24;99;15;1;3;4;4599;399;26;7;190
FR;6;2022-03-25;203;141;2;1;15;4802;540;28;8;205
FR;6;2022-03-26;332;295;7;1;19;5134;835;35;9;224
FR;6;2022-03-27;32;30;1;0;1;5166;865;36;9;225
FR;6;2022-03-28;200;208;8;1;17;5366;1073;44;10;242
FR;6;2022-03-29;126;189;12;2;12;5492;1262;56;12;254
FR;6;2022-03-30;305;476;10;2;22;5797;1738;66;14;276
FR;6;2022-03-31;124;140;9;0;13;5921;1878;75;14;289
FR;6;2022-04-01;194;150;11;2;23;6115;2028;86;16;312
FR;6;2022-04-02;205;241;9;1;13;6320;2269;95;17;325
FR;6;2022-04-03;17;21;0;0;1;6337;2290;95;17;326
FR;6;2022-04-04;130;114;6;1;9;6467;2404;101;18;335
FR;6;2022-04-05;145;88;15;1;11;6612;2492;116;19;346
FR;6;2022-04-06;203;245;22;26;27;6815;2737;138;45;373
FR;6;2022-04-07;127;96;15;5;17;6942;2833;153;50;390
FR;6;2022-04-08;199;170;16;3;17;7141;3003;169;53;407
FR;6;2022-04-09;145;139;6;12;13;7286;3142;175;65;420
FR;6;2022-04-10;10;20;3;0;1;7296;3162;178;65;421
FR;6;2022-04-11;101;106;4;0;5;7397;3268;182;65;426
FR;6;2022-04-12;135;75;5;8;10;7532;3343;187;73;436
FR;6;2022-04-13;160;175;7;5;13;7692;3518;194;78;449
FR;6;2022-04-14;100;103;5;10;8;7792;3621;199;88;457
FR;6;2022-04-15;160;148;11;7;19;7952;3769;210;95;476
FR;6;2022-04-16;127;132;5;0;14;8079;3901;215;95;490
FR;6;2022-04-17;8;9;4;0;4;8087;3910;219;95;494
FR;6;2022-04-18;8;15;3;0;4;8095;3925;222;95;498
FR;6;2022-04-19;97;112;4;3;3;8192;4037;226;98;501
FR;6;2022-04-20;172;227;8;7;15;8364;4264;234;105;516
FR;6;2022-04-21;111;93;8;4;11;8475;4357;242;109;527
FR;6;2022-04-22;136;160;13;12;13;8611;4517;255;121;540
FR;6;2022-04-23;104;129;1;1;7;8715;4646;256;122;547
FR;6;2022-04-24;5;21;1;0;0;8720;4667;257;122;547
FR;6;2022-04-25;90;128;3;8;11;8810;4795;260;130;558
FR;6;2022-04-26;101;128;18;2;16;8911;4923;278;132;574
FR;6;2022-04-27;197;159;21;1;27;9108;5082;299;133;601
FR;6;2022-04-28;108;87;6;1;8;9216;5169;305;134;609
FR;6;2022-04-29;186;168;16;2;20;9402;5337;321;136;629
FR;6;2022-04-30;131;125;7;1;24;9533;5462;328;137;653
FR;6;2022-05-01;7;6;0;0;0;9540;5468;328;137;653
FR;6;2022-05-02;94;65;3;4;3;9634;5533;331;141;656
FR;6;2022-05-03;136;91;11;2;7;9770;5624;342;143;663
FR;6;2022-05-04;165;118;25;12;29;9935;5742;367;155;692
FR;6;2022-05-05;101;70;8;3;12;10036;5812;375;158;704
FR;6;2022-05-06;150;110;10;9;16;10186;5922;385;167;720
FR;6;2022-05-07;138;93;13;3;23;10324;6015;398;170;743
FR;6;2022-05-08;20;8;6;5;7;10344;6023;404;175;750
FR;6;2022-05-09;83;70;9;7;13;10427;6093;413;182;763
FR;6;2022-05-10;109;80;15;7;12;10536;6173;428;189;775
FR;6;2022-05-11;130;120;11;14;20;10666;6293;439;203;795
FR;6;2022-05-12;105;75;6;5;13;10771;6368;445;208;808
FR;6;2022-05-13;154;95;17;21;20;10925;6463;462;229;828
FR;6;2022-05-14;81;59;6;7;15;11006;6522;468;236;843
FR;6;2022-05-15;12;7;1;0;1;11018;6529;469;236;844
FR;6;2022-05-16;63;52;7;2;12;11081;6581;476;238;856
FR;6;2022-05-17;123;76;4;7;10;11204;6657;480;245;866
FR;6;2022-05-18;130;116;6;1;14;11334;6773;486;246;880
FR;6;2022-05-19;123;56;6;8;9;11457;6829;492;254;889
FR;0;2020-12-27;602;0;0;0;0;602;0;0;0;0
FR;0;2020-12-28;663;1;0;0;0;1265;1;0;0;0
FR;0;2020-12-29;371;0;0;0;0;1636;1;0;0;0
FR;0;2020-12-30;437;0;0;0;0;2073;1;0;0;0
FR;0;2020-12-31;413;0;0;0;0;2486;1;0;0;0
FR;0;2021-01-01;1135;1;0;0;0;3621;2;0;0;0
FR;0;2021-01-02;356;3;0;0;0;3977;5;0;0;0
FR;0;2021-01-03;399;0;0;0;0;4376;5;0;0;0
FR;0;2021-01-04;2086;2;0;0;0;6462;7;0;0;0
FR;0;2021-01-05;7558;2;0;0;0;14020;9;0;0;0
FR;0;2021-01-06;12410;10;0;0;0;26430;19;0;0;0
FR;0;2021-01-07;29445;9;0;0;0;55875;28;0;0;0
FR;0;2021-01-08;37121;9;0;0;0;92996;37;0;0;0
FR;0;2021-01-09;11209;4;0;0;0;104205;41;0;0;0
FR;0;2021-01-10;5996;3;0;0;0;110201;44;0;0;0
FR;0;2021-01-11;39922;16;0;0;0;150123;60;0;0;0
FR;0;2021-01-12;62119;15;0;0;0;212242;75;0;0;0
FR;0;2021-01-13;65096;28;0;0;0;277338;103;0;0;0
FR;0;2021-01-14;83123;71;0;0;0;360461;174;0;0;0
FR;0;2021-01-15;68986;27;0;0;0;429447;201;0;0;0
FR;0;2021-01-16;20208;70;0;0;0;449655;271;0;0;0
FR;0;2021-01-17;10976;46;0;0;0;460631;317;0;0;0
FR;0;2021-01-18;85874;165;0;0;0;546505;482;0;0;0
FR;0;2021-01-19;130571;170;0;0;0;677076;652;0;0;0
FR;0;2021-01-20;137523;170;0;0;0;814599;822;0;0;0
FR;0;2021-01-21;158368;168;0;0;0;972967;990;0;0;0
FR;0;2021-01-22;121038;199;0;0;0;1094005;1189;0;0;0
FR;0;2021-01-23;38464;63;0;0;0;1132469;1252;0;0;0
FR;0;2021-01-24;9740;69;0;0;0;1142209;1321;0;0;0
FR;0;2021-01-25;78216;1263;0;0;0;1220425;2584;0;0;0
FR;0;2021-01-26;100358;3282;1;0;0;1320783;5866;1;0;0
FR;0;2021-01-27;107222;5896;0;0;0;1428005;11762;1;0;0
FR;0;2021-01-28;124322;14925;0;0;0;1552327;26687;1;0;0
FR;0;2021-01-29;92168;17703;0;0;0;1644495;44390;1;0;0
FR;0;2021-01-30;29110;4258;0;0;0;1673605;48648;1;0;0
FR;0;2021-01-31;5225;1732;0;0;0;1678830;50380;1;0;0
FR;0;2021-02-01;53103;21507;0;0;0;1731933;71887;1;0;0
FR;0;2021-02-02;72274;35649;0;0;0;1804207;107536;1;0;0
FR;0;2021-02-03;72284;37902;0;0;0;1876491;145438;1;0;0
FR;0;2021-02-04;82047;51419;0;0;0;1958538;196857;1;0;0
FR;0;2021-02-05;68216;46065;0;0;0;2026754;242922;1;0;0
FR;0;2021-02-06;23113;10752;0;0;0;2049867;253674;1;0;0
FR;0;2021-02-07;5181;5255;0;0;0;2055048;258929;1;0;0
FR;0;2021-02-08;46815;46853;0;0;0;2101863;305782;1;0;0
FR;0;2021-02-09;65990;74236;0;0;0;2167853;380018;1;0;0
FR;0;2021-02-10;70980;79112;0;0;0;2238833;459130;1;0;0
FR;0;2021-02-11;87235;100998;0;0;0;2326068;560128;1;0;0
FR;0;2021-02-12;79286;74917;0;0;0;2405354;635045;1;0;0
FR;0;2021-02-13;22351;19478;0;0;0;2427705;654523;1;0;0
FR;0;2021-02-14;5070;7193;0;0;0;2432775;661716;1;0;0
FR;0;2021-02-15;38068;76586;0;0;0;2470843;738302;1;0;0
FR;0;2021-02-16;50361;100527;0;0;0;2521204;838829;1;0;0
FR;0;2021-02-17;50495;104540;1;0;0;2571699;943369;2;0;0
FR;0;2021-02-18;69755;120207;0;0;0;2641454;1063576;2;0;0
FR;0;2021-02-19;65048;91023;1;0;0;2706502;1154599;3;0;0
FR;0;2021-02-20;18573;28582;0;0;0;2725075;1183181;3;0;0
FR;0;2021-02-21;3314;6314;0;0;0;2728389;1189495;3;0;0
FR;0;2021-02-22;37476;73125;2;0;0;2765865;1262620;5;0;0
FR;0;2021-02-23;53758;84429;1;0;0;2819623;1347049;6;0;0
FR;0;2021-02-24;59977;81630;1;0;0;2879600;1428679;7;0;0
FR;0;2021-02-25;100541;91421;1;0;0;2980141;1520100;8;0;0
FR;0;2021-02-26;113422;70749;1;0;0;3093563;1590849;9;0;0
FR;0;2021-02-27;52091;22134;0;0;0;3145654;1612983;9;0;0
FR;0;2021-02-28;6190;4283;1;0;0;3151844;1617266;10;0;0
FR;0;2021-03-01;65828;53296;1;0;0;3217672;1670562;11;0;0
FR;0;2021-03-02;101345;66552;2;0;0;3319017;1737114;13;0;0
FR;0;2021-03-03;116459;65513;0;0;0;3435476;1802627;13;0;0
FR;0;2021-03-04;163580;70142;3;0;0;3599056;1872769;16;0;0
FR;0;2021-03-05;200881;63133;3;0;0;3799937;1935902;19;0;0
FR;0;2021-03-06;207921;17735;3;0;0;4007858;1953637;22;0;0
FR;0;2021-03-07;121250;5008;1;0;0;4129108;1958645;23;0;0
FR;0;2021-03-08;107110;50394;2;0;0;4236218;2009039;25;0;0
FR;0;2021-03-09;172409;56531;2;0;0;4408627;2065570;27;0;0
FR;0;2021-03-10;178932;57131;5;0;0;4587559;2122701;32;0;0
FR;0;2021-03-11;242820;63410;2;0;0;4830379;2186111;34;0;0
FR;0;2021-03-12;294771;53407;1;0;0;5125150;2239518;35;0;0
FR;0;2021-03-13;231370;15317;1;0;0;5356520;2254835;36;0;0
FR;0;2021-03-14;63334;3300;1;0;0;5419854;2258135;37;0;0
FR;0;2021-03-15;158598;32179;3;0;0;5578452;2290314;40;0;0
FR;0;2021-03-16;141538;39141;6;0;0;5719990;2329455;46;0;0
FR;0;2021-03-17;150440;38199;4;0;0;5870430;2367654;50;0;0
FR;0;2021-03-18;167777;44530;5;0;0;6038207;2412184;55;0;0
FR;0;2021-03-19;229961;37172;2;0;0;6268168;2449356;57;0;0
FR;0;2021-03-20;166639;11599;1;0;0;6434807;2460955;58;0;0
FR;0;2021-03-21;49918;2521;1;0;0;6484725;2463476;59;0;0
FR;0;2021-03-22;169992;34005;2;0;0;6654717;2497481;61;0;0
FR;0;2021-03-23;250329;42387;1;0;0;6905046;2539868;62;0;0
FR;0;2021-03-24;256846;43713;0;0;0;7161892;2583581;62;0;0
FR;0;2021-03-25;341745;44854;5;0;0;7503637;2628435;67;0;0
FR;0;2021-03-26;358743;41825;4;1;0;7862380;2670260;71;1;0
FR;0;2021-03-27;195238;16705;1;0;0;8057618;2686965;72;1;0
FR;0;2021-03-28;59321;3992;3;0;0;8116939;2690957;75;1;0
FR;0;2021-03-29;202926;54031;4;0;0;8319865;2744988;79;1;0
FR;0;2021-03-30;285406;69653;4;0;0;8605271;2814641;83;1;0
FR;0;2021-03-31;262962;73212;4;0;0;8868233;2887853;87;1;0
FR;0;2021-04-01;315379;89140;12;0;0;9183612;2976993;99;1;0
FR;0;2021-04-02;281274;92730;7;0;0;9464886;3069723;106;1;0
FR;0;2021-04-03;141046;61906;5;0;0;9605932;3131629;111;1;0
FR;0;2021-04-04;46448;18735;2;0;0;9652380;3150364;113;1;0
FR;0;2021-04-05;63304;10817;11;0;0;9715684;3161181;124;1;0
FR;0;2021-04-06;217139;109153;17;0;0;9932823;3270334;141;1;0
FR;0;2021-04-07;260184;115392;17;0;0;10193007;3385726;158;1;0
FR;0;2021-04-08;337730;121664;14;0;0;10530737;3507390;172;1;0
FR;0;2021-04-09;410076;116288;49;0;0;10940813;3623678;221;1;0
FR;0;2021-04-10;212579;82616;15;0;0;11153392;3706294;236;1;0
FR;0;2021-04-11;56121;34439;7;0;0;11209513;3740733;243;1;0
FR;0;2021-04-12;236995;115216;45;0;0;11446508;3855949;288;1;0
FR;0;2021-04-13;309415;144544;98;1;0;11755923;4000493;386;2;0
FR;0;2021-04-14;294430;139287;213;0;0;12050353;4139780;599;2;0
FR;0;2021-04-15;337002;148330;338;0;0;12387355;4288110;937;2;0
FR;0;2021-04-16;339221;145861;352;0;0;12726576;4433971;1289;2;0
FR;0;2021-04-17;188619;90039;109;0;0;12915195;4524010;1398;2;0
FR;0;2021-04-18;51600;35368;47;0;0;12966795;4559378;1445;2;0
FR;0;2021-04-19;205639;138213;454;0;0;13172434;4697591;1899;2;0
FR;0;2021-04-20;254340;170770;568;0;0;13426774;4868361;2467;2;0
FR;0;2021-04-21;253173;169046;834;0;0;13679947;5037407;3301;2;0
FR;0;2021-04-22;287485;188646;818;0;0;13967432;5226053;4119;2;0
FR;0;2021-04-23;297923;183388;747;0;0;14265355;5409441;4866;2;0
FR;0;2021-04-24;190407;111539;251;0;0;14455762;5520980;5117;2;0
FR;0;2021-04-25;69536;38781;51;0;0;14525298;5559761;5168;2;0
FR;0;2021-04-26;220889;156213;560;0;0;14746187;5715974;5728;2;0
FR;0;2021-04-27;284543;187311;939;0;0;15030730;5903285;6667;2;0
FR;0;2021-04-28;299431;183162;1422;1;1;15330161;6086447;8089;3;1
FR;0;2021-04-29;357051;196431;1276;0;0;15687212;6282878;9365;3;1
FR;0;2021-04-30;372130;184753;1119;1;0;16059342;6467631;10484;4;1
FR;0;2021-05-01;167595;52497;178;0;0;16226937;6520128;10662;4;1
FR;0;2021-05-02;91699;37749;83;0;0;16318636;6557877;10745;4;1
FR;0;2021-05-03;288848;168494;839;0;0;16607484;6726371;11584;4;1
FR;0;2021-05-04;315582;224342;1230;0;0;16923066;6950713;12814;4;1
FR;0;2021-05-05;327088;224692;1312;0;0;17250154;7175405;14126;4;1
FR;0;2021-05-06;379416;239335;1629;0;0;17629570;7414740;15755;4;1
FR;0;2021-05-07;372674;257255;1222;0;0;18002244;7671995;16977;4;1
FR;0;2021-05-08;222132;67303;297;0;0;18224376;7739298;17274;4;1
FR;0;2021-05-09;129684;46415;243;0;0;18354060;7785713;17517;4;1
FR;0;2021-05-10;313292;228676;1232;0;0;18667352;8014389;18749;4;1
FR;0;2021-05-11;403807;257797;1563;0;0;19071159;8272186;20312;4;1
FR;0;2021-05-12;434024;233016;1542;0;0;19505183;8505202;21854;4;1
FR;0;2021-05-13;338542;56933;430;0;0;19843725;8562135;22284;4;1
FR;0;2021-05-14;454049;167248;1122;0;0;20297774;8729383;23406;4;1
FR;0;2021-05-15;374916;94017;442;0;0;20672690;8823400;23848;4;1
FR;0;2021-05-16;202717;20785;168;0;0;20875407;8844185;24016;4;1
FR;0;2021-05-17;376054;148833;1549;0;0;21251461;8993018;25565;4;1
FR;0;2021-05-18;460054;153062;1986;0;0;21711515;9146080;27551;4;1
FR;0;2021-05-19;467314;144784;2455;0;0;22178829;9290864;30006;4;1
FR;0;2021-05-20;507393;160174;2331;0;0;22686222;9451038;32337;4;1
FR;0;2021-05-21;489550;174348;1987;0;0;23175772;9625386;34324;4;1
FR;0;2021-05-22;347137;79842;668;0;0;23522909;9705228;34992;4;1
FR;0;2021-05-23;161636;14402;246;0;0;23684545;9719630;35238;4;1
FR;0;2021-05-24;263129;33172;599;0;0;23947674;9752802;35837;4;1
FR;0;2021-05-25;400135;189108;2349;1;0;24347809;9941910;38186;5;1
FR;0;2021-05-26;413355;188374;2217;0;0;24761164;10130284;40403;5;1
FR;0;2021-05-27;449697;218534;2158;0;0;25210861;10348818;42561;5;1
FR;0;2021-05-28;429442;259389;1890;0;0;25640303;10608207;44451;5;1
FR;0;2021-05-29;298939;149321;583;0;0;25939242;10757528;45034;5;1
FR;0;2021-05-30;107095;32582;163;0;0;26046337;10790110;45197;5;1
FR;0;2021-05-31;357910;203378;1465;1;1;26404247;10993488;46662;6;2
FR;0;2021-06-01;430830;251260;1959;1;1;26835077;11244748;48621;7;3
FR;0;2021-06-02;419284;230805;1978;0;0;27254361;11475553;50599;7;3
FR;0;2021-06-03;464538;258394;1819;0;0;27718899;11733947;52418;7;3
FR;0;2021-06-04;455682;304705;1729;1;1;28174581;12038652;54147;8;4
FR;0;2021-06-05;304744;188934;651;0;0;28479325;12227586;54798;8;4
FR;0;2021-06-06;133235;49130;226;0;0;28612560;12276716;55024;8;4
FR;0;2021-06-07;338964;261947;1518;0;0;28951524;12538663;56542;8;4
FR;0;2021-06-08;393557;290950;1797;0;0;29345081;12829613;58339;8;4
FR;0;2021-06-09;384656;275486;1727;0;0;29729737;13105099;60066;8;4
FR;0;2021-06-10;403955;288934;1719;1;0;30133692;13394033;61785;9;4
FR;0;2021-06-11;386460;357241;1459;0;0;30520152;13751274;63244;9;4
FR;0;2021-06-12;283202;211287;490;0;0;30803354;13962561;63734;9;4
FR;0;2021-06-13;104828;73985;204;0;0;30908182;14036546;63938;9;4
FR;0;2021-06-14;240646;355583;1425;1;0;31148828;14392129;65363;10;4
FR;0;2021-06-15;307971;385620;1564;1;0;31456799;14777749;66927;11;4
FR;0;2021-06-16;313833;357729;1414;1;0;31770632;15135478;68341;12;4
FR;0;2021-06-17;317551;372403;1422;1;0;32088183;15507881;69763;13;4
FR;0;2021-06-18;321551;442416;1332;1;0;32409734;15950297;71095;14;4
FR;0;2021-06-19;224305;273789;448;0;0;32634039;16224086;71543;14;4
FR;0;2021-06-20;74366;102591;127;0;0;32708405;16326677;71670;14;4
FR;0;2021-06-21;195561;401873;1032;1;1;32903966;16728550;72702;15;5
FR;0;2021-06-22;222998;467401;1260;10;2;33126964;17195951;73962;25;7
FR;0;2021-06-23;233863;439905;1195;1;1;33360827;17635856;75157;26;8
FR;0;2021-06-24;241723;409575;1348;0;0;33602550;18045431;76505;26;8
FR;0;2021-06-25;227460;522216;1398;0;0;33830010;18567647;77903;26;8
FR;0;2021-06-26;153191;370694;585;1;0;33983201;18938341;78488;27;8
FR;0;2021-06-27;55861;156222;168;1;0;34039062;19094563;78656;28;8
FR;0;2021-06-28;154610;452889;1167;0;0;34193672;19547452;79823;28;8
FR;0;2021-06-29;182537;506773;2124;0;0;34376209;20054225;81947;28;8
FR;0;2021-06-30;203832;482351;2009;21;2;34580041;20536576;83956;49;10
FR;0;2021-07-01;231094;457818;2221;5;1;34811135;20994394;86177;54;11
FR;0;2021-07-02;228290;520212;2119;5;3;35039425;21514606;88296;59;14
FR;0;2021-07-03;141928;368739;909;3;1;35181353;21883345;89205;62;15
FR;0;2021-07-04;56689;141265;265;0;0;35238042;22024610;89470;62;15
FR;0;2021-07-05;168202;419320;1668;8;2;35406244;22443930;91138;70;17
FR;0;2021-07-06;196542;474803;1828;45;8;35602786;22918733;92966;115;25
FR;0;2021-07-07;212917;439309;1876;24;5;35815703;23358042;94842;139;30
FR;0;2021-07-08;231433;424169;2088;20;7;36047136;23782211;96930;159;37
FR;0;2021-07-09;228338;510683;2182;4;2;36275474;24292894;99112;163;39
FR;0;2021-07-10;148531;339864;982;1;1;36424005;24632758;100094;164;40
FR;0;2021-07-11;60140;110141;282;0;0;36484145;24742899;100376;164;40
FR;0;2021-07-12;168951;478213;1756;4;0;36653096;25221112;102132;168;40
FR;0;2021-07-13;287045;527443;2045;8;2;36940141;25748555;104177;176;42
FR;0;2021-07-14;180875;157743;433;0;0;37121016;25906298;104610;176;42
FR;0;2021-07-15;346852;502478;2097;1;0;37467868;26408776;106707;177;42
FR;0;2021-07-16;379898;495975;2021;3;1;37847766;26904751;108728;180;43
FR;0;2021-07-17;259648;319818;876;1;0;38107414;27224569;109604;181;43
FR;0;2021-07-18;109663;114800;310;0;0;38217077;27339369;109914;181;43
FR;0;2021-07-19;285308;425103;1627;3;0;38502385;27764472;111541;184;43
FR;0;2021-07-20;376712;452479;1721;0;0;38879097;28216951;113262;184;43
FR;0;2021-07-21;395620;407940;1549;4;2;39274717;28624891;114811;188;45
FR;0;2021-07-22;440873;388161;1713;4;2;39715590;29013052;116524;192;47
FR;0;2021-07-23;439809;423204;1880;4;2;40155399;29436256;118404;196;49
FR;0;2021-07-24;285177;269615;803;1;0;40440576;29705871;119207;197;49
FR;0;2021-07-25;121051;80062;226;0;0;40561627;29785933;119433;197;49
FR;0;2021-07-26;347248;323238;1614;3;2;40908875;30109171;121047;200;51
FR;0;2021-07-27;463878;320331;1696;4;2;41372753;30429502;122743;204;53
FR;0;2021-07-28;459288;290033;1634;4;2;41832041;30719535;124377;208;55
FR;0;2021-07-29;489676;276937;1794;2;1;42321717;30996472;126171;210;56
FR;0;2021-07-30;461624;302905;1935;5;2;42783341;31299377;128106;215;58
FR;0;2021-07-31;285338;185067;914;1;0;43068679;31484444;129020;216;58
FR;0;2021-08-01;111933;50011;252;0;0;43180612;31534455;129272;216;58
FR;0;2021-08-02;341202;234607;1598;2;0;43521814;31769062;130870;218;58
FR;0;2021-08-03;398387;245132;1716;2;1;43920201;32014194;132586;220;59
FR;0;2021-08-04;384611;210132;1590;6;3;44304812;32224326;134176;226;62
FR;0;2021-08-05;365972;228920;1709;0;0;44670784;32453246;135885;226;62
FR;0;2021-08-06;359542;271741;1833;4;1;45030326;32724987;137718;230;63
FR;0;2021-08-07;213032;178380;755;4;3;45243358;32903367;138473;234;66
FR;0;2021-08-08;74128;63246;270;0;0;45317486;32966613;138743;234;66
FR;0;2021-08-09;258569;259564;1540;4;3;45576055;33226177;140283;238;69
FR;0;2021-08-10;306587;278058;1655;2;1;45882642;33504235;141938;240;70
FR;0;2021-08-11;279514;260308;1440;5;1;46162156;33764543;143378;245;71
FR;0;2021-08-12;271363;278618;1659;3;1;46433519;34043161;145037;248;72
FR;0;2021-08-13;252028;277881;1589;3;2;46685547;34321042;146626;251;74
FR;0;2021-08-14;145272;197354;739;0;0;46830819;34518396;147365;251;74
FR;0;2021-08-15;39298;50108;215;1;0;46870117;34568504;147580;252;74
FR;0;2021-08-16;186033;318164;1539;0;0;47056150;34886668;149119;252;74
FR;0;2021-08-17;215551;336609;1633;7;1;47271701;35223277;150752;259;75
FR;0;2021-08-18;198915;324776;1594;7;4;47470616;35548053;152346;266;79
FR;0;2021-08-19;191875;325748;1633;1;0;47662491;35873801;153979;267;79
FR;0;2021-08-20;186335;366323;1810;3;2;47848826;36240124;155789;270;81
FR;0;2021-08-21;104746;238167;703;0;0;47953572;36478291;156492;270;81
FR;0;2021-08-22;31885;87200;253;1;1;47985457;36565491;156745;271;82
FR;0;2021-08-23;140882;357274;1558;3;2;48126339;36922765;158303;274;84
FR;0;2021-08-24;162398;376922;1844;5;1;48288737;37299687;160147;279;85
FR;0;2021-08-25;151057;350883;2028;8;3;48439794;37650570;162175;287;88
FR;0;2021-08-26;142731;342882;2553;10;1;48582525;37993452;164728;297;89
FR;0;2021-08-27;148359;388101;2789;10;3;48730884;38381553;167517;307;92
FR;0;2021-08-28;90599;249558;1405;0;0;48821483;38631111;168922;307;92
FR;0;2021-08-29;27304;83331;516;1;0;48848787;38714442;169438;308;92
FR;0;2021-08-30;117321;324905;4706;6;6026;48966108;39039347;174144;314;6118
FR;0;2021-08-31;128713;334676;10176;19;11883;49094821;39374023;184320;333;18001
FR;0;2021-09-01;135727;285693;22414;7;24305;49230548;39659716;206734;340;42306
FR;0;2021-09-02;112577;247281;26507;13;28849;49343125;39906997;233241;353;71155
FR;0;2021-09-03;118164;292725;29951;23;32962;49461289;40199722;263192;376;104117
FR;0;2021-09-04;89793;217729;12583;12;14069;49551082;40417451;275775;388;118186
FR;0;2021-09-05;21334;44868;4391;2;4730;49572416;40462319;280166;390;122916
FR;0;2021-09-06;75315;180824;31944;16;34240;49647731;40643143;312110;406;157156
FR;0;2021-09-07;80045;181258;33234;40;36091;49727776;40824401;345344;446;193247
FR;0;2021-09-08;89656;206209;29653;27;32455;49817432;41030610;374997;473;225702
FR;0;2021-09-09;76634;165401;33040;26;36520;49894066;41196011;408037;499;262222
FR;0;2021-09-10;95564;203698;35713;26;40504;49989630;41399709;443750;525;302726
FR;0;2021-09-11;66726;169220;12134;19;14306;50056356;41568929;455884;544;317032
FR;0;2021-09-12;12791;32079;2766;1;3160;50069147;41601008;458650;545;320192
FR;0;2021-09-13;64365;126390;41202;32;44042;50133512;41727398;499852;577;364234
FR;0;2021-09-14;73295;129121;56343;78;62012;50206807;41856519;556195;655;426246
FR;0;2021-09-15;76399;167866;55626;58;54772;50283206;42024385;611821;713;481018
FR;0;2021-09-16;63751;114542;60026;85;60012;50346957;42138927;671847;798;541030
FR;0;2021-09-17;74960;156840;53821;70;57221;50421917;42295767;725668;868;598251
FR;0;2021-09-18;48185;139594;15594;25;17282;50470102;42435361;741262;893;615533
FR;0;2021-09-19;7863;23718;2434;1;2621;50477965;42459079;743696;894;618154
FR;0;2021-09-20;44435;93933;50020;73;50249;50522400;42553012;793716;967;668403
FR;0;2021-09-21;45802;98455;62724;76;63356;50568202;42651467;856440;1043;731759
FR;0;2021-09-22;48580;142300;55331;83;55342;50616782;42793767;911771;1126;787101
FR;0;2021-09-23;43154;91992;62349;94;63465;50659936;42885759;974120;1220;850566
FR;0;2021-09-24;52195;133241;54523;110;59084;50712131;43019000;1028643;1330;909650
FR;0;2021-09-25;35192;115496;16263;37;18251;50747323;43134496;1044906;1367;927901
FR;0;2021-09-26;5524;17817;2265;5;2330;50752847;43152313;1047171;1372;930231
FR;0;2021-09-27;33917;76984;47170;97;48121;50786764;43229297;1094341;1469;978352
FR;0;2021-09-28;36444;75259;54928;88;56456;50823208;43304556;1149269;1557;1034808
FR;0;2021-09-29;44311;100845;53320;112;54803;50867519;43405401;1202589;1669;1089611
FR;0;2021-09-30;36265;72775;57000;95;59467;50903784;43478176;1259589;1764;1149078
FR;0;2021-10-01;61505;100829;57771;108;63677;50965289;43579005;1317360;1872;1212755
FR;0;2021-10-02;39412;78329;20949;38;23318;51004701;43657334;1338309;1910;1236073
FR;0;2021-10-03;5261;10540;2523;4;2539;51009962;43667874;1340832;1914;1238612
FR;0;2021-10-04;34933;58511;52609;84;54772;51044895;43726385;1393441;1998;1293384
FR;0;2021-10-05;33538;64343;60958;135;64908;51078433;43790728;1454399;2133;1358292
FR;0;2021-10-06;42404;79215;65686;113;68206;51120837;43869943;1520085;2246;1426498
FR;0;2021-10-07;30388;62124;65374;91;68654;51151225;43932067;1585459;2337;1495152
FR;0;2021-10-08;48726;91800;77713;110;84608;51199951;44023867;1663172;2447;1579760
FR;0;2021-10-09;33620;60865;31521;36;33852;51233571;44084732;1694693;2483;1613612
FR;0;2021-10-10;4586;7431;3186;9;3483;51238157;44092163;1697879;2492;1617095
FR;0;2021-10-11;30548;49905;61017;105;64021;51268705;44142068;1758896;2597;1681116
FR;0;2021-10-12;31320;54460;70560;139;75823;51300025;44196528;1829456;2736;1756939
FR;0;2021-10-13;39975;62782;74394;135;79240;51340000;44259310;1903850;2871;1836179
FR;0;2021-10-14;30219;52864;68719;116;73754;51370219;44312174;1972569;2987;1909933
FR;0;2021-10-15;44729;75235;93206;191;102886;51414948;44387409;2065775;3178;2012819
FR;0;2021-10-16;31269;44079;36681;44;39606;51446217;44431488;2102456;3222;2052425
FR;0;2021-10-17;3826;5278;3590;2;3691;51450043;44436766;2106046;3224;2056116
FR;0;2021-10-18;28247;42474;67467;133;71333;51478290;44479240;2173513;3357;2127449
FR;0;2021-10-19;27039;44401;76374;141;81600;51505329;44523641;2249887;3498;2209049
FR;0;2021-10-20;35197;52436;96901;180;101452;51540526;44576077;2346788;3678;2310501
FR;0;2021-10-21;25919;45196;83912;112;89099;51566445;44621273;2430700;3790;2399600
FR;0;2021-10-22;38184;62350;104861;199;112474;51604629;44683623;2535561;3989;2512074
FR;0;2021-10-23;26960;41223;45433;57;48594;51631589;44724846;2580994;4046;2560668
FR;0;2021-10-24;2912;4803;3679;6;3937;51634501;44729649;2584673;4052;2564605
FR;0;2021-10-25;25972;36341;82298;144;86594;51660473;44765990;2666971;4196;2651199
FR;0;2021-10-26;23680;35071;87202;166;92303;51684153;44801061;2754173;4362;2743502
FR;0;2021-10-27;30003;46407;108957;257;114603;51714156;44847468;2863130;4619;2858105
FR;0;2021-10-28;23373;34878;88654;153;94361;51737529;44882346;2951784;4772;2952466
FR;0;2021-10-29;31498;51340;117277;204;125236;51769027;44933686;3069061;4976;3077702
FR;0;2021-10-30;20520;33100;50322;77;53352;51789547;44966786;3119383;5053;3131054
FR;0;2021-10-31;2477;3763;3584;3;3867;51792024;44970549;3122967;5056;3134921
FR;0;2021-11-01;8190;4804;3198;3;3551;51800214;44975353;3126165;5059;3138472
FR;0;2021-11-02;25263;40083;93525;157;99459;51825477;45015436;3219690;5216;3237931
FR;0;2021-11-03;29743;47897;118835;218;125770;51855220;45063333;3338525;5434;3363701
FR;0;2021-11-04;23658;37493;107491;217;114312;51878878;45100826;3446016;5651;3478013
FR;0;2021-11-05;32262;52911;141582;233;151246;51911140;45153737;3587598;5884;3629259
FR;0;2021-11-06;21477;34566;64838;123;68220;51932617;45188303;3652436;6007;3697479
FR;0;2021-11-07;2377;4243;5171;6;5583;51934994;45192546;3657607;6013;3703062
FR;0;2021-11-08;20393;37831;127105;227;134150;51955387;45230377;3784712;6240;3837212
FR;0;2021-11-09;22120;44816;161607;341;172097;51977507;45275193;3946319;6581;4009309
FR;0;2021-11-10;31350;55058;186923;446;198663;52008857;45330251;4133242;7027;4207972
FR;0;2021-11-11;4291;6727;12922;28;13924;52013148;45336978;4146164;7055;4221896
FR;0;2021-11-12;28982;55160;183706;251;197253;52042130;45392138;4329870;7306;4419149
FR;0;2021-11-13;20288;32724;80673;118;86288;52062418;45424862;4410543;7424;4505437
FR;0;2021-11-14;2323;3948;7162;6;7877;52064741;45428810;4417705;7430;4513314
FR;0;2021-11-15;20285;38805;160773;312;171437;52085026;45467615;4578478;7742;4684751
FR;0;2021-11-16;23326;44045;200302;390;214860;52108352;45511660;4778780;8132;4899611
FR;0;2021-11-17;30337;50498;199771;407;212775;52138689;45562158;4978551;8539;5112386
FR;0;2021-11-18;23340;44932;191568;468;205388;52162029;45607090;5170119;9007;5317774
FR;0;2021-11-19;33550;61425;243119;548;262060;52195579;45668515;5413238;9555;5579834
FR;0;2021-11-20;25313;36772;102110;206;109656;52220892;45705287;5515348;9761;5689490
FR;0;2021-11-21;2622;4567;9640;18;10643;52223514;45709854;5524988;9779;5700133
FR;0;2021-11-22;22731;33341;180270;470;194737;52246245;45743195;5705258;10249;5894870
FR;0;2021-11-23;25544;45725;229289;547;247701;52271789;45788920;5934547;10796;6142571
FR;0;2021-11-24;31760;53798;224728;717;243107;52303549;45842718;6159275;11513;6385678
FR;0;2021-11-25;25381;49159;255807;740;277583;52328930;45891877;6415082;12253;6663261
FR;0;2021-11-26;33201;74737;379359;863;414491;52362131;45966614;6794441;13116;7077752
FR;0;2021-11-27;23292;49685;214835;389;236547;52385423;46016299;7009276;13505;7314299
FR;0;2021-11-28;3478;10592;56722;66;63329;52388901;46026891;7065998;13571;7377628
FR;0;2021-11-29;19384;54256;341366;863;371537;52408285;46081147;7407364;14434;7749165
FR;0;2021-11-30;24675;72190;457278;984;500626;52432960;46153337;7864642;15418;8249791
FR;0;2021-12-01;26825;75981;468966;1159;511170;52459785;46229318;8333608;16577;8760961
FR;0;2021-12-02;21966;71791;526974;1279;574686;52481751;46301109;8860582;17856;9335647
FR;0;2021-12-03;25459;92526;596231;1419;650957;52507210;46393635;9456813;19275;9986604
FR;0;2021-12-04;18285;60548;336151;690;369685;52525495;46454183;9792964;19965;10356289
FR;0;2021-12-05;4141;16268;95753;157;107048;52529636;46470451;9888717;20122;10463337
FR;0;2021-12-06;22523;73233;493009;1174;539812;52552159;46543684;10381726;21296;11003149
FR;0;2021-12-07;23303;91791;645231;1769;706135;52575462;46635475;11026957;23065;11709284
FR;0;2021-12-08;25325;92408;591416;1873;647307;52600787;46727883;11618373;24938;12356591
FR;0;2021-12-09;23990;94353;662915;2179;726167;52624777;46822236;12281288;27117;13082758
FR;0;2021-12-10;27638;111129;735909;2074;805973;52652415;46933365;13017197;29191;13888731
FR;0;2021-12-11;20219;76063;435107;986;480316;52672634;47009428;13452304;30177;14369047
FR;0;2021-12-12;5624;23286;142262;262;159225;52678258;47032714;13594566;30439;14528272
FR;0;2021-12-13;21047;91315;587503;1698;649185;52699305;47124029;14182069;32137;15177457
FR;0;2021-12-14;27537;118665;765351;2648;847349;52726842;47242694;14947420;34785;16024806
FR;0;2021-12-15;28181;114547;694158;2262;768901;52755023;47357241;15641578;37047;16793707
FR;0;2021-12-16;27926;116095;763848;2555;844256;52782949;47473336;16405426;39602;17637963
FR;0;2021-12-17;31534;128828;807709;2707;891979;52814483;47602164;17213135;42309;18529942
FR;0;2021-12-18;24913;81728;469898;1178;522139;52839396;47683892;17683033;43487;19052081
FR;0;2021-12-19;8740;28851;169347;378;191144;52848136;47712743;17852380;43865;19243225
FR;0;2021-12-20;31584;97549;591308;1787;658580;52879720;47810292;18443688;45652;19901805
FR;0;2021-12-21;39212;112386;682280;2391;759447;52918932;47922678;19125968;48043;20661252
FR;0;2021-12-22;39456;99672;575632;2167;642023;52958388;48022350;19701600;50210;21303275
FR;0;2021-12-23;33737;79767;440876;1654;494320;52992125;48102117;20142476;51864;21797595
FR;0;2021-12-24;10663;26053;110969;396;126628;53002788;48128170;20253445;52260;21924223
FR;0;2021-12-25;767;3499;7570;25;9028;53003555;48131669;20261015;52285;21933251
FR;0;2021-12-26;4696;11917;52072;141;60130;53008251;48143586;20313087;52426;21993381
FR;0;2021-12-27;30347;84119;453433;1366;509081;53038598;48227705;20766520;53792;22502462
FR;0;2021-12-28;38304;99066;564059;1767;632145;53076902;48326771;21330579;55559;23134607
FR;0;2021-12-29;39840;88474;501102;1686;560919;53116742;48415245;21831681;57245;23695526
FR;0;2021-12-30;35885;75053;420942;1519;471082;53152627;48490298;22252623;58764;24166608
FR;0;2021-12-31;12032;25209;116833;406;131620;53164659;48515507;22369456;59170;24298228
FR;0;2022-01-01;1310;3201;8496;36;9926;53165969;48518708;22377952;59206;24308154
FR;0;2022-01-02;6074;13009;58389;125;66930;53172043;48531717;22436341;59331;24375084
FR;0;2022-01-03;32562;89834;494671;1593;551467;53204605;48621551;22931012;60924;24926551
FR;0;2022-01-04;40836;110878;641256;2302;714199;53245441;48732429;23572268;63226;25640750
FR;0;2022-01-05;60299;103295;569034;1984;634049;53305740;48835724;24141302;65210;26274799
FR;0;2022-01-06;43917;110166;638870;2693;711308;53349657;48945890;24780172;67903;26986107
FR;0;2022-01-07;50542;123079;710895;2806;790319;53400199;49068969;25491067;70709;27776426
FR;0;2022-01-08;44950;80325;423770;1210;472837;53445149;49149294;25914837;71919;28249263
FR;0;2022-01-09;15597;26715;128542;300;145699;53460746;49176009;26043379;72219;28394962
FR;0;2022-01-10;34980;88161;469180;1810;522147;53495726;49264170;26512559;74029;28917109
FR;0;2022-01-11;41635;100105;548125;2307;608383;53537361;49364275;27060684;76336;29525492
FR;0;2022-01-12;60129;95524;452549;1964;504229;53597490;49459799;27513233;78300;30029721
FR;0;2022-01-13;37887;92295;487225;2084;540919;53635377;49552094;28000458;80384;30570640
FR;0;2022-01-14;42373;103266;568480;2285;628950;53677750;49655360;28568938;82669;31199590
FR;0;2022-01-15;39300;65813;340077;981;377533;53717050;49721173;28909015;83650;31577123
FR;0;2022-01-16;11381;19303;87380;215;99448;53728431;49740476;28996395;83865;31676571
FR;0;2022-01-17;24591;60095;320200;1380;354136;53753022;49800571;29316595;85245;32030707
FR;0;2022-01-18;28101;68486;360995;1799;397501;53781123;49869057;29677590;87044;32428208
FR;0;2022-01-19;43033;67050;281200;1448;311039;53824156;49936107;29958790;88492;32739247
FR;0;2022-01-20;23403;59424;298889;1740;328398;53847559;49995531;30257679;90232;33067645
FR;0;2022-01-21;27984;68764;366271;2084;401114;53875543;50064295;30623950;92316;33468759
FR;0;2022-01-22;27605;47853;218754;838;241742;53903148;50112148;30842704;93154;33710501
FR;0;2022-01-23;6701;13044;48644;171;55182;53909849;50125192;30891348;93325;33765683
FR;0;2022-01-24;16193;47162;217240;1136;239314;53926042;50172354;31108588;94461;34004997
FR;0;2022-01-25;18897;54154;242970;1547;267026;53944939;50226508;31351558;96008;34272023
FR;0;2022-01-26;28103;60134;209207;1296;229338;53973042;50286642;31560765;97304;34501361
FR;0;2022-01-27;16271;45870;207561;1270;225803;53989313;50332512;31768326;98574;34727164
FR;0;2022-01-28;21497;75723;289972;1573;321455;54010810;50408235;32058298;100147;35048619
FR;0;2022-01-29;18401;52836;184079;686;204566;54029211;50461071;32242377;100833;35253185
FR;0;2022-01-30;4466;14554;39125;124;45092;54033677;50475625;32281502;100957;35298277
FR;0;2022-01-31;11219;43835;148143;738;164781;54044896;50519460;32429645;101695;35463058
FR;0;2022-02-01;12794;48125;174052;1140;191355;54057690;50567585;32603697;102835;35654413
FR;0;2022-02-02;19971;65875;171449;1033;190117;54077661;50633460;32775146;103868;35844530
FR;0;2022-02-03;10937;44127;157482;984;173293;54088598;50677587;32932628;104852;36017823
FR;0;2022-02-04;14474;66428;239168;1262;264164;54103072;50744015;33171796;106114;36281987
FR;0;2022-02-05;12781;51449;153506;522;172331;54115853;50795464;33325302;106636;36454318
FR;0;2022-02-06;2706;12247;28869;99;33828;54118559;50807711;33354171;106735;36488146
FR;0;2022-02-07;9280;46649;156809;585;176314;54127839;50854360;33510980;107320;36664460
FR;0;2022-02-08;9587;42642;166551;867;184318;54137426;50897002;33677531;108187;36848778
FR;0;2022-02-09;14148;57776;172282;864;192950;54151574;50954778;33849813;109051;37041728
FR;0;2022-02-10;8259;38314;150144;876;166568;54159833;50993092;33999957;109927;37208296
FR;0;2022-02-11;10741;55427;218430;1097;242996;54170574;51048519;34218387;111024;37451292
FR;0;2022-02-12;8344;40870;134690;461;151703;54178918;51089389;34353077;111485;37602995
FR;0;2022-02-13;1892;8574;26547;82;30902;54180810;51097963;34379624;111567;37633897
FR;0;2022-02-14;6887;35088;148309;477;166300;54187697;51133051;34527933;112044;37800197
FR;0;2022-02-15;6848;35416;146892;750;162428;54194545;51168467;34674825;112794;37962625
FR;0;2022-02-16;9282;42554;132467;716;146642;54203827;51211021;34807292;113510;38109267
FR;0;2022-02-17;5364;23675;87241;584;94753;54209191;51234696;34894533;114094;38204020
FR;0;2022-02-18;6874;33215;119586;802;129235;54216065;51267911;35014119;114896;38333255
FR;0;2022-02-19;5340;24439;70002;370;77300;54221405;51292350;35084121;115266;38410555
FR;0;2022-02-20;1135;4616;12151;38;13923;54222540;51296966;35096272;115304;38424478
FR;0;2022-02-21;4018;17754;61911;351;67134;54226558;51314720;35158183;115655;38491612
FR;0;2022-02-22;4365;18463;60780;575;64404;54230923;51333183;35218963;116230;38556016
FR;0;2022-02-23;6507;27122;66456;591;71852;54237430;51360305;35285419;116821;38627868
FR;0;2022-02-24;3743;15137;50365;518;53172;54241173;51375442;35335784;117339;38681040
FR;0;2022-02-25;5194;23533;76271;803;79994;54246367;51398975;35412055;118142;38761034
FR;0;2022-02-26;3969;17638;47386;357;51450;54250336;51416613;35459441;118499;38812484
FR;0;2022-02-27;867;2984;8020;47;8931;54251203;51419597;35467461;118546;38821415
FR;0;2022-02-28;3066;12115;40438;353;42869;54254269;51431712;35507899;118899;38864284
FR;0;2022-03-01;3120;12202;44121;433;44757;54257389;51443914;35552020;119332;38909041
FR;0;2022-03-02;5067;17438;47079;436;48983;54262456;51461352;35599099;119768;38958024
FR;0;2022-03-03;2644;8864;29825;361;29918;54265100;51470216;35628924;120129;38987942
FR;0;2022-03-04;3175;12161;40251;649;39382;54268275;51482377;35669175;120778;39027324
FR;0;2022-03-05;2915;9207;24921;309;25071;54271190;51491584;35694096;121087;39052395
FR;0;2022-03-06;508;1377;3192;42;3429;54271698;51492961;35697288;121129;39055824
FR;0;2022-03-07;1932;5457;18391;313;17648;54273630;51498418;35715679;121442;39073472
FR;0;2022-03-08;1962;5876;19398;359;17856;54275592;51504294;35735077;121801;39091328
FR;0;2022-03-09;3445;10248;22141;403;21220;54279037;51514542;35757218;122204;39112548
FR;0;2022-03-10;1706;5159;16882;339;15672;54280743;51519701;35774100;122543;39128220
FR;0;2022-03-11;2340;7283;24459;538;22217;54283083;51526984;35798559;123081;39150437
FR;0;2022-03-12;2654;6709;17148;304;16497;54285737;51533693;35815707;123385;39166934
FR;0;2022-03-13;385;778;2303;144;2252;54286122;51534471;35818010;123529;39169186
FR;0;2022-03-14;1457;4120;14926;4403;13782;54287579;51538591;35832936;127932;39182968
FR;0;2022-03-15;1591;4346;16226;7549;14329;54289170;51542937;35849162;135481;39197297
FR;0;2022-03-16;2939;7017;19341;13128;17999;54292109;51549954;35868503;148609;39215296
FR;0;2022-03-17;1367;3683;13088;10835;11928;54293476;51553637;35881591;159444;39227224
FR;0;2022-03-18;2195;5497;19930;18273;18014;54295671;51559134;35901521;177717;39245238
FR;0;2022-03-19;2274;4666;13101;9395;12399;54297945;51563800;35914622;187112;39257637
FR;0;2022-03-20;291;705;1906;1065;1914;54298236;51564505;35916528;188177;39259551
FR;0;2022-03-21;1337;3119;12682;14927;11902;54299573;51567624;35929210;203104;39271453
FR;0;2022-03-22;1455;3565;13750;20516;12505;54301028;51571189;35942960;223620;39283958
FR;0;2022-03-23;2631;6060;17628;23129;17134;54303659;51577249;35960588;246749;39301092
FR;0;2022-03-24;1352;2907;11538;17569;10609;54305011;51580156;35972126;264318;39311701
FR;0;2022-03-25;2039;4796;18462;27736;16805;54307050;51584952;35990588;292054;39328506
FR;0;2022-03-26;2214;4233;12055;12651;11494;54309264;51589185;36002643;304705;39340000
FR;0;2022-03-27;352;680;1873;1474;1907;54309616;51589865;36004516;306179;39341907
FR;0;2022-03-28;1409;2912;11045;17450;10532;54311025;51592777;36015561;323629;39352439
FR;0;2022-03-29;1419;3221;12845;27528;11989;54312444;51595998;36028406;351157;39364428
FR;0;2022-03-30;2805;5356;15590;27343;14981;54315249;51601354;36043996;378500;39379409
FR;0;2022-03-31;1584;3128;12803;24856;12133;54316833;51604482;36056799;403356;39391542
FR;0;2022-04-01;2070;4265;19967;30799;18584;54318903;51608747;36076766;434155;39410126
FR;0;2022-04-02;1489;2603;9015;10096;8673;54320392;51611350;36085781;444251;39418799
FR;0;2022-04-03;270;495;1555;1168;1570;54320662;51611845;36087336;445419;39420369
FR;0;2022-04-04;1307;2509;12096;19029;11278;54321969;51614354;36099432;464448;39431647
FR;0;2022-04-05;1578;2903;14212;33965;13057;54323547;51617257;36113644;498413;39444704
FR;0;2022-04-06;2020;3604;13391;26275;12627;54325567;51620861;36127035;524688;39457331
FR;0;2022-04-07;1415;2835;13566;33509;12764;54326982;51623696;36140601;558197;39470095
FR;0;2022-04-08;2004;4056;19093;43540;17706;54328986;51627752;36159694;601737;39487801
FR;0;2022-04-09;1340;2647;9281;13533;8831;54330326;51630399;36168975;615270;39496632
FR;0;2022-04-10;271;548;1963;1991;1968;54330597;51630947;36170938;617261;39498600
FR;0;2022-04-11;1170;2438;11792;23621;11393;54331767;51633385;36182730;640882;39509993
FR;0;2022-04-12;1555;2759;13860;40454;13224;54333322;51636144;36196590;681336;39523217
FR;0;2022-04-13;1830;3388;13235;32649;12839;54335152;51639532;36209825;713985;39536056
FR;0;2022-04-14;1423;2642;13014;35864;12832;54336575;51642174;36222839;749849;39548888
FR;0;2022-04-15;1755;3259;15444;35138;14691;54338330;51645433;36238283;784987;39563579
FR;0;2022-04-16;1023;1809;6350;8508;6203;54339353;51647242;36244633;793495;39569782
FR;0;2022-04-17;183;315;988;1154;1026;54339536;51647557;36245621;794649;39570808
FR;0;2022-04-18;142;424;2716;1033;2733;54339678;51647981;36248337;795682;39573541
FR;0;2022-04-19;1458;2884;12801;29210;12263;54341136;51650865;36261138;824892;39585804
FR;0;2022-04-20;1877;3312;13101;28601;12765;54343013;51654177;36274239;853493;39598569
FR;0;2022-04-21;1463;2702;12368;34561;12399;54344476;51656879;36286607;888054;39610968
FR;0;2022-04-22;1805;3450;16355;37295;15712;54346281;51660329;36302962;925349;39626680
FR;0;2022-04-23;1102;2026;7342;10622;7190;54347383;51662355;36310304;935971;39633870
FR;0;2022-04-24;232;438;1461;1571;1396;54347615;51662793;36311765;937542;39635266
FR;0;2022-04-25;1233;2410;10563;20777;10370;54348848;51665203;36322328;958319;39645636
FR;0;2022-04-26;1539;2928;13534;38007;12965;54350387;51668131;36335862;996326;39658601
FR;0;2022-04-27;1876;2994;11390;30318;11419;54352263;51671125;36347252;1026644;39670020
FR;0;2022-04-28;1505;2612;12347;35561;12068;54353768;51673737;36359599;1062205;39682088
FR;0;2022-04-29;1926;3392;15303;36704;14644;54355694;51677129;36374902;1098909;39696732
FR;0;2022-04-30;1171;1786;6739;9610;6555;54356865;51678915;36381641;1108519;39703287
FR;0;2022-05-01;166;289;858;951;857;54357031;51679204;36382499;1109470;39704144
FR;0;2022-05-02;1118;2041;10246;17679;10041;54358149;51681245;36392745;1127149;39714185
FR;0;2022-05-03;1696;2835;13006;33929;12866;54359845;51684080;36405751;1161078;39727051
FR;0;2022-05-04;1775;2862;10944;24975;11042;54361620;51686942;36416695;1186053;39738093
FR;0;2022-05-05;1573;2561;11679;32610;11389;54363193;51689503;36428374;1218663;39749482
FR;0;2022-05-06;2011;3440;14657;36277;14149;54365204;51692943;36443031;1254940;39763631
FR;0;2022-05-07;1151;1716;6102;9532;6099;54366355;51694659;36449133;1264472;39769730
FR;0;2022-05-08;247;354;1023;1512;1082;54366602;51695013;36450156;1265984;39770812
FR;0;2022-05-09;1200;2016;8619;19686;8487;54367802;51697029;36458775;1285670;39779299
FR;0;2022-05-10;1589;2746;12059;37856;11695;54369391;51699775;36470834;1323526;39790994
FR;0;2022-05-11;1886;2608;9777;27039;9677;54371277;51702383;36480611;1350565;39800671
FR;0;2022-05-12;1476;2409;10607;34567;10207;54372753;51704792;36491218;1385132;39810878
FR;0;2022-05-13;1878;2981;12816;36796;12415;54374631;51707773;36504034;1421928;39823293
FR;0;2022-05-14;1101;1530;5392;10575;5256;54375732;51709303;36509426;1432503;39828549
FR;0;2022-05-15;254;380;1094;1389;1184;54375986;51709683;36510520;1433892;39829733
FR;0;2022-05-16;1098;1764;7156;19981;7150;54377084;51711447;36517676;1453873;39836883
FR;0;2022-05-17;1475;2353;10233;36078;9874;54378559;51713800;36527909;1489951;39846757
FR;0;2022-05-18;1662;2343;8251;25431;8180;54380221;51716143;36536160;1515382;39854937
FR;0;2022-05-19;1280;2255;8917;32172;8817;54381501;51718398;36545077;1547554;39863754
