fra;vaccin;jour;n_dose1;n_dose2;n_dose3;n_dose4;n_complet;n_rappel;n_2_rappel;n_rappel_biv;n_3_rappel;n_cum_dose1;n_cum_dose2;n_cum_dose3;n_cum_dose4;n_cum_complet;n_cum_rappel;n_cum_2_rappel;n_cum_rappel_biv;n_cum_3_rappel
FR;1;2020-12-27;616;0;0;0;55;0;0;0;0;616;0;0;0;55;0;0;0;0
FR;1;2020-12-28;710;1;0;0;44;0;0;0;0;1326;1;0;0;99;0;0;0;0
FR;1;2020-12-29;389;0;0;0;19;0;0;0;0;1715;1;0;0;118;0;0;0;0
FR;1;2020-12-30;456;0;0;0;20;0;0;0;0;2171;1;0;0;138;0;0;0;0
FR;1;2020-12-31;451;1;0;0;21;0;0;0;0;2622;2;0;0;159;0;0;0;0
FR;1;2021-01-01;1199;2;0;0;66;0;0;0;0;3821;4;0;0;225;0;0;0;0
FR;1;2021-01-02;370;4;0;0;29;0;0;0;0;4191;8;0;0;254;0;0;0;0
FR;1;2021-01-03;419;0;0;0;23;0;0;0;0;4610;8;0;0;277;0;0;0;0
FR;1;2021-01-04;2152;5;0;0;51;0;0;0;0;6762;13;0;0;328;0;0;0;0
FR;1;2021-01-05;7794;6;0;0;128;0;0;0;0;14556;19;0;0;456;0;0;0;0
FR;1;2021-01-06;12491;23;0;0;128;0;0;0;0;27047;42;0;0;584;0;0;0;0
FR;1;2021-01-07;29481;24;0;0;159;0;0;0;0;56528;66;0;0;743;0;0;0;0
FR;1;2021-01-08;37170;36;0;0;205;0;0;0;0;93698;102;0;0;948;0;0;0;0
FR;1;2021-01-09;11221;9;0;0;77;0;0;0;0;104919;111;0;0;1025;0;0;0;0
FR;1;2021-01-10;6017;8;0;0;28;0;0;0;0;110936;119;0;0;1053;0;0;0;0
FR;1;2021-01-11;39956;39;0;0;232;0;0;0;0;150892;158;0;0;1285;0;0;0;0
FR;1;2021-01-12;62166;31;0;0;296;0;0;0;0;213058;189;0;0;1581;0;0;0;0
FR;1;2021-01-13;65150;62;0;0;433;0;0;0;0;278208;251;0;0;2014;0;0;0;0
FR;1;2021-01-14;81473;263;0;0;953;0;0;0;0;359681;514;0;0;2967;0;0;0;0
FR;1;2021-01-15;68641;103;1;0;527;0;0;0;0;428322;617;1;0;3494;0;0;0;0
FR;1;2021-01-16;19903;73;0;0;171;0;0;0;0;448225;690;1;0;3665;0;0;0;0
FR;1;2021-01-17;10909;54;0;0;130;0;0;0;0;459134;744;1;0;3795;0;0;0;0
FR;1;2021-01-18;82849;176;0;0;587;0;0;0;0;541983;920;1;0;4382;0;0;0;0
FR;1;2021-01-19;125934;209;0;0;830;0;0;0;0;667917;1129;1;0;5212;0;0;0;0
FR;1;2021-01-20;132440;191;0;0;779;0;0;0;0;800357;1320;1;0;5991;0;0;0;0
FR;1;2021-01-21;153089;196;0;0;892;0;0;0;0;953446;1516;1;0;6883;0;0;0;0
FR;1;2021-01-22;115972;240;0;0;776;0;0;0;0;1069418;1756;1;0;7659;0;0;0;0
FR;1;2021-01-23;36619;84;0;0;207;0;0;0;0;1106037;1840;1;0;7866;0;0;0;0
FR;1;2021-01-24;9589;129;0;0;188;0;0;0;0;1115626;1969;1;0;8054;0;0;0;0
FR;1;2021-01-25;74443;1454;0;0;1771;0;0;0;0;1190069;3423;1;0;9825;0;0;0;0
FR;1;2021-01-26;96471;3706;1;0;4146;0;0;0;0;1286540;7129;2;0;13971;0;0;0;0
FR;1;2021-01-27;103660;6443;0;0;7126;0;0;0;0;1390200;13572;2;0;21097;0;0;0;0
FR;1;2021-01-28;120627;16418;0;0;17205;0;0;0;0;1510827;29990;2;0;38302;0;0;0;0
FR;1;2021-01-29;88904;18796;0;0;19337;0;0;0;0;1599731;48786;2;0;57639;0;0;0;0
FR;1;2021-01-30;27995;4538;0;0;4662;0;0;0;0;1627726;53324;2;0;62301;0;0;0;0
FR;1;2021-01-31;5194;1898;0;0;1936;0;0;0;0;1632920;55222;2;0;64237;0;0;0;0
FR;1;2021-02-01;49753;23051;0;0;23294;0;0;0;0;1682673;78273;2;0;87531;0;0;0;0
FR;1;2021-02-02;67839;38221;0;0;38679;0;0;0;0;1750512;116494;2;0;126210;0;0;0;0
FR;1;2021-02-03;67106;40294;0;0;40729;0;0;0;0;1817618;156788;2;0;166939;0;0;0;0
FR;1;2021-02-04;77159;55144;0;0;55714;0;0;0;0;1894777;211932;2;0;222653;0;0;0;0
FR;1;2021-02-05;63435;48241;0;0;48646;0;0;0;0;1958212;260173;2;0;271299;0;0;0;0
FR;1;2021-02-06;19428;11421;0;0;11528;0;0;0;0;1977640;271594;2;0;282827;0;0;0;0
FR;1;2021-02-07;3669;6072;0;0;6099;0;0;0;0;1981309;277666;2;0;288926;0;0;0;0
FR;1;2021-02-08;36508;48799;0;0;49053;0;0;0;0;2017817;326465;2;0;337979;0;0;0;0
FR;1;2021-02-09;50830;78458;0;0;78985;0;0;0;0;2068647;404923;2;0;416964;0;0;0;0
FR;1;2021-02-10;52088;83487;0;0;83971;0;0;0;0;2120735;488410;2;0;500935;0;0;0;0
FR;1;2021-02-11;63397;105629;0;0;106539;0;0;0;0;2184132;594039;2;0;607474;0;0;0;0
FR;1;2021-02-12;55889;75808;0;0;76494;0;0;0;0;2240021;669847;2;0;683968;0;0;0;0
FR;1;2021-02-13;15470;19307;0;0;19419;0;0;0;0;2255491;689154;2;0;703387;0;0;0;0
FR;1;2021-02-14;3747;7312;0;0;7378;0;0;0;0;2259238;696466;2;0;710765;0;0;0;0
FR;1;2021-02-15;24175;73669;0;0;73929;0;0;0;0;2283413;770135;2;0;784694;0;0;0;0
FR;1;2021-02-16;32788;95520;0;0;95935;0;0;0;0;2316201;865655;2;0;880629;0;0;0;0
FR;1;2021-02-17;35142;102381;20;0;103040;0;0;0;0;2351343;968036;22;0;983669;0;0;0;0
FR;1;2021-02-18;49466;118603;0;0;119600;0;0;0;0;2400809;1086639;22;0;1103269;0;0;0;0
FR;1;2021-02-19;45400;87836;1;0;88780;0;0;0;0;2446209;1174475;23;0;1192049;0;0;0;0
FR;1;2021-02-20;13398;27024;0;0;27200;0;0;0;0;2459607;1201499;23;0;1219249;0;0;0;0
FR;1;2021-02-21;2471;5942;0;0;6010;0;0;0;0;2462078;1207441;23;0;1225259;0;0;0;0
FR;1;2021-02-22;24726;69386;2;0;69688;0;0;0;0;2486804;1276827;25;0;1294947;0;0;0;0
FR;1;2021-02-23;37441;81548;1;0;82253;0;0;0;0;2524245;1358375;26;0;1377200;0;0;0;0
FR;1;2021-02-24;40717;79378;1;0;80079;0;0;0;0;2564962;1437753;27;0;1457279;0;0;0;0
FR;1;2021-02-25;50177;87705;1;0;88804;0;0;0;0;2615139;1525458;28;0;1546083;0;0;0;0
FR;1;2021-02-26;47235;67556;1;0;68445;0;0;0;0;2662374;1593014;29;0;1614528;0;0;0;0
FR;1;2021-02-27;15691;21359;1;0;21572;0;0;0;0;2678065;1614373;30;0;1636100;0;0;0;0
FR;1;2021-02-28;3566;4092;2;0;4165;0;0;0;0;2681631;1618465;32;0;1640265;0;0;0;0
FR;1;2021-03-01;40232;50295;1;0;51033;0;0;0;0;2721863;1668760;33;0;1691298;0;0;0;0
FR;1;2021-03-02;55997;62428;3;0;63608;0;0;0;0;2777860;1731188;36;0;1754906;0;0;0;0
FR;1;2021-03-03;61273;60508;0;0;61950;0;0;0;0;2839133;1791696;36;0;1816856;0;0;0;0
FR;1;2021-03-04;73023;68408;3;0;70627;0;0;0;0;2912156;1860104;39;0;1887483;0;0;0;0
FR;1;2021-03-05;74787;58604;3;0;60505;0;0;0;0;2986943;1918708;42;0;1947988;0;0;0;0
FR;1;2021-03-06;82477;15730;2;0;17439;0;0;0;0;3069420;1934438;44;0;1965427;0;0;0;0
FR;1;2021-03-07;63734;3913;1;0;5458;0;0;0;0;3133154;1938351;45;0;1970885;0;0;0;0
FR;1;2021-03-08;60200;41127;2;0;42415;0;0;0;0;3193354;1979478;47;0;2013300;0;0;0;0
FR;1;2021-03-09;86016;47364;1;0;49369;0;0;0;0;3279370;2026842;48;0;2062669;0;0;0;0
FR;1;2021-03-10;90951;47750;5;0;50024;0;0;0;0;3370321;2074592;53;0;2112693;0;0;0;0
FR;1;2021-03-11;105108;54606;1;0;57682;0;0;0;0;3475429;2129198;54;0;2170375;0;0;0;0
FR;1;2021-03-12;104169;44879;1;0;47877;0;0;0;0;3579598;2174077;55;0;2218252;0;0;0;0
FR;1;2021-03-13;89226;12579;1;0;14797;0;0;0;0;3668824;2186656;56;0;2233049;0;0;0;0
FR;1;2021-03-14;44463;2646;1;0;3979;0;0;0;0;3713287;2189302;57;0;2237028;0;0;0;0
FR;1;2021-03-15;95539;27932;3;0;30284;0;0;0;0;3808826;2217234;60;0;2267312;0;0;0;0
FR;1;2021-03-16;123608;34031;5;0;37579;0;0;0;0;3932434;2251265;65;0;2304891;0;0;0;0
FR;1;2021-03-17;129327;33513;4;0;37569;0;0;0;0;4061761;2284778;69;0;2342460;0;0;0;0
FR;1;2021-03-18;142921;39150;5;0;43828;0;0;0;0;4204682;2323928;74;0;2386288;0;0;0;0
FR;1;2021-03-19;136282;32011;2;0;36604;0;0;0;0;4340964;2355939;76;0;2422892;0;0;0;0
FR;1;2021-03-20;76028;9746;1;0;11963;0;0;0;0;4416992;2365685;77;0;2434855;0;0;0;0
FR;1;2021-03-21;26523;1968;1;0;2958;0;0;0;0;4443515;2367653;78;0;2437813;0;0;0;0
FR;1;2021-03-22;114783;30209;2;0;34042;0;0;0;0;4558298;2397862;80;0;2471855;0;0;0;0
FR;1;2021-03-23;143065;37990;1;0;42781;0;0;0;0;4701363;2435852;81;0;2514636;0;0;0;0
FR;1;2021-03-24;142031;38398;0;0;43272;0;0;0;0;4843394;2474250;81;0;2557908;0;0;0;0
FR;1;2021-03-25;165045;39884;4;0;46045;0;0;0;0;5008439;2514134;85;0;2603953;0;0;0;0
FR;1;2021-03-26;166426;37408;5;1;44029;0;0;0;0;5174865;2551542;90;1;2647982;0;0;0;0
FR;1;2021-03-27;110909;15482;1;0;19493;0;0;0;0;5285774;2567024;91;1;2667475;0;0;0;0
FR;1;2021-03-28;42317;4432;3;0;5987;0;0;0;0;5328091;2571456;94;1;2673462;0;0;0;0
FR;1;2021-03-29;129853;48963;4;0;53631;0;0;0;0;5457944;2620419;98;1;2727093;0;0;0;0
FR;1;2021-03-30;167768;63835;5;0;70848;0;0;0;0;5625712;2684254;103;1;2797941;0;0;0;0
FR;1;2021-03-31;170974;68019;4;0;75544;0;0;0;0;5796686;2752273;107;1;2873485;0;0;0;0
FR;1;2021-04-01;194890;84131;10;0;93642;0;0;0;0;5991576;2836404;117;1;2967127;0;0;0;0
FR;1;2021-04-02;164477;86902;7;0;94726;0;0;0;0;6156053;2923306;124;1;3061853;0;0;0;0
FR;1;2021-04-03;88262;58223;6;0;61772;0;0;0;0;6244315;2981529;130;1;3123625;0;0;0;0
FR;1;2021-04-04;33666;17734;0;0;19235;0;0;0;0;6277981;2999263;130;1;3142860;0;0;0;0
FR;1;2021-04-05;46433;9565;11;0;11442;0;0;0;0;6324414;3008828;141;1;3154302;0;0;0;0
FR;1;2021-04-06;160354;105686;17;0;112179;0;0;0;0;6484768;3114514;158;1;3266481;0;0;0;0
FR;1;2021-04-07;197044;108101;16;0;116941;0;0;0;0;6681812;3222615;174;1;3383422;0;0;0;0
FR;1;2021-04-08;222196;114359;14;0;125722;0;0;0;0;6904008;3336974;188;1;3509144;0;0;0;0
FR;1;2021-04-09;214625;108035;22;0;118936;0;0;0;0;7118633;3445009;210;1;3628080;0;0;0;0
FR;1;2021-04-10;117212;73246;14;0;78396;0;0;0;0;7235845;3518255;224;1;3706476;0;0;0;0
FR;1;2021-04-11;40903;29892;6;0;31796;0;0;0;0;7276748;3548147;230;1;3738272;0;0;0;0
FR;1;2021-04-12;168509;104586;46;0;111837;0;0;0;0;7445257;3652733;276;1;3850109;0;0;0;0
FR;1;2021-04-13;203857;127755;97;1;137102;0;0;0;0;7649114;3780488;373;2;3987211;0;0;0;0
FR;1;2021-04-14;208691;123037;208;0;133269;0;0;0;0;7857805;3903525;581;2;4120480;0;0;0;0
FR;1;2021-04-15;221751;128254;313;0;139305;0;0;0;0;8079556;4031779;894;2;4259785;0;0;0;0
FR;1;2021-04-16;206110;125773;309;0;135444;0;0;0;0;8285666;4157552;1203;2;4395229;0;0;0;0
FR;1;2021-04-17;122112;67117;103;0;72180;0;0;0;0;8407778;4224669;1306;2;4467409;0;0;0;0
FR;1;2021-04-18;35982;21015;42;0;22723;0;0;0;0;8443760;4245684;1348;2;4490132;0;0;0;0
FR;1;2021-04-19;163784;121618;433;0;129169;0;0;0;0;8607544;4367302;1781;2;4619301;0;0;0;0
FR;1;2021-04-20;189492;149804;531;0;158934;0;0;0;0;8797036;4517106;2312;2;4778235;0;0;0;0
FR;1;2021-04-21;194064;147784;761;0;157313;0;0;0;0;8991100;4664890;3073;2;4935548;0;0;0;0
FR;1;2021-04-22;209088;164625;779;0;175856;0;0;0;0;9200188;4829515;3852;2;5111404;0;0;0;0
FR;1;2021-04-23;198999;158153;671;0;169178;0;0;0;0;9399187;4987668;4523;2;5280582;0;0;0;0
FR;1;2021-04-24;126355;95888;148;0;101958;0;0;0;0;9525542;5083556;4671;2;5382540;0;0;0;0
FR;1;2021-04-25;53642;30080;46;0;32837;0;0;0;0;9579184;5113636;4717;2;5415377;0;0;0;0
FR;1;2021-04-26;181174;140327;543;0;149046;0;0;0;0;9760358;5253963;5260;2;5564423;0;0;0;0
FR;1;2021-04-27;221406;162639;901;0;174014;0;0;0;0;9981764;5416602;6161;2;5738437;0;0;0;0
FR;1;2021-04-28;238374;156220;1314;1;168903;1;0;0;0;10220138;5572822;7475;3;5907340;1;0;0;0
FR;1;2021-04-29;270354;161697;1211;0;177302;0;0;0;0;10490492;5734519;8686;3;6084642;1;0;0;0
FR;1;2021-04-30;272030;149050;1074;0;165149;0;0;0;0;10762522;5883569;9760;3;6249791;1;0;0;0
FR;1;2021-05-01;141180;40615;173;0;48643;0;0;0;0;10903702;5924184;9933;3;6298434;1;0;0;0
FR;1;2021-05-02;81564;28243;81;0;32999;0;0;0;0;10985266;5952427;10014;3;6331433;1;0;0;0
FR;1;2021-05-03;250829;142036;803;0;155731;0;0;0;0;11236095;6094463;10817;3;6487164;1;0;0;0
FR;1;2021-05-04;265939;188055;1204;0;203627;0;0;0;0;11502034;6282518;12021;3;6690791;1;0;0;0
FR;1;2021-05-05;283977;186327;1268;0;202990;0;0;0;0;11786011;6468845;13289;3;6893781;1;0;0;0
FR;1;2021-05-06;310084;184609;1502;0;204359;0;0;0;0;12096095;6653454;14791;3;7098140;1;0;0;0
FR;1;2021-05-07;284151;196767;1128;0;214583;0;0;0;0;12380246;6850221;15919;3;7312723;1;0;0;0
FR;1;2021-05-08;191687;51633;285;0;63016;0;0;0;0;12571933;6901854;16204;3;7375739;1;0;0;0
FR;1;2021-05-09;114076;34208;236;0;41380;0;0;0;0;12686009;6936062;16440;3;7417119;1;0;0;0
FR;1;2021-05-10;258240;195103;1188;0;211096;0;0;0;0;12944249;7131165;17628;3;7628215;1;0;0;0
FR;1;2021-05-11;318945;211268;1465;0;231506;0;0;0;0;13263194;7342433;19093;3;7859721;1;0;0;0
FR;1;2021-05-12;356714;186097;1402;0;208403;0;0;0;0;13619908;7528530;20495;3;8068124;1;0;0;0
FR;1;2021-05-13;283474;47323;401;0;64245;0;0;0;0;13903382;7575853;20896;3;8132369;1;0;0;0
FR;1;2021-05-14;370544;128527;998;0;151947;0;0;0;0;14273926;7704380;21894;3;8284316;1;0;0;0
FR;1;2021-05-15;298131;66209;404;0;84916;0;0;0;0;14572057;7770589;22298;3;8369232;1;0;0;0
FR;1;2021-05-16;157797;15471;158;0;26039;0;0;0;0;14729854;7786060;22456;3;8395271;1;0;0;0
FR;1;2021-05-17;318963;116205;1441;0;138168;0;0;0;0;15048817;7902265;23897;3;8533439;1;0;0;0
FR;1;2021-05-18;383395;111696;1801;0;137645;0;0;0;0;15432212;8013961;25698;3;8671084;1;0;0;0
FR;1;2021-05-19;395327;101588;2185;0;128523;0;0;0;0;15827539;8115549;27883;3;8799607;1;0;0;0
FR;1;2021-05-20;421862;95617;2049;0;125078;0;0;0;0;16249401;8211166;29932;3;8924685;1;0;0;0
FR;1;2021-05-21;399844;97453;1765;0;125850;0;0;0;0;16649245;8308619;31697;3;9050535;1;0;0;0
FR;1;2021-05-22;275713;41925;604;0;60948;0;0;0;0;16924958;8350544;32301;3;9111483;1;0;0;0
FR;1;2021-05-23;123034;10969;224;0;20572;0;0;0;0;17047992;8361513;32525;3;9132055;1;0;0;0
FR;1;2021-05-24;244028;26268;569;0;43793;0;0;0;0;17292020;8387781;33094;3;9175848;1;0;0;0
FR;1;2021-05-25;366248;131454;2115;1;158386;0;0;0;0;17658268;8519235;35209;4;9334234;1;0;0;0
FR;1;2021-05-26;380865;127556;1996;0;155879;0;0;0;0;18039133;8646791;37205;4;9490113;1;0;0;0
FR;1;2021-05-27;406209;128369;1978;0;158848;0;0;0;0;18445342;8775160;39183;4;9648961;1;0;0;0
FR;1;2021-05-28;366081;145712;1702;0;174274;0;0;0;0;18811423;8920872;40885;4;9823235;1;0;0;0
FR;1;2021-05-29;253850;81137;527;0;100334;0;0;0;0;19065273;9002009;41412;4;9923569;1;0;0;0
FR;1;2021-05-30;100983;22600;158;0;30833;0;0;0;0;19166256;9024609;41570;4;9954402;1;0;0;0
FR;1;2021-05-31;314351;149250;1287;1;172506;1;0;0;0;19480607;9173859;42857;5;10126908;2;0;0;0
FR;1;2021-06-01;361719;166427;1733;1;194131;1;0;0;0;19842326;9340286;44590;6;10321039;3;0;0;0
FR;1;2021-06-02;365450;154543;1798;0;184085;0;0;0;0;20207776;9494829;46388;6;10505124;3;0;0;0
FR;1;2021-06-03;391508;147436;1654;0;178407;0;0;0;0;20599284;9642265;48042;6;10683531;3;0;0;0
FR;1;2021-06-04;364149;175901;1496;1;205193;1;0;0;0;20963433;9818166;49538;7;10888724;4;0;0;0
FR;1;2021-06-05;258534;112822;597;0;133183;0;0;0;0;21221967;9930988;50135;7;11021907;4;0;0;0
FR;1;2021-06-06;126834;37555;216;0;48192;0;0;0;0;21348801;9968543;50351;7;11070099;4;0;0;0
FR;1;2021-06-07;301134;207764;1368;0;233040;0;0;0;0;21649935;10176307;51719;7;11303139;4;0;0;0
FR;1;2021-06-08;330916;221017;1645;0;248977;0;0;0;0;21980851;10397324;53364;7;11552116;4;0;0;0
FR;1;2021-06-09;336664;210940;1614;0;239697;0;0;0;0;22317515;10608264;54978;7;11791813;4;0;0;0
FR;1;2021-06-10;343950;199497;1616;0;229241;0;0;0;0;22661465;10807761;56594;7;12021054;4;0;0;0
FR;1;2021-06-11;311947;234702;1300;1;262613;0;0;0;0;22973412;11042463;57894;8;12283667;4;0;0;0
FR;1;2021-06-12;244101;150610;438;0;172218;0;0;0;0;23217513;11193073;58332;8;12455885;4;0;0;0
FR;1;2021-06-13;100383;61036;188;0;70698;0;0;0;0;23317896;11254109;58520;8;12526583;4;0;0;0
FR;1;2021-06-14;207886;287568;1320;1;307380;0;0;0;0;23525782;11541677;59840;9;12833963;4;0;0;0
FR;1;2021-06-15;256915;281121;1400;1;304970;0;0;0;0;23782697;11822798;61240;10;13138933;4;0;0;0
FR;1;2021-06-16;273687;270713;1264;1;296153;0;0;0;0;24056384;12093511;62504;11;13435086;4;0;0;0
FR;1;2021-06-17;268261;245099;1241;1;271170;0;0;0;0;24324645;12338610;63745;12;13706256;4;0;0;0
FR;1;2021-06-18;260626;295195;1156;2;321021;0;0;0;0;24585271;12633805;64901;14;14027277;4;0;0;0
FR;1;2021-06-19;193469;209606;388;0;228267;0;0;0;0;24778740;12843411;65289;14;14255544;4;0;0;0
FR;1;2021-06-20;69724;89029;122;0;96867;0;0;0;0;24848464;12932440;65411;14;14352411;4;0;0;0
FR;1;2021-06-21;172400;319783;934;1;338493;1;0;0;0;25020864;13252223;66345;15;14690904;5;0;0;0
FR;1;2021-06-22;185899;348088;1102;10;369157;1;0;0;0;25206763;13600311;67447;25;15060061;6;0;0;0
FR;1;2021-06-23;204245;339656;1050;0;363556;0;0;0;0;25411008;13939967;68497;25;15423617;6;0;0;0
FR;1;2021-06-24;203557;282110;1176;0;306856;0;0;0;0;25614565;14222077;69673;25;15730473;6;0;0;0
FR;1;2021-06-25;182687;371703;1200;0;395711;0;0;0;0;25797252;14593780;70873;25;16126184;6;0;0;0
FR;1;2021-06-26;131415;278613;506;0;295988;0;0;0;0;25928667;14872393;71379;25;16422172;6;0;0;0
FR;1;2021-06-27;52422;122845;146;0;130382;0;0;0;0;25981089;14995238;71525;25;16552554;6;0;0;0
FR;1;2021-06-28;136682;368244;1066;0;386845;0;0;0;0;26117771;15363482;72591;25;16939399;6;0;0;0
FR;1;2021-06-29;154930;391181;1849;0;412273;0;0;0;0;26272701;15754663;74440;25;17351672;6;0;0;0
FR;1;2021-06-30;180077;381967;1668;4;406564;2;0;0;0;26452778;16136630;76108;29;17758236;8;0;0;0
FR;1;2021-07-01;201593;332530;1890;5;360598;0;0;0;0;26654371;16469160;77998;34;18118834;8;0;0;0
FR;1;2021-07-02;193889;367288;1765;5;395482;2;0;0;0;26848260;16836448;79763;39;18514316;10;0;0;0
FR;1;2021-07-03;124485;280410;704;3;299514;1;0;0;0;26972745;17116858;80467;42;18813830;11;0;0;0
FR;1;2021-07-04;53970;113732;244;0;122137;0;0;0;0;27026715;17230590;80711;42;18935967;11;0;0;0
FR;1;2021-07-05;153987;355762;1500;8;379100;0;0;0;0;27180702;17586352;82211;50;19315067;11;0;0;0
FR;1;2021-07-06;173534;382279;1603;45;408166;8;0;0;0;27354236;17968631;83814;95;19723233;19;0;0;0
FR;1;2021-07-07;190875;362305;1659;25;390648;2;0;0;0;27545111;18330936;85473;120;20113881;21;0;0;0
FR;1;2021-07-08;201595;322963;1827;20;353607;2;0;0;0;27746706;18653899;87300;140;20467488;23;0;0;0
FR;1;2021-07-09;189996;387760;1854;3;418157;1;0;0;0;27936702;19041659;89154;143;20885645;24;0;0;0
FR;1;2021-07-10;129968;281184;818;1;302611;0;0;0;0;28066670;19322843;89972;144;21188256;24;0;0;0
FR;1;2021-07-11;57688;102527;263;0;112404;0;0;0;0;28124358;19425370;90235;144;21300660;24;0;0;0
FR;1;2021-07-12;149932;416805;1588;4;442792;0;0;0;0;28274290;19842175;91823;148;21743452;24;0;0;0
FR;1;2021-07-13;234313;438998;1808;8;476173;0;0;0;0;28508603;20281173;93631;156;22219625;24;0;0;0
FR;1;2021-07-14;171932;151300;418;0;176927;0;0;0;0;28680535;20432473;94049;156;22396552;24;0;0;0
FR;1;2021-07-15;279707;424132;1859;1;467101;0;0;0;0;28960242;20856605;95908;157;22863653;24;0;0;0
FR;1;2021-07-16;290447;400514;1711;3;445148;1;0;0;0;29250689;21257119;97619;160;23308801;25;0;0;0
FR;1;2021-07-17;217362;281971;755;1;315431;0;0;0;0;29468051;21539090;98374;161;23624232;25;0;0;0
FR;1;2021-07-18;102032;107205;288;0;123090;0;0;0;0;29570083;21646295;98662;161;23747322;25;0;0;0
FR;1;2021-07-19;238250;378359;1498;3;414395;0;0;0;0;29808333;22024654;100160;164;24161717;25;0;0;0
FR;1;2021-07-20;305778;379722;1471;0;425541;0;0;0;0;30114111;22404376;101631;164;24587258;25;0;0;0
FR;1;2021-07-21;333316;352689;1413;4;404053;1;0;0;0;30447427;22757065;103044;168;24991311;26;0;0;0
FR;1;2021-07-22;364709;318524;1502;3;374927;1;0;0;0;30812136;23075589;104546;171;25366238;27;0;0;0
FR;1;2021-07-23;349411;342717;1589;4;398252;1;0;0;0;31161547;23418306;106135;175;25764490;28;0;0;0
FR;1;2021-07-24;238968;240735;697;1;278063;0;0;0;0;31400515;23659041;106832;176;26042553;28;0;0;0
FR;1;2021-07-25;112813;76012;223;0;93705;0;0;0;0;31513328;23735053;107055;176;26136258;28;0;0;0
FR;1;2021-07-26;299151;289258;1495;2;334966;1;0;0;0;31812479;24024311;108550;178;26471224;29;0;0;0
FR;1;2021-07-27;385873;267858;1460;4;324822;1;0;0;0;32198352;24292169;110010;182;26796046;30;0;0;0
FR;1;2021-07-28;390231;250919;1463;4;307203;1;0;0;0;32588583;24543088;111473;186;27103249;31;0;0;0
FR;1;2021-07-29;406162;227576;1541;2;284265;0;0;0;0;32994745;24770664;113014;188;27387514;31;0;0;0
FR;1;2021-07-30;370762;246474;1639;4;298301;1;0;0;0;33365507;25017138;114653;192;27685815;32;0;0;0
FR;1;2021-07-31;243396;165091;794;1;199410;0;0;0;0;33608903;25182229;115447;193;27885225;32;0;0;0
FR;1;2021-08-01;105617;47204;237;0;61197;0;0;0;0;33714520;25229433;115684;193;27946422;32;0;0;0
FR;1;2021-08-02;297440;212829;1480;2;250606;0;0;0;0;34011960;25442262;117164;195;28197028;32;0;0;0
FR;1;2021-08-03;331357;208670;1557;2;250632;1;0;0;0;34343317;25650932;118721;197;28447660;33;0;0;0
FR;1;2021-08-04;328059;183822;1440;5;223968;3;0;0;0;34671376;25834754;120161;202;28671628;36;0;0;0
FR;1;2021-08-05;301300;193081;1483;0;229373;0;0;0;0;34972676;26027835;121644;202;28901001;36;0;0;0
FR;1;2021-08-06;291006;224079;1560;3;261358;0;0;0;0;35263682;26251914;123204;205;29162359;36;0;0;0
FR;1;2021-08-07;182686;158758;655;5;181661;1;0;0;0;35446368;26410672;123859;210;29344020;37;0;0;0
FR;1;2021-08-08;68897;59100;253;0;67627;0;0;0;0;35515265;26469772;124112;210;29411647;37;0;0;0
FR;1;2021-08-09;222801;235140;1446;4;263841;2;0;0;0;35738066;26704912;125558;214;29675488;39;0;0;0
FR;1;2021-08-10;252764;239819;1492;2;271646;0;0;0;0;35990830;26944731;127050;216;29947134;39;0;0;0
FR;1;2021-08-11;236257;231717;1272;5;261225;0;0;0;0;36227087;27176448;128322;221;30208359;39;0;0;0
FR;1;2021-08-12;220806;239711;1492;3;267797;0;0;0;0;36447893;27416159;129814;224;30476156;39;0;0;0
FR;1;2021-08-13;201733;238485;1361;2;264021;2;0;0;0;36649626;27654644;131175;226;30740177;41;0;0;0
FR;1;2021-08-14;122877;174034;645;0;189536;0;0;0;0;36772503;27828678;131820;226;30929713;41;0;0;0
FR;1;2021-08-15;34711;46113;201;1;50330;0;0;0;0;36807214;27874791;132021;227;30980043;41;0;0;0
FR;1;2021-08-16;156967;289320;1424;0;309888;0;0;0;0;36964181;28164111;133445;227;31289931;41;0;0;0
FR;1;2021-08-17;171626;290949;1422;5;313349;0;0;0;0;37135807;28455060;134867;232;31603280;41;0;0;0
FR;1;2021-08-18;161452;286670;1394;6;307296;3;0;0;0;37297259;28741730;136261;238;31910576;44;0;0;0
FR;1;2021-08-19;148964;277408;1405;1;297247;0;0;0;0;37446223;29019138;137666;239;32207823;44;0;0;0
FR;1;2021-08-20;140535;308906;1535;2;328135;2;0;0;0;37586758;29328044;139201;241;32535958;46;0;0;0
FR;1;2021-08-21;84288;213210;589;0;224528;0;0;0;0;37671046;29541254;139790;241;32760486;46;0;0;0
FR;1;2021-08-22;28585;82695;233;0;86699;0;0;0;0;37699631;29623949;140023;241;32847185;46;0;0;0
FR;1;2021-08-23;118674;320942;1422;2;337671;0;0;0;0;37818305;29944891;141445;243;33184856;46;0;0;0
FR;1;2021-08-24;126689;319599;1604;5;337411;0;0;0;0;37944994;30264490;143049;248;33522267;46;0;0;0
FR;1;2021-08-25;121548;306410;1783;8;323581;2;0;0;0;38066542;30570900;144832;256;33845848;48;0;0;0
FR;1;2021-08-26;106649;286079;2165;10;302375;0;0;0;0;38173191;30856979;146997;266;34148223;48;0;0;0
FR;1;2021-08-27;107659;321584;2303;9;338837;1;0;0;0;38280850;31178563;149300;275;34487060;49;0;0;0
FR;1;2021-08-28;71030;220701;1102;0;231221;0;0;0;0;38351880;31399264;150402;275;34718281;49;0;0;0
FR;1;2021-08-29;24156;78209;469;1;82099;0;0;0;0;38376036;31477473;150871;276;34800380;49;0;0;0
FR;1;2021-08-30;96904;286251;4315;6;299752;4951;0;0;0;38472940;31763724;155186;282;35100132;5000;0;0;0
FR;1;2021-08-31;98136;276227;9295;15;289897;10059;2;0;0;38571076;32039951;164481;297;35390029;15059;2;0;0
FR;1;2021-09-01;112366;245283;21122;8;257667;22154;1;0;0;38683442;32285234;185603;305;35647696;37213;3;0;0
FR;1;2021-09-02;86760;197906;24536;18;208302;25517;0;0;0;38770202;32483140;210139;323;35855998;62730;3;0;0
FR;1;2021-09-03;82435;227476;26958;21;238914;28038;0;0;0;38852637;32710616;237097;344;36094912;90768;3;0;0
FR;1;2021-09-04;71632;189720;11141;11;199297;11712;7;0;0;38924269;32900336;248238;355;36294209;102480;10;0;0
FR;1;2021-09-05;18615;41142;4126;2;43849;4275;0;0;0;38942884;32941478;252364;357;36338058;106755;10;0;0
FR;1;2021-09-06;59825;151363;30182;15;158892;31206;2;0;0;39002709;33092841;282546;372;36496950;137961;12;0;0
FR;1;2021-09-07;57400;139622;30215;30;146741;31253;2;0;0;39060109;33232463;312761;402;36643691;169214;14;0;0
FR;1;2021-09-08;72358;173795;26926;22;182263;27967;4;0;0;39132467;33406258;339687;424;36825954;197181;18;0;0
FR;1;2021-09-09;54516;124427;28638;24;131186;29745;5;0;0;39186983;33530685;368325;448;36957140;226926;23;0;0
FR;1;2021-09-10;66225;152068;30452;24;161152;31694;5;0;0;39253208;33682753;398777;472;37118292;258620;28;0;0
FR;1;2021-09-11;52689;146638;9731;14;154126;10356;0;0;0;39305897;33829391;408508;486;37272418;268976;28;0;0
FR;1;2021-09-12;10800;29268;2491;1;30966;2661;2;0;0;39316697;33858659;410999;487;37303384;271637;30;0;0
FR;1;2021-09-13;51520;104394;38767;31;110927;40098;16;0;0;39368217;33963053;449766;518;37414311;311735;46;0;0
FR;1;2021-09-14;53343;96011;51293;67;102370;53299;37;0;0;39421560;34059064;501059;585;37516681;365034;83;0;0
FR;1;2021-09-15;60592;139228;50499;55;146396;47072;67;0;0;39482152;34198292;551558;640;37663077;412106;150;0;0
FR;1;2021-09-16;46646;81362;53354;70;86256;49617;55;0;0;39528798;34279654;604912;710;37749333;461723;205;0;0
FR;1;2021-09-17;53227;109326;45085;61;115661;42717;61;0;0;39582025;34388980;649997;771;37864994;504440;266;0;0
FR;1;2021-09-18;37887;118499;11797;19;124081;11280;19;0;0;39619912;34507479;661794;790;37989075;515720;285;0;0
FR;1;2021-09-19;6531;21022;2045;1;22126;1985;1;0;0;39626443;34528501;663839;791;38011201;517705;286;0;0
FR;1;2021-09-20;36543;74843;46230;65;78563;44197;30;0;0;39662986;34603344;710069;856;38089764;561902;316;0;0
FR;1;2021-09-21;34209;68101;56270;72;71136;52747;76;0;0;39697195;34671445;766339;928;38160900;614649;392;0;0
FR;1;2021-09-22;38851;118605;49885;76;123023;46938;39;0;0;39736046;34790050;816224;1004;38283923;661587;431;0;0
FR;1;2021-09-23;32043;62888;54515;85;65791;50921;76;0;0;39768089;34852938;870739;1089;38349714;712508;507;0;0
FR;1;2021-09-24;36804;90014;43678;89;94371;41959;57;0;0;39804893;34942952;914417;1178;38444085;754467;564;0;0
FR;1;2021-09-25;27655;96714;12308;27;101064;12190;19;0;0;39832548;35039666;926725;1205;38545149;766657;583;0;0
FR;1;2021-09-26;4390;15201;1777;5;16066;1699;4;0;0;39836938;35054867;928502;1210;38561215;768356;587;0;0
FR;1;2021-09-27;27356;60205;42930;89;63435;41661;78;0;1;39864294;35115072;971432;1299;38624650;810017;665;0;1
FR;1;2021-09-28;26913;49419;47207;76;52034;44497;38;0;0;39891207;35164491;1018639;1375;38676684;854514;703;0;1
FR;1;2021-09-29;35927;80251;47298;88;84638;45624;33;0;0;39927134;35244742;1065937;1463;38761322;900138;736;0;1
FR;1;2021-09-30;26077;46900;47530;80;49257;45481;51;0;0;39953211;35291642;1113467;1543;38810579;945619;787;0;1
FR;1;2021-10-01;47307;66913;44909;83;70794;44633;14;0;0;40000518;35358555;1158376;1626;38881373;990252;801;0;1
FR;1;2021-10-02;32385;62416;16114;32;67224;16325;6;0;0;40032903;35420971;1174490;1658;38948597;1006577;807;0;1
FR;1;2021-10-03;4344;8561;2043;3;9310;2038;4;0;0;40037247;35429532;1176533;1661;38957907;1008615;811;0;1
FR;1;2021-10-04;28986;44424;47117;79;46836;46986;31;0;0;40066233;35473956;1223650;1740;39004743;1055601;842;0;1
FR;1;2021-10-05;24576;41642;49895;116;43137;49354;46;0;0;40090809;35515598;1273545;1856;39047880;1104955;888;0;1
FR;1;2021-10-06;34660;61393;57511;101;64500;57267;24;0;0;40125469;35576991;1331056;1957;39112380;1162222;912;0;1
FR;1;2021-10-07;21084;39908;53056;74;41087;52001;32;0;0;40146553;35616899;1384112;2031;39153467;1214223;944;0;1
FR;1;2021-10-08;35672;59644;60412;83;62870;61169;28;0;0;40182225;35676543;1444524;2114;39216337;1275392;972;0;1
FR;1;2021-10-09;27466;48025;25498;29;52491;26028;10;0;0;40209691;35724568;1470022;2143;39268828;1301420;982;0;1
FR;1;2021-10-10;3727;5812;2759;7;6290;2865;1;0;0;40213418;35730380;1472781;2150;39275118;1304285;983;0;1
FR;1;2021-10-11;24860;38210;54590;88;40295;55272;43;0;0;40238278;35768590;1527371;2238;39315413;1359557;1026;0;1
FR;1;2021-10-12;23387;36580;58078;128;37078;59241;18;0;0;40261665;35805170;1585449;2366;39352491;1418798;1044;0;1
FR;1;2021-10-13;32975;47839;64177;125;50643;65703;22;0;1;40294640;35853009;1649626;2491;39403134;1484501;1066;0;2
FR;1;2021-10-14;21715;34774;53776;103;35680;54373;21;0;0;40316355;35887783;1703402;2594;39438814;1538874;1087;0;2
FR;1;2021-10-15;32757;48766;72340;165;50457;75038;22;0;0;40349112;35936549;1775742;2759;39489271;1613912;1109;0;2
FR;1;2021-10-16;26014;35281;34874;45;38297;36431;13;0;0;40375126;35971830;1810616;2804;39527568;1650343;1122;0;2
FR;1;2021-10-17;3161;4054;3418;2;4497;3319;3;0;0;40378287;35975884;1814034;2806;39532065;1653662;1125;0;2
FR;1;2021-10-18;24353;34880;66854;132;34917;69740;27;0;0;40402640;36010764;1880888;2938;39566982;1723402;1152;0;2
FR;1;2021-10-19;20724;35571;75678;135;33221;79612;38;0;0;40423364;36046335;1956566;3073;39600203;1803014;1190;0;2
FR;1;2021-10-20;29918;44201;96192;178;43275;99883;45;0;0;40453282;36090536;2052758;3251;39643478;1902897;1235;0;2
FR;1;2021-10-21;19807;35053;83202;107;31763;87065;29;0;0;40473089;36125589;2135960;3358;39675241;1989962;1264;0;2
FR;1;2021-10-22;29756;47758;103757;196;44556;109722;58;0;0;40502845;36173347;2239717;3554;39719797;2099684;1322;0;2
FR;1;2021-10-23;23055;35142;44876;57;36130;47385;11;0;0;40525900;36208489;2284593;3611;39755927;2147069;1333;0;2
FR;1;2021-10-24;2407;3841;3585;6;4041;3718;1;0;0;40528307;36212330;2288178;3617;39759968;2150787;1334;0;2
FR;1;2021-10-25;22504;30718;82031;143;29600;85840;36;0;0;40550811;36243048;2370209;3760;39789568;2236627;1370;0;2
FR;1;2021-10-26;19368;27645;86127;162;24737;90358;30;0;0;40570179;36270693;2456336;3922;39814305;2326985;1400;0;2
FR;1;2021-10-27;26223;39609;107828;252;37300;112743;45;0;0;40596402;36310302;2564164;4174;39851605;2439728;1445;0;2
FR;1;2021-10-28;18804;27108;86970;150;23481;91739;34;0;0;40615206;36337410;2651134;4324;39875086;2531467;1479;0;2
FR;1;2021-10-29;25936;40253;114845;202;35486;121684;49;0;0;40641142;36377663;2765979;4526;39910572;2653151;1528;0;2
FR;1;2021-10-30;17714;28718;49373;74;28302;51970;18;0;0;40658856;36406381;2815352;4600;39938874;2705121;1546;0;2
FR;1;2021-10-31;2088;3169;3452;2;3215;3686;2;0;0;40660944;36409550;2818804;4602;39942089;2708807;1548;0;2
FR;1;2021-11-01;8027;4274;3037;3;4357;3295;6;0;0;40668971;36413824;2821841;4605;39946446;2712102;1554;0;2
FR;1;2021-11-02;22918;33218;92416;156;29172;97870;39;0;1;40691889;36447042;2914257;4761;39975618;2809972;1593;0;3
FR;1;2021-11-03;26639;41549;117526;219;36997;123912;54;0;0;40718528;36488591;3031783;4980;40012615;2933884;1647;0;3
FR;1;2021-11-04;19630;30287;105827;213;24182;111971;42;0;0;40738158;36518878;3137610;5193;40036797;3045855;1689;0;3
FR;1;2021-11-05;27036;42299;138800;230;34179;147490;47;0;0;40765194;36561177;3276410;5423;40070976;3193345;1736;0;3
FR;1;2021-11-06;18864;29807;63500;123;27605;66520;24;0;0;40784058;36590984;3339910;5546;40098581;3259865;1760;0;3
FR;1;2021-11-07;1835;3267;4985;6;3024;5302;5;0;0;40785893;36594251;3344895;5552;40101605;3265167;1765;0;3
FR;1;2021-11-08;17882;32249;126022;224;25390;132661;47;0;0;40803775;36626500;3470917;5776;40126995;3397828;1812;0;3
FR;1;2021-11-09;19520;37608;159334;334;26129;169157;63;0;0;40823295;36664108;3630251;6110;40153124;3566985;1875;0;3
FR;1;2021-11-10;28895;49047;181931;441;39012;192548;82;0;0;40852190;36713155;3812182;6551;40192136;3759533;1957;0;3
FR;1;2021-11-11;4192;5931;12240;26;5108;13030;14;0;0;40856382;36719086;3824422;6577;40197244;3772563;1971;0;3
FR;1;2021-11-12;26028;46818;174849;244;35281;186551;76;0;0;40882410;36765904;3999271;6821;40232525;3959114;2047;0;3
FR;1;2021-11-13;18736;29143;76847;111;25369;81792;40;0;0;40901146;36795047;4076118;6932;40257894;4040906;2087;0;3
FR;1;2021-11-14;2051;3240;6828;5;2796;7358;6;0;0;40903197;36798287;4082946;6937;40260690;4048264;2093;0;3
FR;1;2021-11-15;18798;34705;156449;306;24613;166286;59;0;0;40921995;36832992;4239395;7243;40285303;4214550;2152;0;3
FR;1;2021-11-16;21369;37810;192164;380;23315;205082;99;0;1;40943364;36870802;4431559;7623;40308618;4419632;2251;0;4
FR;1;2021-11-17;28675;45551;193256;398;33020;205083;92;0;0;40972039;36916353;4624815;8021;40341638;4624715;2343;0;4
FR;1;2021-11-18;21149;39595;182546;459;25134;194673;85;0;0;40993188;36955948;4807361;8480;40366772;4819388;2428;0;4
FR;1;2021-11-19;30894;53317;230287;532;34810;246783;134;0;0;41024082;37009265;5037648;9012;40401582;5066171;2562;0;4
FR;1;2021-11-20;23776;33216;97003;202;26735;103656;40;0;0;41047858;37042481;5134651;9214;40428317;5169827;2602;0;4
FR;1;2021-11-21;2342;3909;9134;19;2957;9940;16;0;0;41050200;37046390;5143785;9233;40431274;5179767;2618;0;4
FR;1;2021-11-22;21426;30328;175932;467;16943;189483;79;0;0;41071626;37076718;5319717;9700;40448217;5369250;2697;0;4
FR;1;2021-11-23;24033;40968;221267;540;21318;238019;77;0;0;41095659;37117686;5540984;10240;40469535;5607269;2774;0;4
FR;1;2021-11-24;30298;49641;217403;701;31960;234586;67;0;0;41125957;37167327;5758387;10941;40501495;5841855;2841;0;4
FR;1;2021-11-25;23732;44044;244528;718;22070;264229;101;0;0;41149689;37211371;6002915;11659;40523565;6106084;2942;0;4
FR;1;2021-11-26;30618;66640;356842;836;33240;388630;154;0;0;41180307;37278011;6359757;12495;40556805;6494714;3096;0;4
FR;1;2021-11-27;21960;45262;202667;372;26149;222698;112;0;0;41202267;37323273;6562424;12867;40582954;6717412;3208;0;4
FR;1;2021-11-28;3180;9543;54804;63;3468;61016;37;0;0;41205447;37332816;6617228;12930;40586422;6778428;3245;0;4
FR;1;2021-11-29;17905;49469;326437;841;20782;354580;150;0;0;41223352;37382285;6943665;13771;40607204;7133008;3395;0;4
FR;1;2021-11-30;22790;64817;431197;952;23793;470847;266;0;0;41246142;37447102;7374862;14723;40630997;7603855;3661;0;4
FR;1;2021-12-01;25365;69037;442956;1131;28429;481822;271;0;0;41271507;37516139;7817818;15854;40659426;8085677;3932;0;4
FR;1;2021-12-02;20094;64295;489465;1230;18431;532971;274;0;0;41291601;37580434;8307283;17084;40677857;8618648;4206;0;4
FR;1;2021-12-03;22912;82296;542843;1310;30267;591859;308;0;0;41314513;37662730;8850126;18394;40708124;9210507;4514;0;4
FR;1;2021-12-04;16416;53778;299138;654;23203;328999;180;0;0;41330929;37716508;9149264;19048;40731327;9539506;4694;0;4
FR;1;2021-12-05;3635;13773;81549;143;4193;91048;85;0;0;41334564;37730281;9230813;19191;40735520;9630554;4779;0;4
FR;1;2021-12-06;25847;62421;415526;1066;22060;455255;358;0;0;41360411;37792702;9646339;20257;40757580;10085809;5137;0;4
FR;1;2021-12-07;20020;75449;523086;1536;24268;572745;372;0;0;41380431;37868151;10169425;21793;40781848;10658554;5509;0;4
FR;1;2021-12-08;21719;75489;458639;1545;30647;502296;377;0;0;41402150;37943640;10628064;23338;40812495;11160850;5886;0;4
FR;1;2021-12-09;19473;73925;493117;1624;24309;541130;398;0;0;41421623;38017565;11121181;24962;40836804;11701980;6284;0;4
FR;1;2021-12-10;23330;87514;547476;1585;32410;600119;392;0;1;41444953;38105079;11668657;26547;40869214;12302099;6676;0;5
FR;1;2021-12-11;16533;59085;302772;751;25944;335505;278;0;0;41461486;38164164;11971429;27298;40895158;12637604;6954;0;5
FR;1;2021-12-12;4398;15878;83241;179;5243;94049;96;0;0;41465884;38180042;12054670;27477;40900401;12731653;7050;0;5
FR;1;2021-12-13;15761;63389;367088;1094;23898;406370;236;0;0;41481645;38243431;12421758;28571;40924299;13138023;7286;0;5
FR;1;2021-12-14;20870;80105;464907;1749;28630;515367;507;0;1;41502515;38323536;12886665;30320;40952929;13653390;7793;0;6
FR;1;2021-12-15;21629;77283;409190;1309;33000;453259;311;0;1;41524144;38400819;13295855;31629;40985929;14106649;8104;0;7
FR;1;2021-12-16;20069;77046;452015;1577;27918;500753;324;0;0;41544213;38477865;13747870;33206;41013847;14607402;8428;0;7
FR;1;2021-12-17;22628;86367;480032;1737;34637;531058;371;0;0;41566841;38564232;14227902;34943;41048484;15138460;8799;0;7
FR;1;2021-12-18;17610;54545;257664;731;24680;288531;232;0;0;41584451;38618777;14485566;35674;41073164;15426991;9031;0;7
FR;1;2021-12-19;5563;16907;79205;194;5920;90677;117;0;0;41590014;38635684;14564771;35868;41079084;15517668;9148;0;7
FR;1;2021-12-20;20957;62862;316308;1082;26481;355339;286;0;0;41610971;38698546;14881079;36950;41105565;15873007;9434;0;7
FR;1;2021-12-21;26344;72856;372822;1422;30551;418150;338;0;0;41637315;38771402;15253901;38372;41136116;16291157;9772;0;7
FR;1;2021-12-22;24989;65638;310706;1217;29569;349629;361;0;1;41662304;38837040;15564607;39589;41165685;16640786;10133;0;8
FR;1;2021-12-23;21280;52101;241543;958;23337;273074;362;0;0;41683584;38889141;15806150;40547;41189022;16913860;10495;0;8
FR;1;2021-12-24;7130;18267;67172;258;9242;77064;154;0;1;41690714;38907408;15873322;40805;41198264;16990924;10649;0;9
FR;1;2021-12-25;510;2864;5595;15;1797;6539;55;0;0;41691224;38910272;15878917;40820;41200061;16997463;10704;0;9
FR;1;2021-12-26;2751;7565;26961;71;3489;31471;100;0;0;41693975;38917837;15905878;40891;41203550;17028934;10804;0;9
FR;1;2021-12-27;18311;53455;235148;705;25446;265807;365;0;0;41712286;38971292;16141026;41596;41228996;17294741;11169;0;9
FR;1;2021-12-28;23302;61879;292071;1026;26988;330246;595;0;1;41735588;39033171;16433097;42622;41255984;17624987;11764;0;10
FR;1;2021-12-29;22218;55369;255050;921;25253;288246;645;0;1;41757806;39088540;16688147;43543;41281237;17913233;12409;0;11
FR;1;2021-12-30;21240;46407;212185;858;22443;239635;718;0;0;41779046;39134947;16900332;44401;41303680;18152868;13127;0;11
FR;1;2021-12-31;7468;16536;61882;229;8713;70417;347;0;0;41786514;39151483;16962214;44630;41312393;18223285;13474;0;11
FR;1;2022-01-01;1173;2492;5668;30;1546;6577;73;0;0;41787687;39153975;16967882;44660;41313939;18229862;13547;0;11
FR;1;2022-01-02;3096;8073;28896;50;3672;33536;190;0;0;41790783;39162048;16996778;44710;41317611;18263398;13737;0;11
FR;1;2022-01-03;27025;54161;228289;790;27528;257750;964;0;1;41817808;39216209;17225067;45500;41345139;18521148;14701;0;12
FR;1;2022-01-04;26374;64968;299328;1241;29773;337372;1367;0;2;41844182;39281177;17524395;46741;41374912;18858520;16068;0;14
FR;1;2022-01-05;30572;64235;274940;1099;32504;310318;1264;0;0;41874754;39345412;17799335;47840;41407416;19168838;17332;0;14
FR;1;2022-01-06;26862;66197;306957;1404;29269;346634;1568;0;1;41901616;39411609;18106292;49244;41436685;19515472;18900;0;15
FR;1;2022-01-07;31584;74958;349881;1538;34384;394009;1822;0;1;41933200;39486567;18456173;50782;41471069;19909481;20722;0;16
FR;1;2022-01-08;23391;51356;222512;698;25569;251139;913;0;1;41956591;39537923;18678685;51480;41496638;20160620;21635;0;17
FR;1;2022-01-09;7091;17130;66036;163;8165;76142;335;0;0;41963682;39555053;18744721;51643;41504803;20236762;21970;0;17
FR;1;2022-01-10;21815;60570;236839;957;32913;267628;1258;0;1;41985497;39615623;18981560;52600;41537716;20504390;23228;0;18
FR;1;2022-01-11;26786;63429;282350;1281;31188;317867;1838;0;1;42012283;39679052;19263910;53881;41568904;20822257;25066;0;19
FR;1;2022-01-12;28969;62476;246306;1106;35041;278095;1686;0;3;42041252;39741528;19510216;54987;41603945;21100352;26752;0;22
FR;1;2022-01-13;24791;60152;262845;1253;30023;296165;1993;0;4;42066043;39801680;19773061;56240;41633968;21396517;28745;0;26
FR;1;2022-01-14;27972;66679;314057;1366;32102;351307;2475;0;1;42094015;39868359;20087118;57606;41666070;21747824;31220;0;27
FR;1;2022-01-15;19371;44409;199333;619;22462;223870;1363;0;1;42113386;39912768;20286451;58225;41688532;21971694;32583;0;28
FR;1;2022-01-16;5161;12954;51537;135;6017;59558;338;0;0;42118547;39925722;20337988;58360;41694549;22031252;32921;0;28
FR;1;2022-01-17;16884;39659;184868;783;20108;206846;1690;0;2;42135431;39965381;20522856;59143;41714657;22238098;34611;0;30
FR;1;2022-01-18;19460;45957;212464;1154;22982;237066;2456;0;1;42154891;40011338;20735320;60297;41737639;22475164;37067;0;31
FR;1;2022-01-19;20314;43936;176151;898;25463;197206;1977;0;4;42175205;40055274;20911471;61195;41763102;22672370;39044;0;35
FR;1;2022-01-20;16853;40568;183727;1147;20814;204772;2517;0;2;42192058;40095842;21095198;62342;41783916;22877142;41561;0;37
FR;1;2022-01-21;19923;47002;228985;1405;23880;253362;3106;0;1;42211981;40142844;21324183;63747;41807796;23130504;44667;0;38
FR;1;2022-01-22;13845;33330;144509;579;18431;161398;1404;0;2;42225826;40176174;21468692;64326;41826227;23291902;46071;0;40
FR;1;2022-01-23;3379;8761;33439;132;4575;38323;352;0;1;42229205;40184935;21502131;64458;41830802;23330225;46423;0;41
FR;1;2022-01-24;11817;32967;142244;718;17787;158281;2105;0;1;42241022;40217902;21644375;65176;41848589;23488506;48528;0;42
FR;1;2022-01-25;14217;38160;163436;1049;20283;181572;3181;0;1;42255239;40256062;21807811;66225;41868872;23670078;51709;0;43
FR;1;2022-01-26;14865;37722;150273;934;22633;166402;2516;0;1;42270104;40293784;21958084;67159;41891505;23836480;54225;0;44
FR;1;2022-01-27;12341;33337;143472;896;18497;158051;3230;0;3;42282445;40327121;22101556;68055;41910002;23994531;57455;0;47
FR;1;2022-01-28;16331;56907;198337;1144;32662;222397;4007;0;3;42298776;40384028;22299893;69199;41942664;24216928;61462;0;50
FR;1;2022-01-29;10270;35466;135216;525;19612;151540;1879;0;1;42309046;40419494;22435109;69724;41962276;24368468;63341;0;51
FR;1;2022-01-30;2485;9253;29688;86;4826;34449;434;0;1;42311531;40428747;22464797;69810;41967102;24402917;63775;0;52
FR;1;2022-01-31;8759;32461;104354;533;19470;117343;2340;0;3;42320290;40461208;22569151;70343;41986572;24520260;66115;0;55
FR;1;2022-02-01;11011;36444;127095;866;20630;141216;4320;0;1;42331301;40497652;22696246;71209;42007202;24661476;70435;0;56
FR;1;2022-02-02;12169;41572;130371;783;25262;145818;3773;0;9;42343470;40539224;22826617;71992;42032464;24807294;74208;0;65
FR;1;2022-02-03;9520;34055;117034;785;19123;130333;4284;0;4;42352990;40573279;22943651;72777;42051587;24937627;78492;0;69
FR;1;2022-02-04;11544;49691;172589;968;26983;192723;5479;0;5;42364534;40622970;23116240;73745;42078570;25130350;83971;0;74
FR;1;2022-02-05;8000;33921;117593;391;18170;133023;2414;0;3;42372534;40656891;23233833;74136;42096740;25263373;86385;0;77
FR;1;2022-02-06;1706;7995;22754;86;3873;26905;444;0;0;42374240;40664886;23256587;74222;42100613;25290278;86829;0;77
FR;1;2022-02-07;7369;35386;119114;460;18174;134969;3398;0;4;42381609;40700272;23375701;74682;42118787;25425247;90227;0;81
FR;1;2022-02-08;7772;31960;125678;696;14891;140668;4301;0;5;42389381;40732232;23501379;75378;42133678;25565915;94528;0;86
FR;1;2022-02-09;8741;36529;135267;702;17930;152510;3884;0;7;42398122;40768761;23636646;76080;42151608;25718425;98412;0;93
FR;1;2022-02-10;7032;30146;116383;677;13911;130171;4445;0;1;42405154;40798907;23753029;76757;42165519;25848596;102857;0;94
FR;1;2022-02-11;8662;41569;165150;878;18383;185374;5430;0;3;42413816;40840476;23918179;77635;42183902;26033970;108287;0;97
FR;1;2022-02-12;5346;27617;106715;379;12540;120900;2396;0;2;42419162;40868093;24024894;78014;42196442;26154870;110683;0;99
FR;1;2022-02-13;1269;5721;21721;66;2188;25339;402;0;3;42420431;40873814;24046615;78080;42198630;26180209;111085;0;102
FR;1;2022-02-14;5462;27230;118095;395;10644;133123;3385;0;4;42425893;40901044;24164710;78475;42209274;26313332;114470;0;106
FR;1;2022-02-15;5797;28872;118941;611;12221;132572;4883;0;1;42431690;40929916;24283651;79086;42221495;26445904;119353;0;107
FR;1;2022-02-16;5763;28497;110429;597;13764;123059;4153;0;3;42437453;40958413;24394080;79683;42235259;26568963;123506;0;110
FR;1;2022-02-17;4617;19749;73156;489;10129;80263;3999;0;3;42442070;40978162;24467236;80172;42245388;26649226;127505;0;113
FR;1;2022-02-18;5615;26805;99209;673;14177;108171;5519;0;2;42447685;41004967;24566445;80845;42259565;26757397;133024;0;115
FR;1;2022-02-19;3552;17178;59479;305;9571;66060;2267;0;0;42451237;41022145;24625924;81150;42269136;26823457;135291;0;115
FR;1;2022-02-20;794;3258;10706;36;1651;12333;360;0;1;42452031;41025403;24636630;81186;42270787;26835790;135651;0;116
FR;1;2022-02-21;3430;14599;52830;286;7919;57678;3126;0;2;42455461;41040002;24689460;81472;42278706;26893468;138777;0;118
FR;1;2022-02-22;3804;15551;51919;500;9048;55657;4070;0;1;42459265;41055553;24741379;81972;42287754;26949125;142847;0;119
FR;1;2022-02-23;4235;17827;57487;510;10747;62589;3568;0;3;42463500;41073380;24798866;82482;42298501;27011714;146415;0;122
FR;1;2022-02-24;3345;13146;43620;436;7841;46410;3658;0;2;42466845;41086526;24842486;82918;42306342;27058124;150073;0;124
FR;1;2022-02-25;4478;20133;64928;697;12250;68799;5768;0;4;42471323;41106659;24907414;83615;42318592;27126923;155841;0;128
FR;1;2022-02-26;2698;12806;41371;310;7653;45124;2494;0;2;42474021;41119465;24948785;83925;42326245;27172047;158335;0;130
FR;1;2022-02-27;644;2192;7131;42;1207;7994;433;0;0;42474665;41121657;24955916;83967;42327452;27180041;158768;0;130
FR;1;2022-02-28;2614;10502;34968;306;6082;37395;3123;0;0;42477279;41132159;24990884;84273;42333534;27217436;161891;0;130
FR;1;2022-03-01;3592;10762;38706;392;6364;39662;4549;0;4;42480871;41142921;25029590;84665;42339898;27257098;166440;0;134
FR;1;2022-03-02;3685;12287;41871;400;7554;43941;4112;0;1;42484556;41155208;25071461;85065;42347452;27301039;170552;0;135
FR;1;2022-03-03;2464;7994;26185;329;5249;26523;3380;0;1;42487020;41163202;25097646;85394;42352701;27327562;173932;0;136
FR;1;2022-03-04;2691;10555;35468;594;6986;34963;5280;0;3;42489711;41173757;25133114;85988;42359687;27362525;179212;0;139
FR;1;2022-03-05;1823;6370;21972;281;4208;22370;2573;0;1;42491534;41180127;25155086;86269;42363895;27384895;181785;0;140
FR;1;2022-03-06;360;959;2918;38;605;3121;327;0;0;42491894;41181086;25158004;86307;42364500;27388016;182112;0;140
FR;1;2022-03-07;1923;4724;16442;245;3046;15909;2832;0;4;42493817;41185810;25174446;86552;42367546;27403925;184944;0;144
FR;1;2022-03-08;1719;5261;17172;309;3672;16001;3471;0;3;42495536;41191071;25191618;86861;42371218;27419926;188415;0;147
FR;1;2022-03-09;1988;6749;19821;371;4824;19179;3424;0;4;42497524;41197820;25211439;87232;42376042;27439105;191839;0;151
FR;1;2022-03-10;1416;5024;15302;309;3676;14340;2944;0;2;42498940;41202844;25226741;87541;42379718;27453445;194783;0;153
FR;1;2022-03-11;1761;6416;21717;487;4450;19873;4737;0;1;42500701;41209260;25248458;88028;42384168;27473318;199520;0;154
FR;1;2022-03-12;1264;4651;15367;281;3092;14915;2687;0;2;42501965;41213911;25263825;88309;42387260;27488233;202207;0;156
FR;1;2022-03-13;258;614;2119;120;416;2065;469;0;0;42502223;41214525;25265944;88429;42387676;27490298;202676;0;156
FR;1;2022-03-14;1160;3682;13408;3882;2297;12529;6342;0;8;42503383;41218207;25279352;92311;42389973;27502827;209018;0;164
FR;1;2022-03-15;1409;5736;14665;6865;4320;13262;9847;0;8;42504792;41223943;25294017;99176;42394293;27516089;218865;0;172
FR;1;2022-03-16;1700;5092;17402;11522;3603;16465;14128;0;6;42506492;41229035;25311419;110698;42397896;27532554;232993;0;178
FR;1;2022-03-17;1182;3442;11735;9648;2367;10829;11733;0;8;42507674;41232477;25323154;120346;42400263;27543383;244726;0;186
FR;1;2022-03-18;1725;4931;17980;16508;3324;16419;19722;0;14;42509399;41237408;25341134;136854;42403587;27559802;264448;0;200
FR;1;2022-03-19;1126;3302;11891;8460;2277;11362;10142;0;6;42510525;41240710;25353025;145314;42405864;27571164;274590;0;206
FR;1;2022-03-20;225;562;1726;1015;364;1761;1224;0;2;42510750;41241272;25354751;146329;42406228;27572925;275814;0;208
FR;1;2022-03-21;1088;2768;11506;13462;1787;10857;15142;0;10;42511838;41244040;25366257;159791;42408015;27583782;290956;0;218
FR;1;2022-03-22;1282;3216;12265;18716;2156;11254;20619;0;5;42513120;41247256;25378522;178507;42410171;27595036;311575;0;223
FR;1;2022-03-23;1517;4365;16037;20112;2961;15718;21884;0;34;42514637;41251621;25394559;198619;42413132;27610754;333459;0;257
FR;1;2022-03-24;1121;2754;10405;16060;1910;9666;17565;0;15;42515758;41254375;25404964;214679;42415042;27620420;351024;0;272
FR;1;2022-03-25;1541;4364;16758;25317;2882;15411;27960;0;23;42517299;41258739;25421722;239996;42417924;27635831;378984;0;295
FR;1;2022-03-26;1110;3018;10856;11452;2065;10518;12864;0;20;42518409;41261757;25432578;251448;42419989;27646349;391848;0;315
FR;1;2022-03-27;237;546;1751;1383;334;1804;1594;0;1;42518646;41262303;25434329;252831;42420323;27648153;393442;0;316
FR;1;2022-03-28;1086;2490;9981;15885;1558;9602;17230;0;10;42519732;41264793;25444310;268716;42421881;27657755;410672;0;326
FR;1;2022-03-29;1140;2754;11562;25112;1602;10926;26509;0;30;42520872;41267547;25455872;293828;42423483;27668681;437181;0;356
FR;1;2022-03-30;1632;3680;14176;24233;2454;13716;25897;0;19;42522504;41271227;25470048;318061;42425937;27682397;463078;0;375
FR;1;2022-03-31;1281;3033;11702;22704;2061;11215;24025;0;40;42523785;41274260;25481750;340765;42427998;27693612;487103;0;415
FR;1;2022-04-01;2243;4025;18493;28533;2482;17363;30805;0;54;42526028;41278285;25500243;369298;42430480;27710975;517908;0;469
FR;1;2022-04-02;911;1894;8197;9241;1106;7960;10234;0;28;42526939;41280179;25508440;378539;42431586;27718935;528142;0;497
FR;1;2022-04-03;207;382;1433;1058;219;1435;1249;0;1;42527146;41280561;25509873;379597;42431805;27720370;529391;0;498
FR;1;2022-04-04;4273;2608;11386;17683;1696;10777;18903;0;30;42531419;41283169;25521259;397280;42433501;27731147;548294;0;528
FR;1;2022-04-05;2262;2725;13008;31222;1708;12034;32603;0;68;42533681;41285894;25534267;428502;42435209;27743181;580897;0;596
FR;1;2022-04-06;1893;3018;12208;23987;1926;11645;25284;0;62;42535574;41288912;25546475;452489;42437135;27754826;606181;0;658
FR;1;2022-04-07;1694;2754;12361;31122;1651;11830;32196;0;68;42537268;41291666;25558836;483611;42438786;27766656;638377;0;726
FR;1;2022-04-08;1847;3714;17571;40649;2100;16501;42702;0;76;42539115;41295380;25576407;524260;42440886;27783157;681079;0;802
FR;1;2022-04-09;828;2000;8406;12504;1079;8106;13502;0;26;42539943;41297380;25584813;536764;42441965;27791263;694581;0;828
FR;1;2022-04-10;202;655;1837;1855;420;1883;2075;0;6;42540145;41298035;25586650;538619;42442385;27793146;696656;0;834
FR;1;2022-04-11;1108;2269;10973;22373;1322;10687;23481;0;68;42541253;41300304;25597623;560992;42443707;27803833;720137;0;902
FR;1;2022-04-12;1352;2680;12830;38148;1594;12318;38900;0;119;42542605;41302984;25610453;599140;42445301;27816151;759037;0;1021
FR;1;2022-04-13;1284;2895;12279;30627;1790;12010;31399;0;85;42543889;41305879;25622732;629767;42447091;27828161;790436;0;1106
FR;1;2022-04-14;1240;2629;12119;33661;1632;12133;34098;0;87;42545129;41308508;25634851;663428;42448723;27840294;824534;0;1193
FR;1;2022-04-15;1512;3352;14408;33269;2166;13815;34671;0;107;42546641;41311860;25649259;696697;42450889;27854109;859205;0;1300
FR;1;2022-04-16;663;1410;5845;8003;767;5777;8757;0;31;42547304;41313270;25655104;704700;42451656;27859886;867962;0;1331
FR;1;2022-04-17;157;290;930;1121;177;975;1171;0;7;42547461;41313560;25656034;705821;42451833;27860861;869133;0;1338
FR;1;2022-04-18;170;499;2636;1002;313;2660;1187;0;5;42547631;41314059;25658670;706823;42452146;27863521;870320;0;1343
FR;1;2022-04-19;1260;2610;11788;27937;1501;11519;28792;0;69;42548891;41316669;25670458;734760;42453647;27875040;899112;0;1412
FR;1;2022-04-20;1361;2676;12179;26886;1679;12031;27711;0;82;42550252;41319345;25682637;761646;42455326;27887071;926823;0;1494
FR;1;2022-04-21;1245;2466;11554;33286;1515;11785;33624;0;107;42551497;41321811;25694191;794932;42456841;27898856;960447;0;1601
FR;1;2022-04-22;1527;3094;15219;35528;1927;14803;36719;0;121;42553024;41324905;25709410;830460;42458768;27913659;997166;0;1722
FR;1;2022-04-23;767;1591;6738;9894;928;6644;10578;0;30;42553791;41326496;25716148;840354;42459696;27920303;1007744;0;1752
FR;1;2022-04-24;195;378;1376;1524;242;1329;1749;0;7;42553986;41326874;25717524;841878;42459938;27921632;1009493;0;1759
FR;1;2022-04-25;1042;2133;9858;19736;1255;9758;20558;0;64;42555028;41329007;25727382;861614;42461193;27931390;1030051;0;1823
FR;1;2022-04-26;1351;2627;12608;36640;1608;12207;37228;0;163;42556379;41331634;25739990;898254;42462801;27943597;1067279;0;1986
FR;1;2022-04-27;1331;2411;10655;29292;1471;10791;29677;0;123;42557710;41334045;25750645;927546;42464272;27954388;1096956;0;2109
FR;1;2022-04-28;1285;2423;11565;34331;1530;11406;34481;0;127;42558995;41336468;25762210;961877;42465802;27965794;1131437;0;2236
FR;1;2022-04-29;1616;4296;14407;35563;3169;13860;36852;0;153;42560611;41340764;25776617;997440;42468971;27979654;1168289;0;2389
FR;1;2022-04-30;841;4335;6448;9173;3762;6292;9974;0;35;42561452;41345099;25783065;1006613;42472733;27985946;1178263;0;2424
FR;1;2022-05-01;179;288;832;951;190;826;1080;0;5;42561631;41345387;25783897;1007564;42472923;27986772;1179343;0;2429
FR;1;2022-05-02;2098;2629;10383;16956;1784;10308;17637;0;64;42563729;41348016;25794280;1024520;42474707;27997080;1196980;0;2493
FR;1;2022-05-03;1689;2880;12712;32916;1764;12604;33715;0;149;42565418;41350896;25806992;1057436;42476471;28009684;1230695;0;2642
FR;1;2022-05-04;1384;2751;11235;23825;1696;11396;24365;0;96;42566802;41353647;25818227;1081261;42478167;28021080;1255060;0;2738
FR;1;2022-05-05;1501;2739;12201;31862;1723;12124;32410;0;170;42568303;41356386;25830428;1113123;42479890;28033204;1287470;0;2908
FR;1;2022-05-06;1823;3243;14246;34957;1919;13833;36216;0;166;42570126;41359629;25844674;1148080;42481809;28047037;1323686;0;3074
FR;1;2022-05-07;860;1473;5979;9097;878;6013;9731;0;44;42570986;41361102;25850653;1157177;42482687;28053050;1333417;0;3118
FR;1;2022-05-08;190;329;1062;1472;221;1124;1548;0;8;42571176;41361431;25851715;1158649;42482908;28054174;1334965;0;3126
FR;1;2022-05-09;1168;2020;9249;19262;1160;9164;20034;0;93;42572344;41363451;25860964;1177911;42484068;28063338;1354999;0;3219
FR;1;2022-05-10;1513;3050;12620;37145;1961;12219;38043;0;177;42573857;41366501;25873584;1215056;42486029;28075557;1393042;0;3396
FR;1;2022-05-11;1440;2480;9913;26043;1698;9860;26561;0;138;42575297;41368981;25883497;1241099;42487727;28085417;1419603;0;3534
FR;1;2022-05-12;1326;2458;10530;33654;1550;10230;34300;0;188;42576623;41371439;25894027;1274753;42489277;28095647;1453903;0;3722
FR;1;2022-05-13;1620;2808;12770;35855;1688;12418;36950;0;149;42578243;41374247;25906797;1310608;42490965;28108065;1490853;0;3871
FR;1;2022-05-14;783;1331;5481;10217;817;5365;10732;0;52;42579026;41375578;25912278;1320825;42491782;28113430;1501585;0;3923
FR;1;2022-05-15;223;423;1182;1352;247;1252;1497;0;5;42579249;41376001;25913460;1322177;42492029;28114682;1503082;0;3928
FR;1;2022-05-16;972;1786;8082;20138;1005;8146;20550;0;117;42580221;41377787;25921542;1342315;42493034;28122828;1523632;0;4045
FR;1;2022-05-17;1298;2303;11126;36187;1387;10730;36973;0;172;42581519;41380090;25932668;1378502;42494421;28133558;1560605;0;4217
FR;1;2022-05-18;1313;2137;9042;25730;1369;8991;26290;0;99;42582832;41382227;25941710;1404232;42495790;28142549;1586895;0;4316
FR;1;2022-05-19;1207;2404;9856;34005;1415;9951;34208;0;150;42584039;41384631;25951566;1438237;42497205;28152500;1621103;0;4466
FR;1;2022-05-20;1563;2757;12533;37655;1721;12113;38516;0;151;42585602;41387388;25964099;1475892;42498926;28164613;1659619;0;4617
FR;1;2022-05-21;775;1387;5247;9374;880;5164;9944;0;37;42586377;41388775;25969346;1485266;42499806;28169777;1669563;0;4654
FR;1;2022-05-22;194;292;955;1398;204;953;1522;0;10;42586571;41389067;25970301;1486664;42500010;28170730;1671085;0;4664
FR;1;2022-05-23;971;1891;8372;19439;1179;8348;20056;0;79;42587542;41390958;25978673;1506103;42501189;28179078;1691141;0;4743
FR;1;2022-05-24;1289;2448;10728;37252;1440;10598;37825;0;173;42588831;41393406;25989401;1543355;42502629;28189676;1728966;0;4916
FR;1;2022-05-25;1272;2305;8793;23694;1430;8957;24056;0;111;42590103;41395711;25998194;1567049;42504059;28198633;1753022;0;5027
FR;1;2022-05-26;175;385;1585;1155;261;1580;1288;0;24;42590278;41396096;25999779;1568204;42504320;28200213;1754310;0;5051
FR;1;2022-05-27;1120;2192;8790;20457;1377;8538;21410;0;84;42591398;41398288;26008569;1588661;42505697;28208751;1775720;0;5135
FR;1;2022-05-28;486;1059;3692;6543;627;3729;6930;0;37;42591884;41399347;26012261;1595204;42506324;28212480;1782650;0;5172
FR;1;2022-05-29;121;257;708;896;149;719;1005;0;4;42592005;41399604;26012969;1596100;42506473;28213199;1783655;0;5176
FR;1;2022-05-30;832;1745;6559;18536;1046;6592;18990;0;85;42592837;41401349;26019528;1614636;42507519;28219791;1802645;0;5261
FR;1;2022-05-31;1266;2241;9248;34376;1372;9118;34976;0;159;42594103;41403590;26028776;1649012;42508891;28228909;1837621;0;5420
FR;1;2022-06-01;1336;2605;10439;23460;1752;10302;24307;0;116;42595439;41406195;26039215;1672472;42510643;28239211;1861928;0;5536
FR;1;2022-06-02;1228;2309;10670;34153;1450;10248;34986;0;162;42596667;41408504;26049885;1706625;42512093;28249459;1896914;0;5698
FR;1;2022-06-03;1447;2749;12735;37113;1740;12156;38289;0;157;42598114;41411253;26062620;1743738;42513833;28261615;1935203;0;5855
FR;1;2022-06-04;686;1263;4750;8678;760;4826;9168;0;62;42598800;41412516;26067370;1752416;42514593;28266441;1944371;0;5917
FR;1;2022-06-05;134;293;811;1049;151;835;1154;0;3;42598934;41412809;26068181;1753465;42514744;28267276;1945525;0;5920
FR;1;2022-06-06;851;1196;2028;1252;1020;2047;1427;0;9;42599785;41414005;26070209;1754717;42515764;28269323;1946952;0;5929
FR;1;2022-06-07;1264;2343;9186;34056;1440;8846;35155;0;143;42601049;41416348;26079395;1788773;42517204;28278169;1982107;0;6072
FR;1;2022-06-08;1140;2240;8682;27615;1403;8566;28486;0;107;42602189;41418588;26088077;1816388;42518607;28286735;2010593;0;6179
FR;1;2022-06-09;1076;2152;9988;37576;1283;9673;38343;0;148;42603265;41420740;26098065;1853964;42519890;28296408;2048936;0;6327
FR;1;2022-06-10;1337;2862;12426;43134;1825;12017;44363;0;200;42604602;41423602;26110491;1897098;42521715;28308425;2093299;0;6527
FR;1;2022-06-11;661;1451;5136;11085;798;5185;11614;0;50;42605263;41425053;26115627;1908183;42522513;28313610;2104913;0;6577
FR;1;2022-06-12;158;377;1019;1687;189;1077;1788;0;11;42605421;41425430;26116646;1909870;42522702;28314687;2106701;0;6588
FR;1;2022-06-13;951;1841;7015;22226;1136;6872;23067;0;84;42606372;41427271;26123661;1932096;42523838;28321559;2129768;0;6672
FR;1;2022-06-14;1118;2234;9841;42852;1312;9247;43943;0;186;42607490;41429505;26133502;1974948;42525150;28330806;2173711;0;6858
FR;1;2022-06-15;1095;2013;8788;29396;1364;8476;29944;0;170;42608585;41431518;26142290;2004344;42526514;28339282;2203655;0;7028
FR;1;2022-06-16;959;1840;9405;38510;1061;8883;39417;0;188;42609544;41433358;26151695;2042854;42527575;28348165;2243072;0;7216
FR;1;2022-06-17;1229;2568;11916;44864;1483;11382;46004;0;224;42610773;41435926;26163611;2087718;42529058;28359547;2289076;0;7440
FR;1;2022-06-18;564;1277;4320;10544;717;4258;11087;0;62;42611337;41437203;26167931;2098262;42529775;28363805;2300163;0;7502
FR;1;2022-06-19;137;325;1003;1543;173;1082;1609;0;12;42611474;41437528;26168934;2099805;42529948;28364887;2301772;0;7514
FR;1;2022-06-20;861;1710;8493;25050;1009;8157;25911;0;146;42612335;41439238;26177427;2124855;42530957;28373044;2327683;0;7660
FR;1;2022-06-21;1104;2140;9765;47760;1254;8856;49105;0;241;42613439;41441378;26187192;2172615;42532211;28381900;2376788;0;7901
FR;1;2022-06-22;1046;2074;8442;37163;1302;7963;38023;0;231;42614485;41443452;26195634;2209778;42533513;28389863;2414811;0;8132
FR;1;2022-06-23;1054;2182;10126;52819;1211;9409;53828;0;290;42615539;41445634;26205760;2262597;42534724;28399272;2468639;0;8422
FR;1;2022-06-24;1256;2720;12917;65968;1487;11702;67640;0;367;42616795;41448354;26218677;2328565;42536211;28410974;2536279;0;8789
FR;1;2022-06-25;685;1506;5930;18924;792;5712;19723;0;163;42617480;41449860;26224607;2347489;42537003;28416686;2556002;0;8952
FR;1;2022-06-26;167;406;1817;3494;191;1713;3730;0;34;42617647;41450266;26226424;2350983;42537194;28418399;2559732;0;8986
FR;1;2022-06-27;945;1777;9901;45985;943;9127;47120;0;300;42618592;41452043;26236325;2396968;42538137;28427526;2606852;0;9286
FR;1;2022-06-28;1216;2576;13844;86597;1382;12406;88283;0;570;42619808;41454619;26250169;2483565;42539519;28439932;2695135;0;9856
FR;1;2022-06-29;1243;2297;11483;67405;1261;10550;68450;0;487;42621051;41456916;26261652;2550970;42540780;28450482;2763585;0;10343
FR;1;2022-06-30;1291;2487;13518;89968;1438;11829;91769;0;645;42622342;41459403;26275170;2640938;42542218;28462311;2855354;0;10988
FR;1;2022-07-01;1659;3483;20317;109201;1992;17974;111597;0;859;42624001;41462886;26295487;2750139;42544210;28480285;2966951;0;11847
FR;1;2022-07-02;770;1527;8025;33776;751;7254;34802;0;315;42624771;41464413;26303512;2783915;42544961;28487539;3001753;0;12162
FR;1;2022-07-03;230;480;1943;6119;258;1759;6445;0;71;42625001;41464893;26305455;2790034;42545219;28489298;3008198;0;12233
FR;1;2022-07-04;1681;3178;13933;75423;2063;12360;77312;0;589;42626682;41468071;26319388;2865457;42547282;28501658;3085510;0;12822
FR;1;2022-07-05;1507;2858;17696;126387;1512;15153;128500;0;1060;42628189;41470929;26337084;2991844;42548794;28516811;3214010;0;13882
FR;1;2022-07-06;1379;2410;14890;93749;1389;12914;95185;0;815;42629568;41473339;26351974;3085593;42550183;28529725;3309195;0;14697
FR;1;2022-07-07;1447;2538;16939;119493;1406;14009;121588;0;1074;42631015;41475877;26368913;3205086;42551589;28543734;3430783;0;15771
FR;1;2022-07-08;1534;2823;19612;130008;1541;15975;132812;0;1220;42632549;41478700;26388525;3335094;42553130;28559709;3563595;0;16991
FR;1;2022-07-09;663;1281;7311;36022;699;6354;36809;0;392;42633212;41479981;26395836;3371116;42553829;28566063;3600404;0;17383
FR;1;2022-07-10;245;657;2240;6689;412;2032;7068;0;89;42633457;41480638;26398076;3377805;42554241;28568095;3607472;0;17472
FR;1;2022-07-11;1242;2246;14320;84458;1181;11942;86568;0;734;42634699;41482884;26412396;3462263;42555422;28580037;3694040;0;18206
FR;1;2022-07-12;1605;2806;19465;137424;1441;15905;139914;0;1485;42636304;41485690;26431861;3599687;42556863;28595942;3833954;0;19691
FR;1;2022-07-13;1462;2442;14791;89837;1319;12644;91522;0;1002;42637766;41488132;26446652;3689524;42558182;28608586;3925476;0;20693
FR;1;2022-07-14;163;351;1866;5290;196;1775;5437;0;74;42637929;41488483;26448518;3694814;42558378;28610361;3930913;0;20767
FR;1;2022-07-15;1267;2319;14364;80599;1206;12007;82603;0;960;42639196;41490802;26462882;3775413;42559584;28622368;4013516;0;21727
FR;1;2022-07-16;514;1064;5640;23949;556;4893;24590;0;302;42639710;41491866;26468522;3799362;42560140;28627261;4038106;0;22029
FR;1;2022-07-17;163;369;1656;4464;193;1501;4727;0;60;42639873;41492235;26470178;3803826;42560333;28628762;4042833;0;22089
FR;1;2022-07-18;975;2037;11302;59281;1148;9572;61005;0;715;42640848;41494272;26481480;3863107;42561481;28638334;4103838;0;22804
FR;1;2022-07-19;1235;2132;14695;99429;1196;11727;101426;0;1386;42642083;41496404;26496175;3962536;42562677;28650061;4205264;0;24190
FR;1;2022-07-20;1185;2007;12376;74374;1173;10287;75859;0;964;42643268;41498411;26508551;4036910;42563850;28660348;4281123;0;25154
FR;1;2022-07-21;1138;1955;12418;84547;1189;9994;85912;0;1211;42644406;41500366;26520969;4121457;42565039;28670342;4367035;0;26365
FR;1;2022-07-22;1274;2246;14112;85964;1260;11434;87689;0;1264;42645680;41502612;26535081;4207421;42566299;28681776;4454724;0;27629
FR;1;2022-07-23;549;1093;5238;21296;634;4611;21842;0;373;42646229;41503705;26540319;4228717;42566933;28686387;4476566;0;28002
FR;1;2022-07-24;149;306;1328;3700;153;1169;3925;0;65;42646378;41504011;26541647;4232417;42567086;28687556;4480491;0;28067
FR;1;2022-07-25;891;1634;9076;46124;984;7526;47497;0;680;42647269;41505645;26550723;4278541;42568070;28695082;4527988;0;28747
FR;1;2022-07-26;1136;1964;12682;81968;1120;10336;83583;0;1198;42648405;41507609;26563405;4360509;42569190;28705418;4611571;0;29945
FR;1;2022-07-27;1021;1730;9760;58521;1047;8138;59702;0;874;42649426;41509339;26573165;4419030;42570237;28713556;4671273;0;30819
FR;1;2022-07-28;983;1706;9857;61925;1114;7856;63149;0;967;42650409;41511045;26583022;4480955;42571351;28721412;4734422;0;31786
FR;1;2022-07-29;1112;1845;10461;62991;1171;8385;64305;0;1066;42651521;41512890;26593483;4543946;42572522;28729797;4798727;0;32852
FR;1;2022-07-30;395;727;3349;14491;442;2850;14851;0;279;42651916;41513617;26596832;4558437;42572964;28732647;4813578;0;33131
FR;1;2022-07-31;141;264;900;2335;159;766;2477;0;47;42652057;41513881;26597732;4560772;42573123;28733413;4816055;0;33178
FR;1;2022-08-01;885;1474;7259;28968;1088;6121;29961;0;519;42652942;41515355;26604991;4589740;42574211;28739534;4846016;0;33697
FR;1;2022-08-02;931;1486;8239;54049;1001;6634;54688;0;1091;42653873;41516841;26613230;4643789;42575212;28746168;4900704;0;34788
FR;1;2022-08-03;738;1108;6157;37046;753;4939;37776;0;645;42654611;41517949;26619387;4680835;42575965;28751107;4938480;0;35433
FR;1;2022-08-04;651;1081;6264;41453;697;5058;42008;0;850;42655262;41519030;26625651;4722288;42576662;28756165;4980488;0;36283
FR;1;2022-08-05;745;1198;6766;43085;809;5436;43708;0;933;42656007;41520228;26632417;4765373;42577471;28761601;5024196;0;37216
FR;1;2022-08-06;277;466;1993;9000;306;1674;9192;0;218;42656284;41520694;26634410;4774373;42577777;28763275;5033388;0;37434
FR;1;2022-08-07;89;151;520;1558;107;436;1631;0;35;42656373;41520845;26634930;4775931;42577884;28763711;5035019;0;37469
FR;1;2022-08-08;603;1078;3807;21229;833;3141;21627;0;457;42656976;41521923;26638737;4797160;42578717;28766852;5056646;0;37926
FR;1;2022-08-09;669;1056;5683;38481;747;4558;38967;0;794;42657645;41522979;26644420;4835641;42579464;28771410;5095613;0;38720
FR;1;2022-08-10;571;1186;4435;26915;887;3636;27228;0;601;42658216;41524165;26648855;4862556;42580351;28775046;5122841;0;39321
FR;1;2022-08-11;566;920;4315;28212;632;3589;28540;0;634;42658782;41525085;26653170;4890768;42580983;28778635;5151381;0;39955
FR;1;2022-08-12;732;1044;4554;27171;720;3762;27583;0;668;42659514;41526129;26657724;4917939;42581703;28782397;5178964;0;40623
FR;1;2022-08-13;326;371;1248;5111;263;1066;5282;0;116;42659840;41526500;26658972;4923050;42581966;28783463;5184246;0;40739
FR;1;2022-08-14;67;115;277;871;96;236;941;0;24;42659907;41526615;26659249;4923921;42582062;28783699;5185187;0;40763
FR;1;2022-08-15;112;216;574;542;185;535;593;0;16;42660019;41526831;26659823;4924463;42582247;28784234;5185780;0;40779
FR;1;2022-08-16;551;953;3792;21491;712;3221;21692;0;582;42660570;41527784;26663615;4945954;42582959;28787455;5207472;0;41361
FR;1;2022-08-17;549;915;3769;22152;682;3195;22390;0;579;42661119;41528699;26667384;4968106;42583641;28790650;5229862;0;41940
FR;1;2022-08-18;562;899;3942;25455;700;3141;25677;0;630;42661681;41529598;26671326;4993561;42584341;28793791;5255539;0;42570
FR;1;2022-08-19;538;1050;4369;26547;749;3601;26855;0;732;42662219;41530648;26675695;5020108;42585090;28797392;5282394;0;43302
FR;1;2022-08-20;251;422;1290;5371;322;1107;5524;0;138;42662470;41531070;26676985;5025479;42585412;28798499;5287918;0;43440
FR;1;2022-08-21;84;112;287;990;77;253;1013;0;27;42662554;41531182;26677272;5026469;42585489;28798752;5288931;0;43467
FR;1;2022-08-22;511;900;3142;14956;673;2714;15232;0;411;42663065;41532082;26680414;5041425;42586162;28801466;5304163;0;43878
FR;1;2022-08-23;656;1064;4155;28323;748;3486;28405;0;830;42663721;41533146;26684569;5069748;42586910;28804952;5332568;0;44708
FR;1;2022-08-24;569;839;3405;19069;661;2774;19254;0;587;42664290;41533985;26687974;5088817;42587571;28807726;5351822;0;45295
FR;1;2022-08-25;565;937;3832;22919;654;3215;23148;0;655;42664855;41534922;26691806;5111736;42588225;28810941;5374970;0;45950
FR;1;2022-08-26;754;1137;4350;25157;810;3568;25532;0;745;42665609;41536059;26696156;5136893;42589035;28814509;5400502;0;46695
FR;1;2022-08-27;223;432;1324;5308;277;1191;5362;0;192;42665832;41536491;26697480;5142201;42589312;28815700;5405864;0;46887
FR;1;2022-08-28;113;147;298;900;106;280;949;0;33;42665945;41536638;26697778;5143101;42589418;28815980;5406813;0;46920
FR;1;2022-08-29;507;861;2979;14272;638;2519;14582;0;409;42666452;41537499;26700757;5157373;42590056;28818499;5421395;0;47329
FR;1;2022-08-30;746;1111;4626;27721;788;3776;28042;0;793;42667198;41538610;26705383;5185094;42590844;28822275;5449437;0;48122
FR;1;2022-08-31;587;835;3114;17243;614;2624;17505;0;483;42667785;41539445;26708497;5202337;42591458;28824899;5466942;0;48605
FR;1;2022-09-01;707;927;4333;21897;653;3693;22150;0;587;42668492;41540372;26712830;5224234;42592111;28828592;5489092;0;49192
FR;1;2022-09-02;901;1063;4887;27868;762;4084;28156;0;882;42669393;41541435;26717717;5252102;42592873;28832676;5517248;0;50074
FR;1;2022-09-03;322;511;1834;5876;349;1596;6105;0;174;42669715;41541946;26719551;5257978;42593222;28834272;5523353;0;50248
FR;1;2022-09-04;110;137;341;845;73;334;915;0;21;42669825;41542083;26719892;5258823;42593295;28834606;5524268;0;50269
FR;1;2022-09-05;731;873;3051;15698;697;2557;15982;0;499;42670556;41542956;26722943;5274521;42593992;28837163;5540250;0;50768
FR;1;2022-09-06;850;965;4572;31064;612;3712;31285;0;1002;42671406;41543921;26727515;5305585;42594604;28840875;5571535;0;51770
FR;1;2022-09-07;608;708;2921;16444;469;2426;16582;0;550;42672014;41544629;26730436;5322029;42595073;28843301;5588117;0;52320
FR;1;2022-09-08;585;796;3701;24224;543;3041;24305;0;796;42672599;41545425;26734137;5346253;42595616;28846342;5612422;0;53116
FR;1;2022-09-09;783;993;4307;26897;635;3597;27078;0;903;42673382;41546418;26738444;5373150;42596251;28849939;5639500;0;54019
FR;1;2022-09-10;351;579;1680;5590;410;1480;5782;0;203;42673733;41546997;26740124;5378740;42596661;28851419;5645282;0;54222
FR;1;2022-09-11;106;120;313;646;82;293;703;0;17;42673839;41547117;26740437;5379386;42596743;28851712;5645985;0;54239
FR;1;2022-09-12;485;605;2617;12955;426;2234;13235;0;462;42674324;41547722;26743054;5392341;42597169;28853946;5659220;0;54701
FR;1;2022-09-13;651;831;3872;25850;542;3385;25721;0;834;42674975;41548553;26746926;5418191;42597711;28857331;5684941;0;55535
FR;1;2022-09-14;626;725;2881;15702;509;2412;15938;0;537;42675601;41549278;26749807;5433893;42598220;28859743;5700879;0;56072
FR;1;2022-09-15;532;778;3345;23093;550;2851;23157;0;679;42676133;41550056;26753152;5456986;42598770;28862594;5724036;0;56751
FR;1;2022-09-16;726;947;4021;25351;630;3393;25550;0;891;42676859;41551003;26757173;5482337;42599400;28865987;5749586;0;57642
FR;1;2022-09-17;303;428;1397;5979;300;1222;6087;0;227;42677162;41551431;26758570;5488316;42599700;28867209;5755673;0;57869
FR;1;2022-09-18;99;126;310;924;103;278;980;0;34;42677261;41551557;26758880;5489240;42599803;28867487;5756653;0;57903
FR;1;2022-09-19;400;577;2142;12864;379;1837;13018;0;414;42677661;41552134;26761022;5502104;42600182;28869324;5769671;0;58317
FR;1;2022-09-20;564;841;3670;25830;589;3067;25870;0;854;42678225;41552975;26764692;5527934;42600771;28872391;5795541;0;59171
FR;1;2022-09-21;485;691;2628;15863;491;2256;15827;0;561;42678710;41553666;26767320;5543797;42601262;28874647;5811368;0;59732
FR;1;2022-09-22;549;778;3297;22998;517;2706;23176;0;745;42679259;41554444;26770617;5566795;42601779;28877353;5834544;0;60477
FR;1;2022-09-23;767;946;4353;28164;681;3634;28327;0;981;42680026;41555390;26774970;5594959;42602460;28880987;5862871;0;61458
FR;1;2022-09-24;356;540;1591;6706;379;1374;6880;0;300;42680382;41555930;26776561;5601665;42602839;28882361;5869751;0;61758
FR;1;2022-09-25;81;157;321;1072;111;293;1110;0;32;42680463;41556087;26776882;5602737;42602950;28882654;5870861;0;61790
FR;1;2022-09-26;382;654;2183;13078;432;1935;13172;0;412;42680845;41556741;26779065;5615815;42603382;28884589;5884033;0;62202
FR;1;2022-09-27;545;768;3458;25025;542;2794;25223;0;906;42681390;41557509;26782523;5640840;42603924;28887383;5909256;0;63108
FR;1;2022-09-28;525;720;2448;14971;507;2217;15060;0;597;42681915;41558229;26784971;5655811;42604431;28889600;5924316;0;63705
FR;1;2022-09-29;504;699;3003;20371;488;2527;20387;0;767;42682419;41558928;26787974;5676182;42604919;28892127;5944703;0;64472
FR;1;2022-09-30;694;996;3778;24429;705;3161;24678;0;970;42683113;41559924;26791752;5700611;42605624;28895288;5969381;0;65442
FR;1;2022-10-01;352;648;1905;5507;484;1659;5733;0;273;42683465;41560572;26793657;5706118;42606108;28896947;5975114;0;65715
FR;1;2022-10-02;56;120;204;568;82;204;589;0;29;42683521;41560692;26793861;5706686;42606190;28897151;5975703;0;65744
FR;1;2022-10-03;575;880;2226;10042;725;1986;10210;0;489;42684096;41561572;26796087;5716728;42606915;28899137;5985913;0;66233
FR;1;2022-10-04;683;739;2930;18922;507;2482;19010;0;1086;42684779;41562311;26799017;5735650;42607422;28901619;6004923;0;67319
FR;1;2022-10-05;488;727;2099;11114;501;1872;11243;0;723;42685267;41563038;26801116;5746764;42607923;28903491;6016166;0;68042
FR;1;2022-10-06;452;644;2498;15778;466;2063;15959;0;1063;42685719;41563682;26803614;5762542;42608389;28905554;6032125;0;69105
FR;1;2022-10-07;559;774;2694;16069;572;2311;16092;0;1164;42686278;41564456;26806308;5778611;42608961;28907865;6048217;0;70269
FR;1;2022-10-08;242;315;888;3171;248;776;3276;0;292;42686520;41564771;26807196;5781782;42609209;28908641;6051493;0;70561
FR;1;2022-10-09;76;93;151;461;83;135;487;0;51;42686596;41564864;26807347;5782243;42609292;28908776;6051980;0;70612
FR;1;2022-10-10;315;577;1324;4999;484;1240;5096;0;463;42686911;41565441;26808671;5787242;42609776;28910016;6057076;0;71075
FR;1;2022-10-11;339;457;1316;8087;343;1198;8188;0;758;42687250;41565898;26809987;5795329;42610119;28911214;6065264;0;71833
FR;1;2022-10-12;347;481;1078;5223;367;1076;5240;0;522;42687597;41566379;26811065;5800552;42610486;28912290;6070504;0;72355
FR;1;2022-10-13;338;450;1079;6099;360;936;6146;0;630;42687935;41566829;26812144;5806651;42610846;28913226;6076650;0;72985
FR;1;2022-10-14;413;554;1176;6712;468;1050;6781;0;676;42688348;41567383;26813320;5813363;42611314;28914276;6083431;0;73661
FR;1;2022-10-15;212;350;532;1860;302;515;1868;0;226;42688560;41567733;26813852;5815223;42611616;28914791;6085299;0;73887
FR;1;2022-10-16;47;68;111;296;49;118;315;0;48;42688607;41567801;26813963;5815519;42611665;28914909;6085614;0;73935
FR;1;2022-10-17;237;336;742;2653;268;698;2698;0;366;42688844;41568137;26814705;5818172;42611933;28915607;6088312;0;74301
FR;1;2022-10-18;266;319;956;4596;257;833;4700;0;866;42689110;41568456;26815661;5822768;42612190;28916440;6093012;0;75167
FR;1;2022-10-19;286;406;698;3187;339;667;3166;0;504;42689396;41568862;26816359;5825955;42612529;28917107;6096178;0;75671
FR;1;2022-10-20;289;357;903;4369;304;795;4404;0;771;42689685;41569219;26817262;5830324;42612833;28917902;6100582;0;76442
FR;1;2022-10-21;304;421;847;3807;372;743;3879;0;675;42689989;41569640;26818109;5834131;42613205;28918645;6104461;0;77117
FR;1;2022-10-22;135;184;306;1253;163;300;1218;0;210;42690124;41569824;26818415;5835384;42613368;28918945;6105679;0;77327
FR;1;2022-10-23;34;43;65;197;41;59;213;0;25;42690158;41569867;26818480;5835581;42613409;28919004;6105892;0;77352
FR;1;2022-10-24;273;237;479;1603;205;476;1660;0;306;42690431;41570104;26818959;5837184;42613614;28919480;6107552;0;77658
FR;1;2022-10-25;223;258;528;2651;227;449;2707;0;487;42690654;41570362;26819487;5839835;42613841;28919929;6110259;0;78145
FR;1;2022-10-26;236;251;394;1958;240;371;1965;0;439;42690890;41570613;26819881;5841793;42614081;28920300;6112224;0;78584
FR;1;2022-10-27;260;235;490;2167;207;509;2151;0;518;42691150;41570848;26820371;5843960;42614288;28920809;6114375;0;79102
FR;1;2022-10-28;313;336;534;2335;316;471;2402;0;478;42691463;41571184;26820905;5846295;42614604;28921280;6116777;0;79580
FR;1;2022-10-29;99;159;176;717;129;210;709;0;203;42691562;41571343;26821081;5847012;42614733;28921490;6117486;0;79783
FR;1;2022-10-30;38;52;62;184;44;56;189;0;38;42691600;41571395;26821143;5847196;42614777;28921546;6117675;0;79821
FR;1;2022-10-31;135;189;295;796;168;273;863;0;143;42691735;41571584;26821438;5847992;42614945;28921819;6118538;0;79964
FR;1;2022-11-01;77;135;768;115;117;768;134;0;19;42691812;41571719;26822206;5848107;42615062;28922587;6118672;0;79983
FR;1;2022-11-02;269;246;531;985;242;497;1048;0;356;42692081;41571965;26822737;5849092;42615304;28923084;6119720;0;80339
FR;1;2022-11-03;272;238;442;1380;223;404;1418;0;377;42692353;41572203;26823179;5850472;42615527;28923488;6121138;0;80716
FR;1;2022-11-04;233;262;424;1597;242;401;1637;0;438;42692586;41572465;26823603;5852069;42615769;28923889;6122775;0;81154
FR;1;2022-11-05;100;147;273;503;136;255;525;0;111;42692686;41572612;26823876;5852572;42615905;28924144;6123300;0;81265
FR;1;2022-11-06;36;49;32;131;48;35;129;0;33;42692722;41572661;26823908;5852703;42615953;28924179;6123429;0;81298
FR;1;2022-11-07;226;288;326;899;276;319;944;0;212;42692948;41572949;26824234;5853602;42616229;28924498;6124373;0;81510
FR;1;2022-11-08;240;268;472;1709;256;417;1738;0;524;42693188;41573217;26824706;5855311;42616485;28924915;6126111;0;82034
FR;1;2022-11-09;197;257;337;1104;247;303;1141;0;477;42693385;41573474;26825043;5856415;42616732;28925218;6127252;0;82511
FR;1;2022-11-10;216;394;437;1681;386;445;1670;0;605;42693601;41573868;26825480;5858096;42617118;28925663;6128922;0;83116
FR;1;2022-11-11;34;48;105;101;45;92;115;0;44;42693635;41573916;26825585;5858197;42617163;28925755;6129037;0;83160
FR;1;2022-11-12;95;152;257;375;138;257;390;0;101;42693730;41574068;26825842;5858572;42617301;28926012;6129427;0;83261
FR;1;2022-11-13;27;57;28;64;54;31;66;0;26;42693757;41574125;26825870;5858636;42617355;28926043;6129493;0;83287
FR;1;2022-11-14;175;184;271;768;172;275;838;0;235;42693932;41574309;26826141;5859404;42617527;28926318;6130331;0;83522
FR;1;2022-11-15;228;406;394;1300;405;372;1338;0;436;42694160;41574715;26826535;5860704;42617932;28926690;6131669;0;83958
FR;1;2022-11-16;197;273;336;983;267;350;1017;0;359;42694357;41574988;26826871;5861687;42618199;28927040;6132686;0;84317
FR;1;2022-11-17;171;212;297;1207;206;273;1211;0;388;42694528;41575200;26827168;5862894;42618405;28927313;6133897;0;84705
FR;1;2022-11-18;231;269;394;1315;261;383;1349;0;411;42694759;41575469;26827562;5864209;42618666;28927696;6135246;0;85116
FR;1;2022-11-19;120;115;249;441;114;214;474;0;102;42694879;41575584;26827811;5864650;42618780;28927910;6135720;0;85218
FR;1;2022-11-20;35;129;32;66;125;34;74;0;28;42694914;41575713;26827843;5864716;42618905;28927944;6135794;0;85246
FR;1;2022-11-21;174;173;271;641;146;288;678;0;211;42695088;41575886;26828114;5865357;42619051;28928232;6136472;0;85457
FR;1;2022-11-22;158;169;417;1160;152;398;1185;0;409;42695246;41576055;26828531;5866517;42619203;28928630;6137657;0;85866
FR;1;2022-11-23;180;186;246;763;171;247;786;0;241;42695426;41576241;26828777;5867280;42619374;28928877;6138443;0;86107
FR;1;2022-11-24;138;171;288;1213;151;301;1216;0;442;42695564;41576412;26829065;5868493;42619525;28929178;6139659;0;86549
FR;1;2022-11-25;210;249;429;1159;235;418;1191;0;392;42695774;41576661;26829494;5869652;42619760;28929596;6140850;0;86941
FR;1;2022-11-26;90;109;113;323;101;125;311;0;118;42695864;41576770;26829607;5869975;42619861;28929721;6141161;0;87059
FR;1;2022-11-27;18;38;22;72;25;34;78;0;49;42695882;41576808;26829629;5870047;42619886;28929755;6141239;0;87108
FR;1;2022-11-28;212;147;209;665;155;205;709;0;332;42696094;41576955;26829838;5870712;42620041;28929960;6141948;0;87440
FR;1;2022-11-29;172;145;269;1107;130;251;1119;0;458;42696266;41577100;26830107;5871819;42620171;28930211;6143067;0;87898
FR;1;2022-11-30;161;211;235;940;197;238;962;0;325;42696427;41577311;26830342;5872759;42620368;28930449;6144029;0;88223
FR;1;2022-12-01;199;162;716;1097;150;681;1146;0;379;42696626;41577473;26831058;5873856;42620518;28931130;6145175;0;88602
FR;1;2022-12-02;201;199;517;1187;194;513;1236;0;471;42696827;41577672;26831575;5875043;42620712;28931643;6146411;0;89073
FR;1;2022-12-03;102;112;263;532;100;240;530;0;180;42696929;41577784;26831838;5875575;42620812;28931883;6146941;0;89253
FR;1;2022-12-04;27;28;19;138;25;20;129;0;58;42696956;41577812;26831857;5875713;42620837;28931903;6147070;0;89311
FR;1;2022-12-05;148;171;308;868;167;303;902;0;318;42697104;41577983;26832165;5876581;42621004;28932206;6147972;0;89629
FR;1;2022-12-06;156;176;277;1449;162;282;1455;0;739;42697260;41578159;26832442;5878030;42621166;28932488;6149427;0;90368
FR;1;2022-12-07;155;173;256;1187;182;236;1203;0;576;42697415;41578332;26832698;5879217;42621348;28932724;6150630;0;90944
FR;1;2022-12-08;131;145;302;1757;137;259;1798;0;765;42697546;41578477;26833000;5880974;42621485;28932983;6152428;0;91709
FR;1;2022-12-09;202;197;357;1815;170;365;1836;0;721;42697748;41578674;26833357;5882789;42621655;28933348;6154264;0;92430
FR;1;2022-12-10;117;154;341;856;141;324;877;0;292;42697865;41578828;26833698;5883645;42621796;28933672;6155141;0;92722
FR;1;2022-12-11;32;30;32;219;27;30;201;0;62;42697897;41578858;26833730;5883864;42621823;28933702;6155342;0;92784
FR;1;2022-12-12;130;108;297;1101;105;284;1113;0;459;42698027;41578966;26834027;5884965;42621928;28933986;6156455;0;93243
FR;1;2022-12-13;126;134;293;1307;108;268;1321;0;618;42698153;41579100;26834320;5886272;42622036;28934254;6157776;0;93861
FR;1;2022-12-14;105;160;256;867;154;235;892;0;372;42698258;41579260;26834576;5887139;42622190;28934489;6158668;0;94233
FR;1;2022-12-15;140;183;457;1492;170;427;1518;0;691;42698398;41579443;26835033;5888631;42622360;28934916;6160186;0;94924
FR;1;2022-12-16;206;217;569;1344;220;553;1367;0;623;42698604;41579660;26835602;5889975;42622580;28935469;6161553;0;95547
FR;1;2022-12-17;88;93;224;468;82;219;476;0;204;42698692;41579753;26835826;5890443;42622662;28935688;6162029;0;95751
FR;1;2022-12-18;17;22;29;113;19;31;109;0;37;42698709;41579775;26835855;5890556;42622681;28935719;6162138;0;95788
FR;1;2022-12-19;151;133;251;791;141;221;835;0;382;42698860;41579908;26836106;5891347;42622822;28935940;6162973;0;96170
FR;1;2022-12-20;149;163;355;906;150;349;912;0;428;42699009;41580071;26836461;5892253;42622972;28936289;6163885;0;96598
FR;1;2022-12-21;139;112;218;638;122;183;647;0;388;42699148;41580183;26836679;5892891;42623094;28936472;6164532;0;96986
FR;1;2022-12-22;148;111;165;552;121;150;543;0;329;42699296;41580294;26836844;5893443;42623215;28936622;6165075;0;97315
FR;1;2022-12-23;130;157;459;419;142;449;426;0;182;42699426;41580451;26837303;5893862;42623357;28937071;6165501;0;97497
FR;1;2022-12-24;30;27;34;56;29;33;63;0;21;42699456;41580478;26837337;5893918;42623386;28937104;6165564;0;97518
FR;1;2022-12-25;4;11;20;12;12;14;15;0;11;42699460;41580489;26837357;5893930;42623398;28937118;6165579;0;97529
FR;1;2022-12-26;94;90;248;251;89;253;257;0;93;42699554;41580579;26837605;5894181;42623487;28937371;6165836;0;97622
FR;1;2022-12-27;117;160;311;387;151;317;402;0;180;42699671;41580739;26837916;5894568;42623638;28937688;6166238;0;97802
FR;1;2022-12-28;107;147;204;270;133;207;281;0;126;42699778;41580886;26838120;5894838;42623771;28937895;6166519;0;97928
FR;1;2022-12-29;105;112;154;282;112;153;303;0;114;42699883;41580998;26838274;5895120;42623883;28938048;6166822;0;98042
FR;1;2022-12-30;127;123;89;258;115;94;268;0;143;42700010;41581121;26838363;5895378;42623998;28938142;6167090;0;98185
FR;1;2022-12-31;38;35;28;79;40;25;79;0;25;42700048;41581156;26838391;5895457;42624038;28938167;6167169;0;98210
FR;1;2023-01-01;6;13;61;22;12;58;27;0;10;42700054;41581169;26838452;5895479;42624050;28938225;6167196;0;98220
FR;1;2023-01-02;615;158;678;169;166;658;194;0;64;42700669;41581327;26839130;5895648;42624216;28938883;6167390;0;98284
FR;1;2023-01-03;166;111;373;208;110;366;215;0;147;42700835;41581438;26839503;5895856;42624326;28939249;6167605;0;98431
FR;1;2023-01-04;96;101;249;198;102;250;208;0;193;42700931;41581539;26839752;5896054;42624428;28939499;6167813;0;98624
FR;1;2023-01-05;147;133;179;337;143;179;339;0;206;42701078;41581672;26839931;5896391;42624571;28939678;6168152;0;98830
FR;1;2023-01-06;200;144;226;325;147;212;350;0;230;42701278;41581816;26840157;5896716;42624718;28939890;6168502;0;99060
FR;1;2023-01-07;107;89;175;148;92;158;165;0;93;42701385;41581905;26840332;5896864;42624810;28940048;6168667;0;99153
FR;1;2023-01-08;27;19;31;59;18;26;64;0;24;42701412;41581924;26840363;5896923;42624828;28940074;6168731;0;99177
FR;1;2023-01-09;140;130;136;135;126;144;153;0;115;42701552;41582054;26840499;5897058;42624954;28940218;6168884;0;99292
FR;1;2023-01-10;119;144;284;277;141;291;278;0;192;42701671;41582198;26840783;5897335;42625095;28940509;6169162;0;99484
FR;1;2023-01-11;107;112;92;209;121;95;222;0;96;42701778;41582310;26840875;5897544;42625216;28940604;6169384;0;99580
FR;1;2023-01-12;137;123;215;243;118;215;268;0;166;42701915;41582433;26841090;5897787;42625334;28940819;6169652;0;99746
FR;1;2023-01-13;258;169;174;286;167;173;306;0;189;42702173;41582602;26841264;5898073;42625501;28940992;6169958;0;99935
FR;1;2023-01-14;89;64;162;104;66;172;103;0;62;42702262;41582666;26841426;5898177;42625567;28941164;6170061;0;99997
FR;1;2023-01-15;23;38;31;42;35;31;46;0;30;42702285;41582704;26841457;5898219;42625602;28941195;6170107;0;100027
FR;1;2023-01-16;113;107;310;155;101;314;133;0;101;42702398;41582811;26841767;5898374;42625703;28941509;6170240;0;100128
FR;1;2023-01-17;114;103;167;216;102;164;243;0;128;42702512;41582914;26841934;5898590;42625805;28941673;6170483;0;100256
FR;1;2023-01-18;99;90;97;143;89;92;184;0;121;42702611;41583004;26842031;5898733;42625894;28941765;6170667;0;100377
FR;1;2023-01-19;112;78;106;134;76;118;134;0;136;42702723;41583082;26842137;5898867;42625970;28941883;6170801;0;100513
FR;1;2023-01-20;170;150;168;278;151;196;267;0;204;42702893;41583232;26842305;5899145;42626121;28942079;6171068;0;100717
FR;1;2023-01-21;58;71;91;85;71;102;75;0;35;42702951;41583303;26842396;5899230;42626192;28942181;6171143;0;100752
FR;1;2023-01-22;10;9;14;21;7;9;26;0;14;42702961;41583312;26842410;5899251;42626199;28942190;6171169;0;100766
FR;1;2023-01-23;88;85;108;100;88;100;119;0;85;42703049;41583397;26842518;5899351;42626287;28942290;6171288;0;100851
FR;1;2023-01-24;122;76;73;122;89;70;131;0;183;42703171;41583473;26842591;5899473;42626376;28942360;6171419;0;101034
FR;1;2023-01-25;98;119;78;108;120;78;124;0;107;42703269;41583592;26842669;5899581;42626496;28942438;6171543;0;101141
FR;1;2023-01-26;104;105;63;152;94;68;173;0;108;42703373;41583697;26842732;5899733;42626590;28942506;6171716;0;101249
FR;1;2023-01-27;172;607;105;137;622;123;137;0;200;42703545;41584304;26842837;5899870;42627212;28942629;6171853;0;101449
FR;1;2023-01-28;73;74;56;40;76;53;48;0;28;42703618;41584378;26842893;5899910;42627288;28942682;6171901;0;101477
FR;1;2023-01-29;12;22;33;10;20;31;16;0;12;42703630;41584400;26842926;5899920;42627308;28942713;6171917;0;101489
FR;1;2023-01-30;144;109;64;72;113;70;80;0;51;42703774;41584509;26842990;5899992;42627421;28942783;6171997;0;101540
FR;1;2023-01-31;122;87;66;137;76;69;149;0;143;42703896;41584596;26843056;5900129;42627497;28942852;6172146;0;101683
FR;1;2023-02-01;122;149;345;106;148;338;134;0;77;42704018;41584745;26843401;5900235;42627645;28943190;6172280;0;101760
FR;1;2023-02-02;88;100;91;106;94;99;108;0;99;42704106;41584845;26843492;5900341;42627739;28943289;6172388;0;101859
FR;1;2023-02-03;156;148;133;98;148;139;104;0;97;42704262;41584993;26843625;5900439;42627887;28943428;6172492;0;101956
FR;1;2023-02-04;50;78;72;46;85;74;47;0;24;42704312;41585071;26843697;5900485;42627972;28943502;6172539;0;101980
FR;1;2023-02-05;6;8;19;6;7;22;7;0;8;42704318;41585079;26843716;5900491;42627979;28943524;6172546;0;101988
FR;1;2023-02-06;96;80;115;77;86;118;81;0;89;42704414;41585159;26843831;5900568;42628065;28943642;6172627;0;102077
FR;1;2023-02-07;92;77;97;77;78;91;97;0;115;42704506;41585236;26843928;5900645;42628143;28943733;6172724;0;102192
FR;1;2023-02-08;83;93;64;30;92;68;35;0;51;42704589;41585329;26843992;5900675;42628235;28943801;6172759;0;102243
FR;1;2023-02-09;65;65;83;59;75;82;67;0;79;42704654;41585394;26844075;5900734;42628310;28943883;6172826;0;102322
FR;1;2023-02-10;142;132;57;72;135;69;73;0;117;42704796;41585526;26844132;5900806;42628445;28943952;6172899;0;102439
FR;1;2023-02-11;45;53;78;25;50;87;27;0;11;42704841;41585579;26844210;5900831;42628495;28944039;6172926;0;102450
FR;1;2023-02-12;11;9;10;8;13;10;9;0;9;42704852;41585588;26844220;5900839;42628508;28944049;6172935;0;102459
FR;1;2023-02-13;96;119;47;42;120;54;34;0;31;42704948;41585707;26844267;5900881;42628628;28944103;6172969;0;102490
FR;1;2023-02-14;69;73;73;50;72;77;47;0;77;42705017;41585780;26844340;5900931;42628700;28944180;6173016;0;102567
FR;1;2023-02-15;76;103;77;52;111;83;60;0;81;42705093;41585883;26844417;5900983;42628811;28944263;6173076;0;102648
FR;1;2023-02-16;60;75;114;83;63;123;86;0;73;42705153;41585958;26844531;5901066;42628874;28944386;6173162;0;102721
FR;1;2023-02-17;105;125;172;61;130;176;70;0;47;42705258;41586083;26844703;5901127;42629004;28944562;6173232;0;102768
FR;1;2023-02-18;44;57;147;41;57;153;43;0;9;42705302;41586140;26844850;5901168;42629061;28944715;6173275;0;102777
FR;1;2023-02-19;14;0;6;4;2;5;4;0;5;42705316;41586140;26844856;5901172;42629063;28944720;6173279;0;102782
FR;1;2023-02-20;77;73;52;28;77;57;32;0;16;42705393;41586213;26844908;5901200;42629140;28944777;6173311;0;102798
FR;1;2023-02-21;62;74;54;49;78;57;47;0;38;42705455;41586287;26844962;5901249;42629218;28944834;6173358;0;102836
FR;1;2023-02-22;65;77;32;18;79;36;18;0;22;42705520;41586364;26844994;5901267;42629297;28944870;6173376;0;102858
FR;1;2023-02-23;52;79;48;36;77;58;31;0;54;42705572;41586443;26845042;5901303;42629374;28944928;6173407;0;102912
FR;1;2023-02-24;95;111;48;33;112;56;34;0;38;42705667;41586554;26845090;5901336;42629486;28944984;6173441;0;102950
FR;1;2023-02-25;42;49;69;22;56;69;24;0;26;42705709;41586603;26845159;5901358;42629542;28945053;6173465;0;102976
FR;1;2023-02-26;2;4;1;2;2;3;1;0;3;42705711;41586607;26845160;5901360;42629544;28945056;6173466;0;102979
FR;1;2023-02-27;91;77;62;35;77;70;32;0;21;42705802;41586684;26845222;5901395;42629621;28945126;6173498;0;103000
FR;1;2023-02-28;87;72;35;50;68;45;52;0;33;42705889;41586756;26845257;5901445;42629689;28945171;6173550;0;103033
FR;1;2023-03-01;73;90;242;52;88;234;69;0;42;42705962;41586846;26845499;5901497;42629777;28945405;6173619;0;103075
FR;1;2023-03-02;65;64;91;55;65;87;67;0;117;42706027;41586910;26845590;5901552;42629842;28945492;6173686;0;103192
FR;1;2023-03-03;106;108;72;53;107;70;57;0;47;42706133;41587018;26845662;5901605;42629949;28945562;6173743;0;103239
FR;1;2023-03-04;51;46;70;26;43;71;31;0;15;42706184;41587064;26845732;5901631;42629992;28945633;6173774;0;103254
FR;1;2023-03-05;4;2;5;0;3;5;1;0;0;42706188;41587066;26845737;5901631;42629995;28945638;6173775;0;103254
FR;1;2023-03-06;86;57;79;17;63;85;23;0;14;42706274;41587123;26845816;5901648;42630058;28945723;6173798;0;103268
FR;1;2023-03-07;53;71;47;40;68;45;50;0;71;42706327;41587194;26845863;5901688;42630126;28945768;6173848;0;103339
FR;1;2023-03-08;47;65;32;16;68;34;22;0;6;42706374;41587259;26845895;5901704;42630194;28945802;6173870;0;103345
FR;1;2023-03-09;37;55;45;22;49;50;31;0;30;42706411;41587314;26845940;5901726;42630243;28945852;6173901;0;103375
FR;1;2023-03-10;93;97;85;41;97;89;46;0;25;42706504;41587411;26846025;5901767;42630340;28945941;6173947;0;103400
FR;1;2023-03-11;47;39;51;9;33;57;13;0;6;42706551;41587450;26846076;5901776;42630373;28945998;6173960;0;103406
FR;1;2023-03-12;2;11;7;0;13;6;1;0;0;42706553;41587461;26846083;5901776;42630386;28946004;6173961;0;103406
FR;1;2023-03-13;50;73;40;15;68;48;14;0;19;42706603;41587534;26846123;5901791;42630454;28946052;6173975;0;103425
FR;1;2023-03-14;68;49;55;21;53;59;23;0;31;42706671;41587583;26846178;5901812;42630507;28946111;6173998;0;103456
FR;1;2023-03-15;40;70;74;60;69;77;67;0;47;42706711;41587653;26846252;5901872;42630576;28946188;6174065;0;103503
FR;1;2023-03-16;55;49;88;24;53;87;28;0;20;42706766;41587702;26846340;5901896;42630629;28946275;6174093;0;103523
FR;1;2023-03-17;109;89;101;37;103;104;41;0;35;42706875;41587791;26846441;5901933;42630732;28946379;6174134;0;103558
FR;1;2023-03-18;34;33;144;10;28;148;15;0;5;42706909;41587824;26846585;5901943;42630760;28946527;6174149;0;103563
FR;1;2023-03-19;11;4;2;2;5;2;3;0;0;42706920;41587828;26846587;5901945;42630765;28946529;6174152;0;103563
FR;1;2023-03-20;45;61;49;29;51;58;33;0;24;42706965;41587889;26846636;5901974;42630816;28946587;6174185;0;103587
FR;1;2023-03-21;73;61;42;11;66;45;16;0;26;42707038;41587950;26846678;5901985;42630882;28946632;6174201;0;103613
FR;1;2023-03-22;58;54;37;31;54;51;26;0;13;42707096;41588004;26846715;5902016;42630936;28946683;6174227;0;103626
FR;1;2023-03-23;59;47;37;23;48;41;25;0;47;42707155;41588051;26846752;5902039;42630984;28946724;6174252;0;103673
FR;1;2023-03-24;77;103;190;29;106;196;35;0;23;42707232;41588154;26846942;5902068;42631090;28946920;6174287;0;103696
FR;1;2023-03-25;47;51;48;11;48;52;15;0;5;42707279;41588205;26846990;5902079;42631138;28946972;6174302;0;103701
FR;1;2023-03-26;2;3;9;0;0;10;2;0;2;42707281;41588208;26846999;5902079;42631138;28946982;6174304;0;103703
FR;1;2023-03-27;104;58;68;11;61;71;15;0;22;42707385;41588266;26847067;5902090;42631199;28947053;6174319;0;103725
FR;1;2023-03-28;48;38;23;21;41;25;21;0;31;42707433;41588304;26847090;5902111;42631240;28947078;6174340;0;103756
FR;1;2023-03-29;55;46;31;28;45;38;25;0;14;42707488;41588350;26847121;5902139;42631285;28947116;6174365;0;103770
FR;1;2023-03-30;56;42;58;19;45;57;26;0;30;42707544;41588392;26847179;5902158;42631330;28947173;6174391;0;103800
FR;1;2023-03-31;66;84;28;16;82;34;13;0;35;42707610;41588476;26847207;5902174;42631412;28947207;6174404;0;103835
FR;1;2023-04-01;29;53;127;10;50;129;17;0;10;42707639;41588529;26847334;5902184;42631462;28947336;6174421;0;103845
FR;1;2023-04-02;1;1;8;0;1;7;1;0;0;42707640;41588530;26847342;5902184;42631463;28947343;6174422;0;103845
FR;1;2023-04-03;91;51;148;28;46;150;34;0;19;42707731;41588581;26847490;5902212;42631509;28947493;6174456;0;103864
FR;1;2023-04-04;40;52;40;11;44;47;12;0;25;42707771;41588633;26847530;5902223;42631553;28947540;6174468;0;103889
FR;1;2023-04-05;25;41;33;19;38;27;27;0;14;42707796;41588674;26847563;5902242;42631591;28947567;6174495;0;103903
FR;1;2023-04-06;43;45;33;11;42;35;16;0;15;42707839;41588719;26847596;5902253;42631633;28947602;6174511;0;103918
FR;1;2023-04-07;48;63;33;17;63;37;16;0;13;42707887;41588782;26847629;5902270;42631696;28947639;6174527;0;103931
FR;1;2023-04-08;25;32;11;13;25;18;13;0;13;42707912;41588814;26847640;5902283;42631721;28947657;6174540;0;103944
FR;1;2023-04-09;5;2;0;2;1;1;2;0;1;42707917;41588816;26847640;5902285;42631722;28947658;6174542;0;103945
FR;1;2023-04-10;5;15;22;1;15;24;1;0;1;42707922;41588831;26847662;5902286;42631737;28947682;6174543;0;103946
FR;1;2023-04-11;40;52;22;12;51;21;14;0;17;42707962;41588883;26847684;5902298;42631788;28947703;6174557;0;103963
FR;1;2023-04-12;36;35;36;19;33;41;22;0;24;42707998;41588918;26847720;5902317;42631821;28947744;6174579;0;103987
FR;1;2023-04-13;36;41;20;16;42;25;14;0;26;42708034;41588959;26847740;5902333;42631863;28947769;6174593;0;104013
FR;1;2023-04-14;59;69;132;15;78;126;22;0;17;42708093;41589028;26847872;5902348;42631941;28947895;6174615;0;104030
FR;1;2023-04-15;28;28;36;10;28;39;12;0;2;42708121;41589056;26847908;5902358;42631969;28947934;6174627;0;104032
FR;1;2023-04-16;3;2;0;0;2;0;0;0;0;42708124;41589058;26847908;5902358;42631971;28947934;6174627;0;104032
FR;1;2023-04-17;37;38;61;16;41;66;15;0;11;42708161;41589096;26847969;5902374;42632012;28948000;6174642;0;104043
FR;1;2023-04-18;37;40;27;7;35;41;12;0;24;42708198;41589136;26847996;5902381;42632047;28948041;6174654;0;104067
FR;1;2023-04-19;36;57;13;9;57;14;11;0;14;42708234;41589193;26848009;5902390;42632104;28948055;6174665;0;104081
FR;1;2023-04-20;27;40;39;16;41;40;17;0;15;42708261;41589233;26848048;5902406;42632145;28948095;6174682;0;104096
FR;1;2023-04-21;46;63;116;17;60;118;21;0;18;42708307;41589296;26848164;5902423;42632205;28948213;6174703;0;104114
FR;1;2023-04-22;19;23;34;9;20;39;9;0;4;42708326;41589319;26848198;5902432;42632225;28948252;6174712;0;104118
FR;1;2023-04-23;1;1;2;1;1;2;1;0;0;42708327;41589320;26848200;5902433;42632226;28948254;6174713;0;104118
FR;1;2023-04-24;58;39;29;5;38;33;6;0;8;42708385;41589359;26848229;5902438;42632264;28948287;6174719;0;104126
FR;1;2023-04-25;31;34;22;16;30;23;20;0;15;42708416;41589393;26848251;5902454;42632294;28948310;6174739;0;104141
FR;1;2023-04-26;31;24;9;6;24;14;8;0;8;42708447;41589417;26848260;5902460;42632318;28948324;6174747;0;104149
FR;1;2023-04-27;32;35;31;25;30;36;28;0;12;42708479;41589452;26848291;5902485;42632348;28948360;6174775;0;104161
FR;1;2023-04-28;70;53;22;14;47;28;20;0;11;42708549;41589505;26848313;5902499;42632395;28948388;6174795;0;104172
FR;1;2023-04-29;19;19;14;7;18;12;11;0;9;42708568;41589524;26848327;5902506;42632413;28948400;6174806;0;104181
FR;1;2023-04-30;6;0;0;1;0;0;1;0;0;42708574;41589524;26848327;5902507;42632413;28948400;6174807;0;104181
FR;1;2023-05-01;0;13;45;1;12;46;1;0;0;42708574;41589537;26848372;5902508;42632425;28948446;6174808;0;104181
FR;1;2023-05-02;94;54;131;12;58;126;24;0;19;42708668;41589591;26848503;5902520;42632483;28948572;6174832;0;104200
FR;1;2023-05-03;51;29;42;5;25;46;7;0;9;42708719;41589620;26848545;5902525;42632508;28948618;6174839;0;104209
FR;1;2023-05-04;19;33;64;26;33;83;35;0;18;42708738;41589653;26848609;5902551;42632541;28948701;6174874;0;104227
FR;1;2023-05-05;27;31;20;3;32;16;7;0;9;42708765;41589684;26848629;5902554;42632573;28948717;6174881;0;104236
FR;1;2023-05-06;11;7;7;3;8;8;4;0;7;42708776;41589691;26848636;5902557;42632581;28948725;6174885;0;104243
FR;1;2023-05-07;2;2;4;4;2;3;2;0;1;42708778;41589693;26848640;5902561;42632583;28948728;6174887;0;104244
FR;1;2023-05-08;7;4;5;1;3;6;1;0;0;42708785;41589697;26848645;5902562;42632586;28948734;6174888;0;104244
FR;1;2023-05-09;14;16;11;3;14;11;6;0;9;42708799;41589713;26848656;5902565;42632600;28948745;6174894;0;104253
FR;1;2023-05-10;19;18;7;11;18;9;8;0;1;42708818;41589731;26848663;5902576;42632618;28948754;6174902;0;104254
FR;1;2023-05-11;13;18;7;9;18;8;8;0;21;42708831;41589749;26848670;5902585;42632636;28948762;6174910;0;104275
FR;1;2023-05-12;16;42;26;15;39;31;18;0;11;42708847;41589791;26848696;5902600;42632675;28948793;6174928;0;104286
FR;1;2023-05-13;12;24;11;2;22;14;2;0;2;42708859;41589815;26848707;5902602;42632697;28948807;6174930;0;104288
FR;1;2023-05-14;12;1;1;0;1;1;0;0;0;42708871;41589816;26848708;5902602;42632698;28948808;6174930;0;104288
FR;1;2023-05-15;17;18;35;4;17;35;6;0;9;42708888;41589834;26848743;5902606;42632715;28948843;6174936;0;104297
FR;1;2023-05-16;17;25;17;30;22;17;35;0;49;42708905;41589859;26848760;5902636;42632737;28948860;6174971;0;104346
FR;1;2023-05-17;21;46;4;6;46;5;6;0;15;42708926;41589905;26848764;5902642;42632783;28948865;6174977;0;104361
FR;1;2023-05-18;0;3;1;0;3;1;0;0;1;42708926;41589908;26848765;5902642;42632786;28948866;6174977;0;104362
FR;1;2023-05-19;13;24;55;12;21;59;15;0;15;42708939;41589932;26848820;5902654;42632807;28948925;6174992;0;104377
FR;1;2023-05-20;6;7;10;6;6;9;9;0;6;42708945;41589939;26848830;5902660;42632813;28948934;6175001;0;104383
FR;1;2023-05-21;6;0;0;0;0;0;0;0;1;42708951;41589939;26848830;5902660;42632813;28948934;6175001;0;104384
FR;1;2023-05-22;41;16;30;6;16;30;7;0;7;42708992;41589955;26848860;5902666;42632829;28948964;6175008;0;104391
FR;1;2023-05-23;7;19;4;6;19;5;6;0;13;42708999;41589974;26848864;5902672;42632848;28948969;6175014;0;104404
FR;1;2023-05-24;14;19;13;16;19;13;18;0;29;42709013;41589993;26848877;5902688;42632867;28948982;6175032;0;104433
FR;1;2023-05-25;14;12;12;5;10;14;7;0;26;42709027;41590005;26848889;5902693;42632877;28948996;6175039;0;104459
FR;1;2023-05-26;25;22;26;8;20;28;10;0;10;42709052;41590027;26848915;5902701;42632897;28949024;6175049;0;104469
FR;1;2023-05-27;5;14;1;3;13;2;4;0;4;42709057;41590041;26848916;5902704;42632910;28949026;6175053;0;104473
FR;1;2023-05-28;1;2;1;0;2;1;0;0;0;42709058;41590043;26848917;5902704;42632912;28949027;6175053;0;104473
FR;1;2023-05-29;0;0;0;0;0;0;0;0;0;42709058;41590043;26848917;5902704;42632912;28949027;6175053;0;104473
FR;1;2023-05-30;40;16;14;25;18;16;28;0;32;42709098;41590059;26848931;5902729;42632930;28949043;6175081;0;104505
FR;1;2023-05-31;19;29;8;12;21;12;18;0;27;42709117;41590088;26848939;5902741;42632951;28949055;6175099;0;104532
FR;1;2023-06-01;10;23;29;12;17;33;12;0;19;42709127;41590111;26848968;5902753;42632968;28949088;6175111;0;104551
FR;1;2023-06-02;12;23;8;4;19;13;6;0;14;42709139;41590134;26848976;5902757;42632987;28949101;6175117;0;104565
FR;1;2023-06-03;4;7;1;2;7;2;2;0;0;42709143;41590141;26848977;5902759;42632994;28949103;6175119;0;104565
FR;1;2023-06-04;0;12;0;0;12;0;0;0;0;42709143;41590153;26848977;5902759;42633006;28949103;6175119;0;104565
FR;1;2023-06-05;50;17;6;5;16;7;7;0;8;42709193;41590170;26848983;5902764;42633022;28949110;6175126;0;104573
FR;1;2023-06-06;18;18;6;5;16;7;9;0;14;42709211;41590188;26848989;5902769;42633038;28949117;6175135;0;104587
FR;1;2023-06-07;14;10;2;3;9;2;4;0;5;42709225;41590198;26848991;5902772;42633047;28949119;6175139;0;104592
FR;1;2023-06-08;13;4;4;2;3;7;6;0;37;42709238;41590202;26848995;5902774;42633050;28949126;6175145;0;104629
FR;1;2023-06-09;17;34;8;13;32;9;13;0;32;42709255;41590236;26849003;5902787;42633082;28949135;6175158;0;104661
FR;1;2023-06-10;9;5;8;1;3;8;3;0;1;42709264;41590241;26849011;5902788;42633085;28949143;6175161;0;104662
FR;1;2023-06-11;0;0;0;0;0;0;0;0;0;42709264;41590241;26849011;5902788;42633085;28949143;6175161;0;104662
FR;1;2023-06-12;5;8;2;4;8;3;7;0;12;42709269;41590249;26849013;5902792;42633093;28949146;6175168;0;104674
FR;1;2023-06-13;8;5;4;4;4;5;6;0;3;42709277;41590254;26849017;5902796;42633097;28949151;6175174;0;104677
FR;1;2023-06-14;9;36;2;8;36;4;6;0;11;42709286;41590290;26849019;5902804;42633133;28949155;6175180;0;104688
FR;1;2023-06-15;5;14;4;18;11;8;17;0;46;42709291;41590304;26849023;5902822;42633144;28949163;6175197;0;104734
FR;1;2023-06-16;7;16;5;15;18;3;17;0;17;42709298;41590320;26849028;5902837;42633162;28949166;6175214;0;104751
FR;1;2023-06-17;5;14;3;1;13;3;1;0;5;42709303;41590334;26849031;5902838;42633175;28949169;6175215;0;104756
FR;1;2023-06-18;0;1;0;0;1;0;0;0;0;42709303;41590335;26849031;5902838;42633176;28949169;6175215;0;104756
FR;1;2023-06-19;12;8;2;3;9;0;5;0;4;42709315;41590343;26849033;5902841;42633185;28949169;6175220;0;104760
FR;2;2020-12-27;0;0;0;0;0;0;0;0;0;0;0;0;0;0;0;0;0;0
FR;2;2020-12-28;0;0;0;0;0;0;0;0;0;0;0;0;0;0;0;0;0;0
FR;2;2020-12-29;0;0;0;0;0;0;0;0;0;0;0;0;0;0;0;0;0;0
FR;2;2020-12-30;0;0;0;0;0;0;0;0;0;0;0;0;0;0;0;0;0;0
FR;2;2020-12-31;0;0;0;0;0;0;0;0;0;0;0;0;0;0;0;0;0;0
FR;2;2021-01-01;0;0;0;0;0;0;0;0;0;0;0;0;0;0;0;0;0;0
FR;2;2021-01-02;0;0;0;0;0;0;0;0;0;0;0;0;0;0;0;0;0;0
FR;2;2021-01-03;0;0;0;0;0;0;0;0;0;0;0;0;0;0;0;0;0;0
FR;2;2021-01-04;0;0;0;0;0;0;0;0;0;0;0;0;0;0;0;0;0;0
FR;2;2021-01-05;0;0;0;0;0;0;0;0;0;0;0;0;0;0;0;0;0;0
FR;2;2021-01-06;0;0;0;0;0;0;0;0;0;0;0;0;0;0;0;0;0;0
FR;2;2021-01-07;0;0;0;0;0;0;0;0;0;0;0;0;0;0;0;0;0;0
FR;2;2021-01-08;0;0;0;0;0;0;0;0;0;0;0;0;0;0;0;0;0;0
FR;2;2021-01-09;0;0;0;0;0;0;0;0;0;0;0;0;0;0;0;0;0;0
FR;2;2021-01-10;0;0;0;0;0;0;0;0;0;0;0;0;0;0;0;0;0;0
FR;2;2021-01-11;0;0;0;0;0;0;0;0;0;0;0;0;0;0;0;0;0;0
FR;2;2021-01-12;0;0;0;0;0;0;0;0;0;0;0;0;0;0;0;0;0;0
FR;2;2021-01-13;0;0;0;0;0;0;0;0;0;0;0;0;0;0;0;0;0;0
FR;2;2021-01-14;1636;0;0;0;213;0;0;0;0;1636;0;0;0;213;0;0;0;0
FR;2;2021-01-15;398;0;0;0;28;0;0;0;0;2034;0;0;0;241;0;0;0;0
FR;2;2021-01-16;316;0;0;0;12;0;0;0;0;2350;0;0;0;253;0;0;0;0
FR;2;2021-01-17;84;0;0;0;7;0;0;0;0;2434;0;0;0;260;0;0;0;0
FR;2;2021-01-18;3075;3;0;0;27;0;0;0;0;5509;3;0;0;287;0;0;0;0
FR;2;2021-01-19;4681;2;0;0;31;0;0;0;0;10190;5;0;0;318;0;0;0;0
FR;2;2021-01-20;5138;6;0;0;58;0;0;0;0;15328;11;0;0;376;0;0;0;0
FR;2;2021-01-21;5346;9;0;0;55;0;0;0;0;20674;20;0;0;431;0;0;0;0
FR;2;2021-01-22;5119;19;0;0;70;0;0;0;0;25793;39;0;0;501;0;0;0;0
FR;2;2021-01-23;1875;2;0;0;16;0;0;0;0;27668;41;0;0;517;0;0;0;0
FR;2;2021-01-24;163;2;0;0;8;0;0;0;0;27831;43;0;0;525;0;0;0;0
FR;2;2021-01-25;3814;4;0;0;37;0;0;0;0;31645;47;0;0;562;0;0;0;0
FR;2;2021-01-26;3930;6;0;0;42;0;0;0;0;35575;53;0;0;604;0;0;0;0
FR;2;2021-01-27;3606;4;0;0;36;0;0;0;0;39181;57;0;0;640;0;0;0;0
FR;2;2021-01-28;3757;9;0;0;44;0;0;0;0;42938;66;0;0;684;0;0;0;0
FR;2;2021-01-29;3300;6;0;0;42;0;0;0;0;46238;72;0;0;726;0;0;0;0
FR;2;2021-01-30;1133;3;0;0;16;0;0;0;0;47371;75;0;0;742;0;0;0;0
FR;2;2021-01-31;47;2;0;0;9;0;0;0;0;47418;77;0;0;751;0;0;0;0
FR;2;2021-02-01;3408;13;0;0;44;0;0;0;0;50826;90;0;0;795;0;0;0;0
FR;2;2021-02-02;4498;19;0;0;53;0;0;0;0;55324;109;0;0;848;0;0;0;0
FR;2;2021-02-03;5223;12;0;0;83;0;0;0;0;60547;121;0;0;931;0;0;0;0
FR;2;2021-02-04;4941;11;0;0;36;0;0;0;0;65488;132;0;0;967;0;0;0;0
FR;2;2021-02-05;4817;17;0;0;50;0;0;0;0;70305;149;0;0;1017;0;0;0;0
FR;2;2021-02-06;2047;15;0;0;41;0;0;0;0;72352;164;0;0;1058;0;0;0;0
FR;2;2021-02-07;103;6;0;0;20;0;0;0;0;72455;170;0;0;1078;0;0;0;0
FR;2;2021-02-08;7559;27;0;0;86;0;0;0;0;80014;197;0;0;1164;0;0;0;0
FR;2;2021-02-09;8435;31;0;0;100;0;0;0;0;88449;228;0;0;1264;0;0;0;0
FR;2;2021-02-10;9349;63;0;0;183;0;0;0;0;97798;291;0;0;1447;0;0;0;0
FR;2;2021-02-11;10292;132;0;0;256;0;0;0;0;108090;423;0;0;1703;0;0;0;0
FR;2;2021-02-12;10059;276;0;0;430;0;0;0;0;118149;699;0;0;2133;0;0;0;0
FR;2;2021-02-13;3121;223;0;0;261;0;0;0;0;121270;922;0;0;2394;0;0;0;0
FR;2;2021-02-14;358;11;0;0;21;0;0;0;0;121628;933;0;0;2415;0;0;0;0
FR;2;2021-02-15;3460;3129;0;0;3176;0;0;0;0;125088;4062;0;0;5591;0;0;0;0
FR;2;2021-02-16;5076;4165;0;0;4238;0;0;0;0;130164;8227;0;0;9829;0;0;0;0
FR;2;2021-02-17;4259;4555;0;0;4632;0;0;0;0;134423;12782;0;0;14461;0;0;0;0
FR;2;2021-02-18;5406;5179;0;0;5249;0;0;0;0;139829;17961;0;0;19710;0;0;0;0
FR;2;2021-02-19;5329;4491;0;0;4592;0;0;0;0;145158;22452;0;0;24302;0;0;0;0
FR;2;2021-02-20;1872;1520;0;0;1537;0;0;0;0;147030;23972;0;0;25839;0;0;0;0
FR;2;2021-02-21;244;96;0;0;98;0;0;0;0;147274;24068;0;0;25937;0;0;0;0
FR;2;2021-02-22;3614;3783;0;0;3845;0;0;0;0;150888;27851;0;0;29782;0;0;0;0
FR;2;2021-02-23;4955;3741;0;0;3805;0;0;0;0;155843;31592;0;0;33587;0;0;0;0
FR;2;2021-02-24;5017;3558;0;0;3611;0;0;0;0;160860;35150;0;0;37198;0;0;0;0
FR;2;2021-02-25;5501;3495;0;0;3585;0;0;0;0;166361;38645;0;0;40783;0;0;0;0
FR;2;2021-02-26;4368;3179;0;0;3253;0;0;0;0;170729;41824;0;0;44036;0;0;0;0
FR;2;2021-02-27;1629;1067;0;0;1086;0;0;0;0;172358;42891;0;0;45122;0;0;0;0
FR;2;2021-02-28;179;17;0;0;28;0;0;0;0;172537;42908;0;0;45150;0;0;0;0
FR;2;2021-03-01;5193;3762;0;0;3851;0;0;0;0;177730;46670;0;0;49001;0;0;0;0
FR;2;2021-03-02;6542;4728;0;0;4829;0;0;0;0;184272;51398;0;0;53830;0;0;0;0
FR;2;2021-03-03;6544;4955;0;0;5096;0;0;0;0;190816;56353;0;0;58926;0;0;0;0
FR;2;2021-03-04;8412;4210;0;0;4396;0;0;0;0;199228;60563;0;0;63322;0;0;0;0
FR;2;2021-03-05;8037;4054;0;0;4237;0;0;0;0;207265;64617;0;0;67559;0;0;0;0
FR;2;2021-03-06;4791;1683;0;0;1783;0;0;0;0;212056;66300;0;0;69342;0;0;0;0
FR;2;2021-03-07;2373;32;0;0;76;0;0;0;0;214429;66332;0;0;69418;0;0;0;0
FR;2;2021-03-08;4166;8392;0;0;8549;0;0;0;0;218595;74724;0;0;77967;0;0;0;0
FR;2;2021-03-09;7494;8610;1;0;8869;0;0;0;0;226089;83334;1;0;86836;0;0;0;0
FR;2;2021-03-10;7108;9246;0;0;9473;0;0;0;0;233197;92580;1;0;96309;0;0;0;0
FR;2;2021-03-11;9379;9365;1;0;9686;0;0;0;0;242576;101945;2;0;105995;0;0;0;0
FR;2;2021-03-12;7989;8368;0;0;8671;0;0;0;0;250565;110313;2;0;114666;0;0;0;0
FR;2;2021-03-13;10058;2593;0;0;2914;0;0;0;0;260623;112906;2;0;117580;0;0;0;0
FR;2;2021-03-14;4841;380;0;0;539;0;0;0;0;265464;113286;2;0;118119;0;0;0;0
FR;2;2021-03-15;10919;3476;0;0;3765;0;0;0;0;276383;116762;2;0;121884;0;0;0;0
FR;2;2021-03-16;16770;4733;1;0;5283;0;0;0;0;293153;121495;3;0;127167;0;0;0;0
FR;2;2021-03-17;20242;4000;0;0;4674;0;0;0;0;313395;125495;3;0;131841;0;0;0;0
FR;2;2021-03-18;23375;5128;0;0;5957;0;0;0;0;336770;130623;3;0;137798;0;0;0;0
FR;2;2021-03-19;23316;4680;0;0;5443;0;0;0;0;360086;135303;3;0;143241;0;0;0;0
FR;2;2021-03-20;25451;1588;0;0;2345;0;0;0;0;385537;136891;3;0;145586;0;0;0;0
FR;2;2021-03-21;17675;153;0;0;731;0;0;0;0;403212;137044;3;0;146317;0;0;0;0
FR;2;2021-03-22;17791;3273;0;0;3942;0;0;0;0;421003;140317;3;0;150259;0;0;0;0
FR;2;2021-03-23;22707;4287;0;0;5142;0;0;0;0;443710;144604;3;0;155401;0;0;0;0
FR;2;2021-03-24;23966;5100;0;0;5937;0;0;0;0;467676;149704;3;0;161338;0;0;0;0
FR;2;2021-03-25;26762;5259;1;0;6456;0;0;0;0;494438;154963;4;0;167794;0;0;0;0
FR;2;2021-03-26;26992;4236;0;0;5382;0;0;0;0;521430;159199;4;0;173176;0;0;0;0
FR;2;2021-03-27;15923;1369;0;0;1899;0;0;0;0;537353;160568;4;0;175075;0;0;0;0
FR;2;2021-03-28;10563;135;0;0;427;0;0;0;0;547916;160703;4;0;175502;0;0;0;0
FR;2;2021-03-29;19004;4349;0;0;5049;0;0;0;0;566920;165052;4;0;180551;0;0;0;0
FR;2;2021-03-30;24597;6105;0;0;7045;0;0;0;0;591517;171157;4;0;187596;0;0;0;0
FR;2;2021-03-31;28562;5931;0;0;7224;0;0;0;0;620079;177088;4;0;194820;0;0;0;0
FR;2;2021-04-01;34560;8576;1;0;10269;0;0;0;0;654639;185664;5;0;205089;0;0;0;0
FR;2;2021-04-02;29992;7736;0;0;9165;0;0;0;0;684631;193400;5;0;214254;0;0;0;0
FR;2;2021-04-03;16959;4263;0;0;4945;0;0;0;0;701590;197663;5;0;219199;0;0;0;0
FR;2;2021-04-04;9309;1269;2;0;1677;0;0;0;0;710899;198932;7;0;220876;0;0;0;0
FR;2;2021-04-05;12448;797;0;0;1381;0;0;0;0;723347;199729;7;0;222257;0;0;0;0
FR;2;2021-04-06;27159;7359;0;0;8751;0;0;0;0;750506;207088;7;0;231008;0;0;0;0
FR;2;2021-04-07;30931;7070;1;0;8646;0;0;0;0;781437;214158;8;0;239654;0;0;0;0
FR;2;2021-04-08;36896;8592;1;0;10517;0;0;0;0;818333;222750;9;0;250171;0;0;0;0
FR;2;2021-04-09;33856;8391;28;0;10176;0;0;0;0;852189;231141;37;0;260347;0;0;0;0
FR;2;2021-04-10;19689;9270;1;0;10182;0;0;0;0;871878;240411;38;0;270529;0;0;0;0
FR;2;2021-04-11;7943;4240;1;0;4603;0;0;0;0;879821;244651;39;0;275132;0;0;0;0
FR;2;2021-04-12;17137;11028;0;0;11870;0;0;0;0;896958;255679;39;0;287002;0;0;0;0
FR;2;2021-04-13;19465;16033;1;0;17101;0;0;0;0;916423;271712;40;0;304103;0;0;0;0
FR;2;2021-04-14;18071;16446;7;0;17542;0;0;0;0;934494;288158;47;0;321645;0;0;0;0
FR;2;2021-04-15;22208;21892;27;0;23346;0;0;0;0;956702;310050;74;0;344991;0;0;0;0
FR;2;2021-04-16;20721;20640;45;0;21913;0;0;0;0;977423;330690;119;0;366904;0;0;0;0
FR;2;2021-04-17;13258;22495;5;0;23226;0;0;0;0;990681;353185;124;0;390130;0;0;0;0
FR;2;2021-04-18;5911;14397;6;0;14737;0;0;0;0;996592;367582;130;0;404867;0;0;0;0
FR;2;2021-04-19;16850;16394;24;0;17197;0;0;0;0;1013442;383976;154;0;422064;0;0;0;0
FR;2;2021-04-20;19328;21807;38;0;22869;0;0;0;0;1032770;405783;192;0;444933;0;0;0;0
FR;2;2021-04-21;20294;21902;76;0;23052;0;0;0;0;1053064;427685;268;0;467985;0;0;0;0
FR;2;2021-04-22;23824;24958;41;0;26371;0;0;0;0;1076888;452643;309;0;494356;0;0;0;0
FR;2;2021-04-23;24534;25501;76;0;27013;0;0;0;0;1101422;478144;385;0;521369;0;0;0;0
FR;2;2021-04-24;25305;15068;104;0;16506;0;0;0;0;1126727;493212;489;0;537875;0;0;0;0
FR;2;2021-04-25;9598;8623;5;0;9183;0;0;0;0;1136325;501835;494;0;547058;0;0;0;0
FR;2;2021-04-26;17169;17679;21;0;18565;0;0;0;0;1153494;519514;515;0;565623;0;0;0;0
FR;2;2021-04-27;19246;24101;40;0;25285;0;0;0;0;1172740;543615;555;0;590908;0;0;0;0
FR;2;2021-04-28;22343;26459;113;0;27860;0;0;0;0;1195083;570074;668;0;618768;0;0;0;0
FR;2;2021-04-29;25477;30500;70;0;32190;0;0;0;0;1220560;600574;738;0;650958;0;0;0;0
FR;2;2021-04-30;25542;27977;49;1;29627;0;0;0;0;1246102;628551;787;1;680585;0;0;0;0
FR;2;2021-05-01;14988;9853;6;0;10654;0;0;0;0;1261090;638404;793;1;691239;0;0;0;0
FR;2;2021-05-02;6642;9160;2;0;9506;0;0;0;0;1267732;647564;795;1;700745;0;0;0;0
FR;2;2021-05-03;20026;19127;40;0;20334;0;0;0;0;1287758;666691;835;1;721079;0;0;0;0
FR;2;2021-05-04;18288;29202;33;0;30348;0;0;0;0;1306046;695893;868;1;751427;0;0;0;0
FR;2;2021-05-05;18385;29524;48;0;30822;0;0;0;0;1324431;725417;916;1;782249;0;0;0;0
FR;2;2021-05-06;23553;35413;132;0;36986;0;0;0;0;1347984;760830;1048;1;819235;0;0;0;0
FR;2;2021-05-07;25349;33240;97;0;35099;0;0;0;0;1373333;794070;1145;1;854334;0;0;0;0
FR;2;2021-05-08;21343;10701;15;0;11788;0;0;0;0;1394676;804771;1160;1;866122;0;0;0;0
FR;2;2021-05-09;13170;7609;7;0;8284;0;0;0;0;1407846;812380;1167;1;874406;0;0;0;0
FR;2;2021-05-10;32949;21717;50;0;23574;0;0;0;0;1440795;834097;1217;1;897980;0;0;0;0
FR;2;2021-05-11;43616;20904;101;0;23529;0;0;0;0;1484411;855001;1318;1;921509;0;0;0;0
FR;2;2021-05-12;50070;19637;143;0;22517;0;0;0;0;1534481;874638;1461;1;944026;0;0;0;0
FR;2;2021-05-13;51301;5597;31;0;8465;0;0;0;0;1585782;880235;1492;1;952491;0;0;0;0
FR;2;2021-05-14;61361;12884;132;0;16538;0;0;0;0;1647143;893119;1624;1;969029;0;0;0;0
FR;2;2021-05-15;65938;7100;40;0;10650;0;0;0;0;1713081;900219;1664;1;979679;0;0;0;0
FR;2;2021-05-16;43588;2573;10;0;4944;0;0;0;0;1756669;902792;1674;1;984623;0;0;0;0
FR;2;2021-05-17;44756;12447;114;0;15354;0;0;0;0;1801425;915239;1788;1;999977;0;0;0;0
FR;2;2021-05-18;54650;12289;190;0;15972;0;0;0;0;1856075;927528;1978;1;1015949;0;0;0;0
FR;2;2021-05-19;57180;10460;281;0;14500;0;0;0;0;1913255;937988;2259;1;1030449;0;0;0;0
FR;2;2021-05-20;63452;10804;288;0;14899;0;0;0;0;1976707;948792;2547;1;1045348;0;0;0;0
FR;2;2021-05-21;64306;11602;230;0;16027;0;0;0;0;2041013;960394;2777;1;1061375;0;0;0;0
FR;2;2021-05-22;61488;4530;65;0;8500;0;0;0;0;2102501;964924;2842;1;1069875;0;0;0;0
FR;2;2021-05-23;37537;575;22;0;2912;0;0;0;0;2140038;965499;2864;1;1072787;0;0;0;0
FR;2;2021-05-24;17248;2052;35;0;3259;0;0;0;0;2157286;967551;2899;1;1076046;0;0;0;0
FR;2;2021-05-25;21121;12253;241;0;13854;0;0;0;0;2178407;979804;3140;1;1089900;0;0;0;0
FR;2;2021-05-26;19946;11539;230;0;13069;0;0;0;0;2198353;991343;3370;1;1102969;0;0;0;0
FR;2;2021-05-27;23001;12663;182;0;14399;0;0;0;0;2221354;1004006;3552;1;1117368;0;0;0;0
FR;2;2021-05-28;29398;15044;190;0;17224;0;0;0;0;2250752;1019050;3742;1;1134592;0;0;0;0
FR;2;2021-05-29;30425;8196;58;0;10104;0;0;0;0;2281177;1027246;3800;1;1144696;0;0;0;0
FR;2;2021-05-30;4648;1819;6;0;2154;0;0;0;0;2285825;1029065;3806;1;1146850;0;0;0;0
FR;2;2021-05-31;28590;18741;184;0;20820;0;0;0;0;2314415;1047806;3990;1;1167670;0;0;0;0
FR;2;2021-06-01;45745;19916;225;0;23152;0;0;0;0;2360160;1067722;4215;1;1190822;0;0;0;0
FR;2;2021-06-02;37483;19311;182;0;22317;0;0;0;0;2397643;1087033;4397;1;1213139;0;0;0;0
FR;2;2021-06-03;51284;23117;161;0;26971;0;0;0;0;2448927;1110150;4558;1;1240110;0;0;0;0
FR;2;2021-06-04;65519;24093;217;0;29058;0;0;0;0;2514446;1134243;4775;1;1269168;0;0;0;0
FR;2;2021-06-05;34607;24109;52;0;26964;0;0;0;0;2549053;1158352;4827;1;1296132;0;0;0;0
FR;2;2021-06-06;4958;6194;10;0;6613;0;0;0;0;2554011;1164546;4837;1;1302745;0;0;0;0
FR;2;2021-06-07;28177;23017;150;0;25433;0;0;0;0;2582188;1187563;4987;1;1328178;0;0;0;0
FR;2;2021-06-08;46379;22943;143;0;26909;0;0;0;0;2628567;1210506;5130;1;1355087;0;0;0;0
FR;2;2021-06-09;34298;20999;107;0;24131;0;0;0;0;2662865;1231505;5237;1;1379218;0;0;0;0
FR;2;2021-06-10;42644;19082;96;1;23004;0;0;0;0;2705509;1250587;5333;2;1402222;0;0;0;0
FR;2;2021-06-11;55306;25133;134;0;30232;0;0;0;0;2760815;1275720;5467;2;1432454;0;0;0;0
FR;2;2021-06-12;30567;19801;53;0;22654;0;0;0;0;2791382;1295521;5520;2;1455108;0;0;0;0
FR;2;2021-06-13;3333;9197;13;0;9586;0;0;0;0;2794715;1304718;5533;2;1464694;0;0;0;0
FR;2;2021-06-14;25304;24119;92;0;26699;0;0;0;0;2820019;1328837;5625;2;1491393;0;0;0;0
FR;2;2021-06-15;39049;22819;154;0;26567;0;0;0;0;2859068;1351656;5779;2;1517960;0;0;0;0
FR;2;2021-06-16;30169;21371;135;0;24524;0;0;0;0;2889237;1373027;5914;2;1542484;0;0;0;0
FR;2;2021-06-17;36913;25736;150;0;29598;0;0;0;0;2926150;1398763;6064;2;1572082;0;0;0;0
FR;2;2021-06-18;46860;28884;123;0;33587;0;0;0;0;2973010;1427647;6187;2;1605669;0;0;0;0
FR;2;2021-06-19;24527;24940;39;0;27714;0;0;0;0;2997537;1452587;6226;2;1633383;0;0;0;0
FR;2;2021-06-20;3745;10058;9;0;10557;0;0;0;0;3001282;1462645;6235;2;1643940;0;0;0;0
FR;2;2021-06-21;17538;42862;88;0;44874;0;0;0;0;3018820;1505507;6323;2;1688814;0;0;0;0
FR;2;2021-06-22;28367;49617;110;0;53046;0;0;0;0;3047187;1555124;6433;2;1741860;0;0;0;0
FR;2;2021-06-23;21790;49613;107;1;52462;1;0;0;0;3068977;1604737;6540;3;1794322;1;0;0;0
FR;2;2021-06-24;28381;50319;134;0;54050;0;0;0;0;3097358;1655056;6674;3;1848372;1;0;0;0
FR;2;2021-06-25;33402;60488;129;0;64877;0;0;0;0;3130760;1715544;6803;3;1913249;1;0;0;0
FR;2;2021-06-26;16396;59357;54;1;61749;0;0;0;0;3147156;1774901;6857;4;1974998;1;0;0;0
FR;2;2021-06-27;2566;29316;22;1;29898;0;0;0;0;3149722;1804217;6879;5;2004896;1;0;0;0
FR;2;2021-06-28;12641;54341;84;0;56317;0;0;0;0;3162363;1858558;6963;5;2061213;1;0;0;0
FR;2;2021-06-29;19857;60001;178;0;62944;0;0;0;0;3182220;1918559;7141;5;2124157;1;0;0;0
FR;2;2021-06-30;16337;58036;253;17;60720;0;0;0;0;3198557;1976595;7394;22;2184877;1;0;0;0
FR;2;2021-07-01;20497;59874;228;0;63201;0;0;0;0;3219054;2036469;7622;22;2248078;1;0;0;0
FR;2;2021-07-02;24083;62161;184;0;66375;0;0;0;0;3243137;2098630;7806;22;2314453;1;0;0;0
FR;2;2021-07-03;12123;57146;153;0;59485;0;0;0;0;3255260;2155776;7959;22;2373938;1;0;0;0
FR;2;2021-07-04;1961;23303;18;0;23870;0;0;0;0;3257221;2179079;7977;22;2397808;1;0;0;0
FR;2;2021-07-05;9179;29257;106;0;30893;0;0;0;0;3266400;2208336;8083;22;2428701;1;0;0;0
FR;2;2021-07-06;14584;36278;135;0;38957;0;0;0;0;3280984;2244614;8218;22;2467658;1;0;0;0
FR;2;2021-07-07;14421;33664;140;0;36417;0;0;0;0;3295405;2278278;8358;22;2504075;1;0;0;0
FR;2;2021-07-08;19723;40326;162;0;43983;0;0;0;0;3315128;2318604;8520;22;2548058;1;0;0;0
FR;2;2021-07-09;27105;54335;202;1;59486;0;0;0;0;3342233;2372939;8722;23;2607544;1;0;0;0
FR;2;2021-07-10;13389;33708;107;0;36392;0;0;0;0;3355622;2406647;8829;23;2643936;1;0;0;0
FR;2;2021-07-11;1811;4344;16;0;4771;0;0;0;0;3357433;2410991;8845;23;2648707;1;0;0;0
FR;2;2021-07-12;12971;37265;119;0;39920;0;0;0;0;3370404;2448256;8964;23;2688627;1;0;0;0
FR;2;2021-07-13;37120;53146;152;0;60280;0;0;0;0;3407524;2501402;9116;23;2748907;1;0;0;0
FR;2;2021-07-14;6628;3540;15;0;4887;0;0;0;0;3414152;2504942;9131;23;2753794;1;0;0;0
FR;2;2021-07-15;47244;47014;156;0;55210;0;0;0;0;3461396;2551956;9287;23;2809004;1;0;0;0
FR;2;2021-07-16;64320;55754;188;0;66737;0;0;0;0;3525716;2607710;9475;23;2875741;1;0;0;0
FR;2;2021-07-17;31603;23918;96;0;29375;0;0;0;0;3557319;2631628;9571;23;2905116;1;0;0;0
FR;2;2021-07-18;6090;4807;19;0;5952;0;0;0;0;3563409;2636435;9590;23;2911068;1;0;0;0
FR;2;2021-07-19;33007;28599;94;0;34212;0;0;0;0;3596416;2665034;9684;23;2945280;1;0;0;0
FR;2;2021-07-20;51999;44522;155;0;53157;0;0;0;0;3648415;2709556;9839;23;2998437;1;0;0;0
FR;2;2021-07-21;45256;34624;93;0;42126;0;0;0;0;3693671;2744180;9932;23;3040563;1;0;0;0
FR;2;2021-07-22;56280;41082;128;1;50355;0;0;0;0;3749951;2785262;10060;24;3090918;1;0;0;0
FR;2;2021-07-23;68305;48967;170;0;60256;0;0;0;0;3818256;2834229;10230;24;3151174;1;0;0;0
FR;2;2021-07-24;36178;21614;82;0;27472;0;0;0;0;3854434;2855843;10312;24;3178646;1;0;0;0
FR;2;2021-07-25;6751;2608;10;0;3866;0;0;0;0;3861185;2858451;10322;24;3182512;1;0;0;0
FR;2;2021-07-26;36320;22336;91;1;27839;0;0;0;0;3897505;2880787;10413;25;3210351;1;0;0;0
FR;2;2021-07-27;62392;34563;180;0;43711;0;0;0;0;3959897;2915350;10593;25;3254062;1;0;0;0
FR;2;2021-07-28;55326;26425;132;0;34511;0;0;0;0;4015223;2941775;10725;25;3288573;1;0;0;0
FR;2;2021-07-29;68481;32794;189;0;42475;0;0;0;0;4083704;2974569;10914;25;3331048;1;0;0;0
FR;2;2021-07-30;74468;37816;222;1;48606;0;0;0;0;4158172;3012385;11136;26;3379654;1;0;0;0
FR;2;2021-07-31;34778;16207;105;0;21406;0;0;0;0;4192950;3028592;11241;26;3401060;1;0;0;0
FR;2;2021-08-01;5416;2260;19;0;3123;0;0;0;0;4198366;3030852;11260;26;3404183;1;0;0;0
FR;2;2021-08-02;35899;16150;101;0;21053;0;0;0;0;4234265;3047002;11361;26;3425236;1;0;0;0
FR;2;2021-08-03;55988;28261;143;0;35464;0;0;0;0;4290253;3075263;11504;26;3460700;1;0;0;0
FR;2;2021-08-04;46638;20828;128;1;26936;0;0;0;0;4336891;3096091;11632;27;3487636;1;0;0;0
FR;2;2021-08-05;54642;31563;215;0;38739;0;0;0;0;4391533;3127654;11847;27;3526375;1;0;0;0
FR;2;2021-08-06;58099;42398;242;1;50226;0;0;0;0;4449632;3170052;12089;28;3576601;1;0;0;0
FR;2;2021-08-07;25152;17627;89;0;21317;0;0;0;0;4474784;3187679;12178;28;3597918;1;0;0;0
FR;2;2021-08-08;3840;3653;21;0;4311;0;0;0;0;4478624;3191332;12199;28;3602229;1;0;0;0
FR;2;2021-08-09;29308;21023;92;0;24849;0;0;0;0;4507932;3212355;12291;28;3627078;1;0;0;0
FR;2;2021-08-10;45014;33467;155;0;39228;0;0;0;0;4552946;3245822;12446;28;3666306;1;0;0;0
FR;2;2021-08-11;35277;25145;151;0;29744;0;0;0;0;4588223;3270967;12597;28;3696050;1;0;0;0
FR;2;2021-08-12;41905;35692;163;0;41229;0;0;0;0;4630128;3306659;12760;28;3737279;1;0;0;0
FR;2;2021-08-13;42608;37354;218;0;43041;0;0;0;0;4672736;3344013;12978;28;3780320;1;0;0;0
FR;2;2021-08-14;18524;22131;94;0;24762;0;0;0;0;4691260;3366144;13072;28;3805082;1;0;0;0
FR;2;2021-08-15;3865;3796;17;0;4382;0;0;0;0;4695125;3369940;13089;28;3809464;1;0;0;0
FR;2;2021-08-16;25095;27123;111;0;30446;0;0;0;0;4720220;3397063;13200;28;3839910;1;0;0;0
FR;2;2021-08-17;38270;43396;207;2;48380;0;0;0;0;4758490;3440459;13407;30;3888290;1;0;0;0
FR;2;2021-08-18;32254;36352;195;1;40693;0;0;0;0;4790744;3476811;13602;31;3928983;1;0;0;0
FR;2;2021-08-19;37436;46575;224;0;51775;0;0;0;0;4828180;3523386;13826;31;3980758;1;0;0;0
FR;2;2021-08-20;40568;55648;271;1;61573;0;0;0;0;4868748;3579034;14097;32;4042331;1;0;0;0
FR;2;2021-08-21;18122;24322;117;0;27114;0;0;0;0;4886870;3603356;14214;32;4069445;1;0;0;0
FR;2;2021-08-22;2909;4319;22;1;4851;1;0;0;0;4889779;3607675;14236;33;4074296;2;0;0;0
FR;2;2021-08-23;19250;35149;131;1;38039;0;0;0;0;4909029;3642824;14367;34;4112335;2;0;0;0
FR;2;2021-08-24;31952;56036;236;0;60693;0;0;0;0;4940981;3698860;14603;34;4173028;2;0;0;0
FR;2;2021-08-25;25934;43456;251;0;47405;0;0;0;0;4966915;3742316;14854;34;4220433;2;0;0;0
FR;2;2021-08-26;32362;55848;388;0;60586;0;0;0;0;4999277;3798164;15242;34;4281019;2;0;0;0
FR;2;2021-08-27;37003;65679;477;2;71403;0;0;0;0;5036280;3863843;15719;36;4352422;2;0;0;0
FR;2;2021-08-28;17819;28556;300;0;31616;0;0;0;0;5054099;3892399;16019;36;4384038;2;0;0;0
FR;2;2021-08-29;2656;5012;47;0;5623;0;0;0;0;5056755;3897411;16066;36;4389661;2;0;0;0
FR;2;2021-08-30;18418;37728;399;0;40147;756;0;0;0;5075173;3935139;16465;36;4429808;758;0;0;0
FR;2;2021-08-31;28077;57516;887;4;60947;1558;0;0;0;5103250;3992655;17352;40;4490755;2316;0;0;0
FR;2;2021-09-01;21595;39876;1309;0;42254;2129;0;0;0;5124845;4032531;18661;40;4533009;4445;0;0;0
FR;2;2021-09-02;25486;48668;1963;2;50943;3369;0;0;0;5150331;4081199;20624;42;4583952;7814;0;0;0
FR;2;2021-09-03;33414;64575;2988;3;67537;4886;1;0;0;5183745;4145774;23612;45;4651489;12700;1;0;0
FR;2;2021-09-04;16833;27764;1443;1;29554;2386;0;0;0;5200578;4173538;25055;46;4681043;15086;1;0;0
FR;2;2021-09-05;2265;3585;266;0;3941;412;0;0;0;5202843;4177123;25321;46;4684984;15498;1;0;0
FR;2;2021-09-06;14045;28693;1771;1;29758;2945;0;0;0;5216888;4205816;27092;47;4714742;18443;1;0;0
FR;2;2021-09-07;21111;41110;3022;13;42261;4945;0;0;0;5237999;4246926;30114;60;4757003;23388;1;0;0
FR;2;2021-09-08;17248;31922;2735;6;32738;4499;0;0;0;5255247;4278848;32849;66;4789741;27887;1;0;0
FR;2;2021-09-09;20982;40485;4437;3;41229;6842;0;0;0;5276229;4319333;37286;69;4830970;34729;1;0;0
FR;2;2021-09-10;28203;51318;5286;4;51885;8980;1;0;0;5304432;4370651;42572;73;4882855;43709;2;0;0
FR;2;2021-09-11;13655;22461;2405;5;23133;3990;0;0;0;5318087;4393112;44977;78;4905988;47699;2;0;0
FR;2;2021-09-12;1824;2770;292;0;2964;509;0;0;0;5319911;4395882;45269;78;4908952;48208;2;0;0
FR;2;2021-09-13;11659;21441;2474;4;21701;4052;0;0;0;5331570;4417323;47743;82;4930653;52260;2;0;0
FR;2;2021-09-14;18579;32719;5092;13;31679;9054;2;0;0;5350149;4450042;52835;95;4962332;61314;4;0;0
FR;2;2021-09-15;14917;28227;5168;3;26926;7749;9;0;0;5365066;4478269;58003;98;4989258;69063;13;0;0
FR;2;2021-09-16;16079;32800;6737;12;30181;10541;4;0;0;5381145;4511069;64740;110;5019439;79604;17;0;0
FR;2;2021-09-17;20916;47179;8782;10;42825;14631;6;0;0;5402061;4558248;73522;120;5062264;94235;23;0;0
FR;2;2021-09-18;9856;20959;3804;6;19595;6034;1;0;0;5411917;4579207;77326;126;5081859;100269;24;0;0
FR;2;2021-09-19;1166;2589;396;0;2532;631;0;0;0;5413083;4581796;77722;126;5084391;100900;24;0;0
FR;2;2021-09-20;7503;18702;3856;7;17025;6135;4;0;0;5420586;4600498;81578;133;5101416;107035;28;0;0
FR;2;2021-09-21;11215;29983;6495;5;26536;10744;3;0;0;5431801;4630481;88073;138;5127952;117779;31;0;0
FR;2;2021-09-22;9415;23545;5490;6;21193;8526;8;0;0;5441216;4654026;93563;144;5149145;126305;39;0;0
FR;2;2021-09-23;10730;28906;7881;10;24732;12647;10;0;0;5451946;4682932;101444;154;5173877;138952;49;0;0
FR;2;2021-09-24;15075;42947;10878;18;37281;17246;21;0;0;5467021;4725879;112322;172;5211158;156198;70;0;0
FR;2;2021-09-25;7258;18799;3965;9;17152;6120;3;0;0;5474279;4744678;116287;181;5228310;162318;73;0;0
FR;2;2021-09-26;1080;2543;495;0;2489;630;1;0;0;5475359;4747221;116782;181;5230799;162948;74;0;0
FR;2;2021-09-27;6311;16399;4287;8;14791;6533;2;0;0;5481670;4763620;121069;189;5245590;169481;76;0;0
FR;2;2021-09-28;9243;25573;7770;14;21719;12089;7;0;0;5490913;4789193;128839;203;5267309;181570;83;0;0
FR;2;2021-09-29;8081;20198;6067;25;17606;9259;8;0;0;5498994;4809391;134906;228;5284915;190829;91;0;0
FR;2;2021-09-30;9865;25838;9509;16;21639;14099;6;0;0;5508859;4835229;144415;244;5306554;204928;97;0;0
FR;2;2021-10-01;13979;35735;12921;25;30045;19328;9;0;0;5522838;4870964;157336;269;5336599;224256;106;0;0
FR;2;2021-10-02;6875;15933;4850;7;14226;7047;6;0;0;5529713;4886897;162186;276;5350825;231303;112;0;0
FR;2;2021-10-03;841;1908;492;1;1839;502;0;0;0;5530554;4888805;162678;277;5352664;231805;112;0;0
FR;2;2021-10-04;5826;13900;5516;5;12135;7854;6;0;0;5536380;4902705;168194;282;5364799;239659;118;0;0
FR;2;2021-10-05;9058;22573;11125;19;18533;15741;1;0;0;5545438;4925278;179319;301;5383332;255400;119;0;0
FR;2;2021-10-06;7785;17747;8243;11;15274;11090;4;0;0;5553223;4943025;187562;312;5398606;266490;123;0;0
FR;2;2021-10-07;9204;22215;12386;14;18008;16878;6;0;0;5562427;4965240;199948;326;5416614;283368;129;0;0
FR;2;2021-10-08;13432;32143;17348;28;26517;23608;11;0;0;5575859;4997383;217296;354;5443131;306976;140;0;0
FR;2;2021-10-09;6000;12847;6044;6;11381;7897;7;0;0;5581859;5010230;223340;360;5454512;314873;147;0;0
FR;2;2021-10-10;885;1592;436;2;1535;604;1;0;0;5582744;5011822;223776;362;5456047;315477;148;0;0
FR;2;2021-10-11;5607;11544;6455;17;9932;8829;3;0;0;5588351;5023366;230231;379;5465979;324306;151;0;0
FR;2;2021-10-12;8031;17790;12551;13;13921;16790;9;0;0;5596382;5041156;242782;392;5479900;341096;160;0;0
FR;2;2021-10-13;6947;14870;10256;12;11811;13663;7;0;0;5603329;5056026;253038;404;5491711;354759;167;0;0
FR;2;2021-10-14;8314;17941;14996;13;13556;19479;10;0;0;5611643;5073967;268034;417;5505267;374238;177;0;0
FR;2;2021-10-15;11856;26311;20902;26;19412;27982;4;0;0;5623499;5100278;288936;443;5524679;402220;181;0;0
FR;2;2021-10-16;5141;8728;1819;0;8172;3205;2;0;0;5628640;5109006;290755;443;5532851;405425;183;0;0
FR;2;2021-10-17;654;1150;185;0;1083;354;1;0;0;5629294;5110156;290940;443;5533934;405779;184;0;0
FR;2;2021-10-18;4564;7335;665;2;7242;1629;0;0;0;5633858;5117491;291605;445;5541176;407408;184;0;0
FR;2;2021-10-19;6239;9849;732;5;9654;2030;5;0;0;5640097;5127340;292337;450;5550830;409438;189;0;0
FR;2;2021-10-20;5170;8051;759;3;8173;1675;0;0;0;5645267;5135391;293096;453;5559003;411113;189;0;0
FR;2;2021-10-21;6090;9982;780;5;9840;2104;1;0;0;5651357;5145373;293876;458;5568843;413217;190;0;0
FR;2;2021-10-22;8452;14602;1151;4;14478;2891;2;0;0;5659809;5159975;295027;462;5583321;416108;192;0;0
FR;2;2021-10-23;3845;5993;587;0;6125;1235;3;0;0;5663654;5165968;295614;462;5589446;417343;195;0;0
FR;2;2021-10-24;494;882;101;0;900;204;0;0;0;5664148;5166850;295715;462;5590346;417547;195;0;0
FR;2;2021-10-25;3360;5342;307;1;5518;825;2;0;0;5667508;5172192;296022;463;5595864;418372;197;0;0
FR;2;2021-10-26;4177;7238;1134;4;7126;2024;5;0;0;5671685;5179430;297156;467;5602990;420396;202;0;0
FR;2;2021-10-27;3677;6586;1194;5;6448;1989;1;0;0;5675362;5186016;298350;472;5609438;422385;203;0;0
FR;2;2021-10-28;4597;7687;1737;3;7415;2746;1;0;0;5679959;5193703;300087;475;5616853;425131;204;0;0
FR;2;2021-10-29;5414;11082;2438;4;10692;3684;3;0;0;5685373;5204785;302525;479;5627545;428815;207;0;0
FR;2;2021-10-30;2749;4455;976;1;4450;1448;2;0;0;5688122;5209240;303501;480;5631995;430263;209;0;0
FR;2;2021-10-31;364;535;140;1;544;191;1;0;0;5688486;5209775;303641;481;5632539;430454;210;0;0
FR;2;2021-11-01;430;546;181;0;563;267;1;0;0;5688916;5210321;303822;481;5633102;430721;211;0;0
FR;2;2021-11-02;3294;6760;1184;0;6800;1771;5;0;0;5692210;5217081;305006;481;5639902;432492;216;0;0
FR;2;2021-11-03;3340;6227;1389;2;6311;1971;2;0;0;5695550;5223308;306395;483;5646213;434463;218;0;0
FR;2;2021-11-04;3987;7069;1769;4;7109;2495;3;0;0;5699537;5230377;308164;487;5653322;436958;221;0;0
FR;2;2021-11-05;5235;10502;2869;5;10215;3957;6;0;0;5704772;5240879;311033;492;5663537;440915;227;0;0
FR;2;2021-11-06;2597;4684;1407;0;4641;1824;2;0;0;5707369;5245563;312440;492;5668178;442739;229;0;0
FR;2;2021-11-07;506;862;221;0;869;291;2;0;0;5707875;5246425;312661;492;5669047;443030;231;0;0
FR;2;2021-11-08;2578;5348;1207;3;5268;1678;3;0;0;5710453;5251773;313868;495;5674315;444708;234;0;0
FR;2;2021-11-09;2749;6907;2402;5;6442;3181;2;0;0;5713202;5258680;316270;500;5680757;447889;236;0;0
FR;2;2021-11-10;2590;5668;5118;6;4761;6294;7;0;0;5715792;5264348;321388;506;5685518;454183;243;0;0
FR;2;2021-11-11;446;754;755;2;647;938;3;0;0;5716238;5265102;322143;508;5686165;455121;246;0;0
FR;2;2021-11-12;2953;8088;8982;8;6197;10932;9;0;0;5719191;5273190;331125;516;5692362;466053;255;0;0
FR;2;2021-11-13;1539;3372;3872;7;2720;4538;4;0;0;5720730;5276562;334997;523;5695082;470591;259;0;0
FR;2;2021-11-14;258;585;351;1;486;480;3;0;0;5720988;5277147;335348;524;5695568;471071;262;0;0
FR;2;2021-11-15;1621;3654;4449;8;2908;5329;16;0;0;5722609;5280801;339797;532;5698476;476400;278;0;0
FR;2;2021-11-16;2185;5875;8314;14;4152;10083;16;0;0;5724794;5286676;348111;546;5702628;486483;294;0;0
FR;2;2021-11-17;1740;4523;6634;8;3168;7852;5;0;0;5726534;5291199;354745;554;5705796;494335;299;0;0
FR;2;2021-11-18;2192;5920;9188;10;4018;11018;8;0;0;5728726;5297119;363933;564;5709814;505353;307;0;0
FR;2;2021-11-19;2701;7752;12981;19;4832;15480;12;0;0;5731427;5304871;376914;583;5714646;520833;319;0;0
FR;2;2021-11-20;1566;3333;5185;5;2351;6098;3;0;0;5732993;5308204;382099;588;5716997;526931;322;0;0
FR;2;2021-11-21;251;504;543;0;393;656;3;0;0;5733244;5308708;382642;588;5717390;527587;325;0;0
FR;2;2021-11-22;1278;2570;4485;5;1673;5397;9;0;0;5734522;5311278;387127;593;5719063;532984;334;0;0
FR;2;2021-11-23;1617;4277;8207;9;2536;9923;6;0;0;5736139;5315555;395334;602;5721599;542907;340;0;0
FR;2;2021-11-24;1421;3747;7486;14;2246;8736;9;0;0;5737560;5319302;402820;616;5723845;551643;349;0;0
FR;2;2021-11-25;1814;4863;11474;21;2682;13668;6;0;0;5739374;5324165;414294;637;5726527;565311;355;0;0
FR;2;2021-11-26;2541;7735;22676;31;3812;26091;14;0;0;5741915;5331900;436970;668;5730339;591402;369;0;0
FR;2;2021-11-27;1498;4145;12278;19;2127;14042;13;0;0;5743413;5336045;449248;687;5732466;605444;382;0;0
FR;2;2021-11-28;292;835;1976;3;478;2303;5;0;0;5743705;5336880;451224;690;5732944;607747;387;0;0
FR;2;2021-11-29;1449;4348;15099;23;2009;17269;25;0;0;5745154;5341228;466323;713;5734953;625016;412;0;0
FR;2;2021-11-30;1913;6658;26252;36;2640;30014;22;0;0;5747067;5347886;492575;749;5737593;655030;434;0;0
FR;2;2021-12-01;1918;6006;26211;31;2477;29519;20;0;0;5748985;5353892;518786;780;5740070;684549;454;0;0
FR;2;2021-12-02;1916;6780;37736;52;2112;41995;32;0;0;5750901;5360672;556522;832;5742182;726544;486;0;0
FR;2;2021-12-03;2558;10069;53644;111;3592;59391;31;0;0;5753459;5370741;610166;943;5745774;785935;517;0;0
FR;2;2021-12-04;1850;6275;37132;38;2185;40820;16;0;0;5755309;5377016;647298;981;5747959;826755;533;0;0
FR;2;2021-12-05;458;2242;14265;14;533;15990;7;0;0;5755767;5379258;661563;995;5748492;842745;540;0;0
FR;2;2021-12-06;2486;9844;77735;109;2697;84785;25;0;0;5758253;5389102;739298;1104;5751189;927530;565;0;0
FR;2;2021-12-07;3458;15288;122475;238;3743;133797;40;0;0;5761711;5404390;861773;1342;5754932;1061327;605;0;0
FR;2;2021-12-08;3725;15967;133225;330;3844;145413;54;0;0;5765436;5420357;994998;1672;5758776;1206740;659;0;0
FR;2;2021-12-09;4547;19626;170241;554;4167;185639;61;0;0;5769983;5439983;1165239;2226;5762943;1392379;720;0;0
FR;2;2021-12-10;4676;22806;188699;490;5011;206189;69;0;0;5774659;5462789;1353938;2716;5767954;1598568;789;0;0
FR;2;2021-12-11;3687;16622;132469;239;3664;144937;60;0;0;5778346;5479411;1486407;2955;5771618;1743505;849;0;0
FR;2;2021-12-12;1256;7119;59116;83;1016;65169;12;0;0;5779602;5486530;1545523;3038;5772634;1808674;861;0;0
FR;2;2021-12-13;5529;26811;220733;605;5223;243029;159;0;0;5785131;5513341;1766256;3643;5777857;2051703;1020;0;0
FR;2;2021-12-14;7019;37458;300806;909;6137;332277;190;0;0;5792150;5550799;2067062;4552;5783994;2383980;1210;0;0
FR;2;2021-12-15;6555;36215;285263;958;5866;315902;186;0;0;5798705;5587014;2352325;5510;5789860;2699882;1396;0;0
FR;2;2021-12-16;7764;37922;312180;982;6563;343823;186;0;0;5806469;5624936;2664505;6492;5796423;3043705;1582;0;0
FR;2;2021-12-17;8680;41187;327911;976;8020;360987;232;0;0;5815149;5666123;2992416;7468;5804443;3404692;1814;0;0
FR;2;2021-12-18;6515;26527;212374;448;4904;233673;120;0;0;5821664;5692650;3204790;7916;5809347;3638365;1934;0;0
FR;2;2021-12-19;2603;11403;90226;182;1655;100356;26;0;0;5824267;5704053;3295016;8098;5811002;3738721;1960;0;0
FR;2;2021-12-20;9548;33514;275258;707;6586;303402;209;0;0;5833815;5737567;3570274;8805;5817588;4042123;2169;0;0
FR;2;2021-12-21;11568;38269;309663;968;7368;341439;262;0;0;5845383;5775836;3879937;9773;5824956;4383562;2431;0;0
FR;2;2021-12-22;10461;32776;265149;952;6442;292505;316;0;1;5855844;5808612;4145086;10725;5831398;4676067;2747;0;1
FR;2;2021-12-23;9426;26620;199534;701;5874;221294;225;0;0;5865270;5835232;4344620;11426;5837272;4897361;2972;0;1
FR;2;2021-12-24;2783;7466;43866;140;2036;49561;78;0;0;5868053;5842698;4388486;11566;5839308;4946922;3050;0;1
FR;2;2021-12-25;201;669;2003;10;209;2476;15;0;0;5868254;5843367;4390489;11576;5839517;4949398;3065;0;1
FR;2;2021-12-26;1320;4215;25162;71;1052;28694;70;0;0;5869574;5847582;4415651;11647;5840569;4978092;3135;0;1
FR;2;2021-12-27;8076;29929;218438;659;6624;243389;294;0;0;5877650;5877511;4634089;12306;5847193;5221481;3429;0;1
FR;2;2021-12-28;9832;36287;272117;742;6982;302015;957;0;1;5887482;5913798;4906206;13048;5854175;5523496;4386;0;2
FR;2;2021-12-29;9498;32219;246151;765;6402;272697;1088;0;0;5896980;5946017;5152357;13813;5860577;5796193;5474;0;2
FR;2;2021-12-30;9464;28089;208839;663;5970;231478;1155;0;0;5906444;5974106;5361196;14476;5866547;6027671;6629;0;2
FR;2;2021-12-31;3011;8340;54991;176;2169;61233;392;0;0;5909455;5982446;5416187;14652;5868716;6088904;7021;0;2
FR;2;2022-01-01;231;693;2858;7;207;3353;29;0;0;5909686;5983139;5419045;14659;5868923;6092257;7050;0;2
FR;2;2022-01-02;1503;4860;29524;76;1167;33418;217;0;0;5911189;5987999;5448569;14735;5870090;6125675;7267;0;2
FR;2;2022-01-03;9606;35395;266544;806;8498;293920;1672;0;0;5920795;6023394;5715113;15541;5878588;6419595;8939;0;2
FR;2;2022-01-04;12857;45401;342102;1068;9970;377042;2458;0;1;5933652;6068795;6057215;16609;5888558;6796637;11397;0;3
FR;2;2022-01-05;11273;38627;294222;885;8635;323856;2155;0;2;5944925;6107422;6351437;17494;5897193;7120493;13552;0;5
FR;2;2022-01-06;13653;43486;331956;1298;9932;364765;2977;0;1;5958578;6150908;6683393;18792;5907125;7485258;16529;0;6
FR;2;2022-01-07;14225;47609;361123;1271;11232;396464;3159;0;0;5972803;6198517;7044516;20063;5918357;7881722;19688;0;6
FR;2;2022-01-08;7946;28137;201276;515;7209;221703;1531;0;2;5980749;6226654;7245792;20578;5925566;8103425;21219;0;8
FR;2;2022-01-09;2749;8945;62531;137;2068;69497;493;0;0;5983498;6235599;7308323;20715;5927634;8172922;21712;0;8
FR;2;2022-01-10;10100;31907;232509;859;8901;255085;2460;0;0;5993598;6267506;7540832;21574;5936535;8428007;24172;0;8
FR;2;2022-01-11;11466;36235;265948;1030;10055;290655;3378;0;1;6005064;6303741;7806780;22604;5946590;8718662;27550;0;9
FR;2;2022-01-12;8767;29785;206335;863;8717;226176;2798;0;5;6013831;6333526;8013115;23467;5955307;8944838;30348;0;14
FR;2;2022-01-13;9387;31335;224510;831;9037;244857;3463;0;4;6023218;6364861;8237625;24298;5964344;9189695;33811;0;18
FR;2;2022-01-14;9746;35573;254551;920;9840;277655;3979;0;1;6032964;6400434;8492176;25218;5974184;9467350;37790;0;19
FR;2;2022-01-15;5361;19443;140788;363;5322;153648;1929;0;0;6038325;6419877;8632964;25581;5979506;9620998;39719;0;19
FR;2;2022-01-16;1512;5457;35892;81;1619;39818;424;0;0;6039837;6425334;8668856;25662;5981125;9660816;40143;0;19
FR;2;2022-01-17;5546;19264;135421;601;6600;147263;2264;0;2;6045383;6444598;8804277;26263;5987725;9808079;42407;0;21
FR;2;2022-01-18;6422;21479;148647;648;7518;160471;3311;0;0;6051805;6466077;8952924;26911;5995243;9968550;45718;0;21
FR;2;2022-01-19;4398;16304;105112;552;6206;113701;2411;0;1;6056203;6482381;9058036;27463;6001449;10082251;48129;0;22
FR;2;2022-01-20;4873;17571;115304;603;7067;123694;3111;0;2;6061076;6499952;9173340;28066;6008516;10205945;51240;0;24
FR;2;2022-01-21;5198;20042;137357;679;7170;147776;3455;0;1;6066274;6519994;9310697;28745;6015686;10353721;54695;0;25
FR;2;2022-01-22;3033;10956;74265;260;3956;80339;1428;0;0;6069307;6530950;9384962;29005;6019642;10434060;56123;0;25
FR;2;2022-01-23;724;2707;15243;41;1055;16826;238;0;0;6070031;6533657;9400205;29046;6020697;10450886;56361;0;25
FR;2;2022-01-24;3292;12792;75084;431;5843;81018;1994;0;2;6073323;6546449;9475289;29477;6026540;10531904;58355;0;27
FR;2;2022-01-25;3575;14404;79638;496;6650;85463;2879;0;4;6076898;6560853;9554927;29973;6033190;10617367;61234;0;31
FR;2;2022-01-26;2515;10702;58987;363;5331;63036;1958;0;1;6079413;6571555;9613914;30336;6038521;10680403;63192;0;32
FR;2;2022-01-27;2684;11386;64185;391;5738;67972;2462;0;1;6082097;6582941;9678099;30727;6044259;10748375;65654;0;33
FR;2;2022-01-28;3551;18257;91730;430;8611;98907;3399;0;1;6085648;6601198;9769829;31157;6052870;10847282;69053;0;34
FR;2;2022-01-29;1896;9234;48856;164;4170;52929;1374;0;1;6087544;6610432;9818685;31321;6057040;10900211;70427;0;35
FR;2;2022-01-30;464;2206;9457;38;1049;10584;203;0;0;6088008;6612638;9828142;31359;6058089;10910795;70630;0;35
FR;2;2022-01-31;1891;9551;43834;209;4709;47322;1885;0;2;6089899;6622189;9871976;31568;6062798;10958117;72515;0;37
FR;2;2022-02-01;1917;10019;47030;279;4797;50078;2707;0;0;6091816;6632208;9919006;31847;6067595;11008195;75222;0;37
FR;2;2022-02-02;1614;8970;41124;250;4190;44147;2189;0;1;6093430;6641178;9960130;32097;6071785;11052342;77411;0;38
FR;2;2022-02-03;1732;8929;40526;205;4368;42912;2639;0;2;6095162;6650107;10000656;32302;6076153;11095254;80050;0;40
FR;2;2022-02-04;2151;15168;66648;299;7380;71317;3670;0;1;6097313;6665275;10067304;32601;6083533;11166571;83720;0;41
FR;2;2022-02-05;1360;8517;35948;132;4214;39220;1369;0;0;6098673;6673792;10103252;32733;6087747;11205791;85089;0;41
FR;2;2022-02-06;275;1761;6130;17;842;6899;218;0;0;6098948;6675553;10109382;32750;6088589;11212690;85307;0;41
FR;2;2022-02-07;1352;9543;37760;134;4535;41288;1888;0;2;6100300;6685096;10147142;32884;6093124;11253978;87195;0;43
FR;2;2022-02-08;1300;9834;40956;173;4647;43750;2741;0;1;6101600;6694930;10188098;33057;6097771;11297728;89936;0;44
FR;2;2022-02-09;1160;8841;37040;174;3804;40465;1901;0;2;6102760;6703771;10225138;33231;6101575;11338193;91837;0;46
FR;2;2022-02-10;1030;8001;33837;204;3605;36511;2051;0;1;6103790;6711772;10258975;33435;6105180;11374704;93888;0;47
FR;2;2022-02-11;1391;12088;53348;223;5283;57702;2888;0;0;6105181;6723860;10312323;33658;6110463;11432406;96776;0;47
FR;2;2022-02-12;753;6535;27989;86;2792;30808;1113;0;2;6105934;6730395;10340312;33744;6113255;11463214;97889;0;49
FR;2;2022-02-13;200;1340;4836;20;562;5577;141;0;0;6106134;6731735;10345148;33764;6113817;11468791;98030;0;49
FR;2;2022-02-14;836;6732;30274;92;2599;33233;1399;0;1;6106970;6738467;10375422;33856;6116416;11502024;99429;0;50
FR;2;2022-02-15;773;6473;28051;140;2801;29994;1965;0;2;6107743;6744940;10403473;33996;6119217;11532018;101394;0;52
FR;2;2022-02-16;657;5362;22069;124;2528;23634;1569;0;3;6108400;6750302;10425542;34120;6121745;11555652;102963;0;55
FR;2;2022-02-17;518;3786;14153;98;2131;14618;1406;0;2;6108918;6754088;10439695;34218;6123876;11570270;104369;0;57
FR;2;2022-02-18;723;5369;20443;134;3041;21130;1895;0;0;6109641;6759457;10460138;34352;6126917;11591400;106264;0;57
FR;2;2022-02-19;431;3061;10533;66;1699;11247;753;0;2;6110072;6762518;10470671;34418;6128616;11602647;107017;0;59
FR;2;2022-02-20;102;520;1463;3;314;1613;100;0;0;6110174;6763038;10472134;34421;6128930;11604260;107117;0;59
FR;2;2022-02-21;423;2685;9122;65;1569;9499;930;0;0;6110597;6765723;10481256;34486;6130499;11613759;108047;0;59
FR;2;2022-02-22;393;2568;8894;77;1622;8797;1180;0;0;6110990;6768291;10490150;34563;6132121;11622556;109227;0;59
FR;2;2022-02-23;432;2605;8992;82;1522;9269;1022;0;0;6111422;6770896;10499142;34645;6133643;11631825;110249;0;59
FR;2;2022-02-24;314;2039;6805;82;1251;6835;870;0;0;6111736;6772935;10505947;34727;6134894;11638660;111119;0;59
FR;2;2022-02-25;456;3210;11424;107;1979;11287;1560;0;3;6112192;6776145;10517371;34834;6136873;11649947;112679;0;62
FR;2;2022-02-26;297;1892;6038;49;1161;6345;587;0;1;6112489;6778037;10523409;34883;6138034;11656292;113266;0;63
FR;2;2022-02-27;76;313;908;5;214;951;98;0;0;6112565;6778350;10524317;34888;6138248;11657243;113364;0;63
FR;2;2022-02-28;332;1689;5525;53;1088;5531;733;0;0;6112897;6780039;10529842;34941;6139336;11662774;114097;0;63
FR;2;2022-03-01;279;1569;5484;46;952;5201;964;0;2;6113176;6781608;10535326;34987;6140288;11667975;115061;0;65
FR;2;2022-03-02;298;1446;5248;46;878;5092;816;0;1;6113474;6783054;10540574;35033;6141166;11673067;115877;0;66
FR;2;2022-03-03;226;1112;3709;42;721;3486;668;0;1;6113700;6784166;10544283;35075;6141887;11676553;116545;0;67
FR;2;2022-03-04;243;1469;4860;74;983;4506;950;0;1;6113943;6785635;10549143;35149;6142870;11681059;117495;0;68
FR;2;2022-03-05;174;906;2980;34;613;2724;561;0;0;6114117;6786541;10552123;35183;6143483;11683783;118056;0;68
FR;2;2022-03-06;42;190;280;5;110;322;52;0;0;6114159;6786731;10552403;35188;6143593;11684105;118108;0;68
FR;2;2022-03-07;157;659;1990;70;491;1780;472;0;0;6114316;6787390;10554393;35258;6144084;11685885;118580;0;68
FR;2;2022-03-08;144;670;2273;53;461;1908;619;0;0;6114460;6788060;10556666;35311;6144545;11687793;119199;0;68
FR;2;2022-03-09;156;709;2351;37;473;2052;617;0;0;6114616;6788769;10559017;35348;6145018;11689845;119816;0;68
FR;2;2022-03-10;123;603;1696;35;446;1471;456;0;1;6114739;6789372;10560713;35383;6145464;11691316;120272;0;69
FR;2;2022-03-11;172;757;2770;57;505;2369;737;0;1;6114911;6790129;10563483;35440;6145969;11693685;121009;0;70
FR;2;2022-03-12;149;485;1787;27;331;1557;450;0;0;6115060;6790614;10565270;35467;6146300;11695242;121459;0;70
FR;2;2022-03-13;25;75;203;30;45;204;69;0;0;6115085;6790689;10565473;35497;6146345;11695446;121528;0;70
FR;2;2022-03-14;129;470;1572;529;333;1301;951;0;0;6115214;6791159;10567045;36026;6146678;11696747;122479;0;70
FR;2;2022-03-15;139;441;1713;691;333;1333;1186;0;1;6115353;6791600;10568758;36717;6147011;11698080;123665;0;71
FR;2;2022-03-16;142;476;2013;1616;331;1593;2160;0;2;6115495;6792076;10570771;38333;6147342;11699673;125825;0;73
FR;2;2022-03-17;95;413;1412;1192;273;1148;1576;0;1;6115590;6792489;10572183;39525;6147615;11700821;127401;0;74
FR;2;2022-03-18;147;496;2026;1795;335;1669;2313;0;1;6115737;6792985;10574209;41320;6147950;11702490;129714;0;75
FR;2;2022-03-19;108;321;1210;941;219;1015;1259;0;0;6115845;6793306;10575419;42261;6148169;11703505;130973;0;75
FR;2;2022-03-20;13;77;191;59;39;168;115;0;0;6115858;6793383;10575610;42320;6148208;11703673;131088;0;75
FR;2;2022-03-21;98;307;1218;1483;181;1081;1760;0;1;6115956;6793690;10576828;43803;6148389;11704754;132848;0;76
FR;2;2022-03-22;118;391;1533;1831;244;1294;2220;0;0;6116074;6794081;10578361;45634;6148633;11706048;135068;0;76
FR;2;2022-03-23;137;362;1684;3032;232;1475;3374;0;6;6116211;6794443;10580045;48666;6148865;11707523;138442;0;82
FR;2;2022-03-24;117;293;1183;1548;186;1001;1814;0;8;6116328;6794736;10581228;50214;6149051;11708524;140256;0;90
FR;2;2022-03-25;119;361;1807;2451;238;1477;2837;0;8;6116447;6795097;10583035;52665;6149289;11710001;143093;0;98
FR;2;2022-03-26;79;247;1205;1222;138;953;1531;0;5;6116526;6795344;10584240;53887;6149427;11710954;144624;0;103
FR;2;2022-03-27;19;36;154;100;19;133;144;0;0;6116545;6795380;10584394;53987;6149446;11711087;144768;0;103
FR;2;2022-03-28;94;290;1140;1602;189;996;1835;0;6;6116639;6795670;10585534;55589;6149635;11712083;146603;0;109
FR;2;2022-03-29;108;258;1325;2467;167;1105;2760;0;4;6116747;6795928;10586859;58056;6149802;11713188;149363;0;113
FR;2;2022-03-30;91;313;1489;3187;164;1320;3424;0;2;6116838;6796241;10588348;61243;6149966;11714508;152787;0;115
FR;2;2022-03-31;104;284;1277;2332;171;1092;2616;0;3;6116942;6796525;10589625;63575;6150137;11715600;155403;0;118
FR;2;2022-04-01;123;324;1568;2349;164;1323;2667;0;7;6117065;6796849;10591193;65924;6150301;11716923;158070;0;125
FR;2;2022-04-02;81;161;845;891;83;737;1052;0;1;6117146;6797010;10592038;66815;6150384;11717660;159122;0;126
FR;2;2022-04-03;16;53;128;113;27;142;133;0;1;6117162;6797063;10592166;66928;6150411;11717802;159255;0;127
FR;2;2022-04-04;114;249;990;1447;151;799;1693;0;5;6117276;6797312;10593156;68375;6150562;11718601;160948;0;132
FR;2;2022-04-05;143;302;1322;2921;162;1150;3150;0;17;6117419;6797614;10594478;71296;6150724;11719751;164098;0;149
FR;2;2022-04-06;89;261;1308;2522;129;1131;2687;0;10;6117508;6797875;10595786;73818;6150853;11720882;166785;0;159
FR;2;2022-04-07;120;230;1303;2682;141;1042;2958;0;8;6117628;6798105;10597089;76500;6150994;11721924;169743;0;167
FR;2;2022-04-08;126;346;1636;3351;182;1328;3642;0;12;6117754;6798451;10598725;79851;6151176;11723252;173385;0;179
FR;2;2022-04-09;90;219;900;1046;144;732;1288;0;4;6117844;6798670;10599625;80897;6151320;11723984;174673;0;183
FR;2;2022-04-10;37;49;143;162;46;119;200;0;1;6117881;6798719;10599768;81059;6151366;11724103;174873;0;184
FR;2;2022-04-11;88;196;892;1560;122;782;1718;0;6;6117969;6798915;10600660;82619;6151488;11724885;176591;0;190
FR;2;2022-04-12;176;273;1183;2770;175;1062;2903;0;8;6118145;6799188;10601843;85389;6151663;11725947;179494;0;198
FR;2;2022-04-13;147;232;1125;2477;111;989;2671;0;11;6118292;6799420;10602968;87866;6151774;11726936;182165;0;209
FR;2;2022-04-14;116;227;1085;2677;114;919;2911;0;18;6118408;6799647;10604053;90543;6151888;11727855;185076;0;227
FR;2;2022-04-15;114;261;1221;2304;131;1078;2544;0;7;6118522;6799908;10605274;92847;6152019;11728933;187620;0;234
FR;2;2022-04-16;67;108;548;549;68;459;675;0;9;6118589;6800016;10605822;93396;6152087;11729392;188295;0;243
FR;2;2022-04-17;15;28;57;53;17;53;71;0;0;6118604;6800044;10605879;93449;6152104;11729445;188366;0;243
FR;2;2022-04-18;12;35;121;70;18;116;95;0;0;6118616;6800079;10606000;93519;6152122;11729561;188461;0;243
FR;2;2022-04-19;112;237;1120;1750;149;951;1934;0;9;6118728;6800316;10607120;95269;6152271;11730512;190395;0;252
FR;2;2022-04-20;95;243;1111;2172;127;935;2366;0;14;6118823;6800559;10608231;97441;6152398;11731447;192761;0;266
FR;2;2022-04-21;111;233;983;1912;125;838;2141;0;10;6118934;6800792;10609214;99353;6152523;11732285;194902;0;276
FR;2;2022-04-22;100;276;1243;2102;141;1024;2440;0;11;6119034;6801068;10610457;101455;6152664;11733309;197342;0;287
FR;2;2022-04-23;67;156;645;762;107;574;862;0;8;6119101;6801224;10611102;102217;6152771;11733883;198204;0;295
FR;2;2022-04-24;12;30;101;68;12;79;100;0;0;6119113;6801254;10611203;102285;6152783;11733962;198304;0;295
FR;2;2022-04-25;104;204;822;1329;103;711;1528;0;15;6119217;6801458;10612025;103614;6152886;11734673;199832;0;310
FR;2;2022-04-26;110;184;1041;2022;118;879;2219;0;18;6119327;6801642;10613066;105636;6153004;11735552;202051;0;328
FR;2;2022-04-27;98;181;860;1787;122;764;1809;0;7;6119425;6801823;10613926;107423;6153126;11736316;203860;0;335
FR;2;2022-04-28;93;214;949;1931;128;842;2087;0;12;6119518;6802037;10614875;109354;6153254;11737158;205947;0;347
FR;2;2022-04-29;81;282;1133;1697;131;1044;1876;0;11;6119599;6802319;10616008;111051;6153385;11738202;207823;0;358
FR;2;2022-04-30;66;127;471;540;80;430;628;0;9;6119665;6802446;10616479;111591;6153465;11738632;208451;0;367
FR;2;2022-05-01;24;24;84;49;20;85;61;0;1;6119689;6802470;10616563;111640;6153485;11738717;208512;0;368
FR;2;2022-05-02;115;232;764;1217;141;662;1375;0;5;6119804;6802702;10617327;112857;6153626;11739379;209887;0;373
FR;2;2022-05-03;153;233;999;1781;155;938;1895;0;14;6119957;6802935;10618326;114638;6153781;11740317;211782;0;387
FR;2;2022-05-04;90;226;926;1811;116;869;1822;0;13;6120047;6803161;10619252;116449;6153897;11741186;213604;0;400
FR;2;2022-05-05;127;198;857;1732;147;774;1848;0;10;6120174;6803359;10620109;118181;6154044;11741960;215452;0;410
FR;2;2022-05-06;133;246;1101;1855;139;1017;2052;0;16;6120307;6803605;10621210;120036;6154183;11742977;217504;0;426
FR;2;2022-05-07;40;99;470;504;61;406;593;0;4;6120347;6803704;10621680;120540;6154244;11743383;218097;0;430
FR;2;2022-05-08;48;54;107;71;41;102;101;0;0;6120395;6803758;10621787;120611;6154285;11743485;218198;0;430
FR;2;2022-05-09;101;174;654;986;103;604;1130;0;9;6120496;6803932;10622441;121597;6154388;11744089;219328;0;439
FR;2;2022-05-10;121;252;938;1841;155;893;1965;0;23;6120617;6804184;10623379;123438;6154543;11744982;221293;0;462
FR;2;2022-05-11;103;179;816;1879;117;795;1868;0;8;6120720;6804363;10624195;125317;6154660;11745777;223161;0;470
FR;2;2022-05-12;111;174;845;2096;116;803;2213;0;21;6120831;6804537;10625040;127413;6154776;11746580;225374;0;491
FR;2;2022-05-13;100;236;969;2097;122;900;2273;0;13;6120931;6804773;10626009;129510;6154898;11747480;227647;0;504
FR;2;2022-05-14;76;124;451;553;93;411;632;0;6;6121007;6804897;10626460;130063;6154991;11747891;228279;0;510
FR;2;2022-05-15;24;39;94;88;20;108;95;0;1;6121031;6804936;10626554;130151;6155011;11747999;228374;0;511
FR;2;2022-05-16;102;171;601;925;116;537;1037;0;11;6121133;6805107;10627155;131076;6155127;11748536;229411;0;522
FR;2;2022-05-17;95;184;690;1687;119;658;1739;0;8;6121228;6805291;10627845;132763;6155246;11749194;231150;0;530
FR;2;2022-05-18;80;181;643;1431;97;648;1486;0;10;6121308;6805472;10628488;134194;6155343;11749842;232636;0;540
FR;2;2022-05-19;73;161;710;1830;81;752;1816;0;12;6121381;6805633;10629198;136024;6155424;11750594;234452;0;552
FR;2;2022-05-20;107;181;874;1701;111;779;1849;0;17;6121488;6805814;10630072;137725;6155535;11751373;236301;0;569
FR;2;2022-05-21;48;96;398;517;71;339;581;0;8;6121536;6805910;10630470;138242;6155606;11751712;236882;0;577
FR;2;2022-05-22;8;23;69;37;18;57;56;0;0;6121544;6805933;10630539;138279;6155624;11751769;236938;0;577
FR;2;2022-05-23;86;133;498;931;100;469;967;0;7;6121630;6806066;10631037;139210;6155724;11752238;237905;0;584
FR;2;2022-05-24;87;164;627;1626;103;615;1680;0;17;6121717;6806230;10631664;140836;6155827;11752853;239585;0;601
FR;2;2022-05-25;72;146;539;1149;90;494;1260;0;5;6121789;6806376;10632203;141985;6155917;11753347;240845;0;606
FR;2;2022-05-26;12;31;77;45;13;85;56;0;1;6121801;6806407;10632280;142030;6155930;11753432;240901;0;607
FR;2;2022-05-27;44;124;456;818;68;438;893;0;9;6121845;6806531;10632736;142848;6155998;11753870;241794;0;616
FR;2;2022-05-28;28;60;221;244;29;221;266;0;1;6121873;6806591;10632957;143092;6156027;11754091;242060;0;617
FR;2;2022-05-29;13;34;43;25;22;51;28;0;0;6121886;6806625;10633000;143117;6156049;11754142;242088;0;617
FR;2;2022-05-30;65;109;425;755;60;410;806;0;6;6121951;6806734;10633425;143872;6156109;11754552;242894;0;623
FR;2;2022-05-31;76;135;564;1278;92;511;1304;0;12;6122027;6806869;10633989;145150;6156201;11755063;244198;0;635
FR;2;2022-06-01;59;160;564;1075;86;543;1170;0;6;6122086;6807029;10634553;146225;6156287;11755606;245368;0;641
FR;2;2022-06-02;92;178;627;1450;109;593;1557;0;12;6122178;6807207;10635180;147675;6156396;11756199;246925;0;653
FR;2;2022-06-03;71;157;668;1605;96;595;1694;0;19;6122249;6807364;10635848;149280;6156492;11756794;248619;0;672
FR;2;2022-06-04;69;93;283;434;66;269;476;0;11;6122318;6807457;10636131;149714;6156558;11757063;249095;0;683
FR;2;2022-06-05;12;17;63;58;16;47;75;0;1;6122330;6807474;10636194;149772;6156574;11757110;249170;0;684
FR;2;2022-06-06;12;41;93;76;30;92;81;0;4;6122342;6807515;10636287;149848;6156604;11757202;249251;0;688
FR;2;2022-06-07;99;222;667;1535;154;577;1661;0;10;6122441;6807737;10636954;151383;6156758;11757779;250912;0;698
FR;2;2022-06-08;70;119;477;1166;76;411;1262;0;5;6122511;6807856;10637431;152549;6156834;11758190;252174;0;703
FR;2;2022-06-09;93;167;613;1923;108;571;1927;0;18;6122604;6808023;10638044;154472;6156942;11758761;254101;0;721
FR;2;2022-06-10;93;168;651;1683;107;623;1774;0;23;6122697;6808191;10638695;156155;6157049;11759384;255875;0;744
FR;2;2022-06-11;44;85;287;529;42;258;583;0;5;6122741;6808276;10638982;156684;6157091;11759642;256458;0;749
FR;2;2022-06-12;18;38;58;78;27;60;78;0;0;6122759;6808314;10639040;156762;6157118;11759702;256536;0;749
FR;2;2022-06-13;39;121;395;953;63;379;1021;0;6;6122798;6808435;10639435;157715;6157181;11760081;257557;0;755
FR;2;2022-06-14;68;157;599;2088;101;537;2189;0;14;6122866;6808592;10640034;159803;6157282;11760618;259746;0;769
FR;2;2022-06-15;78;104;522;1504;84;444;1641;0;10;6122944;6808696;10640556;161307;6157366;11761062;261387;0;779
FR;2;2022-06-16;128;128;497;1411;124;424;1526;0;12;6123072;6808824;10641053;162718;6157490;11761486;262913;0;791
FR;2;2022-06-17;73;138;589;1817;88;516;1921;0;16;6123145;6808962;10641642;164535;6157578;11762002;264834;0;807
FR;2;2022-06-18;76;93;224;579;81;196;630;0;4;6123221;6809055;10641866;165114;6157659;11762198;265464;0;811
FR;2;2022-06-19;11;17;53;71;7;41;90;0;2;6123232;6809072;10641919;165185;6157666;11762239;265554;0;813
FR;2;2022-06-20;62;125;401;1028;72;392;1105;0;10;6123294;6809197;10642320;166213;6157738;11762631;266659;0;823
FR;2;2022-06-21;108;116;526;2127;105;455;2164;0;22;6123402;6809313;10642846;168340;6157843;11763086;268823;0;845
FR;2;2022-06-22;39;110;462;1889;57;415;1971;0;25;6123441;6809423;10643308;170229;6157900;11763501;270794;0;870
FR;2;2022-06-23;58;109;537;2282;68;452;2400;0;30;6123499;6809532;10643845;172511;6157968;11763953;273194;0;900
FR;2;2022-06-24;66;122;709;3199;65;571;3339;0;38;6123565;6809654;10644554;175710;6158033;11764524;276533;0;938
FR;2;2022-06-25;30;90;298;988;55;254;1041;0;13;6123595;6809744;10644852;176698;6158088;11764778;277574;0;951
FR;2;2022-06-26;30;27;131;194;29;97;236;0;5;6123625;6809771;10644983;176892;6158117;11764875;277810;0;956
FR;2;2022-06-27;79;137;582;2490;94;483;2623;0;39;6123704;6809908;10645565;179382;6158211;11765358;280433;0;995
FR;2;2022-06-28;110;140;812;4817;81;650;4894;0;54;6123814;6810048;10646377;184199;6158292;11766008;285327;0;1049
FR;2;2022-06-29;73;150;776;4436;80;637;4532;0;56;6123887;6810198;10647153;188635;6158372;11766645;289859;0;1105
FR;2;2022-06-30;72;133;834;5177;71;619;5398;0;79;6123959;6810331;10647987;193812;6158443;11767264;295257;0;1184
FR;2;2022-07-01;113;161;1152;6692;95;853;6944;0;92;6124072;6810492;10649139;200504;6158538;11768117;302201;0;1276
FR;2;2022-07-02;69;132;474;1977;82;392;2068;0;27;6124141;6810624;10649613;202481;6158620;11768509;304269;0;1303
FR;2;2022-07-03;23;30;147;334;21;131;357;0;8;6124164;6810654;10649760;202815;6158641;11768640;304626;0;1311
FR;2;2022-07-04;122;184;776;3785;113;612;3971;0;49;6124286;6810838;10650536;206600;6158754;11769252;308597;0;1360
FR;2;2022-07-05;119;188;1121;6818;121;829;6999;0;85;6124405;6811026;10651657;213418;6158875;11770081;315596;0;1445
FR;2;2022-07-06;93;152;951;5807;95;698;5933;0;84;6124498;6811178;10652608;219225;6158970;11770779;321529;0;1529
FR;2;2022-07-07;81;185;1021;6501;116;752;6732;0;101;6124579;6811363;10653629;225726;6159086;11771531;328261;0;1630
FR;2;2022-07-08;65;122;1095;7044;51;758;7235;0;123;6124644;6811485;10654724;232770;6159137;11772289;335496;0;1753
FR;2;2022-07-09;34;62;417;1869;31;299;1919;0;33;6124678;6811547;10655141;234639;6159168;11772588;337415;0;1786
FR;2;2022-07-10;7;17;97;315;8;83;327;0;5;6124685;6811564;10655238;234954;6159176;11772671;337742;0;1791
FR;2;2022-07-11;68;121;683;3826;76;541;3901;0;67;6124753;6811685;10655921;238780;6159252;11773212;341643;0;1858
FR;2;2022-07-12;102;180;1054;6517;107;809;6725;0;119;6124855;6811865;10656975;245297;6159359;11774021;348368;0;1977
FR;2;2022-07-13;65;128;879;4665;76;591;4831;0;78;6124920;6811993;10657854;249962;6159435;11774612;353199;0;2055
FR;2;2022-07-14;6;13;89;250;8;60;269;0;8;6124926;6812006;10657943;250212;6159443;11774672;353468;0;2063
FR;2;2022-07-15;61;129;739;3795;53;560;3961;0;75;6124987;6812135;10658682;254007;6159496;11775232;357429;0;2138
FR;2;2022-07-16;28;54;289;1031;30;242;1077;0;25;6125015;6812189;10658971;255038;6159526;11775474;358506;0;2163
FR;2;2022-07-17;5;12;78;201;6;67;207;0;6;6125020;6812201;10659049;255239;6159532;11775541;358713;0;2169
FR;2;2022-07-18;57;103;514;2510;61;385;2648;0;59;6125077;6812304;10659563;257749;6159593;11775926;361361;0;2228
FR;2;2022-07-19;66;133;770;4258;72;555;4447;0;72;6125143;6812437;10660333;262007;6159665;11776481;365808;0;2300
FR;2;2022-07-20;59;117;582;3179;68;430;3278;0;87;6125202;6812554;10660915;265186;6159733;11776911;369086;0;2387
FR;2;2022-07-21;60;110;673;3680;73;487;3797;0;105;6125262;6812664;10661588;268866;6159806;11777398;372883;0;2492
FR;2;2022-07-22;51;100;700;3550;48;507;3701;0;80;6125313;6812764;10662288;272416;6159854;11777905;376584;0;2572
FR;2;2022-07-23;38;97;290;1175;51;229;1228;0;37;6125351;6812861;10662578;273591;6159905;11778134;377812;0;2609
FR;2;2022-07-24;14;24;69;201;19;68;203;0;7;6125365;6812885;10662647;273792;6159924;11778202;378015;0;2616
FR;2;2022-07-25;50;71;405;1938;60;300;2000;0;56;6125415;6812956;10663052;275730;6159984;11778502;380015;0;2672
FR;2;2022-07-26;57;133;606;3423;67;476;3496;0;113;6125472;6813089;10663658;279153;6160051;11778978;383511;0;2785
FR;2;2022-07-27;42;81;457;2782;50;361;2801;0;89;6125514;6813170;10664115;281935;6160101;11779339;386312;0;2874
FR;2;2022-07-28;29;75;450;2487;37;356;2491;0;78;6125543;6813245;10664565;284422;6160138;11779695;388803;0;2952
FR;2;2022-07-29;68;88;535;2857;63;347;2978;0;73;6125611;6813333;10665100;287279;6160201;11780042;391781;0;3025
FR;2;2022-07-30;22;39;163;776;32;110;796;0;24;6125633;6813372;10665263;288055;6160233;11780152;392577;0;3049
FR;2;2022-07-31;6;13;27;104;12;21;110;0;2;6125639;6813385;10665290;288159;6160245;11780173;392687;0;3051
FR;2;2022-08-01;38;107;323;1262;74;260;1344;0;29;6125677;6813492;10665613;289421;6160319;11780433;394031;0;3080
FR;2;2022-08-02;49;75;325;2061;50;247;2097;0;78;6125726;6813567;10665938;291482;6160369;11780680;396128;0;3158
FR;2;2022-08-03;29;53;260;1611;25;188;1617;0;57;6125755;6813620;10666198;293093;6160394;11780868;397745;0;3215
FR;2;2022-08-04;40;65;306;1692;39;240;1701;0;66;6125795;6813685;10666504;294785;6160433;11781108;399446;0;3281
FR;2;2022-08-05;33;94;328;1881;67;236;1912;0;60;6125828;6813779;10666832;296666;6160500;11781344;401358;0;3341
FR;2;2022-08-06;22;41;106;365;29;82;372;0;10;6125850;6813820;10666938;297031;6160529;11781426;401730;0;3351
FR;2;2022-08-07;7;8;15;69;5;16;71;0;3;6125857;6813828;10666953;297100;6160534;11781442;401801;0;3354
FR;2;2022-08-08;19;35;220;877;22;148;915;0;33;6125876;6813863;10667173;297977;6160556;11781590;402716;0;3387
FR;2;2022-08-09;30;52;279;1474;42;238;1470;0;50;6125906;6813915;10667452;299451;6160598;11781828;404186;0;3437
FR;2;2022-08-10;17;22;213;1134;19;150;1155;0;46;6125923;6813937;10667665;300585;6160617;11781978;405341;0;3483
FR;2;2022-08-11;21;41;174;1038;26;117;1047;0;40;6125944;6813978;10667839;301623;6160643;11782095;406388;0;3523
FR;2;2022-08-12;36;51;184;1046;38;141;1069;0;35;6125980;6814029;10668023;302669;6160681;11782236;407457;0;3558
FR;2;2022-08-13;11;19;47;149;15;53;137;0;5;6125991;6814048;10668070;302818;6160696;11782289;407594;0;3563
FR;2;2022-08-14;1;2;12;52;1;11;54;0;1;6125992;6814050;10668082;302870;6160697;11782300;407648;0;3564
FR;2;2022-08-15;0;5;32;22;2;21;21;0;3;6125992;6814055;10668114;302892;6160699;11782321;407669;0;3567
FR;2;2022-08-16;27;33;144;681;34;120;678;0;33;6126019;6814088;10668258;303573;6160733;11782441;408347;0;3600
FR;2;2022-08-17;18;27;109;738;18;88;744;0;34;6126037;6814115;10668367;304311;6160751;11782529;409091;0;3634
FR;2;2022-08-18;14;30;160;836;14;107;852;0;42;6126051;6814145;10668527;305147;6160765;11782636;409943;0;3676
FR;2;2022-08-19;8;38;118;706;31;88;706;0;33;6126059;6814183;10668645;305853;6160796;11782724;410649;0;3709
FR;2;2022-08-20;6;26;61;197;16;52;201;0;8;6126065;6814209;10668706;306050;6160812;11782776;410850;0;3717
FR;2;2022-08-21;4;14;15;19;6;13;31;0;0;6126069;6814223;10668721;306069;6160818;11782789;410881;0;3717
FR;2;2022-08-22;11;25;116;395;17;73;451;0;13;6126080;6814248;10668837;306464;6160835;11782862;411332;0;3730
FR;2;2022-08-23;12;42;134;671;23;112;679;0;38;6126092;6814290;10668971;307135;6160858;11782974;412011;0;3768
FR;2;2022-08-24;11;28;87;466;21;80;472;0;18;6126103;6814318;10669058;307601;6160879;11783054;412483;0;3786
FR;2;2022-08-25;8;32;109;481;16;69;516;0;17;6126111;6814350;10669167;308082;6160895;11783123;412999;0;3803
FR;2;2022-08-26;16;46;117;720;36;91;713;0;32;6126127;6814396;10669284;308802;6160931;11783214;413712;0;3835
FR;2;2022-08-27;10;19;47;158;16;42;166;0;2;6126137;6814415;10669331;308960;6160947;11783256;413878;0;3837
FR;2;2022-08-28;1;5;5;15;1;7;16;0;1;6126138;6814420;10669336;308975;6160948;11783263;413894;0;3838
FR;2;2022-08-29;24;43;94;400;29;88;396;0;24;6126162;6814463;10669430;309375;6160977;11783351;414290;0;3862
FR;2;2022-08-30;31;54;154;791;34;119;798;0;29;6126193;6814517;10669584;310166;6161011;11783470;415088;0;3891
FR;2;2022-08-31;19;37;85;392;24;79;393;0;25;6126212;6814554;10669669;310558;6161035;11783549;415481;0;3916
FR;2;2022-09-01;19;43;139;600;25;122;609;0;36;6126231;6814597;10669808;311158;6161060;11783671;416090;0;3952
FR;2;2022-09-02;34;57;147;744;34;160;748;0;32;6126265;6814654;10669955;311902;6161094;11783831;416838;0;3984
FR;2;2022-09-03;17;20;83;205;11;67;213;0;7;6126282;6814674;10670038;312107;6161105;11783898;417051;0;3991
FR;2;2022-09-04;8;5;9;31;2;10;30;0;3;6126290;6814679;10670047;312138;6161107;11783908;417081;0;3994
FR;2;2022-09-05;29;32;126;367;24;98;397;0;24;6126319;6814711;10670173;312505;6161131;11784006;417478;0;4018
FR;2;2022-09-06;44;63;158;762;43;153;768;0;36;6126363;6814774;10670331;313267;6161174;11784159;418246;0;4054
FR;2;2022-09-07;21;22;76;375;18;51;387;0;23;6126384;6814796;10670407;313642;6161192;11784210;418633;0;4077
FR;2;2022-09-08;31;58;109;636;41;100;646;0;22;6126415;6814854;10670516;314278;6161233;11784310;419279;0;4099
FR;2;2022-09-09;18;24;126;754;21;74;747;0;48;6126433;6814878;10670642;315032;6161254;11784384;420026;0;4147
FR;2;2022-09-10;14;25;57;117;17;48;131;0;4;6126447;6814903;10670699;315149;6161271;11784432;420157;0;4151
FR;2;2022-09-11;12;5;11;11;3;13;13;0;0;6126459;6814908;10670710;315160;6161274;11784445;420170;0;4151
FR;2;2022-09-12;20;31;70;340;26;56;352;0;16;6126479;6814939;10670780;315500;6161300;11784501;420522;0;4167
FR;2;2022-09-13;15;34;125;670;13;99;674;0;40;6126494;6814973;10670905;316170;6161313;11784600;421196;0;4207
FR;2;2022-09-14;19;23;81;480;20;60;478;0;36;6126513;6814996;10670986;316650;6161333;11784660;421674;0;4243
FR;2;2022-09-15;23;45;126;486;27;102;493;0;47;6126536;6815041;10671112;317136;6161360;11784762;422167;0;4290
FR;2;2022-09-16;22;32;124;563;18;89;585;0;39;6126558;6815073;10671236;317699;6161378;11784851;422752;0;4329
FR;2;2022-09-17;6;20;56;160;15;52;147;0;14;6126564;6815093;10671292;317859;6161393;11784903;422899;0;4343
FR;2;2022-09-18;4;7;13;37;6;10;37;0;3;6126568;6815100;10671305;317896;6161399;11784913;422936;0;4346
FR;2;2022-09-19;26;24;114;353;16;87;381;0;22;6126594;6815124;10671419;318249;6161415;11785000;423317;0;4368
FR;2;2022-09-20;29;27;117;624;21;84;639;0;38;6126623;6815151;10671536;318873;6161436;11785084;423956;0;4406
FR;2;2022-09-21;15;30;100;393;15;78;418;0;23;6126638;6815181;10671636;319266;6161451;11785162;424374;0;4429
FR;2;2022-09-22;19;39;124;581;18;95;619;0;28;6126657;6815220;10671760;319847;6161469;11785257;424993;0;4457
FR;2;2022-09-23;21;38;135;556;22;111;571;0;40;6126678;6815258;10671895;320403;6161491;11785368;425564;0;4497
FR;2;2022-09-24;10;8;52;190;8;37;201;0;7;6126688;6815266;10671947;320593;6161499;11785405;425765;0;4504
FR;2;2022-09-25;9;11;15;29;11;12;33;0;5;6126697;6815277;10671962;320622;6161510;11785417;425798;0;4509
FR;2;2022-09-26;22;41;116;447;27;79;458;0;20;6126719;6815318;10672078;321069;6161537;11785496;426256;0;4529
FR;2;2022-09-27;30;46;162;906;35;108;861;0;52;6126749;6815364;10672240;321975;6161572;11785604;427117;0;4581
FR;2;2022-09-28;15;31;93;421;18;74;439;0;23;6126764;6815395;10672333;322396;6161590;11785678;427556;0;4604
FR;2;2022-09-29;26;48;115;618;23;110;630;0;33;6126790;6815443;10672448;323014;6161613;11785788;428186;0;4637
FR;2;2022-09-30;25;44;111;520;45;84;533;0;31;6126815;6815487;10672559;323534;6161658;11785872;428719;0;4668
FR;2;2022-10-01;11;20;51;128;20;36;129;0;8;6126826;6815507;10672610;323662;6161678;11785908;428848;0;4676
FR;2;2022-10-02;0;5;8;21;4;5;25;0;2;6126826;6815512;10672618;323683;6161682;11785913;428873;0;4678
FR;2;2022-10-03;22;35;85;291;30;69;306;0;22;6126848;6815547;10672703;323974;6161712;11785982;429179;0;4700
FR;2;2022-10-04;17;21;106;601;19;71;620;0;46;6126865;6815568;10672809;324575;6161731;11786053;429799;0;4746
FR;2;2022-10-05;20;31;75;491;26;67;488;0;54;6126885;6815599;10672884;325066;6161757;11786120;430287;0;4800
FR;2;2022-10-06;30;23;74;442;17;71;428;0;65;6126915;6815622;10672958;325508;6161774;11786191;430715;0;4865
FR;2;2022-10-07;21;30;86;499;27;66;503;0;42;6126936;6815652;10673044;326007;6161801;11786257;431218;0;4907
FR;2;2022-10-08;12;8;24;114;3;25;108;0;12;6126948;6815660;10673068;326121;6161804;11786282;431326;0;4919
FR;2;2022-10-09;1;8;15;17;6;11;22;0;5;6126949;6815668;10673083;326138;6161810;11786293;431348;0;4924
FR;2;2022-10-10;18;27;47;223;25;49;218;0;21;6126967;6815695;10673130;326361;6161835;11786342;431566;0;4945
FR;2;2022-10-11;16;15;48;253;11;39;241;0;52;6126983;6815710;10673178;326614;6161846;11786381;431807;0;4997
FR;2;2022-10-12;9;20;52;290;16;36;305;0;56;6126992;6815730;10673230;326904;6161862;11786417;432112;0;5053
FR;2;2022-10-13;11;14;48;271;9;48;261;0;26;6127003;6815744;10673278;327175;6161871;11786465;432373;0;5079
FR;2;2022-10-14;13;30;36;230;18;40;231;0;29;6127016;6815774;10673314;327405;6161889;11786505;432604;0;5108
FR;2;2022-10-15;4;13;22;111;7;17;113;0;15;6127020;6815787;10673336;327516;6161896;11786522;432717;0;5123
FR;2;2022-10-16;0;7;4;11;6;7;8;0;1;6127020;6815794;10673340;327527;6161902;11786529;432725;0;5124
FR;2;2022-10-17;15;19;31;121;18;26;131;0;29;6127035;6815813;10673371;327648;6161920;11786555;432856;0;5153
FR;2;2022-10-18;13;12;68;185;6;34;247;0;46;6127048;6815825;10673439;327833;6161926;11786589;433103;0;5199
FR;2;2022-10-19;8;17;39;184;12;31;223;0;52;6127056;6815842;10673478;328017;6161938;11786620;433326;0;5251
FR;2;2022-10-20;11;29;41;200;15;40;196;0;52;6127067;6815871;10673519;328217;6161953;11786660;433522;0;5303
FR;2;2022-10-21;6;16;60;233;7;53;222;0;31;6127073;6815887;10673579;328450;6161960;11786713;433744;0;5334
FR;2;2022-10-22;8;7;25;102;2;23;103;0;20;6127081;6815894;10673604;328552;6161962;11786736;433847;0;5354
FR;2;2022-10-23;0;3;1;5;3;0;6;0;2;6127081;6815897;10673605;328557;6161965;11786736;433853;0;5356
FR;2;2022-10-24;12;12;16;110;12;16;113;0;20;6127093;6815909;10673621;328667;6161977;11786752;433966;0;5376
FR;2;2022-10-25;12;7;23;138;6;15;145;0;51;6127105;6815916;10673644;328805;6161983;11786767;434111;0;5427
FR;2;2022-10-26;4;3;17;90;2;11;96;0;27;6127109;6815919;10673661;328895;6161985;11786778;434207;0;5454
FR;2;2022-10-27;7;10;18;88;10;20;71;0;27;6127116;6815929;10673679;328983;6161995;11786798;434278;0;5481
FR;2;2022-10-28;5;3;15;91;3;7;92;0;27;6127121;6815932;10673694;329074;6161998;11786805;434370;0;5508
FR;2;2022-10-29;7;8;18;33;6;14;37;0;8;6127128;6815940;10673712;329107;6162004;11786819;434407;0;5516
FR;2;2022-10-30;3;7;5;8;5;2;5;0;1;6127131;6815947;10673717;329115;6162009;11786821;434412;0;5517
FR;2;2022-10-31;2;8;6;49;6;10;48;0;11;6127133;6815955;10673723;329164;6162015;11786831;434460;0;5528
FR;2;2022-11-01;0;6;8;1;5;6;4;0;0;6127133;6815961;10673731;329165;6162020;11786837;434464;0;5528
FR;2;2022-11-02;6;5;12;44;5;12;45;0;11;6127139;6815966;10673743;329209;6162025;11786849;434509;0;5539
FR;2;2022-11-03;6;7;16;77;6;10;75;0;18;6127145;6815973;10673759;329286;6162031;11786859;434584;0;5557
FR;2;2022-11-04;7;12;15;85;10;14;93;0;10;6127152;6815985;10673774;329371;6162041;11786873;434677;0;5567
FR;2;2022-11-05;0;11;13;38;6;17;35;0;6;6127152;6815996;10673787;329409;6162047;11786890;434712;0;5573
FR;2;2022-11-06;0;2;2;1;0;4;0;0;2;6127152;6815998;10673789;329410;6162047;11786894;434712;0;5575
FR;2;2022-11-07;13;8;15;67;6;14;66;0;20;6127165;6816006;10673804;329477;6162053;11786908;434778;0;5595
FR;2;2022-11-08;14;8;18;58;6;14;65;0;27;6127179;6816014;10673822;329535;6162059;11786922;434843;0;5622
FR;2;2022-11-09;4;5;17;56;2;17;50;0;28;6127183;6816019;10673839;329591;6162061;11786939;434893;0;5650
FR;2;2022-11-10;7;10;17;74;7;14;76;0;14;6127190;6816029;10673856;329665;6162068;11786953;434969;0;5664
FR;2;2022-11-11;0;3;9;3;0;10;4;0;0;6127190;6816032;10673865;329668;6162068;11786963;434973;0;5664
FR;2;2022-11-12;2;5;7;19;4;7;19;0;4;6127192;6816037;10673872;329687;6162072;11786970;434992;0;5668
FR;2;2022-11-13;3;2;4;2;1;5;1;0;0;6127195;6816039;10673876;329689;6162073;11786975;434993;0;5668
FR;2;2022-11-14;7;6;13;29;3;10;33;0;7;6127202;6816045;10673889;329718;6162076;11786985;435026;0;5675
FR;2;2022-11-15;8;15;15;35;16;18;32;0;7;6127210;6816060;10673904;329753;6162092;11787003;435058;0;5682
FR;2;2022-11-16;3;6;4;45;6;4;46;0;18;6127213;6816066;10673908;329798;6162098;11787007;435104;0;5700
FR;2;2022-11-17;2;6;12;56;5;9;55;0;22;6127215;6816072;10673920;329854;6162103;11787016;435159;0;5722
FR;2;2022-11-18;3;4;7;41;4;6;44;0;10;6127218;6816076;10673927;329895;6162107;11787022;435203;0;5732
FR;2;2022-11-19;3;3;2;25;3;3;18;0;5;6127221;6816079;10673929;329920;6162110;11787025;435221;0;5737
FR;2;2022-11-20;0;2;6;9;2;6;10;0;26;6127221;6816081;10673935;329929;6162112;11787031;435231;0;5763
FR;2;2022-11-21;6;10;9;31;7;8;34;0;22;6127227;6816091;10673944;329960;6162119;11787039;435265;0;5785
FR;2;2022-11-22;8;8;20;65;6;21;70;0;71;6127235;6816099;10673964;330025;6162125;11787060;435335;0;5856
FR;2;2022-11-23;7;6;8;68;3;5;73;0;8;6127242;6816105;10673972;330093;6162128;11787065;435408;0;5864
FR;2;2022-11-24;2;2;11;51;2;7;58;0;10;6127244;6816107;10673983;330144;6162130;11787072;435466;0;5874
FR;2;2022-11-25;11;8;14;25;11;14;26;0;8;6127255;6816115;10673997;330169;6162141;11787086;435492;0;5882
FR;2;2022-11-26;1;5;4;8;4;7;6;0;0;6127256;6816120;10674001;330177;6162145;11787093;435498;0;5882
FR;2;2022-11-27;2;2;12;2;0;11;4;0;1;6127258;6816122;10674013;330179;6162145;11787104;435502;0;5883
FR;2;2022-11-28;0;2;8;35;1;6;37;0;5;6127258;6816124;10674021;330214;6162146;11787110;435539;0;5888
FR;2;2022-11-29;1;1;10;24;0;4;30;0;8;6127259;6816125;10674031;330238;6162146;11787114;435569;0;5896
FR;2;2022-11-30;2;2;10;47;1;11;44;0;21;6127261;6816127;10674041;330285;6162147;11787125;435613;0;5917
FR;2;2022-12-01;2;12;6;63;9;13;55;0;24;6127263;6816139;10674047;330348;6162156;11787138;435668;0;5941
FR;2;2022-12-02;1;2;12;51;2;10;51;0;27;6127264;6816141;10674059;330399;6162158;11787148;435719;0;5968
FR;2;2022-12-03;1;4;8;19;2;8;18;0;10;6127265;6816145;10674067;330418;6162160;11787156;435737;0;5978
FR;2;2022-12-04;0;0;0;4;0;0;4;0;2;6127265;6816145;10674067;330422;6162160;11787156;435741;0;5980
FR;2;2022-12-05;3;5;8;51;8;4;45;0;16;6127268;6816150;10674075;330473;6162168;11787160;435786;0;5996
FR;2;2022-12-06;3;5;14;45;4;6;48;0;17;6127271;6816155;10674089;330518;6162172;11787166;435834;0;6013
FR;2;2022-12-07;1;5;9;42;3;8;44;0;11;6127272;6816160;10674098;330560;6162175;11787174;435878;0;6024
FR;2;2022-12-08;0;2;11;44;0;6;49;0;16;6127272;6816162;10674109;330604;6162175;11787180;435927;0;6040
FR;2;2022-12-09;0;1;13;52;0;9;57;0;17;6127272;6816163;10674122;330656;6162175;11787189;435984;0;6057
FR;2;2022-12-10;0;3;15;50;1;6;52;0;9;6127272;6816166;10674137;330706;6162176;11787195;436036;0;6066
FR;2;2022-12-11;0;0;2;2;0;2;1;0;3;6127272;6816166;10674139;330708;6162176;11787197;436037;0;6069
FR;2;2022-12-12;1;0;6;37;0;6;36;0;11;6127273;6816166;10674145;330745;6162176;11787203;436073;0;6080
FR;2;2022-12-13;0;3;2;37;2;1;37;0;14;6127273;6816169;10674147;330782;6162178;11787204;436110;0;6094
FR;2;2022-12-14;0;5;8;26;5;3;31;0;14;6127273;6816174;10674155;330808;6162183;11787207;436141;0;6108
FR;2;2022-12-15;0;5;12;43;5;9;44;0;17;6127273;6816179;10674167;330851;6162188;11787216;436185;0;6125
FR;2;2022-12-16;2;4;27;56;3;20;62;0;16;6127275;6816183;10674194;330907;6162191;11787236;436247;0;6141
FR;2;2022-12-17;1;4;10;44;3;6;39;0;5;6127276;6816187;10674204;330951;6162194;11787242;436286;0;6146
FR;2;2022-12-18;1;0;0;0;0;0;0;0;1;6127277;6816187;10674204;330951;6162194;11787242;436286;0;6147
FR;2;2022-12-19;6;5;4;31;6;5;24;0;24;6127283;6816192;10674208;330982;6162200;11787247;436310;0;6171
FR;2;2022-12-20;0;4;6;37;2;7;38;0;24;6127283;6816196;10674214;331019;6162202;11787254;436348;0;6195
FR;2;2022-12-21;0;1;4;13;1;4;13;0;8;6127283;6816197;10674218;331032;6162203;11787258;436361;0;6203
FR;2;2022-12-22;0;5;17;32;2;6;45;0;10;6127283;6816202;10674235;331064;6162205;11787264;436406;0;6213
FR;2;2022-12-23;1;5;15;18;3;12;22;0;4;6127284;6816207;10674250;331082;6162208;11787276;436428;0;6217
FR;2;2022-12-24;0;0;1;1;0;1;1;0;0;6127284;6816207;10674251;331083;6162208;11787277;436429;0;6217
FR;2;2022-12-25;0;1;1;3;0;1;4;0;0;6127284;6816208;10674252;331086;6162208;11787278;436433;0;6217
FR;2;2022-12-26;0;0;7;11;0;5;11;0;3;6127284;6816208;10674259;331097;6162208;11787283;436444;0;6220
FR;2;2022-12-27;0;1;7;5;1;5;7;0;4;6127284;6816209;10674266;331102;6162209;11787288;436451;0;6224
FR;2;2022-12-28;0;2;4;13;2;3;14;0;5;6127284;6816211;10674270;331115;6162211;11787291;436465;0;6229
FR;2;2022-12-29;1;2;4;18;1;5;18;0;7;6127285;6816213;10674274;331133;6162212;11787296;436483;0;6236
FR;2;2022-12-30;1;0;2;8;0;2;7;0;1;6127286;6816213;10674276;331141;6162212;11787298;436490;0;6237
FR;2;2022-12-31;0;0;1;2;0;1;2;0;1;6127286;6816213;10674277;331143;6162212;11787299;436492;0;6238
FR;2;2023-01-01;0;0;0;0;0;0;0;0;0;6127286;6816213;10674277;331143;6162212;11787299;436492;0;6238
FR;2;2023-01-02;5;4;9;21;3;7;23;0;2;6127291;6816217;10674286;331164;6162215;11787306;436515;0;6240
FR;2;2023-01-03;1;0;6;13;0;7;11;0;6;6127292;6816217;10674292;331177;6162215;11787313;436526;0;6246
FR;2;2023-01-04;1;4;9;13;5;7;13;0;6;6127293;6816221;10674301;331190;6162220;11787320;436539;0;6252
FR;2;2023-01-05;0;2;7;6;2;4;7;0;3;6127293;6816223;10674308;331196;6162222;11787324;436546;0;6255
FR;2;2023-01-06;1;0;9;9;0;4;13;0;9;6127294;6816223;10674317;331205;6162222;11787328;436559;0;6264
FR;2;2023-01-07;0;0;4;10;0;4;8;0;5;6127294;6816223;10674321;331215;6162222;11787332;436567;0;6269
FR;2;2023-01-08;0;0;3;3;0;3;3;0;2;6127294;6816223;10674324;331218;6162222;11787335;436570;0;6271
FR;2;2023-01-09;0;2;8;9;2;3;13;0;5;6127294;6816225;10674332;331227;6162224;11787338;436583;0;6276
FR;2;2023-01-10;0;5;4;8;4;3;10;0;6;6127294;6816230;10674336;331235;6162228;11787341;436593;0;6282
FR;2;2023-01-11;3;0;4;7;0;3;9;0;3;6127297;6816230;10674340;331242;6162228;11787344;436602;0;6285
FR;2;2023-01-12;1;1;9;13;1;7;10;0;11;6127298;6816231;10674349;331255;6162229;11787351;436612;0;6296
FR;2;2023-01-13;0;1;5;7;1;3;10;0;3;6127298;6816232;10674354;331262;6162230;11787354;436622;0;6299
FR;2;2023-01-14;0;1;2;6;0;3;6;0;1;6127298;6816233;10674356;331268;6162230;11787357;436628;0;6300
FR;2;2023-01-15;0;0;0;0;0;0;0;0;0;6127298;6816233;10674356;331268;6162230;11787357;436628;0;6300
FR;2;2023-01-16;1;1;5;7;2;2;7;0;1;6127299;6816234;10674361;331275;6162232;11787359;436635;0;6301
FR;2;2023-01-17;1;0;5;4;0;5;3;0;0;6127300;6816234;10674366;331279;6162232;11787364;436638;0;6301
FR;2;2023-01-18;0;0;3;2;0;3;2;0;0;6127300;6816234;10674369;331281;6162232;11787367;436640;0;6301
FR;2;2023-01-19;0;0;1;6;0;1;6;0;6;6127300;6816234;10674370;331287;6162232;11787368;436646;0;6307
FR;2;2023-01-20;0;0;1;8;0;1;8;0;4;6127300;6816234;10674371;331295;6162232;11787369;436654;0;6311
FR;2;2023-01-21;0;0;0;3;0;0;0;0;0;6127300;6816234;10674371;331298;6162232;11787369;436654;0;6311
FR;2;2023-01-22;0;0;0;0;0;0;0;0;0;6127300;6816234;10674371;331298;6162232;11787369;436654;0;6311
FR;2;2023-01-23;0;0;3;3;0;2;3;0;1;6127300;6816234;10674374;331301;6162232;11787371;436657;0;6312
FR;2;2023-01-24;1;3;1;6;3;0;7;0;4;6127301;6816237;10674375;331307;6162235;11787371;436664;0;6316
FR;2;2023-01-25;1;0;0;6;0;0;6;0;0;6127302;6816237;10674375;331313;6162235;11787371;436670;0;6316
FR;2;2023-01-26;1;0;3;7;0;1;9;0;3;6127303;6816237;10674378;331320;6162235;11787372;436679;0;6319
FR;2;2023-01-27;0;2;3;3;1;2;3;0;2;6127303;6816239;10674381;331323;6162236;11787374;436682;0;6321
FR;2;2023-01-28;0;0;0;1;0;0;1;0;0;6127303;6816239;10674381;331324;6162236;11787374;436683;0;6321
FR;2;2023-01-29;0;0;1;0;0;0;1;0;0;6127303;6816239;10674382;331324;6162236;11787374;436684;0;6321
FR;2;2023-01-30;0;1;2;3;1;1;4;0;1;6127303;6816240;10674384;331327;6162237;11787375;436688;0;6322
FR;2;2023-01-31;1;0;3;2;0;2;3;0;0;6127304;6816240;10674387;331329;6162237;11787377;436691;0;6322
FR;2;2023-02-01;0;3;2;0;2;3;0;0;0;6127304;6816243;10674389;331329;6162239;11787380;436691;0;6322
FR;2;2023-02-02;0;2;3;4;1;4;6;0;4;6127304;6816245;10674392;331333;6162240;11787384;436697;0;6326
FR;2;2023-02-03;0;2;1;12;2;0;11;0;9;6127304;6816247;10674393;331345;6162242;11787384;436708;0;6335
FR;2;2023-02-04;0;1;1;0;0;2;0;0;0;6127304;6816248;10674394;331345;6162242;11787386;436708;0;6335
FR;2;2023-02-05;0;0;0;0;0;0;0;0;0;6127304;6816248;10674394;331345;6162242;11787386;436708;0;6335
FR;2;2023-02-06;0;4;2;2;3;3;2;0;0;6127304;6816252;10674396;331347;6162245;11787389;436710;0;6335
FR;2;2023-02-07;2;1;0;0;0;1;0;0;1;6127306;6816253;10674396;331347;6162245;11787390;436710;0;6336
FR;2;2023-02-08;0;0;3;2;0;2;4;0;1;6127306;6816253;10674399;331349;6162245;11787392;436714;0;6337
FR;2;2023-02-09;0;0;1;4;0;2;3;0;3;6127306;6816253;10674400;331353;6162245;11787394;436717;0;6340
FR;2;2023-02-10;0;0;1;3;0;1;2;0;6;6127306;6816253;10674401;331356;6162245;11787395;436719;0;6346
FR;2;2023-02-11;2;2;1;1;0;2;2;0;0;6127308;6816255;10674402;331357;6162245;11787397;436721;0;6346
FR;2;2023-02-12;0;0;0;0;0;0;0;0;0;6127308;6816255;10674402;331357;6162245;11787397;436721;0;6346
FR;2;2023-02-13;3;0;1;5;0;0;5;0;1;6127311;6816255;10674403;331362;6162245;11787397;436726;0;6347
FR;2;2023-02-14;1;2;1;1;2;0;2;0;0;6127312;6816257;10674404;331363;6162247;11787397;436728;0;6347
FR;2;2023-02-15;3;0;1;1;0;1;1;0;0;6127315;6816257;10674405;331364;6162247;11787398;436729;0;6347
FR;2;2023-02-16;3;1;1;1;1;1;1;0;2;6127318;6816258;10674406;331365;6162248;11787399;436730;0;6349
FR;2;2023-02-17;0;0;1;4;0;1;3;0;4;6127318;6816258;10674407;331369;6162248;11787400;436733;0;6353
FR;2;2023-02-18;0;0;5;1;0;5;0;0;1;6127318;6816258;10674412;331370;6162248;11787405;436733;0;6354
FR;2;2023-02-19;0;1;0;0;1;0;0;0;0;6127318;6816259;10674412;331370;6162249;11787405;436733;0;6354
FR;2;2023-02-20;1;0;0;1;0;0;1;0;2;6127319;6816259;10674412;331371;6162249;11787405;436734;0;6356
FR;2;2023-02-21;0;0;0;1;0;0;1;0;2;6127319;6816259;10674412;331372;6162249;11787405;436735;0;6358
FR;2;2023-02-22;1;0;0;3;0;0;3;0;0;6127320;6816259;10674412;331375;6162249;11787405;436738;0;6358
FR;2;2023-02-23;0;0;0;1;0;0;1;0;3;6127320;6816259;10674412;331376;6162249;11787405;436739;0;6361
FR;2;2023-02-24;1;0;1;2;0;0;3;0;0;6127321;6816259;10674413;331378;6162249;11787405;436742;0;6361
FR;2;2023-02-25;0;0;1;2;0;1;2;0;0;6127321;6816259;10674414;331380;6162249;11787406;436744;0;6361
FR;2;2023-02-26;0;0;0;0;0;0;0;0;0;6127321;6816259;10674414;331380;6162249;11787406;436744;0;6361
FR;2;2023-02-27;1;0;1;1;1;1;1;0;0;6127322;6816259;10674415;331381;6162250;11787407;436745;0;6361
FR;2;2023-02-28;1;0;0;0;0;0;0;0;2;6127323;6816259;10674415;331381;6162250;11787407;436745;0;6363
FR;2;2023-03-01;0;2;3;2;1;3;1;0;1;6127323;6816261;10674418;331383;6162251;11787410;436746;0;6364
FR;2;2023-03-02;0;2;2;1;2;1;1;0;1;6127323;6816263;10674420;331384;6162253;11787411;436747;0;6365
FR;2;2023-03-03;1;0;3;1;0;3;1;0;0;6127324;6816263;10674423;331385;6162253;11787414;436748;0;6365
FR;2;2023-03-04;0;0;1;0;0;1;0;0;0;6127324;6816263;10674424;331385;6162253;11787415;436748;0;6365
FR;2;2023-03-05;0;0;0;0;0;0;0;0;0;6127324;6816263;10674424;331385;6162253;11787415;436748;0;6365
FR;2;2023-03-06;0;0;2;1;0;1;2;0;2;6127324;6816263;10674426;331386;6162253;11787416;436750;0;6367
FR;2;2023-03-07;0;1;2;1;1;2;1;0;1;6127324;6816264;10674428;331387;6162254;11787418;436751;0;6368
FR;2;2023-03-08;0;0;0;0;0;0;0;0;2;6127324;6816264;10674428;331387;6162254;11787418;436751;0;6370
FR;2;2023-03-09;0;0;1;1;0;0;2;0;0;6127324;6816264;10674429;331388;6162254;11787418;436753;0;6370
FR;2;2023-03-10;0;0;1;0;0;1;0;0;0;6127324;6816264;10674430;331388;6162254;11787419;436753;0;6370
FR;2;2023-03-11;0;0;4;1;0;3;2;0;0;6127324;6816264;10674434;331389;6162254;11787422;436755;0;6370
FR;2;2023-03-12;0;0;0;0;0;0;0;0;0;6127324;6816264;10674434;331389;6162254;11787422;436755;0;6370
FR;2;2023-03-13;0;0;1;3;0;1;3;0;0;6127324;6816264;10674435;331392;6162254;11787423;436758;0;6370
FR;2;2023-03-14;1;0;0;0;0;0;0;0;0;6127325;6816264;10674435;331392;6162254;11787423;436758;0;6370
FR;2;2023-03-15;0;2;0;3;2;0;3;0;0;6127325;6816266;10674435;331395;6162256;11787423;436761;0;6370
FR;2;2023-03-16;0;2;0;0;1;1;1;0;0;6127325;6816268;10674435;331395;6162257;11787424;436762;0;6370
FR;2;2023-03-17;0;0;1;1;0;1;0;0;0;6127325;6816268;10674436;331396;6162257;11787425;436762;0;6370
FR;2;2023-03-18;0;0;7;0;0;7;0;0;1;6127325;6816268;10674443;331396;6162257;11787432;436762;0;6371
FR;2;2023-03-19;0;0;0;0;0;0;0;0;0;6127325;6816268;10674443;331396;6162257;11787432;436762;0;6371
FR;2;2023-03-20;0;0;1;0;0;1;0;0;0;6127325;6816268;10674444;331396;6162257;11787433;436762;0;6371
FR;2;2023-03-21;0;0;1;2;0;1;2;0;1;6127325;6816268;10674445;331398;6162257;11787434;436764;0;6372
FR;2;2023-03-22;0;0;0;0;0;0;0;0;1;6127325;6816268;10674445;331398;6162257;11787434;436764;0;6373
FR;2;2023-03-23;0;1;0;0;1;0;0;0;1;6127325;6816269;10674445;331398;6162258;11787434;436764;0;6374
FR;2;2023-03-24;0;1;0;2;1;0;2;0;2;6127325;6816270;10674445;331400;6162259;11787434;436766;0;6376
FR;2;2023-03-25;0;0;1;2;0;1;2;0;0;6127325;6816270;10674446;331402;6162259;11787435;436768;0;6376
FR;2;2023-03-26;0;2;1;0;2;1;0;0;0;6127325;6816272;10674447;331402;6162261;11787436;436768;0;6376
FR;2;2023-03-27;0;2;2;0;2;2;0;0;1;6127325;6816274;10674449;331402;6162263;11787438;436768;0;6377
FR;2;2023-03-28;0;0;0;0;0;0;0;0;1;6127325;6816274;10674449;331402;6162263;11787438;436768;0;6378
FR;2;2023-03-29;0;0;0;2;0;0;2;0;0;6127325;6816274;10674449;331404;6162263;11787438;436770;0;6378
FR;2;2023-03-30;0;0;0;0;0;0;0;0;0;6127325;6816274;10674449;331404;6162263;11787438;436770;0;6378
FR;2;2023-03-31;0;1;0;1;1;0;1;0;0;6127325;6816275;10674449;331405;6162264;11787438;436771;0;6378
FR;2;2023-04-01;0;0;1;0;0;0;1;0;0;6127325;6816275;10674450;331405;6162264;11787438;436772;0;6378
FR;2;2023-04-02;0;0;0;0;0;0;0;0;0;6127325;6816275;10674450;331405;6162264;11787438;436772;0;6378
FR;2;2023-04-03;0;1;2;2;1;2;2;0;1;6127325;6816276;10674452;331407;6162265;11787440;436774;0;6379
FR;2;2023-04-04;0;0;0;2;0;0;2;0;0;6127325;6816276;10674452;331409;6162265;11787440;436776;0;6379
FR;2;2023-04-05;0;0;1;0;0;1;0;0;0;6127325;6816276;10674453;331409;6162265;11787441;436776;0;6379
FR;2;2023-04-06;0;1;0;0;1;0;0;0;0;6127325;6816277;10674453;331409;6162266;11787441;436776;0;6379
FR;2;2023-04-07;0;0;0;1;0;0;1;0;0;6127325;6816277;10674453;331410;6162266;11787441;436777;0;6379
FR;2;2023-04-08;0;0;0;0;0;0;0;0;0;6127325;6816277;10674453;331410;6162266;11787441;436777;0;6379
FR;2;2023-04-09;0;0;1;0;0;1;0;0;0;6127325;6816277;10674454;331410;6162266;11787442;436777;0;6379
FR;2;2023-04-10;0;2;0;0;1;1;0;0;0;6127325;6816279;10674454;331410;6162267;11787443;436777;0;6379
FR;2;2023-04-11;0;0;0;0;0;0;0;0;1;6127325;6816279;10674454;331410;6162267;11787443;436777;0;6380
FR;2;2023-04-12;0;0;0;0;0;0;0;0;0;6127325;6816279;10674454;331410;6162267;11787443;436777;0;6380
FR;2;2023-04-13;0;0;2;1;0;2;0;0;0;6127325;6816279;10674456;331411;6162267;11787445;436777;0;6380
FR;2;2023-04-14;0;1;0;1;1;0;1;0;0;6127325;6816280;10674456;331412;6162268;11787445;436778;0;6380
FR;2;2023-04-15;0;0;0;0;0;0;0;0;0;6127325;6816280;10674456;331412;6162268;11787445;436778;0;6380
FR;2;2023-04-16;0;0;0;0;0;0;0;0;0;6127325;6816280;10674456;331412;6162268;11787445;436778;0;6380
FR;2;2023-04-17;1;1;0;0;2;0;0;0;0;6127326;6816281;10674456;331412;6162270;11787445;436778;0;6380
FR;2;2023-04-18;0;0;1;2;0;1;2;0;0;6127326;6816281;10674457;331414;6162270;11787446;436780;0;6380
FR;2;2023-04-19;0;0;0;0;0;0;2;0;0;6127326;6816281;10674457;331414;6162270;11787446;436782;0;6380
FR;2;2023-04-20;0;0;1;1;0;1;1;0;0;6127326;6816281;10674458;331415;6162270;11787447;436783;0;6380
FR;2;2023-04-21;0;0;1;0;0;1;0;0;0;6127326;6816281;10674459;331415;6162270;11787448;436783;0;6380
FR;2;2023-04-22;0;0;2;2;0;1;1;0;2;6127326;6816281;10674461;331417;6162270;11787449;436784;0;6382
FR;2;2023-04-23;0;0;0;0;0;0;0;0;0;6127326;6816281;10674461;331417;6162270;11787449;436784;0;6382
FR;2;2023-04-24;0;0;1;0;0;0;1;0;0;6127326;6816281;10674462;331417;6162270;11787449;436785;0;6382
FR;2;2023-04-25;0;0;0;0;0;0;0;0;0;6127326;6816281;10674462;331417;6162270;11787449;436785;0;6382
FR;2;2023-04-26;0;1;0;0;0;1;0;0;0;6127326;6816282;10674462;331417;6162270;11787450;436785;0;6382
FR;2;2023-04-27;0;0;0;0;0;0;0;0;1;6127326;6816282;10674462;331417;6162270;11787450;436785;0;6383
FR;2;2023-04-28;0;0;0;0;0;0;0;0;2;6127326;6816282;10674462;331417;6162270;11787450;436785;0;6385
FR;2;2023-04-29;0;0;0;1;0;0;1;0;0;6127326;6816282;10674462;331418;6162270;11787450;436786;0;6385
FR;2;2023-04-30;0;0;0;0;0;0;0;0;0;6127326;6816282;10674462;331418;6162270;11787450;436786;0;6385
FR;2;2023-05-01;0;1;0;0;1;0;0;0;0;6127326;6816283;10674462;331418;6162271;11787450;436786;0;6385
FR;2;2023-05-02;0;0;4;1;0;4;1;0;2;6127326;6816283;10674466;331419;6162271;11787454;436787;0;6387
FR;2;2023-05-03;0;1;0;0;0;1;0;0;0;6127326;6816284;10674466;331419;6162271;11787455;436787;0;6387
FR;2;2023-05-04;0;0;0;1;0;0;1;0;0;6127326;6816284;10674466;331420;6162271;11787455;436788;0;6387
FR;2;2023-05-05;0;1;1;1;1;1;1;0;0;6127326;6816285;10674467;331421;6162272;11787456;436789;0;6387
FR;2;2023-05-06;0;0;0;0;0;0;0;0;0;6127326;6816285;10674467;331421;6162272;11787456;436789;0;6387
FR;2;2023-05-07;0;0;0;0;0;0;0;0;0;6127326;6816285;10674467;331421;6162272;11787456;436789;0;6387
FR;2;2023-05-08;0;0;0;0;0;0;0;0;0;6127326;6816285;10674467;331421;6162272;11787456;436789;0;6387
FR;2;2023-05-09;0;1;0;0;0;1;0;0;0;6127326;6816286;10674467;331421;6162272;11787457;436789;0;6387
FR;2;2023-05-10;0;0;0;0;0;0;0;0;2;6127326;6816286;10674467;331421;6162272;11787457;436789;0;6389
FR;2;2023-05-11;0;0;0;0;0;0;0;0;1;6127326;6816286;10674467;331421;6162272;11787457;436789;0;6390
FR;2;2023-05-12;0;0;0;0;0;0;0;0;0;6127326;6816286;10674467;331421;6162272;11787457;436789;0;6390
FR;2;2023-05-13;0;1;0;0;0;1;0;0;0;6127326;6816287;10674467;331421;6162272;11787458;436789;0;6390
FR;2;2023-05-14;0;0;0;0;0;0;0;0;0;6127326;6816287;10674467;331421;6162272;11787458;436789;0;6390
FR;2;2023-05-15;0;0;1;0;0;1;0;0;0;6127326;6816287;10674468;331421;6162272;11787459;436789;0;6390
FR;2;2023-05-16;0;0;0;0;0;0;0;0;0;6127326;6816287;10674468;331421;6162272;11787459;436789;0;6390
FR;2;2023-05-17;0;0;0;0;0;0;0;0;0;6127326;6816287;10674468;331421;6162272;11787459;436789;0;6390
FR;2;2023-05-18;0;0;0;1;0;0;1;0;0;6127326;6816287;10674468;331422;6162272;11787459;436790;0;6390
FR;2;2023-05-19;0;0;0;0;0;0;0;0;0;6127326;6816287;10674468;331422;6162272;11787459;436790;0;6390
FR;2;2023-05-20;0;0;0;0;0;0;0;0;0;6127326;6816287;10674468;331422;6162272;11787459;436790;0;6390
FR;2;2023-05-21;0;0;0;0;0;0;0;0;0;6127326;6816287;10674468;331422;6162272;11787459;436790;0;6390
FR;2;2023-05-22;0;0;0;1;0;0;1;0;0;6127326;6816287;10674468;331423;6162272;11787459;436791;0;6390
FR;2;2023-05-23;0;0;0;0;0;0;0;0;1;6127326;6816287;10674468;331423;6162272;11787459;436791;0;6391
FR;2;2023-05-24;0;0;0;0;0;0;0;0;0;6127326;6816287;10674468;331423;6162272;11787459;436791;0;6391
FR;2;2023-05-25;0;0;0;0;0;0;1;0;0;6127326;6816287;10674468;331423;6162272;11787459;436792;0;6391
FR;2;2023-05-26;0;1;0;1;1;0;1;0;1;6127326;6816288;10674468;331424;6162273;11787459;436793;0;6392
FR;2;2023-05-27;0;0;2;0;0;2;0;0;0;6127326;6816288;10674470;331424;6162273;11787461;436793;0;6392
FR;2;2023-05-28;0;0;0;0;0;0;0;0;0;6127326;6816288;10674470;331424;6162273;11787461;436793;0;6392
FR;2;2023-05-29;0;0;0;0;0;0;0;0;0;6127326;6816288;10674470;331424;6162273;11787461;436793;0;6392
FR;2;2023-05-30;0;0;0;0;0;0;0;0;0;6127326;6816288;10674470;331424;6162273;11787461;436793;0;6392
FR;2;2023-05-31;0;0;0;0;0;0;0;0;0;6127326;6816288;10674470;331424;6162273;11787461;436793;0;6392
FR;2;2023-06-01;0;0;1;0;0;0;1;0;0;6127326;6816288;10674471;331424;6162273;11787461;436794;0;6392
FR;2;2023-06-02;0;0;0;0;0;0;2;0;0;6127326;6816288;10674471;331424;6162273;11787461;436796;0;6392
FR;2;2023-06-03;0;0;1;0;0;0;1;0;0;6127326;6816288;10674472;331424;6162273;11787461;436797;0;6392
FR;2;2023-06-04;0;0;0;0;0;0;0;0;0;6127326;6816288;10674472;331424;6162273;11787461;436797;0;6392
FR;2;2023-06-05;0;0;0;0;0;0;0;0;0;6127326;6816288;10674472;331424;6162273;11787461;436797;0;6392
FR;2;2023-06-06;0;0;1;0;0;0;0;0;0;6127326;6816288;10674473;331424;6162273;11787461;436797;0;6392
FR;2;2023-06-07;0;0;0;0;0;0;0;0;0;6127326;6816288;10674473;331424;6162273;11787461;436797;0;6392
FR;2;2023-06-08;0;0;0;0;0;0;0;0;0;6127326;6816288;10674473;331424;6162273;11787461;436797;0;6392
FR;2;2023-06-09;0;0;0;0;0;0;0;0;0;6127326;6816288;10674473;331424;6162273;11787461;436797;0;6392
FR;2;2023-06-10;0;0;0;0;0;0;0;0;0;6127326;6816288;10674473;331424;6162273;11787461;436797;0;6392
FR;2;2023-06-11;0;0;0;0;0;0;0;0;0;6127326;6816288;10674473;331424;6162273;11787461;436797;0;6392
FR;2;2023-06-12;0;0;1;0;0;1;0;0;0;6127326;6816288;10674474;331424;6162273;11787462;436797;0;6392
FR;2;2023-06-13;0;0;0;0;0;0;0;0;0;6127326;6816288;10674474;331424;6162273;11787462;436797;0;6392
FR;2;2023-06-14;0;0;0;0;0;0;0;0;0;6127326;6816288;10674474;331424;6162273;11787462;436797;0;6392
FR;2;2023-06-15;0;0;0;0;0;1;0;0;1;6127326;6816288;10674474;331424;6162273;11787463;436797;0;6393
FR;2;2023-06-16;0;0;0;0;0;0;0;0;0;6127326;6816288;10674474;331424;6162273;11787463;436797;0;6393
FR;2;2023-06-17;0;0;0;0;0;0;0;0;0;6127326;6816288;10674474;331424;6162273;11787463;436797;0;6393
FR;2;2023-06-18;0;0;0;0;0;0;0;0;0;6127326;6816288;10674474;331424;6162273;11787463;436797;0;6393
FR;2;2023-06-19;0;0;0;0;0;0;0;0;0;6127326;6816288;10674474;331424;6162273;11787463;436797;0;6393
FR;3;2020-12-27;0;0;0;0;0;0;0;0;0;0;0;0;0;0;0;0;0;0
FR;3;2020-12-28;0;0;0;0;0;0;0;0;0;0;0;0;0;0;0;0;0;0
FR;3;2020-12-29;0;0;0;0;0;0;0;0;0;0;0;0;0;0;0;0;0;0
FR;3;2020-12-30;0;0;0;0;0;0;0;0;0;0;0;0;0;0;0;0;0;0
FR;3;2020-12-31;0;0;0;0;0;0;0;0;0;0;0;0;0;0;0;0;0;0
FR;3;2021-01-01;0;0;0;0;0;0;0;0;0;0;0;0;0;0;0;0;0;0
FR;3;2021-01-02;0;0;0;0;0;0;0;0;0;0;0;0;0;0;0;0;0;0
FR;3;2021-01-03;0;0;0;0;0;0;0;0;0;0;0;0;0;0;0;0;0;0
FR;3;2021-01-04;0;0;0;0;0;0;0;0;0;0;0;0;0;0;0;0;0;0
FR;3;2021-01-05;0;0;0;0;0;0;0;0;0;0;0;0;0;0;0;0;0;0
FR;3;2021-01-06;0;0;0;0;0;0;0;0;0;0;0;0;0;0;0;0;0;0
FR;3;2021-01-07;0;0;0;0;0;0;0;0;0;0;0;0;0;0;0;0;0;0
FR;3;2021-01-08;0;0;0;0;0;0;0;0;0;0;0;0;0;0;0;0;0;0
FR;3;2021-01-09;0;0;0;0;0;0;0;0;0;0;0;0;0;0;0;0;0;0
FR;3;2021-01-10;0;0;0;0;0;0;0;0;0;0;0;0;0;0;0;0;0;0
FR;3;2021-01-11;0;0;0;0;0;0;0;0;0;0;0;0;0;0;0;0;0;0
FR;3;2021-01-12;0;0;0;0;0;0;0;0;0;0;0;0;0;0;0;0;0;0
FR;3;2021-01-13;0;0;0;0;0;0;0;0;0;0;0;0;0;0;0;0;0;0
FR;3;2021-01-14;0;0;0;0;0;0;0;0;0;0;0;0;0;0;0;0;0;0
FR;3;2021-01-15;0;0;0;0;0;0;0;0;0;0;0;0;0;0;0;0;0;0
FR;3;2021-01-16;0;0;0;0;0;0;0;0;0;0;0;0;0;0;0;0;0;0
FR;3;2021-01-17;0;0;0;0;0;0;0;0;0;0;0;0;0;0;0;0;0;0
FR;3;2021-01-18;0;0;0;0;0;0;0;0;0;0;0;0;0;0;0;0;0;0
FR;3;2021-01-19;0;0;0;0;0;0;0;0;0;0;0;0;0;0;0;0;0;0
FR;3;2021-01-20;0;0;0;0;0;0;0;0;0;0;0;0;0;0;0;0;0;0
FR;3;2021-01-21;0;0;0;0;0;0;0;0;0;0;0;0;0;0;0;0;0;0
FR;3;2021-01-22;0;0;0;0;0;0;0;0;0;0;0;0;0;0;0;0;0;0
FR;3;2021-01-23;0;0;0;0;0;0;0;0;0;0;0;0;0;0;0;0;0;0
FR;3;2021-01-24;0;0;0;0;0;0;0;0;0;0;0;0;0;0;0;0;0;0
FR;3;2021-01-25;0;0;0;0;0;0;0;0;0;0;0;0;0;0;0;0;0;0
FR;3;2021-01-26;0;0;0;0;0;0;0;0;0;0;0;0;0;0;0;0;0;0
FR;3;2021-01-27;0;0;0;0;0;0;0;0;0;0;0;0;0;0;0;0;0;0
FR;3;2021-01-28;0;0;0;0;0;0;0;0;0;0;0;0;0;0;0;0;0;0
FR;3;2021-01-29;0;0;0;0;0;0;0;0;0;0;0;0;0;0;0;0;0;0
FR;3;2021-01-30;0;0;0;0;0;0;0;0;0;0;0;0;0;0;0;0;0;0
FR;3;2021-01-31;0;0;0;0;0;0;0;0;0;0;0;0;0;0;0;0;0;0
FR;3;2021-02-01;0;0;0;0;0;0;0;0;0;0;0;0;0;0;0;0;0;0
FR;3;2021-02-02;0;0;0;0;0;0;0;0;0;0;0;0;0;0;0;0;0;0
FR;3;2021-02-03;0;0;0;0;0;0;0;0;0;0;0;0;0;0;0;0;0;0
FR;3;2021-02-04;0;0;0;0;0;0;0;0;0;0;0;0;0;0;0;0;0;0
FR;3;2021-02-05;0;0;0;0;0;0;0;0;0;0;0;0;0;0;0;0;0;0
FR;3;2021-02-06;1474;0;0;0;105;0;0;0;0;1474;0;0;0;105;0;0;0;0
FR;3;2021-02-07;1423;2;0;0;87;0;0;0;0;2897;2;0;0;192;0;0;0;0
FR;3;2021-02-08;2790;1;0;0;177;0;0;0;0;5687;3;0;0;369;0;0;0;0
FR;3;2021-02-09;6786;0;0;0;502;0;0;0;0;12473;3;0;0;871;0;0;0;0
FR;3;2021-02-10;9612;0;0;0;695;0;0;0;0;22085;3;0;0;1566;0;0;0;0
FR;3;2021-02-11;13620;4;0;0;919;0;0;0;0;35705;7;0;0;2485;0;0;0;0
FR;3;2021-02-12;13410;0;0;0;907;0;0;0;0;49115;7;0;0;3392;0;0;0;0
FR;3;2021-02-13;3800;1;0;0;218;0;0;0;0;52915;8;0;0;3610;0;0;0;0
FR;3;2021-02-14;975;1;0;0;53;0;0;0;0;53890;9;0;0;3663;0;0;0;0
FR;3;2021-02-15;10497;2;0;0;719;0;0;0;0;64387;11;0;0;4382;0;0;0;0
FR;3;2021-02-16;12556;5;0;0;871;0;0;0;0;76943;16;0;0;5253;0;0;0;0
FR;3;2021-02-17;11159;1;0;0;717;0;0;0;0;88102;17;0;0;5970;0;0;0;0
FR;3;2021-02-18;14943;2;0;0;985;0;0;0;0;103045;19;0;0;6955;0;0;0;0
FR;3;2021-02-19;14364;1;0;0;846;0;0;0;0;117409;20;0;0;7801;0;0;0;0
FR;3;2021-02-20;3332;0;0;0;178;0;0;0;0;120741;20;0;0;7979;0;0;0;0
FR;3;2021-02-21;620;0;0;0;35;0;0;0;0;121361;20;0;0;8014;0;0;0;0
FR;3;2021-02-22;9171;1;0;0;654;0;0;0;0;130532;21;0;0;8668;0;0;0;0
FR;3;2021-02-23;11406;6;0;0;761;0;0;0;0;141938;27;0;0;9429;0;0;0;0
FR;3;2021-02-24;14305;1;0;0;829;0;0;0;0;156243;28;0;0;10258;0;0;0;0
FR;3;2021-02-25;44935;3;0;0;1814;0;0;0;0;201178;31;0;0;12072;0;0;0;0
FR;3;2021-02-26;61889;13;0;0;2201;0;0;0;0;263067;44;0;0;14273;0;0;0;0
FR;3;2021-02-27;34811;14;0;0;1028;0;0;0;0;297878;58;0;0;15301;0;0;0;0
FR;3;2021-02-28;2464;0;0;0;114;0;0;0;0;300342;58;0;0;15415;0;0;0;0
FR;3;2021-03-01;20521;21;0;0;1067;0;0;0;0;320863;79;0;0;16482;0;0;0;0
FR;3;2021-03-02;38878;25;0;0;1790;0;0;0;0;359741;104;0;0;18272;0;0;0;0
FR;3;2021-03-03;48750;18;0;0;2130;0;0;0;0;408491;122;0;0;20402;0;0;0;0
FR;3;2021-03-04;82229;25;0;0;3194;0;0;0;0;490720;147;0;0;23596;0;0;0;0
FR;3;2021-03-05;118138;43;0;0;4693;0;0;0;0;608858;190;0;0;28289;0;0;0;0
FR;3;2021-03-06;120727;65;1;0;3559;0;0;0;0;729585;255;1;0;31848;0;0;0;0
FR;3;2021-03-07;55186;23;0;0;1729;0;0;0;0;784771;278;1;0;33577;0;0;0;0
FR;3;2021-03-08;42814;29;0;0;2074;0;0;0;0;827585;307;1;0;35651;0;0;0;0
FR;3;2021-03-09;78979;51;0;0;3288;0;0;0;0;906564;358;1;0;38939;0;0;0;0
FR;3;2021-03-10;80985;67;0;0;3243;0;0;0;0;987549;425;1;0;42182;0;0;0;0
FR;3;2021-03-11;128447;66;0;0;4766;0;0;0;0;1115996;491;1;0;46948;0;0;0;0
FR;3;2021-03-12;182718;122;0;0;6279;0;0;0;0;1298714;613;1;0;53227;0;0;0;0
FR;3;2021-03-13;132160;91;0;0;3530;0;0;0;0;1430874;704;1;0;56757;0;0;0;0
FR;3;2021-03-14;14061;6;0;0;550;0;0;0;0;1444935;710;1;0;57307;0;0;0;0
FR;3;2021-03-15;52243;82;0;0;2097;0;0;0;0;1497178;792;1;0;59404;0;0;0;0
FR;3;2021-03-16;1221;51;0;0;105;0;0;0;0;1498399;843;1;0;59509;0;0;0;0
FR;3;2021-03-17;950;56;0;0;95;0;0;0;0;1499349;899;1;0;59604;0;0;0;0
FR;3;2021-03-18;1577;42;0;0;102;0;0;0;0;1500926;941;1;0;59706;0;0;0;0
FR;3;2021-03-19;70458;56;0;0;2060;0;0;0;0;1571384;997;1;0;61766;0;0;0;0
FR;3;2021-03-20;65242;51;0;0;1702;0;0;0;0;1636626;1048;1;0;63468;0;0;0;0
FR;3;2021-03-21;5761;8;0;0;199;0;0;0;0;1642387;1056;1;0;63667;0;0;0;0
FR;3;2021-03-22;37511;50;0;0;1053;0;0;0;0;1679898;1106;1;0;64720;0;0;0;0
FR;3;2021-03-23;84670;87;0;0;2288;0;0;0;0;1764568;1193;1;0;67008;0;0;0;0
FR;3;2021-03-24;90956;99;0;0;2491;0;0;0;0;1855524;1292;1;0;69499;0;0;0;0
FR;3;2021-03-25;150068;149;0;0;3792;0;0;0;0;2005592;1441;1;0;73291;0;0;0;0
FR;3;2021-03-26;165432;157;0;0;4148;0;0;0;0;2171024;1598;1;0;77439;0;0;0;0
FR;3;2021-03-27;68465;101;0;0;2004;0;0;0;0;2239489;1699;1;0;79443;0;0;0;0
FR;3;2021-03-28;6481;20;0;0;238;0;0;0;0;2245970;1719;1;0;79681;0;0;0;0
FR;3;2021-03-29;54171;83;0;0;1480;0;0;0;0;2300141;1802;1;0;81161;0;0;0;0
FR;3;2021-03-30;93185;103;0;0;2564;0;0;0;0;2393326;1905;1;0;83725;0;0;0;0
FR;3;2021-03-31;63547;110;0;0;1964;0;0;0;0;2456873;2015;1;0;85689;0;0;0;0
FR;3;2021-04-01;86136;116;0;0;2496;0;0;0;0;2543009;2131;1;0;88185;0;0;0;0
FR;3;2021-04-02;86916;186;0;0;2766;0;0;0;0;2629925;2317;1;0;90951;0;0;0;0
FR;3;2021-04-03;35876;133;0;0;1164;0;0;0;0;2665801;2450;1;0;92115;0;0;0;0
FR;3;2021-04-04;3577;19;0;0;164;0;0;0;0;2669378;2469;1;0;92279;0;0;0;0
FR;3;2021-04-05;4492;40;0;0;236;0;0;0;0;2673870;2509;1;0;92515;0;0;0;0
FR;3;2021-04-06;29763;105;0;0;1091;0;0;0;0;2703633;2614;1;0;93606;0;0;0;0
FR;3;2021-04-07;32350;113;0;0;1052;0;0;0;0;2735983;2727;1;0;94658;0;0;0;0
FR;3;2021-04-08;78825;274;0;0;2619;0;0;0;0;2814808;3001;1;0;97277;0;0;0;0
FR;3;2021-04-09;161764;454;0;0;5180;0;0;0;0;2976572;3455;1;0;102457;0;0;0;0
FR;3;2021-04-10;75765;365;0;0;2697;0;0;0;0;3052337;3820;1;0;105154;0;0;0;0
FR;3;2021-04-11;7316;47;0;0;306;0;0;0;0;3059653;3867;1;0;105460;0;0;0;0
FR;3;2021-04-12;51484;219;0;0;1738;0;0;0;0;3111137;4086;1;0;107198;0;0;0;0
FR;3;2021-04-13;86236;364;0;0;2911;0;0;0;0;3197373;4450;1;0;110109;0;0;0;0
FR;3;2021-04-14;67847;377;0;0;2429;0;0;0;0;3265220;4827;1;0;112538;0;0;0;0
FR;3;2021-04-15;93246;404;0;0;3442;0;0;0;0;3358466;5231;1;0;115980;0;0;0;0
FR;3;2021-04-16;112532;628;0;0;4343;0;0;0;0;3470998;5859;1;0;120323;0;0;0;0
FR;3;2021-04-17;53319;371;1;0;2277;0;0;0;0;3524317;6230;2;0;122600;0;0;0;0
FR;3;2021-04-18;9752;49;0;0;423;0;0;0;0;3534069;6279;2;0;123023;0;0;0;0
FR;3;2021-04-19;25117;287;0;0;1093;0;0;0;0;3559186;6566;2;0;124116;0;0;0;0
FR;3;2021-04-20;45676;438;0;0;1908;0;0;0;0;3604862;7004;2;0;126024;0;0;0;0
FR;3;2021-04-21;38988;553;0;0;1897;0;0;0;0;3643850;7557;2;0;127921;0;0;0;0
FR;3;2021-04-22;54723;875;0;0;2827;0;0;0;0;3698573;8432;2;0;130748;0;0;0;0
FR;3;2021-04-23;70493;1095;0;0;3697;0;0;0;0;3769066;9527;2;0;134445;0;0;0;0
FR;3;2021-04-24;37253;1101;0;0;2490;0;0;0;0;3806319;10628;2;0;136935;0;0;0;0
FR;3;2021-04-25;6213;158;0;0;446;0;0;0;0;3812532;10786;2;0;137381;0;0;0;0
FR;3;2021-04-26;19792;701;0;0;1436;0;0;0;0;3832324;11487;2;0;138817;0;0;0;0
FR;3;2021-04-27;34486;1336;0;0;2594;0;0;0;0;3866810;12823;2;0;141411;0;0;0;0
FR;3;2021-04-28;28971;2047;0;0;3164;0;0;0;0;3895781;14870;2;0;144575;0;0;0;0
FR;3;2021-04-29;45394;6127;0;0;7946;0;0;0;0;3941175;20997;2;0;152521;0;0;0;0
FR;3;2021-04-30;55465;9118;1;0;11513;0;0;0;0;3996640;30115;3;0;164034;0;0;0;0
FR;3;2021-05-01;9518;2064;0;0;2495;0;0;0;0;4006158;32179;3;0;166529;0;0;0;0
FR;3;2021-05-02;3081;466;0;0;611;0;0;0;0;4009239;32645;3;0;167140;0;0;0;0
FR;3;2021-05-03;13067;3940;0;0;4507;0;0;0;0;4022306;36585;3;0;171647;0;0;0;0
FR;3;2021-05-04;23123;8375;0;0;9442;0;0;0;0;4045429;44960;3;0;181089;0;0;0;0
FR;3;2021-05-05;18768;10833;0;0;11771;0;0;0;0;4064197;55793;3;0;192860;0;0;0;0
FR;3;2021-05-06;34632;21265;0;0;22815;0;0;0;0;4098829;77058;3;0;215675;0;0;0;0
FR;3;2021-05-07;44211;28903;0;0;31206;0;0;0;0;4143040;105961;3;0;246881;0;0;0;0
FR;3;2021-05-08;6786;9190;0;0;9556;0;0;0;0;4149826;115151;3;0;256437;0;0;0;0
FR;3;2021-05-09;1797;2667;0;0;2768;0;0;0;0;4151623;117818;3;0;259205;0;0;0;0
FR;3;2021-05-10;15001;12917;0;0;13610;0;0;0;0;4166624;130735;3;0;272815;0;0;0;0
FR;3;2021-05-11;27100;26272;0;0;27545;0;0;0;0;4193724;157007;3;0;300360;0;0;0;0
FR;3;2021-05-12;17273;28147;0;0;29085;0;0;0;0;4210997;185154;3;0;329445;0;0;0;0
FR;3;2021-05-13;2285;3511;0;0;3632;0;0;0;0;4213282;188665;3;0;333077;0;0;0;0
FR;3;2021-05-14;14521;26084;0;0;26865;0;0;0;0;4227803;214749;3;0;359942;0;0;0;0
FR;3;2021-05-15;7233;21086;0;0;21516;0;0;0;0;4235036;235835;3;0;381458;0;0;0;0
FR;3;2021-05-16;977;2649;0;0;2695;0;0;0;0;4236013;238484;3;0;384153;0;0;0;0
FR;3;2021-05-17;7967;20224;0;0;20668;0;0;0;0;4243980;258708;3;0;404821;0;0;0;0
FR;3;2021-05-18;13418;30157;0;0;30920;0;0;0;0;4257398;288865;3;0;435741;0;0;0;0
FR;3;2021-05-19;9277;30526;0;0;31120;0;0;0;0;4266675;319391;3;0;466861;0;0;0;0
FR;3;2021-05-20;12809;53832;3;0;54758;0;0;0;0;4279484;373223;6;0;521619;0;0;0;0
FR;3;2021-05-21;12771;66186;2;0;67117;0;0;0;0;4292255;439409;8;0;588736;0;0;0;0
FR;3;2021-05-22;4967;33781;1;0;34164;0;0;0;0;4297222;473190;9;0;622900;0;0;0;0
FR;3;2021-05-23;651;2663;0;0;2695;0;0;0;0;4297873;475853;9;0;625595;0;0;0;0
FR;3;2021-05-24;885;4784;0;0;4828;0;0;0;0;4298758;480637;9;0;630423;0;0;0;0
FR;3;2021-05-25;5316;46738;1;0;47145;0;0;0;0;4304074;527375;10;0;677568;0;0;0;0
FR;3;2021-05-26;4982;52192;1;0;52666;0;0;0;0;4309056;579567;11;0;730234;0;0;0;0
FR;3;2021-05-27;6338;79066;3;0;79677;0;0;0;0;4315394;658633;14;0;809911;0;0;0;0
FR;3;2021-05-28;7546;100338;2;0;101144;0;0;0;0;4322940;758971;16;0;911055;0;0;0;0
FR;3;2021-05-29;3350;61184;1;0;61566;0;0;0;0;4326290;820155;17;0;972621;0;0;0;0
FR;3;2021-05-30;551;8078;0;0;8127;0;0;0;0;4326841;828233;17;0;980748;0;0;0;0
FR;3;2021-05-31;2442;35483;3;0;35749;0;0;0;0;4329283;863716;20;0;1016497;0;0;0;0
FR;3;2021-06-01;3418;64904;10;0;65356;0;0;0;0;4332701;928620;30;0;1081853;0;0;0;0
FR;3;2021-06-02;2735;58932;6;0;59267;0;0;0;0;4335436;987552;36;0;1141120;0;0;0;0
FR;3;2021-06-03;3496;87204;10;0;87743;0;0;0;0;4338932;1074756;46;0;1228863;0;0;0;0
FR;3;2021-06-04;4125;105866;22;0;106532;0;0;0;0;4343057;1180622;68;0;1335395;0;0;0;0
FR;3;2021-06-05;1983;52608;4;0;52926;0;0;0;0;4345040;1233230;72;0;1388321;0;0;0;0
FR;3;2021-06-06;511;5269;1;0;5317;0;0;0;0;4345551;1238499;73;0;1393638;0;0;0;0
FR;3;2021-06-07;1488;30717;11;0;30898;0;0;0;0;4347039;1269216;84;0;1424536;0;0;0;0
FR;3;2021-06-08;2066;47426;18;0;47773;0;0;0;0;4349105;1316642;102;0;1472309;0;0;0;0
FR;3;2021-06-09;1796;41806;13;0;42111;0;0;0;0;4350901;1358448;115;0;1514420;0;0;0;0
FR;3;2021-06-10;2261;67662;17;0;68060;0;0;0;0;4353162;1426110;132;0;1582480;0;0;0;0
FR;3;2021-06-11;2494;96639;34;0;97115;0;0;0;0;4355656;1522749;166;0;1679595;0;0;0;0
FR;3;2021-06-12;1179;40558;6;0;40790;0;0;0;0;4356835;1563307;172;0;1720385;0;0;0;0
FR;3;2021-06-13;283;3606;3;0;3641;0;0;0;0;4357118;1566913;175;0;1724026;0;0;0;0
FR;3;2021-06-14;1051;42316;17;0;42486;0;0;0;0;4358169;1609229;192;0;1766512;0;0;0;0
FR;3;2021-06-15;1379;80353;20;0;80658;0;0;0;0;4359548;1689582;212;0;1847170;0;0;0;0
FR;3;2021-06-16;1263;65504;20;0;65777;0;0;0;0;4360811;1755086;232;0;1912947;0;0;0;0
FR;3;2021-06-17;1667;102294;41;0;102680;0;0;0;0;4362478;1857380;273;0;2015627;0;0;0;0
FR;3;2021-06-18;1873;118469;63;0;118939;0;0;0;0;4364351;1975849;336;0;2134566;0;0;0;0
FR;3;2021-06-19;804;39455;22;0;39650;0;0;0;0;4365155;2015304;358;0;2174216;0;0;0;0
FR;3;2021-06-20;162;3194;0;0;3223;0;0;0;0;4365317;2018498;358;0;2177439;0;0;0;0
FR;3;2021-06-21;775;39091;16;0;39249;0;0;0;0;4366092;2057589;374;0;2216688;0;0;0;0
FR;3;2021-06-22;1065;70092;52;0;70363;0;0;0;0;4367157;2127681;426;0;2287051;0;0;0;0
FR;3;2021-06-23;946;50833;39;0;51105;0;0;0;0;4368103;2178514;465;0;2338156;0;0;0;0
FR;3;2021-06-24;1314;77303;48;0;77676;0;0;0;0;4369417;2255817;513;0;2415832;0;0;0;0
FR;3;2021-06-25;1410;90855;73;0;91289;0;0;0;0;4370827;2346672;586;0;2507121;0;0;0;0
FR;3;2021-06-26;631;33108;29;0;33300;0;0;0;0;4371458;2379780;615;0;2540421;0;0;0;0
FR;3;2021-06-27;168;3778;1;0;3802;0;0;0;0;4371626;2383558;616;0;2544223;0;0;0;0
FR;3;2021-06-28;655;29927;27;0;30121;0;0;0;0;4372281;2413485;643;0;2574344;0;0;0;0
FR;3;2021-06-29;856;56654;95;0;56898;0;0;0;0;4373137;2470139;738;0;2631242;0;0;0;0
FR;3;2021-06-30;905;45216;93;0;45484;0;0;0;0;4374042;2515355;831;0;2676726;0;0;0;0
FR;3;2021-07-01;1164;66131;108;0;66480;0;0;0;0;4375206;2581486;939;0;2743206;0;0;0;0
FR;3;2021-07-02;1305;90525;170;0;91008;0;0;0;0;4376511;2672011;1109;0;2834214;0;0;0;0
FR;3;2021-07-03;602;31185;51;0;31386;0;0;0;0;4377113;2703196;1160;0;2865600;0;0;0;0
FR;3;2021-07-04;144;3968;3;0;3998;0;0;0;0;4377257;2707164;1163;0;2869598;0;0;0;0
FR;3;2021-07-05;613;33604;60;0;33805;0;0;0;0;4377870;2740768;1223;0;2903403;0;0;0;0
FR;3;2021-07-06;965;55938;88;0;56249;0;0;0;0;4378835;2796706;1311;0;2959652;0;0;0;0
FR;3;2021-07-07;874;42968;80;0;43266;0;0;0;0;4379709;2839674;1391;0;3002918;0;0;0;0
FR;3;2021-07-08;1127;60809;99;0;61219;0;0;0;0;4380836;2900483;1490;0;3064137;0;0;0;0
FR;3;2021-07-09;1261;68941;128;0;69406;0;0;0;0;4382097;2969424;1618;0;3133543;0;0;0;0
FR;3;2021-07-10;644;25019;59;0;25217;0;0;0;0;4382741;2994443;1677;0;3158760;0;0;0;0
FR;3;2021-07-11;132;3173;4;0;3198;0;0;0;0;4382873;2997616;1681;0;3161958;0;0;0;0
FR;3;2021-07-12;662;23600;59;0;23813;0;0;0;0;4383535;3021216;1740;0;3185771;0;0;0;0
FR;3;2021-07-13;1648;34428;90;0;34918;0;0;0;0;4385183;3055644;1830;0;3220689;0;0;0;0
FR;3;2021-07-14;272;2475;2;0;2532;0;0;0;0;4385455;3058119;1832;0;3223221;0;0;0;0
FR;3;2021-07-15;1941;30414;85;0;30989;0;0;0;0;4387396;3088533;1917;0;3254210;0;0;0;0
FR;3;2021-07-16;2520;38620;122;0;39354;0;0;0;0;4389916;3127153;2039;0;3293564;0;0;0;0
FR;3;2021-07-17;1051;13723;26;0;14031;0;0;0;0;4390967;3140876;2065;0;3307595;0;0;0;0
FR;3;2021-07-18;266;2548;3;0;2596;0;0;0;0;4391233;3143424;2068;0;3310191;0;0;0;0
FR;3;2021-07-19;1280;16883;38;0;17251;0;0;0;0;4392513;3160307;2106;0;3327442;0;0;0;0
FR;3;2021-07-20;1823;26931;98;0;27472;0;0;0;0;4394336;3187238;2204;0;3354914;0;0;0;0
FR;3;2021-07-21;1652;19473;44;0;19978;0;0;0;0;4395988;3206711;2248;0;3374892;0;0;0;0
FR;3;2021-07-22;1856;27647;83;0;28212;0;0;0;0;4397844;3234358;2331;0;3403104;0;0;0;0
FR;3;2021-07-23;2217;30212;117;0;30949;0;0;0;0;4400061;3264570;2448;0;3434053;0;0;0;0
FR;3;2021-07-24;828;6926;25;0;7149;0;0;0;0;4400889;3271496;2473;0;3441202;0;0;0;0
FR;3;2021-07-25;210;1287;1;0;1342;0;0;0;0;4401099;3272783;2474;0;3442544;0;0;0;0
FR;3;2021-07-26;933;10509;28;0;10817;0;0;0;0;4402032;3283292;2502;0;3453361;0;0;0;0
FR;3;2021-07-27;1171;16802;56;0;17165;0;0;0;0;4403203;3300094;2558;0;3470526;0;0;0;0
FR;3;2021-07-28;989;11999;40;0;12311;0;0;0;0;4404192;3312093;2598;0;3482837;0;0;0;0
FR;3;2021-07-29;1127;15676;63;0;16089;0;0;0;0;4405319;3327769;2661;0;3498926;0;0;0;0
FR;3;2021-07-30;1130;17991;79;0;18366;0;0;0;0;4406449;3345760;2740;0;3517292;0;0;0;0
FR;3;2021-07-31;407;3711;15;0;3837;0;0;0;0;4406856;3349471;2755;0;3521129;0;0;0;0
FR;3;2021-08-01;117;443;1;0;465;0;0;0;0;4406973;3349914;2756;0;3521594;0;0;0;0
FR;3;2021-08-02;424;5016;22;0;5136;0;0;0;0;4407397;3354930;2778;0;3526730;0;0;0;0
FR;3;2021-08-03;498;7466;27;0;7599;0;0;0;0;4407895;3362396;2805;0;3534329;0;0;0;0
FR;3;2021-08-04;441;4831;26;0;4977;0;0;0;0;4408336;3367227;2831;0;3539306;0;0;0;0
FR;3;2021-08-05;433;3653;13;0;3763;0;0;0;0;4408769;3370880;2844;0;3543069;0;0;0;0
FR;3;2021-08-06;456;4699;30;0;4800;0;0;0;0;4409225;3375579;2874;0;3547869;0;0;0;0
FR;3;2021-08-07;214;1900;11;0;1946;0;0;0;0;4409439;3377479;2885;0;3549815;0;0;0;0
FR;3;2021-08-08;251;424;2;0;457;0;0;0;0;4409690;3377903;2887;0;3550272;0;0;0;0
FR;3;2021-08-09;320;2376;11;0;2446;0;0;0;0;4410010;3380279;2898;0;3552718;0;0;0;0
FR;3;2021-08-10;369;3735;15;0;3823;0;0;0;0;4410379;3384014;2913;0;3556541;0;0;0;0
FR;3;2021-08-11;291;2639;15;0;2699;0;0;0;0;4410670;3386653;2928;0;3559240;0;0;0;0
FR;3;2021-08-12;279;2563;13;0;2651;0;0;0;0;4410949;3389216;2941;0;3561891;0;0;0;0
FR;3;2021-08-13;279;2255;16;0;2341;0;0;0;0;4411228;3391471;2957;0;3564232;0;0;0;0
FR;3;2021-08-14;172;874;1;0;905;0;0;0;0;4411400;3392345;2958;0;3565137;0;0;0;0
FR;3;2021-08-15;56;174;0;0;183;0;0;0;0;4411456;3392519;2958;0;3565320;0;0;0;0
FR;3;2021-08-16;126;1002;8;0;1041;0;0;0;0;4411582;3393521;2966;0;3566361;0;0;0;0
FR;3;2021-08-17;191;1430;8;0;1471;0;0;0;0;4411773;3394951;2974;0;3567832;0;0;0;0
FR;3;2021-08-18;205;1309;10;0;1351;0;0;0;0;4411978;3396260;2984;0;3569183;0;0;0;0
FR;3;2021-08-19;165;1373;10;0;1420;0;0;0;0;4412143;3397633;2994;0;3570603;0;0;0;0
FR;3;2021-08-20;167;1595;16;0;1657;0;0;0;0;4412310;3399228;3010;0;3572260;0;0;0;0
FR;3;2021-08-21;94;576;2;0;591;0;0;0;0;4412404;3399804;3012;0;3572851;0;0;0;0
FR;3;2021-08-22;42;194;1;0;197;0;0;0;0;4412446;3399998;3013;0;3573048;0;0;0;0
FR;3;2021-08-23;141;886;7;0;931;0;0;0;0;4412587;3400884;3020;0;3573979;0;0;0;0
FR;3;2021-08-24;125;920;10;0;952;0;0;0;0;4412712;3401804;3030;0;3574931;0;0;0;0
FR;3;2021-08-25;137;821;3;0;850;0;0;0;0;4412849;3402625;3033;0;3575781;0;0;0;0
FR;3;2021-08-26;172;823;9;0;871;0;0;0;0;4413021;3403448;3042;0;3576652;0;0;0;0
FR;3;2021-08-27;178;937;9;0;989;0;0;0;0;4413199;3404385;3051;0;3577641;0;0;0;0
FR;3;2021-08-28;101;373;4;0;390;0;0;0;0;4413300;3404758;3055;0;3578031;0;0;0;0
FR;3;2021-08-29;128;129;1;0;162;0;0;0;0;4413428;3404887;3056;0;3578193;0;0;0;0
FR;3;2021-08-30;100;560;0;0;469;108;0;0;0;4413528;3405447;3056;0;3578662;108;0;0;0
FR;3;2021-08-31;134;682;7;0;587;134;0;0;0;4413662;3406129;3063;0;3579249;242;0;0;0
FR;3;2021-09-01;122;461;5;0;383;106;0;0;0;4413784;3406590;3068;0;3579632;348;0;0;0
FR;3;2021-09-02;100;595;22;0;531;105;0;0;0;4413884;3407185;3090;0;3580163;453;0;0;0
FR;3;2021-09-03;116;552;17;0;477;116;0;0;0;4414000;3407737;3107;0;3580640;569;0;0;0
FR;3;2021-09-04;55;295;3;0;256;50;0;0;0;4414055;3408032;3110;0;3580896;619;0;0;0
FR;3;2021-09-05;52;65;5;0;55;25;0;0;0;4414107;3408097;3115;0;3580951;644;0;0;0
FR;3;2021-09-06;118;367;4;0;261;130;0;0;0;4414225;3408464;3119;0;3581212;774;0;0;0
FR;3;2021-09-07;125;431;14;0;347;116;0;0;0;4414350;3408895;3133;0;3581559;890;0;0;0
FR;3;2021-09-08;122;344;2;0;274;87;0;0;0;4414472;3409239;3135;0;3581833;977;0;0;0
FR;3;2021-09-09;94;379;8;0;299;103;0;0;0;4414566;3409618;3143;0;3582132;1080;0;0;0
FR;3;2021-09-10;101;402;3;0;332;93;0;0;0;4414667;3410020;3146;0;3582464;1173;0;0;0
FR;3;2021-09-11;79;233;4;0;178;65;0;0;0;4414746;3410253;3150;0;3582642;1238;0;0;0
FR;3;2021-09-12;37;49;1;0;38;16;0;0;0;4414783;3410302;3151;0;3582680;1254;0;0;0
FR;3;2021-09-13;78;298;7;0;215;102;1;0;0;4414861;3410600;3158;0;3582895;1356;1;0;0
FR;3;2021-09-14;75;271;6;0;191;94;0;0;0;4414936;3410871;3164;0;3583086;1450;1;0;0
FR;3;2021-09-15;64;252;3;0;257;6;0;0;0;4415000;3411123;3167;0;3583343;1456;1;0;0
FR;3;2021-09-16;65;320;6;0;331;6;0;0;0;4415065;3411443;3173;0;3583674;1462;1;0;0
FR;3;2021-09-17;52;327;3;0;339;6;0;0;0;4415117;3411770;3176;0;3584013;1468;1;0;0
FR;3;2021-09-18;37;172;1;0;176;1;0;0;0;4415154;3411942;3177;0;3584189;1469;1;0;0
FR;3;2021-09-19;29;31;2;0;34;1;0;0;0;4415183;3411973;3179;0;3584223;1470;1;0;0
FR;3;2021-09-20;82;188;0;0;196;1;0;0;0;4415265;3412161;3179;0;3584419;1471;1;0;0
FR;3;2021-09-21;60;273;7;0;277;8;0;0;0;4415325;3412434;3186;0;3584696;1479;1;0;0
FR;3;2021-09-22;67;229;6;0;242;7;0;0;0;4415392;3412663;3192;0;3584938;1486;1;0;0
FR;3;2021-09-23;37;256;11;0;260;7;0;0;0;4415429;3412919;3203;0;3585198;1493;1;0;0
FR;3;2021-09-24;29;315;12;0;313;18;0;0;0;4415458;3413234;3215;0;3585511;1511;1;0;0
FR;3;2021-09-25;31;144;3;0;150;3;0;0;0;4415489;3413378;3218;0;3585661;1514;1;0;0
FR;3;2021-09-26;16;57;1;0;59;1;0;0;0;4415505;3413435;3219;0;3585720;1515;1;0;0
FR;3;2021-09-27;49;282;3;0;285;5;0;0;0;4415554;3413717;3222;0;3586005;1520;1;0;0
FR;3;2021-09-28;49;245;6;0;253;8;0;0;0;4415603;3413962;3228;0;3586258;1528;1;0;0
FR;3;2021-09-29;40;218;10;0;222;15;0;0;0;4415643;3414180;3238;0;3586480;1543;1;0;0
FR;3;2021-09-30;40;200;8;0;204;11;0;0;0;4415683;3414380;3246;0;3586684;1554;1;0;0
FR;3;2021-10-01;23;159;6;0;161;8;0;0;0;4415706;3414539;3252;0;3586845;1562;1;0;0
FR;3;2021-10-02;17;88;0;0;89;0;0;0;0;4415723;3414627;3252;0;3586934;1562;1;0;0
FR;3;2021-10-03;19;19;1;0;19;2;0;0;0;4415742;3414646;3253;0;3586953;1564;1;0;0
FR;3;2021-10-04;33;157;4;0;162;4;0;0;0;4415775;3414803;3257;0;3587115;1568;1;0;0
FR;3;2021-10-05;17;148;10;0;153;12;0;0;0;4415792;3414951;3267;0;3587268;1580;1;0;0
FR;3;2021-10-06;34;145;9;0;153;10;0;0;0;4415826;3415096;3276;0;3587421;1590;1;0;0
FR;3;2021-10-07;20;132;6;0;130;6;0;0;0;4415846;3415228;3282;0;3587551;1596;1;0;0
FR;3;2021-10-08;25;136;10;0;141;9;0;0;0;4415871;3415364;3292;0;3587692;1605;1;0;0
FR;3;2021-10-09;17;72;1;0;73;1;0;0;0;4415888;3415436;3293;0;3587765;1606;1;0;0
FR;3;2021-10-10;13;17;2;0;16;3;0;0;0;4415901;3415453;3295;0;3587781;1609;1;0;0
FR;3;2021-10-11;17;117;4;0;122;5;0;0;0;4415918;3415570;3299;0;3587903;1614;1;0;0
FR;3;2021-10-12;22;99;6;0;99;6;0;0;0;4415940;3415669;3305;0;3588002;1620;1;0;0
FR;3;2021-10-13;25;114;9;0;121;7;0;0;0;4415965;3415783;3314;0;3588123;1627;1;0;0
FR;3;2021-10-14;19;138;3;0;139;4;0;0;0;4415984;3415921;3317;0;3588262;1631;1;0;0
FR;3;2021-10-15;24;139;8;0;138;13;0;0;0;4416008;3416060;3325;0;3588400;1644;1;0;0
FR;3;2021-10-16;13;66;6;0;65;8;0;0;0;4416021;3416126;3331;0;3588465;1652;1;0;0
FR;3;2021-10-17;13;24;0;0;26;0;0;0;0;4416034;3416150;3331;0;3588491;1652;1;0;0
FR;3;2021-10-18;18;112;2;0;117;2;0;0;0;4416052;3416262;3333;0;3588608;1654;1;0;0
FR;3;2021-10-19;18;112;19;0;113;21;0;0;0;4416070;3416374;3352;0;3588721;1675;1;0;0
FR;3;2021-10-20;27;124;6;0;126;7;0;0;0;4416097;3416498;3358;0;3588847;1682;1;0;0
FR;3;2021-10-21;28;120;17;0;120;13;0;0;0;4416125;3416618;3375;0;3588967;1695;1;0;0
FR;3;2021-10-22;25;103;18;0;102;21;0;0;0;4416150;3416721;3393;0;3589069;1716;1;0;0
FR;3;2021-10-23;17;53;3;0;53;2;0;0;0;4416167;3416774;3396;0;3589122;1718;1;0;0
FR;3;2021-10-24;7;36;0;0;34;0;0;0;0;4416174;3416810;3396;0;3589156;1718;1;0;0
FR;3;2021-10-25;27;141;7;0;145;7;0;0;0;4416201;3416951;3403;0;3589301;1725;1;0;0
FR;3;2021-10-26;25;96;22;0;93;19;0;0;0;4416226;3417047;3425;0;3589394;1744;1;0;0
FR;3;2021-10-27;19;91;9;0;93;9;0;0;0;4416245;3417138;3434;0;3589487;1753;1;0;0
FR;3;2021-10-28;23;114;33;0;111;36;0;0;0;4416268;3417252;3467;0;3589598;1789;1;0;0
FR;3;2021-10-29;12;97;64;0;91;54;0;0;0;4416280;3417349;3531;0;3589689;1843;1;0;0
FR;3;2021-10-30;11;62;11;1;62;10;0;0;0;4416291;3417411;3542;1;3589751;1853;1;0;0
FR;3;2021-10-31;8;25;1;0;25;1;0;0;0;4416299;3417436;3543;1;3589776;1854;1;0;0
FR;3;2021-11-01;11;22;2;0;23;1;0;0;0;4416310;3417458;3545;1;3589799;1855;1;0;0
FR;3;2021-11-02;11;100;10;0;100;12;0;0;0;4416321;3417558;3555;1;3589899;1867;1;0;0
FR;3;2021-11-03;22;105;10;0;113;10;0;0;0;4416343;3417663;3565;1;3590012;1877;1;0;0
FR;3;2021-11-04;20;88;6;0;93;5;0;0;0;4416363;3417751;3571;1;3590105;1882;1;0;0
FR;3;2021-11-05;19;119;9;1;125;6;1;0;0;4416382;3417870;3580;2;3590230;1888;2;0;0
FR;3;2021-11-06;11;54;3;0;56;3;0;0;0;4416393;3417924;3583;2;3590286;1891;2;0;0
FR;3;2021-11-07;6;23;1;0;24;1;0;0;0;4416399;3417947;3584;2;3590310;1892;2;0;0
FR;3;2021-11-08;12;124;7;0;129;5;0;0;0;4416411;3418071;3591;2;3590439;1897;2;0;0
FR;3;2021-11-09;15;123;6;0;125;6;0;0;0;4416426;3418194;3597;2;3590564;1903;2;0;0
FR;3;2021-11-10;15;130;15;0;128;16;0;0;0;4416441;3418324;3612;2;3590692;1919;2;0;0
FR;3;2021-11-11;12;49;3;0;51;3;0;0;0;4416453;3418373;3615;2;3590743;1922;2;0;0
FR;3;2021-11-12;15;126;6;0;128;5;0;0;0;4416468;3418499;3621;2;3590871;1927;2;0;0
FR;3;2021-11-13;7;66;9;0;61;10;0;0;0;4416475;3418565;3630;2;3590932;1937;2;0;0
FR;3;2021-11-14;3;24;1;0;24;1;0;0;0;4416478;3418589;3631;2;3590956;1938;2;0;0
FR;3;2021-11-15;7;161;11;0;158;12;0;0;0;4416485;3418750;3642;2;3591114;1950;2;0;0
FR;3;2021-11-16;9;125;11;0;120;10;0;0;0;4416494;3418875;3653;2;3591234;1960;2;0;0
FR;3;2021-11-17;8;134;11;0;135;8;0;0;0;4416502;3419009;3664;2;3591369;1968;2;0;0
FR;3;2021-11-18;16;131;10;0;132;11;0;0;0;4416518;3419140;3674;2;3591501;1979;2;0;0
FR;3;2021-11-19;12;178;23;0;173;28;0;0;0;4416530;3419318;3697;2;3591674;2007;2;0;0
FR;3;2021-11-20;6;101;6;0;102;6;0;0;0;4416536;3419419;3703;2;3591776;2013;2;0;0
FR;3;2021-11-21;3;24;4;0;23;4;0;0;0;4416539;3419443;3707;2;3591799;2017;2;0;0
FR;3;2021-11-22;11;185;11;0;185;11;0;0;0;4416550;3419628;3718;2;3591984;2028;2;0;0
FR;3;2021-11-23;10;180;16;0;178;15;0;0;0;4416560;3419808;3734;2;3592162;2043;2;0;0
FR;3;2021-11-24;11;180;9;0;172;17;0;0;0;4416571;3419988;3743;2;3592334;2060;2;0;0
FR;3;2021-11-25;12;197;11;0;196;11;0;0;0;4416583;3420185;3754;2;3592530;2071;2;0;0
FR;3;2021-11-26;10;251;35;0;250;33;1;0;0;4416593;3420436;3789;2;3592780;2104;3;0;0
FR;3;2021-11-27;8;122;20;0;122;21;0;0;0;4416601;3420558;3809;2;3592902;2125;3;0;0
FR;3;2021-11-28;3;56;7;0;57;7;0;0;0;4416604;3420614;3816;2;3592959;2132;3;0;0
FR;3;2021-11-29;5;214;22;0;209;23;1;0;0;4416609;3420828;3838;2;3593168;2155;4;0;0
FR;3;2021-11-30;9;281;31;0;280;33;1;0;0;4416618;3421109;3869;2;3593448;2188;5;0;0
FR;3;2021-12-01;30;315;39;0;313;41;2;0;0;4416648;3421424;3908;2;3593761;2229;7;0;0
FR;3;2021-12-02;9;337;33;0;333;36;0;0;0;4416657;3421761;3941;2;3594094;2265;7;0;0
FR;3;2021-12-03;6;364;37;0;360;38;0;0;0;4416663;3422125;3978;2;3594454;2303;7;0;0
FR;3;2021-12-04;3;201;26;0;197;28;0;0;0;4416666;3422326;4004;2;3594651;2331;7;0;0
FR;3;2021-12-05;1;61;5;0;61;5;0;0;0;4416667;3422387;4009;2;3594712;2336;7;0;0
FR;3;2021-12-06;7;347;14;0;346;15;0;0;0;4416674;3422734;4023;2;3595058;2351;7;0;0
FR;3;2021-12-07;6;410;20;0;404;24;1;0;0;4416680;3423144;4043;2;3595462;2375;8;0;0
FR;3;2021-12-08;8;374;29;0;366;30;1;0;0;4416688;3423518;4072;2;3595828;2405;9;0;0
FR;3;2021-12-09;3;423;17;0;410;22;1;0;0;4416691;3423941;4089;2;3596238;2427;10;0;0
FR;3;2021-12-10;10;443;29;0;440;25;0;0;0;4416701;3424384;4118;2;3596678;2452;10;0;0
FR;3;2021-12-11;4;299;10;0;296;9;2;0;0;4416705;3424683;4128;2;3596974;2461;12;0;0
FR;3;2021-12-12;1;96;3;0;96;3;0;0;0;4416706;3424779;4131;2;3597070;2464;12;0;0
FR;3;2021-12-13;2;432;19;0;426;21;0;0;0;4416708;3425211;4150;2;3597496;2485;12;0;0
FR;3;2021-12-14;8;550;18;0;538;21;1;0;0;4416716;3425761;4168;2;3598034;2506;13;0;0
FR;3;2021-12-15;10;521;17;0;508;21;0;0;0;4416726;3426282;4185;2;3598542;2527;13;0;0
FR;3;2021-12-16;10;525;19;0;519;18;3;0;0;4416736;3426807;4204;2;3599061;2545;16;0;0
FR;3;2021-12-17;5;592;18;0;588;19;0;0;0;4416741;3427399;4222;2;3599649;2564;16;0;0
FR;3;2021-12-18;5;343;4;0;337;5;1;0;0;4416746;3427742;4226;2;3599986;2569;17;0;0
FR;3;2021-12-19;3;176;2;0;174;2;0;0;0;4416749;3427918;4228;2;3600160;2571;17;0;0
FR;3;2021-12-20;10;566;23;0;560;28;0;0;0;4416759;3428484;4251;2;3600720;2599;17;0;0
FR;3;2021-12-21;5;660;10;0;652;13;2;0;0;4416764;3429144;4261;2;3601372;2612;19;0;0
FR;3;2021-12-22;10;612;9;0;606;10;1;0;0;4416774;3429756;4270;2;3601978;2622;20;0;0
FR;3;2021-12-23;4;534;8;0;532;8;0;0;0;4416778;3430290;4278;2;3602510;2630;20;0;0
FR;3;2021-12-24;2;233;3;0;228;6;0;0;0;4416780;3430523;4281;2;3602738;2636;20;0;0
FR;3;2021-12-25;0;24;0;0;24;0;0;0;0;4416780;3430547;4281;2;3602762;2636;20;0;0
FR;3;2021-12-26;0;87;1;0;87;1;0;0;0;4416780;3430634;4282;2;3602849;2637;20;0;0
FR;3;2021-12-27;7;456;17;0;453;20;1;0;0;4416787;3431090;4299;2;3603302;2657;21;0;0
FR;3;2021-12-28;3;570;6;0;569;5;0;0;0;4416790;3431660;4305;2;3603871;2662;21;0;0
FR;3;2021-12-29;5;487;14;0;482;16;0;0;0;4416795;3432147;4319;2;3604353;2678;21;0;0
FR;3;2021-12-30;3;517;7;0;510;10;2;0;0;4416798;3432664;4326;2;3604863;2688;23;0;0
FR;3;2021-12-31;0;182;5;0;178;7;0;0;0;4416798;3432846;4331;2;3605041;2695;23;0;0
FR;3;2022-01-01;0;26;0;0;24;2;0;0;0;4416798;3432872;4331;2;3605065;2697;23;0;0
FR;3;2022-01-02;0;76;0;0;76;0;0;0;0;4416798;3432948;4331;2;3605141;2697;23;0;0
FR;3;2022-01-03;5;489;17;0;479;21;3;0;0;4416803;3433437;4348;2;3605620;2718;26;0;0
FR;3;2022-01-04;7;533;9;0;532;8;0;0;0;4416810;3433970;4357;2;3606152;2726;26;0;0
FR;3;2022-01-05;5;487;10;0;479;14;1;0;0;4416815;3434457;4367;2;3606631;2740;27;0;0
FR;3;2022-01-06;6;464;9;0;459;10;1;0;0;4416821;3434921;4376;2;3607090;2750;28;0;0
FR;3;2022-01-07;2;489;11;0;483;13;1;0;1;4416823;3435410;4387;2;3607573;2763;29;0;1
FR;3;2022-01-08;6;250;4;0;247;5;0;0;0;4416829;3435660;4391;2;3607820;2768;29;0;1
FR;3;2022-01-09;0;116;0;0;116;0;0;0;0;4416829;3435776;4391;2;3607936;2768;29;0;1
FR;3;2022-01-10;2;420;12;0;418;12;0;0;0;4416831;3436196;4403;2;3608354;2780;29;0;1
FR;3;2022-01-11;3;455;1;0;454;1;0;0;0;4416834;3436651;4404;2;3608808;2781;29;0;1
FR;3;2022-01-12;4;393;9;0;390;10;2;0;0;4416838;3437044;4413;2;3609198;2791;31;0;1
FR;3;2022-01-13;3;381;11;0;379;12;1;0;0;4416841;3437425;4424;2;3609577;2803;32;0;1
FR;3;2022-01-14;4;419;10;0;413;13;1;0;0;4416845;3437844;4434;2;3609990;2816;33;0;1
FR;3;2022-01-15;0;275;2;0;271;3;0;0;0;4416845;3438119;4436;2;3610261;2819;33;0;1
FR;3;2022-01-16;1;108;1;0;106;1;1;0;0;4416846;3438227;4437;2;3610367;2820;34;0;1
FR;3;2022-01-17;2;318;8;0;315;9;1;0;0;4416848;3438545;4445;2;3610682;2829;35;0;1
FR;3;2022-01-18;2;358;1;0;354;2;1;0;0;4416850;3438903;4446;2;3611036;2831;36;0;1
FR;3;2022-01-19;2;322;5;0;316;10;0;0;0;4416852;3439225;4451;2;3611352;2841;36;0;1
FR;3;2022-01-20;1;351;5;0;350;3;2;0;0;4416853;3439576;4456;2;3611702;2844;38;0;1
FR;3;2022-01-21;4;337;5;0;331;7;2;0;0;4416857;3439913;4461;2;3612033;2851;40;0;1
FR;3;2022-01-22;2;218;1;0;214;2;3;0;0;4416859;3440131;4462;2;3612247;2853;43;0;1
FR;3;2022-01-23;0;77;0;0;75;1;1;0;0;4416859;3440208;4462;2;3612322;2854;44;0;1
FR;3;2022-01-24;3;316;1;0;308;6;2;0;0;4416862;3440524;4463;2;3612630;2860;46;0;1
FR;3;2022-01-25;0;171;0;0;168;0;1;0;0;4416862;3440695;4463;2;3612798;2860;47;0;1
FR;3;2022-01-26;0;77;0;0;77;0;0;0;0;4416862;3440772;4463;2;3612875;2860;47;0;1
FR;3;2022-01-27;0;52;0;0;52;0;0;0;0;4416862;3440824;4463;2;3612927;2860;47;0;1
FR;3;2022-01-28;0;115;0;0;114;0;0;0;0;4416862;3440939;4463;2;3613041;2860;47;0;1
FR;3;2022-01-29;0;97;0;0;97;0;0;0;0;4416862;3441036;4463;2;3613138;2860;47;0;1
FR;3;2022-01-30;0;50;0;0;50;0;0;0;0;4416862;3441086;4463;2;3613188;2860;47;0;1
FR;3;2022-01-31;0;90;0;0;90;0;0;0;0;4416862;3441176;4463;2;3613278;2860;47;0;1
FR;3;2022-02-01;0;98;0;0;96;1;0;0;0;4416862;3441274;4463;2;3613374;2861;47;0;1
FR;3;2022-02-02;0;85;0;0;83;0;0;0;0;4416862;3441359;4463;2;3613457;2861;47;0;1
FR;3;2022-02-03;0;91;0;0;89;0;0;0;0;4416862;3441450;4463;2;3613546;2861;47;0;1
FR;3;2022-02-04;0;113;0;0;110;0;1;0;0;4416862;3441563;4463;2;3613656;2861;48;0;1
FR;3;2022-02-05;0;68;0;0;68;0;0;0;0;4416862;3441631;4463;2;3613724;2861;48;0;1
FR;3;2022-02-06;0;10;0;0;10;0;0;0;0;4416862;3441641;4463;2;3613734;2861;48;0;1
FR;3;2022-02-07;0;75;0;0;75;0;0;0;0;4416862;3441716;4463;2;3613809;2861;48;0;1
FR;3;2022-02-08;0;0;0;0;0;0;0;0;0;4416862;3441716;4463;2;3613809;2861;48;0;1
FR;3;2022-02-09;0;0;0;0;0;0;0;0;0;4416862;3441716;4463;2;3613809;2861;48;0;1
FR;3;2022-02-10;0;0;0;0;0;0;0;0;0;4416862;3441716;4463;2;3613809;2861;48;0;1
FR;3;2022-02-11;0;0;0;0;0;0;0;0;0;4416862;3441716;4463;2;3613809;2861;48;0;1
FR;3;2022-02-12;0;0;0;0;0;0;0;0;0;4416862;3441716;4463;2;3613809;2861;48;0;1
FR;3;2022-02-13;0;0;0;0;0;0;0;0;0;4416862;3441716;4463;2;3613809;2861;48;0;1
FR;3;2022-02-14;0;0;0;0;0;0;0;0;0;4416862;3441716;4463;2;3613809;2861;48;0;1
FR;3;2022-02-15;0;0;0;0;0;0;0;0;0;4416862;3441716;4463;2;3613809;2861;48;0;1
FR;3;2022-02-16;0;0;0;0;0;0;0;0;0;4416862;3441716;4463;2;3613809;2861;48;0;1
FR;3;2022-02-17;0;0;0;0;0;0;0;0;0;4416862;3441716;4463;2;3613809;2861;48;0;1
FR;3;2022-02-18;0;0;0;0;0;0;0;0;0;4416862;3441716;4463;2;3613809;2861;48;0;1
FR;3;2022-02-19;0;0;0;0;0;0;0;0;0;4416862;3441716;4463;2;3613809;2861;48;0;1
FR;3;2022-02-20;0;0;0;0;0;0;0;0;0;4416862;3441716;4463;2;3613809;2861;48;0;1
FR;3;2022-02-21;2;0;0;0;0;0;0;0;0;4416864;3441716;4463;2;3613809;2861;48;0;1
FR;3;2022-02-22;0;0;0;0;0;0;0;0;0;4416864;3441716;4463;2;3613809;2861;48;0;1
FR;3;2022-02-23;0;0;0;0;0;0;0;0;0;4416864;3441716;4463;2;3613809;2861;48;0;1
FR;3;2022-02-24;0;0;0;0;0;0;0;0;0;4416864;3441716;4463;2;3613809;2861;48;0;1
FR;3;2022-02-25;0;0;0;0;0;0;0;0;0;4416864;3441716;4463;2;3613809;2861;48;0;1
FR;3;2022-02-26;0;0;0;0;0;0;0;0;0;4416864;3441716;4463;2;3613809;2861;48;0;1
FR;3;2022-02-27;0;0;0;0;0;0;0;0;0;4416864;3441716;4463;2;3613809;2861;48;0;1
FR;3;2022-02-28;1;0;0;0;0;0;0;0;0;4416865;3441716;4463;2;3613809;2861;48;0;1
FR;3;2022-03-01;1;0;0;0;0;0;0;0;0;4416866;3441716;4463;2;3613809;2861;48;0;1
FR;3;2022-03-02;0;0;0;0;0;0;0;0;0;4416866;3441716;4463;2;3613809;2861;48;0;1
FR;3;2022-03-03;0;0;0;0;0;0;0;0;0;4416866;3441716;4463;2;3613809;2861;48;0;1
FR;3;2022-03-04;0;0;0;0;0;0;0;0;0;4416866;3441716;4463;2;3613809;2861;48;0;1
FR;3;2022-03-05;0;0;0;0;0;0;0;0;0;4416866;3441716;4463;2;3613809;2861;48;0;1
FR;3;2022-03-06;1;0;0;0;0;0;0;0;0;4416867;3441716;4463;2;3613809;2861;48;0;1
FR;3;2022-03-07;0;0;0;0;0;0;0;0;0;4416867;3441716;4463;2;3613809;2861;48;0;1
FR;3;2022-03-08;1;0;0;0;0;0;0;0;0;4416868;3441716;4463;2;3613809;2861;48;0;1
FR;3;2022-03-09;0;0;0;0;0;0;0;0;0;4416868;3441716;4463;2;3613809;2861;48;0;1
FR;3;2022-03-10;0;0;0;0;0;0;0;0;0;4416868;3441716;4463;2;3613809;2861;48;0;1
FR;3;2022-03-11;0;0;0;0;0;0;0;0;0;4416868;3441716;4463;2;3613809;2861;48;0;1
FR;3;2022-03-12;0;0;0;0;0;0;0;0;0;4416868;3441716;4463;2;3613809;2861;48;0;1
FR;3;2022-03-13;0;0;0;0;0;0;0;0;0;4416868;3441716;4463;2;3613809;2861;48;0;1
FR;3;2022-03-14;0;0;0;0;0;0;0;0;0;4416868;3441716;4463;2;3613809;2861;48;0;1
FR;3;2022-03-15;0;0;0;0;0;0;0;0;0;4416868;3441716;4463;2;3613809;2861;48;0;1
FR;3;2022-03-16;0;0;0;0;0;0;0;0;0;4416868;3441716;4463;2;3613809;2861;48;0;1
FR;3;2022-03-17;0;0;0;0;0;0;0;0;0;4416868;3441716;4463;2;3613809;2861;48;0;1
FR;3;2022-03-18;0;0;0;0;0;0;0;0;0;4416868;3441716;4463;2;3613809;2861;48;0;1
FR;3;2022-03-19;0;0;0;0;0;0;0;0;0;4416868;3441716;4463;2;3613809;2861;48;0;1
FR;3;2022-03-20;1;0;0;0;0;0;0;0;0;4416869;3441716;4463;2;3613809;2861;48;0;1
FR;3;2022-03-21;0;0;0;0;0;0;0;0;0;4416869;3441716;4463;2;3613809;2861;48;0;1
FR;3;2022-03-22;0;0;0;0;0;0;0;0;0;4416869;3441716;4463;2;3613809;2861;48;0;1
FR;3;2022-03-23;1;0;0;0;0;0;0;0;0;4416870;3441716;4463;2;3613809;2861;48;0;1
FR;3;2022-03-24;0;0;0;0;0;0;0;0;0;4416870;3441716;4463;2;3613809;2861;48;0;1
FR;3;2022-03-25;1;0;0;0;0;0;0;0;0;4416871;3441716;4463;2;3613809;2861;48;0;1
FR;3;2022-03-26;0;0;0;0;0;0;0;0;0;4416871;3441716;4463;2;3613809;2861;48;0;1
FR;3;2022-03-27;0;0;0;0;0;0;0;0;0;4416871;3441716;4463;2;3613809;2861;48;0;1
FR;3;2022-03-28;0;0;0;0;0;0;0;0;0;4416871;3441716;4463;2;3613809;2861;48;0;1
FR;3;2022-03-29;0;0;0;0;0;0;0;0;0;4416871;3441716;4463;2;3613809;2861;48;0;1
FR;3;2022-03-30;0;0;0;0;0;0;0;0;0;4416871;3441716;4463;2;3613809;2861;48;0;1
FR;3;2022-03-31;0;0;0;0;0;0;0;0;0;4416871;3441716;4463;2;3613809;2861;48;0;1
FR;3;2022-04-01;0;0;0;0;0;0;0;0;0;4416871;3441716;4463;2;3613809;2861;48;0;1
FR;3;2022-04-02;0;0;0;0;0;0;0;0;0;4416871;3441716;4463;2;3613809;2861;48;0;1
FR;3;2022-04-03;0;0;0;0;0;0;0;0;0;4416871;3441716;4463;2;3613809;2861;48;0;1
FR;3;2022-04-04;0;0;0;0;0;0;0;0;0;4416871;3441716;4463;2;3613809;2861;48;0;1
FR;3;2022-04-05;0;0;0;0;0;0;0;0;0;4416871;3441716;4463;2;3613809;2861;48;0;1
FR;3;2022-04-06;0;0;0;0;0;0;0;0;0;4416871;3441716;4463;2;3613809;2861;48;0;1
FR;3;2022-04-07;0;0;0;0;0;0;0;0;0;4416871;3441716;4463;2;3613809;2861;48;0;1
FR;3;2022-04-08;0;0;0;0;0;0;0;0;0;4416871;3441716;4463;2;3613809;2861;48;0;1
FR;3;2022-04-09;0;0;0;0;0;0;0;0;0;4416871;3441716;4463;2;3613809;2861;48;0;1
FR;3;2022-04-10;0;0;0;0;0;0;0;0;0;4416871;3441716;4463;2;3613809;2861;48;0;1
FR;3;2022-04-11;0;0;0;0;0;0;0;0;0;4416871;3441716;4463;2;3613809;2861;48;0;1
FR;3;2022-04-12;0;0;0;0;0;0;0;0;0;4416871;3441716;4463;2;3613809;2861;48;0;1
FR;3;2022-04-13;0;0;0;0;0;0;0;0;0;4416871;3441716;4463;2;3613809;2861;48;0;1
FR;3;2022-04-14;0;0;0;0;0;0;0;0;0;4416871;3441716;4463;2;3613809;2861;48;0;1
FR;3;2022-04-15;1;0;0;0;0;0;0;0;0;4416872;3441716;4463;2;3613809;2861;48;0;1
FR;3;2022-04-16;0;0;0;0;0;0;0;0;0;4416872;3441716;4463;2;3613809;2861;48;0;1
FR;3;2022-04-17;0;0;0;0;0;0;0;0;0;4416872;3441716;4463;2;3613809;2861;48;0;1
FR;3;2022-04-18;0;0;0;0;0;0;0;0;0;4416872;3441716;4463;2;3613809;2861;48;0;1
FR;3;2022-04-19;0;0;0;0;0;0;0;0;0;4416872;3441716;4463;2;3613809;2861;48;0;1
FR;3;2022-04-20;0;0;0;0;0;0;0;0;0;4416872;3441716;4463;2;3613809;2861;48;0;1
FR;3;2022-04-21;0;0;0;0;0;0;0;0;0;4416872;3441716;4463;2;3613809;2861;48;0;1
FR;3;2022-04-22;0;0;0;0;0;0;0;0;0;4416872;3441716;4463;2;3613809;2861;48;0;1
FR;3;2022-04-23;0;0;0;0;0;0;0;0;0;4416872;3441716;4463;2;3613809;2861;48;0;1
FR;3;2022-04-24;0;0;0;0;0;0;0;0;0;4416872;3441716;4463;2;3613809;2861;48;0;1
FR;3;2022-04-25;0;0;0;0;0;0;0;0;0;4416872;3441716;4463;2;3613809;2861;48;0;1
FR;3;2022-04-26;0;0;0;0;0;0;0;0;0;4416872;3441716;4463;2;3613809;2861;48;0;1
FR;3;2022-04-27;0;0;0;0;0;0;0;0;0;4416872;3441716;4463;2;3613809;2861;48;0;1
FR;3;2022-04-28;0;0;0;0;0;0;0;0;0;4416872;3441716;4463;2;3613809;2861;48;0;1
FR;3;2022-04-29;0;0;0;0;0;0;0;0;0;4416872;3441716;4463;2;3613809;2861;48;0;1
FR;3;2022-04-30;0;0;0;0;0;0;0;0;0;4416872;3441716;4463;2;3613809;2861;48;0;1
FR;3;2022-05-01;0;0;0;0;0;0;0;0;0;4416872;3441716;4463;2;3613809;2861;48;0;1
FR;3;2022-05-02;0;0;0;0;0;0;0;0;0;4416872;3441716;4463;2;3613809;2861;48;0;1
FR;3;2022-05-03;0;0;0;0;0;0;0;0;0;4416872;3441716;4463;2;3613809;2861;48;0;1
FR;3;2022-05-04;0;0;0;0;0;0;0;0;0;4416872;3441716;4463;2;3613809;2861;48;0;1
FR;3;2022-05-05;0;0;0;0;0;0;0;0;0;4416872;3441716;4463;2;3613809;2861;48;0;1
FR;3;2022-05-06;0;0;0;0;0;0;0;0;0;4416872;3441716;4463;2;3613809;2861;48;0;1
FR;3;2022-05-07;0;0;0;0;0;0;0;0;0;4416872;3441716;4463;2;3613809;2861;48;0;1
FR;3;2022-05-08;0;0;0;0;0;0;0;0;0;4416872;3441716;4463;2;3613809;2861;48;0;1
FR;3;2022-05-09;0;0;0;0;0;0;0;0;0;4416872;3441716;4463;2;3613809;2861;48;0;1
FR;3;2022-05-10;0;0;0;0;0;0;0;0;0;4416872;3441716;4463;2;3613809;2861;48;0;1
FR;3;2022-05-11;0;0;0;0;0;0;0;0;0;4416872;3441716;4463;2;3613809;2861;48;0;1
FR;3;2022-05-12;0;0;0;0;0;0;0;0;0;4416872;3441716;4463;2;3613809;2861;48;0;1
FR;3;2022-05-13;0;0;0;0;0;0;0;0;0;4416872;3441716;4463;2;3613809;2861;48;0;1
FR;3;2022-05-14;1;0;0;0;0;0;0;0;0;4416873;3441716;4463;2;3613809;2861;48;0;1
FR;3;2022-05-15;0;0;0;0;0;0;0;0;0;4416873;3441716;4463;2;3613809;2861;48;0;1
FR;3;2022-05-16;0;0;0;0;0;0;0;0;0;4416873;3441716;4463;2;3613809;2861;48;0;1
FR;3;2022-05-17;0;0;0;0;0;0;0;0;0;4416873;3441716;4463;2;3613809;2861;48;0;1
FR;3;2022-05-18;0;0;0;0;0;0;0;0;0;4416873;3441716;4463;2;3613809;2861;48;0;1
FR;3;2022-05-19;0;0;0;0;0;0;0;0;0;4416873;3441716;4463;2;3613809;2861;48;0;1
FR;3;2022-05-20;0;0;0;0;0;0;0;0;0;4416873;3441716;4463;2;3613809;2861;48;0;1
FR;3;2022-05-21;0;0;0;0;0;0;0;0;0;4416873;3441716;4463;2;3613809;2861;48;0;1
FR;3;2022-05-22;0;0;0;0;0;0;0;0;0;4416873;3441716;4463;2;3613809;2861;48;0;1
FR;3;2022-05-23;0;0;0;0;0;0;0;0;0;4416873;3441716;4463;2;3613809;2861;48;0;1
FR;3;2022-05-24;0;0;0;0;0;0;0;0;0;4416873;3441716;4463;2;3613809;2861;48;0;1
FR;3;2022-05-25;0;0;0;0;0;0;0;0;0;4416873;3441716;4463;2;3613809;2861;48;0;1
FR;3;2022-05-26;0;0;0;0;0;0;0;0;0;4416873;3441716;4463;2;3613809;2861;48;0;1
FR;3;2022-05-27;0;0;0;0;0;0;0;0;0;4416873;3441716;4463;2;3613809;2861;48;0;1
FR;3;2022-05-28;0;0;0;0;0;0;0;0;0;4416873;3441716;4463;2;3613809;2861;48;0;1
FR;3;2022-05-29;0;0;0;0;0;0;0;0;0;4416873;3441716;4463;2;3613809;2861;48;0;1
FR;3;2022-05-30;0;0;0;0;0;0;0;0;0;4416873;3441716;4463;2;3613809;2861;48;0;1
FR;3;2022-05-31;0;0;0;0;0;0;0;0;0;4416873;3441716;4463;2;3613809;2861;48;0;1
FR;3;2022-06-01;0;0;0;0;0;0;0;0;0;4416873;3441716;4463;2;3613809;2861;48;0;1
FR;3;2022-06-02;0;0;0;0;0;0;0;0;0;4416873;3441716;4463;2;3613809;2861;48;0;1
FR;3;2022-06-03;0;0;0;0;0;0;0;0;0;4416873;3441716;4463;2;3613809;2861;48;0;1
FR;3;2022-06-04;0;0;0;0;0;0;0;0;0;4416873;3441716;4463;2;3613809;2861;48;0;1
FR;3;2022-06-05;0;0;0;0;0;0;0;0;0;4416873;3441716;4463;2;3613809;2861;48;0;1
FR;3;2022-06-06;0;0;0;0;0;0;0;0;0;4416873;3441716;4463;2;3613809;2861;48;0;1
FR;3;2022-06-07;0;0;0;0;0;0;0;0;0;4416873;3441716;4463;2;3613809;2861;48;0;1
FR;3;2022-06-08;0;0;0;0;0;0;0;0;0;4416873;3441716;4463;2;3613809;2861;48;0;1
FR;3;2022-06-09;0;0;0;0;0;0;0;0;0;4416873;3441716;4463;2;3613809;2861;48;0;1
FR;3;2022-06-10;0;0;0;0;0;0;0;0;0;4416873;3441716;4463;2;3613809;2861;48;0;1
FR;3;2022-06-11;0;0;0;0;0;0;0;0;0;4416873;3441716;4463;2;3613809;2861;48;0;1
FR;3;2022-06-12;0;0;0;0;0;0;0;0;0;4416873;3441716;4463;2;3613809;2861;48;0;1
FR;3;2022-06-13;1;0;0;0;0;0;0;0;0;4416874;3441716;4463;2;3613809;2861;48;0;1
FR;3;2022-06-14;0;0;0;0;0;0;0;0;0;4416874;3441716;4463;2;3613809;2861;48;0;1
FR;3;2022-06-15;0;0;0;0;0;0;0;0;0;4416874;3441716;4463;2;3613809;2861;48;0;1
FR;3;2022-06-16;0;0;0;0;0;0;0;0;0;4416874;3441716;4463;2;3613809;2861;48;0;1
FR;3;2022-06-17;0;0;0;0;0;0;0;0;0;4416874;3441716;4463;2;3613809;2861;48;0;1
FR;3;2022-06-18;0;0;0;0;0;0;0;0;0;4416874;3441716;4463;2;3613809;2861;48;0;1
FR;3;2022-06-19;0;0;0;0;0;0;0;0;0;4416874;3441716;4463;2;3613809;2861;48;0;1
FR;3;2022-06-20;0;0;0;0;0;0;0;0;0;4416874;3441716;4463;2;3613809;2861;48;0;1
FR;3;2022-06-21;0;0;0;0;0;0;0;0;0;4416874;3441716;4463;2;3613809;2861;48;0;1
FR;3;2022-06-22;0;0;0;0;0;0;0;0;0;4416874;3441716;4463;2;3613809;2861;48;0;1
FR;3;2022-06-23;0;0;0;0;0;0;0;0;0;4416874;3441716;4463;2;3613809;2861;48;0;1
FR;3;2022-06-24;0;0;0;0;0;0;0;0;0;4416874;3441716;4463;2;3613809;2861;48;0;1
FR;3;2022-06-25;0;0;0;0;0;0;0;0;0;4416874;3441716;4463;2;3613809;2861;48;0;1
FR;3;2022-06-26;0;0;0;0;0;0;0;0;0;4416874;3441716;4463;2;3613809;2861;48;0;1
FR;3;2022-06-27;0;0;0;0;0;0;0;0;0;4416874;3441716;4463;2;3613809;2861;48;0;1
FR;3;2022-06-28;0;0;0;0;0;0;0;0;0;4416874;3441716;4463;2;3613809;2861;48;0;1
FR;3;2022-06-29;1;0;0;0;0;0;0;0;0;4416875;3441716;4463;2;3613809;2861;48;0;1
FR;3;2022-06-30;0;0;0;0;0;0;0;0;0;4416875;3441716;4463;2;3613809;2861;48;0;1
FR;3;2022-07-01;0;0;0;0;0;0;0;0;0;4416875;3441716;4463;2;3613809;2861;48;0;1
FR;3;2022-07-02;0;0;0;0;0;0;0;0;0;4416875;3441716;4463;2;3613809;2861;48;0;1
FR;3;2022-07-03;0;0;0;0;0;0;0;0;0;4416875;3441716;4463;2;3613809;2861;48;0;1
FR;3;2022-07-04;0;0;0;0;0;0;0;0;0;4416875;3441716;4463;2;3613809;2861;48;0;1
FR;3;2022-07-05;0;0;0;0;0;0;0;0;0;4416875;3441716;4463;2;3613809;2861;48;0;1
FR;3;2022-07-06;0;0;0;0;0;0;0;0;0;4416875;3441716;4463;2;3613809;2861;48;0;1
FR;3;2022-07-07;0;0;0;0;0;0;0;0;0;4416875;3441716;4463;2;3613809;2861;48;0;1
FR;3;2022-07-08;0;0;0;0;0;0;0;0;0;4416875;3441716;4463;2;3613809;2861;48;0;1
FR;3;2022-07-09;0;0;0;0;0;0;0;0;0;4416875;3441716;4463;2;3613809;2861;48;0;1
FR;3;2022-07-10;0;0;0;0;0;0;0;0;0;4416875;3441716;4463;2;3613809;2861;48;0;1
FR;3;2022-07-11;0;0;0;0;0;0;0;0;0;4416875;3441716;4463;2;3613809;2861;48;0;1
FR;3;2022-07-12;0;0;0;0;0;0;0;0;0;4416875;3441716;4463;2;3613809;2861;48;0;1
FR;3;2022-07-13;0;0;0;0;0;0;0;0;0;4416875;3441716;4463;2;3613809;2861;48;0;1
FR;3;2022-07-14;0;0;0;0;0;0;0;0;0;4416875;3441716;4463;2;3613809;2861;48;0;1
FR;3;2022-07-15;0;0;0;0;0;0;0;0;0;4416875;3441716;4463;2;3613809;2861;48;0;1
FR;3;2022-07-16;0;0;0;0;0;0;0;0;0;4416875;3441716;4463;2;3613809;2861;48;0;1
FR;3;2022-07-17;0;0;0;0;0;0;0;0;0;4416875;3441716;4463;2;3613809;2861;48;0;1
FR;3;2022-07-18;0;0;0;0;0;0;0;0;0;4416875;3441716;4463;2;3613809;2861;48;0;1
FR;3;2022-07-19;0;0;0;0;0;0;0;0;0;4416875;3441716;4463;2;3613809;2861;48;0;1
FR;3;2022-07-20;0;0;0;0;0;0;0;0;0;4416875;3441716;4463;2;3613809;2861;48;0;1
FR;3;2022-07-21;0;0;0;0;0;0;0;0;0;4416875;3441716;4463;2;3613809;2861;48;0;1
FR;3;2022-07-22;0;0;0;0;0;0;0;0;0;4416875;3441716;4463;2;3613809;2861;48;0;1
FR;3;2022-07-23;0;0;0;0;0;0;0;0;0;4416875;3441716;4463;2;3613809;2861;48;0;1
FR;3;2022-07-24;0;0;0;0;0;0;0;0;0;4416875;3441716;4463;2;3613809;2861;48;0;1
FR;3;2022-07-25;0;0;0;0;0;0;0;0;0;4416875;3441716;4463;2;3613809;2861;48;0;1
FR;3;2022-07-26;0;0;0;0;0;0;0;0;0;4416875;3441716;4463;2;3613809;2861;48;0;1
FR;3;2022-07-27;0;0;0;0;0;0;0;0;0;4416875;3441716;4463;2;3613809;2861;48;0;1
FR;3;2022-07-28;0;0;0;0;0;0;0;0;0;4416875;3441716;4463;2;3613809;2861;48;0;1
FR;3;2022-07-29;0;0;0;0;0;0;0;0;0;4416875;3441716;4463;2;3613809;2861;48;0;1
FR;3;2022-07-30;0;0;0;0;0;0;0;0;0;4416875;3441716;4463;2;3613809;2861;48;0;1
FR;3;2022-07-31;0;0;0;0;0;0;0;0;0;4416875;3441716;4463;2;3613809;2861;48;0;1
FR;3;2022-08-01;0;0;0;0;0;0;0;0;0;4416875;3441716;4463;2;3613809;2861;48;0;1
FR;3;2022-08-02;0;0;0;0;0;0;0;0;0;4416875;3441716;4463;2;3613809;2861;48;0;1
FR;3;2022-08-03;0;0;0;0;0;0;0;0;0;4416875;3441716;4463;2;3613809;2861;48;0;1
FR;3;2022-08-04;0;0;0;0;0;0;0;0;0;4416875;3441716;4463;2;3613809;2861;48;0;1
FR;3;2022-08-05;0;0;0;0;0;0;0;0;0;4416875;3441716;4463;2;3613809;2861;48;0;1
FR;3;2022-08-06;0;0;0;0;0;0;0;0;0;4416875;3441716;4463;2;3613809;2861;48;0;1
FR;3;2022-08-07;0;0;0;0;0;0;0;0;0;4416875;3441716;4463;2;3613809;2861;48;0;1
FR;3;2022-08-08;0;0;0;0;0;0;0;0;0;4416875;3441716;4463;2;3613809;2861;48;0;1
FR;3;2022-08-09;0;0;0;0;0;0;0;0;0;4416875;3441716;4463;2;3613809;2861;48;0;1
FR;3;2022-08-10;0;0;0;0;0;0;0;0;0;4416875;3441716;4463;2;3613809;2861;48;0;1
FR;3;2022-08-11;0;0;0;0;0;0;0;0;0;4416875;3441716;4463;2;3613809;2861;48;0;1
FR;3;2022-08-12;0;0;0;0;0;0;0;0;0;4416875;3441716;4463;2;3613809;2861;48;0;1
FR;3;2022-08-13;0;0;0;0;0;0;0;0;0;4416875;3441716;4463;2;3613809;2861;48;0;1
FR;3;2022-08-14;0;0;0;0;0;0;0;0;0;4416875;3441716;4463;2;3613809;2861;48;0;1
FR;3;2022-08-15;0;0;0;0;0;0;0;0;0;4416875;3441716;4463;2;3613809;2861;48;0;1
FR;3;2022-08-16;0;0;0;0;0;0;0;0;0;4416875;3441716;4463;2;3613809;2861;48;0;1
FR;3;2022-08-17;0;0;0;0;0;0;0;0;0;4416875;3441716;4463;2;3613809;2861;48;0;1
FR;3;2022-08-18;0;0;0;0;0;0;0;0;0;4416875;3441716;4463;2;3613809;2861;48;0;1
FR;3;2022-08-19;0;0;0;0;0;0;0;0;0;4416875;3441716;4463;2;3613809;2861;48;0;1
FR;3;2022-08-20;0;0;0;0;0;0;0;0;0;4416875;3441716;4463;2;3613809;2861;48;0;1
FR;3;2022-08-21;0;0;0;0;0;0;0;0;0;4416875;3441716;4463;2;3613809;2861;48;0;1
FR;3;2022-08-22;0;0;0;0;0;0;0;0;0;4416875;3441716;4463;2;3613809;2861;48;0;1
FR;3;2022-08-23;0;0;0;0;0;0;0;0;0;4416875;3441716;4463;2;3613809;2861;48;0;1
FR;3;2022-08-24;0;0;0;0;0;0;0;0;0;4416875;3441716;4463;2;3613809;2861;48;0;1
FR;3;2022-08-25;0;0;0;0;0;0;0;0;0;4416875;3441716;4463;2;3613809;2861;48;0;1
FR;3;2022-08-26;0;0;0;0;0;0;0;0;0;4416875;3441716;4463;2;3613809;2861;48;0;1
FR;3;2022-08-27;0;0;0;0;0;0;0;0;0;4416875;3441716;4463;2;3613809;2861;48;0;1
FR;3;2022-08-28;0;0;0;0;0;0;0;0;0;4416875;3441716;4463;2;3613809;2861;48;0;1
FR;3;2022-08-29;0;0;0;0;0;0;0;0;0;4416875;3441716;4463;2;3613809;2861;48;0;1
FR;3;2022-08-30;0;0;0;0;0;0;0;0;0;4416875;3441716;4463;2;3613809;2861;48;0;1
FR;3;2022-08-31;0;0;0;0;0;0;0;0;0;4416875;3441716;4463;2;3613809;2861;48;0;1
FR;3;2022-09-01;0;0;0;0;0;0;0;0;0;4416875;3441716;4463;2;3613809;2861;48;0;1
FR;3;2022-09-02;0;0;0;0;0;0;0;0;0;4416875;3441716;4463;2;3613809;2861;48;0;1
FR;3;2022-09-03;0;0;0;0;0;0;0;0;0;4416875;3441716;4463;2;3613809;2861;48;0;1
FR;3;2022-09-04;0;0;0;0;0;0;0;0;0;4416875;3441716;4463;2;3613809;2861;48;0;1
FR;3;2022-09-05;0;0;0;0;0;0;0;0;0;4416875;3441716;4463;2;3613809;2861;48;0;1
FR;3;2022-09-06;0;0;0;0;0;0;0;0;0;4416875;3441716;4463;2;3613809;2861;48;0;1
FR;3;2022-09-07;0;0;0;0;0;0;0;0;0;4416875;3441716;4463;2;3613809;2861;48;0;1
FR;3;2022-09-08;0;0;0;0;0;0;0;0;0;4416875;3441716;4463;2;3613809;2861;48;0;1
FR;3;2022-09-09;0;0;0;0;0;0;0;0;0;4416875;3441716;4463;2;3613809;2861;48;0;1
FR;3;2022-09-10;0;0;0;0;0;0;0;0;0;4416875;3441716;4463;2;3613809;2861;48;0;1
FR;3;2022-09-11;0;0;0;0;0;0;0;0;0;4416875;3441716;4463;2;3613809;2861;48;0;1
FR;3;2022-09-12;0;0;0;0;0;0;0;0;0;4416875;3441716;4463;2;3613809;2861;48;0;1
FR;3;2022-09-13;0;0;0;0;0;0;0;0;0;4416875;3441716;4463;2;3613809;2861;48;0;1
FR;3;2022-09-14;0;0;0;0;0;0;0;0;0;4416875;3441716;4463;2;3613809;2861;48;0;1
FR;3;2022-09-15;0;0;0;0;0;0;0;0;0;4416875;3441716;4463;2;3613809;2861;48;0;1
FR;3;2022-09-16;0;0;0;0;0;0;0;0;0;4416875;3441716;4463;2;3613809;2861;48;0;1
FR;3;2022-09-17;0;0;0;0;0;0;0;0;0;4416875;3441716;4463;2;3613809;2861;48;0;1
FR;3;2022-09-18;0;0;0;0;0;0;0;0;0;4416875;3441716;4463;2;3613809;2861;48;0;1
FR;3;2022-09-19;0;0;0;0;0;0;0;0;0;4416875;3441716;4463;2;3613809;2861;48;0;1
FR;3;2022-09-20;0;0;0;0;0;0;0;0;0;4416875;3441716;4463;2;3613809;2861;48;0;1
FR;3;2022-09-21;0;0;0;0;0;0;0;0;0;4416875;3441716;4463;2;3613809;2861;48;0;1
FR;3;2022-09-22;0;0;0;0;0;0;0;0;0;4416875;3441716;4463;2;3613809;2861;48;0;1
FR;3;2022-09-23;0;0;0;0;0;0;0;0;0;4416875;3441716;4463;2;3613809;2861;48;0;1
FR;3;2022-09-24;0;0;0;0;0;0;0;0;0;4416875;3441716;4463;2;3613809;2861;48;0;1
FR;3;2022-09-25;0;0;0;0;0;0;0;0;0;4416875;3441716;4463;2;3613809;2861;48;0;1
FR;3;2022-09-26;0;0;0;0;0;0;0;0;0;4416875;3441716;4463;2;3613809;2861;48;0;1
FR;3;2022-09-27;0;0;0;0;0;0;0;0;0;4416875;3441716;4463;2;3613809;2861;48;0;1
FR;3;2022-09-28;0;0;0;0;0;0;0;0;0;4416875;3441716;4463;2;3613809;2861;48;0;1
FR;3;2022-09-29;0;0;0;0;0;0;0;0;0;4416875;3441716;4463;2;3613809;2861;48;0;1
FR;3;2022-09-30;0;0;0;0;0;0;0;0;0;4416875;3441716;4463;2;3613809;2861;48;0;1
FR;3;2022-10-01;0;0;0;0;0;0;0;0;0;4416875;3441716;4463;2;3613809;2861;48;0;1
FR;3;2022-10-02;0;0;0;0;0;0;0;0;0;4416875;3441716;4463;2;3613809;2861;48;0;1
FR;3;2022-10-03;0;0;0;0;0;0;0;0;0;4416875;3441716;4463;2;3613809;2861;48;0;1
FR;3;2022-10-04;0;0;0;0;0;0;0;0;0;4416875;3441716;4463;2;3613809;2861;48;0;1
FR;3;2022-10-05;0;0;0;0;0;0;0;0;0;4416875;3441716;4463;2;3613809;2861;48;0;1
FR;3;2022-10-06;0;0;0;0;0;0;0;0;0;4416875;3441716;4463;2;3613809;2861;48;0;1
FR;3;2022-10-07;0;0;0;0;0;0;0;0;0;4416875;3441716;4463;2;3613809;2861;48;0;1
FR;3;2022-10-08;0;0;0;0;0;0;0;0;0;4416875;3441716;4463;2;3613809;2861;48;0;1
FR;3;2022-10-09;0;0;0;0;0;0;0;0;0;4416875;3441716;4463;2;3613809;2861;48;0;1
FR;3;2022-10-10;0;0;0;0;0;0;0;0;0;4416875;3441716;4463;2;3613809;2861;48;0;1
FR;3;2022-10-11;0;0;0;0;0;0;0;0;0;4416875;3441716;4463;2;3613809;2861;48;0;1
FR;3;2022-10-12;0;0;0;0;0;0;0;0;0;4416875;3441716;4463;2;3613809;2861;48;0;1
FR;3;2022-10-13;0;0;0;0;0;0;0;0;0;4416875;3441716;4463;2;3613809;2861;48;0;1
FR;3;2022-10-14;0;0;0;0;0;0;0;0;0;4416875;3441716;4463;2;3613809;2861;48;0;1
FR;3;2022-10-15;0;0;0;0;0;0;0;0;0;4416875;3441716;4463;2;3613809;2861;48;0;1
FR;3;2022-10-16;0;0;0;0;0;0;0;0;0;4416875;3441716;4463;2;3613809;2861;48;0;1
FR;3;2022-10-17;0;0;0;0;0;0;0;0;0;4416875;3441716;4463;2;3613809;2861;48;0;1
FR;3;2022-10-18;0;0;0;0;0;0;0;0;0;4416875;3441716;4463;2;3613809;2861;48;0;1
FR;3;2022-10-19;0;0;0;0;0;0;0;0;0;4416875;3441716;4463;2;3613809;2861;48;0;1
FR;3;2022-10-20;0;0;0;0;0;0;0;0;0;4416875;3441716;4463;2;3613809;2861;48;0;1
FR;3;2022-10-21;0;0;0;0;0;0;0;0;0;4416875;3441716;4463;2;3613809;2861;48;0;1
FR;3;2022-10-22;0;0;0;0;0;0;0;0;0;4416875;3441716;4463;2;3613809;2861;48;0;1
FR;3;2022-10-23;0;0;0;0;0;0;0;0;0;4416875;3441716;4463;2;3613809;2861;48;0;1
FR;3;2022-10-24;0;0;0;0;0;0;0;0;0;4416875;3441716;4463;2;3613809;2861;48;0;1
FR;3;2022-10-25;0;0;0;0;0;0;0;0;0;4416875;3441716;4463;2;3613809;2861;48;0;1
FR;3;2022-10-26;0;0;0;0;0;0;0;0;0;4416875;3441716;4463;2;3613809;2861;48;0;1
FR;3;2022-10-27;0;0;0;0;0;0;0;0;0;4416875;3441716;4463;2;3613809;2861;48;0;1
FR;3;2022-10-28;0;0;0;0;0;0;0;0;0;4416875;3441716;4463;2;3613809;2861;48;0;1
FR;3;2022-10-29;0;0;0;0;0;0;0;0;0;4416875;3441716;4463;2;3613809;2861;48;0;1
FR;3;2022-10-30;0;0;0;0;0;0;0;0;0;4416875;3441716;4463;2;3613809;2861;48;0;1
FR;3;2022-10-31;0;0;0;0;0;0;0;0;0;4416875;3441716;4463;2;3613809;2861;48;0;1
FR;3;2022-11-01;0;0;0;0;0;0;0;0;0;4416875;3441716;4463;2;3613809;2861;48;0;1
FR;3;2022-11-02;0;0;0;0;0;0;0;0;0;4416875;3441716;4463;2;3613809;2861;48;0;1
FR;3;2022-11-03;0;0;0;0;0;0;0;0;0;4416875;3441716;4463;2;3613809;2861;48;0;1
FR;3;2022-11-04;0;0;0;0;0;0;0;0;0;4416875;3441716;4463;2;3613809;2861;48;0;1
FR;3;2022-11-05;0;0;0;0;0;0;0;0;0;4416875;3441716;4463;2;3613809;2861;48;0;1
FR;3;2022-11-06;0;0;0;0;0;0;0;0;0;4416875;3441716;4463;2;3613809;2861;48;0;1
FR;3;2022-11-07;0;0;0;0;0;0;0;0;0;4416875;3441716;4463;2;3613809;2861;48;0;1
FR;3;2022-11-08;1;0;0;0;0;0;0;0;0;4416876;3441716;4463;2;3613809;2861;48;0;1
FR;3;2022-11-09;0;0;0;0;0;0;0;0;0;4416876;3441716;4463;2;3613809;2861;48;0;1
FR;3;2022-11-10;0;0;0;0;0;0;0;0;0;4416876;3441716;4463;2;3613809;2861;48;0;1
FR;3;2022-11-11;0;0;0;0;0;0;0;0;0;4416876;3441716;4463;2;3613809;2861;48;0;1
FR;3;2022-11-12;0;0;0;0;0;0;0;0;0;4416876;3441716;4463;2;3613809;2861;48;0;1
FR;3;2022-11-13;0;0;0;0;0;0;0;0;0;4416876;3441716;4463;2;3613809;2861;48;0;1
FR;3;2022-11-14;0;0;0;0;0;0;0;0;0;4416876;3441716;4463;2;3613809;2861;48;0;1
FR;3;2022-11-15;0;0;0;0;0;0;0;0;0;4416876;3441716;4463;2;3613809;2861;48;0;1
FR;3;2022-11-16;0;0;0;0;0;0;0;0;0;4416876;3441716;4463;2;3613809;2861;48;0;1
FR;3;2022-11-17;0;0;0;0;0;0;0;0;0;4416876;3441716;4463;2;3613809;2861;48;0;1
FR;3;2022-11-18;0;0;0;0;0;0;0;0;0;4416876;3441716;4463;2;3613809;2861;48;0;1
FR;3;2022-11-19;0;0;0;0;0;0;0;0;0;4416876;3441716;4463;2;3613809;2861;48;0;1
FR;3;2022-11-20;0;0;0;0;0;0;0;0;0;4416876;3441716;4463;2;3613809;2861;48;0;1
FR;3;2022-11-21;0;0;0;0;0;0;0;0;0;4416876;3441716;4463;2;3613809;2861;48;0;1
FR;3;2022-11-22;0;0;0;0;0;0;0;0;0;4416876;3441716;4463;2;3613809;2861;48;0;1
FR;3;2022-11-23;0;0;0;0;0;0;0;0;0;4416876;3441716;4463;2;3613809;2861;48;0;1
FR;3;2022-11-24;0;0;0;0;0;0;0;0;0;4416876;3441716;4463;2;3613809;2861;48;0;1
FR;3;2022-11-25;0;0;0;0;0;0;0;0;0;4416876;3441716;4463;2;3613809;2861;48;0;1
FR;3;2022-11-26;0;0;0;0;0;0;0;0;0;4416876;3441716;4463;2;3613809;2861;48;0;1
FR;3;2022-11-27;0;0;0;0;0;0;0;0;0;4416876;3441716;4463;2;3613809;2861;48;0;1
FR;3;2022-11-28;0;0;0;0;0;0;0;0;0;4416876;3441716;4463;2;3613809;2861;48;0;1
FR;3;2022-11-29;0;0;0;0;0;0;0;0;0;4416876;3441716;4463;2;3613809;2861;48;0;1
FR;3;2022-11-30;0;0;0;0;0;0;0;0;0;4416876;3441716;4463;2;3613809;2861;48;0;1
FR;3;2022-12-01;0;0;0;0;0;0;0;0;0;4416876;3441716;4463;2;3613809;2861;48;0;1
FR;3;2022-12-02;0;0;0;0;0;0;0;0;0;4416876;3441716;4463;2;3613809;2861;48;0;1
FR;3;2022-12-03;0;0;0;0;0;0;0;0;0;4416876;3441716;4463;2;3613809;2861;48;0;1
FR;3;2022-12-04;0;0;0;0;0;0;0;0;0;4416876;3441716;4463;2;3613809;2861;48;0;1
FR;3;2022-12-05;0;0;0;0;0;0;0;0;0;4416876;3441716;4463;2;3613809;2861;48;0;1
FR;3;2022-12-06;0;0;0;0;0;0;0;0;0;4416876;3441716;4463;2;3613809;2861;48;0;1
FR;3;2022-12-07;0;0;0;0;0;0;0;0;0;4416876;3441716;4463;2;3613809;2861;48;0;1
FR;3;2022-12-08;0;0;0;0;0;0;0;0;0;4416876;3441716;4463;2;3613809;2861;48;0;1
FR;3;2022-12-09;0;0;0;0;0;0;0;0;0;4416876;3441716;4463;2;3613809;2861;48;0;1
FR;3;2022-12-10;0;0;0;0;0;0;0;0;0;4416876;3441716;4463;2;3613809;2861;48;0;1
FR;3;2022-12-11;0;0;0;0;0;0;0;0;0;4416876;3441716;4463;2;3613809;2861;48;0;1
FR;3;2022-12-12;0;0;0;0;0;0;0;0;0;4416876;3441716;4463;2;3613809;2861;48;0;1
FR;3;2022-12-13;0;0;0;0;0;0;0;0;0;4416876;3441716;4463;2;3613809;2861;48;0;1
FR;3;2022-12-14;0;0;0;0;0;0;0;0;0;4416876;3441716;4463;2;3613809;2861;48;0;1
FR;3;2022-12-15;0;0;0;0;0;0;0;0;0;4416876;3441716;4463;2;3613809;2861;48;0;1
FR;3;2022-12-16;0;0;0;0;0;0;0;0;0;4416876;3441716;4463;2;3613809;2861;48;0;1
FR;3;2022-12-17;0;0;0;0;0;0;0;0;0;4416876;3441716;4463;2;3613809;2861;48;0;1
FR;3;2022-12-18;0;0;0;0;0;0;0;0;0;4416876;3441716;4463;2;3613809;2861;48;0;1
FR;3;2022-12-19;0;0;0;0;0;0;0;0;0;4416876;3441716;4463;2;3613809;2861;48;0;1
FR;3;2022-12-20;0;0;0;0;0;0;0;0;0;4416876;3441716;4463;2;3613809;2861;48;0;1
FR;3;2022-12-21;0;0;0;0;0;0;0;0;0;4416876;3441716;4463;2;3613809;2861;48;0;1
FR;3;2022-12-22;0;0;0;0;0;0;0;0;0;4416876;3441716;4463;2;3613809;2861;48;0;1
FR;3;2022-12-23;0;0;0;0;0;0;0;0;0;4416876;3441716;4463;2;3613809;2861;48;0;1
FR;3;2022-12-24;0;0;0;0;0;0;0;0;0;4416876;3441716;4463;2;3613809;2861;48;0;1
FR;3;2022-12-25;0;0;0;0;0;0;0;0;0;4416876;3441716;4463;2;3613809;2861;48;0;1
FR;3;2022-12-26;0;0;0;0;0;0;0;0;0;4416876;3441716;4463;2;3613809;2861;48;0;1
FR;3;2022-12-27;0;0;0;0;0;0;0;0;0;4416876;3441716;4463;2;3613809;2861;48;0;1
FR;3;2022-12-28;0;0;0;0;0;0;0;0;0;4416876;3441716;4463;2;3613809;2861;48;0;1
FR;3;2022-12-29;0;0;0;0;0;0;0;0;0;4416876;3441716;4463;2;3613809;2861;48;0;1
FR;3;2022-12-30;0;0;0;0;0;0;0;0;0;4416876;3441716;4463;2;3613809;2861;48;0;1
FR;3;2022-12-31;0;0;0;0;0;0;0;0;0;4416876;3441716;4463;2;3613809;2861;48;0;1
FR;3;2023-01-01;0;0;0;0;0;0;0;0;0;4416876;3441716;4463;2;3613809;2861;48;0;1
FR;3;2023-01-02;0;0;0;0;0;0;0;0;0;4416876;3441716;4463;2;3613809;2861;48;0;1
FR;3;2023-01-03;0;0;0;0;0;0;0;0;0;4416876;3441716;4463;2;3613809;2861;48;0;1
FR;3;2023-01-04;0;0;0;0;0;0;0;0;0;4416876;3441716;4463;2;3613809;2861;48;0;1
FR;3;2023-01-05;0;0;0;0;0;0;0;0;0;4416876;3441716;4463;2;3613809;2861;48;0;1
FR;3;2023-01-06;0;0;0;0;0;0;0;0;0;4416876;3441716;4463;2;3613809;2861;48;0;1
FR;3;2023-01-07;0;0;0;0;0;0;0;0;0;4416876;3441716;4463;2;3613809;2861;48;0;1
FR;3;2023-01-08;0;0;0;0;0;0;0;0;0;4416876;3441716;4463;2;3613809;2861;48;0;1
FR;3;2023-01-09;0;0;0;0;0;0;0;0;0;4416876;3441716;4463;2;3613809;2861;48;0;1
FR;3;2023-01-10;0;0;0;0;0;0;0;0;0;4416876;3441716;4463;2;3613809;2861;48;0;1
FR;3;2023-01-11;0;0;0;0;0;0;0;0;0;4416876;3441716;4463;2;3613809;2861;48;0;1
FR;3;2023-01-12;0;0;0;0;0;0;0;0;0;4416876;3441716;4463;2;3613809;2861;48;0;1
FR;3;2023-01-13;0;0;0;0;0;0;0;0;0;4416876;3441716;4463;2;3613809;2861;48;0;1
FR;3;2023-01-14;0;0;0;0;0;0;0;0;0;4416876;3441716;4463;2;3613809;2861;48;0;1
FR;3;2023-01-15;0;0;0;0;0;0;0;0;0;4416876;3441716;4463;2;3613809;2861;48;0;1
FR;3;2023-01-16;0;0;0;0;0;0;0;0;0;4416876;3441716;4463;2;3613809;2861;48;0;1
FR;3;2023-01-17;0;0;0;0;0;0;0;0;0;4416876;3441716;4463;2;3613809;2861;48;0;1
FR;3;2023-01-18;0;0;0;0;0;0;0;0;0;4416876;3441716;4463;2;3613809;2861;48;0;1
FR;3;2023-01-19;0;0;0;0;0;0;0;0;0;4416876;3441716;4463;2;3613809;2861;48;0;1
FR;3;2023-01-20;0;0;0;0;0;0;0;0;0;4416876;3441716;4463;2;3613809;2861;48;0;1
FR;3;2023-01-21;0;0;0;0;0;0;0;0;0;4416876;3441716;4463;2;3613809;2861;48;0;1
FR;3;2023-01-22;0;0;0;0;0;0;0;0;0;4416876;3441716;4463;2;3613809;2861;48;0;1
FR;3;2023-01-23;0;0;0;0;0;0;0;0;0;4416876;3441716;4463;2;3613809;2861;48;0;1
FR;3;2023-01-24;0;0;0;0;0;0;0;0;0;4416876;3441716;4463;2;3613809;2861;48;0;1
FR;3;2023-01-25;1;0;0;0;0;0;0;0;0;4416877;3441716;4463;2;3613809;2861;48;0;1
FR;3;2023-01-26;0;0;0;0;0;0;0;0;0;4416877;3441716;4463;2;3613809;2861;48;0;1
FR;3;2023-01-27;0;0;0;0;0;0;0;0;0;4416877;3441716;4463;2;3613809;2861;48;0;1
FR;3;2023-01-28;0;0;0;0;0;0;0;0;0;4416877;3441716;4463;2;3613809;2861;48;0;1
FR;3;2023-01-29;0;0;0;0;0;0;0;0;0;4416877;3441716;4463;2;3613809;2861;48;0;1
FR;3;2023-01-30;0;0;0;0;0;0;0;0;0;4416877;3441716;4463;2;3613809;2861;48;0;1
FR;3;2023-01-31;0;0;0;0;0;0;0;0;0;4416877;3441716;4463;2;3613809;2861;48;0;1
FR;3;2023-02-01;0;0;0;0;0;0;0;0;0;4416877;3441716;4463;2;3613809;2861;48;0;1
FR;3;2023-02-02;0;0;0;0;0;0;0;0;0;4416877;3441716;4463;2;3613809;2861;48;0;1
FR;3;2023-02-03;0;0;0;0;0;0;0;0;0;4416877;3441716;4463;2;3613809;2861;48;0;1
FR;3;2023-02-04;0;0;0;0;0;0;0;0;0;4416877;3441716;4463;2;3613809;2861;48;0;1
FR;3;2023-02-05;0;0;0;0;0;0;0;0;0;4416877;3441716;4463;2;3613809;2861;48;0;1
FR;3;2023-02-06;0;0;0;0;0;0;0;0;0;4416877;3441716;4463;2;3613809;2861;48;0;1
FR;3;2023-02-07;0;0;0;0;0;0;0;0;0;4416877;3441716;4463;2;3613809;2861;48;0;1
FR;3;2023-02-08;0;0;0;0;0;0;0;0;0;4416877;3441716;4463;2;3613809;2861;48;0;1
FR;3;2023-02-09;0;0;0;0;0;0;0;0;0;4416877;3441716;4463;2;3613809;2861;48;0;1
FR;3;2023-02-10;0;0;0;0;0;0;0;0;0;4416877;3441716;4463;2;3613809;2861;48;0;1
FR;3;2023-02-11;0;0;0;0;0;0;0;0;0;4416877;3441716;4463;2;3613809;2861;48;0;1
FR;3;2023-02-12;0;0;0;0;0;0;0;0;0;4416877;3441716;4463;2;3613809;2861;48;0;1
FR;3;2023-02-13;0;0;0;0;0;0;0;0;0;4416877;3441716;4463;2;3613809;2861;48;0;1
FR;3;2023-02-14;0;0;0;0;0;0;0;0;0;4416877;3441716;4463;2;3613809;2861;48;0;1
FR;3;2023-02-15;0;0;0;0;0;0;0;0;0;4416877;3441716;4463;2;3613809;2861;48;0;1
FR;3;2023-02-16;0;0;0;0;0;0;0;0;0;4416877;3441716;4463;2;3613809;2861;48;0;1
FR;3;2023-02-17;0;0;0;0;0;0;0;0;0;4416877;3441716;4463;2;3613809;2861;48;0;1
FR;3;2023-02-18;0;0;0;0;0;0;0;0;0;4416877;3441716;4463;2;3613809;2861;48;0;1
FR;3;2023-02-19;0;0;0;0;0;0;0;0;0;4416877;3441716;4463;2;3613809;2861;48;0;1
FR;3;2023-02-20;0;0;0;0;0;0;0;0;0;4416877;3441716;4463;2;3613809;2861;48;0;1
FR;3;2023-02-21;0;0;0;0;0;0;0;0;0;4416877;3441716;4463;2;3613809;2861;48;0;1
FR;3;2023-02-22;0;0;0;0;0;0;0;0;0;4416877;3441716;4463;2;3613809;2861;48;0;1
FR;3;2023-02-23;0;0;0;0;0;0;0;0;0;4416877;3441716;4463;2;3613809;2861;48;0;1
FR;3;2023-02-24;0;0;0;0;0;0;0;0;0;4416877;3441716;4463;2;3613809;2861;48;0;1
FR;3;2023-02-25;0;0;0;0;0;0;0;0;0;4416877;3441716;4463;2;3613809;2861;48;0;1
FR;3;2023-02-26;0;0;0;0;0;0;0;0;0;4416877;3441716;4463;2;3613809;2861;48;0;1
FR;3;2023-02-27;0;0;0;0;0;0;0;0;0;4416877;3441716;4463;2;3613809;2861;48;0;1
FR;3;2023-02-28;0;0;0;0;0;0;0;0;0;4416877;3441716;4463;2;3613809;2861;48;0;1
FR;3;2023-03-01;0;0;0;0;0;0;0;0;0;4416877;3441716;4463;2;3613809;2861;48;0;1
FR;3;2023-03-02;0;0;0;0;0;0;0;0;0;4416877;3441716;4463;2;3613809;2861;48;0;1
FR;3;2023-03-03;0;0;0;0;0;0;0;0;0;4416877;3441716;4463;2;3613809;2861;48;0;1
FR;3;2023-03-04;0;0;0;0;0;0;0;0;0;4416877;3441716;4463;2;3613809;2861;48;0;1
FR;3;2023-03-05;0;0;0;0;0;0;0;0;0;4416877;3441716;4463;2;3613809;2861;48;0;1
FR;3;2023-03-06;0;0;0;0;0;0;0;0;0;4416877;3441716;4463;2;3613809;2861;48;0;1
FR;3;2023-03-07;0;0;0;0;0;0;0;0;0;4416877;3441716;4463;2;3613809;2861;48;0;1
FR;3;2023-03-08;0;0;0;0;0;0;0;0;0;4416877;3441716;4463;2;3613809;2861;48;0;1
FR;3;2023-03-09;0;0;0;0;0;0;0;0;0;4416877;3441716;4463;2;3613809;2861;48;0;1
FR;3;2023-03-10;0;0;0;0;0;0;0;0;0;4416877;3441716;4463;2;3613809;2861;48;0;1
FR;3;2023-03-11;0;0;0;0;0;0;0;0;0;4416877;3441716;4463;2;3613809;2861;48;0;1
FR;3;2023-03-12;0;0;0;0;0;0;0;0;0;4416877;3441716;4463;2;3613809;2861;48;0;1
FR;3;2023-03-13;0;0;0;0;0;0;0;0;0;4416877;3441716;4463;2;3613809;2861;48;0;1
FR;3;2023-03-14;0;0;0;0;0;0;0;0;0;4416877;3441716;4463;2;3613809;2861;48;0;1
FR;3;2023-03-15;0;0;0;0;0;0;0;0;0;4416877;3441716;4463;2;3613809;2861;48;0;1
FR;3;2023-03-16;0;0;0;0;0;0;0;0;0;4416877;3441716;4463;2;3613809;2861;48;0;1
FR;3;2023-03-17;0;0;0;0;0;0;0;0;0;4416877;3441716;4463;2;3613809;2861;48;0;1
FR;3;2023-03-18;0;0;0;0;0;0;0;0;0;4416877;3441716;4463;2;3613809;2861;48;0;1
FR;3;2023-03-19;0;0;0;0;0;0;0;0;0;4416877;3441716;4463;2;3613809;2861;48;0;1
FR;3;2023-03-20;0;0;0;0;0;0;0;0;0;4416877;3441716;4463;2;3613809;2861;48;0;1
FR;3;2023-03-21;0;0;0;0;0;0;0;0;0;4416877;3441716;4463;2;3613809;2861;48;0;1
FR;3;2023-03-22;0;0;0;0;0;0;0;0;0;4416877;3441716;4463;2;3613809;2861;48;0;1
FR;3;2023-03-23;0;0;0;0;0;0;0;0;0;4416877;3441716;4463;2;3613809;2861;48;0;1
FR;3;2023-03-24;0;0;0;0;0;0;0;0;0;4416877;3441716;4463;2;3613809;2861;48;0;1
FR;3;2023-03-25;0;0;0;0;0;0;0;0;0;4416877;3441716;4463;2;3613809;2861;48;0;1
FR;3;2023-03-26;0;0;0;0;0;0;0;0;0;4416877;3441716;4463;2;3613809;2861;48;0;1
FR;3;2023-03-27;0;0;0;0;0;0;0;0;0;4416877;3441716;4463;2;3613809;2861;48;0;1
FR;3;2023-03-28;0;0;0;0;0;0;0;0;0;4416877;3441716;4463;2;3613809;2861;48;0;1
FR;3;2023-03-29;0;0;0;0;0;0;0;0;0;4416877;3441716;4463;2;3613809;2861;48;0;1
FR;3;2023-03-30;0;0;0;0;0;0;0;0;0;4416877;3441716;4463;2;3613809;2861;48;0;1
FR;3;2023-03-31;0;0;0;0;0;0;0;0;0;4416877;3441716;4463;2;3613809;2861;48;0;1
FR;3;2023-04-01;0;0;0;0;0;0;0;0;0;4416877;3441716;4463;2;3613809;2861;48;0;1
FR;3;2023-04-02;0;0;0;0;0;0;0;0;0;4416877;3441716;4463;2;3613809;2861;48;0;1
FR;3;2023-04-03;0;0;0;0;0;0;0;0;0;4416877;3441716;4463;2;3613809;2861;48;0;1
FR;3;2023-04-04;0;0;0;0;0;0;0;0;0;4416877;3441716;4463;2;3613809;2861;48;0;1
FR;3;2023-04-05;0;0;0;0;0;0;0;0;0;4416877;3441716;4463;2;3613809;2861;48;0;1
FR;3;2023-04-06;0;0;0;0;0;0;0;0;0;4416877;3441716;4463;2;3613809;2861;48;0;1
FR;3;2023-04-07;0;0;0;0;0;0;0;0;0;4416877;3441716;4463;2;3613809;2861;48;0;1
FR;3;2023-04-08;0;0;0;0;0;0;0;0;0;4416877;3441716;4463;2;3613809;2861;48;0;1
FR;3;2023-04-09;0;0;0;0;0;0;0;0;0;4416877;3441716;4463;2;3613809;2861;48;0;1
FR;3;2023-04-10;0;0;0;0;0;0;0;0;0;4416877;3441716;4463;2;3613809;2861;48;0;1
FR;3;2023-04-11;0;0;0;0;0;0;0;0;0;4416877;3441716;4463;2;3613809;2861;48;0;1
FR;3;2023-04-12;0;0;0;0;0;0;0;0;0;4416877;3441716;4463;2;3613809;2861;48;0;1
FR;3;2023-04-13;0;0;0;0;0;0;0;0;0;4416877;3441716;4463;2;3613809;2861;48;0;1
FR;3;2023-04-14;0;0;0;0;0;0;0;0;0;4416877;3441716;4463;2;3613809;2861;48;0;1
FR;3;2023-04-15;0;0;0;0;0;0;0;0;0;4416877;3441716;4463;2;3613809;2861;48;0;1
FR;3;2023-04-16;0;0;0;0;0;0;0;0;0;4416877;3441716;4463;2;3613809;2861;48;0;1
FR;3;2023-04-17;0;0;0;0;0;0;0;0;0;4416877;3441716;4463;2;3613809;2861;48;0;1
FR;3;2023-04-18;0;0;0;0;0;0;0;0;0;4416877;3441716;4463;2;3613809;2861;48;0;1
FR;3;2023-04-19;0;0;0;0;0;0;0;0;0;4416877;3441716;4463;2;3613809;2861;48;0;1
FR;3;2023-04-20;0;0;0;0;0;0;0;0;0;4416877;3441716;4463;2;3613809;2861;48;0;1
FR;3;2023-04-21;0;0;0;0;0;0;0;0;0;4416877;3441716;4463;2;3613809;2861;48;0;1
FR;3;2023-04-22;0;0;0;0;0;0;0;0;0;4416877;3441716;4463;2;3613809;2861;48;0;1
FR;3;2023-04-23;0;0;0;0;0;0;0;0;0;4416877;3441716;4463;2;3613809;2861;48;0;1
FR;3;2023-04-24;0;0;0;0;0;0;0;0;0;4416877;3441716;4463;2;3613809;2861;48;0;1
FR;3;2023-04-25;0;0;0;0;0;0;0;0;0;4416877;3441716;4463;2;3613809;2861;48;0;1
FR;3;2023-04-26;0;0;0;0;0;0;0;0;0;4416877;3441716;4463;2;3613809;2861;48;0;1
FR;3;2023-04-27;0;0;0;0;0;0;0;0;0;4416877;3441716;4463;2;3613809;2861;48;0;1
FR;3;2023-04-28;0;0;0;0;0;0;0;0;0;4416877;3441716;4463;2;3613809;2861;48;0;1
FR;3;2023-04-29;0;0;0;0;0;0;0;0;0;4416877;3441716;4463;2;3613809;2861;48;0;1
FR;3;2023-04-30;0;0;0;0;0;0;0;0;0;4416877;3441716;4463;2;3613809;2861;48;0;1
FR;3;2023-05-01;0;0;0;0;0;0;0;0;0;4416877;3441716;4463;2;3613809;2861;48;0;1
FR;3;2023-05-02;0;0;0;0;0;0;0;0;0;4416877;3441716;4463;2;3613809;2861;48;0;1
FR;3;2023-05-03;0;0;0;0;0;0;0;0;0;4416877;3441716;4463;2;3613809;2861;48;0;1
FR;3;2023-05-04;0;0;0;0;0;0;0;0;0;4416877;3441716;4463;2;3613809;2861;48;0;1
FR;3;2023-05-05;0;0;0;0;0;0;0;0;0;4416877;3441716;4463;2;3613809;2861;48;0;1
FR;3;2023-05-06;0;0;0;0;0;0;0;0;0;4416877;3441716;4463;2;3613809;2861;48;0;1
FR;3;2023-05-07;0;0;0;0;0;0;0;0;0;4416877;3441716;4463;2;3613809;2861;48;0;1
FR;3;2023-05-08;0;0;0;0;0;0;0;0;0;4416877;3441716;4463;2;3613809;2861;48;0;1
FR;3;2023-05-09;0;0;0;0;0;0;0;0;0;4416877;3441716;4463;2;3613809;2861;48;0;1
FR;3;2023-05-10;0;0;0;0;0;0;0;0;0;4416877;3441716;4463;2;3613809;2861;48;0;1
FR;3;2023-05-11;0;0;0;0;0;0;0;0;0;4416877;3441716;4463;2;3613809;2861;48;0;1
FR;3;2023-05-12;0;0;0;0;0;0;0;0;0;4416877;3441716;4463;2;3613809;2861;48;0;1
FR;3;2023-05-13;0;0;0;0;0;0;0;0;0;4416877;3441716;4463;2;3613809;2861;48;0;1
FR;3;2023-05-14;0;0;0;0;0;0;0;0;0;4416877;3441716;4463;2;3613809;2861;48;0;1
FR;3;2023-05-15;0;0;0;0;0;0;0;0;0;4416877;3441716;4463;2;3613809;2861;48;0;1
FR;3;2023-05-16;0;0;0;0;0;0;0;0;0;4416877;3441716;4463;2;3613809;2861;48;0;1
FR;3;2023-05-17;0;0;0;0;0;0;0;0;0;4416877;3441716;4463;2;3613809;2861;48;0;1
FR;3;2023-05-18;0;0;0;0;0;0;0;0;0;4416877;3441716;4463;2;3613809;2861;48;0;1
FR;3;2023-05-19;0;0;0;0;0;0;0;0;0;4416877;3441716;4463;2;3613809;2861;48;0;1
FR;3;2023-05-20;0;0;0;0;0;0;0;0;0;4416877;3441716;4463;2;3613809;2861;48;0;1
FR;3;2023-05-21;0;0;0;0;0;0;0;0;0;4416877;3441716;4463;2;3613809;2861;48;0;1
FR;3;2023-05-22;0;0;0;0;0;0;0;0;0;4416877;3441716;4463;2;3613809;2861;48;0;1
FR;3;2023-05-23;0;0;0;0;0;0;0;0;0;4416877;3441716;4463;2;3613809;2861;48;0;1
FR;3;2023-05-24;0;0;0;0;0;0;0;0;0;4416877;3441716;4463;2;3613809;2861;48;0;1
FR;3;2023-05-25;0;0;0;0;0;0;0;0;0;4416877;3441716;4463;2;3613809;2861;48;0;1
FR;3;2023-05-26;0;0;0;0;0;0;0;0;0;4416877;3441716;4463;2;3613809;2861;48;0;1
FR;3;2023-05-27;0;0;0;0;0;0;0;0;0;4416877;3441716;4463;2;3613809;2861;48;0;1
FR;3;2023-05-28;0;0;0;0;0;0;0;0;0;4416877;3441716;4463;2;3613809;2861;48;0;1
FR;3;2023-05-29;0;0;0;0;0;0;0;0;0;4416877;3441716;4463;2;3613809;2861;48;0;1
FR;3;2023-05-30;0;0;0;0;0;0;0;0;0;4416877;3441716;4463;2;3613809;2861;48;0;1
FR;3;2023-05-31;0;0;0;0;0;0;0;0;0;4416877;3441716;4463;2;3613809;2861;48;0;1
FR;3;2023-06-01;0;0;0;0;0;0;0;0;0;4416877;3441716;4463;2;3613809;2861;48;0;1
FR;3;2023-06-02;0;0;0;0;0;0;0;0;0;4416877;3441716;4463;2;3613809;2861;48;0;1
FR;3;2023-06-03;0;0;0;0;0;0;0;0;0;4416877;3441716;4463;2;3613809;2861;48;0;1
FR;3;2023-06-04;0;0;0;0;0;0;0;0;0;4416877;3441716;4463;2;3613809;2861;48;0;1
FR;3;2023-06-05;0;0;0;0;0;0;0;0;0;4416877;3441716;4463;2;3613809;2861;48;0;1
FR;3;2023-06-06;0;0;0;0;0;0;0;0;0;4416877;3441716;4463;2;3613809;2861;48;0;1
FR;3;2023-06-07;0;0;0;0;0;0;0;0;0;4416877;3441716;4463;2;3613809;2861;48;0;1
FR;3;2023-06-08;0;0;0;0;0;0;0;0;0;4416877;3441716;4463;2;3613809;2861;48;0;1
FR;3;2023-06-09;0;0;0;0;0;0;0;0;0;4416877;3441716;4463;2;3613809;2861;48;0;1
FR;3;2023-06-10;0;0;0;0;0;0;0;0;0;4416877;3441716;4463;2;3613809;2861;48;0;1
FR;3;2023-06-11;0;0;0;0;0;0;0;0;0;4416877;3441716;4463;2;3613809;2861;48;0;1
FR;3;2023-06-12;0;0;0;0;0;0;0;0;0;4416877;3441716;4463;2;3613809;2861;48;0;1
FR;3;2023-06-13;0;0;0;0;0;0;0;0;0;4416877;3441716;4463;2;3613809;2861;48;0;1
FR;3;2023-06-14;0;0;0;0;0;0;0;0;0;4416877;3441716;4463;2;3613809;2861;48;0;1
FR;3;2023-06-15;0;0;0;0;0;0;0;0;0;4416877;3441716;4463;2;3613809;2861;48;0;1
FR;3;2023-06-16;0;0;0;0;0;0;0;0;0;4416877;3441716;4463;2;3613809;2861;48;0;1
FR;3;2023-06-17;0;0;0;0;0;0;0;0;0;4416877;3441716;4463;2;3613809;2861;48;0;1
FR;3;2023-06-18;0;0;0;0;0;0;0;0;0;4416877;3441716;4463;2;3613809;2861;48;0;1
FR;3;2023-06-19;0;0;0;0;0;0;0;0;0;4416877;3441716;4463;2;3613809;2861;48;0;1
FR;4;2020-12-27;0;0;0;0;0;0;0;0;0;0;0;0;0;0;0;0;0;0
FR;4;2020-12-28;0;0;0;0;0;0;0;0;0;0;0;0;0;0;0;0;0;0
FR;4;2020-12-29;0;0;0;0;0;0;0;0;0;0;0;0;0;0;0;0;0;0
FR;4;2020-12-30;0;0;0;0;0;0;0;0;0;0;0;0;0;0;0;0;0;0
FR;4;2020-12-31;0;0;0;0;0;0;0;0;0;0;0;0;0;0;0;0;0;0
FR;4;2021-01-01;0;0;0;0;0;0;0;0;0;0;0;0;0;0;0;0;0;0
FR;4;2021-01-02;0;0;0;0;0;0;0;0;0;0;0;0;0;0;0;0;0;0
FR;4;2021-01-03;0;0;0;0;0;0;0;0;0;0;0;0;0;0;0;0;0;0
FR;4;2021-01-04;0;0;0;0;0;0;0;0;0;0;0;0;0;0;0;0;0;0
FR;4;2021-01-05;0;0;0;0;0;0;0;0;0;0;0;0;0;0;0;0;0;0
FR;4;2021-01-06;0;0;0;0;0;0;0;0;0;0;0;0;0;0;0;0;0;0
FR;4;2021-01-07;0;0;0;0;0;0;0;0;0;0;0;0;0;0;0;0;0;0
FR;4;2021-01-08;0;0;0;0;0;0;0;0;0;0;0;0;0;0;0;0;0;0
FR;4;2021-01-09;0;0;0;0;0;0;0;0;0;0;0;0;0;0;0;0;0;0
FR;4;2021-01-10;0;0;0;0;0;0;0;0;0;0;0;0;0;0;0;0;0;0
FR;4;2021-01-11;0;0;0;0;0;0;0;0;0;0;0;0;0;0;0;0;0;0
FR;4;2021-01-12;0;0;0;0;0;0;0;0;0;0;0;0;0;0;0;0;0;0
FR;4;2021-01-13;0;0;0;0;0;0;0;0;0;0;0;0;0;0;0;0;0;0
FR;4;2021-01-14;0;0;0;0;0;0;0;0;0;0;0;0;0;0;0;0;0;0
FR;4;2021-01-15;0;0;0;0;0;0;0;0;0;0;0;0;0;0;0;0;0;0
FR;4;2021-01-16;0;0;0;0;0;0;0;0;0;0;0;0;0;0;0;0;0;0
FR;4;2021-01-17;0;0;0;0;0;0;0;0;0;0;0;0;0;0;0;0;0;0
FR;4;2021-01-18;0;0;0;0;0;0;0;0;0;0;0;0;0;0;0;0;0;0
FR;4;2021-01-19;0;0;0;0;0;0;0;0;0;0;0;0;0;0;0;0;0;0
FR;4;2021-01-20;0;0;0;0;0;0;0;0;0;0;0;0;0;0;0;0;0;0
FR;4;2021-01-21;0;0;0;0;0;0;0;0;0;0;0;0;0;0;0;0;0;0
FR;4;2021-01-22;0;0;0;0;0;0;0;0;0;0;0;0;0;0;0;0;0;0
FR;4;2021-01-23;0;0;0;0;0;0;0;0;0;0;0;0;0;0;0;0;0;0
FR;4;2021-01-24;0;0;0;0;0;0;0;0;0;0;0;0;0;0;0;0;0;0
FR;4;2021-01-25;0;0;0;0;0;0;0;0;0;0;0;0;0;0;0;0;0;0
FR;4;2021-01-26;0;0;0;0;0;0;0;0;0;0;0;0;0;0;0;0;0;0
FR;4;2021-01-27;0;0;0;0;0;0;0;0;0;0;0;0;0;0;0;0;0;0
FR;4;2021-01-28;0;0;0;0;0;0;0;0;0;0;0;0;0;0;0;0;0;0
FR;4;2021-01-29;0;0;0;0;0;0;0;0;0;0;0;0;0;0;0;0;0;0
FR;4;2021-01-30;0;0;0;0;0;0;0;0;0;0;0;0;0;0;0;0;0;0
FR;4;2021-01-31;0;0;0;0;0;0;0;0;0;0;0;0;0;0;0;0;0;0
FR;4;2021-02-01;0;0;0;0;0;0;0;0;0;0;0;0;0;0;0;0;0;0
FR;4;2021-02-02;0;0;0;0;0;0;0;0;0;0;0;0;0;0;0;0;0;0
FR;4;2021-02-03;0;0;0;0;0;0;0;0;0;0;0;0;0;0;0;0;0;0
FR;4;2021-02-04;0;0;0;0;0;0;0;0;0;0;0;0;0;0;0;0;0;0
FR;4;2021-02-05;0;0;0;0;0;0;0;0;0;0;0;0;0;0;0;0;0;0
FR;4;2021-02-06;0;0;0;0;0;0;0;0;0;0;0;0;0;0;0;0;0;0
FR;4;2021-02-07;0;0;0;0;0;0;0;0;0;0;0;0;0;0;0;0;0;0
FR;4;2021-02-08;0;0;0;0;0;0;0;0;0;0;0;0;0;0;0;0;0;0
FR;4;2021-02-09;0;0;0;0;0;0;0;0;0;0;0;0;0;0;0;0;0;0
FR;4;2021-02-10;0;0;0;0;0;0;0;0;0;0;0;0;0;0;0;0;0;0
FR;4;2021-02-11;0;0;0;0;0;0;0;0;0;0;0;0;0;0;0;0;0;0
FR;4;2021-02-12;0;0;0;0;0;0;0;0;0;0;0;0;0;0;0;0;0;0
FR;4;2021-02-13;0;0;0;0;0;0;0;0;0;0;0;0;0;0;0;0;0;0
FR;4;2021-02-14;0;0;0;0;0;0;0;0;0;0;0;0;0;0;0;0;0;0
FR;4;2021-02-15;0;0;0;0;0;0;0;0;0;0;0;0;0;0;0;0;0;0
FR;4;2021-02-16;0;0;0;0;0;0;0;0;0;0;0;0;0;0;0;0;0;0
FR;4;2021-02-17;0;0;0;0;0;0;0;0;0;0;0;0;0;0;0;0;0;0
FR;4;2021-02-18;0;0;0;0;0;0;0;0;0;0;0;0;0;0;0;0;0;0
FR;4;2021-02-19;0;0;0;0;0;0;0;0;0;0;0;0;0;0;0;0;0;0
FR;4;2021-02-20;0;0;0;0;0;0;0;0;0;0;0;0;0;0;0;0;0;0
FR;4;2021-02-21;0;0;0;0;0;0;0;0;0;0;0;0;0;0;0;0;0;0
FR;4;2021-02-22;0;0;0;0;0;0;0;0;0;0;0;0;0;0;0;0;0;0
FR;4;2021-02-23;0;0;0;0;0;0;0;0;0;0;0;0;0;0;0;0;0;0
FR;4;2021-02-24;0;0;0;0;0;0;0;0;0;0;0;0;0;0;0;0;0;0
FR;4;2021-02-25;0;0;0;0;0;0;0;0;0;0;0;0;0;0;0;0;0;0
FR;4;2021-02-26;0;0;0;0;0;0;0;0;0;0;0;0;0;0;0;0;0;0
FR;4;2021-02-27;0;0;0;0;0;0;0;0;0;0;0;0;0;0;0;0;0;0
FR;4;2021-02-28;0;0;0;0;0;0;0;0;0;0;0;0;0;0;0;0;0;0
FR;4;2021-03-01;0;0;0;0;0;0;0;0;0;0;0;0;0;0;0;0;0;0
FR;4;2021-03-02;0;0;0;0;0;0;0;0;0;0;0;0;0;0;0;0;0;0
FR;4;2021-03-03;0;0;0;0;0;0;0;0;0;0;0;0;0;0;0;0;0;0
FR;4;2021-03-04;0;0;0;0;0;0;0;0;0;0;0;0;0;0;0;0;0;0
FR;4;2021-03-05;0;0;0;0;0;0;0;0;0;0;0;0;0;0;0;0;0;0
FR;4;2021-03-06;0;0;0;0;0;0;0;0;0;0;0;0;0;0;0;0;0;0
FR;4;2021-03-07;0;0;0;0;0;0;0;0;0;0;0;0;0;0;0;0;0;0
FR;4;2021-03-08;0;0;0;0;0;0;0;0;0;0;0;0;0;0;0;0;0;0
FR;4;2021-03-09;0;0;0;0;0;0;0;0;0;0;0;0;0;0;0;0;0;0
FR;4;2021-03-10;0;0;0;0;0;0;0;0;0;0;0;0;0;0;0;0;0;0
FR;4;2021-03-11;0;0;0;0;0;0;0;0;0;0;0;0;0;0;0;0;0;0
FR;4;2021-03-12;0;0;0;0;0;0;0;0;0;0;0;0;0;0;0;0;0;0
FR;4;2021-03-13;0;0;0;0;0;0;0;0;0;0;0;0;0;0;0;0;0;0
FR;4;2021-03-14;0;0;0;0;0;0;0;0;0;0;0;0;0;0;0;0;0;0
FR;4;2021-03-15;0;0;0;0;0;0;0;0;0;0;0;0;0;0;0;0;0;0
FR;4;2021-03-16;0;0;0;0;0;0;0;0;0;0;0;0;0;0;0;0;0;0
FR;4;2021-03-17;0;0;0;0;0;0;0;0;0;0;0;0;0;0;0;0;0;0
FR;4;2021-03-18;0;0;0;0;0;0;0;0;0;0;0;0;0;0;0;0;0;0
FR;4;2021-03-19;0;0;0;0;0;0;0;0;0;0;0;0;0;0;0;0;0;0
FR;4;2021-03-20;0;0;0;0;0;0;0;0;0;0;0;0;0;0;0;0;0;0
FR;4;2021-03-21;0;0;0;0;0;0;0;0;0;0;0;0;0;0;0;0;0;0
FR;4;2021-03-22;0;0;0;0;0;0;0;0;0;0;0;0;0;0;0;0;0;0
FR;4;2021-03-23;0;0;0;0;0;0;0;0;0;0;0;0;0;0;0;0;0;0
FR;4;2021-03-24;0;0;0;0;0;0;0;0;0;0;0;0;0;0;0;0;0;0
FR;4;2021-03-25;0;0;0;0;0;0;0;0;0;0;0;0;0;0;0;0;0;0
FR;4;2021-03-26;0;0;0;0;0;0;0;0;0;0;0;0;0;0;0;0;0;0
FR;4;2021-03-27;0;0;0;0;0;0;0;0;0;0;0;0;0;0;0;0;0;0
FR;4;2021-03-28;0;0;0;0;0;0;0;0;0;0;0;0;0;0;0;0;0;0
FR;4;2021-03-29;0;0;0;0;0;0;0;0;0;0;0;0;0;0;0;0;0;0
FR;4;2021-03-30;0;0;0;0;0;0;0;0;0;0;0;0;0;0;0;0;0;0
FR;4;2021-03-31;0;0;0;0;0;0;0;0;0;0;0;0;0;0;0;0;0;0
FR;4;2021-04-01;0;0;0;0;0;0;0;0;0;0;0;0;0;0;0;0;0;0
FR;4;2021-04-02;0;0;0;0;0;0;0;0;0;0;0;0;0;0;0;0;0;0
FR;4;2021-04-03;0;0;0;0;0;0;0;0;0;0;0;0;0;0;0;0;0;0
FR;4;2021-04-04;0;0;0;0;0;0;0;0;0;0;0;0;0;0;0;0;0;0
FR;4;2021-04-05;0;0;0;0;0;0;0;0;0;0;0;0;0;0;0;0;0;0
FR;4;2021-04-06;0;0;0;0;0;0;0;0;0;0;0;0;0;0;0;0;0;0
FR;4;2021-04-07;0;0;0;0;0;0;0;0;0;0;0;0;0;0;0;0;0;0
FR;4;2021-04-08;0;0;0;0;0;0;0;0;0;0;0;0;0;0;0;0;0;0
FR;4;2021-04-09;0;0;0;0;0;0;0;0;0;0;0;0;0;0;0;0;0;0
FR;4;2021-04-10;0;0;0;0;0;0;0;0;0;0;0;0;0;0;0;0;0;0
FR;4;2021-04-11;0;0;0;0;0;0;0;0;0;0;0;0;0;0;0;0;0;0
FR;4;2021-04-12;0;0;0;0;0;0;0;0;0;0;0;0;0;0;0;0;0;0
FR;4;2021-04-13;0;0;0;0;0;0;0;0;0;0;0;0;0;0;0;0;0;0
FR;4;2021-04-14;0;0;0;0;0;0;0;0;0;0;0;0;0;0;0;0;0;0
FR;4;2021-04-15;0;0;0;0;0;0;0;0;0;0;0;0;0;0;0;0;0;0
FR;4;2021-04-16;0;0;0;0;0;0;0;0;0;0;0;0;0;0;0;0;0;0
FR;4;2021-04-17;0;0;0;0;0;0;0;0;0;0;0;0;0;0;0;0;0;0
FR;4;2021-04-18;0;0;0;0;0;0;0;0;0;0;0;0;0;0;0;0;0;0
FR;4;2021-04-19;0;0;0;0;0;0;0;0;0;0;0;0;0;0;0;0;0;0
FR;4;2021-04-20;0;0;0;0;0;0;0;0;0;0;0;0;0;0;0;0;0;0
FR;4;2021-04-21;0;0;0;0;0;0;0;0;0;0;0;0;0;0;0;0;0;0
FR;4;2021-04-22;0;0;0;0;0;0;0;0;0;0;0;0;0;0;0;0;0;0
FR;4;2021-04-23;3660;0;0;0;3622;0;0;0;0;3660;0;0;0;3622;0;0;0;0
FR;4;2021-04-24;1570;1;0;0;1559;0;0;0;0;5230;1;0;0;5181;0;0;0;0
FR;4;2021-04-25;125;0;0;0;125;0;0;0;0;5355;1;0;0;5306;0;0;0;0
FR;4;2021-04-26;2872;1;0;0;2862;0;0;0;0;8227;2;0;0;8168;0;0;0;0
FR;4;2021-04-27;9520;3;0;0;9501;0;0;0;0;17747;5;0;0;17669;0;0;0;0
FR;4;2021-04-28;9910;6;0;0;9885;0;0;0;0;27657;11;0;0;27554;0;0;0;0
FR;4;2021-04-29;15995;8;0;0;15979;0;0;0;0;43652;19;0;0;43533;0;0;0;0
FR;4;2021-04-30;19234;10;0;0;19205;0;0;0;0;62886;29;0;0;62738;0;0;0;0
FR;4;2021-05-01;1994;6;0;0;1992;0;0;0;0;64880;35;0;0;64730;0;0;0;0
FR;4;2021-05-02;484;0;0;0;482;0;0;0;0;65364;35;0;0;65212;0;0;0;0
FR;4;2021-05-03;5066;2;0;0;5059;0;0;0;0;70430;37;0;0;70271;0;0;0;0
FR;4;2021-05-04;8411;11;0;0;8400;0;0;0;0;78841;48;0;0;78671;0;0;0;0
FR;4;2021-05-05;6193;7;0;0;6188;0;0;0;0;85034;55;0;0;84859;0;0;0;0
FR;4;2021-05-06;11388;11;0;0;11385;0;0;0;0;96422;66;0;0;96244;0;0;0;0
FR;4;2021-05-07;19126;9;0;0;19087;0;0;0;0;115548;75;0;0;115331;0;0;0;0
FR;4;2021-05-08;2376;7;0;0;2380;0;0;0;0;117924;82;0;0;117711;0;0;0;0
FR;4;2021-05-09;692;3;0;0;693;0;0;0;0;118616;85;0;0;118404;0;0;0;0
FR;4;2021-05-10;7246;5;1;0;7243;0;0;0;0;125862;90;1;0;125647;0;0;0;0
FR;4;2021-05-11;14325;13;0;0;14305;0;0;0;0;140187;103;1;0;139952;0;0;0;0
FR;4;2021-05-12;10176;15;0;0;10179;0;0;0;0;150363;118;1;0;150131;0;0;0;0
FR;4;2021-05-13;1584;4;0;0;1585;0;0;0;0;151947;122;1;0;151716;0;0;0;0
FR;4;2021-05-14;7768;7;0;0;7763;0;0;0;0;159715;129;1;0;159479;0;0;0;0
FR;4;2021-05-15;3721;8;1;0;3720;0;0;0;0;163436;137;2;0;163199;0;0;0;0
FR;4;2021-05-16;417;1;0;0;417;0;0;0;0;163853;138;2;0;163616;0;0;0;0
FR;4;2021-05-17;4485;8;0;0;4484;0;0;0;0;168338;146;2;0;168100;0;0;0;0
FR;4;2021-05-18;8769;10;0;0;8769;0;0;0;0;177107;156;2;0;176869;0;0;0;0
FR;4;2021-05-19;5699;7;0;0;5701;0;0;0;0;182806;163;2;0;182570;0;0;0;0
FR;4;2021-05-20;9487;8;0;0;9479;0;0;0;0;192293;171;2;0;192049;0;0;0;0
FR;4;2021-05-21;12816;30;0;0;12823;0;0;0;0;205109;201;2;0;204872;0;0;0;0
FR;4;2021-05-22;5063;15;0;0;5070;0;0;0;0;210172;216;2;0;209942;0;0;0;0
FR;4;2021-05-23;498;4;0;0;501;0;0;0;0;210670;220;2;0;210443;0;0;0;0
FR;4;2021-05-24;1062;7;0;0;1066;0;0;0;0;211732;227;2;0;211509;0;0;0;0
FR;4;2021-05-25;7637;16;0;0;7643;0;0;0;0;219369;243;2;0;219152;0;0;0;0
FR;4;2021-05-26;7731;16;0;0;7739;0;0;0;0;227100;259;2;0;226891;0;0;0;0
FR;4;2021-05-27;14340;35;0;0;14349;0;0;0;0;241440;294;2;0;241240;0;0;0;0
FR;4;2021-05-28;26593;82;1;0;26634;0;0;0;0;268033;376;3;0;267874;0;0;0;0
FR;4;2021-05-29;11385;19;0;0;11385;0;0;0;0;279418;395;3;0;279259;0;0;0;0
FR;4;2021-05-30;974;7;0;0;973;0;0;0;0;280392;402;3;0;280232;0;0;0;0
FR;4;2021-05-31;12701;21;0;0;12701;0;0;0;0;293093;423;3;0;292933;0;0;0;0
FR;4;2021-06-01;20283;48;1;0;20301;0;0;0;0;313376;471;4;0;313234;0;0;0;0
FR;4;2021-06-02;14526;33;0;0;14538;0;0;0;0;327902;504;4;0;327772;0;0;0;0
FR;4;2021-06-03;19436;24;1;0;19434;0;0;0;0;347338;528;5;0;347206;0;0;0;0
FR;4;2021-06-04;22520;48;0;0;22538;0;0;0;0;369858;576;5;0;369744;0;0;0;0
FR;4;2021-06-05;9717;32;0;0;9721;0;0;0;0;379575;608;5;0;379465;0;0;0;0
FR;4;2021-06-06;1041;2;0;0;1037;0;0;0;0;380616;610;5;0;380502;0;0;0;0
FR;4;2021-06-07;9230;19;0;0;9238;0;0;0;0;389846;629;5;0;389740;0;0;0;0
FR;4;2021-06-08;14613;32;0;0;14625;0;0;0;0;404459;661;5;0;404365;0;0;0;0
FR;4;2021-06-09;12218;25;0;0;12226;0;0;0;0;416677;686;5;0;416591;0;0;0;0
FR;4;2021-06-10;15408;30;0;0;15416;0;0;0;0;432085;716;5;0;432007;0;0;0;0
FR;4;2021-06-11;16990;57;0;0;17017;0;0;0;0;449075;773;5;0;449024;0;0;0;0
FR;4;2021-06-12;7454;27;0;0;7479;0;0;0;0;456529;800;5;0;456503;0;0;0;0
FR;4;2021-06-13;908;3;0;0;910;0;0;0;0;457437;803;5;0;457413;0;0;0;0
FR;4;2021-06-14;6652;27;0;0;6662;0;0;0;0;464089;830;5;0;464075;0;0;0;0
FR;4;2021-06-15;10896;39;0;0;10913;0;0;0;0;474985;869;5;0;474988;0;0;0;0
FR;4;2021-06-16;8909;17;0;0;8917;0;0;0;0;483894;886;5;0;483905;0;0;0;0
FR;4;2021-06-17;10903;36;0;0;10915;0;0;0;0;494797;922;5;0;494820;0;0;0;0
FR;4;2021-06-18;12427;45;0;0;12454;0;0;0;0;507224;967;5;0;507274;0;0;0;0
FR;4;2021-06-19;5568;25;0;0;5588;0;0;0;0;512792;992;5;0;512862;0;0;0;0
FR;4;2021-06-20;828;5;0;0;832;0;0;0;0;513620;997;5;0;513694;0;0;0;0
FR;4;2021-06-21;5107;21;0;0;5107;0;0;0;0;518727;1018;5;0;518801;0;0;0;0
FR;4;2021-06-22;7916;29;2;0;7934;0;0;0;0;526643;1047;7;0;526735;0;0;0;0
FR;4;2021-06-23;7106;43;2;0;7133;0;0;0;0;533749;1090;9;0;533868;0;0;0;0
FR;4;2021-06-24;8657;46;1;0;8689;0;0;0;0;542406;1136;10;0;542557;0;0;0;0
FR;4;2021-06-25;10179;41;2;0;10211;0;0;0;0;552585;1177;12;0;552768;0;0;0;0
FR;4;2021-06-26;4854;23;0;0;4871;0;0;0;0;557439;1200;12;0;557639;0;0;0;0
FR;4;2021-06-27;769;4;0;0;771;0;0;0;0;558208;1204;12;0;558410;0;0;0;0
FR;4;2021-06-28;4835;16;1;0;4844;0;0;0;0;563043;1220;13;0;563254;0;0;0;0
FR;4;2021-06-29;7110;28;2;0;7119;0;0;0;0;570153;1248;15;0;570373;0;0;0;0
FR;4;2021-06-30;6728;41;2;0;6756;0;0;0;0;576881;1289;17;0;577129;0;0;0;0
FR;4;2021-07-01;8213;42;0;0;8235;0;0;0;0;585094;1331;17;0;585364;0;0;0;0
FR;4;2021-07-02;9430;53;1;0;9470;0;0;0;0;594524;1384;18;0;594834;0;0;0;0
FR;4;2021-07-03;4848;20;0;0;4863;0;0;0;0;599372;1404;18;0;599697;0;0;0;0
FR;4;2021-07-04;690;5;0;0;692;0;0;0;0;600062;1409;18;0;600389;0;0;0;0
FR;4;2021-07-05;4776;19;2;0;4787;0;0;0;0;604838;1428;20;0;605176;0;0;0;0
FR;4;2021-07-06;7729;29;4;0;7742;0;0;0;0;612567;1457;24;0;612918;0;0;0;0
FR;4;2021-07-07;7088;34;2;0;7100;0;0;0;0;619655;1491;26;0;620018;0;0;0;0
FR;4;2021-07-08;9235;40;2;0;9258;0;0;0;0;628890;1531;28;0;629276;0;0;0;0
FR;4;2021-07-09;10282;34;1;0;10305;0;0;0;0;639172;1565;29;0;639581;0;0;0;0
FR;4;2021-07-10;4639;14;2;0;4646;0;0;0;0;643811;1579;31;0;644227;0;0;0;0
FR;4;2021-07-11;586;4;1;0;584;0;0;0;0;644397;1583;32;0;644811;0;0;0;0
FR;4;2021-07-12;5879;29;0;0;5901;0;0;0;0;650276;1612;32;0;650712;0;0;0;0
FR;4;2021-07-13;14231;29;0;0;14249;0;0;0;0;664507;1641;32;0;664961;0;0;0;0
FR;4;2021-07-14;2291;15;0;0;2291;0;0;0;0;666798;1656;32;0;667252;0;0;0;0
FR;4;2021-07-15;18239;37;0;0;18256;0;0;0;0;685037;1693;32;0;685508;0;0;0;0
FR;4;2021-07-16;22838;71;2;0;22888;0;0;0;0;707875;1764;34;0;708396;0;0;0;0
FR;4;2021-07-17;9741;20;0;0;9749;0;0;0;0;717616;1784;34;0;718145;0;0;0;0
FR;4;2021-07-18;1359;5;0;0;1362;0;0;0;0;718975;1789;34;0;719507;0;0;0;0
FR;4;2021-07-19;12991;30;1;0;13016;0;0;0;0;731966;1819;35;0;732523;0;0;0;0
FR;4;2021-07-20;17345;26;1;0;17361;0;0;0;0;749311;1845;36;0;749884;0;0;0;0
FR;4;2021-07-21;15623;33;0;0;15643;0;0;0;0;764934;1878;36;0;765527;0;0;0;0
FR;4;2021-07-22;18247;45;2;0;18271;0;0;0;0;783181;1923;38;0;783798;0;0;0;0
FR;4;2021-07-23;20420;57;7;0;20453;0;0;0;0;803601;1980;45;0;804251;0;0;0;0
FR;4;2021-07-24;9290;34;0;0;9305;0;0;0;0;812891;2014;45;0;813556;0;0;0;0
FR;4;2021-07-25;1356;11;0;0;1358;0;0;0;0;814247;2025;45;0;814914;0;0;0;0
FR;4;2021-07-26;11050;23;0;0;11057;0;0;0;0;825297;2048;45;0;825971;0;0;0;0
FR;4;2021-07-27;14688;35;3;0;14708;0;0;0;0;839985;2083;48;0;840679;0;0;0;0
FR;4;2021-07-28;12937;26;2;0;12954;0;0;0;0;852922;2109;50;0;853633;0;0;0;0
FR;4;2021-07-29;14098;54;4;0;14140;0;0;0;0;867020;2163;54;0;867773;0;0;0;0
FR;4;2021-07-30;15503;46;2;0;15533;0;0;0;0;882523;2209;56;0;883306;0;0;0;0
FR;4;2021-07-31;6845;14;2;0;6855;0;0;0;0;889368;2223;58;0;890161;0;0;0;0
FR;4;2021-08-01;906;1;0;0;901;0;0;0;0;890274;2224;58;0;891062;0;0;0;0
FR;4;2021-08-02;7918;31;0;0;7919;0;0;0;0;898192;2255;58;0;898981;0;0;0;0
FR;4;2021-08-03;10805;31;2;0;10801;0;0;0;0;908997;2286;60;0;909782;0;0;0;0
FR;4;2021-08-04;9749;29;0;0;9748;0;0;0;0;918746;2315;60;0;919530;0;0;0;0
FR;4;2021-08-05;9831;42;0;0;9837;0;0;0;0;928577;2357;60;0;929367;0;0;0;0
FR;4;2021-08-06;10201;30;3;0;10198;0;0;0;0;938778;2387;63;0;939565;0;0;0;0
FR;4;2021-08-07;5100;30;1;0;5116;0;0;0;0;943878;2417;64;0;944681;0;0;0;0
FR;4;2021-08-08;1225;13;0;0;1228;0;0;0;0;945103;2430;64;0;945909;0;0;0;0
FR;4;2021-08-09;6350;31;0;0;6343;0;0;0;0;951453;2461;64;0;952252;0;0;0;0
FR;4;2021-08-10;8753;18;0;0;8724;0;0;0;0;960206;2479;64;0;960976;0;0;0;0
FR;4;2021-08-11;7945;34;4;0;7934;0;0;0;0;968151;2513;68;0;968910;0;0;0;0
FR;4;2021-08-12;8585;31;1;0;8573;0;0;0;0;976736;2544;69;0;977483;0;0;0;0
FR;4;2021-08-13;7561;25;0;1;7548;0;0;0;0;984297;2569;69;1;985031;0;0;0;0
FR;4;2021-08-14;3793;20;0;0;3777;0;0;0;0;988090;2589;69;1;988808;0;0;0;0
FR;4;2021-08-15;771;5;0;0;773;0;0;0;0;988861;2594;69;1;989581;0;0;0;0
FR;4;2021-08-16;4010;17;0;0;4005;0;0;0;0;992871;2611;69;1;993586;0;0;0;0
FR;4;2021-08-17;5634;17;1;0;5624;0;0;0;0;998505;2628;70;1;999210;0;0;0;0
FR;4;2021-08-18;5172;37;0;0;5189;0;0;0;0;1003677;2665;70;1;1004399;0;0;0;0
FR;4;2021-08-19;5489;34;3;0;5503;0;0;0;0;1009166;2699;73;1;1009902;0;0;0;0
FR;4;2021-08-20;5225;25;1;0;5235;0;0;0;0;1014391;2724;74;1;1015137;0;0;0;0
FR;4;2021-08-21;2311;23;1;0;2328;0;0;0;0;1016702;2747;75;1;1017465;0;0;0;0
FR;4;2021-08-22;414;2;0;0;415;0;0;0;0;1017116;2749;75;1;1017880;0;0;0;0
FR;4;2021-08-23;2938;21;1;0;2946;0;0;0;0;1020054;2770;76;1;1020826;0;0;0;0
FR;4;2021-08-24;3758;16;0;0;3761;0;0;0;0;1023812;2786;76;1;1024587;0;0;0;0
FR;4;2021-08-25;3546;25;1;0;3562;0;0;0;0;1027358;2811;77;1;1028149;0;0;0;0
FR;4;2021-08-26;3716;21;2;0;3728;0;0;0;0;1031074;2832;79;1;1031877;0;0;0;0
FR;4;2021-08-27;3617;31;2;0;3635;0;0;0;0;1034691;2863;81;1;1035512;0;0;0;0
FR;4;2021-08-28;1732;10;1;0;1737;0;0;0;0;1036423;2873;82;1;1037249;0;0;0;0
FR;4;2021-08-29;385;7;1;0;389;0;0;0;0;1036808;2880;83;1;1037638;0;0;0;0
FR;4;2021-08-30;2010;25;0;0;2018;16;0;0;0;1038818;2905;83;1;1039656;16;0;0;0
FR;4;2021-08-31;2487;21;0;0;2494;14;0;0;0;1041305;2926;83;1;1042150;30;0;0;0
FR;4;2021-09-01;2085;38;1;0;2096;22;0;0;0;1043390;2964;84;1;1044246;52;0;0;0
FR;4;2021-09-02;2309;31;4;0;2322;18;0;0;0;1045699;2995;88;1;1046568;70;0;0;0
FR;4;2021-09-03;2366;44;5;0;2375;36;0;0;0;1048065;3039;93;1;1048943;106;0;0;0
FR;4;2021-09-04;1374;18;0;0;1381;9;0;0;0;1049439;3057;93;1;1050324;115;0;0;0
FR;4;2021-09-05;434;2;0;0;434;2;0;0;0;1049873;3059;93;1;1050758;117;0;0;0
FR;4;2021-09-06;1713;62;0;0;1750;24;0;0;0;1051586;3121;93;1;1052508;141;0;0;0
FR;4;2021-09-07;1681;18;0;0;1690;8;0;0;0;1053267;3139;93;1;1054198;149;0;0;0
FR;4;2021-09-08;1286;26;3;0;1291;19;0;0;0;1054553;3165;96;1;1055489;168;0;0;0
FR;4;2021-09-09;1394;23;2;0;1404;9;0;0;0;1055947;3188;98;1;1056893;177;0;0;0
FR;4;2021-09-10;1522;31;2;0;1526;23;1;0;0;1057469;3219;100;1;1058419;200;1;0;0
FR;4;2021-09-11;746;11;0;0;749;3;0;0;0;1058215;3230;100;1;1059168;203;1;0;0
FR;4;2021-09-12;169;5;0;0;170;4;0;0;0;1058384;3235;100;1;1059338;207;1;0;0
FR;4;2021-09-13;1325;22;1;0;1328;16;0;0;0;1059709;3257;101;1;1060666;223;1;0;0
FR;4;2021-09-14;1507;9;2;0;1509;7;0;0;0;1061216;3266;103;1;1062175;230;1;0;0
FR;4;2021-09-15;1095;28;1;0;1098;25;0;0;0;1062311;3294;104;1;1063273;255;1;0;0
FR;4;2021-09-16;1108;22;2;0;1112;15;0;0;0;1063419;3316;106;1;1064385;270;1;0;0
FR;4;2021-09-17;898;21;1;0;905;12;0;0;0;1064317;3337;107;1;1065290;282;1;0;0
FR;4;2021-09-18;464;7;1;0;465;6;0;0;0;1064781;3344;108;1;1065755;288;1;0;0
FR;4;2021-09-19;182;3;0;0;183;2;0;0;0;1064963;3347;108;1;1065938;290;1;0;0
FR;4;2021-09-20;452;19;0;0;458;13;0;0;0;1065415;3366;108;1;1066396;303;1;0;0
FR;4;2021-09-21;434;11;0;0;436;7;0;0;0;1065849;3377;108;1;1066832;310;1;0;0
FR;4;2021-09-22;377;19;4;0;384;15;0;0;0;1066226;3396;112;1;1067216;325;1;0;0
FR;4;2021-09-23;488;15;1;0;489;14;0;0;0;1066714;3411;113;1;1067705;339;1;0;0
FR;4;2021-09-24;416;13;2;0;420;9;0;0;0;1067130;3424;115;1;1068125;348;1;0;0
FR;4;2021-09-25;281;10;1;0;282;5;0;0;0;1067411;3434;116;1;1068407;353;1;0;0
FR;4;2021-09-26;75;2;0;0;76;1;0;0;0;1067486;3436;116;1;1068483;354;1;0;0
FR;4;2021-09-27;270;10;1;0;271;8;0;0;0;1067756;3446;117;1;1068754;362;1;0;0
FR;4;2021-09-28;319;8;0;0;319;8;0;0;0;1068075;3454;117;1;1069073;370;1;0;0
FR;4;2021-09-29;378;19;1;0;380;13;0;0;0;1068453;3473;118;1;1069453;383;1;0;0
FR;4;2021-09-30;367;41;0;0;381;22;0;0;0;1068820;3514;118;1;1069834;405;1;0;0
FR;4;2021-10-01;411;56;0;0;413;50;0;0;0;1069231;3570;118;1;1070247;455;1;0;0
FR;4;2021-10-02;196;23;1;0;198;14;0;0;0;1069427;3593;119;1;1070445;469;1;0;0
FR;4;2021-10-03;86;1;0;0;87;0;0;0;0;1069513;3594;119;1;1070532;469;1;0;0
FR;4;2021-10-04;363;20;1;0;367;16;0;0;0;1069876;3614;120;1;1070899;485;1;0;0
FR;4;2021-10-05;286;19;2;0;288;15;0;0;0;1070162;3633;122;1;1071187;500;1;0;0
FR;4;2021-10-06;249;23;1;0;254;18;0;0;0;1070411;3656;123;1;1071441;518;1;0;0
FR;4;2021-10-07;268;25;2;0;273;13;0;0;0;1070679;3681;125;1;1071714;531;1;0;0
FR;4;2021-10-08;357;24;2;0;360;20;0;0;0;1071036;3705;127;1;1072074;551;1;0;0
FR;4;2021-10-09;194;6;6;0;195;7;0;0;0;1071230;3711;133;1;1072269;558;1;0;0
FR;4;2021-10-10;97;3;2;0;99;3;0;0;0;1071327;3714;135;1;1072368;561;1;0;0
FR;4;2021-10-11;252;15;1;0;253;14;0;0;0;1071579;3729;136;1;1072621;575;1;0;0
FR;4;2021-10-12;211;14;0;0;211;13;0;0;0;1071790;3743;136;1;1072832;588;1;0;0
FR;4;2021-10-13;221;28;1;0;224;25;0;0;0;1072011;3771;137;1;1073056;613;1;0;0
FR;4;2021-10-14;316;21;4;0;320;15;0;0;0;1072327;3792;141;1;1073376;628;1;0;0
FR;4;2021-10-15;324;24;5;0;325;25;0;0;0;1072651;3816;146;1;1073701;653;1;0;0
FR;4;2021-10-16;167;6;2;0;167;6;0;0;0;1072818;3822;148;1;1073868;659;1;0;0
FR;4;2021-10-17;70;2;0;0;71;1;0;0;0;1072888;3824;148;1;1073939;660;1;0;0
FR;4;2021-10-18;282;16;1;0;284;13;0;0;0;1073170;3840;149;1;1074223;673;1;0;0
FR;4;2021-10-19;215;15;2;0;215;16;0;0;0;1073385;3855;151;1;1074438;689;1;0;0
FR;4;2021-10-20;232;27;4;0;235;15;0;0;0;1073617;3882;155;1;1074673;704;1;0;0
FR;4;2021-10-21;244;18;0;0;246;14;0;0;0;1073861;3900;155;1;1074919;718;1;0;0
FR;4;2021-10-22;217;25;2;0;219;20;1;0;0;1074078;3925;157;1;1075138;738;2;0;0
FR;4;2021-10-23;117;16;1;0;118;15;0;0;0;1074195;3941;158;1;1075256;753;2;0;0
FR;4;2021-10-24;39;4;0;0;39;1;0;0;0;1074234;3945;158;1;1075295;754;2;0;0
FR;4;2021-10-25;218;7;2;0;218;9;0;0;0;1074452;3952;160;1;1075513;763;2;0;0
FR;4;2021-10-26;200;14;0;0;202;12;0;0;0;1074652;3966;160;1;1075715;775;2;0;0
FR;4;2021-10-27;196;12;4;0;196;12;2;0;0;1074848;3978;164;1;1075911;787;4;0;0
FR;4;2021-10-28;187;18;5;0;187;22;0;0;0;1075035;3996;169;1;1076098;809;4;0;0
FR;4;2021-10-29;227;18;2;0;228;16;0;0;0;1075262;4014;171;1;1076326;825;4;0;0
FR;4;2021-10-30;104;2;1;0;105;2;0;0;0;1075366;4016;172;1;1076431;827;4;0;0
FR;4;2021-10-31;59;3;2;0;60;3;0;0;0;1075425;4019;174;1;1076491;830;4;0;0
FR;4;2021-11-01;76;27;4;0;77;24;3;0;0;1075501;4046;178;1;1076568;854;7;0;0
FR;4;2021-11-02;164;21;2;0;165;21;0;0;0;1075665;4067;180;1;1076733;875;7;0;0
FR;4;2021-11-03;133;21;8;1;134;19;6;0;0;1075798;4088;188;2;1076867;894;13;0;0
FR;4;2021-11-04;187;15;1;0;188;12;1;0;0;1075985;4103;189;2;1077055;906;14;0;0
FR;4;2021-11-05;132;17;1;0;133;16;0;0;0;1076117;4120;190;2;1077188;922;14;0;0
FR;4;2021-11-06;82;6;1;0;82;6;0;0;0;1076199;4126;191;2;1077270;928;14;0;0
FR;4;2021-11-07;83;2;2;0;83;4;0;0;0;1076282;4128;193;2;1077353;932;14;0;0
FR;4;2021-11-08;162;20;1;0;163;20;0;0;0;1076444;4148;194;2;1077516;952;14;0;0
FR;4;2021-11-09;159;14;3;0;159;16;0;0;0;1076603;4162;197;2;1077675;968;14;0;0
FR;4;2021-11-10;121;30;7;0;121;33;2;0;0;1076724;4192;204;2;1077796;1001;16;0;0
FR;4;2021-11-11;100;10;1;0;100;11;0;0;0;1076824;4202;205;2;1077896;1012;16;0;0
FR;4;2021-11-12;107;19;2;0;108;18;1;0;0;1076931;4221;207;2;1078004;1030;17;0;0
FR;4;2021-11-13;75;15;2;0;76;14;0;0;0;1077006;4236;209;2;1078080;1044;17;0;0
FR;4;2021-11-14;55;5;4;0;56;8;0;0;0;1077061;4241;213;2;1078136;1052;17;0;0
FR;4;2021-11-15;99;26;2;0;101;24;2;0;0;1077160;4267;215;2;1078237;1076;19;0;0
FR;4;2021-11-16;112;14;3;0;112;17;0;0;0;1077272;4281;218;2;1078349;1093;19;0;0
FR;4;2021-11-17;122;30;4;0;122;30;1;0;0;1077394;4311;222;2;1078471;1123;20;0;0
FR;4;2021-11-18;103;34;14;0;105;43;1;0;0;1077497;4345;236;2;1078576;1166;21;0;0
FR;4;2021-11-19;89;21;3;0;89;22;1;0;0;1077586;4366;239;2;1078665;1188;22;0;0
FR;4;2021-11-20;78;8;1;0;78;8;0;0;0;1077664;4374;240;2;1078743;1196;22;0;0
FR;4;2021-11-21;70;7;2;0;70;9;0;0;0;1077734;4381;242;2;1078813;1205;22;0;0
FR;4;2021-11-22;109;28;9;0;110;33;2;0;0;1077843;4409;251;2;1078923;1238;24;0;0
FR;4;2021-11-23;78;31;6;0;79;29;2;0;0;1077921;4440;257;2;1079002;1267;26;0;0
FR;4;2021-11-24;92;23;12;0;94;25;4;0;0;1078013;4463;269;2;1079096;1292;30;0;0
FR;4;2021-11-25;96;28;19;0;97;35;5;0;0;1078109;4491;288;2;1079193;1327;35;0;0
FR;4;2021-11-26;86;43;12;0;90;45;3;0;0;1078195;4534;300;2;1079283;1372;38;0;0
FR;4;2021-11-27;42;22;15;0;42;25;10;0;0;1078237;4556;315;2;1079325;1397;48;0;0
FR;4;2021-11-28;53;8;0;0;54;7;0;0;0;1078290;4564;315;2;1079379;1404;48;0;0
FR;4;2021-11-29;90;31;16;0;90;40;2;0;0;1078380;4595;331;2;1079469;1444;50;0;0
FR;4;2021-11-30;77;37;13;0;77;42;2;0;0;1078457;4632;344;2;1079546;1486;52;0;0
FR;4;2021-12-01;88;60;19;0;88;67;11;0;0;1078545;4692;363;2;1079634;1553;63;0;0
FR;4;2021-12-02;114;48;21;0;118;56;3;0;0;1078659;4740;384;2;1079752;1609;66;0;0
FR;4;2021-12-03;106;36;15;0;106;44;4;0;0;1078765;4776;399;2;1079858;1653;70;0;0
FR;4;2021-12-04;73;31;18;0;75;44;1;0;0;1078838;4807;417;2;1079933;1697;71;0;0
FR;4;2021-12-05;64;7;1;0;65;7;0;0;0;1078902;4814;418;2;1079998;1704;71;0;0
FR;4;2021-12-06;112;46;20;0;112;60;3;0;0;1079014;4860;438;2;1080110;1764;74;0;0
FR;4;2021-12-07;85;37;9;0;88;36;3;0;0;1079099;4897;447;2;1080198;1800;77;0;0
FR;4;2021-12-08;74;31;17;0;76;38;7;0;0;1079173;4928;464;2;1080274;1838;84;0;0
FR;4;2021-12-09;65;32;10;1;65;39;3;0;0;1079238;4960;474;3;1080339;1877;87;0;0
FR;4;2021-12-10;64;64;20;0;65;68;10;0;0;1079302;5024;494;3;1080404;1945;97;0;0
FR;4;2021-12-11;30;34;7;0;30;34;3;0;0;1079332;5058;501;3;1080434;1979;100;0;0
FR;4;2021-12-12;30;12;3;0;30;15;0;0;0;1079362;5070;504;3;1080464;1994;100;0;0
FR;4;2021-12-13;79;40;14;0;81;49;2;0;0;1079441;5110;518;3;1080545;2043;102;0;0
FR;4;2021-12-14;61;43;18;0;62;55;2;0;0;1079502;5153;536;3;1080607;2098;104;0;0
FR;4;2021-12-15;68;65;29;0;68;86;6;0;0;1079570;5218;565;3;1080675;2184;110;0;0
FR;4;2021-12-16;35;45;18;0;36;58;3;0;0;1079605;5263;583;3;1080711;2242;113;0;0
FR;4;2021-12-17;39;55;11;0;39;59;6;0;0;1079644;5318;594;3;1080750;2301;119;0;0
FR;4;2021-12-18;49;31;3;0;50;33;0;0;0;1079693;5349;597;3;1080800;2334;119;0;0
FR;4;2021-12-19;17;4;1;0;18;4;0;0;0;1079710;5353;598;3;1080818;2338;119;0;0
FR;4;2021-12-20;45;38;10;0;46;41;6;0;0;1079755;5391;608;3;1080864;2379;125;0;0
FR;4;2021-12-21;32;32;17;0;34;39;5;0;0;1079787;5423;625;3;1080898;2418;130;0;0
FR;4;2021-12-22;37;39;10;0;38;39;7;0;0;1079824;5462;635;3;1080936;2457;137;0;0
FR;4;2021-12-23;41;45;8;0;41;49;2;0;0;1079865;5507;643;3;1080977;2506;139;0;0
FR;4;2021-12-24;25;28;10;0;27;31;4;0;0;1079890;5535;653;3;1081004;2537;143;0;0
FR;4;2021-12-25;7;3;3;0;7;4;2;0;0;1079897;5538;656;3;1081011;2541;145;0;0
FR;4;2021-12-26;5;3;1;0;6;2;0;0;0;1079902;5541;657;3;1081017;2543;145;0;0
FR;4;2021-12-27;31;41;9;0;32;43;4;0;0;1079933;5582;666;3;1081049;2586;149;0;0
FR;4;2021-12-28;28;28;7;0;30;29;4;0;0;1079961;5610;673;3;1081079;2615;153;0;0
FR;4;2021-12-29;56;25;11;0;57;30;5;0;0;1080017;5635;684;3;1081136;2645;158;0;0
FR;4;2021-12-30;48;19;12;0;51;22;5;0;0;1080065;5654;696;3;1081187;2667;163;0;0
FR;4;2021-12-31;20;7;8;0;21;12;2;0;0;1080085;5661;704;3;1081208;2679;165;0;0
FR;4;2022-01-01;7;4;5;0;7;7;1;0;0;1080092;5665;709;3;1081215;2686;166;0;0
FR;4;2022-01-02;43;5;16;0;43;20;1;0;0;1080135;5670;725;3;1081258;2706;167;0;0
FR;4;2022-01-03;45;55;25;1;47;65;10;0;0;1080180;5725;750;4;1081305;2771;177;0;0
FR;4;2022-01-04;44;28;16;0;45;33;8;0;0;1080224;5753;766;4;1081350;2804;185;0;0
FR;4;2022-01-05;52;24;19;0;58;27;9;0;0;1080276;5777;785;4;1081408;2831;194;0;0
FR;4;2022-01-06;52;24;24;0;52;40;8;0;0;1080328;5801;809;4;1081460;2871;202;0;0
FR;4;2022-01-07;31;20;16;0;33;21;12;0;0;1080359;5821;825;4;1081493;2892;214;0;0
FR;4;2022-01-08;13;6;10;0;14;12;3;0;0;1080372;5827;835;4;1081507;2904;217;0;0
FR;4;2022-01-09;20;2;3;0;21;4;0;0;0;1080392;5829;838;4;1081528;2908;217;0;0
FR;4;2022-01-10;53;22;19;0;53;36;4;0;0;1080445;5851;857;4;1081581;2944;221;0;0
FR;4;2022-01-11;30;31;12;0;34;35;1;0;0;1080475;5882;869;4;1081615;2979;222;0;0
FR;4;2022-01-12;35;21;13;0;37;23;9;0;0;1080510;5903;882;4;1081652;3002;231;0;0
FR;4;2022-01-13;55;20;27;0;56;38;8;0;0;1080565;5923;909;4;1081708;3040;239;0;0
FR;4;2022-01-14;25;32;13;0;26;35;7;0;0;1080590;5955;922;4;1081734;3075;246;0;0
FR;4;2022-01-15;15;6;8;0;16;12;1;0;0;1080605;5961;930;4;1081750;3087;247;0;0
FR;4;2022-01-16;13;9;14;0;13;22;1;0;0;1080618;5970;944;4;1081763;3109;248;0;0
FR;4;2022-01-17;27;20;15;0;27;29;5;0;0;1080645;5990;959;4;1081790;3138;253;0;0
FR;4;2022-01-18;17;14;10;0;17;21;3;0;0;1080662;6004;969;4;1081807;3159;256;0;0
FR;4;2022-01-19;33;23;13;0;33;34;1;0;0;1080695;6027;982;4;1081840;3193;257;0;0
FR;4;2022-01-20;34;34;13;0;36;39;5;0;0;1080729;6061;995;4;1081876;3232;262;0;0
FR;4;2022-01-21;13;12;20;1;13;17;15;0;1;1080742;6073;1015;5;1081889;3249;277;0;1
FR;4;2022-01-22;30;13;3;0;30;14;2;0;0;1080772;6086;1018;5;1081919;3263;279;0;1
FR;4;2022-01-23;8;2;7;0;8;9;0;0;0;1080780;6088;1025;5;1081927;3272;279;0;1
FR;4;2022-01-24;14;21;9;0;15;28;1;0;0;1080794;6109;1034;5;1081942;3300;280;0;1
FR;4;2022-01-25;22;32;10;1;23;38;3;0;0;1080816;6141;1044;6;1081965;3338;283;0;1
FR;4;2022-01-26;20;17;9;1;21;21;4;0;0;1080836;6158;1053;7;1081986;3359;287;0;1
FR;4;2022-01-27;22;19;8;0;23;25;1;0;0;1080858;6177;1061;7;1082009;3384;288;0;1
FR;4;2022-01-28;14;23;8;0;15;26;4;0;0;1080872;6200;1069;7;1082024;3410;292;0;1
FR;4;2022-01-29;17;6;5;0;17;10;0;0;0;1080889;6206;1074;7;1082041;3420;292;0;1
FR;4;2022-01-30;19;3;2;0;19;5;0;0;0;1080908;6209;1076;7;1082060;3425;292;0;1
FR;4;2022-01-31;22;28;8;0;22;32;2;0;0;1080930;6237;1084;7;1082082;3457;294;0;1
FR;4;2022-02-01;13;24;13;0;15;25;9;0;0;1080943;6261;1097;7;1082097;3482;303;0;1
FR;4;2022-02-02;19;12;14;2;20;20;7;0;0;1080962;6273;1111;9;1082117;3502;310;0;1
FR;4;2022-02-03;16;24;11;0;18;29;4;0;0;1080978;6297;1122;9;1082135;3531;314;0;1
FR;4;2022-02-04;7;5;7;0;7;9;3;0;0;1080985;6302;1129;9;1082142;3540;317;0;1
FR;4;2022-02-05;7;14;1;0;8;13;1;0;0;1080992;6316;1130;9;1082150;3553;318;0;1
FR;4;2022-02-06;8;4;4;0;8;7;1;0;0;1081000;6320;1134;9;1082158;3560;319;0;1
FR;4;2022-02-07;15;20;8;0;17;20;6;0;0;1081015;6340;1142;9;1082175;3580;325;0;1
FR;4;2022-02-08;20;21;13;1;22;22;10;0;0;1081035;6361;1155;10;1082197;3602;335;0;1
FR;4;2022-02-09;18;12;9;0;19;17;2;0;0;1081053;6373;1164;10;1082216;3619;337;0;1
FR;4;2022-02-10;23;23;10;0;24;25;7;0;0;1081076;6396;1174;10;1082240;3644;344;0;1
FR;4;2022-02-11;18;15;8;0;18;20;3;0;0;1081094;6411;1182;10;1082258;3664;347;0;1
FR;4;2022-02-12;24;6;3;0;26;7;0;0;0;1081118;6417;1185;10;1082284;3671;347;0;1
FR;4;2022-02-13;7;3;3;0;7;6;0;0;0;1081125;6420;1188;10;1082291;3677;347;0;1
FR;4;2022-02-14;22;10;10;0;22;16;4;0;0;1081147;6430;1198;10;1082313;3693;351;0;1
FR;4;2022-02-15;18;7;2;0;18;8;0;0;0;1081165;6437;1200;10;1082331;3701;351;0;1
FR;4;2022-02-16;17;11;11;0;17;18;3;0;0;1081182;6448;1211;10;1082348;3719;354;0;1
FR;4;2022-02-17;11;4;5;0;11;7;2;0;0;1081193;6452;1216;10;1082359;3726;356;0;1
FR;4;2022-02-18;16;15;8;0;16;21;2;0;0;1081209;6467;1224;10;1082375;3747;358;0;1
FR;4;2022-02-19;16;4;2;0;17;5;0;0;0;1081225;6471;1226;10;1082392;3752;358;0;1
FR;4;2022-02-20;9;4;0;0;10;3;0;0;0;1081234;6475;1226;10;1082402;3755;358;0;1
FR;4;2022-02-21;24;5;4;0;24;7;2;0;0;1081258;6480;1230;10;1082426;3762;360;0;1
FR;4;2022-02-22;9;5;10;0;10;10;4;0;0;1081267;6485;1240;10;1082436;3772;364;0;1
FR;4;2022-02-23;17;6;10;0;17;10;5;0;0;1081284;6491;1250;10;1082453;3782;369;0;1
FR;4;2022-02-24;11;5;4;0;11;7;2;0;0;1081295;6496;1254;10;1082464;3789;371;0;1
FR;4;2022-02-25;17;5;7;0;17;6;6;0;0;1081312;6501;1261;10;1082481;3795;377;0;1
FR;4;2022-02-26;27;3;1;0;27;4;0;0;0;1081339;6504;1262;10;1082508;3799;377;0;1
FR;4;2022-02-27;9;0;1;0;9;1;0;0;0;1081348;6504;1263;10;1082517;3800;377;0;1
FR;4;2022-02-28;18;3;2;0;19;3;1;0;0;1081366;6507;1265;10;1082536;3803;378;0;1
FR;4;2022-03-01;8;4;7;0;8;5;5;0;0;1081374;6511;1272;10;1082544;3808;383;0;1
FR;4;2022-03-02;16;3;6;0;17;7;1;0;0;1081390;6514;1278;10;1082561;3815;384;0;1
FR;4;2022-03-03;19;5;3;0;19;6;1;0;0;1081409;6519;1281;10;1082580;3821;385;0;1
FR;4;2022-03-04;7;8;2;1;7;6;3;0;0;1081416;6527;1283;11;1082587;3827;388;0;1
FR;4;2022-03-05;9;2;0;0;9;2;0;0;0;1081425;6529;1283;11;1082596;3829;388;0;1
FR;4;2022-03-06;4;0;1;0;4;1;0;0;0;1081429;6529;1284;11;1082600;3830;388;0;1
FR;4;2022-03-07;11;6;2;0;11;5;2;0;0;1081440;6535;1286;11;1082611;3835;390;0;1
FR;4;2022-03-08;15;3;0;0;15;3;0;0;0;1081455;6538;1286;11;1082626;3838;390;0;1
FR;4;2022-03-09;9;7;2;0;11;7;0;0;0;1081464;6545;1288;11;1082637;3845;390;0;1
FR;4;2022-03-10;6;1;6;0;6;3;4;0;0;1081470;6546;1294;11;1082643;3848;394;0;1
FR;4;2022-03-11;10;4;5;0;12;2;5;0;0;1081480;6550;1299;11;1082655;3850;399;0;1
FR;4;2022-03-12;10;2;0;0;11;0;0;0;0;1081490;6552;1299;11;1082666;3850;399;0;1
FR;4;2022-03-13;6;2;1;0;7;2;0;0;0;1081496;6554;1300;11;1082673;3852;399;0;1
FR;4;2022-03-14;4;3;1;0;5;3;0;0;0;1081500;6557;1301;11;1082678;3855;399;0;1
FR;4;2022-03-15;8;8;3;0;10;7;2;0;0;1081508;6565;1304;11;1082688;3862;401;0;1
FR;4;2022-03-16;7;3;4;0;7;4;3;0;0;1081515;6568;1308;11;1082695;3866;404;0;1
FR;4;2022-03-17;4;4;1;0;4;5;0;0;0;1081519;6572;1309;11;1082699;3871;404;0;1
FR;4;2022-03-18;9;3;0;0;9;3;0;0;0;1081528;6575;1309;11;1082708;3874;404;0;1
FR;4;2022-03-19;1;1;1;0;1;2;0;0;0;1081529;6576;1310;11;1082709;3876;404;0;1
FR;4;2022-03-20;3;1;2;0;3;2;1;0;0;1081532;6577;1312;11;1082712;3878;405;0;1
FR;4;2022-03-21;6;4;1;0;6;5;0;0;0;1081538;6581;1313;11;1082718;3883;405;0;1
FR;4;2022-03-22;4;2;2;0;4;3;1;0;0;1081542;6583;1315;11;1082722;3886;406;0;1
FR;4;2022-03-23;6;4;5;0;6;8;1;0;0;1081548;6587;1320;11;1082728;3894;407;0;1
FR;4;2022-03-24;2;5;3;1;2;7;2;0;0;1081550;6592;1323;12;1082730;3901;409;0;1
FR;4;2022-03-25;4;1;2;0;4;1;2;0;0;1081554;6593;1325;12;1082734;3902;411;0;1
FR;4;2022-03-26;5;5;0;0;5;5;0;0;0;1081559;6598;1325;12;1082739;3907;411;0;1
FR;4;2022-03-27;1;0;3;0;1;2;1;0;0;1081560;6598;1328;12;1082740;3909;412;0;1
FR;4;2022-03-28;6;1;3;0;7;3;0;0;0;1081566;6599;1331;12;1082747;3912;412;0;1
FR;4;2022-03-29;9;0;4;1;9;0;2;0;0;1081575;6599;1335;13;1082756;3912;414;0;1
FR;4;2022-03-30;3;4;0;0;3;4;0;0;0;1081578;6603;1335;13;1082759;3916;414;0;1
FR;4;2022-03-31;5;3;2;1;5;4;1;0;0;1081583;6606;1337;14;1082764;3920;415;0;1
FR;4;2022-04-01;15;3;5;0;15;6;2;0;0;1081598;6609;1342;14;1082779;3926;417;0;1
FR;4;2022-04-02;4;4;0;0;5;3;0;0;0;1081602;6613;1342;14;1082784;3929;417;0;1
FR;4;2022-04-03;0;1;0;0;0;1;0;0;0;1081602;6614;1342;14;1082784;3930;417;0;1
FR;4;2022-04-04;4;4;4;0;5;5;2;0;0;1081606;6618;1346;14;1082789;3935;419;0;1
FR;4;2022-04-05;4;3;3;1;5;3;3;0;0;1081610;6621;1349;15;1082794;3938;422;0;1
FR;4;2022-04-06;6;1;0;0;6;1;0;0;0;1081616;6622;1349;15;1082800;3939;422;0;1
FR;4;2022-04-07;3;2;3;2;3;5;0;0;0;1081619;6624;1352;17;1082803;3944;422;0;1
FR;4;2022-04-08;4;2;1;0;4;2;1;0;0;1081623;6626;1353;17;1082807;3946;423;0;1
FR;4;2022-04-09;0;0;1;1;0;1;1;0;0;1081623;6626;1354;18;1082807;3947;424;0;1
FR;4;2022-04-10;2;2;0;0;2;2;0;0;0;1081625;6628;1354;18;1082809;3949;424;0;1
FR;4;2022-04-11;4;3;4;0;4;5;2;0;0;1081629;6631;1358;18;1082813;3954;426;0;1
FR;4;2022-04-12;6;1;4;0;6;2;3;0;0;1081635;6632;1362;18;1082819;3956;429;0;1
FR;4;2022-04-13;5;8;2;1;5;10;1;0;0;1081640;6640;1364;19;1082824;3966;430;0;1
FR;4;2022-04-14;6;4;2;1;7;5;1;0;0;1081646;6644;1366;20;1082831;3971;431;0;1
FR;4;2022-04-15;7;9;1;0;7;10;0;0;0;1081653;6653;1367;20;1082838;3981;431;0;1
FR;4;2022-04-16;1;0;0;0;1;0;0;0;0;1081654;6653;1367;20;1082839;3981;431;0;1
FR;4;2022-04-17;3;2;1;0;3;3;0;0;0;1081657;6655;1368;20;1082842;3984;431;0;1
FR;4;2022-04-18;2;2;6;0;2;4;4;0;0;1081659;6657;1374;20;1082844;3988;435;0;1
FR;4;2022-04-19;3;1;1;0;3;1;1;0;0;1081662;6658;1375;20;1082847;3989;436;0;1
FR;4;2022-04-20;15;4;1;1;16;3;1;0;0;1081677;6662;1376;21;1082863;3992;437;0;1
FR;4;2022-04-21;7;1;0;0;7;1;0;0;0;1081684;6663;1376;21;1082870;3993;437;0;1
FR;4;2022-04-22;1;1;2;0;1;2;1;0;0;1081685;6664;1378;21;1082871;3995;438;0;1
FR;4;2022-04-23;2;3;3;0;2;6;0;0;0;1081687;6667;1381;21;1082873;4001;438;0;1
FR;4;2022-04-24;0;3;0;0;0;3;0;0;0;1081687;6670;1381;21;1082873;4004;438;0;1
FR;4;2022-04-25;3;5;3;0;3;8;0;0;0;1081690;6675;1384;21;1082876;4012;438;0;1
FR;4;2022-04-26;5;6;1;0;5;6;1;0;0;1081695;6681;1385;21;1082881;4018;439;0;1
FR;4;2022-04-27;4;1;1;2;5;1;2;0;0;1081699;6682;1386;23;1082886;4019;441;0;1
FR;4;2022-04-28;3;5;5;1;3;7;4;0;0;1081702;6687;1391;24;1082889;4026;445;0;1
FR;4;2022-04-29;6;3;0;0;6;2;0;0;0;1081708;6690;1391;24;1082895;4028;445;0;1
FR;4;2022-04-30;2;1;1;0;2;2;0;0;0;1081710;6691;1392;24;1082897;4030;445;0;1
FR;4;2022-05-01;0;0;0;0;0;0;0;0;0;1081710;6691;1392;24;1082897;4030;445;0;1
FR;4;2022-05-02;5;16;6;0;5;19;3;0;0;1081715;6707;1398;24;1082902;4049;448;0;1
FR;4;2022-05-03;2;6;2;0;2;7;1;0;0;1081717;6713;1400;24;1082904;4056;449;0;1
FR;4;2022-05-04;7;4;1;0;7;4;1;0;0;1081724;6717;1401;24;1082911;4060;450;0;1
FR;4;2022-05-05;5;2;1;1;6;1;2;0;0;1081729;6719;1402;25;1082917;4061;452;0;1
FR;4;2022-05-06;5;3;1;0;6;2;1;0;0;1081734;6722;1403;25;1082923;4063;453;0;1
FR;4;2022-05-07;0;1;0;0;0;1;0;0;0;1081734;6723;1403;25;1082923;4064;453;0;1
FR;4;2022-05-08;1;1;0;0;1;1;0;0;0;1081735;6724;1403;25;1082924;4065;453;0;1
FR;4;2022-05-09;5;1;0;1;5;1;1;0;0;1081740;6725;1403;26;1082929;4066;454;0;1
FR;4;2022-05-10;3;1;0;2;3;3;0;0;0;1081743;6726;1403;28;1082932;4069;454;0;1
FR;4;2022-05-11;4;2;4;0;4;5;1;0;0;1081747;6728;1407;28;1082936;4074;455;0;1
FR;4;2022-05-12;7;4;2;1;7;5;1;0;1;1081754;6732;1409;29;1082943;4079;456;0;2
FR;4;2022-05-13;1;0;2;0;1;2;0;0;0;1081755;6732;1411;29;1082944;4081;456;0;2
FR;4;2022-05-14;0;2;0;0;0;2;0;0;0;1081755;6734;1411;29;1082944;4083;456;0;2
FR;4;2022-05-15;2;2;0;0;4;0;0;0;0;1081757;6736;1411;29;1082948;4083;456;0;2
FR;4;2022-05-16;5;2;2;0;5;2;2;0;0;1081762;6738;1413;29;1082953;4085;458;0;2
FR;4;2022-05-17;5;1;2;0;5;3;0;0;0;1081767;6739;1415;29;1082958;4088;458;0;2
FR;4;2022-05-18;3;6;0;0;3;6;0;0;0;1081770;6745;1415;29;1082961;4094;458;0;2
FR;4;2022-05-19;2;3;3;0;2;5;1;0;0;1081772;6748;1418;29;1082963;4099;459;0;2
FR;4;2022-05-20;5;2;3;0;5;2;3;0;0;1081777;6750;1421;29;1082968;4101;462;0;2
FR;4;2022-05-21;2;0;1;0;2;1;0;0;0;1081779;6750;1422;29;1082970;4102;462;0;2
FR;4;2022-05-22;0;0;1;0;0;1;0;0;0;1081779;6750;1423;29;1082970;4103;462;0;2
FR;4;2022-05-23;0;0;2;0;0;0;2;0;0;1081779;6750;1425;29;1082970;4103;464;0;2
FR;4;2022-05-24;2;4;1;0;2;5;0;0;0;1081781;6754;1426;29;1082972;4108;464;0;2
FR;4;2022-05-25;1;4;1;0;3;3;0;0;0;1081782;6758;1427;29;1082975;4111;464;0;2
FR;4;2022-05-26;5;0;1;0;5;1;0;0;0;1081787;6758;1428;29;1082980;4112;464;0;2
FR;4;2022-05-27;0;2;1;1;0;3;1;0;0;1081787;6760;1429;30;1082980;4115;465;0;2
FR;4;2022-05-28;1;0;0;0;1;0;0;0;0;1081788;6760;1429;30;1082981;4115;465;0;2
FR;4;2022-05-29;1;0;1;0;1;1;0;0;0;1081789;6760;1430;30;1082982;4116;465;0;2
FR;4;2022-05-30;3;4;2;0;3;5;1;0;0;1081792;6764;1432;30;1082985;4121;466;0;2
FR;4;2022-05-31;2;1;0;0;2;1;0;0;0;1081794;6765;1432;30;1082987;4122;466;0;2
FR;4;2022-06-01;5;11;7;0;5;15;3;0;0;1081799;6776;1439;30;1082992;4137;469;0;2
FR;4;2022-06-02;6;7;3;0;6;7;2;0;0;1081805;6783;1442;30;1082998;4144;471;0;2
FR;4;2022-06-03;2;6;4;1;2;7;4;0;0;1081807;6789;1446;31;1083000;4151;475;0;2
FR;4;2022-06-04;0;1;1;1;0;1;2;0;0;1081807;6790;1447;32;1083000;4152;477;0;2
FR;4;2022-06-05;1;0;0;0;1;0;0;0;0;1081808;6790;1447;32;1083001;4152;477;0;2
FR;4;2022-06-06;8;0;3;0;8;2;1;0;0;1081816;6790;1450;32;1083009;4154;478;0;2
FR;4;2022-06-07;7;2;0;1;7;2;1;0;0;1081823;6792;1450;33;1083016;4156;479;0;2
FR;4;2022-06-08;0;5;3;0;1;7;0;0;0;1081823;6797;1453;33;1083017;4163;479;0;2
FR;4;2022-06-09;1;2;0;0;2;1;0;0;0;1081824;6799;1453;33;1083019;4164;479;0;2
FR;4;2022-06-10;4;0;3;0;4;1;2;0;0;1081828;6799;1456;33;1083023;4165;481;0;2
FR;4;2022-06-11;1;0;0;0;1;0;0;0;0;1081829;6799;1456;33;1083024;4165;481;0;2
FR;4;2022-06-12;4;1;1;0;4;2;0;0;0;1081833;6800;1457;33;1083028;4167;481;0;2
FR;4;2022-06-13;6;2;3;0;7;2;1;0;0;1081839;6802;1460;33;1083035;4169;482;0;2
FR;4;2022-06-14;4;3;0;0;5;2;0;0;0;1081843;6805;1460;33;1083040;4171;482;0;2
FR;4;2022-06-15;10;3;4;0;10;3;4;0;0;1081853;6808;1464;33;1083050;4174;486;0;2
FR;4;2022-06-16;2;3;1;1;3;2;1;0;1;1081855;6811;1465;34;1083053;4176;487;0;3
FR;4;2022-06-17;6;1;0;0;6;1;0;0;0;1081861;6812;1465;34;1083059;4177;487;0;3
FR;4;2022-06-18;0;0;0;0;0;0;0;0;0;1081861;6812;1465;34;1083059;4177;487;0;3
FR;4;2022-06-19;3;0;0;0;3;0;0;0;0;1081864;6812;1465;34;1083062;4177;487;0;3
FR;4;2022-06-20;6;2;2;1;6;3;2;0;0;1081870;6814;1467;35;1083068;4180;489;0;3
FR;4;2022-06-21;5;2;4;1;6;4;2;0;0;1081875;6816;1471;36;1083074;4184;491;0;3
FR;4;2022-06-22;3;2;1;3;4;2;1;0;0;1081878;6818;1472;39;1083078;4186;492;0;3
FR;4;2022-06-23;3;3;3;0;3;5;1;0;0;1081881;6821;1475;39;1083081;4191;493;0;3
FR;4;2022-06-24;3;0;2;0;3;0;2;0;0;1081884;6821;1477;39;1083084;4191;495;0;3
FR;4;2022-06-25;3;0;1;1;3;1;1;0;0;1081887;6821;1478;40;1083087;4192;496;0;3
FR;4;2022-06-26;0;0;2;0;0;2;0;0;0;1081887;6821;1480;40;1083087;4194;496;0;3
FR;4;2022-06-27;2;2;1;3;2;3;3;0;0;1081889;6823;1481;43;1083089;4197;499;0;3
FR;4;2022-06-28;0;4;2;1;0;5;2;0;0;1081889;6827;1483;44;1083089;4202;501;0;3
FR;4;2022-06-29;1;2;0;0;1;2;0;0;0;1081890;6829;1483;44;1083090;4204;501;0;3
FR;4;2022-06-30;2;0;0;0;2;0;0;0;0;1081892;6829;1483;44;1083092;4204;501;0;3
FR;4;2022-07-01;3;4;8;0;3;4;8;0;0;1081895;6833;1491;44;1083095;4208;509;0;3
FR;4;2022-07-02;0;1;0;0;1;0;0;0;0;1081895;6834;1491;44;1083096;4208;509;0;3
FR;4;2022-07-03;0;0;0;0;0;0;0;0;0;1081895;6834;1491;44;1083096;4208;509;0;3
FR;4;2022-07-04;4;1;0;0;4;1;0;0;0;1081899;6835;1491;44;1083100;4209;509;0;3
FR;4;2022-07-05;4;1;3;0;4;3;1;0;0;1081903;6836;1494;44;1083104;4212;510;0;3
FR;4;2022-07-06;5;0;1;1;5;0;1;0;1;1081908;6836;1495;45;1083109;4212;511;0;4
FR;4;2022-07-07;2;1;2;1;2;1;3;0;0;1081910;6837;1497;46;1083111;4213;514;0;4
FR;4;2022-07-08;4;1;0;0;4;1;0;0;0;1081914;6838;1497;46;1083115;4214;514;0;4
FR;4;2022-07-09;2;2;1;0;2;3;0;0;0;1081916;6840;1498;46;1083117;4217;514;0;4
FR;4;2022-07-10;2;0;1;0;2;0;0;0;0;1081918;6840;1499;46;1083119;4217;514;0;4
FR;4;2022-07-11;3;0;2;0;3;0;1;0;0;1081921;6840;1501;46;1083122;4217;515;0;4
FR;4;2022-07-12;0;0;2;0;0;2;0;0;0;1081921;6840;1503;46;1083122;4219;515;0;4
FR;4;2022-07-13;4;2;3;1;4;2;4;0;0;1081925;6842;1506;47;1083126;4221;519;0;4
FR;4;2022-07-14;6;0;1;0;6;0;1;0;0;1081931;6842;1507;47;1083132;4221;520;0;4
FR;4;2022-07-15;11;2;0;0;11;2;0;0;0;1081942;6844;1507;47;1083143;4223;520;0;4
FR;4;2022-07-16;5;0;0;2;5;0;2;0;0;1081947;6844;1507;49;1083148;4223;522;0;4
FR;4;2022-07-17;1;0;1;1;1;0;2;0;0;1081948;6844;1508;50;1083149;4223;524;0;4
FR;4;2022-07-18;3;3;2;0;3;3;2;0;0;1081951;6847;1510;50;1083152;4226;526;0;4
FR;4;2022-07-19;5;0;1;0;5;1;0;0;0;1081956;6847;1511;50;1083157;4227;526;0;4
FR;4;2022-07-20;12;2;1;0;13;2;0;0;0;1081968;6849;1512;50;1083170;4229;526;0;4
FR;4;2022-07-21;2;3;1;0;2;3;1;0;0;1081970;6852;1513;50;1083172;4232;527;0;4
FR;4;2022-07-22;5;1;3;0;5;2;2;0;0;1081975;6853;1516;50;1083177;4234;529;0;4
FR;4;2022-07-23;1;2;0;0;1;1;0;0;0;1081976;6855;1516;50;1083178;4235;529;0;4
FR;4;2022-07-24;1;0;0;0;1;0;0;0;0;1081977;6855;1516;50;1083179;4235;529;0;4
FR;4;2022-07-25;7;0;2;1;7;2;1;0;0;1081984;6855;1518;51;1083186;4237;530;0;4
FR;4;2022-07-26;3;0;0;0;3;0;0;0;0;1081987;6855;1518;51;1083189;4237;530;0;4
FR;4;2022-07-27;3;1;0;0;3;0;0;0;0;1081990;6856;1518;51;1083192;4237;530;0;4
FR;4;2022-07-28;13;0;0;0;13;0;0;0;0;1082003;6856;1518;51;1083205;4237;530;0;4
FR;4;2022-07-29;3;0;2;0;3;1;1;0;0;1082006;6856;1520;51;1083208;4238;531;0;4
FR;4;2022-07-30;5;0;2;0;5;0;2;0;0;1082011;6856;1522;51;1083213;4238;533;0;4
FR;4;2022-07-31;0;0;0;0;0;0;0;0;0;1082011;6856;1522;51;1083213;4238;533;0;4
FR;4;2022-08-01;4;0;3;0;4;2;1;0;0;1082015;6856;1525;51;1083217;4240;534;0;4
FR;4;2022-08-02;7;0;0;0;7;0;0;0;0;1082022;6856;1525;51;1083224;4240;534;0;4
FR;4;2022-08-03;2;2;1;0;2;2;1;0;0;1082024;6858;1526;51;1083226;4242;535;0;4
FR;4;2022-08-04;5;2;0;1;5;2;1;0;0;1082029;6860;1526;52;1083231;4244;536;0;4
FR;4;2022-08-05;3;1;1;0;3;1;1;0;0;1082032;6861;1527;52;1083234;4245;537;0;4
FR;4;2022-08-06;2;0;0;0;2;0;0;0;0;1082034;6861;1527;52;1083236;4245;537;0;4
FR;4;2022-08-07;5;0;0;0;5;0;0;0;0;1082039;6861;1527;52;1083241;4245;537;0;4
FR;4;2022-08-08;2;0;1;1;2;1;1;0;0;1082041;6861;1528;53;1083243;4246;538;0;4
FR;4;2022-08-09;1;1;2;2;1;2;3;0;0;1082042;6862;1530;55;1083244;4248;541;0;4
FR;4;2022-08-10;6;1;1;0;7;1;0;0;0;1082048;6863;1531;55;1083251;4249;541;0;4
FR;4;2022-08-11;2;0;1;0;2;1;0;0;0;1082050;6863;1532;55;1083253;4250;541;0;4
FR;4;2022-08-12;4;0;1;0;4;0;1;0;0;1082054;6863;1533;55;1083257;4250;542;0;4
FR;4;2022-08-13;1;0;0;0;1;0;0;0;0;1082055;6863;1533;55;1083258;4250;542;0;4
FR;4;2022-08-14;1;0;0;0;1;0;0;0;0;1082056;6863;1533;55;1083259;4250;542;0;4
FR;4;2022-08-15;1;2;3;0;1;2;3;0;0;1082057;6865;1536;55;1083260;4252;545;0;4
FR;4;2022-08-16;0;0;1;0;0;1;0;0;0;1082057;6865;1537;55;1083260;4253;545;0;4
FR;4;2022-08-17;3;0;0;0;3;0;0;0;0;1082060;6865;1537;55;1083263;4253;545;0;4
FR;4;2022-08-18;6;0;0;0;6;0;0;0;0;1082066;6865;1537;55;1083269;4253;545;0;4
FR;4;2022-08-19;5;0;0;0;5;0;0;0;0;1082071;6865;1537;55;1083274;4253;545;0;4
FR;4;2022-08-20;3;1;0;0;4;0;0;0;0;1082074;6866;1537;55;1083278;4253;545;0;4
FR;4;2022-08-21;1;0;0;0;1;0;0;0;0;1082075;6866;1537;55;1083279;4253;545;0;4
FR;4;2022-08-22;3;9;0;0;3;9;0;0;0;1082078;6875;1537;55;1083282;4262;545;0;4
FR;4;2022-08-23;3;3;3;0;3;4;2;0;0;1082081;6878;1540;55;1083285;4266;547;0;4
FR;4;2022-08-24;6;0;0;1;6;0;1;0;0;1082087;6878;1540;56;1083291;4266;548;0;4
FR;4;2022-08-25;1;3;2;0;1;4;1;0;0;1082088;6881;1542;56;1083292;4270;549;0;4
FR;4;2022-08-26;6;0;0;1;6;0;1;0;0;1082094;6881;1542;57;1083298;4270;550;0;4
FR;4;2022-08-27;1;0;0;0;1;0;0;0;0;1082095;6881;1542;57;1083299;4270;550;0;4
FR;4;2022-08-28;0;1;0;0;0;0;0;0;0;1082095;6882;1542;57;1083299;4270;550;0;4
FR;4;2022-08-29;8;0;0;0;8;0;0;0;0;1082103;6882;1542;57;1083307;4270;550;0;4
FR;4;2022-08-30;5;1;0;0;5;1;0;0;0;1082108;6883;1542;57;1083312;4271;550;0;4
FR;4;2022-08-31;3;1;0;0;3;1;0;0;0;1082111;6884;1542;57;1083315;4272;550;0;4
FR;4;2022-09-01;4;8;2;0;5;7;2;0;0;1082115;6892;1544;57;1083320;4279;552;0;4
FR;4;2022-09-02;2;2;1;0;3;2;0;0;0;1082117;6894;1545;57;1083323;4281;552;0;4
FR;4;2022-09-03;3;0;0;0;3;0;0;0;0;1082120;6894;1545;57;1083326;4281;552;0;4
FR;4;2022-09-04;1;0;0;0;1;0;0;0;0;1082121;6894;1545;57;1083327;4281;552;0;4
FR;4;2022-09-05;4;2;0;0;4;2;0;0;0;1082125;6896;1545;57;1083331;4283;552;0;4
FR;4;2022-09-06;1;0;0;0;1;0;0;0;0;1082126;6896;1545;57;1083332;4283;552;0;4
FR;4;2022-09-07;2;0;1;1;2;1;1;0;0;1082128;6896;1546;58;1083334;4284;553;0;4
FR;4;2022-09-08;3;0;0;0;3;0;0;0;0;1082131;6896;1546;58;1083337;4284;553;0;4
FR;4;2022-09-09;2;2;0;0;2;2;0;0;0;1082133;6898;1546;58;1083339;4286;553;0;4
FR;4;2022-09-10;0;1;0;3;0;2;2;0;0;1082133;6899;1546;61;1083339;4288;555;0;4
FR;4;2022-09-11;2;0;0;0;2;0;0;0;0;1082135;6899;1546;61;1083341;4288;555;0;4
FR;4;2022-09-12;1;1;1;0;1;1;1;0;0;1082136;6900;1547;61;1083342;4289;556;0;4
FR;4;2022-09-13;1;0;0;0;1;0;0;0;0;1082137;6900;1547;61;1083343;4289;556;0;4
FR;4;2022-09-14;4;0;0;0;4;0;0;0;0;1082141;6900;1547;61;1083347;4289;556;0;4
FR;4;2022-09-15;5;0;0;0;5;0;0;0;0;1082146;6900;1547;61;1083352;4289;556;0;4
FR;4;2022-09-16;1;0;0;0;1;0;0;0;0;1082147;6900;1547;61;1083353;4289;556;0;4
FR;4;2022-09-17;2;0;0;0;2;0;0;0;0;1082149;6900;1547;61;1083355;4289;556;0;4
FR;4;2022-09-18;0;1;0;0;0;1;0;0;0;1082149;6901;1547;61;1083355;4290;556;0;4
FR;4;2022-09-19;4;0;2;0;4;2;0;0;0;1082153;6901;1549;61;1083359;4292;556;0;4
FR;4;2022-09-20;4;0;0;0;4;0;0;0;0;1082157;6901;1549;61;1083363;4292;556;0;4
FR;4;2022-09-21;2;1;0;0;2;1;0;0;0;1082159;6902;1549;61;1083365;4293;556;0;4
FR;4;2022-09-22;2;1;0;0;2;1;0;0;0;1082161;6903;1549;61;1083367;4294;556;0;4
FR;4;2022-09-23;2;3;0;0;3;2;0;0;0;1082163;6906;1549;61;1083370;4296;556;0;4
FR;4;2022-09-24;1;0;0;0;1;0;0;0;0;1082164;6906;1549;61;1083371;4296;556;0;4
FR;4;2022-09-25;0;0;0;0;0;0;0;0;0;1082164;6906;1549;61;1083371;4296;556;0;4
FR;4;2022-09-26;2;0;1;0;2;0;1;0;0;1082166;6906;1550;61;1083373;4296;557;0;4
FR;4;2022-09-27;1;0;1;1;1;0;2;0;0;1082167;6906;1551;62;1083374;4296;559;0;4
FR;4;2022-09-28;3;0;2;0;3;2;0;0;0;1082170;6906;1553;62;1083377;4298;559;0;4
FR;4;2022-09-29;5;0;1;1;5;1;1;0;0;1082175;6906;1554;63;1083382;4299;560;0;4
FR;4;2022-09-30;1;1;0;0;1;1;0;0;0;1082176;6907;1554;63;1083383;4300;560;0;4
FR;4;2022-10-01;1;1;0;0;2;0;0;0;0;1082177;6908;1554;63;1083385;4300;560;0;4
FR;4;2022-10-02;0;1;0;0;0;1;0;0;0;1082177;6909;1554;63;1083385;4301;560;0;4
FR;4;2022-10-03;2;3;1;1;3;3;1;0;0;1082179;6912;1555;64;1083388;4304;561;0;4
FR;4;2022-10-04;3;0;0;0;3;0;0;0;0;1082182;6912;1555;64;1083391;4304;561;0;4
FR;4;2022-10-05;0;1;0;0;0;1;0;0;0;1082182;6913;1555;64;1083391;4305;561;0;4
FR;4;2022-10-06;2;0;0;0;2;0;0;0;0;1082184;6913;1555;64;1083393;4305;561;0;4
FR;4;2022-10-07;3;1;1;0;3;1;1;0;0;1082187;6914;1556;64;1083396;4306;562;0;4
FR;4;2022-10-08;4;1;0;0;4;0;0;0;0;1082191;6915;1556;64;1083400;4306;562;0;4
FR;4;2022-10-09;0;0;0;0;0;0;0;0;0;1082191;6915;1556;64;1083400;4306;562;0;4
FR;4;2022-10-10;5;0;2;3;5;2;1;0;2;1082196;6915;1558;67;1083405;4308;563;0;6
FR;4;2022-10-11;2;2;0;0;2;1;0;0;0;1082198;6917;1558;67;1083407;4309;563;0;6
FR;4;2022-10-12;1;0;0;0;1;0;0;0;0;1082199;6917;1558;67;1083408;4309;563;0;6
FR;4;2022-10-13;5;0;0;0;5;0;0;0;0;1082204;6917;1558;67;1083413;4309;563;0;6
FR;4;2022-10-14;1;1;0;0;1;1;0;0;0;1082205;6918;1558;67;1083414;4310;563;0;6
FR;4;2022-10-15;1;2;0;0;1;2;0;0;0;1082206;6920;1558;67;1083415;4312;563;0;6
FR;4;2022-10-16;0;0;0;0;0;0;0;0;0;1082206;6920;1558;67;1083415;4312;563;0;6
FR;4;2022-10-17;3;0;1;0;3;1;0;0;0;1082209;6920;1559;67;1083418;4313;563;0;6
FR;4;2022-10-18;1;0;0;1;1;0;1;0;0;1082210;6920;1559;68;1083419;4313;564;0;6
FR;4;2022-10-19;1;0;0;2;1;0;2;0;3;1082211;6920;1559;70;1083420;4313;566;0;9
FR;4;2022-10-20;4;1;0;0;4;1;0;0;0;1082215;6921;1559;70;1083424;4314;566;0;9
FR;4;2022-10-21;3;1;0;0;3;1;0;0;0;1082218;6922;1559;70;1083427;4315;566;0;9
FR;4;2022-10-22;1;0;0;0;1;0;0;0;0;1082219;6922;1559;70;1083428;4315;566;0;9
FR;4;2022-10-23;0;0;0;0;0;0;0;0;0;1082219;6922;1559;70;1083428;4315;566;0;9
FR;4;2022-10-24;3;0;0;0;3;0;0;0;0;1082222;6922;1559;70;1083431;4315;566;0;9
FR;4;2022-10-25;4;0;0;0;4;0;0;0;0;1082226;6922;1559;70;1083435;4315;566;0;9
FR;4;2022-10-26;2;1;0;0;2;1;0;0;0;1082228;6923;1559;70;1083437;4316;566;0;9
FR;4;2022-10-27;3;1;1;0;3;0;1;0;0;1082231;6924;1560;70;1083440;4316;567;0;9
FR;4;2022-10-28;0;0;0;0;0;0;0;0;0;1082231;6924;1560;70;1083440;4316;567;0;9
FR;4;2022-10-29;1;0;0;3;1;0;3;0;3;1082232;6924;1560;73;1083441;4316;570;0;12
FR;4;2022-10-30;1;0;0;0;1;0;0;0;0;1082233;6924;1560;73;1083442;4316;570;0;12
FR;4;2022-10-31;1;0;0;0;1;0;0;0;0;1082234;6924;1560;73;1083443;4316;570;0;12
FR;4;2022-11-01;1;6;0;0;1;6;0;0;0;1082235;6930;1560;73;1083444;4322;570;0;12
FR;4;2022-11-02;0;0;2;2;0;1;3;0;0;1082235;6930;1562;75;1083444;4323;573;0;12
FR;4;2022-11-03;1;0;0;0;1;0;0;0;0;1082236;6930;1562;75;1083445;4323;573;0;12
FR;4;2022-11-04;4;1;0;0;4;0;0;0;0;1082240;6931;1562;75;1083449;4323;573;0;12
FR;4;2022-11-05;0;0;0;0;0;0;0;0;0;1082240;6931;1562;75;1083449;4323;573;0;12
FR;4;2022-11-06;2;0;0;0;2;0;0;0;0;1082242;6931;1562;75;1083451;4323;573;0;12
FR;4;2022-11-07;2;0;0;0;2;0;0;0;0;1082244;6931;1562;75;1083453;4323;573;0;12
FR;4;2022-11-08;7;0;0;0;7;0;0;0;0;1082251;6931;1562;75;1083460;4323;573;0;12
FR;4;2022-11-09;0;0;0;0;0;0;0;0;0;1082251;6931;1562;75;1083460;4323;573;0;12
FR;4;2022-11-10;2;0;1;0;2;1;0;0;0;1082253;6931;1563;75;1083462;4324;573;0;12
FR;4;2022-11-11;1;0;0;0;1;0;0;0;0;1082254;6931;1563;75;1083463;4324;573;0;12
FR;4;2022-11-12;3;1;0;0;3;1;0;0;0;1082257;6932;1563;75;1083466;4325;573;0;12
FR;4;2022-11-13;2;0;0;0;2;0;0;0;0;1082259;6932;1563;75;1083468;4325;573;0;12
FR;4;2022-11-14;0;1;0;0;0;1;0;0;0;1082259;6933;1563;75;1083468;4326;573;0;12
FR;4;2022-11-15;3;1;0;0;3;1;0;0;0;1082262;6934;1563;75;1083471;4327;573;0;12
FR;4;2022-11-16;1;1;1;0;1;1;1;0;0;1082263;6935;1564;75;1083472;4328;574;0;12
FR;4;2022-11-17;0;2;0;0;0;2;0;0;0;1082263;6937;1564;75;1083472;4330;574;0;12
FR;4;2022-11-18;5;0;1;0;5;0;1;0;0;1082268;6937;1565;75;1083477;4330;575;0;12
FR;4;2022-11-19;0;0;0;0;0;0;0;0;0;1082268;6937;1565;75;1083477;4330;575;0;12
FR;4;2022-11-20;0;0;0;1;0;0;0;0;1;1082268;6937;1565;76;1083477;4330;575;0;13
FR;4;2022-11-21;0;0;0;0;0;0;0;0;0;1082268;6937;1565;76;1083477;4330;575;0;13
FR;4;2022-11-22;0;1;1;0;0;2;0;0;0;1082268;6938;1566;76;1083477;4332;575;0;13
FR;4;2022-11-23;1;0;0;0;1;0;0;0;1;1082269;6938;1566;76;1083478;4332;575;0;14
FR;4;2022-11-24;0;2;0;0;0;2;0;0;0;1082269;6940;1566;76;1083478;4334;575;0;14
FR;4;2022-11-25;3;4;0;0;3;4;0;0;0;1082272;6944;1566;76;1083481;4338;575;0;14
FR;4;2022-11-26;1;0;0;0;1;0;0;0;0;1082273;6944;1566;76;1083482;4338;575;0;14
FR;4;2022-11-27;0;0;0;0;0;0;0;0;0;1082273;6944;1566;76;1083482;4338;575;0;14
FR;4;2022-11-28;4;0;0;0;4;0;0;0;0;1082277;6944;1566;76;1083486;4338;575;0;14
FR;4;2022-11-29;3;0;0;0;3;0;0;0;0;1082280;6944;1566;76;1083489;4338;575;0;14
FR;4;2022-11-30;0;0;0;0;0;0;0;0;0;1082280;6944;1566;76;1083489;4338;575;0;14
FR;4;2022-12-01;1;2;2;0;2;2;1;0;0;1082281;6946;1568;76;1083491;4340;576;0;14
FR;4;2022-12-02;6;1;0;1;6;1;0;0;1;1082287;6947;1568;77;1083497;4341;576;0;15
FR;4;2022-12-03;1;0;0;0;1;0;0;0;0;1082288;6947;1568;77;1083498;4341;576;0;15
FR;4;2022-12-04;0;0;0;0;0;0;0;0;0;1082288;6947;1568;77;1083498;4341;576;0;15
FR;4;2022-12-05;3;1;0;0;3;1;0;0;0;1082291;6948;1568;77;1083501;4342;576;0;15
FR;4;2022-12-06;2;0;0;0;2;0;0;0;0;1082293;6948;1568;77;1083503;4342;576;0;15
FR;4;2022-12-07;2;3;1;0;2;4;0;0;0;1082295;6951;1569;77;1083505;4346;576;0;15
FR;4;2022-12-08;1;0;0;0;1;0;0;0;0;1082296;6951;1569;77;1083506;4346;576;0;15
FR;4;2022-12-09;2;0;1;0;2;0;1;0;0;1082298;6951;1570;77;1083508;4346;577;0;15
FR;4;2022-12-10;1;0;0;0;1;0;0;0;0;1082299;6951;1570;77;1083509;4346;577;0;15
FR;4;2022-12-11;0;0;0;0;0;0;0;0;0;1082299;6951;1570;77;1083509;4346;577;0;15
FR;4;2022-12-12;2;1;0;5;2;1;5;0;0;1082301;6952;1570;82;1083511;4347;582;0;15
FR;4;2022-12-13;2;0;0;0;2;0;0;0;0;1082303;6952;1570;82;1083513;4347;582;0;15
FR;4;2022-12-14;0;0;0;0;0;0;0;0;0;1082303;6952;1570;82;1083513;4347;582;0;15
FR;4;2022-12-15;1;1;0;0;1;1;0;0;0;1082304;6953;1570;82;1083514;4348;582;0;15
FR;4;2022-12-16;2;0;0;0;2;0;0;0;0;1082306;6953;1570;82;1083516;4348;582;0;15
FR;4;2022-12-17;0;0;1;0;0;0;1;0;0;1082306;6953;1571;82;1083516;4348;583;0;15
FR;4;2022-12-18;1;0;0;0;1;0;0;0;0;1082307;6953;1571;82;1083517;4348;583;0;15
FR;4;2022-12-19;1;0;0;0;1;0;0;0;0;1082308;6953;1571;82;1083518;4348;583;0;15
FR;4;2022-12-20;4;2;0;0;5;1;0;0;0;1082312;6955;1571;82;1083523;4349;583;0;15
FR;4;2022-12-21;6;0;0;0;6;0;0;0;0;1082318;6955;1571;82;1083529;4349;583;0;15
FR;4;2022-12-22;2;1;0;0;2;1;0;0;0;1082320;6956;1571;82;1083531;4350;583;0;15
FR;4;2022-12-23;3;0;0;0;3;0;0;0;0;1082323;6956;1571;82;1083534;4350;583;0;15
FR;4;2022-12-24;0;0;1;0;0;1;0;0;0;1082323;6956;1572;82;1083534;4351;583;0;15
FR;4;2022-12-25;0;0;0;0;0;0;0;0;0;1082323;6956;1572;82;1083534;4351;583;0;15
FR;4;2022-12-26;1;2;0;0;1;1;0;0;0;1082324;6958;1572;82;1083535;4352;583;0;15
FR;4;2022-12-27;1;1;0;0;1;1;0;0;0;1082325;6959;1572;82;1083536;4353;583;0;15
FR;4;2022-12-28;0;0;0;0;0;0;0;0;0;1082325;6959;1572;82;1083536;4353;583;0;15
FR;4;2022-12-29;0;1;0;0;1;0;0;0;0;1082325;6960;1572;82;1083537;4353;583;0;15
FR;4;2022-12-30;1;0;0;0;1;0;0;0;0;1082326;6960;1572;82;1083538;4353;583;0;15
FR;4;2022-12-31;0;0;0;0;0;0;0;0;0;1082326;6960;1572;82;1083538;4353;583;0;15
FR;4;2023-01-01;0;0;0;0;0;0;0;0;0;1082326;6960;1572;82;1083538;4353;583;0;15
FR;4;2023-01-02;2;0;2;0;2;1;1;0;0;1082328;6960;1574;82;1083540;4354;584;0;15
FR;4;2023-01-03;1;1;0;0;1;1;0;0;0;1082329;6961;1574;82;1083541;4355;584;0;15
FR;4;2023-01-04;0;0;0;0;0;0;0;0;0;1082329;6961;1574;82;1083541;4355;584;0;15
FR;4;2023-01-05;0;0;0;0;0;0;0;0;0;1082329;6961;1574;82;1083541;4355;584;0;15
FR;4;2023-01-06;1;1;3;0;1;4;0;0;0;1082330;6962;1577;82;1083542;4359;584;0;15
FR;4;2023-01-07;1;0;0;0;1;0;0;0;0;1082331;6962;1577;82;1083543;4359;584;0;15
FR;4;2023-01-08;1;0;0;0;1;0;0;0;0;1082332;6962;1577;82;1083544;4359;584;0;15
FR;4;2023-01-09;1;0;0;0;1;0;0;0;0;1082333;6962;1577;82;1083545;4359;584;0;15
FR;4;2023-01-10;2;1;0;0;2;1;0;0;0;1082335;6963;1577;82;1083547;4360;584;0;15
FR;4;2023-01-11;0;0;0;0;0;0;0;0;0;1082335;6963;1577;82;1083547;4360;584;0;15
FR;4;2023-01-12;3;2;0;0;3;2;0;0;0;1082338;6965;1577;82;1083550;4362;584;0;15
FR;4;2023-01-13;3;0;2;0;3;0;2;0;0;1082341;6965;1579;82;1083553;4362;586;0;15
FR;4;2023-01-14;0;0;1;0;0;0;1;0;0;1082341;6965;1580;82;1083553;4362;587;0;15
FR;4;2023-01-15;0;0;0;0;0;0;0;0;0;1082341;6965;1580;82;1083553;4362;587;0;15
FR;4;2023-01-16;3;0;0;0;3;0;0;0;0;1082344;6965;1580;82;1083556;4362;587;0;15
FR;4;2023-01-17;2;0;0;0;2;0;0;0;0;1082346;6965;1580;82;1083558;4362;587;0;15
FR;4;2023-01-18;3;0;0;0;3;0;0;0;0;1082349;6965;1580;82;1083561;4362;587;0;15
FR;4;2023-01-19;1;0;0;2;1;0;0;0;0;1082350;6965;1580;84;1083562;4362;587;0;15
FR;4;2023-01-20;0;0;0;0;0;0;0;0;0;1082350;6965;1580;84;1083562;4362;587;0;15
FR;4;2023-01-21;0;0;0;0;0;0;0;0;0;1082350;6965;1580;84;1083562;4362;587;0;15
FR;4;2023-01-22;0;0;0;0;0;0;0;0;0;1082350;6965;1580;84;1083562;4362;587;0;15
FR;4;2023-01-23;1;0;0;0;1;0;0;0;0;1082351;6965;1580;84;1083563;4362;587;0;15
FR;4;2023-01-24;3;1;0;0;3;1;0;0;0;1082354;6966;1580;84;1083566;4363;587;0;15
FR;4;2023-01-25;6;0;0;0;6;0;0;0;0;1082360;6966;1580;84;1083572;4363;587;0;15
FR;4;2023-01-26;1;0;1;0;1;1;0;0;0;1082361;6966;1581;84;1083573;4364;587;0;15
FR;4;2023-01-27;0;0;0;0;0;0;0;0;0;1082361;6966;1581;84;1083573;4364;587;0;15
FR;4;2023-01-28;0;0;0;0;0;0;0;0;0;1082361;6966;1581;84;1083573;4364;587;0;15
FR;4;2023-01-29;0;0;0;0;0;0;0;0;0;1082361;6966;1581;84;1083573;4364;587;0;15
FR;4;2023-01-30;0;0;0;0;0;0;0;0;0;1082361;6966;1581;84;1083573;4364;587;0;15
FR;4;2023-01-31;0;0;0;0;0;0;0;0;0;1082361;6966;1581;84;1083573;4364;587;0;15
FR;4;2023-02-01;0;0;0;0;0;0;0;0;0;1082361;6966;1581;84;1083573;4364;587;0;15
FR;4;2023-02-02;3;2;2;1;3;3;1;0;0;1082364;6968;1583;85;1083576;4367;588;0;15
FR;4;2023-02-03;0;0;0;0;0;0;0;0;0;1082364;6968;1583;85;1083576;4367;588;0;15
FR;4;2023-02-04;1;0;0;0;1;0;0;0;0;1082365;6968;1583;85;1083577;4367;588;0;15
FR;4;2023-02-05;0;0;0;0;0;0;0;0;0;1082365;6968;1583;85;1083577;4367;588;0;15
FR;4;2023-02-06;1;0;0;0;1;0;0;0;0;1082366;6968;1583;85;1083578;4367;588;0;15
FR;4;2023-02-07;2;0;0;0;2;0;0;0;0;1082368;6968;1583;85;1083580;4367;588;0;15
FR;4;2023-02-08;2;1;0;0;2;0;0;0;0;1082370;6969;1583;85;1083582;4367;588;0;15
FR;4;2023-02-09;1;1;0;0;1;1;0;0;0;1082371;6970;1583;85;1083583;4368;588;0;15
FR;4;2023-02-10;5;1;0;0;5;0;0;0;0;1082376;6971;1583;85;1083588;4368;588;0;15
FR;4;2023-02-11;4;0;0;0;4;0;0;0;0;1082380;6971;1583;85;1083592;4368;588;0;15
FR;4;2023-02-12;0;0;0;0;0;0;0;0;0;1082380;6971;1583;85;1083592;4368;588;0;15
FR;4;2023-02-13;3;0;0;0;3;0;0;0;0;1082383;6971;1583;85;1083595;4368;588;0;15
FR;4;2023-02-14;0;2;0;0;2;0;0;0;0;1082383;6973;1583;85;1083597;4368;588;0;15
FR;4;2023-02-15;2;0;0;0;2;0;0;0;0;1082385;6973;1583;85;1083599;4368;588;0;15
FR;4;2023-02-16;1;1;0;0;1;1;0;0;0;1082386;6974;1583;85;1083600;4369;588;0;15
FR;4;2023-02-17;1;0;0;0;1;0;0;0;0;1082387;6974;1583;85;1083601;4369;588;0;15
FR;4;2023-02-18;0;2;0;0;0;2;0;0;0;1082387;6976;1583;85;1083601;4371;588;0;15
FR;4;2023-02-19;0;0;0;0;0;0;0;0;0;1082387;6976;1583;85;1083601;4371;588;0;15
FR;4;2023-02-20;1;0;0;0;1;0;0;0;0;1082388;6976;1583;85;1083602;4371;588;0;15
FR;4;2023-02-21;2;0;0;0;2;0;0;0;0;1082390;6976;1583;85;1083604;4371;588;0;15
FR;4;2023-02-22;0;0;0;0;0;0;0;0;0;1082390;6976;1583;85;1083604;4371;588;0;15
FR;4;2023-02-23;0;0;0;0;0;0;0;0;0;1082390;6976;1583;85;1083604;4371;588;0;15
FR;4;2023-02-24;1;0;0;0;1;0;0;0;0;1082391;6976;1583;85;1083605;4371;588;0;15
FR;4;2023-02-25;2;1;0;0;2;1;0;0;0;1082393;6977;1583;85;1083607;4372;588;0;15
FR;4;2023-02-26;0;0;0;0;0;0;0;0;0;1082393;6977;1583;85;1083607;4372;588;0;15
FR;4;2023-02-27;1;0;0;0;1;0;0;0;0;1082394;6977;1583;85;1083608;4372;588;0;15
FR;4;2023-02-28;0;0;0;0;0;0;0;0;0;1082394;6977;1583;85;1083608;4372;588;0;15
FR;4;2023-03-01;1;0;0;0;1;0;0;0;0;1082395;6977;1583;85;1083609;4372;588;0;15
FR;4;2023-03-02;1;1;2;0;1;1;2;0;0;1082396;6978;1585;85;1083610;4373;590;0;15
FR;4;2023-03-03;1;0;0;0;1;0;0;0;0;1082397;6978;1585;85;1083611;4373;590;0;15
FR;4;2023-03-04;0;0;0;0;0;0;0;0;0;1082397;6978;1585;85;1083611;4373;590;0;15
FR;4;2023-03-05;0;0;0;0;0;0;0;0;0;1082397;6978;1585;85;1083611;4373;590;0;15
FR;4;2023-03-06;0;0;0;0;0;0;0;0;0;1082397;6978;1585;85;1083611;4373;590;0;15
FR;4;2023-03-07;0;0;0;0;0;0;0;0;0;1082397;6978;1585;85;1083611;4373;590;0;15
FR;4;2023-03-08;1;0;0;0;1;0;0;0;0;1082398;6978;1585;85;1083612;4373;590;0;15
FR;4;2023-03-09;0;0;0;0;0;0;0;0;0;1082398;6978;1585;85;1083612;4373;590;0;15
FR;4;2023-03-10;2;0;1;0;2;0;1;0;0;1082400;6978;1586;85;1083614;4373;591;0;15
FR;4;2023-03-11;0;0;0;0;0;0;0;0;0;1082400;6978;1586;85;1083614;4373;591;0;15
FR;4;2023-03-12;0;0;0;0;0;0;0;0;0;1082400;6978;1586;85;1083614;4373;591;0;15
FR;4;2023-03-13;0;0;0;0;0;0;0;0;0;1082400;6978;1586;85;1083614;4373;591;0;15
FR;4;2023-03-14;0;0;0;0;0;0;0;0;0;1082400;6978;1586;85;1083614;4373;591;0;15
FR;4;2023-03-15;1;0;0;1;1;0;0;0;1;1082401;6978;1586;86;1083615;4373;591;0;16
FR;4;2023-03-16;1;0;0;0;1;0;0;0;0;1082402;6978;1586;86;1083616;4373;591;0;16
FR;4;2023-03-17;1;0;0;0;1;0;0;0;0;1082403;6978;1586;86;1083617;4373;591;0;16
FR;4;2023-03-18;0;1;0;0;0;1;0;0;0;1082403;6979;1586;86;1083617;4374;591;0;16
FR;4;2023-03-19;0;0;0;0;0;0;0;0;0;1082403;6979;1586;86;1083617;4374;591;0;16
FR;4;2023-03-20;0;0;0;0;0;0;0;0;0;1082403;6979;1586;86;1083617;4374;591;0;16
FR;4;2023-03-21;2;0;0;0;2;0;0;0;0;1082405;6979;1586;86;1083619;4374;591;0;16
FR;4;2023-03-22;0;0;1;0;0;0;1;0;0;1082405;6979;1587;86;1083619;4374;592;0;16
FR;4;2023-03-23;1;0;0;0;1;0;0;0;0;1082406;6979;1587;86;1083620;4374;592;0;16
FR;4;2023-03-24;0;0;0;0;0;0;0;0;0;1082406;6979;1587;86;1083620;4374;592;0;16
FR;4;2023-03-25;0;0;0;0;0;0;0;0;0;1082406;6979;1587;86;1083620;4374;592;0;16
FR;4;2023-03-26;0;0;0;0;0;0;0;0;0;1082406;6979;1587;86;1083620;4374;592;0;16
FR;4;2023-03-27;1;0;0;0;1;0;0;0;0;1082407;6979;1587;86;1083621;4374;592;0;16
FR;4;2023-03-28;1;0;0;0;1;0;0;0;0;1082408;6979;1587;86;1083622;4374;592;0;16
FR;4;2023-03-29;2;0;0;0;2;0;0;0;0;1082410;6979;1587;86;1083624;4374;592;0;16
FR;4;2023-03-30;0;1;0;0;1;0;0;0;0;1082410;6980;1587;86;1083625;4374;592;0;16
FR;4;2023-03-31;3;0;0;1;3;0;0;0;4;1082413;6980;1587;87;1083628;4374;592;0;20
FR;4;2023-04-01;2;0;0;0;2;0;0;0;0;1082415;6980;1587;87;1083630;4374;592;0;20
FR;4;2023-04-02;0;0;0;0;0;0;0;0;0;1082415;6980;1587;87;1083630;4374;592;0;20
FR;4;2023-04-03;0;0;0;0;0;0;0;0;0;1082415;6980;1587;87;1083630;4374;592;0;20
FR;4;2023-04-04;0;0;0;0;0;0;0;0;0;1082415;6980;1587;87;1083630;4374;592;0;20
FR;4;2023-04-05;0;0;0;0;0;0;0;0;0;1082415;6980;1587;87;1083630;4374;592;0;20
FR;4;2023-04-06;0;0;0;0;0;0;0;0;0;1082415;6980;1587;87;1083630;4374;592;0;20
FR;4;2023-04-07;0;0;0;0;0;0;0;0;0;1082415;6980;1587;87;1083630;4374;592;0;20
FR;4;2023-04-08;0;0;0;0;0;0;0;0;0;1082415;6980;1587;87;1083630;4374;592;0;20
FR;4;2023-04-09;0;0;0;0;0;0;0;0;0;1082415;6980;1587;87;1083630;4374;592;0;20
FR;4;2023-04-10;1;0;0;0;1;0;0;0;0;1082416;6980;1587;87;1083631;4374;592;0;20
FR;4;2023-04-11;0;0;0;0;0;0;0;0;0;1082416;6980;1587;87;1083631;4374;592;0;20
FR;4;2023-04-12;1;0;0;0;1;0;0;0;0;1082417;6980;1587;87;1083632;4374;592;0;20
FR;4;2023-04-13;0;0;0;0;0;0;0;0;0;1082417;6980;1587;87;1083632;4374;592;0;20
FR;4;2023-04-14;0;0;0;0;0;0;0;0;0;1082417;6980;1587;87;1083632;4374;592;0;20
FR;4;2023-04-15;0;0;0;0;0;0;0;0;0;1082417;6980;1587;87;1083632;4374;592;0;20
FR;4;2023-04-16;0;0;0;0;0;0;0;0;0;1082417;6980;1587;87;1083632;4374;592;0;20
FR;4;2023-04-17;0;0;0;0;0;0;0;0;0;1082417;6980;1587;87;1083632;4374;592;0;20
FR;4;2023-04-18;0;0;0;0;0;0;0;0;0;1082417;6980;1587;87;1083632;4374;592;0;20
FR;4;2023-04-19;1;0;0;0;1;0;0;0;0;1082418;6980;1587;87;1083633;4374;592;0;20
FR;4;2023-04-20;0;0;0;0;0;0;0;0;0;1082418;6980;1587;87;1083633;4374;592;0;20
FR;4;2023-04-21;0;1;0;0;0;1;0;0;0;1082418;6981;1587;87;1083633;4375;592;0;20
FR;4;2023-04-22;0;0;0;0;0;0;0;0;0;1082418;6981;1587;87;1083633;4375;592;0;20
FR;4;2023-04-23;1;0;0;0;1;0;0;0;0;1082419;6981;1587;87;1083634;4375;592;0;20
FR;4;2023-04-24;1;0;0;0;1;0;0;0;0;1082420;6981;1587;87;1083635;4375;592;0;20
FR;4;2023-04-25;1;0;0;0;1;0;0;0;0;1082421;6981;1587;87;1083636;4375;592;0;20
FR;4;2023-04-26;0;0;0;0;0;0;0;0;0;1082421;6981;1587;87;1083636;4375;592;0;20
FR;4;2023-04-27;0;0;0;0;0;0;0;0;0;1082421;6981;1587;87;1083636;4375;592;0;20
FR;4;2023-04-28;0;0;0;0;0;0;0;0;0;1082421;6981;1587;87;1083636;4375;592;0;20
FR;4;2023-04-29;0;0;0;0;0;0;0;0;0;1082421;6981;1587;87;1083636;4375;592;0;20
FR;4;2023-04-30;0;0;0;0;0;0;0;0;0;1082421;6981;1587;87;1083636;4375;592;0;20
FR;4;2023-05-01;1;0;0;0;1;0;0;0;0;1082422;6981;1587;87;1083637;4375;592;0;20
FR;4;2023-05-02;0;0;0;0;0;0;0;0;0;1082422;6981;1587;87;1083637;4375;592;0;20
FR;4;2023-05-03;0;0;0;0;0;0;0;0;0;1082422;6981;1587;87;1083637;4375;592;0;20
FR;4;2023-05-04;0;0;0;0;0;0;0;0;0;1082422;6981;1587;87;1083637;4375;592;0;20
FR;4;2023-05-05;0;0;0;0;0;0;0;0;0;1082422;6981;1587;87;1083637;4375;592;0;20
FR;4;2023-05-06;0;0;0;0;0;0;0;0;0;1082422;6981;1587;87;1083637;4375;592;0;20
FR;4;2023-05-07;0;0;0;0;0;0;0;0;0;1082422;6981;1587;87;1083637;4375;592;0;20
FR;4;2023-05-08;0;0;0;0;0;0;0;0;0;1082422;6981;1587;87;1083637;4375;592;0;20
FR;4;2023-05-09;0;0;0;0;0;0;0;0;0;1082422;6981;1587;87;1083637;4375;592;0;20
FR;4;2023-05-10;0;0;0;0;0;0;0;0;0;1082422;6981;1587;87;1083637;4375;592;0;20
FR;4;2023-05-11;0;0;0;0;0;0;0;0;0;1082422;6981;1587;87;1083637;4375;592;0;20
FR;4;2023-05-12;0;0;0;0;0;0;0;0;0;1082422;6981;1587;87;1083637;4375;592;0;20
FR;4;2023-05-13;0;0;0;0;0;0;0;0;0;1082422;6981;1587;87;1083637;4375;592;0;20
FR;4;2023-05-14;0;0;0;0;0;0;0;0;0;1082422;6981;1587;87;1083637;4375;592;0;20
FR;4;2023-05-15;0;0;0;0;0;0;0;0;0;1082422;6981;1587;87;1083637;4375;592;0;20
FR;4;2023-05-16;0;0;0;0;0;0;0;0;0;1082422;6981;1587;87;1083637;4375;592;0;20
FR;4;2023-05-17;0;0;0;1;0;0;1;0;0;1082422;6981;1587;88;1083637;4375;593;0;20
FR;4;2023-05-18;0;0;0;0;0;0;0;0;0;1082422;6981;1587;88;1083637;4375;593;0;20
FR;4;2023-05-19;0;0;0;0;0;0;0;0;0;1082422;6981;1587;88;1083637;4375;593;0;20
FR;4;2023-05-20;0;0;0;0;0;0;0;0;0;1082422;6981;1587;88;1083637;4375;593;0;20
FR;4;2023-05-21;0;0;0;0;0;0;0;0;0;1082422;6981;1587;88;1083637;4375;593;0;20
FR;4;2023-05-22;0;0;0;0;0;0;0;0;0;1082422;6981;1587;88;1083637;4375;593;0;20
FR;4;2023-05-23;0;0;0;0;0;0;0;0;0;1082422;6981;1587;88;1083637;4375;593;0;20
FR;4;2023-05-24;0;0;0;0;0;0;0;0;0;1082422;6981;1587;88;1083637;4375;593;0;20
FR;4;2023-05-25;0;0;0;0;0;0;0;0;0;1082422;6981;1587;88;1083637;4375;593;0;20
FR;4;2023-05-26;0;0;0;0;0;0;0;0;0;1082422;6981;1587;88;1083637;4375;593;0;20
FR;4;2023-05-27;0;0;0;0;0;0;0;0;0;1082422;6981;1587;88;1083637;4375;593;0;20
FR;4;2023-05-28;0;0;0;0;0;0;0;0;0;1082422;6981;1587;88;1083637;4375;593;0;20
FR;4;2023-05-29;0;0;0;0;0;0;0;0;0;1082422;6981;1587;88;1083637;4375;593;0;20
FR;4;2023-05-30;0;0;0;0;0;0;0;0;0;1082422;6981;1587;88;1083637;4375;593;0;20
FR;4;2023-05-31;0;0;0;0;0;0;0;0;0;1082422;6981;1587;88;1083637;4375;593;0;20
FR;4;2023-06-01;1;0;0;0;1;0;0;0;0;1082423;6981;1587;88;1083638;4375;593;0;20
FR;4;2023-06-02;1;0;0;0;1;0;0;0;0;1082424;6981;1587;88;1083639;4375;593;0;20
FR;4;2023-06-03;0;0;0;0;0;0;0;0;0;1082424;6981;1587;88;1083639;4375;593;0;20
FR;4;2023-06-04;0;0;0;0;0;0;0;0;0;1082424;6981;1587;88;1083639;4375;593;0;20
FR;4;2023-06-05;0;0;0;0;0;0;0;0;0;1082424;6981;1587;88;1083639;4375;593;0;20
FR;4;2023-06-06;1;0;0;0;1;0;0;0;0;1082425;6981;1587;88;1083640;4375;593;0;20
FR;4;2023-06-07;0;0;0;0;0;0;0;0;0;1082425;6981;1587;88;1083640;4375;593;0;20
FR;4;2023-06-08;1;0;0;0;1;0;0;0;0;1082426;6981;1587;88;1083641;4375;593;0;20
FR;4;2023-06-09;1;0;0;0;1;0;0;0;0;1082427;6981;1587;88;1083642;4375;593;0;20
FR;4;2023-06-10;0;0;0;0;0;0;0;0;0;1082427;6981;1587;88;1083642;4375;593;0;20
FR;4;2023-06-11;0;0;0;0;0;0;0;0;0;1082427;6981;1587;88;1083642;4375;593;0;20
FR;4;2023-06-12;0;0;0;0;0;0;0;0;0;1082427;6981;1587;88;1083642;4375;593;0;20
FR;4;2023-06-13;0;0;0;0;0;0;0;0;0;1082427;6981;1587;88;1083642;4375;593;0;20
FR;4;2023-06-14;0;0;0;0;0;0;0;0;0;1082427;6981;1587;88;1083642;4375;593;0;20
FR;4;2023-06-15;0;0;0;0;0;0;0;0;0;1082427;6981;1587;88;1083642;4375;593;0;20
FR;4;2023-06-16;0;0;0;0;0;0;0;0;0;1082427;6981;1587;88;1083642;4375;593;0;20
FR;4;2023-06-17;0;0;0;0;0;0;0;0;0;1082427;6981;1587;88;1083642;4375;593;0;20
FR;4;2023-06-18;0;0;0;0;0;0;0;0;0;1082427;6981;1587;88;1083642;4375;593;0;20
FR;4;2023-06-19;0;0;0;0;0;0;0;0;0;1082427;6981;1587;88;1083642;4375;593;0;20
FR;5;2020-12-27;0;0;0;0;0;0;0;0;0;0;0;0;0;0;0;0;0;0
FR;5;2020-12-28;0;0;0;0;0;0;0;0;0;0;0;0;0;0;0;0;0;0
FR;5;2020-12-29;0;0;0;0;0;0;0;0;0;0;0;0;0;0;0;0;0;0
FR;5;2020-12-30;0;0;0;0;0;0;0;0;0;0;0;0;0;0;0;0;0;0
FR;5;2020-12-31;0;0;0;0;0;0;0;0;0;0;0;0;0;0;0;0;0;0
FR;5;2021-01-01;0;0;0;0;0;0;0;0;0;0;0;0;0;0;0;0;0;0
FR;5;2021-01-02;0;0;0;0;0;0;0;0;0;0;0;0;0;0;0;0;0;0
FR;5;2021-01-03;0;0;0;0;0;0;0;0;0;0;0;0;0;0;0;0;0;0
FR;5;2021-01-04;0;0;0;0;0;0;0;0;0;0;0;0;0;0;0;0;0;0
FR;5;2021-01-05;0;0;0;0;0;0;0;0;0;0;0;0;0;0;0;0;0;0
FR;5;2021-01-06;0;0;0;0;0;0;0;0;0;0;0;0;0;0;0;0;0;0
FR;5;2021-01-07;0;0;0;0;0;0;0;0;0;0;0;0;0;0;0;0;0;0
FR;5;2021-01-08;0;0;0;0;0;0;0;0;0;0;0;0;0;0;0;0;0;0
FR;5;2021-01-09;0;0;0;0;0;0;0;0;0;0;0;0;0;0;0;0;0;0
FR;5;2021-01-10;0;0;0;0;0;0;0;0;0;0;0;0;0;0;0;0;0;0
FR;5;2021-01-11;0;0;0;0;0;0;0;0;0;0;0;0;0;0;0;0;0;0
FR;5;2021-01-12;0;0;0;0;0;0;0;0;0;0;0;0;0;0;0;0;0;0
FR;5;2021-01-13;0;0;0;0;0;0;0;0;0;0;0;0;0;0;0;0;0;0
FR;5;2021-01-14;0;0;0;0;0;0;0;0;0;0;0;0;0;0;0;0;0;0
FR;5;2021-01-15;0;0;0;0;0;0;0;0;0;0;0;0;0;0;0;0;0;0
FR;5;2021-01-16;0;0;0;0;0;0;0;0;0;0;0;0;0;0;0;0;0;0
FR;5;2021-01-17;0;0;0;0;0;0;0;0;0;0;0;0;0;0;0;0;0;0
FR;5;2021-01-18;0;0;0;0;0;0;0;0;0;0;0;0;0;0;0;0;0;0
FR;5;2021-01-19;0;0;0;0;0;0;0;0;0;0;0;0;0;0;0;0;0;0
FR;5;2021-01-20;0;0;0;0;0;0;0;0;0;0;0;0;0;0;0;0;0;0
FR;5;2021-01-21;0;0;0;0;0;0;0;0;0;0;0;0;0;0;0;0;0;0
FR;5;2021-01-22;0;0;0;0;0;0;0;0;0;0;0;0;0;0;0;0;0;0
FR;5;2021-01-23;0;0;0;0;0;0;0;0;0;0;0;0;0;0;0;0;0;0
FR;5;2021-01-24;0;0;0;0;0;0;0;0;0;0;0;0;0;0;0;0;0;0
FR;5;2021-01-25;0;0;0;0;0;0;0;0;0;0;0;0;0;0;0;0;0;0
FR;5;2021-01-26;0;0;0;0;0;0;0;0;0;0;0;0;0;0;0;0;0;0
FR;5;2021-01-27;0;0;0;0;0;0;0;0;0;0;0;0;0;0;0;0;0;0
FR;5;2021-01-28;0;0;0;0;0;0;0;0;0;0;0;0;0;0;0;0;0;0
FR;5;2021-01-29;0;0;0;0;0;0;0;0;0;0;0;0;0;0;0;0;0;0
FR;5;2021-01-30;0;0;0;0;0;0;0;0;0;0;0;0;0;0;0;0;0;0
FR;5;2021-01-31;0;0;0;0;0;0;0;0;0;0;0;0;0;0;0;0;0;0
FR;5;2021-02-01;0;0;0;0;0;0;0;0;0;0;0;0;0;0;0;0;0;0
FR;5;2021-02-02;0;0;0;0;0;0;0;0;0;0;0;0;0;0;0;0;0;0
FR;5;2021-02-03;0;0;0;0;0;0;0;0;0;0;0;0;0;0;0;0;0;0
FR;5;2021-02-04;0;0;0;0;0;0;0;0;0;0;0;0;0;0;0;0;0;0
FR;5;2021-02-05;0;0;0;0;0;0;0;0;0;0;0;0;0;0;0;0;0;0
FR;5;2021-02-06;0;0;0;0;0;0;0;0;0;0;0;0;0;0;0;0;0;0
FR;5;2021-02-07;0;0;0;0;0;0;0;0;0;0;0;0;0;0;0;0;0;0
FR;5;2021-02-08;0;0;0;0;0;0;0;0;0;0;0;0;0;0;0;0;0;0
FR;5;2021-02-09;0;0;0;0;0;0;0;0;0;0;0;0;0;0;0;0;0;0
FR;5;2021-02-10;0;0;0;0;0;0;0;0;0;0;0;0;0;0;0;0;0;0
FR;5;2021-02-11;0;0;0;0;0;0;0;0;0;0;0;0;0;0;0;0;0;0
FR;5;2021-02-12;0;0;0;0;0;0;0;0;0;0;0;0;0;0;0;0;0;0
FR;5;2021-02-13;0;0;0;0;0;0;0;0;0;0;0;0;0;0;0;0;0;0
FR;5;2021-02-14;0;0;0;0;0;0;0;0;0;0;0;0;0;0;0;0;0;0
FR;5;2021-02-15;0;0;0;0;0;0;0;0;0;0;0;0;0;0;0;0;0;0
FR;5;2021-02-16;0;0;0;0;0;0;0;0;0;0;0;0;0;0;0;0;0;0
FR;5;2021-02-17;0;0;0;0;0;0;0;0;0;0;0;0;0;0;0;0;0;0
FR;5;2021-02-18;0;0;0;0;0;0;0;0;0;0;0;0;0;0;0;0;0;0
FR;5;2021-02-19;0;0;0;0;0;0;0;0;0;0;0;0;0;0;0;0;0;0
FR;5;2021-02-20;0;0;0;0;0;0;0;0;0;0;0;0;0;0;0;0;0;0
FR;5;2021-02-21;0;0;0;0;0;0;0;0;0;0;0;0;0;0;0;0;0;0
FR;5;2021-02-22;0;0;0;0;0;0;0;0;0;0;0;0;0;0;0;0;0;0
FR;5;2021-02-23;0;0;0;0;0;0;0;0;0;0;0;0;0;0;0;0;0;0
FR;5;2021-02-24;0;0;0;0;0;0;0;0;0;0;0;0;0;0;0;0;0;0
FR;5;2021-02-25;0;0;0;0;0;0;0;0;0;0;0;0;0;0;0;0;0;0
FR;5;2021-02-26;0;0;0;0;0;0;0;0;0;0;0;0;0;0;0;0;0;0
FR;5;2021-02-27;0;0;0;0;0;0;0;0;0;0;0;0;0;0;0;0;0;0
FR;5;2021-02-28;0;0;0;0;0;0;0;0;0;0;0;0;0;0;0;0;0;0
FR;5;2021-03-01;0;0;0;0;0;0;0;0;0;0;0;0;0;0;0;0;0;0
FR;5;2021-03-02;0;0;0;0;0;0;0;0;0;0;0;0;0;0;0;0;0;0
FR;5;2021-03-03;0;0;0;0;0;0;0;0;0;0;0;0;0;0;0;0;0;0
FR;5;2021-03-04;0;0;0;0;0;0;0;0;0;0;0;0;0;0;0;0;0;0
FR;5;2021-03-05;0;0;0;0;0;0;0;0;0;0;0;0;0;0;0;0;0;0
FR;5;2021-03-06;0;0;0;0;0;0;0;0;0;0;0;0;0;0;0;0;0;0
FR;5;2021-03-07;0;0;0;0;0;0;0;0;0;0;0;0;0;0;0;0;0;0
FR;5;2021-03-08;0;0;0;0;0;0;0;0;0;0;0;0;0;0;0;0;0;0
FR;5;2021-03-09;0;0;0;0;0;0;0;0;0;0;0;0;0;0;0;0;0;0
FR;5;2021-03-10;0;0;0;0;0;0;0;0;0;0;0;0;0;0;0;0;0;0
FR;5;2021-03-11;0;0;0;0;0;0;0;0;0;0;0;0;0;0;0;0;0;0
FR;5;2021-03-12;0;0;0;0;0;0;0;0;0;0;0;0;0;0;0;0;0;0
FR;5;2021-03-13;0;0;0;0;0;0;0;0;0;0;0;0;0;0;0;0;0;0
FR;5;2021-03-14;0;0;0;0;0;0;0;0;0;0;0;0;0;0;0;0;0;0
FR;5;2021-03-15;0;0;0;0;0;0;0;0;0;0;0;0;0;0;0;0;0;0
FR;5;2021-03-16;0;0;0;0;0;0;0;0;0;0;0;0;0;0;0;0;0;0
FR;5;2021-03-17;0;0;0;0;0;0;0;0;0;0;0;0;0;0;0;0;0;0
FR;5;2021-03-18;0;0;0;0;0;0;0;0;0;0;0;0;0;0;0;0;0;0
FR;5;2021-03-19;0;0;0;0;0;0;0;0;0;0;0;0;0;0;0;0;0;0
FR;5;2021-03-20;0;0;0;0;0;0;0;0;0;0;0;0;0;0;0;0;0;0
FR;5;2021-03-21;0;0;0;0;0;0;0;0;0;0;0;0;0;0;0;0;0;0
FR;5;2021-03-22;0;0;0;0;0;0;0;0;0;0;0;0;0;0;0;0;0;0
FR;5;2021-03-23;0;0;0;0;0;0;0;0;0;0;0;0;0;0;0;0;0;0
FR;5;2021-03-24;0;0;0;0;0;0;0;0;0;0;0;0;0;0;0;0;0;0
FR;5;2021-03-25;0;0;0;0;0;0;0;0;0;0;0;0;0;0;0;0;0;0
FR;5;2021-03-26;0;0;0;0;0;0;0;0;0;0;0;0;0;0;0;0;0;0
FR;5;2021-03-27;0;0;0;0;0;0;0;0;0;0;0;0;0;0;0;0;0;0
FR;5;2021-03-28;0;0;0;0;0;0;0;0;0;0;0;0;0;0;0;0;0;0
FR;5;2021-03-29;0;0;0;0;0;0;0;0;0;0;0;0;0;0;0;0;0;0
FR;5;2021-03-30;0;0;0;0;0;0;0;0;0;0;0;0;0;0;0;0;0;0
FR;5;2021-03-31;0;0;0;0;0;0;0;0;0;0;0;0;0;0;0;0;0;0
FR;5;2021-04-01;0;0;0;0;0;0;0;0;0;0;0;0;0;0;0;0;0;0
FR;5;2021-04-02;0;0;0;0;0;0;0;0;0;0;0;0;0;0;0;0;0;0
FR;5;2021-04-03;0;0;0;0;0;0;0;0;0;0;0;0;0;0;0;0;0;0
FR;5;2021-04-04;0;0;0;0;0;0;0;0;0;0;0;0;0;0;0;0;0;0
FR;5;2021-04-05;0;0;0;0;0;0;0;0;0;0;0;0;0;0;0;0;0;0
FR;5;2021-04-06;0;0;0;0;0;0;0;0;0;0;0;0;0;0;0;0;0;0
FR;5;2021-04-07;0;0;0;0;0;0;0;0;0;0;0;0;0;0;0;0;0;0
FR;5;2021-04-08;0;0;0;0;0;0;0;0;0;0;0;0;0;0;0;0;0;0
FR;5;2021-04-09;0;0;0;0;0;0;0;0;0;0;0;0;0;0;0;0;0;0
FR;5;2021-04-10;0;0;0;0;0;0;0;0;0;0;0;0;0;0;0;0;0;0
FR;5;2021-04-11;0;0;0;0;0;0;0;0;0;0;0;0;0;0;0;0;0;0
FR;5;2021-04-12;0;0;0;0;0;0;0;0;0;0;0;0;0;0;0;0;0;0
FR;5;2021-04-13;0;0;0;0;0;0;0;0;0;0;0;0;0;0;0;0;0;0
FR;5;2021-04-14;0;0;0;0;0;0;0;0;0;0;0;0;0;0;0;0;0;0
FR;5;2021-04-15;0;0;0;0;0;0;0;0;0;0;0;0;0;0;0;0;0;0
FR;5;2021-04-16;0;0;0;0;0;0;0;0;0;0;0;0;0;0;0;0;0;0
FR;5;2021-04-17;0;0;0;0;0;0;0;0;0;0;0;0;0;0;0;0;0;0
FR;5;2021-04-18;0;0;0;0;0;0;0;0;0;0;0;0;0;0;0;0;0;0
FR;5;2021-04-19;0;0;0;0;0;0;0;0;0;0;0;0;0;0;0;0;0;0
FR;5;2021-04-20;0;0;0;0;0;0;0;0;0;0;0;0;0;0;0;0;0;0
FR;5;2021-04-21;0;0;0;0;0;0;0;0;0;0;0;0;0;0;0;0;0;0
FR;5;2021-04-22;0;0;0;0;0;0;0;0;0;0;0;0;0;0;0;0;0;0
FR;5;2021-04-23;0;0;0;0;0;0;0;0;0;0;0;0;0;0;0;0;0;0
FR;5;2021-04-24;0;0;0;0;0;0;0;0;0;0;0;0;0;0;0;0;0;0
FR;5;2021-04-25;0;0;0;0;0;0;0;0;0;0;0;0;0;0;0;0;0;0
FR;5;2021-04-26;0;0;0;0;0;0;0;0;0;0;0;0;0;0;0;0;0;0
FR;5;2021-04-27;0;0;0;0;0;0;0;0;0;0;0;0;0;0;0;0;0;0
FR;5;2021-04-28;0;0;0;0;0;0;0;0;0;0;0;0;0;0;0;0;0;0
FR;5;2021-04-29;0;0;0;0;0;0;0;0;0;0;0;0;0;0;0;0;0;0
FR;5;2021-04-30;0;0;0;0;0;0;0;0;0;0;0;0;0;0;0;0;0;0
FR;5;2021-05-01;0;0;0;0;0;0;0;0;0;0;0;0;0;0;0;0;0;0
FR;5;2021-05-02;0;0;0;0;0;0;0;0;0;0;0;0;0;0;0;0;0;0
FR;5;2021-05-03;0;0;0;0;0;0;0;0;0;0;0;0;0;0;0;0;0;0
FR;5;2021-05-04;0;0;0;0;0;0;0;0;0;0;0;0;0;0;0;0;0;0
FR;5;2021-05-05;0;0;0;0;0;0;0;0;0;0;0;0;0;0;0;0;0;0
FR;5;2021-05-06;0;0;0;0;0;0;0;0;0;0;0;0;0;0;0;0;0;0
FR;5;2021-05-07;0;0;0;0;0;0;0;0;0;0;0;0;0;0;0;0;0;0
FR;5;2021-05-08;0;0;0;0;0;0;0;0;0;0;0;0;0;0;0;0;0;0
FR;5;2021-05-09;0;0;0;0;0;0;0;0;0;0;0;0;0;0;0;0;0;0
FR;5;2021-05-10;0;0;0;0;0;0;0;0;0;0;0;0;0;0;0;0;0;0
FR;5;2021-05-11;0;0;0;0;0;0;0;0;0;0;0;0;0;0;0;0;0;0
FR;5;2021-05-12;0;0;0;0;0;0;0;0;0;0;0;0;0;0;0;0;0;0
FR;5;2021-05-13;0;0;0;0;0;0;0;0;0;0;0;0;0;0;0;0;0;0
FR;5;2021-05-14;0;0;0;0;0;0;0;0;0;0;0;0;0;0;0;0;0;0
FR;5;2021-05-15;0;0;0;0;0;0;0;0;0;0;0;0;0;0;0;0;0;0
FR;5;2021-05-16;0;0;0;0;0;0;0;0;0;0;0;0;0;0;0;0;0;0
FR;5;2021-05-17;0;0;0;0;0;0;0;0;0;0;0;0;0;0;0;0;0;0
FR;5;2021-05-18;0;0;0;0;0;0;0;0;0;0;0;0;0;0;0;0;0;0
FR;5;2021-05-19;0;0;0;0;0;0;0;0;0;0;0;0;0;0;0;0;0;0
FR;5;2021-05-20;0;0;0;0;0;0;0;0;0;0;0;0;0;0;0;0;0;0
FR;5;2021-05-21;0;0;0;0;0;0;0;0;0;0;0;0;0;0;0;0;0;0
FR;5;2021-05-22;0;0;0;0;0;0;0;0;0;0;0;0;0;0;0;0;0;0
FR;5;2021-05-23;0;0;0;0;0;0;0;0;0;0;0;0;0;0;0;0;0;0
FR;5;2021-05-24;0;0;0;0;0;0;0;0;0;0;0;0;0;0;0;0;0;0
FR;5;2021-05-25;0;0;0;0;0;0;0;0;0;0;0;0;0;0;0;0;0;0
FR;5;2021-05-26;0;0;0;0;0;0;0;0;0;0;0;0;0;0;0;0;0;0
FR;5;2021-05-27;0;0;0;0;0;0;0;0;0;0;0;0;0;0;0;0;0;0
FR;5;2021-05-28;0;0;0;0;0;0;0;0;0;0;0;0;0;0;0;0;0;0
FR;5;2021-05-29;0;0;0;0;0;0;0;0;0;0;0;0;0;0;0;0;0;0
FR;5;2021-05-30;0;0;0;0;0;0;0;0;0;0;0;0;0;0;0;0;0;0
FR;5;2021-05-31;0;0;0;0;0;0;0;0;0;0;0;0;0;0;0;0;0;0
FR;5;2021-06-01;0;0;0;0;0;0;0;0;0;0;0;0;0;0;0;0;0;0
FR;5;2021-06-02;0;0;0;0;0;0;0;0;0;0;0;0;0;0;0;0;0;0
FR;5;2021-06-03;0;0;0;0;0;0;0;0;0;0;0;0;0;0;0;0;0;0
FR;5;2021-06-04;0;0;0;0;0;0;0;0;0;0;0;0;0;0;0;0;0;0
FR;5;2021-06-05;0;0;0;0;0;0;0;0;0;0;0;0;0;0;0;0;0;0
FR;5;2021-06-06;0;0;0;0;0;0;0;0;0;0;0;0;0;0;0;0;0;0
FR;5;2021-06-07;0;0;0;0;0;0;0;0;0;0;0;0;0;0;0;0;0;0
FR;5;2021-06-08;0;0;0;0;0;0;0;0;0;0;0;0;0;0;0;0;0;0
FR;5;2021-06-09;0;0;0;0;0;0;0;0;0;0;0;0;0;0;0;0;0;0
FR;5;2021-06-10;0;0;0;0;0;0;0;0;0;0;0;0;0;0;0;0;0;0
FR;5;2021-06-11;0;0;0;0;0;0;0;0;0;0;0;0;0;0;0;0;0;0
FR;5;2021-06-12;0;0;0;0;0;0;0;0;0;0;0;0;0;0;0;0;0;0
FR;5;2021-06-13;0;0;0;0;0;0;0;0;0;0;0;0;0;0;0;0;0;0
FR;5;2021-06-14;0;0;0;0;0;0;0;0;0;0;0;0;0;0;0;0;0;0
FR;5;2021-06-15;0;0;0;0;0;0;0;0;0;0;0;0;0;0;0;0;0;0
FR;5;2021-06-16;0;0;0;0;0;0;0;0;0;0;0;0;0;0;0;0;0;0
FR;5;2021-06-17;0;0;0;0;0;0;0;0;0;0;0;0;0;0;0;0;0;0
FR;5;2021-06-18;0;0;0;0;0;0;0;0;0;0;0;0;0;0;0;0;0;0
FR;5;2021-06-19;0;0;0;0;0;0;0;0;0;0;0;0;0;0;0;0;0;0
FR;5;2021-06-20;0;0;0;0;0;0;0;0;0;0;0;0;0;0;0;0;0;0
FR;5;2021-06-21;0;0;0;0;0;0;0;0;0;0;0;0;0;0;0;0;0;0
FR;5;2021-06-22;0;0;0;0;0;0;0;0;0;0;0;0;0;0;0;0;0;0
FR;5;2021-06-23;0;0;0;0;0;0;0;0;0;0;0;0;0;0;0;0;0;0
FR;5;2021-06-24;0;0;0;0;0;0;0;0;0;0;0;0;0;0;0;0;0;0
FR;5;2021-06-25;0;0;0;0;0;0;0;0;0;0;0;0;0;0;0;0;0;0
FR;5;2021-06-26;0;0;0;0;0;0;0;0;0;0;0;0;0;0;0;0;0;0
FR;5;2021-06-27;0;0;0;0;0;0;0;0;0;0;0;0;0;0;0;0;0;0
FR;5;2021-06-28;0;0;0;0;0;0;0;0;0;0;0;0;0;0;0;0;0;0
FR;5;2021-06-29;0;0;0;0;0;0;0;0;0;0;0;0;0;0;0;0;0;0
FR;5;2021-06-30;0;0;0;0;0;0;0;0;0;0;0;0;0;0;0;0;0;0
FR;5;2021-07-01;0;0;0;0;0;0;0;0;0;0;0;0;0;0;0;0;0;0
FR;5;2021-07-02;0;0;0;0;0;0;0;0;0;0;0;0;0;0;0;0;0;0
FR;5;2021-07-03;0;0;0;0;0;0;0;0;0;0;0;0;0;0;0;0;0;0
FR;5;2021-07-04;0;0;0;0;0;0;0;0;0;0;0;0;0;0;0;0;0;0
FR;5;2021-07-05;0;0;0;0;0;0;0;0;0;0;0;0;0;0;0;0;0;0
FR;5;2021-07-06;0;0;0;0;0;0;0;0;0;0;0;0;0;0;0;0;0;0
FR;5;2021-07-07;0;0;0;0;0;0;0;0;0;0;0;0;0;0;0;0;0;0
FR;5;2021-07-08;0;0;0;0;0;0;0;0;0;0;0;0;0;0;0;0;0;0
FR;5;2021-07-09;0;0;0;0;0;0;0;0;0;0;0;0;0;0;0;0;0;0
FR;5;2021-07-10;0;0;0;0;0;0;0;0;0;0;0;0;0;0;0;0;0;0
FR;5;2021-07-11;0;0;0;0;0;0;0;0;0;0;0;0;0;0;0;0;0;0
FR;5;2021-07-12;0;0;0;0;0;0;0;0;0;0;0;0;0;0;0;0;0;0
FR;5;2021-07-13;0;0;0;0;0;0;0;0;0;0;0;0;0;0;0;0;0;0
FR;5;2021-07-14;0;0;0;0;0;0;0;0;0;0;0;0;0;0;0;0;0;0
FR;5;2021-07-15;0;0;0;0;0;0;0;0;0;0;0;0;0;0;0;0;0;0
FR;5;2021-07-16;0;0;0;0;0;0;0;0;0;0;0;0;0;0;0;0;0;0
FR;5;2021-07-17;0;0;0;0;0;0;0;0;0;0;0;0;0;0;0;0;0;0
FR;5;2021-07-18;0;0;0;0;0;0;0;0;0;0;0;0;0;0;0;0;0;0
FR;5;2021-07-19;0;0;0;0;0;0;0;0;0;0;0;0;0;0;0;0;0;0
FR;5;2021-07-20;0;0;0;0;0;0;0;0;0;0;0;0;0;0;0;0;0;0
FR;5;2021-07-21;0;0;0;0;0;0;0;0;0;0;0;0;0;0;0;0;0;0
FR;5;2021-07-22;0;0;0;0;0;0;0;0;0;0;0;0;0;0;0;0;0;0
FR;5;2021-07-23;0;0;0;0;0;0;0;0;0;0;0;0;0;0;0;0;0;0
FR;5;2021-07-24;0;0;0;0;0;0;0;0;0;0;0;0;0;0;0;0;0;0
FR;5;2021-07-25;0;0;0;0;0;0;0;0;0;0;0;0;0;0;0;0;0;0
FR;5;2021-07-26;0;0;0;0;0;0;0;0;0;0;0;0;0;0;0;0;0;0
FR;5;2021-07-27;0;0;0;0;0;0;0;0;0;0;0;0;0;0;0;0;0;0
FR;5;2021-07-28;0;0;0;0;0;0;0;0;0;0;0;0;0;0;0;0;0;0
FR;5;2021-07-29;0;0;0;0;0;0;0;0;0;0;0;0;0;0;0;0;0;0
FR;5;2021-07-30;0;0;0;0;0;0;0;0;0;0;0;0;0;0;0;0;0;0
FR;5;2021-07-31;0;0;0;0;0;0;0;0;0;0;0;0;0;0;0;0;0;0
FR;5;2021-08-01;0;0;0;0;0;0;0;0;0;0;0;0;0;0;0;0;0;0
FR;5;2021-08-02;0;0;0;0;0;0;0;0;0;0;0;0;0;0;0;0;0;0
FR;5;2021-08-03;0;0;0;0;0;0;0;0;0;0;0;0;0;0;0;0;0;0
FR;5;2021-08-04;0;0;0;0;0;0;0;0;0;0;0;0;0;0;0;0;0;0
FR;5;2021-08-05;0;0;0;0;0;0;0;0;0;0;0;0;0;0;0;0;0;0
FR;5;2021-08-06;0;0;0;0;0;0;0;0;0;0;0;0;0;0;0;0;0;0
FR;5;2021-08-07;0;0;0;0;0;0;0;0;0;0;0;0;0;0;0;0;0;0
FR;5;2021-08-08;0;0;0;0;0;0;0;0;0;0;0;0;0;0;0;0;0;0
FR;5;2021-08-09;0;0;0;0;0;0;0;0;0;0;0;0;0;0;0;0;0;0
FR;5;2021-08-10;0;0;0;0;0;0;0;0;0;0;0;0;0;0;0;0;0;0
FR;5;2021-08-11;0;0;0;0;0;0;0;0;0;0;0;0;0;0;0;0;0;0
FR;5;2021-08-12;0;0;0;0;0;0;0;0;0;0;0;0;0;0;0;0;0;0
FR;5;2021-08-13;0;0;0;0;0;0;0;0;0;0;0;0;0;0;0;0;0;0
FR;5;2021-08-14;0;0;0;0;0;0;0;0;0;0;0;0;0;0;0;0;0;0
FR;5;2021-08-15;0;0;0;0;0;0;0;0;0;0;0;0;0;0;0;0;0;0
FR;5;2021-08-16;0;0;0;0;0;0;0;0;0;0;0;0;0;0;0;0;0;0
FR;5;2021-08-17;0;0;0;0;0;0;0;0;0;0;0;0;0;0;0;0;0;0
FR;5;2021-08-18;0;0;0;0;0;0;0;0;0;0;0;0;0;0;0;0;0;0
FR;5;2021-08-19;0;0;0;0;0;0;0;0;0;0;0;0;0;0;0;0;0;0
FR;5;2021-08-20;0;0;0;0;0;0;0;0;0;0;0;0;0;0;0;0;0;0
FR;5;2021-08-21;0;0;0;0;0;0;0;0;0;0;0;0;0;0;0;0;0;0
FR;5;2021-08-22;0;0;0;0;0;0;0;0;0;0;0;0;0;0;0;0;0;0
FR;5;2021-08-23;0;0;0;0;0;0;0;0;0;0;0;0;0;0;0;0;0;0
FR;5;2021-08-24;0;0;0;0;0;0;0;0;0;0;0;0;0;0;0;0;0;0
FR;5;2021-08-25;0;0;0;0;0;0;0;0;0;0;0;0;0;0;0;0;0;0
FR;5;2021-08-26;0;0;0;0;0;0;0;0;0;0;0;0;0;0;0;0;0;0
FR;5;2021-08-27;0;0;0;0;0;0;0;0;0;0;0;0;0;0;0;0;0;0
FR;5;2021-08-28;0;0;0;0;0;0;0;0;0;0;0;0;0;0;0;0;0;0
FR;5;2021-08-29;0;0;0;0;0;0;0;0;0;0;0;0;0;0;0;0;0;0
FR;5;2021-08-30;0;0;0;0;0;0;0;0;0;0;0;0;0;0;0;0;0;0
FR;5;2021-08-31;0;0;0;0;0;0;0;0;0;0;0;0;0;0;0;0;0;0
FR;5;2021-09-01;0;0;0;0;0;0;0;0;0;0;0;0;0;0;0;0;0;0
FR;5;2021-09-02;0;0;0;0;0;0;0;0;0;0;0;0;0;0;0;0;0;0
FR;5;2021-09-03;0;0;0;0;0;0;0;0;0;0;0;0;0;0;0;0;0;0
FR;5;2021-09-04;0;0;0;0;0;0;0;0;0;0;0;0;0;0;0;0;0;0
FR;5;2021-09-05;0;0;0;0;0;0;0;0;0;0;0;0;0;0;0;0;0;0
FR;5;2021-09-06;0;0;0;0;0;0;0;0;0;0;0;0;0;0;0;0;0;0
FR;5;2021-09-07;0;0;0;0;0;0;0;0;0;0;0;0;0;0;0;0;0;0
FR;5;2021-09-08;0;0;0;0;0;0;0;0;0;0;0;0;0;0;0;0;0;0
FR;5;2021-09-09;0;0;0;0;0;0;0;0;0;0;0;0;0;0;0;0;0;0
FR;5;2021-09-10;0;0;0;0;0;0;0;0;0;0;0;0;0;0;0;0;0;0
FR;5;2021-09-11;0;0;0;0;0;0;0;0;0;0;0;0;0;0;0;0;0;0
FR;5;2021-09-12;0;0;0;0;0;0;0;0;0;0;0;0;0;0;0;0;0;0
FR;5;2021-09-13;0;0;0;0;0;0;0;0;0;0;0;0;0;0;0;0;0;0
FR;5;2021-09-14;0;0;0;0;0;0;0;0;0;0;0;0;0;0;0;0;0;0
FR;5;2021-09-15;0;0;0;0;0;0;0;0;0;0;0;0;0;0;0;0;0;0
FR;5;2021-09-16;0;0;0;0;0;0;0;0;0;0;0;0;0;0;0;0;0;0
FR;5;2021-09-17;0;0;0;0;0;0;0;0;0;0;0;0;0;0;0;0;0;0
FR;5;2021-09-18;0;0;0;0;0;0;0;0;0;0;0;0;0;0;0;0;0;0
FR;5;2021-09-19;0;0;0;0;0;0;0;0;0;0;0;0;0;0;0;0;0;0
FR;5;2021-09-20;0;0;0;0;0;0;0;0;0;0;0;0;0;0;0;0;0;0
FR;5;2021-09-21;0;0;0;0;0;0;0;0;0;0;0;0;0;0;0;0;0;0
FR;5;2021-09-22;0;0;0;0;0;0;0;0;0;0;0;0;0;0;0;0;0;0
FR;5;2021-09-23;0;0;0;0;0;0;0;0;0;0;0;0;0;0;0;0;0;0
FR;5;2021-09-24;0;0;0;0;0;0;0;0;0;0;0;0;0;0;0;0;0;0
FR;5;2021-09-25;0;0;0;0;0;0;0;0;0;0;0;0;0;0;0;0;0;0
FR;5;2021-09-26;0;0;0;0;0;0;0;0;0;0;0;0;0;0;0;0;0;0
FR;5;2021-09-27;0;0;0;0;0;0;0;0;0;0;0;0;0;0;0;0;0;0
FR;5;2021-09-28;0;0;0;0;0;0;0;0;0;0;0;0;0;0;0;0;0;0
FR;5;2021-09-29;0;0;0;0;0;0;0;0;0;0;0;0;0;0;0;0;0;0
FR;5;2021-09-30;0;0;0;0;0;0;0;0;0;0;0;0;0;0;0;0;0;0
FR;5;2021-10-01;0;0;0;0;0;0;0;0;0;0;0;0;0;0;0;0;0;0
FR;5;2021-10-02;0;0;0;0;0;0;0;0;0;0;0;0;0;0;0;0;0;0
FR;5;2021-10-03;0;0;0;0;0;0;0;0;0;0;0;0;0;0;0;0;0;0
FR;5;2021-10-04;0;0;0;0;0;0;0;0;0;0;0;0;0;0;0;0;0;0
FR;5;2021-10-05;0;0;0;0;0;0;0;0;0;0;0;0;0;0;0;0;0;0
FR;5;2021-10-06;0;0;0;0;0;0;0;0;0;0;0;0;0;0;0;0;0;0
FR;5;2021-10-07;0;0;0;0;0;0;0;0;0;0;0;0;0;0;0;0;0;0
FR;5;2021-10-08;0;0;0;0;0;0;0;0;0;0;0;0;0;0;0;0;0;0
FR;5;2021-10-09;0;0;0;0;0;0;0;0;0;0;0;0;0;0;0;0;0;0
FR;5;2021-10-10;0;0;0;0;0;0;0;0;0;0;0;0;0;0;0;0;0;0
FR;5;2021-10-11;0;0;0;0;0;0;0;0;0;0;0;0;0;0;0;0;0;0
FR;5;2021-10-12;0;0;0;0;0;0;0;0;0;0;0;0;0;0;0;0;0;0
FR;5;2021-10-13;0;0;0;0;0;0;0;0;0;0;0;0;0;0;0;0;0;0
FR;5;2021-10-14;0;0;0;0;0;0;0;0;0;0;0;0;0;0;0;0;0;0
FR;5;2021-10-15;0;0;0;0;0;0;0;0;0;0;0;0;0;0;0;0;0;0
FR;5;2021-10-16;0;0;0;0;0;0;0;0;0;0;0;0;0;0;0;0;0;0
FR;5;2021-10-17;0;0;0;0;0;0;0;0;0;0;0;0;0;0;0;0;0;0
FR;5;2021-10-18;0;0;0;0;0;0;0;0;0;0;0;0;0;0;0;0;0;0
FR;5;2021-10-19;0;0;0;0;0;0;0;0;0;0;0;0;0;0;0;0;0;0
FR;5;2021-10-20;0;0;0;0;0;0;0;0;0;0;0;0;0;0;0;0;0;0
FR;5;2021-10-21;0;0;0;0;0;0;0;0;0;0;0;0;0;0;0;0;0;0
FR;5;2021-10-22;0;0;0;0;0;0;0;0;0;0;0;0;0;0;0;0;0;0
FR;5;2021-10-23;0;0;0;0;0;0;0;0;0;0;0;0;0;0;0;0;0;0
FR;5;2021-10-24;0;0;0;0;0;0;0;0;0;0;0;0;0;0;0;0;0;0
FR;5;2021-10-25;0;0;0;0;0;0;0;0;0;0;0;0;0;0;0;0;0;0
FR;5;2021-10-26;0;0;0;0;0;0;0;0;0;0;0;0;0;0;0;0;0;0
FR;5;2021-10-27;0;0;0;0;0;0;0;0;0;0;0;0;0;0;0;0;0;0
FR;5;2021-10-28;0;0;0;0;0;0;0;0;0;0;0;0;0;0;0;0;0;0
FR;5;2021-10-29;0;0;0;0;0;0;0;0;0;0;0;0;0;0;0;0;0;0
FR;5;2021-10-30;0;0;0;0;0;0;0;0;0;0;0;0;0;0;0;0;0;0
FR;5;2021-10-31;0;0;0;0;0;0;0;0;0;0;0;0;0;0;0;0;0;0
FR;5;2021-11-01;0;0;0;0;0;0;0;0;0;0;0;0;0;0;0;0;0;0
FR;5;2021-11-02;0;0;0;0;0;0;0;0;0;0;0;0;0;0;0;0;0;0
FR;5;2021-11-03;0;0;0;0;0;0;0;0;0;0;0;0;0;0;0;0;0;0
FR;5;2021-11-04;0;0;0;0;0;0;0;0;0;0;0;0;0;0;0;0;0;0
FR;5;2021-11-05;0;0;0;0;0;0;0;0;0;0;0;0;0;0;0;0;0;0
FR;5;2021-11-06;0;0;0;0;0;0;0;0;0;0;0;0;0;0;0;0;0;0
FR;5;2021-11-07;0;0;0;0;0;0;0;0;0;0;0;0;0;0;0;0;0;0
FR;5;2021-11-08;0;0;0;0;0;0;0;0;0;0;0;0;0;0;0;0;0;0
FR;5;2021-11-09;0;0;0;0;0;0;0;0;0;0;0;0;0;0;0;0;0;0
FR;5;2021-11-10;0;0;0;0;0;0;0;0;0;0;0;0;0;0;0;0;0;0
FR;5;2021-11-11;0;0;0;0;0;0;0;0;0;0;0;0;0;0;0;0;0;0
FR;5;2021-11-12;0;0;0;0;0;0;0;0;0;0;0;0;0;0;0;0;0;0
FR;5;2021-11-13;0;0;0;0;0;0;0;0;0;0;0;0;0;0;0;0;0;0
FR;5;2021-11-14;0;0;0;0;0;0;0;0;0;0;0;0;0;0;0;0;0;0
FR;5;2021-11-15;0;0;0;0;0;0;0;0;0;0;0;0;0;0;0;0;0;0
FR;5;2021-11-16;0;0;0;0;0;0;0;0;0;0;0;0;0;0;0;0;0;0
FR;5;2021-11-17;0;0;0;0;0;0;0;0;0;0;0;0;0;0;0;0;0;0
FR;5;2021-11-18;0;0;0;0;0;0;0;0;0;0;0;0;0;0;0;0;0;0
FR;5;2021-11-19;0;0;0;0;0;0;0;0;0;0;0;0;0;0;0;0;0;0
FR;5;2021-11-20;0;0;0;0;0;0;0;0;0;0;0;0;0;0;0;0;0;0
FR;5;2021-11-21;0;0;0;0;0;0;0;0;0;0;0;0;0;0;0;0;0;0
FR;5;2021-11-22;0;0;0;0;0;0;0;0;0;0;0;0;0;0;0;0;0;0
FR;5;2021-11-23;0;0;0;0;0;0;0;0;0;0;0;0;0;0;0;0;0;0
FR;5;2021-11-24;0;0;0;0;0;0;0;0;0;0;0;0;0;0;0;0;0;0
FR;5;2021-11-25;0;0;0;0;0;0;0;0;0;0;0;0;0;0;0;0;0;0
FR;5;2021-11-26;0;0;0;0;0;0;0;0;0;0;0;0;0;0;0;0;0;0
FR;5;2021-11-27;0;0;0;0;0;0;0;0;0;0;0;0;0;0;0;0;0;0
FR;5;2021-11-28;0;0;0;0;0;0;0;0;0;0;0;0;0;0;0;0;0;0
FR;5;2021-11-29;0;0;0;0;0;0;0;0;0;0;0;0;0;0;0;0;0;0
FR;5;2021-11-30;0;0;0;0;0;0;0;0;0;0;0;0;0;0;0;0;0;0
FR;5;2021-12-01;0;0;0;0;0;0;0;0;0;0;0;0;0;0;0;0;0;0
FR;5;2021-12-02;0;0;0;0;0;0;0;0;0;0;0;0;0;0;0;0;0;0
FR;5;2021-12-03;0;0;0;0;0;0;0;0;0;0;0;0;0;0;0;0;0;0
FR;5;2021-12-04;0;0;0;0;0;0;0;0;0;0;0;0;0;0;0;0;0;0
FR;5;2021-12-05;0;0;0;0;0;0;0;0;0;0;0;0;0;0;0;0;0;0
FR;5;2021-12-06;0;0;0;0;0;0;0;0;0;0;0;0;0;0;0;0;0;0
FR;5;2021-12-07;0;0;0;0;0;0;0;0;0;0;0;0;0;0;0;0;0;0
FR;5;2021-12-08;0;0;0;0;0;0;0;0;0;0;0;0;0;0;0;0;0;0
FR;5;2021-12-09;0;0;0;0;0;0;0;0;0;0;0;0;0;0;0;0;0;0
FR;5;2021-12-10;0;0;0;0;0;0;0;0;0;0;0;0;0;0;0;0;0;0
FR;5;2021-12-11;0;0;0;0;0;0;0;0;0;0;0;0;0;0;0;0;0;0
FR;5;2021-12-12;0;0;0;0;0;0;0;0;0;0;0;0;0;0;0;0;0;0
FR;5;2021-12-13;0;0;0;0;0;0;0;0;0;0;0;0;0;0;0;0;0;0
FR;5;2021-12-14;33;45;77;0;27;88;1;0;0;33;45;77;0;27;88;1;0;0
FR;5;2021-12-15;196;44;37;0;42;49;0;0;0;229;89;114;0;69;137;1;0;0
FR;5;2021-12-16;181;21;44;0;38;48;0;0;0;410;110;158;0;107;185;1;0;0
FR;5;2021-12-17;313;16;72;0;34;74;2;0;0;723;126;230;0;141;259;3;0;0
FR;5;2021-12-18;766;24;22;0;67;29;0;0;0;1489;150;252;0;208;288;3;0;0
FR;5;2021-12-19;585;15;15;0;67;17;0;0;0;2074;165;267;0;275;305;3;0;0
FR;5;2021-12-20;1225;31;34;0;134;37;2;0;0;3299;196;301;0;409;342;5;0;0
FR;5;2021-12-21;1535;22;54;1;141;60;0;0;0;4834;218;355;1;550;402;5;0;0
FR;5;2021-12-22;4069;40;37;0;420;46;2;0;0;8903;258;392;1;970;448;7;0;0
FR;5;2021-12-23;3043;16;21;0;305;25;0;0;0;11946;274;413;1;1275;473;7;0;0
FR;5;2021-12-24;761;18;9;0;103;14;0;0;0;12707;292;422;1;1378;487;7;0;0
FR;5;2021-12-25;61;5;2;0;9;3;0;0;0;12768;297;424;1;1387;490;7;0;0
FR;5;2021-12-26;623;6;3;0;101;4;0;0;0;13391;303;427;1;1488;494;7;0;0
FR;5;2021-12-27;4085;25;21;0;458;23;1;0;0;17476;328;448;1;1946;517;8;0;0
FR;5;2021-12-28;5204;23;41;1;513;43;2;0;0;22680;351;489;2;2459;560;10;0;0
FR;5;2021-12-29;8105;34;66;1;888;69;0;0;0;30785;385;555;3;3347;629;10;0;0
FR;5;2021-12-30;5173;18;33;0;525;39;0;0;0;35958;403;588;3;3872;668;10;0;0
FR;5;2021-12-31;1554;8;10;0;182;11;0;0;0;37512;411;598;3;4054;679;10;0;0
FR;5;2022-01-01;186;2;2;0;24;3;0;0;0;37698;413;600;3;4078;682;10;0;0
FR;5;2022-01-02;1489;1;1;0;152;1;0;0;0;39187;414;601;3;4230;683;10;0;0
FR;5;2022-01-03;3069;36;34;0;323;33;1;0;0;42256;450;635;3;4553;716;11;0;0
FR;5;2022-01-04;3034;39;33;0;321;42;3;0;0;45290;489;668;3;4874;758;14;0;0
FR;5;2022-01-05;19324;203;97;1;2118;108;0;0;0;64614;692;765;4;6992;866;14;0;0
FR;5;2022-01-06;3748;134;122;0;507;142;2;0;0;68362;826;887;4;7499;1008;16;0;0
FR;5;2022-01-07;5006;202;48;2;705;56;1;0;0;73368;1028;935;6;8204;1064;17;0;0
FR;5;2022-01-08;13659;514;45;0;2003;52;0;0;0;87027;1542;980;6;10207;1116;17;0;0
FR;5;2022-01-09;5754;399;15;0;1112;20;1;0;0;92781;1941;995;6;11319;1136;18;0;0
FR;5;2022-01-10;3455;326;25;0;735;29;0;0;0;96236;2267;1020;6;12054;1165;18;0;0
FR;5;2022-01-11;3671;283;38;0;661;41;1;0;0;99907;2550;1058;6;12715;1206;19;0;0
FR;5;2022-01-12;22650;3005;89;0;5297;112;2;0;0;122557;5555;1147;6;18012;1318;21;0;0
FR;5;2022-01-13;4039;623;29;0;1052;31;2;0;0;126596;6178;1176;6;19064;1349;23;0;0
FR;5;2022-01-14;4843;583;45;0;1115;52;1;0;0;131439;6761;1221;6;20179;1401;24;0;0
FR;5;2022-01-15;14686;1747;38;3;3378;49;3;0;0;146125;8508;1259;9;23557;1450;27;0;0
FR;5;2022-01-16;4728;666;3;0;1261;5;0;0;0;150853;9174;1262;9;24818;1455;27;0;0
FR;5;2022-01-17;2297;718;26;0;986;29;0;0;0;153150;9892;1288;9;25804;1484;27;0;0
FR;5;2022-01-18;2431;870;30;0;1141;40;0;0;0;155581;10762;1318;9;26945;1524;27;0;0
FR;5;2022-01-19;18484;6423;74;2;8366;142;3;0;0;174065;17185;1392;11;35311;1666;30;0;0
FR;5;2022-01-20;1920;1067;25;0;1295;34;2;0;0;175985;18252;1417;11;36606;1700;32;0;0
FR;5;2022-01-21;3077;1372;47;1;1677;59;2;0;0;179062;19624;1464;12;38283;1759;34;0;0
FR;5;2022-01-22;10720;3454;33;1;4671;43;1;0;0;189782;23078;1497;13;42954;1802;35;0;0
FR;5;2022-01-23;2629;1415;6;0;1789;10;0;0;0;192411;24493;1503;13;44743;1812;35;0;0
FR;5;2022-01-24;1161;1341;19;0;1447;23;1;0;0;193572;25834;1522;13;46190;1835;36;0;0
FR;5;2022-01-25;1220;1550;20;2;1684;31;3;0;0;194792;27384;1542;15;47874;1866;39;0;0
FR;5;2022-01-26;10748;12032;50;1;13300;89;1;0;1;205540;39416;1592;16;61174;1955;40;0;1
FR;5;2022-01-27;1291;1693;10;0;1838;17;0;0;0;206831;41109;1602;16;63012;1972;40;0;1
FR;5;2022-01-28;1698;3346;16;0;3566;19;1;0;0;208529;44455;1618;16;66578;1991;41;0;1
FR;5;2022-01-29;6241;8041;68;0;8855;96;2;0;0;214770;52496;1686;16;75433;2087;43;0;1
FR;5;2022-01-30;1509;2950;5;0;3185;18;0;0;0;216279;55446;1691;16;78618;2105;43;0;1
FR;5;2022-01-31;589;1773;23;0;1837;24;3;0;0;216868;57219;1714;16;80455;2129;46;0;1
FR;5;2022-02-01;712;1706;10;0;1791;15;0;0;0;217580;58925;1724;16;82246;2144;46;0;1
FR;5;2022-02-02;6959;15655;52;0;16603;94;0;0;0;224539;74580;1776;16;98849;2238;46;0;1
FR;5;2022-02-03;492;1691;14;0;1748;13;5;0;0;225031;76271;1790;16;100597;2251;51;0;1
FR;5;2022-02-04;945;3002;19;0;3123;31;0;0;0;225976;79273;1809;16;103720;2282;51;0;1
FR;5;2022-02-05;3536;8919;23;0;9517;37;0;0;0;229512;88192;1832;16;113237;2319;51;0;1
FR;5;2022-02-06;737;2398;10;0;2556;19;0;0;0;230249;90590;1842;16;115793;2338;51;0;1
FR;5;2022-02-07;884;1596;23;0;1715;25;2;0;0;231133;92186;1865;16;117508;2363;53;0;1
FR;5;2022-02-08;725;1287;18;0;1407;20;2;0;0;231858;93473;1883;16;118915;2383;55;0;1
FR;5;2022-02-09;4544;12880;44;0;13608;76;1;0;0;236402;106353;1927;16;132523;2459;56;0;1
FR;5;2022-02-10;646;1059;14;0;1166;15;0;0;0;237048;107412;1941;16;133689;2474;56;0;1
FR;5;2022-02-11;793;2032;16;0;2163;21;1;0;0;237841;109444;1957;16;135852;2495;57;0;1
FR;5;2022-02-12;2286;6812;33;0;7279;53;0;0;0;240127;116256;1990;16;143131;2548;57;0;1
FR;5;2022-02-13;464;1541;8;0;1654;8;1;0;0;240591;117797;1998;16;144785;2556;58;0;1
FR;5;2022-02-14;678;1288;10;0;1407;13;1;0;0;241269;119085;2008;16;146192;2569;59;0;1
FR;5;2022-02-15;482;886;9;0;968;14;1;0;0;241751;119971;2017;16;147160;2583;60;0;1
FR;5;2022-02-16;2980;9124;41;1;9676;58;2;0;0;244731;129095;2058;17;156836;2641;62;0;1
FR;5;2022-02-17;436;809;6;0;876;7;1;0;0;245167;129904;2064;17;157712;2648;63;0;1
FR;5;2022-02-18;649;1408;13;0;1535;17;0;0;0;245816;131312;2077;17;159247;2665;63;0;1
FR;5;2022-02-19;1373;4315;16;0;4623;28;0;0;0;247189;135627;2093;17;163870;2693;63;0;1
FR;5;2022-02-20;247;879;6;0;941;8;0;0;0;247436;136506;2099;17;164811;2701;63;0;1
FR;5;2022-02-21;221;607;2;0;661;4;1;0;0;247657;137113;2101;17;165472;2705;64;0;1
FR;5;2022-02-22;262;545;17;0;591;17;1;0;0;247919;137658;2118;17;166063;2722;65;0;1
FR;5;2022-02-23;1909;6926;23;1;7346;43;0;0;0;249828;144584;2141;18;173409;2765;65;0;1
FR;5;2022-02-24;182;374;6;1;421;7;1;0;0;250010;144958;2147;19;173830;2772;66;0;1
FR;5;2022-02-25;336;951;13;0;1028;12;2;0;0;250346;145909;2160;19;174858;2784;68;0;1
FR;5;2022-02-26;972;3071;11;0;3333;15;2;0;0;251318;148980;2171;19;178191;2799;70;0;1
FR;5;2022-02-27;151;506;0;0;549;3;0;0;0;251469;149486;2171;19;178740;2802;70;0;1
FR;5;2022-02-28;162;369;1;0;408;1;0;0;0;251631;149855;2172;19;179148;2803;70;0;1
FR;5;2022-03-01;130;280;6;0;315;7;1;0;0;251761;150135;2178;19;179463;2810;71;0;1
FR;5;2022-03-02;1242;4156;28;2;4497;40;2;0;0;253003;154291;2206;21;183960;2850;73;0;1
FR;5;2022-03-03;121;251;5;0;271;10;1;0;0;253124;154542;2211;21;184231;2860;74;0;1
FR;5;2022-03-04;197;488;13;0;538;14;2;0;0;253321;155030;2224;21;184769;2874;76;0;1
FR;5;2022-03-05;677;1990;8;0;2243;16;2;0;0;253998;157020;2232;21;187012;2890;78;0;1
FR;5;2022-03-06;108;260;0;0;310;0;0;0;0;254106;157280;2232;21;187322;2890;78;0;1
FR;5;2022-03-07;71;228;5;0;254;3;2;0;0;254177;157508;2237;21;187576;2893;80;0;1
FR;5;2022-03-08;46;134;7;1;141;8;3;0;0;254223;157642;2244;22;187717;2901;83;0;1
FR;5;2022-03-09;911;3078;24;0;3407;36;0;0;0;255134;160720;2268;22;191124;2937;83;0;1
FR;5;2022-03-10;82;202;9;0;216;13;3;0;0;255216;160922;2277;22;191340;2950;86;0;1
FR;5;2022-03-11;148;369;13;1;426;15;0;0;0;255364;161291;2290;23;191766;2965;86;0;1
FR;5;2022-03-12;758;1613;13;1;1977;30;0;0;0;256122;162904;2303;24;193743;2995;86;0;1
FR;5;2022-03-13;78;102;0;0;135;0;0;0;0;256200;163006;2303;24;193878;2995;86;0;1
FR;5;2022-03-14;69;119;7;1;139;7;1;0;0;256269;163125;2310;25;194017;3002;87;0;1
FR;5;2022-03-15;83;99;4;0;119;7;1;0;0;256352;163224;2314;25;194136;3009;88;0;1
FR;5;2022-03-16;882;1827;15;3;2227;36;7;0;0;257234;165051;2329;28;196363;3045;95;0;1
FR;5;2022-03-17;68;123;8;4;151;10;4;0;0;257302;165174;2337;32;196514;3055;99;0;1
FR;5;2022-03-18;172;318;13;4;391;18;4;0;0;257474;165492;2350;36;196905;3073;103;0;1
FR;5;2022-03-19;752;1163;12;5;1555;33;8;0;0;258226;166655;2362;41;198460;3106;111;0;1
FR;5;2022-03-20;45;93;1;0;119;1;0;0;0;258271;166748;2363;41;198579;3107;111;0;1
FR;5;2022-03-21;71;120;10;6;136;15;8;0;0;258342;166868;2373;47;198715;3122;119;0;1
FR;5;2022-03-22;56;119;8;7;143;9;6;0;0;258398;166987;2381;54;198858;3131;125;0;1
FR;5;2022-03-23;805;1461;14;8;1878;36;9;0;0;259203;168448;2395;62;200736;3167;134;0;1
FR;5;2022-03-24;71;93;8;7;118;7;10;0;0;259274;168541;2403;69;200854;3174;144;0;1
FR;5;2022-03-25;222;293;14;8;388;18;9;0;0;259496;168834;2417;77;201242;3192;153;0;1
FR;5;2022-03-26;707;853;12;5;1273;26;6;0;1;260203;169687;2429;82;202515;3218;159;0;2
FR;5;2022-03-27;76;81;0;0;124;3;0;0;0;260279;169768;2429;82;202639;3221;159;0;2
FR;5;2022-03-28;81;93;1;2;132;3;2;0;0;260360;169861;2430;84;202771;3224;161;0;2
FR;5;2022-03-29;71;83;10;4;114;12;5;0;0;260431;169944;2440;88;202885;3236;166;0;2
FR;5;2022-03-30;823;1116;16;13;1604;29;14;0;0;261254;171060;2456;101;204489;3265;180;0;2
FR;5;2022-03-31;102;125;1;4;173;6;4;0;0;261356;171185;2457;105;204662;3271;184;0;2
FR;5;2022-04-01;114;86;7;12;135;11;12;0;1;261470;171271;2464;117;204797;3282;196;0;3
FR;5;2022-04-02;330;349;3;3;535;15;4;0;0;261800;171620;2467;120;205332;3297;200;0;3
FR;5;2022-04-03;54;59;1;0;88;1;0;0;0;261854;171679;2468;120;205420;3298;200;0;3
FR;5;2022-04-04;40;57;4;1;70;8;2;0;0;261894;171736;2472;121;205490;3306;202;0;3
FR;5;2022-04-05;53;60;6;6;75;9;5;0;0;261947;171796;2478;127;205565;3315;207;0;3
FR;5;2022-04-06;421;439;7;14;678;16;14;0;0;262368;172235;2485;141;206243;3331;221;0;3
FR;5;2022-04-07;45;69;5;7;89;7;10;0;0;262413;172304;2490;148;206332;3338;231;0;3
FR;5;2022-04-08;134;112;12;13;175;14;15;0;0;262547;172416;2502;161;206507;3352;246;0;3
FR;5;2022-04-09;311;324;2;5;511;17;5;0;0;262858;172740;2504;166;207018;3369;251;0;3
FR;5;2022-04-10;44;31;2;0;61;2;1;0;0;262902;172771;2506;166;207079;3371;252;0;3
FR;5;2022-04-11;50;60;3;2;78;4;3;0;0;262952;172831;2509;168;207157;3375;255;0;3
FR;5;2022-04-12;59;54;3;3;78;5;3;0;0;263011;172885;2512;171;207235;3380;258;0;3
FR;5;2022-04-13;382;413;3;8;606;16;8;0;0;263393;173298;2515;179;207841;3396;266;0;3
FR;5;2022-04-14;48;53;5;5;70;9;3;0;0;263441;173351;2520;184;207911;3405;269;0;3
FR;5;2022-04-15;91;111;4;4;152;5;6;0;0;263532;173462;2524;188;208063;3410;275;0;3
FR;5;2022-04-16;188;184;2;1;265;13;1;0;0;263720;173646;2526;189;208328;3423;276;0;3
FR;5;2022-04-17;12;11;1;0;17;1;0;0;0;263732;173657;2527;189;208345;3424;276;0;3
FR;5;2022-04-18;9;10;2;0;11;3;1;0;0;263741;173667;2529;189;208356;3427;277;0;3
FR;5;2022-04-19;75;71;6;1;96;6;4;0;0;263816;173738;2535;190;208452;3433;281;0;3
FR;5;2022-04-20;361;349;9;6;521;12;7;0;0;264177;174087;2544;196;208973;3445;288;0;3
FR;5;2022-04-21;42;64;9;10;71;12;14;0;0;264219;174151;2553;206;209044;3457;302;0;3
FR;5;2022-04-22;113;96;5;4;144;5;5;0;0;264332;174247;2558;210;209188;3462;307;0;3
FR;5;2022-04-23;209;193;4;2;284;11;3;0;0;264541;174440;2562;212;209472;3473;310;0;3
FR;5;2022-04-24;37;35;0;0;50;3;0;0;0;264578;174475;2562;212;209522;3476;310;0;3
FR;5;2022-04-25;69;65;1;1;102;4;1;0;0;264647;174540;2563;213;209624;3480;311;0;3
FR;5;2022-04-26;60;63;2;1;85;5;1;0;0;264707;174603;2565;214;209709;3485;312;0;3
FR;5;2022-04-27;335;316;3;7;463;14;8;0;0;265042;174919;2568;221;210172;3499;320;0;3
FR;5;2022-04-28;81;54;4;5;81;8;7;0;0;265123;174973;2572;226;210253;3507;327;0;3
FR;5;2022-04-29;117;84;5;19;118;12;17;0;0;265240;175057;2577;245;210371;3519;344;0;3
FR;5;2022-04-30;183;114;2;3;184;10;4;0;0;265423;175171;2579;248;210555;3529;348;0;3
FR;5;2022-05-01;11;7;0;0;11;0;0;0;0;265434;175178;2579;248;210566;3529;348;0;3
FR;5;2022-05-02;52;28;4;5;48;2;7;0;0;265486;175206;2583;253;210614;3531;355;0;3
FR;5;2022-05-03;87;57;2;4;84;11;4;0;0;265573;175263;2585;257;210698;3542;359;0;3
FR;5;2022-05-04;278;205;1;2;324;7;2;0;0;265851;175468;2586;259;211022;3549;361;0;3
FR;5;2022-05-05;62;32;3;4;46;5;4;0;0;265913;175500;2589;263;211068;3554;365;0;3
FR;5;2022-05-06;105;65;2;3;106;5;3;0;0;266018;175565;2591;266;211174;3559;368;0;3
FR;5;2022-05-07;171;117;2;10;180;13;7;0;0;266189;175682;2593;276;211354;3572;375;0;3
FR;5;2022-05-08;8;8;0;0;9;2;0;0;0;266197;175690;2593;276;211363;3574;375;0;3
FR;5;2022-05-09;44;34;15;3;51;16;4;0;0;266241;175724;2608;279;211414;3590;379;0;3
FR;5;2022-05-10;54;49;3;4;67;5;5;0;0;266295;175773;2611;283;211481;3595;384;0;3
FR;5;2022-05-11;327;237;12;7;344;21;11;0;0;266622;176010;2623;290;211825;3616;395;0;3
FR;5;2022-05-12;46;34;2;2;47;2;3;0;0;266668;176044;2625;292;211872;3618;398;0;3
FR;5;2022-05-13;109;83;3;8;120;8;7;0;0;266777;176127;2628;300;211992;3626;405;0;3
FR;5;2022-05-14;209;131;0;1;212;8;0;0;0;266986;176258;2628;301;212204;3634;405;0;3
FR;5;2022-05-15;22;9;2;0;18;1;1;0;0;267008;176267;2630;301;212222;3635;406;0;3
FR;5;2022-05-16;52;34;4;5;53;4;5;0;0;267060;176301;2634;306;212275;3639;411;0;3
FR;5;2022-05-17;72;40;5;0;68;2;3;0;0;267132;176341;2639;306;212343;3641;414;0;3
FR;5;2022-05-18;289;215;4;4;330;8;6;0;0;267421;176556;2643;310;212673;3649;420;0;3
FR;5;2022-05-19;45;35;5;3;42;3;4;0;0;267466;176591;2648;313;212715;3652;424;0;3
FR;5;2022-05-20;76;63;3;10;92;1;11;0;0;267542;176654;2651;323;212807;3653;435;0;3
FR;5;2022-05-21;242;166;2;3;268;17;1;0;0;267784;176820;2653;326;213075;3670;436;0;3
FR;5;2022-05-22;20;14;2;5;20;2;6;0;0;267804;176834;2655;331;213095;3672;442;0;3
FR;5;2022-05-23;42;31;4;3;42;6;3;0;0;267846;176865;2659;334;213137;3678;445;0;3
FR;5;2022-05-24;47;45;3;2;60;5;2;0;0;267893;176910;2662;336;213197;3683;447;0;3
FR;5;2022-05-25;329;258;4;1;386;16;1;0;0;268222;177168;2666;337;213583;3699;448;0;3
FR;5;2022-05-26;17;5;0;1;9;2;0;0;1;268239;177173;2666;338;213592;3701;448;0;4
FR;5;2022-05-27;99;54;4;4;89;9;3;0;0;268338;177227;2670;342;213681;3710;451;0;4
FR;5;2022-05-28;100;78;5;3;106;10;3;0;0;268438;177305;2675;345;213787;3720;454;0;4
FR;5;2022-05-29;14;14;1;0;18;2;0;0;0;268452;177319;2676;345;213805;3722;454;0;4
FR;5;2022-05-30;56;41;2;1;54;2;2;0;0;268508;177360;2678;346;213859;3724;456;0;4
FR;5;2022-05-31;57;43;1;8;62;1;8;0;0;268565;177403;2679;354;213921;3725;464;0;4
FR;5;2022-06-01;257;241;9;2;302;25;5;0;0;268822;177644;2688;356;214223;3750;469;0;4
FR;5;2022-06-02;63;61;5;0;73;9;1;0;0;268885;177705;2693;356;214296;3759;470;0;4
FR;5;2022-06-03;83;71;4;5;88;10;6;0;0;268968;177776;2697;361;214384;3769;476;0;4
FR;5;2022-06-04;157;109;2;1;187;9;1;0;0;269125;177885;2699;362;214571;3778;477;0;4
FR;5;2022-06-05;18;11;0;0;21;1;0;0;0;269143;177896;2699;362;214592;3779;477;0;4
FR;5;2022-06-06;16;12;0;1;15;0;1;0;0;269159;177908;2699;363;214607;3779;478;0;4
FR;5;2022-06-07;50;56;1;1;76;2;1;0;0;269209;177964;2700;364;214683;3781;479;0;4
FR;5;2022-06-08;283;225;3;4;332;17;2;0;0;269492;178189;2703;368;215015;3798;481;0;4
FR;5;2022-06-09;52;41;6;3;57;7;2;0;1;269544;178230;2709;371;215072;3805;483;0;5
FR;5;2022-06-10;81;72;1;1;105;6;1;0;0;269625;178302;2710;372;215177;3811;484;0;5
FR;5;2022-06-11;173;141;3;3;202;10;4;0;0;269798;178443;2713;375;215379;3821;488;0;5
FR;5;2022-06-12;17;16;0;0;19;2;0;0;0;269815;178459;2713;375;215398;3823;488;0;5
FR;5;2022-06-13;56;47;9;3;70;10;6;0;0;269871;178506;2722;378;215468;3833;494;0;5
FR;5;2022-06-14;59;56;1;4;64;6;4;0;0;269930;178562;2723;382;215532;3839;498;0;5
FR;5;2022-06-15;266;260;5;2;363;27;1;0;0;270196;178822;2728;384;215895;3866;499;0;5
FR;5;2022-06-16;47;30;5;2;44;5;2;0;0;270243;178852;2733;386;215939;3871;501;0;5
FR;5;2022-06-17;100;67;5;5;102;10;5;0;0;270343;178919;2738;391;216041;3881;506;0;5
FR;5;2022-06-18;146;95;10;2;152;26;2;0;1;270489;179014;2748;393;216193;3907;508;0;6
FR;5;2022-06-19;26;15;0;1;18;4;1;0;0;270515;179029;2748;394;216211;3911;509;0;6
FR;5;2022-06-20;56;50;8;0;62;11;2;0;0;270571;179079;2756;394;216273;3922;511;0;6
FR;5;2022-06-21;53;73;5;3;91;7;5;0;1;270624;179152;2761;397;216364;3929;516;0;7
FR;5;2022-06-22;224;248;7;9;348;33;10;0;0;270848;179400;2768;406;216712;3962;526;0;7
FR;5;2022-06-23;50;38;2;5;43;6;6;0;0;270898;179438;2770;411;216755;3968;532;0;7
FR;5;2022-06-24;91;70;12;5;101;16;8;0;0;270989;179508;2782;416;216856;3984;540;0;7
FR;5;2022-06-25;154;124;3;7;185;14;8;0;1;271143;179632;2785;423;217041;3998;548;0;8
FR;5;2022-06-26;26;19;2;0;29;5;0;0;0;271169;179651;2787;423;217070;4003;548;0;8
FR;5;2022-06-27;57;60;5;7;78;11;9;0;0;271226;179711;2792;430;217148;4014;557;0;8
FR;5;2022-06-28;70;49;8;2;69;14;5;0;0;271296;179760;2800;432;217217;4028;562;0;8
FR;5;2022-06-29;297;269;9;21;391;34;23;0;0;271593;180029;2809;453;217608;4062;585;0;8
FR;5;2022-06-30;89;57;10;12;89;17;11;0;0;271682;180086;2819;465;217697;4079;596;0;8
FR;5;2022-07-01;127;65;7;11;118;12;11;0;2;271809;180151;2826;476;217815;4091;607;0;10
FR;5;2022-07-02;191;132;4;0;210;22;0;0;0;272000;180283;2830;476;218025;4113;607;0;10
FR;5;2022-07-03;30;25;1;0;36;4;0;0;0;272030;180308;2831;476;218061;4117;607;0;10
FR;5;2022-07-04;103;65;2;5;102;7;5;0;1;272133;180373;2833;481;218163;4124;612;0;11
FR;5;2022-07-05;104;72;3;8;107;13;8;0;1;272237;180445;2836;489;218270;4137;620;0;12
FR;5;2022-07-06;278;168;9;36;289;27;36;0;0;272515;180613;2845;525;218559;4164;656;0;12
FR;5;2022-07-07;88;69;6;9;89;13;11;0;0;272603;180682;2851;534;218648;4177;667;0;12
FR;5;2022-07-08;152;120;7;14;146;25;13;0;1;272755;180802;2858;548;218794;4202;680;0;13
FR;5;2022-07-09;116;68;1;8;100;10;8;0;0;272871;180870;2859;556;218894;4212;688;0;13
FR;5;2022-07-10;15;6;0;0;10;1;0;0;0;272886;180876;2859;556;218904;4213;688;0;13
FR;5;2022-07-11;92;72;10;2;98;19;3;0;0;272978;180948;2869;558;219002;4232;691;0;13
FR;5;2022-07-12;67;63;5;10;81;7;12;0;0;273045;181011;2874;568;219083;4239;703;0;13
FR;5;2022-07-13;169;118;10;19;196;16;23;0;0;273214;181129;2884;587;219279;4255;726;0;13
FR;5;2022-07-14;8;4;0;0;7;0;0;0;0;273222;181133;2884;587;219286;4255;726;0;13
FR;5;2022-07-15;74;66;5;14;86;15;15;0;0;273296;181199;2889;601;219372;4270;741;0;13
FR;5;2022-07-16;54;44;3;0;71;3;2;0;0;273350;181243;2892;601;219443;4273;743;0;13
FR;5;2022-07-17;10;7;3;0;10;2;2;0;0;273360;181250;2895;601;219453;4275;745;0;13
FR;5;2022-07-18;60;47;0;4;70;4;3;0;0;273420;181297;2895;605;219523;4279;748;0;13
FR;5;2022-07-19;63;42;5;3;63;7;4;0;0;273483;181339;2900;608;219586;4286;752;0;13
FR;5;2022-07-20;120;106;4;11;141;14;9;0;0;273603;181445;2904;619;219727;4300;761;0;13
FR;5;2022-07-21;38;43;2;10;52;5;10;0;0;273641;181488;2906;629;219779;4305;771;0;13
FR;5;2022-07-22;48;69;11;13;75;23;11;0;1;273689;181557;2917;642;219854;4328;782;0;14
FR;5;2022-07-23;59;78;2;1;95;11;2;0;0;273748;181635;2919;643;219949;4339;784;0;14
FR;5;2022-07-24;11;9;3;1;12;3;1;0;0;273759;181644;2922;644;219961;4342;785;0;14
FR;5;2022-07-25;53;48;2;7;57;8;8;0;0;273812;181692;2924;651;220018;4350;793;0;14
FR;5;2022-07-26;58;52;5;41;70;6;44;0;0;273870;181744;2929;692;220088;4356;837;0;14
FR;5;2022-07-27;106;118;4;4;161;13;4;0;0;273976;181862;2933;696;220249;4369;841;0;14
FR;5;2022-07-28;39;35;2;2;47;6;1;0;0;274015;181897;2935;698;220296;4375;842;0;14
FR;5;2022-07-29;56;74;3;14;90;8;10;0;0;274071;181971;2938;712;220386;4383;852;0;14
FR;5;2022-07-30;55;53;5;1;76;7;2;0;0;274126;182024;2943;713;220462;4390;854;0;14
FR;5;2022-07-31;7;11;1;0;13;1;0;0;0;274133;182035;2944;713;220475;4391;854;0;14
FR;5;2022-08-01;39;53;1;2;64;6;2;0;0;274172;182088;2945;715;220539;4397;856;0;14
FR;5;2022-08-02;32;43;8;7;47;8;7;0;1;274204;182131;2953;722;220586;4405;863;0;15
FR;5;2022-08-03;54;51;4;10;70;9;8;0;0;274258;182182;2957;732;220656;4414;871;0;15
FR;5;2022-08-04;20;18;1;6;22;1;6;0;0;274278;182200;2958;738;220678;4415;877;0;15
FR;5;2022-08-05;35;26;3;3;39;3;3;0;0;274313;182226;2961;741;220717;4418;880;0;15
FR;5;2022-08-06;23;26;1;0;31;1;0;0;0;274336;182252;2962;741;220748;4419;880;0;15
FR;5;2022-08-07;2;2;1;0;1;1;1;0;0;274338;182254;2963;741;220749;4420;881;0;15
FR;5;2022-08-08;26;19;1;2;24;2;1;0;0;274364;182273;2964;743;220773;4422;882;0;15
FR;5;2022-08-09;26;28;3;3;35;3;3;0;0;274390;182301;2967;746;220808;4425;885;0;15
FR;5;2022-08-10;47;47;2;0;56;5;0;0;0;274437;182348;2969;746;220864;4430;885;0;15
FR;5;2022-08-11;19;36;2;2;42;5;2;0;0;274456;182384;2971;748;220906;4435;887;0;15
FR;5;2022-08-12;27;28;2;0;39;2;0;0;0;274483;182412;2973;748;220945;4437;887;0;15
FR;5;2022-08-13;16;18;0;0;24;0;0;0;0;274499;182430;2973;748;220969;4437;887;0;15
FR;5;2022-08-14;2;3;0;0;4;0;0;0;0;274501;182433;2973;748;220973;4437;887;0;15
FR;5;2022-08-15;2;6;0;0;6;0;0;0;0;274503;182439;2973;748;220979;4437;887;0;15
FR;5;2022-08-16;33;26;3;0;28;6;0;0;0;274536;182465;2976;748;221007;4443;887;0;15
FR;5;2022-08-17;52;55;2;1;72;1;1;0;0;274588;182520;2978;749;221079;4444;888;0;15
FR;5;2022-08-18;26;18;8;17;25;10;16;0;0;274614;182538;2986;766;221104;4454;904;0;15
FR;5;2022-08-19;26;34;1;2;43;2;2;0;0;274640;182572;2987;768;221147;4456;906;0;15
FR;5;2022-08-20;25;27;2;1;33;4;2;0;0;274665;182599;2989;769;221180;4460;908;0;15
FR;5;2022-08-21;7;4;1;0;7;1;0;0;0;274672;182603;2990;769;221187;4461;908;0;15
FR;5;2022-08-22;39;26;1;6;42;2;5;0;1;274711;182629;2991;775;221229;4463;913;0;16
FR;5;2022-08-23;27;26;1;1;32;2;1;0;0;274738;182655;2992;776;221261;4465;914;0;16
FR;5;2022-08-24;50;43;0;0;62;0;0;0;0;274788;182698;2992;776;221323;4465;914;0;16
FR;5;2022-08-25;27;26;3;1;31;2;0;0;1;274815;182724;2995;777;221354;4467;914;0;17
FR;5;2022-08-26;48;39;7;2;58;5;4;0;0;274863;182763;3002;779;221412;4472;918;0;17
FR;5;2022-08-27;46;28;1;0;46;3;1;0;0;274909;182791;3003;779;221458;4475;919;0;17
FR;5;2022-08-28;5;7;0;0;7;0;0;0;0;274914;182798;3003;779;221465;4475;919;0;17
FR;5;2022-08-29;58;44;1;1;66;4;1;0;0;274972;182842;3004;780;221531;4479;920;0;17
FR;5;2022-08-30;45;23;12;29;40;10;30;0;1;275017;182865;3016;809;221571;4489;950;0;18
FR;5;2022-08-31;53;47;6;1;58;11;1;0;0;275070;182912;3022;810;221629;4500;951;0;18
FR;5;2022-09-01;16;8;1;4;13;1;4;0;0;275086;182920;3023;814;221642;4501;955;0;18
FR;5;2022-09-02;42;23;8;2;35;9;3;0;0;275128;182943;3031;816;221677;4510;958;0;18
FR;5;2022-09-03;69;37;2;0;58;2;0;0;0;275197;182980;3033;816;221735;4512;958;0;18
FR;5;2022-09-04;12;7;1;0;8;3;0;0;0;275209;182987;3034;816;221743;4515;958;0;18
FR;5;2022-09-05;7;4;1;0;4;1;0;0;0;275216;182991;3035;816;221747;4516;958;0;18
FR;5;2022-09-06;23;14;3;15;17;2;14;0;2;275239;183005;3038;831;221764;4518;972;0;20
FR;5;2022-09-07;79;53;1;1;76;3;1;0;0;275318;183058;3039;832;221840;4521;973;0;20
FR;5;2022-09-08;10;4;0;4;7;0;4;0;0;275328;183062;3039;836;221847;4521;977;0;20
FR;5;2022-09-09;42;11;9;2;14;10;3;0;0;275370;183073;3048;838;221861;4531;980;0;20
FR;5;2022-09-10;40;45;1;1;50;8;1;0;0;275410;183118;3049;839;221911;4539;981;0;20
FR;5;2022-09-11;3;3;0;0;3;1;0;0;0;275413;183121;3049;839;221914;4540;981;0;20
FR;5;2022-09-12;7;5;2;2;7;2;2;0;0;275420;183126;3051;841;221921;4542;983;0;20
FR;5;2022-09-13;9;6;0;1;4;3;1;0;0;275429;183132;3051;842;221925;4545;984;0;20
FR;5;2022-09-14;52;47;4;6;55;9;5;0;0;275481;183179;3055;848;221980;4554;989;0;20
FR;5;2022-09-15;11;13;2;3;11;5;3;0;0;275492;183192;3057;851;221991;4559;992;0;20
FR;5;2022-09-16;25;33;1;4;38;3;3;0;0;275517;183225;3058;855;222029;4562;995;0;20
FR;5;2022-09-17;60;43;1;1;51;5;1;0;0;275577;183268;3059;856;222080;4567;996;0;20
FR;5;2022-09-18;9;6;0;1;10;1;0;0;0;275586;183274;3059;857;222090;4568;996;0;20
FR;5;2022-09-19;22;17;2;1;20;5;2;0;0;275608;183291;3061;858;222110;4573;998;0;20
FR;5;2022-09-20;15;11;3;3;15;1;4;0;0;275623;183302;3064;861;222125;4574;1002;0;20
FR;5;2022-09-21;68;45;9;0;65;13;0;0;0;275691;183347;3073;861;222190;4587;1002;0;20
FR;5;2022-09-22;12;6;4;24;6;4;23;0;1;275703;183353;3077;885;222196;4591;1025;0;21
FR;5;2022-09-23;20;25;2;3;23;8;3;0;0;275723;183378;3079;888;222219;4599;1028;0;21
FR;5;2022-09-24;44;51;1;8;65;5;8;0;0;275767;183429;3080;896;222284;4604;1036;0;21
FR;5;2022-09-25;6;12;0;0;13;1;0;0;0;275773;183441;3080;896;222297;4605;1036;0;21
FR;5;2022-09-26;15;7;0;2;12;0;1;0;1;275788;183448;3080;898;222309;4605;1037;0;22
FR;5;2022-09-27;7;12;4;9;14;4;9;0;1;275795;183460;3084;907;222323;4609;1046;0;23
FR;5;2022-09-28;65;67;5;0;91;7;0;0;0;275860;183527;3089;907;222414;4616;1046;0;23
FR;5;2022-09-29;17;9;1;0;15;1;1;0;1;275877;183536;3090;907;222429;4617;1047;0;24
FR;5;2022-09-30;28;47;2;2;54;4;3;0;0;275905;183583;3092;909;222483;4621;1050;0;24
FR;5;2022-10-01;40;35;5;5;48;8;7;0;0;275945;183618;3097;914;222531;4629;1057;0;24
FR;5;2022-10-02;1;9;1;0;10;1;0;0;0;275946;183627;3098;914;222541;4630;1057;0;24
FR;5;2022-10-03;7;6;3;0;5;4;0;0;0;275953;183633;3101;914;222546;4634;1057;0;24
FR;5;2022-10-04;11;8;1;3;11;2;3;0;0;275964;183641;3102;917;222557;4636;1060;0;24
FR;5;2022-10-05;57;62;2;2;79;13;2;0;0;276021;183703;3104;919;222636;4649;1062;0;24
FR;5;2022-10-06;12;10;1;4;15;2;4;0;0;276033;183713;3105;923;222651;4651;1066;0;24
FR;5;2022-10-07;21;31;1;0;34;5;0;0;0;276054;183744;3106;923;222685;4656;1066;0;24
FR;5;2022-10-08;33;51;1;0;54;7;0;0;0;276087;183795;3107;923;222739;4663;1066;0;24
FR;5;2022-10-09;7;10;0;0;11;1;0;0;0;276094;183805;3107;923;222750;4664;1066;0;24
FR;5;2022-10-10;14;6;0;1;8;1;1;0;0;276108;183811;3107;924;222758;4665;1067;0;24
FR;5;2022-10-11;6;13;2;1;14;2;2;0;0;276114;183824;3109;925;222772;4667;1069;0;24
FR;5;2022-10-12;40;57;3;2;69;8;2;0;0;276154;183881;3112;927;222841;4675;1071;0;24
FR;5;2022-10-13;11;16;2;0;18;4;0;0;0;276165;183897;3114;927;222859;4679;1071;0;24
FR;5;2022-10-14;21;21;1;0;20;5;0;0;0;276186;183918;3115;927;222879;4684;1071;0;24
FR;5;2022-10-15;19;26;10;0;25;11;2;0;0;276205;183944;3125;927;222904;4695;1073;0;24
FR;5;2022-10-16;3;1;0;0;1;1;0;0;0;276208;183945;3125;927;222905;4696;1073;0;24
FR;5;2022-10-17;8;8;2;1;8;3;1;0;2;276216;183953;3127;928;222913;4699;1074;0;26
FR;5;2022-10-18;6;7;0;2;8;0;2;0;0;276222;183960;3127;930;222921;4699;1076;0;26
FR;5;2022-10-19;38;44;8;0;53;11;0;0;1;276260;184004;3135;930;222974;4710;1076;0;27
FR;5;2022-10-20;18;15;2;1;16;3;1;0;0;276278;184019;3137;931;222990;4713;1077;0;27
FR;5;2022-10-21;22;15;6;0;19;8;1;0;2;276300;184034;3143;931;223009;4721;1078;0;29
FR;5;2022-10-22;35;29;2;12;32;5;12;0;0;276335;184063;3145;943;223041;4726;1090;0;29
FR;5;2022-10-23;9;3;0;0;4;0;0;0;0;276344;184066;3145;943;223045;4726;1090;0;29
FR;5;2022-10-24;14;7;6;7;9;9;8;0;0;276358;184073;3151;950;223054;4735;1098;0;29
FR;5;2022-10-25;13;9;6;3;9;8;3;0;2;276371;184082;3157;953;223063;4743;1101;0;31
FR;5;2022-10-26;34;22;6;0;29;10;0;0;0;276405;184104;3163;953;223092;4753;1101;0;31
FR;5;2022-10-27;16;4;4;0;11;4;0;0;0;276421;184108;3167;953;223103;4757;1101;0;31
FR;5;2022-10-28;19;13;5;3;14;6;4;0;0;276440;184121;3172;956;223117;4763;1105;0;31
FR;5;2022-10-29;21;13;0;0;17;3;0;0;0;276461;184134;3172;956;223134;4766;1105;0;31
FR;5;2022-10-30;1;4;2;0;4;3;0;0;0;276462;184138;3174;956;223138;4769;1105;0;31
FR;5;2022-10-31;14;11;2;1;12;3;1;0;0;276476;184149;3176;957;223150;4772;1106;0;31
FR;5;2022-11-01;3;3;0;1;3;0;1;0;0;276479;184152;3176;958;223153;4772;1107;0;31
FR;5;2022-11-02;23;17;5;4;23;5;5;0;0;276502;184169;3181;962;223176;4777;1112;0;31
FR;5;2022-11-03;22;4;1;1;11;1;1;0;0;276524;184173;3182;963;223187;4778;1113;0;31
FR;5;2022-11-04;19;18;1;0;18;2;0;0;0;276543;184191;3183;963;223205;4780;1113;0;31
FR;5;2022-11-05;25;16;1;0;21;1;0;0;0;276568;184207;3184;963;223226;4781;1113;0;31
FR;5;2022-11-06;1;7;0;0;7;0;0;0;0;276569;184214;3184;963;223233;4781;1113;0;31
FR;5;2022-11-07;10;3;3;0;3;3;0;0;0;276579;184217;3187;963;223236;4784;1113;0;31
FR;5;2022-11-08;12;7;1;2;8;1;1;0;0;276591;184224;3188;965;223244;4785;1114;0;31
FR;5;2022-11-09;30;29;6;1;32;6;1;0;0;276621;184253;3194;966;223276;4791;1115;0;31
FR;5;2022-11-10;11;16;1;0;17;1;0;0;0;276632;184269;3195;966;223293;4792;1115;0;31
FR;5;2022-11-11;2;4;0;1;6;0;1;0;0;276634;184273;3195;967;223299;4792;1116;0;31
FR;5;2022-11-12;19;10;5;9;18;6;9;0;2;276653;184283;3200;976;223317;4798;1125;0;33
FR;5;2022-11-13;2;2;0;1;2;0;1;0;0;276655;184285;3200;977;223319;4798;1126;0;33
FR;5;2022-11-14;8;11;0;1;10;3;0;0;0;276663;184296;3200;978;223329;4801;1126;0;33
FR;5;2022-11-15;8;6;4;3;6;4;3;0;0;276671;184302;3204;981;223335;4805;1129;0;33
FR;5;2022-11-16;29;28;2;1;33;5;0;0;0;276700;184330;3206;982;223368;4810;1129;0;33
FR;5;2022-11-17;6;16;4;0;16;5;0;0;0;276706;184346;3210;982;223384;4815;1129;0;33
FR;5;2022-11-18;17;17;7;0;19;9;0;0;0;276723;184363;3217;982;223403;4824;1129;0;33
FR;5;2022-11-19;18;27;2;0;28;6;0;0;0;276741;184390;3219;982;223431;4830;1129;0;33
FR;5;2022-11-20;6;3;0;0;5;0;0;0;0;276747;184393;3219;982;223436;4830;1129;0;33
FR;5;2022-11-21;8;5;0;2;4;2;1;0;0;276755;184398;3219;984;223440;4832;1130;0;33
FR;5;2022-11-22;9;3;0;1;4;0;1;0;0;276764;184401;3219;985;223444;4832;1131;0;33
FR;5;2022-11-23;34;25;6;1;27;13;0;0;0;276798;184426;3225;986;223471;4845;1131;0;33
FR;5;2022-11-24;3;7;2;0;8;1;1;0;0;276801;184433;3227;986;223479;4846;1132;0;33
FR;5;2022-11-25;15;20;2;0;25;3;0;0;1;276816;184453;3229;986;223504;4849;1132;0;34
FR;5;2022-11-26;22;19;4;0;20;8;0;0;0;276838;184472;3233;986;223524;4857;1132;0;34
FR;5;2022-11-27;7;0;1;0;3;1;0;0;0;276845;184472;3234;986;223527;4858;1132;0;34
FR;5;2022-11-28;7;15;3;0;15;5;0;0;0;276852;184487;3237;986;223542;4863;1132;0;34
FR;5;2022-11-29;10;9;1;0;11;3;0;0;1;276862;184496;3238;986;223553;4866;1132;0;35
FR;5;2022-11-30;35;48;12;0;56;17;1;0;0;276897;184544;3250;986;223609;4883;1133;0;35
FR;5;2022-12-01;5;10;2;0;10;3;0;0;0;276902;184554;3252;986;223619;4886;1133;0;35
FR;5;2022-12-02;1;5;2;1;4;3;1;0;0;276903;184559;3254;987;223623;4889;1134;0;35
FR;5;2022-12-03;3;3;8;1;5;8;1;0;0;276906;184562;3262;988;223628;4897;1135;0;35
FR;5;2022-12-04;3;2;1;0;2;2;0;0;0;276909;184564;3263;988;223630;4899;1135;0;35
FR;5;2022-12-05;1;2;0;0;1;1;0;0;0;276910;184566;3263;988;223631;4900;1135;0;35
FR;5;2022-12-06;5;1;0;0;1;0;0;0;1;276915;184567;3263;988;223632;4900;1135;0;36
FR;5;2022-12-07;5;8;1;0;8;1;0;0;0;276920;184575;3264;988;223640;4901;1135;0;36
FR;5;2022-12-08;2;2;0;0;2;0;0;0;0;276922;184577;3264;988;223642;4901;1135;0;36
FR;5;2022-12-09;5;8;0;0;6;2;0;0;0;276927;184585;3264;988;223648;4903;1135;0;36
FR;5;2022-12-10;4;7;2;1;8;2;1;0;0;276931;184592;3266;989;223656;4905;1136;0;36
FR;5;2022-12-11;2;0;0;0;0;0;0;0;0;276933;184592;3266;989;223656;4905;1136;0;36
FR;5;2022-12-12;0;0;0;0;0;0;0;0;0;276933;184592;3266;989;223656;4905;1136;0;36
FR;5;2022-12-13;2;3;0;0;4;1;0;0;0;276935;184595;3266;989;223660;4906;1136;0;36
FR;5;2022-12-14;2;3;0;9;3;1;8;0;3;276937;184598;3266;998;223663;4907;1144;0;39
FR;5;2022-12-15;0;2;0;0;2;0;0;0;0;276937;184600;3266;998;223665;4907;1144;0;39
FR;5;2022-12-16;3;3;2;0;4;3;0;0;0;276940;184603;3268;998;223669;4910;1144;0;39
FR;5;2022-12-17;3;3;3;0;3;2;1;0;0;276943;184606;3271;998;223672;4912;1145;0;39
FR;5;2022-12-18;3;0;0;1;0;0;1;0;1;276946;184606;3271;999;223672;4912;1146;0;40
FR;5;2022-12-19;1;0;0;2;0;0;2;0;0;276947;184606;3271;1001;223672;4912;1148;0;40
FR;5;2022-12-20;0;1;3;0;1;3;0;0;0;276947;184607;3274;1001;223673;4915;1148;0;40
FR;5;2022-12-21;2;4;0;0;4;0;0;0;0;276949;184611;3274;1001;223677;4915;1148;0;40
FR;5;2022-12-22;2;2;1;0;2;1;0;0;0;276951;184613;3275;1001;223679;4916;1148;0;40
FR;5;2022-12-23;3;1;1;0;1;1;0;0;0;276954;184614;3276;1001;223680;4917;1148;0;40
FR;5;2022-12-24;0;1;0;0;1;0;0;0;0;276954;184615;3276;1001;223681;4917;1148;0;40
FR;5;2022-12-25;0;1;2;0;0;3;0;0;0;276954;184616;3278;1001;223681;4920;1148;0;40
FR;5;2022-12-26;2;2;0;0;2;0;0;0;0;276956;184618;3278;1001;223683;4920;1148;0;40
FR;5;2022-12-27;0;3;0;0;3;0;0;0;0;276956;184621;3278;1001;223686;4920;1148;0;40
FR;5;2022-12-28;5;3;3;0;3;3;2;0;0;276961;184624;3281;1001;223689;4923;1150;0;40
FR;5;2022-12-29;3;2;2;0;3;2;0;0;0;276964;184626;3283;1001;223692;4925;1150;0;40
FR;5;2022-12-30;3;2;1;0;2;1;0;0;0;276967;184628;3284;1001;223694;4926;1150;0;40
FR;5;2022-12-31;0;0;0;0;0;0;0;0;0;276967;184628;3284;1001;223694;4926;1150;0;40
FR;5;2023-01-01;0;0;0;0;0;0;0;0;0;276967;184628;3284;1001;223694;4926;1150;0;40
FR;5;2023-01-02;1;1;1;0;1;1;0;0;0;276968;184629;3285;1001;223695;4927;1150;0;40
FR;5;2023-01-03;3;1;0;0;2;0;0;0;0;276971;184630;3285;1001;223697;4927;1150;0;40
FR;5;2023-01-04;6;1;1;0;2;1;0;0;0;276977;184631;3286;1001;223699;4928;1150;0;40
FR;5;2023-01-05;0;3;0;0;3;0;0;0;0;276977;184634;3286;1001;223702;4928;1150;0;40
FR;5;2023-01-06;2;1;1;0;1;1;0;0;0;276979;184635;3287;1001;223703;4929;1150;0;40
FR;5;2023-01-07;5;1;1;0;1;2;0;0;0;276984;184636;3288;1001;223704;4931;1150;0;40
FR;5;2023-01-08;2;2;0;0;2;0;0;0;0;276986;184638;3288;1001;223706;4931;1150;0;40
FR;5;2023-01-09;4;0;1;0;1;1;0;0;0;276990;184638;3289;1001;223707;4932;1150;0;40
FR;5;2023-01-10;3;1;0;0;2;0;0;0;0;276993;184639;3289;1001;223709;4932;1150;0;40
FR;5;2023-01-11;7;5;3;0;4;4;0;0;0;277000;184644;3292;1001;223713;4936;1150;0;40
FR;5;2023-01-12;14;6;4;0;6;6;0;0;0;277014;184650;3296;1001;223719;4942;1150;0;40
FR;5;2023-01-13;56;16;16;0;31;18;0;0;0;277070;184666;3312;1001;223750;4960;1150;0;40
FR;5;2023-01-14;56;34;13;1;34;20;2;0;0;277126;184700;3325;1002;223784;4980;1152;0;40
FR;5;2023-01-15;13;9;0;0;5;4;0;0;0;277139;184709;3325;1002;223789;4984;1152;0;40
FR;5;2023-01-16;13;8;3;0;8;3;0;0;0;277152;184717;3328;1002;223797;4987;1152;0;40
FR;5;2023-01-17;12;8;3;0;4;7;0;0;0;277164;184725;3331;1002;223801;4994;1152;0;40
FR;5;2023-01-18;72;35;21;2;46;25;2;0;0;277236;184760;3352;1004;223847;5019;1154;0;40
FR;5;2023-01-19;13;6;8;0;5;10;1;0;0;277249;184766;3360;1004;223852;5029;1155;0;40
FR;5;2023-01-20;27;17;13;0;17;18;0;0;2;277276;184783;3373;1004;223869;5047;1155;0;42
FR;5;2023-01-21;34;23;18;1;31;21;1;0;0;277310;184806;3391;1005;223900;5068;1156;0;42
FR;5;2023-01-22;6;4;2;0;4;3;0;0;0;277316;184810;3393;1005;223904;5071;1156;0;42
FR;5;2023-01-23;6;5;3;0;3;5;0;0;0;277322;184815;3396;1005;223907;5076;1156;0;42
FR;5;2023-01-24;16;3;3;0;6;4;0;0;0;277338;184818;3399;1005;223913;5080;1156;0;42
FR;5;2023-01-25;33;31;12;2;27;23;2;0;0;277371;184849;3411;1007;223940;5103;1158;0;42
FR;5;2023-01-26;6;5;4;0;6;4;0;0;0;277377;184854;3415;1007;223946;5107;1158;0;42
FR;5;2023-01-27;18;13;8;0;17;8;1;0;0;277395;184867;3423;1007;223963;5115;1159;0;42
FR;5;2023-01-28;21;8;4;3;11;6;3;0;0;277416;184875;3427;1010;223974;5121;1162;0;42
FR;5;2023-01-29;0;3;0;0;2;1;0;0;0;277416;184878;3427;1010;223976;5122;1162;0;42
FR;5;2023-01-30;7;5;3;0;4;6;0;0;0;277423;184883;3430;1010;223980;5128;1162;0;42
FR;5;2023-01-31;3;7;2;0;5;4;0;0;0;277426;184890;3432;1010;223985;5132;1162;0;42
FR;5;2023-02-01;18;18;7;1;19;8;1;0;0;277444;184908;3439;1011;224004;5140;1163;0;42
FR;5;2023-02-02;7;8;1;0;7;2;0;0;0;277451;184916;3440;1011;224011;5142;1163;0;42
FR;5;2023-02-03;15;26;6;0;27;9;0;0;0;277466;184942;3446;1011;224038;5151;1163;0;42
FR;5;2023-02-04;17;23;5;0;25;6;0;0;0;277483;184965;3451;1011;224063;5157;1163;0;42
FR;5;2023-02-05;1;2;0;1;2;1;0;0;0;277484;184967;3451;1012;224065;5158;1163;0;42
FR;5;2023-02-06;12;11;7;0;12;7;0;0;0;277496;184978;3458;1012;224077;5165;1163;0;42
FR;5;2023-02-07;6;11;2;0;10;4;0;0;0;277502;184989;3460;1012;224087;5169;1163;0;42
FR;5;2023-02-08;29;35;8;0;39;10;0;0;0;277531;185024;3468;1012;224126;5179;1163;0;42
FR;5;2023-02-09;15;7;5;0;8;5;0;0;0;277546;185031;3473;1012;224134;5184;1163;0;42
FR;5;2023-02-10;11;22;5;0;24;7;0;0;0;277557;185053;3478;1012;224158;5191;1163;0;42
FR;5;2023-02-11;12;11;3;1;15;4;0;0;0;277569;185064;3481;1013;224173;5195;1163;0;42
FR;5;2023-02-12;4;7;1;0;8;1;0;0;0;277573;185071;3482;1013;224181;5196;1163;0;42
FR;5;2023-02-13;4;6;6;0;5;7;0;0;0;277577;185077;3488;1013;224186;5203;1163;0;42
FR;5;2023-02-14;11;8;2;0;9;3;0;0;0;277588;185085;3490;1013;224195;5206;1163;0;42
FR;5;2023-02-15;27;25;4;0;27;5;0;0;0;277615;185110;3494;1013;224222;5211;1163;0;42
FR;5;2023-02-16;8;4;3;0;8;3;0;0;0;277623;185114;3497;1013;224230;5214;1163;0;42
FR;5;2023-02-17;9;5;9;0;6;9;0;0;0;277632;185119;3506;1013;224236;5223;1163;0;42
FR;5;2023-02-18;9;14;3;1;16;3;1;0;0;277641;185133;3509;1014;224252;5226;1164;0;42
FR;5;2023-02-19;0;1;0;0;1;0;0;0;0;277641;185134;3509;1014;224253;5226;1164;0;42
FR;5;2023-02-20;6;6;4;0;6;5;0;0;0;277647;185140;3513;1014;224259;5231;1164;0;42
FR;5;2023-02-21;4;6;5;0;7;5;0;0;0;277651;185146;3518;1014;224266;5236;1164;0;42
FR;5;2023-02-22;10;16;5;0;15;5;1;0;0;277661;185162;3523;1014;224281;5241;1165;0;42
FR;5;2023-02-23;5;5;2;0;5;2;0;0;0;277666;185167;3525;1014;224286;5243;1165;0;42
FR;5;2023-02-24;17;23;1;0;22;3;0;0;0;277683;185190;3526;1014;224308;5246;1165;0;42
FR;5;2023-02-25;11;9;0;0;10;0;0;0;0;277694;185199;3526;1014;224318;5246;1165;0;42
FR;5;2023-02-26;1;1;0;0;1;0;0;0;0;277695;185200;3526;1014;224319;5246;1165;0;42
FR;5;2023-02-27;7;5;2;0;5;2;0;0;0;277702;185205;3528;1014;224324;5248;1165;0;42
FR;5;2023-02-28;4;8;2;0;8;4;0;0;0;277706;185213;3530;1014;224332;5252;1165;0;42
FR;5;2023-03-01;12;25;1;0;23;3;1;0;0;277718;185238;3531;1014;224355;5255;1166;0;42
FR;5;2023-03-02;7;13;3;0;12;5;0;0;0;277725;185251;3534;1014;224367;5260;1166;0;42
FR;5;2023-03-03;11;4;3;0;8;3;1;0;0;277736;185255;3537;1014;224375;5263;1167;0;42
FR;5;2023-03-04;8;17;7;0;18;8;0;0;0;277744;185272;3544;1014;224393;5271;1167;0;42
FR;5;2023-03-05;3;3;0;0;3;0;0;0;0;277747;185275;3544;1014;224396;5271;1167;0;42
FR;5;2023-03-06;2;8;2;0;6;4;0;0;0;277749;185283;3546;1014;224402;5275;1167;0;42
FR;5;2023-03-07;2;9;4;0;9;4;0;0;0;277751;185292;3550;1014;224411;5279;1167;0;42
FR;5;2023-03-08;9;21;1;0;22;1;0;0;0;277760;185313;3551;1014;224433;5280;1167;0;42
FR;5;2023-03-09;1;6;0;0;5;1;0;0;0;277761;185319;3551;1014;224438;5281;1167;0;42
FR;5;2023-03-10;3;7;2;1;8;2;1;0;0;277764;185326;3553;1015;224446;5283;1168;0;42
FR;5;2023-03-11;5;4;0;0;6;0;0;0;0;277769;185330;3553;1015;224452;5283;1168;0;42
FR;5;2023-03-12;0;1;0;0;1;0;0;0;0;277769;185331;3553;1015;224453;5283;1168;0;42
FR;5;2023-03-13;2;2;0;0;4;0;0;0;0;277771;185333;3553;1015;224457;5283;1168;0;42
FR;5;2023-03-14;6;1;1;1;5;1;1;0;0;277777;185334;3554;1016;224462;5284;1169;0;42
FR;5;2023-03-15;7;8;2;0;12;3;0;0;0;277784;185342;3556;1016;224474;5287;1169;0;42
FR;5;2023-03-16;2;6;0;0;6;0;0;0;0;277786;185348;3556;1016;224480;5287;1169;0;42
FR;5;2023-03-17;14;15;3;0;13;4;1;0;0;277800;185363;3559;1016;224493;5291;1170;0;42
FR;5;2023-03-18;4;9;0;0;9;1;0;0;0;277804;185372;3559;1016;224502;5292;1170;0;42
FR;5;2023-03-19;0;0;0;0;0;0;0;0;0;277804;185372;3559;1016;224502;5292;1170;0;42
FR;5;2023-03-20;3;8;0;0;9;0;0;0;0;277807;185380;3559;1016;224511;5292;1170;0;42
FR;5;2023-03-21;3;8;2;2;8;2;2;0;0;277810;185388;3561;1018;224519;5294;1172;0;42
FR;5;2023-03-22;9;22;3;0;20;4;0;0;0;277819;185410;3564;1018;224539;5298;1172;0;42
FR;5;2023-03-23;2;5;1;0;5;1;0;0;0;277821;185415;3565;1018;224544;5299;1172;0;42
FR;5;2023-03-24;5;9;1;0;9;3;0;0;0;277826;185424;3566;1018;224553;5302;1172;0;42
FR;5;2023-03-25;3;8;2;0;8;2;0;0;0;277829;185432;3568;1018;224561;5304;1172;0;42
FR;5;2023-03-26;0;1;0;0;0;1;0;0;0;277829;185433;3568;1018;224561;5305;1172;0;42
FR;5;2023-03-27;3;0;1;0;1;1;0;0;0;277832;185433;3569;1018;224562;5306;1172;0;42
FR;5;2023-03-28;3;3;0;0;4;0;0;0;0;277835;185436;3569;1018;224566;5306;1172;0;42
FR;5;2023-03-29;7;16;4;0;16;6;0;0;0;277842;185452;3573;1018;224582;5312;1172;0;42
FR;5;2023-03-30;3;2;0;0;4;0;0;0;1;277845;185454;3573;1018;224586;5312;1172;0;43
FR;5;2023-03-31;3;7;2;1;7;2;1;0;0;277848;185461;3575;1019;224593;5314;1173;0;43
FR;5;2023-04-01;5;7;3;1;5;4;2;0;0;277853;185468;3578;1020;224598;5318;1175;0;43
FR;5;2023-04-02;0;1;0;0;1;0;0;0;0;277853;185469;3578;1020;224599;5318;1175;0;43
FR;5;2023-04-03;3;4;2;0;4;0;2;0;0;277856;185473;3580;1020;224603;5318;1177;0;43
FR;5;2023-04-04;1;3;0;0;3;0;0;0;0;277857;185476;3580;1020;224606;5318;1177;0;43
FR;5;2023-04-05;3;6;1;0;5;2;0;0;0;277860;185482;3581;1020;224611;5320;1177;0;43
FR;5;2023-04-06;3;3;0;0;3;0;0;0;0;277863;185485;3581;1020;224614;5320;1177;0;43
FR;5;2023-04-07;6;4;1;0;4;1;0;0;0;277869;185489;3582;1020;224618;5321;1177;0;43
FR;5;2023-04-08;6;10;1;0;10;1;0;0;0;277875;185499;3583;1020;224628;5322;1177;0;43
FR;5;2023-04-09;0;0;0;0;0;0;0;0;0;277875;185499;3583;1020;224628;5322;1177;0;43
FR;5;2023-04-10;0;0;0;0;0;0;0;0;0;277875;185499;3583;1020;224628;5322;1177;0;43
FR;5;2023-04-11;1;6;0;0;6;0;0;0;1;277876;185505;3583;1020;224634;5322;1177;0;44
FR;5;2023-04-12;4;9;1;0;9;1;0;0;0;277880;185514;3584;1020;224643;5323;1177;0;44
FR;5;2023-04-13;2;1;2;0;0;3;0;0;0;277882;185515;3586;1020;224643;5326;1177;0;44
FR;5;2023-04-14;5;5;2;0;8;2;0;0;0;277887;185520;3588;1020;224651;5328;1177;0;44
FR;5;2023-04-15;3;4;0;0;4;0;0;0;0;277890;185524;3588;1020;224655;5328;1177;0;44
FR;5;2023-04-16;1;0;0;0;0;0;0;0;0;277891;185524;3588;1020;224655;5328;1177;0;44
FR;5;2023-04-17;4;4;3;0;4;3;0;0;0;277895;185528;3591;1020;224659;5331;1177;0;44
FR;5;2023-04-18;3;2;0;0;2;0;0;0;0;277898;185530;3591;1020;224661;5331;1177;0;44
FR;5;2023-04-19;9;7;0;0;3;5;0;0;0;277907;185537;3591;1020;224664;5336;1177;0;44
FR;5;2023-04-20;5;2;0;0;2;0;0;0;0;277912;185539;3591;1020;224666;5336;1177;0;44
FR;5;2023-04-21;2;6;1;0;5;2;0;0;0;277914;185545;3592;1020;224671;5338;1177;0;44
FR;5;2023-04-22;4;6;1;0;6;1;0;0;0;277918;185551;3593;1020;224677;5339;1177;0;44
FR;5;2023-04-23;1;0;0;0;0;0;0;0;0;277919;185551;3593;1020;224677;5339;1177;0;44
FR;5;2023-04-24;3;5;2;0;5;2;0;0;0;277922;185556;3595;1020;224682;5341;1177;0;44
FR;5;2023-04-25;0;1;1;2;1;1;2;0;0;277922;185557;3596;1022;224683;5342;1179;0;44
FR;5;2023-04-26;1;3;0;0;3;0;0;0;0;277923;185560;3596;1022;224686;5342;1179;0;44
FR;5;2023-04-27;3;4;0;0;3;1;0;0;0;277926;185564;3596;1022;224689;5343;1179;0;44
FR;5;2023-04-28;2;3;0;0;2;1;0;0;0;277928;185567;3596;1022;224691;5344;1179;0;44
FR;5;2023-04-29;2;9;0;0;9;0;0;0;0;277930;185576;3596;1022;224700;5344;1179;0;44
FR;5;2023-04-30;0;0;0;0;0;0;0;0;0;277930;185576;3596;1022;224700;5344;1179;0;44
FR;5;2023-05-01;0;0;0;0;0;0;0;0;0;277930;185576;3596;1022;224700;5344;1179;0;44
FR;5;2023-05-02;2;2;1;0;3;1;0;0;0;277932;185578;3597;1022;224703;5345;1179;0;44
FR;5;2023-05-03;5;3;0;0;3;0;0;0;0;277937;185581;3597;1022;224706;5345;1179;0;44
FR;5;2023-05-04;1;3;0;0;3;0;0;0;0;277938;185584;3597;1022;224709;5345;1179;0;44
FR;5;2023-05-05;1;1;0;0;1;0;0;0;0;277939;185585;3597;1022;224710;5345;1179;0;44
FR;5;2023-05-06;2;1;0;0;1;0;0;0;0;277941;185586;3597;1022;224711;5345;1179;0;44
FR;5;2023-05-07;0;1;0;0;1;0;0;0;0;277941;185587;3597;1022;224712;5345;1179;0;44
FR;5;2023-05-08;1;1;0;0;1;0;0;0;0;277942;185588;3597;1022;224713;5345;1179;0;44
FR;5;2023-05-09;0;3;0;0;3;0;0;0;0;277942;185591;3597;1022;224716;5345;1179;0;44
FR;5;2023-05-10;2;8;0;0;8;0;0;0;0;277944;185599;3597;1022;224724;5345;1179;0;44
FR;5;2023-05-11;2;1;0;0;1;0;0;0;0;277946;185600;3597;1022;224725;5345;1179;0;44
FR;5;2023-05-12;2;2;0;0;2;0;0;0;0;277948;185602;3597;1022;224727;5345;1179;0;44
FR;5;2023-05-13;6;4;0;0;4;2;0;0;0;277954;185606;3597;1022;224731;5347;1179;0;44
FR;5;2023-05-14;0;0;0;0;0;0;0;0;0;277954;185606;3597;1022;224731;5347;1179;0;44
FR;5;2023-05-15;3;0;0;0;0;0;0;0;1;277957;185606;3597;1022;224731;5347;1179;0;45
FR;5;2023-05-16;0;1;0;0;1;0;0;0;0;277957;185607;3597;1022;224732;5347;1179;0;45
FR;5;2023-05-17;3;6;2;0;7;2;0;0;0;277960;185613;3599;1022;224739;5349;1179;0;45
FR;5;2023-05-18;0;1;0;0;1;0;0;0;0;277960;185614;3599;1022;224740;5349;1179;0;45
FR;5;2023-05-19;1;4;1;0;3;1;0;0;0;277961;185618;3600;1022;224743;5350;1179;0;45
FR;5;2023-05-20;5;0;0;0;0;0;0;0;0;277966;185618;3600;1022;224743;5350;1179;0;45
FR;5;2023-05-21;0;0;0;0;0;0;0;0;0;277966;185618;3600;1022;224743;5350;1179;0;45
FR;5;2023-05-22;0;3;0;0;3;0;0;0;0;277966;185621;3600;1022;224746;5350;1179;0;45
FR;5;2023-05-23;1;1;1;0;1;1;0;0;0;277967;185622;3601;1022;224747;5351;1179;0;45
FR;5;2023-05-24;6;5;0;0;5;0;0;0;0;277973;185627;3601;1022;224752;5351;1179;0;45
FR;5;2023-05-25;1;1;0;0;1;0;0;0;0;277974;185628;3601;1022;224753;5351;1179;0;45
FR;5;2023-05-26;2;5;0;0;5;0;0;0;0;277976;185633;3601;1022;224758;5351;1179;0;45
FR;5;2023-05-27;4;3;1;0;5;1;0;0;0;277980;185636;3602;1022;224763;5352;1179;0;45
FR;5;2023-05-28;0;1;0;0;1;0;0;0;0;277980;185637;3602;1022;224764;5352;1179;0;45
FR;5;2023-05-29;0;1;0;0;0;1;0;0;0;277980;185638;3602;1022;224764;5353;1179;0;45
FR;5;2023-05-30;0;1;0;0;1;0;0;0;0;277980;185639;3602;1022;224765;5353;1179;0;45
FR;5;2023-05-31;5;5;1;0;5;1;0;0;0;277985;185644;3603;1022;224770;5354;1179;0;45
FR;5;2023-06-01;1;0;0;0;0;0;0;0;0;277986;185644;3603;1022;224770;5354;1179;0;45
FR;5;2023-06-02;0;1;0;0;1;0;0;0;0;277986;185645;3603;1022;224771;5354;1179;0;45
FR;5;2023-06-03;3;4;4;0;4;4;1;0;0;277989;185649;3607;1022;224775;5358;1180;0;45
FR;5;2023-06-04;0;0;0;0;0;0;0;0;0;277989;185649;3607;1022;224775;5358;1180;0;45
FR;5;2023-06-05;3;1;0;0;1;0;0;0;0;277992;185650;3607;1022;224776;5358;1180;0;45
FR;5;2023-06-06;3;1;0;0;1;0;0;0;0;277995;185651;3607;1022;224777;5358;1180;0;45
FR;5;2023-06-07;6;1;4;0;0;5;0;0;0;278001;185652;3611;1022;224777;5363;1180;0;45
FR;5;2023-06-08;1;1;1;0;1;1;0;0;0;278002;185653;3612;1022;224778;5364;1180;0;45
FR;5;2023-06-09;1;1;1;0;1;1;0;0;0;278003;185654;3613;1022;224779;5365;1180;0;45
FR;5;2023-06-10;2;2;0;0;3;0;0;0;0;278005;185656;3613;1022;224782;5365;1180;0;45
FR;5;2023-06-11;0;0;1;0;0;1;0;0;0;278005;185656;3614;1022;224782;5366;1180;0;45
FR;5;2023-06-12;0;2;0;0;2;0;0;0;0;278005;185658;3614;1022;224784;5366;1180;0;45
FR;5;2023-06-13;0;0;0;0;0;0;0;0;0;278005;185658;3614;1022;224784;5366;1180;0;45
FR;5;2023-06-14;0;6;0;0;6;0;0;0;0;278005;185664;3614;1022;224790;5366;1180;0;45
FR;5;2023-06-15;1;1;0;1;2;0;0;0;0;278006;185665;3614;1023;224792;5366;1180;0;45
FR;5;2023-06-16;0;2;0;0;2;0;0;0;0;278006;185667;3614;1023;224794;5366;1180;0;45
FR;5;2023-06-17;3;3;0;0;3;1;0;0;0;278009;185670;3614;1023;224797;5367;1180;0;45
FR;5;2023-06-18;1;0;0;0;0;0;0;0;0;278010;185670;3614;1023;224797;5367;1180;0;45
FR;5;2023-06-19;3;0;0;0;0;0;0;0;0;278013;185670;3614;1023;224797;5367;1180;0;45
FR;6;2020-12-27;0;0;0;0;0;0;0;0;0;0;0;0;0;0;0;0;0;0
FR;6;2020-12-28;0;0;0;0;0;0;0;0;0;0;0;0;0;0;0;0;0;0
FR;6;2020-12-29;0;0;0;0;0;0;0;0;0;0;0;0;0;0;0;0;0;0
FR;6;2020-12-30;0;0;0;0;0;0;0;0;0;0;0;0;0;0;0;0;0;0
FR;6;2020-12-31;0;0;0;0;0;0;0;0;0;0;0;0;0;0;0;0;0;0
FR;6;2021-01-01;0;0;0;0;0;0;0;0;0;0;0;0;0;0;0;0;0;0
FR;6;2021-01-02;0;0;0;0;0;0;0;0;0;0;0;0;0;0;0;0;0;0
FR;6;2021-01-03;0;0;0;0;0;0;0;0;0;0;0;0;0;0;0;0;0;0
FR;6;2021-01-04;0;0;0;0;0;0;0;0;0;0;0;0;0;0;0;0;0;0
FR;6;2021-01-05;0;0;0;0;0;0;0;0;0;0;0;0;0;0;0;0;0;0
FR;6;2021-01-06;0;0;0;0;0;0;0;0;0;0;0;0;0;0;0;0;0;0
FR;6;2021-01-07;0;0;0;0;0;0;0;0;0;0;0;0;0;0;0;0;0;0
FR;6;2021-01-08;0;0;0;0;0;0;0;0;0;0;0;0;0;0;0;0;0;0
FR;6;2021-01-09;0;0;0;0;0;0;0;0;0;0;0;0;0;0;0;0;0;0
FR;6;2021-01-10;0;0;0;0;0;0;0;0;0;0;0;0;0;0;0;0;0;0
FR;6;2021-01-11;0;0;0;0;0;0;0;0;0;0;0;0;0;0;0;0;0;0
FR;6;2021-01-12;0;0;0;0;0;0;0;0;0;0;0;0;0;0;0;0;0;0
FR;6;2021-01-13;0;0;0;0;0;0;0;0;0;0;0;0;0;0;0;0;0;0
FR;6;2021-01-14;0;0;0;0;0;0;0;0;0;0;0;0;0;0;0;0;0;0
FR;6;2021-01-15;0;0;0;0;0;0;0;0;0;0;0;0;0;0;0;0;0;0
FR;6;2021-01-16;0;0;0;0;0;0;0;0;0;0;0;0;0;0;0;0;0;0
FR;6;2021-01-17;0;0;0;0;0;0;0;0;0;0;0;0;0;0;0;0;0;0
FR;6;2021-01-18;0;0;0;0;0;0;0;0;0;0;0;0;0;0;0;0;0;0
FR;6;2021-01-19;0;0;0;0;0;0;0;0;0;0;0;0;0;0;0;0;0;0
FR;6;2021-01-20;0;0;0;0;0;0;0;0;0;0;0;0;0;0;0;0;0;0
FR;6;2021-01-21;0;0;0;0;0;0;0;0;0;0;0;0;0;0;0;0;0;0
FR;6;2021-01-22;0;0;0;0;0;0;0;0;0;0;0;0;0;0;0;0;0;0
FR;6;2021-01-23;0;0;0;0;0;0;0;0;0;0;0;0;0;0;0;0;0;0
FR;6;2021-01-24;0;0;0;0;0;0;0;0;0;0;0;0;0;0;0;0;0;0
FR;6;2021-01-25;0;0;0;0;0;0;0;0;0;0;0;0;0;0;0;0;0;0
FR;6;2021-01-26;0;0;0;0;0;0;0;0;0;0;0;0;0;0;0;0;0;0
FR;6;2021-01-27;0;0;0;0;0;0;0;0;0;0;0;0;0;0;0;0;0;0
FR;6;2021-01-28;0;0;0;0;0;0;0;0;0;0;0;0;0;0;0;0;0;0
FR;6;2021-01-29;0;0;0;0;0;0;0;0;0;0;0;0;0;0;0;0;0;0
FR;6;2021-01-30;0;0;0;0;0;0;0;0;0;0;0;0;0;0;0;0;0;0
FR;6;2021-01-31;0;0;0;0;0;0;0;0;0;0;0;0;0;0;0;0;0;0
FR;6;2021-02-01;0;0;0;0;0;0;0;0;0;0;0;0;0;0;0;0;0;0
FR;6;2021-02-02;0;0;0;0;0;0;0;0;0;0;0;0;0;0;0;0;0;0
FR;6;2021-02-03;0;0;0;0;0;0;0;0;0;0;0;0;0;0;0;0;0;0
FR;6;2021-02-04;0;0;0;0;0;0;0;0;0;0;0;0;0;0;0;0;0;0
FR;6;2021-02-05;0;0;0;0;0;0;0;0;0;0;0;0;0;0;0;0;0;0
FR;6;2021-02-06;0;0;0;0;0;0;0;0;0;0;0;0;0;0;0;0;0;0
FR;6;2021-02-07;0;0;0;0;0;0;0;0;0;0;0;0;0;0;0;0;0;0
FR;6;2021-02-08;0;0;0;0;0;0;0;0;0;0;0;0;0;0;0;0;0;0
FR;6;2021-02-09;0;0;0;0;0;0;0;0;0;0;0;0;0;0;0;0;0;0
FR;6;2021-02-10;0;0;0;0;0;0;0;0;0;0;0;0;0;0;0;0;0;0
FR;6;2021-02-11;0;0;0;0;0;0;0;0;0;0;0;0;0;0;0;0;0;0
FR;6;2021-02-12;0;0;0;0;0;0;0;0;0;0;0;0;0;0;0;0;0;0
FR;6;2021-02-13;0;0;0;0;0;0;0;0;0;0;0;0;0;0;0;0;0;0
FR;6;2021-02-14;0;0;0;0;0;0;0;0;0;0;0;0;0;0;0;0;0;0
FR;6;2021-02-15;0;0;0;0;0;0;0;0;0;0;0;0;0;0;0;0;0;0
FR;6;2021-02-16;0;0;0;0;0;0;0;0;0;0;0;0;0;0;0;0;0;0
FR;6;2021-02-17;0;0;0;0;0;0;0;0;0;0;0;0;0;0;0;0;0;0
FR;6;2021-02-18;0;0;0;0;0;0;0;0;0;0;0;0;0;0;0;0;0;0
FR;6;2021-02-19;0;0;0;0;0;0;0;0;0;0;0;0;0;0;0;0;0;0
FR;6;2021-02-20;0;0;0;0;0;0;0;0;0;0;0;0;0;0;0;0;0;0
FR;6;2021-02-21;0;0;0;0;0;0;0;0;0;0;0;0;0;0;0;0;0;0
FR;6;2021-02-22;0;0;0;0;0;0;0;0;0;0;0;0;0;0;0;0;0;0
FR;6;2021-02-23;0;0;0;0;0;0;0;0;0;0;0;0;0;0;0;0;0;0
FR;6;2021-02-24;0;0;0;0;0;0;0;0;0;0;0;0;0;0;0;0;0;0
FR;6;2021-02-25;0;0;0;0;0;0;0;0;0;0;0;0;0;0;0;0;0;0
FR;6;2021-02-26;0;0;0;0;0;0;0;0;0;0;0;0;0;0;0;0;0;0
FR;6;2021-02-27;0;0;0;0;0;0;0;0;0;0;0;0;0;0;0;0;0;0
FR;6;2021-02-28;0;0;0;0;0;0;0;0;0;0;0;0;0;0;0;0;0;0
FR;6;2021-03-01;0;0;0;0;0;0;0;0;0;0;0;0;0;0;0;0;0;0
FR;6;2021-03-02;0;0;0;0;0;0;0;0;0;0;0;0;0;0;0;0;0;0
FR;6;2021-03-03;0;0;0;0;0;0;0;0;0;0;0;0;0;0;0;0;0;0
FR;6;2021-03-04;0;0;0;0;0;0;0;0;0;0;0;0;0;0;0;0;0;0
FR;6;2021-03-05;0;0;0;0;0;0;0;0;0;0;0;0;0;0;0;0;0;0
FR;6;2021-03-06;0;0;0;0;0;0;0;0;0;0;0;0;0;0;0;0;0;0
FR;6;2021-03-07;0;0;0;0;0;0;0;0;0;0;0;0;0;0;0;0;0;0
FR;6;2021-03-08;0;0;0;0;0;0;0;0;0;0;0;0;0;0;0;0;0;0
FR;6;2021-03-09;0;0;0;0;0;0;0;0;0;0;0;0;0;0;0;0;0;0
FR;6;2021-03-10;0;0;0;0;0;0;0;0;0;0;0;0;0;0;0;0;0;0
FR;6;2021-03-11;0;0;0;0;0;0;0;0;0;0;0;0;0;0;0;0;0;0
FR;6;2021-03-12;0;0;0;0;0;0;0;0;0;0;0;0;0;0;0;0;0;0
FR;6;2021-03-13;0;0;0;0;0;0;0;0;0;0;0;0;0;0;0;0;0;0
FR;6;2021-03-14;0;0;0;0;0;0;0;0;0;0;0;0;0;0;0;0;0;0
FR;6;2021-03-15;0;0;0;0;0;0;0;0;0;0;0;0;0;0;0;0;0;0
FR;6;2021-03-16;0;0;0;0;0;0;0;0;0;0;0;0;0;0;0;0;0;0
FR;6;2021-03-17;0;0;0;0;0;0;0;0;0;0;0;0;0;0;0;0;0;0
FR;6;2021-03-18;0;0;0;0;0;0;0;0;0;0;0;0;0;0;0;0;0;0
FR;6;2021-03-19;0;0;0;0;0;0;0;0;0;0;0;0;0;0;0;0;0;0
FR;6;2021-03-20;0;0;0;0;0;0;0;0;0;0;0;0;0;0;0;0;0;0
FR;6;2021-03-21;0;0;0;0;0;0;0;0;0;0;0;0;0;0;0;0;0;0
FR;6;2021-03-22;0;0;0;0;0;0;0;0;0;0;0;0;0;0;0;0;0;0
FR;6;2021-03-23;0;0;0;0;0;0;0;0;0;0;0;0;0;0;0;0;0;0
FR;6;2021-03-24;0;0;0;0;0;0;0;0;0;0;0;0;0;0;0;0;0;0
FR;6;2021-03-25;0;0;0;0;0;0;0;0;0;0;0;0;0;0;0;0;0;0
FR;6;2021-03-26;0;0;0;0;0;0;0;0;0;0;0;0;0;0;0;0;0;0
FR;6;2021-03-27;0;0;0;0;0;0;0;0;0;0;0;0;0;0;0;0;0;0
FR;6;2021-03-28;0;0;0;0;0;0;0;0;0;0;0;0;0;0;0;0;0;0
FR;6;2021-03-29;0;0;0;0;0;0;0;0;0;0;0;0;0;0;0;0;0;0
FR;6;2021-03-30;0;0;0;0;0;0;0;0;0;0;0;0;0;0;0;0;0;0
FR;6;2021-03-31;0;0;0;0;0;0;0;0;0;0;0;0;0;0;0;0;0;0
FR;6;2021-04-01;0;0;0;0;0;0;0;0;0;0;0;0;0;0;0;0;0;0
FR;6;2021-04-02;0;0;0;0;0;0;0;0;0;0;0;0;0;0;0;0;0;0
FR;6;2021-04-03;0;0;0;0;0;0;0;0;0;0;0;0;0;0;0;0;0;0
FR;6;2021-04-04;0;0;0;0;0;0;0;0;0;0;0;0;0;0;0;0;0;0
FR;6;2021-04-05;0;0;0;0;0;0;0;0;0;0;0;0;0;0;0;0;0;0
FR;6;2021-04-06;0;0;0;0;0;0;0;0;0;0;0;0;0;0;0;0;0;0
FR;6;2021-04-07;0;0;0;0;0;0;0;0;0;0;0;0;0;0;0;0;0;0
FR;6;2021-04-08;0;0;0;0;0;0;0;0;0;0;0;0;0;0;0;0;0;0
FR;6;2021-04-09;0;0;0;0;0;0;0;0;0;0;0;0;0;0;0;0;0;0
FR;6;2021-04-10;0;0;0;0;0;0;0;0;0;0;0;0;0;0;0;0;0;0
FR;6;2021-04-11;0;0;0;0;0;0;0;0;0;0;0;0;0;0;0;0;0;0
FR;6;2021-04-12;0;0;0;0;0;0;0;0;0;0;0;0;0;0;0;0;0;0
FR;6;2021-04-13;0;0;0;0;0;0;0;0;0;0;0;0;0;0;0;0;0;0
FR;6;2021-04-14;0;0;0;0;0;0;0;0;0;0;0;0;0;0;0;0;0;0
FR;6;2021-04-15;0;0;0;0;0;0;0;0;0;0;0;0;0;0;0;0;0;0
FR;6;2021-04-16;0;0;0;0;0;0;0;0;0;0;0;0;0;0;0;0;0;0
FR;6;2021-04-17;0;0;0;0;0;0;0;0;0;0;0;0;0;0;0;0;0;0
FR;6;2021-04-18;0;0;0;0;0;0;0;0;0;0;0;0;0;0;0;0;0;0
FR;6;2021-04-19;0;0;0;0;0;0;0;0;0;0;0;0;0;0;0;0;0;0
FR;6;2021-04-20;0;0;0;0;0;0;0;0;0;0;0;0;0;0;0;0;0;0
FR;6;2021-04-21;0;0;0;0;0;0;0;0;0;0;0;0;0;0;0;0;0;0
FR;6;2021-04-22;0;0;0;0;0;0;0;0;0;0;0;0;0;0;0;0;0;0
FR;6;2021-04-23;0;0;0;0;0;0;0;0;0;0;0;0;0;0;0;0;0;0
FR;6;2021-04-24;0;0;0;0;0;0;0;0;0;0;0;0;0;0;0;0;0;0
FR;6;2021-04-25;0;0;0;0;0;0;0;0;0;0;0;0;0;0;0;0;0;0
FR;6;2021-04-26;0;0;0;0;0;0;0;0;0;0;0;0;0;0;0;0;0;0
FR;6;2021-04-27;0;0;0;0;0;0;0;0;0;0;0;0;0;0;0;0;0;0
FR;6;2021-04-28;0;0;0;0;0;0;0;0;0;0;0;0;0;0;0;0;0;0
FR;6;2021-04-29;0;0;0;0;0;0;0;0;0;0;0;0;0;0;0;0;0;0
FR;6;2021-04-30;0;0;0;0;0;0;0;0;0;0;0;0;0;0;0;0;0;0
FR;6;2021-05-01;0;0;0;0;0;0;0;0;0;0;0;0;0;0;0;0;0;0
FR;6;2021-05-02;0;0;0;0;0;0;0;0;0;0;0;0;0;0;0;0;0;0
FR;6;2021-05-03;0;0;0;0;0;0;0;0;0;0;0;0;0;0;0;0;0;0
FR;6;2021-05-04;0;0;0;0;0;0;0;0;0;0;0;0;0;0;0;0;0;0
FR;6;2021-05-05;0;0;0;0;0;0;0;0;0;0;0;0;0;0;0;0;0;0
FR;6;2021-05-06;0;0;0;0;0;0;0;0;0;0;0;0;0;0;0;0;0;0
FR;6;2021-05-07;0;0;0;0;0;0;0;0;0;0;0;0;0;0;0;0;0;0
FR;6;2021-05-08;0;0;0;0;0;0;0;0;0;0;0;0;0;0;0;0;0;0
FR;6;2021-05-09;0;0;0;0;0;0;0;0;0;0;0;0;0;0;0;0;0;0
FR;6;2021-05-10;0;0;0;0;0;0;0;0;0;0;0;0;0;0;0;0;0;0
FR;6;2021-05-11;0;0;0;0;0;0;0;0;0;0;0;0;0;0;0;0;0;0
FR;6;2021-05-12;0;0;0;0;0;0;0;0;0;0;0;0;0;0;0;0;0;0
FR;6;2021-05-13;0;0;0;0;0;0;0;0;0;0;0;0;0;0;0;0;0;0
FR;6;2021-05-14;0;0;0;0;0;0;0;0;0;0;0;0;0;0;0;0;0;0
FR;6;2021-05-15;0;0;0;0;0;0;0;0;0;0;0;0;0;0;0;0;0;0
FR;6;2021-05-16;0;0;0;0;0;0;0;0;0;0;0;0;0;0;0;0;0;0
FR;6;2021-05-17;0;0;0;0;0;0;0;0;0;0;0;0;0;0;0;0;0;0
FR;6;2021-05-18;0;0;0;0;0;0;0;0;0;0;0;0;0;0;0;0;0;0
FR;6;2021-05-19;0;0;0;0;0;0;0;0;0;0;0;0;0;0;0;0;0;0
FR;6;2021-05-20;0;0;0;0;0;0;0;0;0;0;0;0;0;0;0;0;0;0
FR;6;2021-05-21;0;0;0;0;0;0;0;0;0;0;0;0;0;0;0;0;0;0
FR;6;2021-05-22;0;0;0;0;0;0;0;0;0;0;0;0;0;0;0;0;0;0
FR;6;2021-05-23;0;0;0;0;0;0;0;0;0;0;0;0;0;0;0;0;0;0
FR;6;2021-05-24;0;0;0;0;0;0;0;0;0;0;0;0;0;0;0;0;0;0
FR;6;2021-05-25;0;0;0;0;0;0;0;0;0;0;0;0;0;0;0;0;0;0
FR;6;2021-05-26;0;0;0;0;0;0;0;0;0;0;0;0;0;0;0;0;0;0
FR;6;2021-05-27;0;0;0;0;0;0;0;0;0;0;0;0;0;0;0;0;0;0
FR;6;2021-05-28;0;0;0;0;0;0;0;0;0;0;0;0;0;0;0;0;0;0
FR;6;2021-05-29;0;0;0;0;0;0;0;0;0;0;0;0;0;0;0;0;0;0
FR;6;2021-05-30;0;0;0;0;0;0;0;0;0;0;0;0;0;0;0;0;0;0
FR;6;2021-05-31;0;0;0;0;0;0;0;0;0;0;0;0;0;0;0;0;0;0
FR;6;2021-06-01;0;0;0;0;0;0;0;0;0;0;0;0;0;0;0;0;0;0
FR;6;2021-06-02;0;0;0;0;0;0;0;0;0;0;0;0;0;0;0;0;0;0
FR;6;2021-06-03;0;0;0;0;0;0;0;0;0;0;0;0;0;0;0;0;0;0
FR;6;2021-06-04;0;0;0;0;0;0;0;0;0;0;0;0;0;0;0;0;0;0
FR;6;2021-06-05;0;0;0;0;0;0;0;0;0;0;0;0;0;0;0;0;0;0
FR;6;2021-06-06;0;0;0;0;0;0;0;0;0;0;0;0;0;0;0;0;0;0
FR;6;2021-06-07;0;0;0;0;0;0;0;0;0;0;0;0;0;0;0;0;0;0
FR;6;2021-06-08;0;0;0;0;0;0;0;0;0;0;0;0;0;0;0;0;0;0
FR;6;2021-06-09;0;0;0;0;0;0;0;0;0;0;0;0;0;0;0;0;0;0
FR;6;2021-06-10;0;0;0;0;0;0;0;0;0;0;0;0;0;0;0;0;0;0
FR;6;2021-06-11;0;0;0;0;0;0;0;0;0;0;0;0;0;0;0;0;0;0
FR;6;2021-06-12;0;0;0;0;0;0;0;0;0;0;0;0;0;0;0;0;0;0
FR;6;2021-06-13;0;0;0;0;0;0;0;0;0;0;0;0;0;0;0;0;0;0
FR;6;2021-06-14;0;0;0;0;0;0;0;0;0;0;0;0;0;0;0;0;0;0
FR;6;2021-06-15;0;0;0;0;0;0;0;0;0;0;0;0;0;0;0;0;0;0
FR;6;2021-06-16;0;0;0;0;0;0;0;0;0;0;0;0;0;0;0;0;0;0
FR;6;2021-06-17;0;0;0;0;0;0;0;0;0;0;0;0;0;0;0;0;0;0
FR;6;2021-06-18;0;0;0;0;0;0;0;0;0;0;0;0;0;0;0;0;0;0
FR;6;2021-06-19;0;0;0;0;0;0;0;0;0;0;0;0;0;0;0;0;0;0
FR;6;2021-06-20;0;0;0;0;0;0;0;0;0;0;0;0;0;0;0;0;0;0
FR;6;2021-06-21;0;0;0;0;0;0;0;0;0;0;0;0;0;0;0;0;0;0
FR;6;2021-06-22;0;0;0;0;0;0;0;0;0;0;0;0;0;0;0;0;0;0
FR;6;2021-06-23;0;0;0;0;0;0;0;0;0;0;0;0;0;0;0;0;0;0
FR;6;2021-06-24;0;0;0;0;0;0;0;0;0;0;0;0;0;0;0;0;0;0
FR;6;2021-06-25;0;0;0;0;0;0;0;0;0;0;0;0;0;0;0;0;0;0
FR;6;2021-06-26;0;0;0;0;0;0;0;0;0;0;0;0;0;0;0;0;0;0
FR;6;2021-06-27;0;0;0;0;0;0;0;0;0;0;0;0;0;0;0;0;0;0
FR;6;2021-06-28;0;0;0;0;0;0;0;0;0;0;0;0;0;0;0;0;0;0
FR;6;2021-06-29;0;0;0;0;0;0;0;0;0;0;0;0;0;0;0;0;0;0
FR;6;2021-06-30;0;0;0;0;0;0;0;0;0;0;0;0;0;0;0;0;0;0
FR;6;2021-07-01;0;0;0;0;0;0;0;0;0;0;0;0;0;0;0;0;0;0
FR;6;2021-07-02;0;0;0;0;0;0;0;0;0;0;0;0;0;0;0;0;0;0
FR;6;2021-07-03;0;0;0;0;0;0;0;0;0;0;0;0;0;0;0;0;0;0
FR;6;2021-07-04;0;0;0;0;0;0;0;0;0;0;0;0;0;0;0;0;0;0
FR;6;2021-07-05;0;0;0;0;0;0;0;0;0;0;0;0;0;0;0;0;0;0
FR;6;2021-07-06;0;0;0;0;0;0;0;0;0;0;0;0;0;0;0;0;0;0
FR;6;2021-07-07;0;0;0;0;0;0;0;0;0;0;0;0;0;0;0;0;0;0
FR;6;2021-07-08;0;0;0;0;0;0;0;0;0;0;0;0;0;0;0;0;0;0
FR;6;2021-07-09;0;0;0;0;0;0;0;0;0;0;0;0;0;0;0;0;0;0
FR;6;2021-07-10;0;0;0;0;0;0;0;0;0;0;0;0;0;0;0;0;0;0
FR;6;2021-07-11;0;0;0;0;0;0;0;0;0;0;0;0;0;0;0;0;0;0
FR;6;2021-07-12;0;0;0;0;0;0;0;0;0;0;0;0;0;0;0;0;0;0
FR;6;2021-07-13;0;0;0;0;0;0;0;0;0;0;0;0;0;0;0;0;0;0
FR;6;2021-07-14;0;0;0;0;0;0;0;0;0;0;0;0;0;0;0;0;0;0
FR;6;2021-07-15;0;0;0;0;0;0;0;0;0;0;0;0;0;0;0;0;0;0
FR;6;2021-07-16;0;0;0;0;0;0;0;0;0;0;0;0;0;0;0;0;0;0
FR;6;2021-07-17;0;0;0;0;0;0;0;0;0;0;0;0;0;0;0;0;0;0
FR;6;2021-07-18;0;0;0;0;0;0;0;0;0;0;0;0;0;0;0;0;0;0
FR;6;2021-07-19;0;0;0;0;0;0;0;0;0;0;0;0;0;0;0;0;0;0
FR;6;2021-07-20;0;0;0;0;0;0;0;0;0;0;0;0;0;0;0;0;0;0
FR;6;2021-07-21;0;0;0;0;0;0;0;0;0;0;0;0;0;0;0;0;0;0
FR;6;2021-07-22;0;0;0;0;0;0;0;0;0;0;0;0;0;0;0;0;0;0
FR;6;2021-07-23;0;0;0;0;0;0;0;0;0;0;0;0;0;0;0;0;0;0
FR;6;2021-07-24;0;0;0;0;0;0;0;0;0;0;0;0;0;0;0;0;0;0
FR;6;2021-07-25;0;0;0;0;0;0;0;0;0;0;0;0;0;0;0;0;0;0
FR;6;2021-07-26;0;0;0;0;0;0;0;0;0;0;0;0;0;0;0;0;0;0
FR;6;2021-07-27;0;0;0;0;0;0;0;0;0;0;0;0;0;0;0;0;0;0
FR;6;2021-07-28;0;0;0;0;0;0;0;0;0;0;0;0;0;0;0;0;0;0
FR;6;2021-07-29;0;0;0;0;0;0;0;0;0;0;0;0;0;0;0;0;0;0
FR;6;2021-07-30;0;0;0;0;0;0;0;0;0;0;0;0;0;0;0;0;0;0
FR;6;2021-07-31;0;0;0;0;0;0;0;0;0;0;0;0;0;0;0;0;0;0
FR;6;2021-08-01;0;0;0;0;0;0;0;0;0;0;0;0;0;0;0;0;0;0
FR;6;2021-08-02;0;0;0;0;0;0;0;0;0;0;0;0;0;0;0;0;0;0
FR;6;2021-08-03;0;0;0;0;0;0;0;0;0;0;0;0;0;0;0;0;0;0
FR;6;2021-08-04;0;0;0;0;0;0;0;0;0;0;0;0;0;0;0;0;0;0
FR;6;2021-08-05;0;0;0;0;0;0;0;0;0;0;0;0;0;0;0;0;0;0
FR;6;2021-08-06;0;0;0;0;0;0;0;0;0;0;0;0;0;0;0;0;0;0
FR;6;2021-08-07;0;0;0;0;0;0;0;0;0;0;0;0;0;0;0;0;0;0
FR;6;2021-08-08;0;0;0;0;0;0;0;0;0;0;0;0;0;0;0;0;0;0
FR;6;2021-08-09;0;0;0;0;0;0;0;0;0;0;0;0;0;0;0;0;0;0
FR;6;2021-08-10;0;0;0;0;0;0;0;0;0;0;0;0;0;0;0;0;0;0
FR;6;2021-08-11;0;0;0;0;0;0;0;0;0;0;0;0;0;0;0;0;0;0
FR;6;2021-08-12;0;0;0;0;0;0;0;0;0;0;0;0;0;0;0;0;0;0
FR;6;2021-08-13;0;0;0;0;0;0;0;0;0;0;0;0;0;0;0;0;0;0
FR;6;2021-08-14;0;0;0;0;0;0;0;0;0;0;0;0;0;0;0;0;0;0
FR;6;2021-08-15;0;0;0;0;0;0;0;0;0;0;0;0;0;0;0;0;0;0
FR;6;2021-08-16;0;0;0;0;0;0;0;0;0;0;0;0;0;0;0;0;0;0
FR;6;2021-08-17;0;0;0;0;0;0;0;0;0;0;0;0;0;0;0;0;0;0
FR;6;2021-08-18;0;0;0;0;0;0;0;0;0;0;0;0;0;0;0;0;0;0
FR;6;2021-08-19;0;0;0;0;0;0;0;0;0;0;0;0;0;0;0;0;0;0
FR;6;2021-08-20;0;0;0;0;0;0;0;0;0;0;0;0;0;0;0;0;0;0
FR;6;2021-08-21;0;0;0;0;0;0;0;0;0;0;0;0;0;0;0;0;0;0
FR;6;2021-08-22;0;0;0;0;0;0;0;0;0;0;0;0;0;0;0;0;0;0
FR;6;2021-08-23;0;0;0;0;0;0;0;0;0;0;0;0;0;0;0;0;0;0
FR;6;2021-08-24;0;0;0;0;0;0;0;0;0;0;0;0;0;0;0;0;0;0
FR;6;2021-08-25;0;0;0;0;0;0;0;0;0;0;0;0;0;0;0;0;0;0
FR;6;2021-08-26;0;0;0;0;0;0;0;0;0;0;0;0;0;0;0;0;0;0
FR;6;2021-08-27;0;0;0;0;0;0;0;0;0;0;0;0;0;0;0;0;0;0
FR;6;2021-08-28;0;0;0;0;0;0;0;0;0;0;0;0;0;0;0;0;0;0
FR;6;2021-08-29;0;0;0;0;0;0;0;0;0;0;0;0;0;0;0;0;0;0
FR;6;2021-08-30;0;0;0;0;0;0;0;0;0;0;0;0;0;0;0;0;0;0
FR;6;2021-08-31;0;0;0;0;0;0;0;0;0;0;0;0;0;0;0;0;0;0
FR;6;2021-09-01;0;0;0;0;0;0;0;0;0;0;0;0;0;0;0;0;0;0
FR;6;2021-09-02;0;0;0;0;0;0;0;0;0;0;0;0;0;0;0;0;0;0
FR;6;2021-09-03;0;0;0;0;0;0;0;0;0;0;0;0;0;0;0;0;0;0
FR;6;2021-09-04;0;0;0;0;0;0;0;0;0;0;0;0;0;0;0;0;0;0
FR;6;2021-09-05;0;0;0;0;0;0;0;0;0;0;0;0;0;0;0;0;0;0
FR;6;2021-09-06;0;0;0;0;0;0;0;0;0;0;0;0;0;0;0;0;0;0
FR;6;2021-09-07;0;0;0;0;0;0;0;0;0;0;0;0;0;0;0;0;0;0
FR;6;2021-09-08;0;0;0;0;0;0;0;0;0;0;0;0;0;0;0;0;0;0
FR;6;2021-09-09;0;0;0;0;0;0;0;0;0;0;0;0;0;0;0;0;0;0
FR;6;2021-09-10;0;0;0;0;0;0;0;0;0;0;0;0;0;0;0;0;0;0
FR;6;2021-09-11;0;0;0;0;0;0;0;0;0;0;0;0;0;0;0;0;0;0
FR;6;2021-09-12;0;0;0;0;0;0;0;0;0;0;0;0;0;0;0;0;0;0
FR;6;2021-09-13;0;0;0;0;0;0;0;0;0;0;0;0;0;0;0;0;0;0
FR;6;2021-09-14;0;0;0;0;0;0;0;0;0;0;0;0;0;0;0;0;0;0
FR;6;2021-09-15;0;0;0;0;0;0;0;0;0;0;0;0;0;0;0;0;0;0
FR;6;2021-09-16;0;0;0;0;0;0;0;0;0;0;0;0;0;0;0;0;0;0
FR;6;2021-09-17;0;0;0;0;0;0;0;0;0;0;0;0;0;0;0;0;0;0
FR;6;2021-09-18;0;0;0;0;0;0;0;0;0;0;0;0;0;0;0;0;0;0
FR;6;2021-09-19;0;0;0;0;0;0;0;0;0;0;0;0;0;0;0;0;0;0
FR;6;2021-09-20;0;0;0;0;0;0;0;0;0;0;0;0;0;0;0;0;0;0
FR;6;2021-09-21;0;0;0;0;0;0;0;0;0;0;0;0;0;0;0;0;0;0
FR;6;2021-09-22;0;0;0;0;0;0;0;0;0;0;0;0;0;0;0;0;0;0
FR;6;2021-09-23;0;0;0;0;0;0;0;0;0;0;0;0;0;0;0;0;0;0
FR;6;2021-09-24;0;0;0;0;0;0;0;0;0;0;0;0;0;0;0;0;0;0
FR;6;2021-09-25;0;0;0;0;0;0;0;0;0;0;0;0;0;0;0;0;0;0
FR;6;2021-09-26;0;0;0;0;0;0;0;0;0;0;0;0;0;0;0;0;0;0
FR;6;2021-09-27;0;0;0;0;0;0;0;0;0;0;0;0;0;0;0;0;0;0
FR;6;2021-09-28;0;0;0;0;0;0;0;0;0;0;0;0;0;0;0;0;0;0
FR;6;2021-09-29;0;0;0;0;0;0;0;0;0;0;0;0;0;0;0;0;0;0
FR;6;2021-09-30;0;0;0;0;0;0;0;0;0;0;0;0;0;0;0;0;0;0
FR;6;2021-10-01;0;0;0;0;0;0;0;0;0;0;0;0;0;0;0;0;0;0
FR;6;2021-10-02;0;0;0;0;0;0;0;0;0;0;0;0;0;0;0;0;0;0
FR;6;2021-10-03;0;0;0;0;0;0;0;0;0;0;0;0;0;0;0;0;0;0
FR;6;2021-10-04;0;0;0;0;0;0;0;0;0;0;0;0;0;0;0;0;0;0
FR;6;2021-10-05;0;0;0;0;0;0;0;0;0;0;0;0;0;0;0;0;0;0
FR;6;2021-10-06;0;0;0;0;0;0;0;0;0;0;0;0;0;0;0;0;0;0
FR;6;2021-10-07;0;0;0;0;0;0;0;0;0;0;0;0;0;0;0;0;0;0
FR;6;2021-10-08;0;0;0;0;0;0;0;0;0;0;0;0;0;0;0;0;0;0
FR;6;2021-10-09;0;0;0;0;0;0;0;0;0;0;0;0;0;0;0;0;0;0
FR;6;2021-10-10;0;0;0;0;0;0;0;0;0;0;0;0;0;0;0;0;0;0
FR;6;2021-10-11;0;0;0;0;0;0;0;0;0;0;0;0;0;0;0;0;0;0
FR;6;2021-10-12;0;0;0;0;0;0;0;0;0;0;0;0;0;0;0;0;0;0
FR;6;2021-10-13;0;0;0;0;0;0;0;0;0;0;0;0;0;0;0;0;0;0
FR;6;2021-10-14;0;0;0;0;0;0;0;0;0;0;0;0;0;0;0;0;0;0
FR;6;2021-10-15;0;0;0;0;0;0;0;0;0;0;0;0;0;0;0;0;0;0
FR;6;2021-10-16;0;0;0;0;0;0;0;0;0;0;0;0;0;0;0;0;0;0
FR;6;2021-10-17;0;0;0;0;0;0;0;0;0;0;0;0;0;0;0;0;0;0
FR;6;2021-10-18;0;0;0;0;0;0;0;0;0;0;0;0;0;0;0;0;0;0
FR;6;2021-10-19;0;0;0;0;0;0;0;0;0;0;0;0;0;0;0;0;0;0
FR;6;2021-10-20;0;0;0;0;0;0;0;0;0;0;0;0;0;0;0;0;0;0
FR;6;2021-10-21;0;0;0;0;0;0;0;0;0;0;0;0;0;0;0;0;0;0
FR;6;2021-10-22;0;0;0;0;0;0;0;0;0;0;0;0;0;0;0;0;0;0
FR;6;2021-10-23;0;0;0;0;0;0;0;0;0;0;0;0;0;0;0;0;0;0
FR;6;2021-10-24;0;0;0;0;0;0;0;0;0;0;0;0;0;0;0;0;0;0
FR;6;2021-10-25;0;0;0;0;0;0;0;0;0;0;0;0;0;0;0;0;0;0
FR;6;2021-10-26;0;0;0;0;0;0;0;0;0;0;0;0;0;0;0;0;0;0
FR;6;2021-10-27;0;0;0;0;0;0;0;0;0;0;0;0;0;0;0;0;0;0
FR;6;2021-10-28;0;0;0;0;0;0;0;0;0;0;0;0;0;0;0;0;0;0
FR;6;2021-10-29;0;0;0;0;0;0;0;0;0;0;0;0;0;0;0;0;0;0
FR;6;2021-10-30;0;0;0;0;0;0;0;0;0;0;0;0;0;0;0;0;0;0
FR;6;2021-10-31;0;0;0;0;0;0;0;0;0;0;0;0;0;0;0;0;0;0
FR;6;2021-11-01;0;0;0;0;0;0;0;0;0;0;0;0;0;0;0;0;0;0
FR;6;2021-11-02;0;0;0;0;0;0;0;0;0;0;0;0;0;0;0;0;0;0
FR;6;2021-11-03;0;0;0;0;0;0;0;0;0;0;0;0;0;0;0;0;0;0
FR;6;2021-11-04;0;0;0;0;0;0;0;0;0;0;0;0;0;0;0;0;0;0
FR;6;2021-11-05;0;0;0;0;0;0;0;0;0;0;0;0;0;0;0;0;0;0
FR;6;2021-11-06;0;0;0;0;0;0;0;0;0;0;0;0;0;0;0;0;0;0
FR;6;2021-11-07;0;0;0;0;0;0;0;0;0;0;0;0;0;0;0;0;0;0
FR;6;2021-11-08;0;0;0;0;0;0;0;0;0;0;0;0;0;0;0;0;0;0
FR;6;2021-11-09;0;0;0;0;0;0;0;0;0;0;0;0;0;0;0;0;0;0
FR;6;2021-11-10;0;0;0;0;0;0;0;0;0;0;0;0;0;0;0;0;0;0
FR;6;2021-11-11;0;0;0;0;0;0;0;0;0;0;0;0;0;0;0;0;0;0
FR;6;2021-11-12;0;0;0;0;0;0;0;0;0;0;0;0;0;0;0;0;0;0
FR;6;2021-11-13;0;0;0;0;0;0;0;0;0;0;0;0;0;0;0;0;0;0
FR;6;2021-11-14;0;0;0;0;0;0;0;0;0;0;0;0;0;0;0;0;0;0
FR;6;2021-11-15;0;0;0;0;0;0;0;0;0;0;0;0;0;0;0;0;0;0
FR;6;2021-11-16;0;0;0;0;0;0;0;0;0;0;0;0;0;0;0;0;0;0
FR;6;2021-11-17;0;0;0;0;0;0;0;0;0;0;0;0;0;0;0;0;0;0
FR;6;2021-11-18;0;0;0;0;0;0;0;0;0;0;0;0;0;0;0;0;0;0
FR;6;2021-11-19;0;0;0;0;0;0;0;0;0;0;0;0;0;0;0;0;0;0
FR;6;2021-11-20;0;0;0;0;0;0;0;0;0;0;0;0;0;0;0;0;0;0
FR;6;2021-11-21;0;0;0;0;0;0;0;0;0;0;0;0;0;0;0;0;0;0
FR;6;2021-11-22;0;0;0;0;0;0;0;0;0;0;0;0;0;0;0;0;0;0
FR;6;2021-11-23;0;0;0;0;0;0;0;0;0;0;0;0;0;0;0;0;0;0
FR;6;2021-11-24;0;0;0;0;0;0;0;0;0;0;0;0;0;0;0;0;0;0
FR;6;2021-11-25;0;0;0;0;0;0;0;0;0;0;0;0;0;0;0;0;0;0
FR;6;2021-11-26;0;0;0;0;0;0;0;0;0;0;0;0;0;0;0;0;0;0
FR;6;2021-11-27;0;0;0;0;0;0;0;0;0;0;0;0;0;0;0;0;0;0
FR;6;2021-11-28;0;0;0;0;0;0;0;0;0;0;0;0;0;0;0;0;0;0
FR;6;2021-11-29;0;0;0;0;0;0;0;0;0;0;0;0;0;0;0;0;0;0
FR;6;2021-11-30;0;0;0;0;0;0;0;0;0;0;0;0;0;0;0;0;0;0
FR;6;2021-12-01;0;0;0;0;0;0;0;0;0;0;0;0;0;0;0;0;0;0
FR;6;2021-12-02;0;0;0;0;0;0;0;0;0;0;0;0;0;0;0;0;0;0
FR;6;2021-12-03;0;0;0;0;0;0;0;0;0;0;0;0;0;0;0;0;0;0
FR;6;2021-12-04;0;0;0;0;0;0;0;0;0;0;0;0;0;0;0;0;0;0
FR;6;2021-12-05;0;0;0;0;0;0;0;0;0;0;0;0;0;0;0;0;0;0
FR;6;2021-12-06;0;0;0;0;0;0;0;0;0;0;0;0;0;0;0;0;0;0
FR;6;2021-12-07;0;0;0;0;0;0;0;0;0;0;0;0;0;0;0;0;0;0
FR;6;2021-12-08;0;0;0;0;0;0;0;0;0;0;0;0;0;0;0;0;0;0
FR;6;2021-12-09;0;0;0;0;0;0;0;0;0;0;0;0;0;0;0;0;0;0
FR;6;2021-12-10;0;0;0;0;0;0;0;0;0;0;0;0;0;0;0;0;0;0
FR;6;2021-12-11;0;0;0;0;0;0;0;0;0;0;0;0;0;0;0;0;0;0
FR;6;2021-12-12;0;0;0;0;0;0;0;0;0;0;0;0;0;0;0;0;0;0
FR;6;2021-12-13;0;0;0;0;0;0;0;0;0;0;0;0;0;0;0;0;0;0
FR;6;2021-12-14;0;0;0;0;0;0;0;0;0;0;0;0;0;0;0;0;0;0
FR;6;2021-12-15;0;0;0;0;0;0;0;0;0;0;0;0;0;0;0;0;0;0
FR;6;2021-12-16;0;0;0;0;0;0;0;0;0;0;0;0;0;0;0;0;0;0
FR;6;2021-12-17;0;0;0;0;0;0;0;0;0;0;0;0;0;0;0;0;0;0
FR;6;2021-12-18;0;0;0;0;0;0;0;0;0;0;0;0;0;0;0;0;0;0
FR;6;2021-12-19;0;0;0;0;0;0;0;0;0;0;0;0;0;0;0;0;0;0
FR;6;2021-12-20;0;0;0;0;0;0;0;0;0;0;0;0;0;0;0;0;0;0
FR;6;2021-12-21;0;0;0;0;0;0;0;0;0;0;0;0;0;0;0;0;0;0
FR;6;2021-12-22;0;0;0;0;0;0;0;0;0;0;0;0;0;0;0;0;0;0
FR;6;2021-12-23;0;0;0;0;0;0;0;0;0;0;0;0;0;0;0;0;0;0
FR;6;2021-12-24;0;0;0;0;0;0;0;0;0;0;0;0;0;0;0;0;0;0
FR;6;2021-12-25;0;0;0;0;0;0;0;0;0;0;0;0;0;0;0;0;0;0
FR;6;2021-12-26;0;0;0;0;0;0;0;0;0;0;0;0;0;0;0;0;0;0
FR;6;2021-12-27;0;0;0;0;0;0;0;0;0;0;0;0;0;0;0;0;0;0
FR;6;2021-12-28;0;0;0;0;0;0;0;0;0;0;0;0;0;0;0;0;0;0
FR;6;2021-12-29;0;0;0;0;0;0;0;0;0;0;0;0;0;0;0;0;0;0
FR;6;2021-12-30;0;0;0;0;0;0;0;0;0;0;0;0;0;0;0;0;0;0
FR;6;2021-12-31;0;0;0;0;0;0;0;0;0;0;0;0;0;0;0;0;0;0
FR;6;2022-01-01;0;0;0;0;0;0;0;0;0;0;0;0;0;0;0;0;0;0
FR;6;2022-01-02;0;0;0;0;0;0;0;0;0;0;0;0;0;0;0;0;0;0
FR;6;2022-01-03;0;0;0;0;0;0;0;0;0;0;0;0;0;0;0;0;0;0
FR;6;2022-01-04;0;0;0;0;0;0;0;0;0;0;0;0;0;0;0;0;0;0
FR;6;2022-01-05;0;0;0;0;0;0;0;0;0;0;0;0;0;0;0;0;0;0
FR;6;2022-01-06;0;0;0;0;0;0;0;0;0;0;0;0;0;0;0;0;0;0
FR;6;2022-01-07;0;0;0;0;0;0;0;0;0;0;0;0;0;0;0;0;0;0
FR;6;2022-01-08;0;0;0;0;0;0;0;0;0;0;0;0;0;0;0;0;0;0
FR;6;2022-01-09;0;0;0;0;0;0;0;0;0;0;0;0;0;0;0;0;0;0
FR;6;2022-01-10;0;0;0;0;0;0;0;0;0;0;0;0;0;0;0;0;0;0
FR;6;2022-01-11;0;0;0;0;0;0;0;0;0;0;0;0;0;0;0;0;0;0
FR;6;2022-01-12;0;0;0;0;0;0;0;0;0;0;0;0;0;0;0;0;0;0
FR;6;2022-01-13;0;0;0;0;0;0;0;0;0;0;0;0;0;0;0;0;0;0
FR;6;2022-01-14;0;0;0;0;0;0;0;0;0;0;0;0;0;0;0;0;0;0
FR;6;2022-01-15;0;0;0;0;0;0;0;0;0;0;0;0;0;0;0;0;0;0
FR;6;2022-01-16;0;0;0;0;0;0;0;0;0;0;0;0;0;0;0;0;0;0
FR;6;2022-01-17;0;0;0;0;0;0;0;0;0;0;0;0;0;0;0;0;0;0
FR;6;2022-01-18;0;0;0;0;0;0;0;0;0;0;0;0;0;0;0;0;0;0
FR;6;2022-01-19;0;0;0;0;0;0;0;0;0;0;0;0;0;0;0;0;0;0
FR;6;2022-01-20;0;0;0;0;0;0;0;0;0;0;0;0;0;0;0;0;0;0
FR;6;2022-01-21;0;0;0;0;0;0;0;0;0;0;0;0;0;0;0;0;0;0
FR;6;2022-01-22;0;0;0;0;0;0;0;0;0;0;0;0;0;0;0;0;0;0
FR;6;2022-01-23;0;0;0;0;0;0;0;0;0;0;0;0;0;0;0;0;0;0
FR;6;2022-01-24;0;0;0;0;0;0;0;0;0;0;0;0;0;0;0;0;0;0
FR;6;2022-01-25;0;0;0;0;0;0;0;0;0;0;0;0;0;0;0;0;0;0
FR;6;2022-01-26;0;0;0;0;0;0;0;0;0;0;0;0;0;0;0;0;0;0
FR;6;2022-01-27;0;0;0;0;0;0;0;0;0;0;0;0;0;0;0;0;0;0
FR;6;2022-01-28;0;0;0;0;0;0;0;0;0;0;0;0;0;0;0;0;0;0
FR;6;2022-01-29;0;0;0;0;0;0;0;0;0;0;0;0;0;0;0;0;0;0
FR;6;2022-01-30;0;0;0;0;0;0;0;0;0;0;0;0;0;0;0;0;0;0
FR;6;2022-01-31;0;0;0;0;0;0;0;0;0;0;0;0;0;0;0;0;0;0
FR;6;2022-02-01;0;0;0;0;0;0;0;0;0;0;0;0;0;0;0;0;0;0
FR;6;2022-02-02;0;0;0;0;0;0;0;0;0;0;0;0;0;0;0;0;0;0
FR;6;2022-02-03;0;0;0;0;0;0;0;0;0;0;0;0;0;0;0;0;0;0
FR;6;2022-02-04;0;0;0;0;0;0;0;0;0;0;0;0;0;0;0;0;0;0
FR;6;2022-02-05;0;0;0;0;0;0;0;0;0;0;0;0;0;0;0;0;0;0
FR;6;2022-02-06;0;0;0;0;0;0;0;0;0;0;0;0;0;0;0;0;0;0
FR;6;2022-02-07;0;0;0;0;0;0;0;0;0;0;0;0;0;0;0;0;0;0
FR;6;2022-02-08;0;0;0;0;0;0;0;0;0;0;0;0;0;0;0;0;0;0
FR;6;2022-02-09;0;0;0;0;0;0;0;0;0;0;0;0;0;0;0;0;0;0
FR;6;2022-02-10;0;0;0;0;0;0;0;0;0;0;0;0;0;0;0;0;0;0
FR;6;2022-02-11;0;0;0;0;0;0;0;0;0;0;0;0;0;0;0;0;0;0
FR;6;2022-02-12;0;0;0;0;0;0;0;0;0;0;0;0;0;0;0;0;0;0
FR;6;2022-02-13;0;0;0;0;0;0;0;0;0;0;0;0;0;0;0;0;0;0
FR;6;2022-02-14;0;0;0;0;0;0;0;0;0;0;0;0;0;0;0;0;0;0
FR;6;2022-02-15;0;0;0;0;0;0;0;0;0;0;0;0;0;0;0;0;0;0
FR;6;2022-02-16;0;0;0;0;0;0;0;0;0;0;0;0;0;0;0;0;0;0
FR;6;2022-02-17;0;0;0;0;0;0;0;0;0;0;0;0;0;0;0;0;0;0
FR;6;2022-02-18;0;0;0;0;0;0;0;0;0;0;0;0;0;0;0;0;0;0
FR;6;2022-02-19;0;0;0;0;0;0;0;0;0;0;0;0;0;0;0;0;0;0
FR;6;2022-02-20;0;0;0;0;0;0;0;0;0;0;0;0;0;0;0;0;0;0
FR;6;2022-02-21;0;0;0;0;0;0;0;0;0;0;0;0;0;0;0;0;0;0
FR;6;2022-02-22;0;0;0;0;0;0;0;0;0;0;0;0;0;0;0;0;0;0
FR;6;2022-02-23;0;0;0;0;0;0;0;0;0;0;0;0;0;0;0;0;0;0
FR;6;2022-02-24;0;0;0;0;0;0;0;0;0;0;0;0;0;0;0;0;0;0
FR;6;2022-02-25;0;0;0;0;0;0;0;0;0;0;0;0;0;0;0;0;0;0
FR;6;2022-02-26;1;0;0;0;0;0;0;0;0;1;0;0;0;0;0;0;0;0
FR;6;2022-02-27;1;0;0;0;1;0;0;0;0;2;0;0;0;1;0;0;0;0
FR;6;2022-02-28;0;0;0;0;0;0;0;0;0;2;0;0;0;1;0;0;0;0
FR;6;2022-03-01;3;0;0;0;0;0;0;0;0;5;0;0;0;1;0;0;0;0
FR;6;2022-03-02;97;9;2;0;15;7;0;0;0;102;9;2;0;16;7;0;0;0
FR;6;2022-03-03;0;0;0;0;0;0;0;0;0;102;9;2;0;16;7;0;0;0
FR;6;2022-03-04;92;4;0;0;8;4;0;0;0;194;13;2;0;24;11;0;0;0
FR;6;2022-03-05;391;23;2;0;60;14;0;0;0;585;36;4;0;84;25;0;0;0
FR;6;2022-03-06;7;1;0;0;2;0;0;0;0;592;37;4;0;86;25;0;0;0
FR;6;2022-03-07;337;19;0;0;51;13;0;0;0;929;56;4;0;137;38;0;0;0
FR;6;2022-03-08;230;14;0;0;47;5;0;0;0;1159;70;4;0;184;43;0;0;0
FR;6;2022-03-09;519;29;2;0;84;21;1;0;0;1678;99;6;0;268;64;1;0;0
FR;6;2022-03-10;206;19;0;1;54;12;1;0;0;1884;118;6;1;322;76;2;0;0
FR;6;2022-03-11;331;22;6;0;53;21;0;0;0;2215;140;12;1;375;97;2;0;0
FR;6;2022-03-12;518;25;1;0;83;20;0;0;0;2733;165;13;1;458;117;2;0;0
FR;6;2022-03-13;40;2;0;0;2;1;0;0;0;2773;167;13;1;460;118;2;0;0
FR;6;2022-03-14;201;4;2;0;39;3;1;0;0;2974;171;15;1;499;121;3;0;0
FR;6;2022-03-15;112;11;2;0;28;9;0;0;0;3086;182;17;1;527;130;3;0;0
FR;6;2022-03-16;310;17;2;1;49;15;1;0;0;3396;199;19;2;576;145;4;0;0
FR;6;2022-03-17;117;6;1;2;14;4;2;0;0;3513;205;20;4;590;149;6;0;0
FR;6;2022-03-18;215;10;0;0;40;6;0;0;0;3728;215;20;4;630;155;6;0;0
FR;6;2022-03-19;307;19;2;0;90;9;0;0;0;4035;234;22;4;720;164;6;0;0
FR;6;2022-03-20;15;5;0;0;5;1;0;0;0;4050;239;22;4;725;165;6;0;0
FR;6;2022-03-21;132;23;1;0;47;4;0;0;0;4182;262;23;4;772;169;6;0;0
FR;6;2022-03-22;97;15;0;0;34;4;0;0;0;4279;277;23;4;806;173;6;0;0
FR;6;2022-03-23;226;108;3;0;155;14;1;0;0;4505;385;26;4;961;187;7;0;0
FR;6;2022-03-24;100;15;1;3;32;4;3;0;0;4605;400;27;7;993;191;10;0;0
FR;6;2022-03-25;203;141;2;1;179;15;2;0;0;4808;541;29;8;1172;206;12;0;0
FR;6;2022-03-26;331;295;7;1;385;19;1;0;0;5139;836;36;9;1557;225;13;0;0
FR;6;2022-03-27;32;30;1;0;37;1;1;0;0;5171;866;37;9;1594;226;14;0;0
FR;6;2022-03-28;201;208;8;1;234;17;3;0;0;5372;1074;45;10;1828;243;17;0;0
FR;6;2022-03-29;124;189;12;2;206;12;9;0;0;5496;1263;57;12;2034;255;26;0;0
FR;6;2022-03-30;305;476;10;2;548;22;6;0;0;5801;1739;67;14;2582;277;32;0;0
FR;6;2022-03-31;123;140;10;0;160;14;5;0;0;5924;1879;77;14;2742;291;37;0;0
FR;6;2022-04-01;195;150;11;2;178;23;3;0;0;6119;2029;88;16;2920;314;40;0;0
FR;6;2022-04-02;206;241;9;1;280;13;8;0;0;6325;2270;97;17;3200;327;48;0;0
FR;6;2022-04-03;17;21;0;0;26;1;0;0;0;6342;2291;97;17;3226;328;48;0;0
FR;6;2022-04-04;137;114;6;1;131;9;5;0;0;6479;2405;103;18;3357;337;53;0;0
FR;6;2022-04-05;146;88;15;1;105;11;8;0;0;6625;2493;118;19;3462;348;61;0;0
FR;6;2022-04-06;204;245;22;26;291;27;33;0;0;6829;2738;140;45;3753;375;94;0;0
FR;6;2022-04-07;127;96;15;9;115;17;14;0;0;6956;2834;155;54;3868;392;108;0;0
FR;6;2022-04-08;199;171;16;3;214;17;9;0;1;7155;3005;171;57;4082;409;117;0;1
FR;6;2022-04-09;145;139;6;12;171;13;4;0;0;7300;3144;177;69;4253;422;121;0;1
FR;6;2022-04-10;11;20;3;0;26;1;3;0;0;7311;3164;180;69;4279;423;124;0;1
FR;6;2022-04-11;101;106;4;0;129;5;3;0;0;7412;3270;184;69;4408;428;127;0;1
FR;6;2022-04-12;136;75;5;8;114;10;10;0;0;7548;3345;189;77;4522;438;137;0;1
FR;6;2022-04-13;162;175;7;5;208;13;8;0;0;7710;3520;196;82;4730;451;145;0;1
FR;6;2022-04-14;100;103;5;10;121;8;10;0;0;7810;3623;201;92;4851;459;155;0;1
FR;6;2022-04-15;158;149;11;7;167;19;14;0;1;7968;3772;212;99;5018;478;169;0;2
FR;6;2022-04-16;127;132;5;0;162;14;2;0;0;8095;3904;217;99;5180;492;171;0;2
FR;6;2022-04-17;8;9;4;0;10;4;0;0;0;8103;3913;221;99;5190;496;171;0;2
FR;6;2022-04-18;8;15;3;0;14;4;0;0;0;8111;3928;224;99;5204;500;171;0;2
FR;6;2022-04-19;97;112;4;3;130;3;7;0;0;8208;4040;228;102;5334;503;178;0;2
FR;6;2022-04-20;177;227;8;7;269;15;3;0;0;8385;4267;236;109;5603;518;181;0;2
FR;6;2022-04-21;111;93;8;4;110;11;7;0;0;8496;4360;244;113;5713;529;188;0;2
FR;6;2022-04-22;139;160;13;12;189;13;13;0;0;8635;4520;257;125;5902;542;201;0;2
FR;6;2022-04-23;106;129;1;1;161;7;1;0;0;8741;4649;258;126;6063;549;202;0;2
FR;6;2022-04-24;5;21;1;0;22;0;1;0;0;8746;4670;259;126;6085;549;203;0;2
FR;6;2022-04-25;90;128;3;8;151;11;9;0;0;8836;4798;262;134;6236;560;212;0;2
FR;6;2022-04-26;101;128;19;2;151;17;13;0;0;8937;4926;281;136;6387;577;225;0;2
FR;6;2022-04-27;197;159;21;1;222;27;11;0;1;9134;5085;302;137;6609;604;236;0;3
FR;6;2022-04-28;109;87;7;1;123;8;7;0;0;9243;5172;309;138;6732;612;243;0;3
FR;6;2022-04-29;191;169;16;2;215;20;6;0;0;9434;5341;325;140;6947;632;249;0;3
FR;6;2022-04-30;133;125;7;1;168;24;2;0;0;9567;5466;332;141;7115;656;251;0;3
FR;6;2022-05-01;7;6;0;0;8;0;0;0;0;9574;5472;332;141;7123;656;251;0;3
FR;6;2022-05-02;94;65;3;4;88;3;4;0;0;9668;5537;335;145;7211;659;255;0;3
FR;6;2022-05-03;136;93;11;2;125;7;9;0;0;9804;5630;346;147;7336;666;264;0;3
FR;6;2022-05-04;167;118;25;12;161;29;12;0;1;9971;5748;371;159;7497;695;276;0;4
FR;6;2022-05-05;101;70;8;3;97;12;6;0;0;10072;5818;379;162;7594;707;282;0;4
FR;6;2022-05-06;152;110;10;9;155;16;11;0;0;10224;5928;389;171;7749;723;293;0;4
FR;6;2022-05-07;139;93;13;3;136;23;8;0;0;10363;6021;402;174;7885;746;301;0;4
FR;6;2022-05-08;20;8;6;5;16;7;5;0;0;10383;6029;408;179;7901;753;306;0;4
FR;6;2022-05-09;86;78;9;7;95;13;6;0;0;10469;6107;417;186;7996;766;312;0;4
FR;6;2022-05-10;112;80;15;7;110;12;13;0;0;10581;6187;432;193;8106;778;325;0;4
FR;6;2022-05-11;130;124;11;14;163;20;6;0;0;10711;6311;443;207;8269;798;331;0;4
FR;6;2022-05-12;105;76;7;5;96;15;6;0;1;10816;6387;450;212;8365;813;337;0;5
FR;6;2022-05-13;155;97;17;21;137;22;16;0;0;10971;6484;467;233;8502;835;353;0;5
FR;6;2022-05-14;81;60;6;7;84;15;2;0;0;11052;6544;473;240;8586;850;355;0;5
FR;6;2022-05-15;12;7;0;0;14;0;0;0;0;11064;6551;473;240;8600;850;355;0;5
FR;6;2022-05-16;65;54;6;2;69;12;3;0;0;11129;6605;479;242;8669;862;358;0;5
FR;6;2022-05-17;123;77;5;7;92;11;8;0;0;11252;6682;484;249;8761;873;366;0;5
FR;6;2022-05-18;131;116;5;1;158;14;3;0;0;11383;6798;489;250;8919;887;369;0;5
FR;6;2022-05-19;124;57;6;8;96;9;8;0;0;11507;6855;495;258;9015;896;377;0;5
FR;6;2022-05-20;125;115;13;3;151;18;10;0;0;11632;6970;508;261;9166;914;387;0;5
FR;6;2022-05-21;92;69;14;3;93;12;8;0;0;11724;7039;522;264;9259;926;395;0;5
FR;6;2022-05-22;19;12;5;0;21;4;1;0;0;11743;7051;527;264;9280;930;396;0;5
FR;6;2022-05-23;77;72;4;2;90;7;2;0;0;11820;7123;531;266;9370;937;398;0;5
FR;6;2022-05-24;117;98;8;2;131;16;4;0;0;11937;7221;539;268;9501;953;402;0;5
FR;6;2022-05-25;140;129;6;3;171;11;6;0;0;12077;7350;545;271;9672;964;408;0;5
FR;6;2022-05-26;7;9;3;0;5;9;0;0;0;12084;7359;548;271;9677;973;408;0;5
FR;6;2022-05-27;127;105;15;11;136;18;18;0;1;12211;7464;563;282;9813;991;426;0;6
FR;6;2022-05-28;54;75;1;5;89;8;5;0;0;12265;7539;564;287;9902;999;431;0;6
FR;6;2022-05-29;8;10;0;0;10;1;0;0;0;12273;7549;564;287;9912;1000;431;0;6
FR;6;2022-05-30;70;70;7;4;86;4;9;0;0;12343;7619;571;291;9998;1004;440;0;6
FR;6;2022-05-31;87;102;10;2;121;14;7;0;0;12430;7721;581;293;10119;1018;447;0;6
FR;6;2022-06-01;97;89;10;1;111;11;6;0;0;12527;7810;591;294;10230;1029;453;0;6
FR;6;2022-06-02;91;60;6;3;80;9;6;0;0;12618;7870;597;297;10310;1038;459;0;6
FR;6;2022-06-03;126;102;13;7;128;21;8;0;0;12744;7972;610;304;10438;1059;467;0;6
FR;6;2022-06-04;63;51;10;0;64;12;3;0;0;12807;8023;620;304;10502;1071;470;0;6
FR;6;2022-06-05;16;15;2;1;18;4;1;0;0;12823;8038;622;305;10520;1075;471;0;6
FR;6;2022-06-06;9;6;0;0;8;0;0;0;0;12832;8044;622;305;10528;1075;471;0;6
FR;6;2022-06-07;79;90;3;4;117;8;6;0;0;12911;8134;625;309;10645;1083;477;0;6
FR;6;2022-06-08;92;110;13;5;130;20;6;0;0;13003;8244;638;314;10775;1103;483;0;6
FR;6;2022-06-09;75;81;15;3;106;15;8;0;0;13078;8325;653;317;10881;1118;491;0;6
FR;6;2022-06-10;116;93;26;10;120;22;13;0;0;13194;8418;679;327;11001;1140;504;0;6
FR;6;2022-06-11;83;62;6;10;82;12;11;0;0;13277;8480;685;337;11083;1152;515;0;6
FR;6;2022-06-12;6;14;1;0;16;2;0;0;0;13283;8494;686;337;11099;1154;515;0;6
FR;6;2022-06-13;74;59;18;1;68;7;4;0;0;13357;8553;704;338;11167;1161;519;0;6
FR;6;2022-06-14;98;100;8;5;116;16;8;0;0;13455;8653;712;343;11283;1177;527;0;6
FR;6;2022-06-15;80;86;7;8;114;15;10;0;0;13535;8739;719;351;11397;1192;537;0;6
FR;6;2022-06-16;53;40;11;7;45;14;6;0;0;13588;8779;730;358;11442;1206;543;0;6
FR;6;2022-06-17;86;85;3;13;109;11;5;0;0;13674;8864;733;371;11551;1217;548;0;6
FR;6;2022-06-18;71;62;13;0;88;21;1;0;0;13745;8926;746;371;11639;1238;549;0;6
FR;6;2022-06-19;6;6;3;0;7;4;1;0;0;13751;8932;749;371;11646;1242;550;0;6
FR;6;2022-06-20;42;41;4;1;55;6;1;0;0;13793;8973;753;372;11701;1248;551;0;6
FR;6;2022-06-21;59;73;10;7;83;17;7;0;0;13852;9046;763;379;11784;1265;558;0;6
FR;6;2022-06-22;86;85;8;2;98;17;3;0;0;13938;9131;771;381;11882;1282;561;0;6
FR;6;2022-06-23;64;39;13;7;41;15;10;0;0;14002;9170;784;388;11923;1297;571;0;6
FR;6;2022-06-24;77;85;7;14;95;20;16;0;0;14079;9255;791;402;12018;1317;587;0;6
FR;6;2022-06-25;67;61;4;3;77;8;5;0;0;14146;9316;795;405;12095;1325;592;0;6
FR;6;2022-06-26;6;7;1;0;10;1;0;0;0;14152;9323;796;405;12105;1326;592;0;6
FR;6;2022-06-27;51;50;4;9;62;12;7;0;0;14203;9373;800;414;12167;1338;599;0;6
FR;6;2022-06-28;68;47;6;3;53;15;5;0;0;14271;9420;806;417;12220;1353;604;0;6
FR;6;2022-06-29;98;117;26;37;115;19;35;0;5;14369;9537;832;454;12335;1372;639;0;11
FR;6;2022-06-30;84;60;33;10;61;12;7;0;0;14453;9597;865;464;12396;1384;646;0;11
FR;6;2022-07-01;115;94;25;33;102;18;27;0;1;14568;9691;890;497;12498;1402;673;0;12
FR;6;2022-07-02;58;67;26;2;64;37;6;0;0;14626;9758;916;499;12562;1439;679;0;12
FR;6;2022-07-03;11;4;4;3;5;4;3;0;0;14637;9762;920;502;12567;1443;682;0;12
FR;6;2022-07-04;61;43;3;23;55;13;20;0;0;14698;9805;923;525;12622;1456;702;0;12
FR;6;2022-07-05;65;53;19;67;60;27;63;0;0;14763;9858;942;592;12682;1483;765;0;12
FR;6;2022-07-06;94;64;7;11;78;12;17;0;0;14857;9922;949;603;12760;1495;782;0;12
FR;6;2022-07-07;99;79;42;37;99;14;34;0;4;14956;10001;991;640;12859;1509;816;0;16
FR;6;2022-07-08;139;87;42;27;115;10;25;0;3;15095;10088;1033;667;12974;1519;841;0;19
FR;6;2022-07-09;53;51;16;29;51;27;33;0;1;15148;10139;1049;696;13025;1546;874;0;20
FR;6;2022-07-10;3;7;8;0;9;9;0;0;0;15151;10146;1057;696;13034;1555;874;0;20
FR;6;2022-07-11;54;44;5;4;47;12;4;0;0;15205;10190;1062;700;13081;1567;878;0;20
FR;6;2022-07-12;70;72;12;23;87;12;27;0;0;15275;10262;1074;723;13168;1579;905;0;20
FR;6;2022-07-13;84;65;14;21;71;25;22;0;0;15359;10327;1088;744;13239;1604;927;0;20
FR;6;2022-07-14;4;3;1;0;4;1;0;0;0;15363;10330;1089;744;13243;1605;927;0;20
FR;6;2022-07-15;74;59;9;57;85;16;45;0;0;15437;10389;1098;801;13328;1621;972;0;20
FR;6;2022-07-16;27;31;17;0;37;17;3;0;0;15464;10420;1115;801;13365;1638;975;0;20
FR;6;2022-07-17;3;7;0;0;8;0;0;0;0;15467;10427;1115;801;13373;1638;975;0;20
FR;6;2022-07-18;37;62;11;14;60;15;14;0;6;15504;10489;1126;815;13433;1653;989;0;26
FR;6;2022-07-19;54;48;4;19;60;6;21;0;1;15558;10537;1130;834;13493;1659;1010;0;27
FR;6;2022-07-20;53;70;7;22;75;11;27;0;0;15611;10607;1137;856;13568;1670;1037;0;27
FR;6;2022-07-21;51;61;4;7;56;11;9;0;0;15662;10668;1141;863;13624;1681;1046;0;27
FR;6;2022-07-22;55;74;7;26;82;8;16;0;2;15717;10742;1148;889;13706;1689;1062;0;29
FR;6;2022-07-23;38;40;6;10;40;6;9;0;1;15755;10782;1154;899;13746;1695;1071;0;30
FR;6;2022-07-24;11;14;1;3;19;3;3;0;0;15766;10796;1155;902;13765;1698;1074;0;30
FR;6;2022-07-25;60;44;8;12;41;9;13;0;1;15826;10840;1163;914;13806;1707;1087;0;31
FR;6;2022-07-26;47;64;14;6;62;10;13;0;0;15873;10904;1177;920;13868;1717;1100;0;31
FR;6;2022-07-27;54;78;15;11;80;18;15;0;8;15927;10982;1192;931;13948;1735;1115;0;39
FR;6;2022-07-28;30;48;4;6;50;8;7;0;1;15957;11030;1196;937;13998;1743;1122;0;40
FR;6;2022-07-29;43;71;10;38;60;24;36;0;1;16000;11101;1206;975;14058;1767;1158;0;41
FR;6;2022-07-30;26;48;4;15;49;7;15;0;0;16026;11149;1210;990;14107;1774;1173;0;41
FR;6;2022-07-31;0;1;1;0;1;0;1;0;0;16026;11150;1211;990;14108;1774;1174;0;41
FR;6;2022-08-01;39;36;14;8;32;10;6;0;1;16065;11186;1225;998;14140;1784;1180;0;42
FR;6;2022-08-02;37;46;10;14;52;6;16;0;0;16102;11232;1235;1012;14192;1790;1196;0;42
FR;6;2022-08-03;29;52;7;16;53;11;19;0;0;16131;11284;1242;1028;14245;1801;1215;0;42
FR;6;2022-08-04;25;21;4;9;20;6;10;0;1;16156;11305;1246;1037;14265;1807;1225;0;43
FR;6;2022-08-05;43;45;1;7;54;5;7;0;0;16199;11350;1247;1044;14319;1812;1232;0;43
FR;6;2022-08-06;17;27;1;3;33;2;4;0;0;16216;11377;1248;1047;14352;1814;1236;0;43
FR;6;2022-08-07;1;2;0;0;2;0;0;0;0;16217;11379;1248;1047;14354;1814;1236;0;43
FR;6;2022-08-08;24;33;1;0;40;1;0;0;0;16241;11412;1249;1047;14394;1815;1236;0;43
FR;6;2022-08-09;22;30;6;3;29;3;3;0;0;16263;11442;1255;1050;14423;1818;1239;0;43
FR;6;2022-08-10;32;36;5;9;38;5;9;0;5;16295;11478;1260;1059;14461;1823;1248;0;48
FR;6;2022-08-11;32;33;1;1;40;1;0;0;1;16327;11511;1261;1060;14501;1824;1248;0;49
FR;6;2022-08-12;50;44;6;2;50;15;3;0;1;16377;11555;1267;1062;14551;1839;1251;0;50
FR;6;2022-08-13;9;20;0;0;22;1;0;0;0;16386;11575;1267;1062;14573;1840;1251;0;50
FR;6;2022-08-14;3;1;0;0;2;0;0;0;0;16389;11576;1267;1062;14575;1840;1251;0;50
FR;6;2022-08-15;2;3;1;0;4;0;1;0;0;16391;11579;1268;1062;14579;1840;1252;0;50
FR;6;2022-08-16;35;66;21;7;66;7;2;0;0;16426;11645;1289;1069;14645;1847;1254;0;50
FR;6;2022-08-17;32;44;10;9;41;10;6;0;7;16458;11689;1299;1078;14686;1857;1260;0;57
FR;6;2022-08-18;29;55;14;4;61;4;0;0;1;16487;11744;1313;1082;14747;1861;1260;0;58
FR;6;2022-08-19;30;45;5;4;47;3;2;0;1;16517;11789;1318;1086;14794;1864;1262;0;59
FR;6;2022-08-20;26;28;3;0;27;8;1;0;0;16543;11817;1321;1086;14821;1872;1263;0;59
FR;6;2022-08-21;1;5;2;0;5;0;0;0;0;16544;11822;1323;1086;14826;1872;1263;0;59
FR;6;2022-08-22;20;42;15;1;45;0;0;0;0;16564;11864;1338;1087;14871;1872;1263;0;59
FR;6;2022-08-23;34;45;6;7;47;6;4;0;2;16598;11909;1344;1094;14918;1878;1267;0;61
FR;6;2022-08-24;34;30;6;3;36;6;2;0;3;16632;11939;1350;1097;14954;1884;1269;0;64
FR;6;2022-08-25;25;27;1;1;29;5;1;0;0;16657;11966;1351;1098;14983;1889;1270;0;64
FR;6;2022-08-26;38;44;4;4;51;7;7;0;0;16695;12010;1355;1102;15034;1896;1277;0;64
FR;6;2022-08-27;19;21;7;3;22;8;4;0;0;16714;12031;1362;1105;15056;1904;1281;0;64
FR;6;2022-08-28;6;3;0;6;3;1;1;0;4;16720;12034;1362;1111;15059;1905;1282;0;68
FR;6;2022-08-29;26;22;2;6;29;3;6;0;0;16746;12056;1364;1117;15088;1908;1288;0;68
FR;6;2022-08-30;28;35;4;12;33;8;13;0;0;16774;12091;1368;1129;15121;1916;1301;0;68
FR;6;2022-08-31;35;38;2;11;46;3;12;0;0;16809;12129;1370;1140;15167;1919;1313;0;68
FR;6;2022-09-01;17;11;5;1;13;4;3;0;0;16826;12140;1375;1141;15180;1923;1316;0;68
FR;6;2022-09-02;19;14;2;1;13;3;2;0;0;16845;12154;1377;1142;15193;1926;1318;0;68
FR;6;2022-09-03;10;3;1;5;4;2;5;0;0;16855;12157;1378;1147;15197;1928;1323;0;68
FR;6;2022-09-04;4;1;0;0;1;0;0;0;0;16859;12158;1378;1147;15198;1928;1323;0;68
FR;6;2022-09-05;8;7;0;0;10;0;0;0;0;16867;12165;1378;1147;15208;1928;1323;0;68
FR;6;2022-09-06;7;9;7;12;8;6;15;0;0;16874;12174;1385;1159;15216;1934;1338;0;68
FR;6;2022-09-07;3;8;1;0;8;1;0;0;0;16877;12182;1386;1159;15224;1935;1338;0;68
FR;6;2022-09-08;6;4;0;2;3;1;2;0;0;16883;12186;1386;1161;15227;1936;1340;0;68
FR;6;2022-09-09;7;9;2;7;9;3;8;0;0;16890;12195;1388;1168;15236;1939;1348;0;68
FR;6;2022-09-10;3;4;1;0;3;1;1;0;0;16893;12199;1389;1168;15239;1940;1349;0;68
FR;6;2022-09-11;1;3;0;0;3;0;0;0;0;16894;12202;1389;1168;15242;1940;1349;0;68
FR;6;2022-09-12;10;4;1;0;3;3;0;0;0;16904;12206;1390;1168;15245;1943;1349;0;68
FR;6;2022-09-13;7;2;3;0;2;2;2;0;0;16911;12208;1393;1168;15247;1945;1351;0;68
FR;6;2022-09-14;9;8;2;0;7;4;0;0;0;16920;12216;1395;1168;15254;1949;1351;0;68
FR;6;2022-09-15;8;13;5;5;9;9;3;0;2;16928;12229;1400;1173;15263;1958;1354;0;70
FR;6;2022-09-16;25;39;1;1;47;4;1;0;2;16953;12268;1401;1174;15310;1962;1355;0;72
FR;6;2022-09-17;24;22;0;6;24;5;3;0;2;16977;12290;1401;1180;15334;1967;1358;0;74
FR;6;2022-09-18;5;4;0;0;4;1;0;0;0;16982;12294;1401;1180;15338;1968;1358;0;74
FR;6;2022-09-19;30;30;2;1;32;5;1;0;0;17012;12324;1403;1181;15370;1973;1359;0;74
FR;6;2022-09-20;34;25;1;4;30;6;2;0;1;17046;12349;1404;1185;15400;1979;1361;0;75
FR;6;2022-09-21;21;9;3;3;7;7;5;0;3;17067;12358;1407;1188;15407;1986;1366;0;78
FR;6;2022-09-22;19;28;1;22;32;3;21;0;1;17086;12386;1408;1210;15439;1989;1387;0;79
FR;6;2022-09-23;28;41;5;9;47;9;2;0;0;17114;12427;1413;1219;15486;1998;1389;0;79
FR;6;2022-09-24;16;16;4;2;21;6;2;0;0;17130;12443;1417;1221;15507;2004;1391;0;79
FR;6;2022-09-25;3;14;0;0;14;1;0;0;0;17133;12457;1417;1221;15521;2005;1391;0;79
FR;6;2022-09-26;16;13;0;18;12;5;18;0;2;17149;12470;1417;1239;15533;2010;1409;0;81
FR;6;2022-09-27;32;19;2;3;23;4;4;0;0;17181;12489;1419;1242;15556;2014;1413;0;81
FR;6;2022-09-28;27;10;9;11;16;5;17;0;2;17208;12499;1428;1253;15572;2019;1430;0;83
FR;6;2022-09-29;13;13;10;34;16;6;33;0;7;17221;12512;1438;1287;15588;2025;1463;0;90
FR;6;2022-09-30;34;24;5;6;33;5;3;0;0;17255;12536;1443;1293;15621;2030;1466;0;90
FR;6;2022-10-01;17;12;5;8;9;8;8;0;2;17272;12548;1448;1301;15630;2038;1474;0;92
FR;6;2022-10-02;4;0;0;0;1;0;0;0;0;17276;12548;1448;1301;15631;2038;1474;0;92
FR;6;2022-10-03;11;10;3;5;11;4;6;0;0;17287;12558;1451;1306;15642;2042;1480;0;92
FR;6;2022-10-04;19;17;4;28;21;3;30;0;3;17306;12575;1455;1334;15663;2045;1510;0;95
FR;6;2022-10-05;11;12;3;2;9;7;4;0;0;17317;12587;1458;1336;15672;2052;1514;0;95
FR;6;2022-10-06;19;13;4;6;17;2;10;0;0;17336;12600;1462;1342;15689;2054;1524;0;95
FR;6;2022-10-07;27;26;5;24;24;11;16;0;5;17363;12626;1467;1366;15713;2065;1540;0;100
FR;6;2022-10-08;18;13;0;0;16;0;0;0;0;17381;12639;1467;1366;15729;2065;1540;0;100
FR;6;2022-10-09;7;3;4;27;3;4;30;0;6;17388;12642;1471;1393;15732;2069;1570;0;106
FR;6;2022-10-10;15;14;1;16;16;6;13;0;0;17403;12656;1472;1409;15748;2075;1583;0;106
FR;6;2022-10-11;21;23;3;11;22;8;13;0;3;17424;12679;1475;1420;15770;2083;1596;0;109
FR;6;2022-10-12;20;16;7;19;18;3;24;0;7;17444;12695;1482;1439;15788;2086;1620;0;116
FR;6;2022-10-13;28;15;2;36;23;0;38;0;6;17472;12710;1484;1475;15811;2086;1658;0;122
FR;6;2022-10-14;29;23;5;49;24;11;45;0;13;17501;12733;1489;1524;15835;2097;1703;0;135
FR;6;2022-10-15;13;9;0;22;8;4;21;0;6;17514;12742;1489;1546;15843;2101;1724;0;141
FR;6;2022-10-16;4;5;0;6;2;3;6;0;0;17518;12747;1489;1552;15845;2104;1730;0;141
FR;6;2022-10-17;14;14;2;10;14;1;12;0;2;17532;12761;1491;1562;15859;2105;1742;0;143
FR;6;2022-10-18;12;19;9;26;19;4;18;0;11;17544;12780;1500;1588;15878;2109;1760;0;154
FR;6;2022-10-19;10;20;6;16;20;5;19;0;5;17554;12800;1506;1604;15898;2114;1779;0;159
FR;6;2022-10-20;16;15;12;57;19;5;67;0;13;17570;12815;1518;1661;15917;2119;1846;0;172
FR;6;2022-10-21;16;21;9;34;22;11;37;0;10;17586;12836;1527;1695;15939;2130;1883;0;182
FR;6;2022-10-22;19;14;1;4;17;3;4;0;0;17605;12850;1528;1699;15956;2133;1887;0;182
FR;6;2022-10-23;3;3;1;0;4;0;1;0;0;17608;12853;1529;1699;15960;2133;1888;0;182
FR;6;2022-10-24;12;14;2;7;14;6;5;0;2;17620;12867;1531;1706;15974;2139;1893;0;184
FR;6;2022-10-25;20;13;6;17;16;7;19;0;4;17640;12880;1537;1723;15990;2146;1912;0;188
FR;6;2022-10-26;17;9;4;13;12;4;15;0;5;17657;12889;1541;1736;16002;2150;1927;0;193
FR;6;2022-10-27;20;7;8;37;10;6;36;0;14;17677;12896;1549;1773;16012;2156;1963;0;207
FR;6;2022-10-28;21;27;3;4;28;6;5;0;1;17698;12923;1552;1777;16040;2162;1968;0;208
FR;6;2022-10-29;7;11;5;11;10;6;14;0;12;17705;12934;1557;1788;16050;2168;1982;0;220
FR;6;2022-10-30;2;5;0;0;5;0;0;0;0;17707;12939;1557;1788;16055;2168;1982;0;220
FR;6;2022-10-31;20;14;2;13;17;4;12;0;3;17727;12953;1559;1801;16072;2172;1994;0;223
FR;6;2022-11-01;2;1;1;0;1;1;0;0;0;17729;12954;1560;1801;16073;2173;1994;0;223
FR;6;2022-11-02;15;25;9;21;26;11;19;0;12;17744;12979;1569;1822;16099;2184;2013;0;235
FR;6;2022-11-03;17;17;11;39;20;8;43;0;9;17761;12996;1580;1861;16119;2192;2056;0;244
FR;6;2022-11-04;19;22;9;16;27;5;16;0;10;17780;13018;1589;1877;16146;2197;2072;0;254
FR;6;2022-11-05;9;16;2;4;17;4;6;0;0;17789;13034;1591;1881;16163;2201;2078;0;254
FR;6;2022-11-06;5;1;0;0;1;0;0;0;0;17794;13035;1591;1881;16164;2201;2078;0;254
FR;6;2022-11-07;18;10;6;17;12;4;18;0;11;17812;13045;1597;1898;16176;2205;2096;0;265
FR;6;2022-11-08;18;10;2;3;8;5;5;0;4;17830;13055;1599;1901;16184;2210;2101;0;269
FR;6;2022-11-09;16;22;1;6;21;4;5;0;4;17846;13077;1600;1907;16205;2214;2106;0;273
FR;6;2022-11-10;10;10;4;12;8;5;11;0;10;17856;13087;1604;1919;16213;2219;2117;0;283
FR;6;2022-11-11;4;1;0;0;1;1;0;0;0;17860;13088;1604;1919;16214;2220;2117;0;283
FR;6;2022-11-12;4;11;1;7;11;2;5;0;9;17864;13099;1605;1926;16225;2222;2122;0;292
FR;6;2022-11-13;1;1;0;1;1;0;1;0;0;17865;13100;1605;1927;16226;2222;2123;0;292
FR;6;2022-11-14;13;10;7;32;14;8;33;0;14;17878;13110;1612;1959;16240;2230;2156;0;306
FR;6;2022-11-15;7;18;1;11;16;4;7;0;2;17885;13128;1613;1970;16256;2234;2163;0;308
FR;6;2022-11-16;16;15;9;32;16;3;42;0;9;17901;13143;1622;2002;16272;2237;2205;0;317
FR;6;2022-11-17;10;8;1;29;8;2;28;0;5;17911;13151;1623;2031;16280;2239;2233;0;322
FR;6;2022-11-18;19;12;5;23;17;4;25;0;7;17930;13163;1628;2054;16297;2243;2258;0;329
FR;6;2022-11-19;5;13;0;2;11;3;2;0;1;17935;13176;1628;2056;16308;2246;2260;0;330
FR;6;2022-11-20;2;1;2;0;1;2;0;0;0;17937;13177;1630;2056;16309;2248;2260;0;330
FR;6;2022-11-21;22;13;1;14;14;6;11;0;3;17959;13190;1631;2070;16323;2254;2271;0;333
FR;6;2022-11-22;14;9;0;4;11;1;3;0;1;17973;13199;1631;2074;16334;2255;2274;0;334
FR;6;2022-11-23;14;15;15;23;17;9;31;0;8;17987;13214;1646;2097;16351;2264;2305;0;342
FR;6;2022-11-24;14;17;1;13;19;5;12;0;7;18001;13231;1647;2110;16370;2269;2317;0;349
FR;6;2022-11-25;23;15;5;50;15;5;47;0;5;18024;13246;1652;2160;16385;2274;2364;0;354
FR;6;2022-11-26;9;5;2;4;3;2;5;0;1;18033;13251;1654;2164;16388;2276;2369;0;355
FR;6;2022-11-27;1;4;0;0;4;0;0;0;0;18034;13255;1654;2164;16392;2276;2369;0;355
FR;6;2022-11-28;9;11;6;22;11;3;24;0;11;18043;13266;1660;2186;16403;2279;2393;0;366
FR;6;2022-11-29;15;10;1;12;14;1;8;0;7;18058;13276;1661;2198;16417;2280;2401;0;373
FR;6;2022-11-30;18;20;8;23;19;12;22;0;8;18076;13296;1669;2221;16436;2292;2423;0;381
FR;6;2022-12-01;12;9;7;20;11;4;24;0;9;18088;13305;1676;2241;16447;2296;2447;0;390
FR;6;2022-12-02;17;9;12;36;12;8;42;0;1;18105;13314;1688;2277;16459;2304;2489;0;391
FR;6;2022-12-03;13;3;13;20;6;5;28;0;13;18118;13317;1701;2297;16465;2309;2517;0;404
FR;6;2022-12-04;3;1;0;2;1;0;2;0;0;18121;13318;1701;2299;16466;2309;2519;0;404
FR;6;2022-12-05;11;10;7;16;10;4;19;0;8;18132;13328;1708;2315;16476;2313;2538;0;412
FR;6;2022-12-06;10;19;3;30;12;11;28;0;3;18142;13347;1711;2345;16488;2324;2566;0;415
FR;6;2022-12-07;17;8;10;56;10;8;57;0;30;18159;13355;1721;2401;16498;2332;2623;0;445
FR;6;2022-12-08;9;13;8;19;11;7;21;0;13;18168;13368;1729;2420;16509;2339;2644;0;458
FR;6;2022-12-09;15;9;5;29;12;4;30;0;6;18183;13377;1734;2449;16521;2343;2674;0;464
FR;6;2022-12-10;12;9;6;9;7;4;14;0;7;18195;13386;1740;2458;16528;2347;2688;0;471
FR;6;2022-12-11;4;2;1;0;2;1;0;0;0;18199;13388;1741;2458;16530;2348;2688;0;471
FR;6;2022-12-12;17;10;8;36;14;9;33;0;17;18216;13398;1749;2494;16544;2357;2721;0;488
FR;6;2022-12-13;17;21;12;66;16;18;65;0;14;18233;13419;1761;2560;16560;2375;2786;0;502
FR;6;2022-12-14;14;13;8;53;11;12;53;0;14;18247;13432;1769;2613;16571;2387;2839;0;516
FR;6;2022-12-15;12;15;14;38;13;9;44;0;9;18259;13447;1783;2651;16584;2396;2883;0;525
FR;6;2022-12-16;18;14;15;39;15;14;39;0;13;18277;13461;1798;2690;16599;2410;2922;0;538
FR;6;2022-12-17;11;10;15;28;9;15;29;0;8;18288;13471;1813;2718;16608;2425;2951;0;546
FR;6;2022-12-18;7;4;0;2;5;0;2;0;0;18295;13475;1813;2720;16613;2425;2953;0;546
FR;6;2022-12-19;12;8;9;29;8;12;29;0;15;18307;13483;1822;2749;16621;2437;2982;0;561
FR;6;2022-12-20;17;23;11;23;17;19;22;0;21;18324;13506;1833;2772;16638;2456;3004;0;582
FR;6;2022-12-21;23;16;9;19;13;13;17;0;5;18347;13522;1842;2791;16651;2469;3021;0;587
FR;6;2022-12-22;13;14;9;21;15;13;18;0;11;18360;13536;1851;2812;16666;2482;3039;0;598
FR;6;2022-12-23;10;19;12;7;14;18;7;0;3;18370;13555;1863;2819;16680;2500;3046;0;601
FR;6;2022-12-24;4;5;3;1;5;2;2;0;1;18374;13560;1866;2820;16685;2502;3048;0;602
FR;6;2022-12-25;0;0;0;0;0;0;0;0;0;18374;13560;1866;2820;16685;2502;3048;0;602
FR;6;2022-12-26;8;12;12;11;10;18;11;0;3;18382;13572;1878;2831;16695;2520;3059;0;605
FR;6;2022-12-27;16;13;15;8;11;19;8;0;0;18398;13585;1893;2839;16706;2539;3067;0;605
FR;6;2022-12-28;15;19;6;8;19;9;9;0;4;18413;13604;1899;2847;16725;2548;3076;0;609
FR;6;2022-12-29;15;12;7;8;10;9;9;0;7;18428;13616;1906;2855;16735;2557;3085;0;616
FR;6;2022-12-30;20;19;13;8;20;13;11;0;4;18448;13635;1919;2863;16755;2570;3096;0;620
FR;6;2022-12-31;5;2;6;1;4;7;1;0;1;18453;13637;1925;2864;16759;2577;3097;0;621
FR;6;2023-01-01;2;1;0;3;0;3;0;0;1;18455;13638;1925;2867;16759;2580;3097;0;622
FR;6;2023-01-02;9;14;2;3;10;7;3;0;0;18464;13652;1927;2870;16769;2587;3100;0;622
FR;6;2023-01-03;8;17;9;21;17;9;21;0;7;18472;13669;1936;2891;16786;2596;3121;0;629
FR;6;2023-01-04;9;10;4;10;9;8;6;0;14;18481;13679;1940;2901;16795;2604;3127;0;643
FR;6;2023-01-05;11;11;6;23;10;3;26;0;8;18492;13690;1946;2924;16805;2607;3153;0;651
FR;6;2023-01-06;16;24;15;30;21;17;29;0;15;18508;13714;1961;2954;16826;2624;3182;0;666
FR;6;2023-01-07;9;19;4;1;10;13;3;0;1;18517;13733;1965;2955;16836;2637;3185;0;667
FR;6;2023-01-08;2;7;4;11;6;4;11;0;3;18519;13740;1969;2966;16842;2641;3196;0;670
FR;6;2023-01-09;16;10;5;35;9;8;34;0;17;18535;13750;1974;3001;16851;2649;3230;0;687
FR;6;2023-01-10;13;15;13;23;13;10;26;0;9;18548;13765;1987;3024;16864;2659;3256;0;696
FR;6;2023-01-11;15;14;5;16;18;6;14;0;12;18563;13779;1992;3040;16882;2665;3270;0;708
FR;6;2023-01-12;7;13;2;5;10;3;5;0;12;18570;13792;1994;3045;16892;2668;3275;0;720
FR;6;2023-01-13;20;14;18;43;15;20;43;0;31;18590;13806;2012;3088;16907;2688;3318;0;751
FR;6;2023-01-14;20;8;6;2;9;9;2;0;0;18610;13814;2018;3090;16916;2697;3320;0;751
FR;6;2023-01-15;0;0;1;3;0;1;3;0;0;18610;13814;2019;3093;16916;2698;3323;0;751
FR;6;2023-01-16;22;12;2;1;10;6;3;0;2;18632;13826;2021;3094;16926;2704;3326;0;753
FR;6;2023-01-17;8;17;12;8;17;11;14;0;5;18640;13843;2033;3102;16943;2715;3340;0;758
FR;6;2023-01-18;22;15;9;7;17;10;8;0;1;18662;13858;2042;3109;16960;2725;3348;0;759
FR;6;2023-01-19;9;9;14;9;11;12;13;0;7;18671;13867;2056;3118;16971;2737;3361;0;766
FR;6;2023-01-20;17;13;9;32;15;7;34;0;27;18688;13880;2065;3150;16986;2744;3395;0;793
FR;6;2023-01-21;12;7;5;2;6;8;3;0;1;18700;13887;2070;3152;16992;2752;3398;0;794
FR;6;2023-01-22;0;0;1;1;0;1;1;0;0;18700;13887;2071;3153;16992;2753;3399;0;794
FR;6;2023-01-23;9;9;5;11;8;5;11;0;3;18709;13896;2076;3164;17000;2758;3410;0;797
FR;6;2023-01-24;14;15;15;13;15;14;18;0;6;18723;13911;2091;3177;17015;2772;3428;0;803
FR;6;2023-01-25;15;7;5;3;6;6;4;0;4;18738;13918;2096;3180;17021;2778;3432;0;807
FR;6;2023-01-26;13;15;3;11;12;8;13;0;9;18751;13933;2099;3191;17033;2786;3445;0;816
FR;6;2023-01-27;21;17;7;34;22;7;29;0;29;18772;13950;2106;3225;17055;2793;3474;0;845
FR;6;2023-01-28;15;15;7;4;17;6;5;0;1;18787;13965;2113;3229;17072;2799;3479;0;846
FR;6;2023-01-29;1;4;0;0;3;1;0;0;0;18788;13969;2113;3229;17075;2800;3479;0;846
FR;6;2023-01-30;2;15;8;4;15;8;3;0;8;18790;13984;2121;3233;17090;2808;3482;0;854
FR;6;2023-01-31;9;8;5;8;8;5;8;0;5;18799;13992;2126;3241;17098;2813;3490;0;859
FR;6;2023-02-01;20;18;4;4;17;4;8;0;4;18819;14010;2130;3245;17115;2817;3498;0;863
FR;6;2023-02-02;8;10;9;1;10;10;1;0;1;18827;14020;2139;3246;17125;2827;3499;0;864
FR;6;2023-02-03;16;15;11;18;15;11;19;0;13;18843;14035;2150;3264;17140;2838;3518;0;877
FR;6;2023-02-04;6;9;9;7;11;9;8;0;2;18849;14044;2159;3271;17151;2847;3526;0;879
FR;6;2023-02-05;0;0;0;4;0;0;4;0;0;18849;14044;2159;3275;17151;2847;3530;0;879
FR;6;2023-02-06;10;16;1;4;15;5;4;0;0;18859;14060;2160;3279;17166;2852;3534;0;879
FR;6;2023-02-07;8;9;4;8;9;7;7;0;3;18867;14069;2164;3287;17175;2859;3541;0;882
FR;6;2023-02-08;7;3;3;2;2;6;1;0;1;18874;14072;2167;3289;17177;2865;3542;0;883
FR;6;2023-02-09;6;11;1;6;8;8;2;0;2;18880;14083;2168;3295;17185;2873;3544;0;885
FR;6;2023-02-10;13;21;6;12;15;15;11;0;2;18893;14104;2174;3307;17200;2888;3555;0;887
FR;6;2023-02-11;12;8;7;4;9;3;9;0;5;18905;14112;2181;3311;17209;2891;3564;0;892
FR;6;2023-02-12;0;1;0;0;1;0;0;0;0;18905;14113;2181;3311;17210;2891;3564;0;892
FR;6;2023-02-13;5;6;0;0;6;1;0;0;0;18910;14119;2181;3311;17216;2892;3564;0;892
FR;6;2023-02-14;12;13;3;15;15;4;14;0;0;18922;14132;2184;3326;17231;2896;3578;0;892
FR;6;2023-02-15;8;11;3;2;11;2;2;0;4;18930;14143;2187;3328;17242;2898;3580;0;896
FR;6;2023-02-16;17;8;1;3;18;1;3;0;4;18947;14151;2188;3331;17260;2899;3583;0;900
FR;6;2023-02-17;9;15;3;9;12;8;9;0;5;18956;14166;2191;3340;17272;2907;3592;0;905
FR;6;2023-02-18;10;6;1;1;7;1;1;0;0;18966;14172;2192;3341;17279;2908;3593;0;905
FR;6;2023-02-19;0;0;0;0;0;0;0;0;0;18966;14172;2192;3341;17279;2908;3593;0;905
FR;6;2023-02-20;10;8;3;2;9;5;1;0;0;18976;14180;2195;3343;17288;2913;3594;0;905
FR;6;2023-02-21;9;8;8;5;6;7;8;0;1;18985;14188;2203;3348;17294;2920;3602;0;906
FR;6;2023-02-22;4;13;1;3;13;3;3;0;5;18989;14201;2204;3351;17307;2923;3605;0;911
FR;6;2023-02-23;7;11;6;2;10;6;4;0;1;18996;14212;2210;3353;17317;2929;3609;0;912
FR;6;2023-02-24;9;13;5;21;15;4;19;0;15;19005;14225;2215;3374;17332;2933;3628;0;927
FR;6;2023-02-25;4;5;1;1;6;1;1;0;0;19009;14230;2216;3375;17338;2934;3629;0;927
FR;6;2023-02-26;0;1;0;0;0;1;0;0;0;19009;14231;2216;3375;17338;2935;3629;0;927
FR;6;2023-02-27;10;8;3;1;3;9;0;0;2;19019;14239;2219;3376;17341;2944;3629;0;929
FR;6;2023-02-28;3;8;4;4;9;3;6;0;0;19022;14247;2223;3380;17350;2947;3635;0;929
FR;6;2023-03-01;6;10;3;2;10;4;2;0;0;19028;14257;2226;3382;17360;2951;3637;0;929
FR;6;2023-03-02;8;7;1;3;7;3;2;0;5;19036;14264;2227;3385;17367;2954;3639;0;934
FR;6;2023-03-03;14;12;5;7;11;9;6;0;7;19050;14276;2232;3392;17378;2963;3645;0;941
FR;6;2023-03-04;8;14;1;0;13;3;0;0;0;19058;14290;2233;3392;17391;2966;3645;0;941
FR;6;2023-03-05;4;0;0;0;0;0;0;0;0;19062;14290;2233;3392;17391;2966;3645;0;941
FR;6;2023-03-06;8;12;0;1;11;2;0;0;1;19070;14302;2233;3393;17402;2968;3645;0;942
FR;6;2023-03-07;4;6;0;1;4;3;0;0;5;19074;14308;2233;3394;17406;2971;3645;0;947
FR;6;2023-03-08;3;7;2;0;7;2;0;0;0;19077;14315;2235;3394;17413;2973;3645;0;947
FR;6;2023-03-09;7;6;0;1;6;2;1;0;0;19084;14321;2235;3395;17419;2975;3646;0;947
FR;6;2023-03-10;9;9;2;9;9;2;9;0;9;19093;14330;2237;3404;17428;2977;3655;0;956
FR;6;2023-03-11;13;12;2;0;12;2;2;0;0;19106;14342;2239;3404;17440;2979;3657;0;956
FR;6;2023-03-12;2;0;0;0;1;0;0;0;0;19108;14342;2239;3404;17441;2979;3657;0;956
FR;6;2023-03-13;7;12;4;1;13;2;1;0;2;19115;14354;2243;3405;17454;2981;3658;0;958
FR;6;2023-03-14;5;12;2;0;8;6;0;0;0;19120;14366;2245;3405;17462;2987;3658;0;958
FR;6;2023-03-15;6;4;2;3;5;3;3;0;1;19126;14370;2247;3408;17467;2990;3661;0;959
FR;6;2023-03-16;9;5;2;0;5;3;0;0;0;19135;14375;2249;3408;17472;2993;3661;0;959
FR;6;2023-03-17;10;12;5;5;8;8;5;0;3;19145;14387;2254;3413;17480;3001;3666;0;962
FR;6;2023-03-18;6;2;2;0;3;2;0;0;0;19151;14389;2256;3413;17483;3003;3666;0;962
FR;6;2023-03-19;0;0;1;0;0;0;0;0;0;19151;14389;2257;3413;17483;3003;3666;0;962
FR;6;2023-03-20;2;6;3;7;5;4;5;0;4;19153;14395;2260;3420;17488;3007;3671;0;966
FR;6;2023-03-21;2;1;5;2;1;3;4;0;0;19155;14396;2265;3422;17489;3010;3675;0;966
FR;6;2023-03-22;1;4;3;0;4;3;0;0;3;19156;14400;2268;3422;17493;3013;3675;0;969
FR;6;2023-03-23;3;4;3;2;4;3;2;0;0;19159;14404;2271;3424;17497;3016;3677;0;969
FR;6;2023-03-24;3;9;6;0;9;7;0;0;0;19162;14413;2277;3424;17506;3023;3677;0;969
FR;6;2023-03-25;10;7;0;0;9;0;0;0;0;19172;14420;2277;3424;17515;3023;3677;0;969
FR;6;2023-03-26;1;0;0;0;0;0;0;0;0;19173;14420;2277;3424;17515;3023;3677;0;969
FR;6;2023-03-27;6;9;2;2;8;4;1;0;0;19179;14429;2279;3426;17523;3027;3678;0;969
FR;6;2023-03-28;8;4;2;2;6;2;2;0;2;19187;14433;2281;3428;17529;3029;3680;0;971
FR;6;2023-03-29;4;1;2;0;1;2;0;0;0;19191;14434;2283;3428;17530;3031;3680;0;971
FR;6;2023-03-30;4;7;1;0;5;3;0;0;0;19195;14441;2284;3428;17535;3034;3680;0;971
FR;6;2023-03-31;1;3;3;3;3;3;1;0;7;19196;14444;2287;3431;17538;3037;3681;0;978
FR;6;2023-04-01;5;11;0;0;11;1;0;0;3;19201;14455;2287;3431;17549;3038;3681;0;981
FR;6;2023-04-02;0;0;0;0;0;0;0;0;0;19201;14455;2287;3431;17549;3038;3681;0;981
FR;6;2023-04-03;5;10;0;1;10;2;1;0;2;19206;14465;2287;3432;17559;3040;3682;0;983
FR;6;2023-04-04;5;10;2;4;8;3;5;0;7;19211;14475;2289;3436;17567;3043;3687;0;990
FR;6;2023-04-05;0;7;3;0;7;3;0;0;3;19211;14482;2292;3436;17574;3046;3687;0;993
FR;6;2023-04-06;3;6;4;1;3;7;1;0;2;19214;14488;2296;3437;17577;3053;3688;0;995
FR;6;2023-04-07;11;8;2;0;9;4;0;0;0;19225;14496;2298;3437;17586;3057;3688;0;995
FR;6;2023-04-08;2;1;3;0;1;3;0;0;0;19227;14497;2301;3437;17587;3060;3688;0;995
FR;6;2023-04-09;0;0;0;0;0;0;0;0;0;19227;14497;2301;3437;17587;3060;3688;0;995
FR;6;2023-04-10;0;0;0;0;0;0;0;0;0;19227;14497;2301;3437;17587;3060;3688;0;995
FR;6;2023-04-11;3;8;1;0;6;3;0;0;0;19230;14505;2302;3437;17593;3063;3688;0;995
FR;6;2023-04-12;3;4;2;0;5;2;0;0;4;19233;14509;2304;3437;17598;3065;3688;0;999
FR;6;2023-04-13;1;4;0;0;3;1;0;0;2;19234;14513;2304;3437;17601;3066;3688;0;1001
FR;6;2023-04-14;4;5;0;0;5;0;0;0;1;19238;14518;2304;3437;17606;3066;3688;0;1002
FR;6;2023-04-15;7;2;1;1;4;1;1;0;0;19245;14520;2305;3438;17610;3067;3689;0;1002
FR;6;2023-04-16;0;2;0;0;1;1;0;0;0;19245;14522;2305;3438;17611;3068;3689;0;1002
FR;6;2023-04-17;4;8;2;0;8;2;0;0;0;19249;14530;2307;3438;17619;3070;3689;0;1002
FR;6;2023-04-18;3;2;1;0;2;1;0;0;1;19252;14532;2308;3438;17621;3071;3689;0;1003
FR;6;2023-04-19;1;3;0;0;2;1;0;0;0;19253;14535;2308;3438;17623;3072;3689;0;1003
FR;6;2023-04-20;5;4;0;0;3;2;0;0;0;19258;14539;2308;3438;17626;3074;3689;0;1003
FR;6;2023-04-21;7;3;2;3;1;5;3;0;1;19265;14542;2310;3441;17627;3079;3692;0;1004
FR;6;2023-04-22;3;3;3;0;1;5;0;0;0;19268;14545;2313;3441;17628;3084;3692;0;1004
FR;6;2023-04-23;0;2;0;0;1;1;0;0;0;19268;14547;2313;3441;17629;3085;3692;0;1004
FR;6;2023-04-24;2;8;0;1;5;3;1;0;0;19270;14555;2313;3442;17634;3088;3693;0;1004
FR;6;2023-04-25;5;2;0;1;2;0;1;0;1;19275;14557;2313;3443;17636;3088;3694;0;1005
FR;6;2023-04-26;7;5;1;0;4;2;0;0;2;19282;14562;2314;3443;17640;3090;3694;0;1007
FR;6;2023-04-27;8;9;2;0;9;3;1;0;3;19290;14571;2316;3443;17649;3093;3695;0;1010
FR;6;2023-04-28;5;4;0;1;4;0;1;0;2;19295;14575;2316;3444;17653;3093;3696;0;1012
FR;6;2023-04-29;7;3;2;0;4;2;1;0;0;19302;14578;2318;3444;17657;3095;3697;0;1012
FR;6;2023-04-30;0;0;0;0;0;0;0;0;0;19302;14578;2318;3444;17657;3095;3697;0;1012
FR;6;2023-05-01;0;0;0;0;0;0;0;0;0;19302;14578;2318;3444;17657;3095;3697;0;1012
FR;6;2023-05-02;3;4;3;0;3;3;1;0;0;19305;14582;2321;3444;17660;3098;3698;0;1012
FR;6;2023-05-03;1;3;0;0;2;1;0;0;2;19306;14585;2321;3444;17662;3099;3698;0;1014
FR;6;2023-05-04;3;4;7;0;5;6;3;0;1;19309;14589;2328;3444;17667;3105;3701;0;1015
FR;6;2023-05-05;3;2;0;0;3;0;0;0;0;19312;14591;2328;3444;17670;3105;3701;0;1015
FR;6;2023-05-06;0;2;1;1;1;2;1;0;0;19312;14593;2329;3445;17671;3107;3702;0;1015
FR;6;2023-05-07;1;0;0;0;0;0;0;0;0;19313;14593;2329;3445;17671;3107;3702;0;1015
FR;6;2023-05-08;0;0;7;0;0;3;4;0;0;19313;14593;2336;3445;17671;3110;3706;0;1015
FR;6;2023-05-09;5;4;2;1;6;2;1;0;0;19318;14597;2338;3446;17677;3112;3707;0;1015
FR;6;2023-05-10;5;2;2;0;3;1;1;0;0;19323;14599;2340;3446;17680;3113;3708;0;1015
FR;6;2023-05-11;2;3;3;1;3;4;2;0;2;19325;14602;2343;3447;17683;3117;3710;0;1017
FR;6;2023-05-12;1;2;0;0;3;0;0;0;1;19326;14604;2343;3447;17686;3117;3710;0;1018
FR;6;2023-05-13;0;3;2;0;1;2;2;0;2;19326;14607;2345;3447;17687;3119;3712;0;1020
FR;6;2023-05-14;0;0;0;0;0;0;0;0;0;19326;14607;2345;3447;17687;3119;3712;0;1020
FR;6;2023-05-15;2;3;2;0;2;3;0;0;0;19328;14610;2347;3447;17689;3122;3712;0;1020
FR;6;2023-05-16;2;5;1;0;5;1;0;0;1;19330;14615;2348;3447;17694;3123;3712;0;1021
FR;6;2023-05-17;7;5;2;0;5;2;1;0;2;19337;14620;2350;3447;17699;3125;3713;0;1023
FR;6;2023-05-18;0;0;0;0;0;0;0;0;0;19337;14620;2350;3447;17699;3125;3713;0;1023
FR;6;2023-05-19;2;2;1;0;2;1;0;0;0;19339;14622;2351;3447;17701;3126;3713;0;1023
FR;6;2023-05-20;1;4;1;0;3;2;0;0;0;19340;14626;2352;3447;17704;3128;3713;0;1023
FR;6;2023-05-21;0;0;0;0;0;0;0;0;0;19340;14626;2352;3447;17704;3128;3713;0;1023
FR;6;2023-05-22;2;1;1;0;1;0;1;0;0;19342;14627;2353;3447;17705;3128;3714;0;1023
FR;6;2023-05-23;1;2;2;2;2;1;3;0;0;19343;14629;2355;3449;17707;3129;3717;0;1023
FR;6;2023-05-24;1;2;3;2;2;2;3;0;1;19344;14631;2358;3451;17709;3131;3720;0;1024
FR;6;2023-05-25;1;3;0;1;1;2;0;0;4;19345;14634;2358;3452;17710;3133;3720;0;1028
FR;6;2023-05-26;3;2;0;4;3;0;4;0;3;19348;14636;2358;3456;17713;3133;3724;0;1031
FR;6;2023-05-27;2;3;0;0;3;0;0;0;1;19350;14639;2358;3456;17716;3133;3724;0;1032
FR;6;2023-05-28;0;1;0;0;1;0;0;0;0;19350;14640;2358;3456;17717;3133;3724;0;1032
FR;6;2023-05-29;0;0;0;0;0;0;0;0;0;19350;14640;2358;3456;17717;3133;3724;0;1032
FR;6;2023-05-30;4;5;3;1;2;5;2;0;0;19354;14645;2361;3457;17719;3138;3726;0;1032
FR;6;2023-05-31;2;4;0;0;3;1;0;0;2;19356;14649;2361;3457;17722;3139;3726;0;1034
FR;6;2023-06-01;0;1;4;0;1;4;0;0;2;19356;14650;2365;3457;17723;3143;3726;0;1036
FR;6;2023-06-02;0;3;1;0;3;1;0;0;0;19356;14653;2366;3457;17726;3144;3726;0;1036
FR;6;2023-06-03;0;1;0;0;1;0;0;0;0;19356;14654;2366;3457;17727;3144;3726;0;1036
FR;6;2023-06-04;0;0;0;0;0;0;0;0;0;19356;14654;2366;3457;17727;3144;3726;0;1036
FR;6;2023-06-05;4;1;2;0;2;2;0;0;2;19360;14655;2368;3457;17729;3146;3726;0;1038
FR;6;2023-06-06;2;2;2;0;2;2;0;0;1;19362;14657;2370;3457;17731;3148;3726;0;1039
FR;6;2023-06-07;0;2;0;0;2;0;0;0;0;19362;14659;2370;3457;17733;3148;3726;0;1039
FR;6;2023-06-08;0;2;0;0;2;0;0;0;0;19362;14661;2370;3457;17735;3148;3726;0;1039
FR;6;2023-06-09;1;2;0;3;2;0;3;0;2;19363;14663;2370;3460;17737;3148;3729;0;1041
FR;6;2023-06-10;1;1;2;1;2;0;4;0;0;19364;14664;2372;3461;17739;3148;3733;0;1041
FR;6;2023-06-11;0;0;0;0;0;0;0;0;0;19364;14664;2372;3461;17739;3148;3733;0;1041
FR;6;2023-06-12;0;1;1;0;1;0;1;0;0;19364;14665;2373;3461;17740;3148;3734;0;1041
FR;6;2023-06-13;1;2;1;2;2;2;1;0;1;19365;14667;2374;3463;17742;3150;3735;0;1042
FR;6;2023-06-14;1;2;1;2;2;1;2;0;2;19366;14669;2375;3465;17744;3151;3737;0;1044
FR;6;2023-06-15;0;0;0;0;0;0;0;0;1;19366;14669;2375;3465;17744;3151;3737;0;1045
FR;6;2023-06-16;0;2;1;0;2;1;0;0;0;19366;14671;2376;3465;17746;3152;3737;0;1045
FR;6;2023-06-17;0;1;0;0;1;0;0;0;0;19366;14672;2376;3465;17747;3152;3737;0;1045
FR;6;2023-06-18;0;0;0;0;0;0;0;0;0;19366;14672;2376;3465;17747;3152;3737;0;1045
FR;6;2023-06-19;0;1;0;0;1;0;0;0;0;19366;14673;2376;3465;17748;3152;3737;0;1045
FR;8;2020-12-27;0;0;0;0;0;0;0;0;0;0;0;0;0;0;0;0;0;0
FR;8;2020-12-28;0;0;0;0;0;0;0;0;0;0;0;0;0;0;0;0;0;0
FR;8;2020-12-29;0;0;0;0;0;0;0;0;0;0;0;0;0;0;0;0;0;0
FR;8;2020-12-30;0;0;0;0;0;0;0;0;0;0;0;0;0;0;0;0;0;0
FR;8;2020-12-31;0;0;0;0;0;0;0;0;0;0;0;0;0;0;0;0;0;0
FR;8;2021-01-01;0;0;0;0;0;0;0;0;0;0;0;0;0;0;0;0;0;0
FR;8;2021-01-02;0;0;0;0;0;0;0;0;0;0;0;0;0;0;0;0;0;0
FR;8;2021-01-03;0;0;0;0;0;0;0;0;0;0;0;0;0;0;0;0;0;0
FR;8;2021-01-04;0;0;0;0;0;0;0;0;0;0;0;0;0;0;0;0;0;0
FR;8;2021-01-05;0;0;0;0;0;0;0;0;0;0;0;0;0;0;0;0;0;0
FR;8;2021-01-06;0;0;0;0;0;0;0;0;0;0;0;0;0;0;0;0;0;0
FR;8;2021-01-07;0;0;0;0;0;0;0;0;0;0;0;0;0;0;0;0;0;0
FR;8;2021-01-08;0;0;0;0;0;0;0;0;0;0;0;0;0;0;0;0;0;0
FR;8;2021-01-09;0;0;0;0;0;0;0;0;0;0;0;0;0;0;0;0;0;0
FR;8;2021-01-10;0;0;0;0;0;0;0;0;0;0;0;0;0;0;0;0;0;0
FR;8;2021-01-11;0;0;0;0;0;0;0;0;0;0;0;0;0;0;0;0;0;0
FR;8;2021-01-12;0;0;0;0;0;0;0;0;0;0;0;0;0;0;0;0;0;0
FR;8;2021-01-13;0;0;0;0;0;0;0;0;0;0;0;0;0;0;0;0;0;0
FR;8;2021-01-14;0;0;0;0;0;0;0;0;0;0;0;0;0;0;0;0;0;0
FR;8;2021-01-15;0;0;0;0;0;0;0;0;0;0;0;0;0;0;0;0;0;0
FR;8;2021-01-16;0;0;0;0;0;0;0;0;0;0;0;0;0;0;0;0;0;0
FR;8;2021-01-17;0;0;0;0;0;0;0;0;0;0;0;0;0;0;0;0;0;0
FR;8;2021-01-18;0;0;0;0;0;0;0;0;0;0;0;0;0;0;0;0;0;0
FR;8;2021-01-19;0;0;0;0;0;0;0;0;0;0;0;0;0;0;0;0;0;0
FR;8;2021-01-20;0;0;0;0;0;0;0;0;0;0;0;0;0;0;0;0;0;0
FR;8;2021-01-21;0;0;0;0;0;0;0;0;0;0;0;0;0;0;0;0;0;0
FR;8;2021-01-22;0;0;0;0;0;0;0;0;0;0;0;0;0;0;0;0;0;0
FR;8;2021-01-23;0;0;0;0;0;0;0;0;0;0;0;0;0;0;0;0;0;0
FR;8;2021-01-24;0;0;0;0;0;0;0;0;0;0;0;0;0;0;0;0;0;0
FR;8;2021-01-25;0;0;0;0;0;0;0;0;0;0;0;0;0;0;0;0;0;0
FR;8;2021-01-26;0;0;0;0;0;0;0;0;0;0;0;0;0;0;0;0;0;0
FR;8;2021-01-27;0;0;0;0;0;0;0;0;0;0;0;0;0;0;0;0;0;0
FR;8;2021-01-28;0;0;0;0;0;0;0;0;0;0;0;0;0;0;0;0;0;0
FR;8;2021-01-29;0;0;0;0;0;0;0;0;0;0;0;0;0;0;0;0;0;0
FR;8;2021-01-30;0;0;0;0;0;0;0;0;0;0;0;0;0;0;0;0;0;0
FR;8;2021-01-31;0;0;0;0;0;0;0;0;0;0;0;0;0;0;0;0;0;0
FR;8;2021-02-01;0;0;0;0;0;0;0;0;0;0;0;0;0;0;0;0;0;0
FR;8;2021-02-02;0;0;0;0;0;0;0;0;0;0;0;0;0;0;0;0;0;0
FR;8;2021-02-03;0;0;0;0;0;0;0;0;0;0;0;0;0;0;0;0;0;0
FR;8;2021-02-04;0;0;0;0;0;0;0;0;0;0;0;0;0;0;0;0;0;0
FR;8;2021-02-05;0;0;0;0;0;0;0;0;0;0;0;0;0;0;0;0;0;0
FR;8;2021-02-06;0;0;0;0;0;0;0;0;0;0;0;0;0;0;0;0;0;0
FR;8;2021-02-07;0;0;0;0;0;0;0;0;0;0;0;0;0;0;0;0;0;0
FR;8;2021-02-08;0;0;0;0;0;0;0;0;0;0;0;0;0;0;0;0;0;0
FR;8;2021-02-09;0;0;0;0;0;0;0;0;0;0;0;0;0;0;0;0;0;0
FR;8;2021-02-10;0;0;0;0;0;0;0;0;0;0;0;0;0;0;0;0;0;0
FR;8;2021-02-11;0;0;0;0;0;0;0;0;0;0;0;0;0;0;0;0;0;0
FR;8;2021-02-12;0;0;0;0;0;0;0;0;0;0;0;0;0;0;0;0;0;0
FR;8;2021-02-13;0;0;0;0;0;0;0;0;0;0;0;0;0;0;0;0;0;0
FR;8;2021-02-14;0;0;0;0;0;0;0;0;0;0;0;0;0;0;0;0;0;0
FR;8;2021-02-15;0;0;0;0;0;0;0;0;0;0;0;0;0;0;0;0;0;0
FR;8;2021-02-16;0;0;0;0;0;0;0;0;0;0;0;0;0;0;0;0;0;0
FR;8;2021-02-17;0;0;0;0;0;0;0;0;0;0;0;0;0;0;0;0;0;0
FR;8;2021-02-18;0;0;0;0;0;0;0;0;0;0;0;0;0;0;0;0;0;0
FR;8;2021-02-19;0;0;0;0;0;0;0;0;0;0;0;0;0;0;0;0;0;0
FR;8;2021-02-20;0;0;0;0;0;0;0;0;0;0;0;0;0;0;0;0;0;0
FR;8;2021-02-21;0;0;0;0;0;0;0;0;0;0;0;0;0;0;0;0;0;0
FR;8;2021-02-22;0;0;0;0;0;0;0;0;0;0;0;0;0;0;0;0;0;0
FR;8;2021-02-23;0;0;0;0;0;0;0;0;0;0;0;0;0;0;0;0;0;0
FR;8;2021-02-24;0;0;0;0;0;0;0;0;0;0;0;0;0;0;0;0;0;0
FR;8;2021-02-25;0;0;0;0;0;0;0;0;0;0;0;0;0;0;0;0;0;0
FR;8;2021-02-26;0;0;0;0;0;0;0;0;0;0;0;0;0;0;0;0;0;0
FR;8;2021-02-27;0;0;0;0;0;0;0;0;0;0;0;0;0;0;0;0;0;0
FR;8;2021-02-28;0;0;0;0;0;0;0;0;0;0;0;0;0;0;0;0;0;0
FR;8;2021-03-01;0;0;0;0;0;0;0;0;0;0;0;0;0;0;0;0;0;0
FR;8;2021-03-02;0;0;0;0;0;0;0;0;0;0;0;0;0;0;0;0;0;0
FR;8;2021-03-03;0;0;0;0;0;0;0;0;0;0;0;0;0;0;0;0;0;0
FR;8;2021-03-04;0;0;0;0;0;0;0;0;0;0;0;0;0;0;0;0;0;0
FR;8;2021-03-05;0;0;0;0;0;0;0;0;0;0;0;0;0;0;0;0;0;0
FR;8;2021-03-06;0;0;0;0;0;0;0;0;0;0;0;0;0;0;0;0;0;0
FR;8;2021-03-07;0;0;0;0;0;0;0;0;0;0;0;0;0;0;0;0;0;0
FR;8;2021-03-08;0;0;0;0;0;0;0;0;0;0;0;0;0;0;0;0;0;0
FR;8;2021-03-09;0;0;0;0;0;0;0;0;0;0;0;0;0;0;0;0;0;0
FR;8;2021-03-10;0;0;0;0;0;0;0;0;0;0;0;0;0;0;0;0;0;0
FR;8;2021-03-11;0;0;0;0;0;0;0;0;0;0;0;0;0;0;0;0;0;0
FR;8;2021-03-12;0;0;0;0;0;0;0;0;0;0;0;0;0;0;0;0;0;0
FR;8;2021-03-13;0;0;0;0;0;0;0;0;0;0;0;0;0;0;0;0;0;0
FR;8;2021-03-14;0;0;0;0;0;0;0;0;0;0;0;0;0;0;0;0;0;0
FR;8;2021-03-15;0;0;0;0;0;0;0;0;0;0;0;0;0;0;0;0;0;0
FR;8;2021-03-16;0;0;0;0;0;0;0;0;0;0;0;0;0;0;0;0;0;0
FR;8;2021-03-17;0;0;0;0;0;0;0;0;0;0;0;0;0;0;0;0;0;0
FR;8;2021-03-18;0;0;0;0;0;0;0;0;0;0;0;0;0;0;0;0;0;0
FR;8;2021-03-19;0;0;0;0;0;0;0;0;0;0;0;0;0;0;0;0;0;0
FR;8;2021-03-20;0;0;0;0;0;0;0;0;0;0;0;0;0;0;0;0;0;0
FR;8;2021-03-21;0;0;0;0;0;0;0;0;0;0;0;0;0;0;0;0;0;0
FR;8;2021-03-22;0;0;0;0;0;0;0;0;0;0;0;0;0;0;0;0;0;0
FR;8;2021-03-23;0;0;0;0;0;0;0;0;0;0;0;0;0;0;0;0;0;0
FR;8;2021-03-24;0;0;0;0;0;0;0;0;0;0;0;0;0;0;0;0;0;0
FR;8;2021-03-25;0;0;0;0;0;0;0;0;0;0;0;0;0;0;0;0;0;0
FR;8;2021-03-26;0;0;0;0;0;0;0;0;0;0;0;0;0;0;0;0;0;0
FR;8;2021-03-27;0;0;0;0;0;0;0;0;0;0;0;0;0;0;0;0;0;0
FR;8;2021-03-28;0;0;0;0;0;0;0;0;0;0;0;0;0;0;0;0;0;0
FR;8;2021-03-29;0;0;0;0;0;0;0;0;0;0;0;0;0;0;0;0;0;0
FR;8;2021-03-30;0;0;0;0;0;0;0;0;0;0;0;0;0;0;0;0;0;0
FR;8;2021-03-31;0;0;0;0;0;0;0;0;0;0;0;0;0;0;0;0;0;0
FR;8;2021-04-01;0;0;0;0;0;0;0;0;0;0;0;0;0;0;0;0;0;0
FR;8;2021-04-02;0;0;0;0;0;0;0;0;0;0;0;0;0;0;0;0;0;0
FR;8;2021-04-03;0;0;0;0;0;0;0;0;0;0;0;0;0;0;0;0;0;0
FR;8;2021-04-04;0;0;0;0;0;0;0;0;0;0;0;0;0;0;0;0;0;0
FR;8;2021-04-05;0;0;0;0;0;0;0;0;0;0;0;0;0;0;0;0;0;0
FR;8;2021-04-06;0;0;0;0;0;0;0;0;0;0;0;0;0;0;0;0;0;0
FR;8;2021-04-07;0;0;0;0;0;0;0;0;0;0;0;0;0;0;0;0;0;0
FR;8;2021-04-08;0;0;0;0;0;0;0;0;0;0;0;0;0;0;0;0;0;0
FR;8;2021-04-09;0;0;0;0;0;0;0;0;0;0;0;0;0;0;0;0;0;0
FR;8;2021-04-10;0;0;0;0;0;0;0;0;0;0;0;0;0;0;0;0;0;0
FR;8;2021-04-11;0;0;0;0;0;0;0;0;0;0;0;0;0;0;0;0;0;0
FR;8;2021-04-12;0;0;0;0;0;0;0;0;0;0;0;0;0;0;0;0;0;0
FR;8;2021-04-13;0;0;0;0;0;0;0;0;0;0;0;0;0;0;0;0;0;0
FR;8;2021-04-14;0;0;0;0;0;0;0;0;0;0;0;0;0;0;0;0;0;0
FR;8;2021-04-15;0;0;0;0;0;0;0;0;0;0;0;0;0;0;0;0;0;0
FR;8;2021-04-16;0;0;0;0;0;0;0;0;0;0;0;0;0;0;0;0;0;0
FR;8;2021-04-17;0;0;0;0;0;0;0;0;0;0;0;0;0;0;0;0;0;0
FR;8;2021-04-18;0;0;0;0;0;0;0;0;0;0;0;0;0;0;0;0;0;0
FR;8;2021-04-19;0;0;0;0;0;0;0;0;0;0;0;0;0;0;0;0;0;0
FR;8;2021-04-20;0;0;0;0;0;0;0;0;0;0;0;0;0;0;0;0;0;0
FR;8;2021-04-21;0;0;0;0;0;0;0;0;0;0;0;0;0;0;0;0;0;0
FR;8;2021-04-22;0;0;0;0;0;0;0;0;0;0;0;0;0;0;0;0;0;0
FR;8;2021-04-23;0;0;0;0;0;0;0;0;0;0;0;0;0;0;0;0;0;0
FR;8;2021-04-24;0;0;0;0;0;0;0;0;0;0;0;0;0;0;0;0;0;0
FR;8;2021-04-25;0;0;0;0;0;0;0;0;0;0;0;0;0;0;0;0;0;0
FR;8;2021-04-26;0;0;0;0;0;0;0;0;0;0;0;0;0;0;0;0;0;0
FR;8;2021-04-27;0;0;0;0;0;0;0;0;0;0;0;0;0;0;0;0;0;0
FR;8;2021-04-28;0;0;0;0;0;0;0;0;0;0;0;0;0;0;0;0;0;0
FR;8;2021-04-29;0;0;0;0;0;0;0;0;0;0;0;0;0;0;0;0;0;0
FR;8;2021-04-30;0;0;0;0;0;0;0;0;0;0;0;0;0;0;0;0;0;0
FR;8;2021-05-01;0;0;0;0;0;0;0;0;0;0;0;0;0;0;0;0;0;0
FR;8;2021-05-02;0;0;0;0;0;0;0;0;0;0;0;0;0;0;0;0;0;0
FR;8;2021-05-03;0;0;0;0;0;0;0;0;0;0;0;0;0;0;0;0;0;0
FR;8;2021-05-04;0;0;0;0;0;0;0;0;0;0;0;0;0;0;0;0;0;0
FR;8;2021-05-05;0;0;0;0;0;0;0;0;0;0;0;0;0;0;0;0;0;0
FR;8;2021-05-06;0;0;0;0;0;0;0;0;0;0;0;0;0;0;0;0;0;0
FR;8;2021-05-07;0;0;0;0;0;0;0;0;0;0;0;0;0;0;0;0;0;0
FR;8;2021-05-08;0;0;0;0;0;0;0;0;0;0;0;0;0;0;0;0;0;0
FR;8;2021-05-09;0;0;0;0;0;0;0;0;0;0;0;0;0;0;0;0;0;0
FR;8;2021-05-10;0;0;0;0;0;0;0;0;0;0;0;0;0;0;0;0;0;0
FR;8;2021-05-11;0;0;0;0;0;0;0;0;0;0;0;0;0;0;0;0;0;0
FR;8;2021-05-12;0;0;0;0;0;0;0;0;0;0;0;0;0;0;0;0;0;0
FR;8;2021-05-13;0;0;0;0;0;0;0;0;0;0;0;0;0;0;0;0;0;0
FR;8;2021-05-14;0;0;0;0;0;0;0;0;0;0;0;0;0;0;0;0;0;0
FR;8;2021-05-15;0;0;0;0;0;0;0;0;0;0;0;0;0;0;0;0;0;0
FR;8;2021-05-16;0;0;0;0;0;0;0;0;0;0;0;0;0;0;0;0;0;0
FR;8;2021-05-17;0;0;0;0;0;0;0;0;0;0;0;0;0;0;0;0;0;0
FR;8;2021-05-18;0;0;0;0;0;0;0;0;0;0;0;0;0;0;0;0;0;0
FR;8;2021-05-19;0;0;0;0;0;0;0;0;0;0;0;0;0;0;0;0;0;0
FR;8;2021-05-20;0;0;0;0;0;0;0;0;0;0;0;0;0;0;0;0;0;0
FR;8;2021-05-21;0;0;0;0;0;0;0;0;0;0;0;0;0;0;0;0;0;0
FR;8;2021-05-22;0;0;0;0;0;0;0;0;0;0;0;0;0;0;0;0;0;0
FR;8;2021-05-23;0;0;0;0;0;0;0;0;0;0;0;0;0;0;0;0;0;0
FR;8;2021-05-24;0;0;0;0;0;0;0;0;0;0;0;0;0;0;0;0;0;0
FR;8;2021-05-25;0;0;0;0;0;0;0;0;0;0;0;0;0;0;0;0;0;0
FR;8;2021-05-26;0;0;0;0;0;0;0;0;0;0;0;0;0;0;0;0;0;0
FR;8;2021-05-27;0;0;0;0;0;0;0;0;0;0;0;0;0;0;0;0;0;0
FR;8;2021-05-28;0;0;0;0;0;0;0;0;0;0;0;0;0;0;0;0;0;0
FR;8;2021-05-29;0;0;0;0;0;0;0;0;0;0;0;0;0;0;0;0;0;0
FR;8;2021-05-30;0;0;0;0;0;0;0;0;0;0;0;0;0;0;0;0;0;0
FR;8;2021-05-31;0;0;0;0;0;0;0;0;0;0;0;0;0;0;0;0;0;0
FR;8;2021-06-01;0;0;0;0;0;0;0;0;0;0;0;0;0;0;0;0;0;0
FR;8;2021-06-02;0;0;0;0;0;0;0;0;0;0;0;0;0;0;0;0;0;0
FR;8;2021-06-03;0;0;0;0;0;0;0;0;0;0;0;0;0;0;0;0;0;0
FR;8;2021-06-04;0;0;0;0;0;0;0;0;0;0;0;0;0;0;0;0;0;0
FR;8;2021-06-05;0;0;0;0;0;0;0;0;0;0;0;0;0;0;0;0;0;0
FR;8;2021-06-06;0;0;0;0;0;0;0;0;0;0;0;0;0;0;0;0;0;0
FR;8;2021-06-07;0;0;0;0;0;0;0;0;0;0;0;0;0;0;0;0;0;0
FR;8;2021-06-08;0;0;0;0;0;0;0;0;0;0;0;0;0;0;0;0;0;0
FR;8;2021-06-09;0;0;0;0;0;0;0;0;0;0;0;0;0;0;0;0;0;0
FR;8;2021-06-10;0;0;0;0;0;0;0;0;0;0;0;0;0;0;0;0;0;0
FR;8;2021-06-11;0;0;0;0;0;0;0;0;0;0;0;0;0;0;0;0;0;0
FR;8;2021-06-12;0;0;0;0;0;0;0;0;0;0;0;0;0;0;0;0;0;0
FR;8;2021-06-13;0;0;0;0;0;0;0;0;0;0;0;0;0;0;0;0;0;0
FR;8;2021-06-14;0;0;0;0;0;0;0;0;0;0;0;0;0;0;0;0;0;0
FR;8;2021-06-15;0;0;0;0;0;0;0;0;0;0;0;0;0;0;0;0;0;0
FR;8;2021-06-16;0;0;0;0;0;0;0;0;0;0;0;0;0;0;0;0;0;0
FR;8;2021-06-17;0;0;0;0;0;0;0;0;0;0;0;0;0;0;0;0;0;0
FR;8;2021-06-18;0;0;0;0;0;0;0;0;0;0;0;0;0;0;0;0;0;0
FR;8;2021-06-19;0;0;0;0;0;0;0;0;0;0;0;0;0;0;0;0;0;0
FR;8;2021-06-20;0;0;0;0;0;0;0;0;0;0;0;0;0;0;0;0;0;0
FR;8;2021-06-21;0;0;0;0;0;0;0;0;0;0;0;0;0;0;0;0;0;0
FR;8;2021-06-22;0;0;0;0;0;0;0;0;0;0;0;0;0;0;0;0;0;0
FR;8;2021-06-23;0;0;0;0;0;0;0;0;0;0;0;0;0;0;0;0;0;0
FR;8;2021-06-24;0;0;0;0;0;0;0;0;0;0;0;0;0;0;0;0;0;0
FR;8;2021-06-25;0;0;0;0;0;0;0;0;0;0;0;0;0;0;0;0;0;0
FR;8;2021-06-26;0;0;0;0;0;0;0;0;0;0;0;0;0;0;0;0;0;0
FR;8;2021-06-27;0;0;0;0;0;0;0;0;0;0;0;0;0;0;0;0;0;0
FR;8;2021-06-28;0;0;0;0;0;0;0;0;0;0;0;0;0;0;0;0;0;0
FR;8;2021-06-29;0;0;0;0;0;0;0;0;0;0;0;0;0;0;0;0;0;0
FR;8;2021-06-30;0;0;0;0;0;0;0;0;0;0;0;0;0;0;0;0;0;0
FR;8;2021-07-01;0;0;0;0;0;0;0;0;0;0;0;0;0;0;0;0;0;0
FR;8;2021-07-02;0;0;0;0;0;0;0;0;0;0;0;0;0;0;0;0;0;0
FR;8;2021-07-03;0;0;0;0;0;0;0;0;0;0;0;0;0;0;0;0;0;0
FR;8;2021-07-04;0;0;0;0;0;0;0;0;0;0;0;0;0;0;0;0;0;0
FR;8;2021-07-05;0;0;0;0;0;0;0;0;0;0;0;0;0;0;0;0;0;0
FR;8;2021-07-06;0;0;0;0;0;0;0;0;0;0;0;0;0;0;0;0;0;0
FR;8;2021-07-07;0;0;0;0;0;0;0;0;0;0;0;0;0;0;0;0;0;0
FR;8;2021-07-08;0;0;0;0;0;0;0;0;0;0;0;0;0;0;0;0;0;0
FR;8;2021-07-09;0;0;0;0;0;0;0;0;0;0;0;0;0;0;0;0;0;0
FR;8;2021-07-10;0;0;0;0;0;0;0;0;0;0;0;0;0;0;0;0;0;0
FR;8;2021-07-11;0;0;0;0;0;0;0;0;0;0;0;0;0;0;0;0;0;0
FR;8;2021-07-12;0;0;0;0;0;0;0;0;0;0;0;0;0;0;0;0;0;0
FR;8;2021-07-13;0;0;0;0;0;0;0;0;0;0;0;0;0;0;0;0;0;0
FR;8;2021-07-14;0;0;0;0;0;0;0;0;0;0;0;0;0;0;0;0;0;0
FR;8;2021-07-15;0;0;0;0;0;0;0;0;0;0;0;0;0;0;0;0;0;0
FR;8;2021-07-16;0;0;0;0;0;0;0;0;0;0;0;0;0;0;0;0;0;0
FR;8;2021-07-17;0;0;0;0;0;0;0;0;0;0;0;0;0;0;0;0;0;0
FR;8;2021-07-18;0;0;0;0;0;0;0;0;0;0;0;0;0;0;0;0;0;0
FR;8;2021-07-19;0;0;0;0;0;0;0;0;0;0;0;0;0;0;0;0;0;0
FR;8;2021-07-20;0;0;0;0;0;0;0;0;0;0;0;0;0;0;0;0;0;0
FR;8;2021-07-21;0;0;0;0;0;0;0;0;0;0;0;0;0;0;0;0;0;0
FR;8;2021-07-22;0;0;0;0;0;0;0;0;0;0;0;0;0;0;0;0;0;0
FR;8;2021-07-23;0;0;0;0;0;0;0;0;0;0;0;0;0;0;0;0;0;0
FR;8;2021-07-24;0;0;0;0;0;0;0;0;0;0;0;0;0;0;0;0;0;0
FR;8;2021-07-25;0;0;0;0;0;0;0;0;0;0;0;0;0;0;0;0;0;0
FR;8;2021-07-26;0;0;0;0;0;0;0;0;0;0;0;0;0;0;0;0;0;0
FR;8;2021-07-27;0;0;0;0;0;0;0;0;0;0;0;0;0;0;0;0;0;0
FR;8;2021-07-28;0;0;0;0;0;0;0;0;0;0;0;0;0;0;0;0;0;0
FR;8;2021-07-29;0;0;0;0;0;0;0;0;0;0;0;0;0;0;0;0;0;0
FR;8;2021-07-30;0;0;0;0;0;0;0;0;0;0;0;0;0;0;0;0;0;0
FR;8;2021-07-31;0;0;0;0;0;0;0;0;0;0;0;0;0;0;0;0;0;0
FR;8;2021-08-01;0;0;0;0;0;0;0;0;0;0;0;0;0;0;0;0;0;0
FR;8;2021-08-02;0;0;0;0;0;0;0;0;0;0;0;0;0;0;0;0;0;0
FR;8;2021-08-03;0;0;0;0;0;0;0;0;0;0;0;0;0;0;0;0;0;0
FR;8;2021-08-04;0;0;0;0;0;0;0;0;0;0;0;0;0;0;0;0;0;0
FR;8;2021-08-05;0;0;0;0;0;0;0;0;0;0;0;0;0;0;0;0;0;0
FR;8;2021-08-06;0;0;0;0;0;0;0;0;0;0;0;0;0;0;0;0;0;0
FR;8;2021-08-07;0;0;0;0;0;0;0;0;0;0;0;0;0;0;0;0;0;0
FR;8;2021-08-08;0;0;0;0;0;0;0;0;0;0;0;0;0;0;0;0;0;0
FR;8;2021-08-09;0;0;0;0;0;0;0;0;0;0;0;0;0;0;0;0;0;0
FR;8;2021-08-10;0;0;0;0;0;0;0;0;0;0;0;0;0;0;0;0;0;0
FR;8;2021-08-11;0;0;0;0;0;0;0;0;0;0;0;0;0;0;0;0;0;0
FR;8;2021-08-12;0;0;0;0;0;0;0;0;0;0;0;0;0;0;0;0;0;0
FR;8;2021-08-13;0;0;0;0;0;0;0;0;0;0;0;0;0;0;0;0;0;0
FR;8;2021-08-14;0;0;0;0;0;0;0;0;0;0;0;0;0;0;0;0;0;0
FR;8;2021-08-15;0;0;0;0;0;0;0;0;0;0;0;0;0;0;0;0;0;0
FR;8;2021-08-16;0;0;0;0;0;0;0;0;0;0;0;0;0;0;0;0;0;0
FR;8;2021-08-17;0;0;0;0;0;0;0;0;0;0;0;0;0;0;0;0;0;0
FR;8;2021-08-18;0;0;0;0;0;0;0;0;0;0;0;0;0;0;0;0;0;0
FR;8;2021-08-19;0;0;0;0;0;0;0;0;0;0;0;0;0;0;0;0;0;0
FR;8;2021-08-20;0;0;0;0;0;0;0;0;0;0;0;0;0;0;0;0;0;0
FR;8;2021-08-21;0;0;0;0;0;0;0;0;0;0;0;0;0;0;0;0;0;0
FR;8;2021-08-22;0;0;0;0;0;0;0;0;0;0;0;0;0;0;0;0;0;0
FR;8;2021-08-23;0;0;0;0;0;0;0;0;0;0;0;0;0;0;0;0;0;0
FR;8;2021-08-24;0;0;0;0;0;0;0;0;0;0;0;0;0;0;0;0;0;0
FR;8;2021-08-25;0;0;0;0;0;0;0;0;0;0;0;0;0;0;0;0;0;0
FR;8;2021-08-26;0;0;0;0;0;0;0;0;0;0;0;0;0;0;0;0;0;0
FR;8;2021-08-27;0;0;0;0;0;0;0;0;0;0;0;0;0;0;0;0;0;0
FR;8;2021-08-28;0;0;0;0;0;0;0;0;0;0;0;0;0;0;0;0;0;0
FR;8;2021-08-29;0;0;0;0;0;0;0;0;0;0;0;0;0;0;0;0;0;0
FR;8;2021-08-30;0;0;0;0;0;0;0;0;0;0;0;0;0;0;0;0;0;0
FR;8;2021-08-31;0;0;0;0;0;0;0;0;0;0;0;0;0;0;0;0;0;0
FR;8;2021-09-01;0;0;0;0;0;0;0;0;0;0;0;0;0;0;0;0;0;0
FR;8;2021-09-02;0;0;0;0;0;0;0;0;0;0;0;0;0;0;0;0;0;0
FR;8;2021-09-03;0;0;0;0;0;0;0;0;0;0;0;0;0;0;0;0;0;0
FR;8;2021-09-04;0;0;0;0;0;0;0;0;0;0;0;0;0;0;0;0;0;0
FR;8;2021-09-05;0;0;0;0;0;0;0;0;0;0;0;0;0;0;0;0;0;0
FR;8;2021-09-06;0;0;0;0;0;0;0;0;0;0;0;0;0;0;0;0;0;0
FR;8;2021-09-07;0;0;0;0;0;0;0;0;0;0;0;0;0;0;0;0;0;0
FR;8;2021-09-08;0;0;0;0;0;0;0;0;0;0;0;0;0;0;0;0;0;0
FR;8;2021-09-09;0;0;0;0;0;0;0;0;0;0;0;0;0;0;0;0;0;0
FR;8;2021-09-10;0;0;0;0;0;0;0;0;0;0;0;0;0;0;0;0;0;0
FR;8;2021-09-11;0;0;0;0;0;0;0;0;0;0;0;0;0;0;0;0;0;0
FR;8;2021-09-12;0;0;0;0;0;0;0;0;0;0;0;0;0;0;0;0;0;0
FR;8;2021-09-13;0;0;0;0;0;0;0;0;0;0;0;0;0;0;0;0;0;0
FR;8;2021-09-14;0;0;0;0;0;0;0;0;0;0;0;0;0;0;0;0;0;0
FR;8;2021-09-15;0;0;0;0;0;0;0;0;0;0;0;0;0;0;0;0;0;0
FR;8;2021-09-16;0;0;0;0;0;0;0;0;0;0;0;0;0;0;0;0;0;0
FR;8;2021-09-17;0;0;0;0;0;0;0;0;0;0;0;0;0;0;0;0;0;0
FR;8;2021-09-18;0;0;0;0;0;0;0;0;0;0;0;0;0;0;0;0;0;0
FR;8;2021-09-19;0;0;0;0;0;0;0;0;0;0;0;0;0;0;0;0;0;0
FR;8;2021-09-20;0;0;0;0;0;0;0;0;0;0;0;0;0;0;0;0;0;0
FR;8;2021-09-21;0;0;0;0;0;0;0;0;0;0;0;0;0;0;0;0;0;0
FR;8;2021-09-22;0;0;0;0;0;0;0;0;0;0;0;0;0;0;0;0;0;0
FR;8;2021-09-23;0;0;0;0;0;0;0;0;0;0;0;0;0;0;0;0;0;0
FR;8;2021-09-24;0;0;0;0;0;0;0;0;0;0;0;0;0;0;0;0;0;0
FR;8;2021-09-25;0;0;0;0;0;0;0;0;0;0;0;0;0;0;0;0;0;0
FR;8;2021-09-26;0;0;0;0;0;0;0;0;0;0;0;0;0;0;0;0;0;0
FR;8;2021-09-27;0;0;0;0;0;0;0;0;0;0;0;0;0;0;0;0;0;0
FR;8;2021-09-28;0;0;0;0;0;0;0;0;0;0;0;0;0;0;0;0;0;0
FR;8;2021-09-29;0;0;0;0;0;0;0;0;0;0;0;0;0;0;0;0;0;0
FR;8;2021-09-30;0;0;0;0;0;0;0;0;0;0;0;0;0;0;0;0;0;0
FR;8;2021-10-01;0;0;0;0;0;0;0;0;0;0;0;0;0;0;0;0;0;0
FR;8;2021-10-02;0;0;0;0;0;0;0;0;0;0;0;0;0;0;0;0;0;0
FR;8;2021-10-03;0;0;0;0;0;0;0;0;0;0;0;0;0;0;0;0;0;0
FR;8;2021-10-04;0;0;0;0;0;0;0;0;0;0;0;0;0;0;0;0;0;0
FR;8;2021-10-05;0;0;0;0;0;0;0;0;0;0;0;0;0;0;0;0;0;0
FR;8;2021-10-06;0;0;0;0;0;0;0;0;0;0;0;0;0;0;0;0;0;0
FR;8;2021-10-07;0;0;0;0;0;0;0;0;0;0;0;0;0;0;0;0;0;0
FR;8;2021-10-08;0;0;0;0;0;0;0;0;0;0;0;0;0;0;0;0;0;0
FR;8;2021-10-09;0;0;0;0;0;0;0;0;0;0;0;0;0;0;0;0;0;0
FR;8;2021-10-10;0;0;0;0;0;0;0;0;0;0;0;0;0;0;0;0;0;0
FR;8;2021-10-11;0;0;0;0;0;0;0;0;0;0;0;0;0;0;0;0;0;0
FR;8;2021-10-12;0;0;0;0;0;0;0;0;0;0;0;0;0;0;0;0;0;0
FR;8;2021-10-13;0;0;0;0;0;0;0;0;0;0;0;0;0;0;0;0;0;0
FR;8;2021-10-14;0;0;0;0;0;0;0;0;0;0;0;0;0;0;0;0;0;0
FR;8;2021-10-15;0;0;0;0;0;0;0;0;0;0;0;0;0;0;0;0;0;0
FR;8;2021-10-16;0;0;0;0;0;0;0;0;0;0;0;0;0;0;0;0;0;0
FR;8;2021-10-17;0;0;0;0;0;0;0;0;0;0;0;0;0;0;0;0;0;0
FR;8;2021-10-18;0;0;0;0;0;0;0;0;0;0;0;0;0;0;0;0;0;0
FR;8;2021-10-19;0;0;0;0;0;0;0;0;0;0;0;0;0;0;0;0;0;0
FR;8;2021-10-20;0;0;0;0;0;0;0;0;0;0;0;0;0;0;0;0;0;0
FR;8;2021-10-21;0;0;0;0;0;0;0;0;0;0;0;0;0;0;0;0;0;0
FR;8;2021-10-22;0;0;0;0;0;0;0;0;0;0;0;0;0;0;0;0;0;0
FR;8;2021-10-23;0;0;0;0;0;0;0;0;0;0;0;0;0;0;0;0;0;0
FR;8;2021-10-24;0;0;0;0;0;0;0;0;0;0;0;0;0;0;0;0;0;0
FR;8;2021-10-25;0;0;0;0;0;0;0;0;0;0;0;0;0;0;0;0;0;0
FR;8;2021-10-26;0;0;0;0;0;0;0;0;0;0;0;0;0;0;0;0;0;0
FR;8;2021-10-27;0;0;0;0;0;0;0;0;0;0;0;0;0;0;0;0;0;0
FR;8;2021-10-28;0;0;0;0;0;0;0;0;0;0;0;0;0;0;0;0;0;0
FR;8;2021-10-29;0;0;0;0;0;0;0;0;0;0;0;0;0;0;0;0;0;0
FR;8;2021-10-30;0;0;0;0;0;0;0;0;0;0;0;0;0;0;0;0;0;0
FR;8;2021-10-31;0;0;0;0;0;0;0;0;0;0;0;0;0;0;0;0;0;0
FR;8;2021-11-01;0;0;0;0;0;0;0;0;0;0;0;0;0;0;0;0;0;0
FR;8;2021-11-02;0;0;0;0;0;0;0;0;0;0;0;0;0;0;0;0;0;0
FR;8;2021-11-03;0;0;0;0;0;0;0;0;0;0;0;0;0;0;0;0;0;0
FR;8;2021-11-04;0;0;0;0;0;0;0;0;0;0;0;0;0;0;0;0;0;0
FR;8;2021-11-05;0;0;0;0;0;0;0;0;0;0;0;0;0;0;0;0;0;0
FR;8;2021-11-06;0;0;0;0;0;0;0;0;0;0;0;0;0;0;0;0;0;0
FR;8;2021-11-07;0;0;0;0;0;0;0;0;0;0;0;0;0;0;0;0;0;0
FR;8;2021-11-08;0;0;0;0;0;0;0;0;0;0;0;0;0;0;0;0;0;0
FR;8;2021-11-09;0;0;0;0;0;0;0;0;0;0;0;0;0;0;0;0;0;0
FR;8;2021-11-10;0;0;0;0;0;0;0;0;0;0;0;0;0;0;0;0;0;0
FR;8;2021-11-11;0;0;0;0;0;0;0;0;0;0;0;0;0;0;0;0;0;0
FR;8;2021-11-12;0;0;0;0;0;0;0;0;0;0;0;0;0;0;0;0;0;0
FR;8;2021-11-13;0;0;0;0;0;0;0;0;0;0;0;0;0;0;0;0;0;0
FR;8;2021-11-14;0;0;0;0;0;0;0;0;0;0;0;0;0;0;0;0;0;0
FR;8;2021-11-15;0;0;0;0;0;0;0;0;0;0;0;0;0;0;0;0;0;0
FR;8;2021-11-16;0;0;0;0;0;0;0;0;0;0;0;0;0;0;0;0;0;0
FR;8;2021-11-17;0;0;0;0;0;0;0;0;0;0;0;0;0;0;0;0;0;0
FR;8;2021-11-18;0;0;0;0;0;0;0;0;0;0;0;0;0;0;0;0;0;0
FR;8;2021-11-19;0;0;0;0;0;0;0;0;0;0;0;0;0;0;0;0;0;0
FR;8;2021-11-20;0;0;0;0;0;0;0;0;0;0;0;0;0;0;0;0;0;0
FR;8;2021-11-21;0;0;0;0;0;0;0;0;0;0;0;0;0;0;0;0;0;0
FR;8;2021-11-22;0;0;0;0;0;0;0;0;0;0;0;0;0;0;0;0;0;0
FR;8;2021-11-23;0;0;0;0;0;0;0;0;0;0;0;0;0;0;0;0;0;0
FR;8;2021-11-24;0;0;0;0;0;0;0;0;0;0;0;0;0;0;0;0;0;0
FR;8;2021-11-25;0;0;0;0;0;0;0;0;0;0;0;0;0;0;0;0;0;0
FR;8;2021-11-26;0;0;0;0;0;0;0;0;0;0;0;0;0;0;0;0;0;0
FR;8;2021-11-27;0;0;0;0;0;0;0;0;0;0;0;0;0;0;0;0;0;0
FR;8;2021-11-28;0;0;0;0;0;0;0;0;0;0;0;0;0;0;0;0;0;0
FR;8;2021-11-29;0;0;0;0;0;0;0;0;0;0;0;0;0;0;0;0;0;0
FR;8;2021-11-30;0;0;0;0;0;0;0;0;0;0;0;0;0;0;0;0;0;0
FR;8;2021-12-01;0;0;0;0;0;0;0;0;0;0;0;0;0;0;0;0;0;0
FR;8;2021-12-02;0;0;0;0;0;0;0;0;0;0;0;0;0;0;0;0;0;0
FR;8;2021-12-03;0;0;0;0;0;0;0;0;0;0;0;0;0;0;0;0;0;0
FR;8;2021-12-04;0;0;0;0;0;0;0;0;0;0;0;0;0;0;0;0;0;0
FR;8;2021-12-05;0;0;0;0;0;0;0;0;0;0;0;0;0;0;0;0;0;0
FR;8;2021-12-06;0;0;0;0;0;0;0;0;0;0;0;0;0;0;0;0;0;0
FR;8;2021-12-07;0;0;0;0;0;0;0;0;0;0;0;0;0;0;0;0;0;0
FR;8;2021-12-08;0;0;0;0;0;0;0;0;0;0;0;0;0;0;0;0;0;0
FR;8;2021-12-09;0;0;0;0;0;0;0;0;0;0;0;0;0;0;0;0;0;0
FR;8;2021-12-10;0;0;0;0;0;0;0;0;0;0;0;0;0;0;0;0;0;0
FR;8;2021-12-11;0;0;0;0;0;0;0;0;0;0;0;0;0;0;0;0;0;0
FR;8;2021-12-12;0;0;0;0;0;0;0;0;0;0;0;0;0;0;0;0;0;0
FR;8;2021-12-13;0;0;0;0;0;0;0;0;0;0;0;0;0;0;0;0;0;0
FR;8;2021-12-14;0;0;0;0;0;0;0;0;0;0;0;0;0;0;0;0;0;0
FR;8;2021-12-15;0;0;0;0;0;0;0;0;0;0;0;0;0;0;0;0;0;0
FR;8;2021-12-16;0;0;0;0;0;0;0;0;0;0;0;0;0;0;0;0;0;0
FR;8;2021-12-17;0;0;0;0;0;0;0;0;0;0;0;0;0;0;0;0;0;0
FR;8;2021-12-18;0;0;0;0;0;0;0;0;0;0;0;0;0;0;0;0;0;0
FR;8;2021-12-19;0;0;0;0;0;0;0;0;0;0;0;0;0;0;0;0;0;0
FR;8;2021-12-20;0;0;0;0;0;0;0;0;0;0;0;0;0;0;0;0;0;0
FR;8;2021-12-21;0;0;0;0;0;0;0;0;0;0;0;0;0;0;0;0;0;0
FR;8;2021-12-22;0;0;0;0;0;0;0;0;0;0;0;0;0;0;0;0;0;0
FR;8;2021-12-23;0;0;0;0;0;0;0;0;0;0;0;0;0;0;0;0;0;0
FR;8;2021-12-24;0;0;0;0;0;0;0;0;0;0;0;0;0;0;0;0;0;0
FR;8;2021-12-25;0;0;0;0;0;0;0;0;0;0;0;0;0;0;0;0;0;0
FR;8;2021-12-26;0;0;0;0;0;0;0;0;0;0;0;0;0;0;0;0;0;0
FR;8;2021-12-27;0;0;0;0;0;0;0;0;0;0;0;0;0;0;0;0;0;0
FR;8;2021-12-28;0;0;0;0;0;0;0;0;0;0;0;0;0;0;0;0;0;0
FR;8;2021-12-29;0;0;0;0;0;0;0;0;0;0;0;0;0;0;0;0;0;0
FR;8;2021-12-30;0;0;0;0;0;0;0;0;0;0;0;0;0;0;0;0;0;0
FR;8;2021-12-31;0;0;0;0;0;0;0;0;0;0;0;0;0;0;0;0;0;0
FR;8;2022-01-01;0;0;0;0;0;0;0;0;0;0;0;0;0;0;0;0;0;0
FR;8;2022-01-02;0;0;0;0;0;0;0;0;0;0;0;0;0;0;0;0;0;0
FR;8;2022-01-03;0;0;0;0;0;0;0;0;0;0;0;0;0;0;0;0;0;0
FR;8;2022-01-04;0;0;0;0;0;0;0;0;0;0;0;0;0;0;0;0;0;0
FR;8;2022-01-05;0;0;0;0;0;0;0;0;0;0;0;0;0;0;0;0;0;0
FR;8;2022-01-06;0;0;0;0;0;0;0;0;0;0;0;0;0;0;0;0;0;0
FR;8;2022-01-07;0;0;0;0;0;0;0;0;0;0;0;0;0;0;0;0;0;0
FR;8;2022-01-08;0;0;0;0;0;0;0;0;0;0;0;0;0;0;0;0;0;0
FR;8;2022-01-09;0;0;0;0;0;0;0;0;0;0;0;0;0;0;0;0;0;0
FR;8;2022-01-10;0;0;0;0;0;0;0;0;0;0;0;0;0;0;0;0;0;0
FR;8;2022-01-11;0;0;0;0;0;0;0;0;0;0;0;0;0;0;0;0;0;0
FR;8;2022-01-12;0;0;0;0;0;0;0;0;0;0;0;0;0;0;0;0;0;0
FR;8;2022-01-13;0;0;0;0;0;0;0;0;0;0;0;0;0;0;0;0;0;0
FR;8;2022-01-14;0;0;0;0;0;0;0;0;0;0;0;0;0;0;0;0;0;0
FR;8;2022-01-15;0;0;0;0;0;0;0;0;0;0;0;0;0;0;0;0;0;0
FR;8;2022-01-16;0;0;0;0;0;0;0;0;0;0;0;0;0;0;0;0;0;0
FR;8;2022-01-17;0;0;0;0;0;0;0;0;0;0;0;0;0;0;0;0;0;0
FR;8;2022-01-18;0;0;0;0;0;0;0;0;0;0;0;0;0;0;0;0;0;0
FR;8;2022-01-19;0;0;0;0;0;0;0;0;0;0;0;0;0;0;0;0;0;0
FR;8;2022-01-20;0;0;0;0;0;0;0;0;0;0;0;0;0;0;0;0;0;0
FR;8;2022-01-21;0;0;0;0;0;0;0;0;0;0;0;0;0;0;0;0;0;0
FR;8;2022-01-22;0;0;0;0;0;0;0;0;0;0;0;0;0;0;0;0;0;0
FR;8;2022-01-23;0;0;0;0;0;0;0;0;0;0;0;0;0;0;0;0;0;0
FR;8;2022-01-24;0;0;0;0;0;0;0;0;0;0;0;0;0;0;0;0;0;0
FR;8;2022-01-25;0;0;0;0;0;0;0;0;0;0;0;0;0;0;0;0;0;0
FR;8;2022-01-26;0;0;0;0;0;0;0;0;0;0;0;0;0;0;0;0;0;0
FR;8;2022-01-27;0;0;0;0;0;0;0;0;0;0;0;0;0;0;0;0;0;0
FR;8;2022-01-28;0;0;0;0;0;0;0;0;0;0;0;0;0;0;0;0;0;0
FR;8;2022-01-29;0;0;0;0;0;0;0;0;0;0;0;0;0;0;0;0;0;0
FR;8;2022-01-30;0;0;0;0;0;0;0;0;0;0;0;0;0;0;0;0;0;0
FR;8;2022-01-31;0;0;0;0;0;0;0;0;0;0;0;0;0;0;0;0;0;0
FR;8;2022-02-01;0;0;0;0;0;0;0;0;0;0;0;0;0;0;0;0;0;0
FR;8;2022-02-02;0;0;0;0;0;0;0;0;0;0;0;0;0;0;0;0;0;0
FR;8;2022-02-03;0;0;0;0;0;0;0;0;0;0;0;0;0;0;0;0;0;0
FR;8;2022-02-04;0;0;0;0;0;0;0;0;0;0;0;0;0;0;0;0;0;0
FR;8;2022-02-05;0;0;0;0;0;0;0;0;0;0;0;0;0;0;0;0;0;0
FR;8;2022-02-06;0;0;0;0;0;0;0;0;0;0;0;0;0;0;0;0;0;0
FR;8;2022-02-07;0;0;0;0;0;0;0;0;0;0;0;0;0;0;0;0;0;0
FR;8;2022-02-08;0;0;0;0;0;0;0;0;0;0;0;0;0;0;0;0;0;0
FR;8;2022-02-09;0;0;0;0;0;0;0;0;0;0;0;0;0;0;0;0;0;0
FR;8;2022-02-10;0;0;0;0;0;0;0;0;0;0;0;0;0;0;0;0;0;0
FR;8;2022-02-11;0;0;0;0;0;0;0;0;0;0;0;0;0;0;0;0;0;0
FR;8;2022-02-12;0;0;0;0;0;0;0;0;0;0;0;0;0;0;0;0;0;0
FR;8;2022-02-13;0;0;0;0;0;0;0;0;0;0;0;0;0;0;0;0;0;0
FR;8;2022-02-14;0;0;0;0;0;0;0;0;0;0;0;0;0;0;0;0;0;0
FR;8;2022-02-15;0;0;0;0;0;0;0;0;0;0;0;0;0;0;0;0;0;0
FR;8;2022-02-16;0;0;0;0;0;0;0;0;0;0;0;0;0;0;0;0;0;0
FR;8;2022-02-17;0;0;0;0;0;0;0;0;0;0;0;0;0;0;0;0;0;0
FR;8;2022-02-18;0;0;0;0;0;0;0;0;0;0;0;0;0;0;0;0;0;0
FR;8;2022-02-19;0;0;0;0;0;0;0;0;0;0;0;0;0;0;0;0;0;0
FR;8;2022-02-20;0;0;0;0;0;0;0;0;0;0;0;0;0;0;0;0;0;0
FR;8;2022-02-21;0;0;0;0;0;0;0;0;0;0;0;0;0;0;0;0;0;0
FR;8;2022-02-22;0;0;0;0;0;0;0;0;0;0;0;0;0;0;0;0;0;0
FR;8;2022-02-23;0;0;0;0;0;0;0;0;0;0;0;0;0;0;0;0;0;0
FR;8;2022-02-24;0;0;0;0;0;0;0;0;0;0;0;0;0;0;0;0;0;0
FR;8;2022-02-25;0;0;0;0;0;0;0;0;0;0;0;0;0;0;0;0;0;0
FR;8;2022-02-26;0;0;0;0;0;0;0;0;0;0;0;0;0;0;0;0;0;0
FR;8;2022-02-27;0;0;0;0;0;0;0;0;0;0;0;0;0;0;0;0;0;0
FR;8;2022-02-28;0;0;0;0;0;0;0;0;0;0;0;0;0;0;0;0;0;0
FR;8;2022-03-01;0;0;0;0;0;0;0;0;0;0;0;0;0;0;0;0;0;0
FR;8;2022-03-02;0;0;0;0;0;0;0;0;0;0;0;0;0;0;0;0;0;0
FR;8;2022-03-03;0;0;0;0;0;0;0;0;0;0;0;0;0;0;0;0;0;0
FR;8;2022-03-04;0;0;0;0;0;0;0;0;0;0;0;0;0;0;0;0;0;0
FR;8;2022-03-05;0;0;0;0;0;0;0;0;0;0;0;0;0;0;0;0;0;0
FR;8;2022-03-06;0;0;0;0;0;0;0;0;0;0;0;0;0;0;0;0;0;0
FR;8;2022-03-07;0;0;0;0;0;0;0;0;0;0;0;0;0;0;0;0;0;0
FR;8;2022-03-08;0;0;0;0;0;0;0;0;0;0;0;0;0;0;0;0;0;0
FR;8;2022-03-09;0;0;0;0;0;0;0;0;0;0;0;0;0;0;0;0;0;0
FR;8;2022-03-10;0;0;0;0;0;0;0;0;0;0;0;0;0;0;0;0;0;0
FR;8;2022-03-11;0;0;0;0;0;0;0;0;0;0;0;0;0;0;0;0;0;0
FR;8;2022-03-12;0;0;0;0;0;0;0;0;0;0;0;0;0;0;0;0;0;0
FR;8;2022-03-13;0;0;0;0;0;0;0;0;0;0;0;0;0;0;0;0;0;0
FR;8;2022-03-14;0;0;0;0;0;0;0;0;0;0;0;0;0;0;0;0;0;0
FR;8;2022-03-15;0;0;0;0;0;0;0;0;0;0;0;0;0;0;0;0;0;0
FR;8;2022-03-16;0;0;0;0;0;0;0;0;0;0;0;0;0;0;0;0;0;0
FR;8;2022-03-17;0;0;0;0;0;0;0;0;0;0;0;0;0;0;0;0;0;0
FR;8;2022-03-18;0;0;0;0;0;0;0;0;0;0;0;0;0;0;0;0;0;0
FR;8;2022-03-19;0;0;0;0;0;0;0;0;0;0;0;0;0;0;0;0;0;0
FR;8;2022-03-20;0;0;0;0;0;0;0;0;0;0;0;0;0;0;0;0;0;0
FR;8;2022-03-21;0;0;0;0;0;0;0;0;0;0;0;0;0;0;0;0;0;0
FR;8;2022-03-22;0;0;0;0;0;0;0;0;0;0;0;0;0;0;0;0;0;0
FR;8;2022-03-23;0;0;0;0;0;0;0;0;0;0;0;0;0;0;0;0;0;0
FR;8;2022-03-24;0;0;0;0;0;0;0;0;0;0;0;0;0;0;0;0;0;0
FR;8;2022-03-25;0;0;0;0;0;0;0;0;0;0;0;0;0;0;0;0;0;0
FR;8;2022-03-26;0;0;0;0;0;0;0;0;0;0;0;0;0;0;0;0;0;0
FR;8;2022-03-27;0;0;0;0;0;0;0;0;0;0;0;0;0;0;0;0;0;0
FR;8;2022-03-28;0;0;0;0;0;0;0;0;0;0;0;0;0;0;0;0;0;0
FR;8;2022-03-29;0;0;0;0;0;0;0;0;0;0;0;0;0;0;0;0;0;0
FR;8;2022-03-30;0;0;0;0;0;0;0;0;0;0;0;0;0;0;0;0;0;0
FR;8;2022-03-31;0;0;0;0;0;0;0;0;0;0;0;0;0;0;0;0;0;0
FR;8;2022-04-01;0;0;0;0;0;0;0;0;0;0;0;0;0;0;0;0;0;0
FR;8;2022-04-02;0;0;0;0;0;0;0;0;0;0;0;0;0;0;0;0;0;0
FR;8;2022-04-03;0;0;0;0;0;0;0;0;0;0;0;0;0;0;0;0;0;0
FR;8;2022-04-04;0;0;0;0;0;0;0;0;0;0;0;0;0;0;0;0;0;0
FR;8;2022-04-05;0;0;0;0;0;0;0;0;0;0;0;0;0;0;0;0;0;0
FR;8;2022-04-06;0;0;0;0;0;0;0;0;0;0;0;0;0;0;0;0;0;0
FR;8;2022-04-07;0;0;0;0;0;0;0;0;0;0;0;0;0;0;0;0;0;0
FR;8;2022-04-08;0;0;0;0;0;0;0;0;0;0;0;0;0;0;0;0;0;0
FR;8;2022-04-09;0;0;0;0;0;0;0;0;0;0;0;0;0;0;0;0;0;0
FR;8;2022-04-10;0;0;0;0;0;0;0;0;0;0;0;0;0;0;0;0;0;0
FR;8;2022-04-11;0;0;0;0;0;0;0;0;0;0;0;0;0;0;0;0;0;0
FR;8;2022-04-12;0;0;0;0;0;0;0;0;0;0;0;0;0;0;0;0;0;0
FR;8;2022-04-13;0;0;0;0;0;0;0;0;0;0;0;0;0;0;0;0;0;0
FR;8;2022-04-14;0;0;0;0;0;0;0;0;0;0;0;0;0;0;0;0;0;0
FR;8;2022-04-15;0;0;0;0;0;0;0;0;0;0;0;0;0;0;0;0;0;0
FR;8;2022-04-16;0;0;0;0;0;0;0;0;0;0;0;0;0;0;0;0;0;0
FR;8;2022-04-17;0;0;0;0;0;0;0;0;0;0;0;0;0;0;0;0;0;0
FR;8;2022-04-18;0;0;0;0;0;0;0;0;0;0;0;0;0;0;0;0;0;0
FR;8;2022-04-19;0;0;0;0;0;0;0;0;0;0;0;0;0;0;0;0;0;0
FR;8;2022-04-20;0;0;0;0;0;0;0;0;0;0;0;0;0;0;0;0;0;0
FR;8;2022-04-21;0;0;0;0;0;0;0;0;0;0;0;0;0;0;0;0;0;0
FR;8;2022-04-22;0;0;0;0;0;0;0;0;0;0;0;0;0;0;0;0;0;0
FR;8;2022-04-23;0;0;0;0;0;0;0;0;0;0;0;0;0;0;0;0;0;0
FR;8;2022-04-24;0;0;0;0;0;0;0;0;0;0;0;0;0;0;0;0;0;0
FR;8;2022-04-25;0;0;0;0;0;0;0;0;0;0;0;0;0;0;0;0;0;0
FR;8;2022-04-26;0;0;0;0;0;0;0;0;0;0;0;0;0;0;0;0;0;0
FR;8;2022-04-27;0;0;0;0;0;0;0;0;0;0;0;0;0;0;0;0;0;0
FR;8;2022-04-28;0;0;0;0;0;0;0;0;0;0;0;0;0;0;0;0;0;0
FR;8;2022-04-29;0;0;0;0;0;0;0;0;0;0;0;0;0;0;0;0;0;0
FR;8;2022-04-30;0;0;0;0;0;0;0;0;0;0;0;0;0;0;0;0;0;0
FR;8;2022-05-01;0;0;0;0;0;0;0;0;0;0;0;0;0;0;0;0;0;0
FR;8;2022-05-02;0;0;0;0;0;0;0;0;0;0;0;0;0;0;0;0;0;0
FR;8;2022-05-03;0;0;0;0;0;0;0;0;0;0;0;0;0;0;0;0;0;0
FR;8;2022-05-04;0;0;0;0;0;0;0;0;0;0;0;0;0;0;0;0;0;0
FR;8;2022-05-05;0;0;0;0;0;0;0;0;0;0;0;0;0;0;0;0;0;0
FR;8;2022-05-06;0;0;0;0;0;0;0;0;0;0;0;0;0;0;0;0;0;0
FR;8;2022-05-07;0;0;0;0;0;0;0;0;0;0;0;0;0;0;0;0;0;0
FR;8;2022-05-08;0;0;0;0;0;0;0;0;0;0;0;0;0;0;0;0;0;0
FR;8;2022-05-09;0;0;0;0;0;0;0;0;0;0;0;0;0;0;0;0;0;0
FR;8;2022-05-10;0;0;0;0;0;0;0;0;0;0;0;0;0;0;0;0;0;0
FR;8;2022-05-11;0;0;0;0;0;0;0;0;0;0;0;0;0;0;0;0;0;0
FR;8;2022-05-12;0;0;0;0;0;0;0;0;0;0;0;0;0;0;0;0;0;0
FR;8;2022-05-13;0;0;0;0;0;0;0;0;0;0;0;0;0;0;0;0;0;0
FR;8;2022-05-14;0;0;0;0;0;0;0;0;0;0;0;0;0;0;0;0;0;0
FR;8;2022-05-15;0;0;0;0;0;0;0;0;0;0;0;0;0;0;0;0;0;0
FR;8;2022-05-16;0;0;0;0;0;0;0;0;0;0;0;0;0;0;0;0;0;0
FR;8;2022-05-17;0;0;0;0;0;0;0;0;0;0;0;0;0;0;0;0;0;0
FR;8;2022-05-18;0;0;0;0;0;0;0;0;0;0;0;0;0;0;0;0;0;0
FR;8;2022-05-19;0;0;0;0;0;0;0;0;0;0;0;0;0;0;0;0;0;0
FR;8;2022-05-20;0;0;0;0;0;0;0;0;0;0;0;0;0;0;0;0;0;0
FR;8;2022-05-21;0;0;0;0;0;0;0;0;0;0;0;0;0;0;0;0;0;0
FR;8;2022-05-22;0;0;0;0;0;0;0;0;0;0;0;0;0;0;0;0;0;0
FR;8;2022-05-23;0;0;0;0;0;0;0;0;0;0;0;0;0;0;0;0;0;0
FR;8;2022-05-24;0;0;0;0;0;0;0;0;0;0;0;0;0;0;0;0;0;0
FR;8;2022-05-25;0;0;0;0;0;0;0;0;0;0;0;0;0;0;0;0;0;0
FR;8;2022-05-26;0;0;0;0;0;0;0;0;0;0;0;0;0;0;0;0;0;0
FR;8;2022-05-27;0;0;0;0;0;0;0;0;0;0;0;0;0;0;0;0;0;0
FR;8;2022-05-28;0;0;0;0;0;0;0;0;0;0;0;0;0;0;0;0;0;0
FR;8;2022-05-29;0;0;0;0;0;0;0;0;0;0;0;0;0;0;0;0;0;0
FR;8;2022-05-30;0;0;0;0;0;0;0;0;0;0;0;0;0;0;0;0;0;0
FR;8;2022-05-31;0;0;0;0;0;0;0;0;0;0;0;0;0;0;0;0;0;0
FR;8;2022-06-01;0;0;0;0;0;0;0;0;0;0;0;0;0;0;0;0;0;0
FR;8;2022-06-02;0;0;0;0;0;0;0;0;0;0;0;0;0;0;0;0;0;0
FR;8;2022-06-03;0;0;0;0;0;0;0;0;0;0;0;0;0;0;0;0;0;0
FR;8;2022-06-04;0;0;0;0;0;0;0;0;0;0;0;0;0;0;0;0;0;0
FR;8;2022-06-05;0;0;0;0;0;0;0;0;0;0;0;0;0;0;0;0;0;0
FR;8;2022-06-06;0;0;0;0;0;0;0;0;0;0;0;0;0;0;0;0;0;0
FR;8;2022-06-07;0;0;0;0;0;0;0;0;0;0;0;0;0;0;0;0;0;0
FR;8;2022-06-08;0;0;0;0;0;0;0;0;0;0;0;0;0;0;0;0;0;0
FR;8;2022-06-09;0;0;0;0;0;0;0;0;0;0;0;0;0;0;0;0;0;0
FR;8;2022-06-10;0;0;0;0;0;0;0;0;0;0;0;0;0;0;0;0;0;0
FR;8;2022-06-11;0;0;0;0;0;0;0;0;0;0;0;0;0;0;0;0;0;0
FR;8;2022-06-12;0;0;0;0;0;0;0;0;0;0;0;0;0;0;0;0;0;0
FR;8;2022-06-13;0;0;0;0;0;0;0;0;0;0;0;0;0;0;0;0;0;0
FR;8;2022-06-14;0;0;0;0;0;0;0;0;0;0;0;0;0;0;0;0;0;0
FR;8;2022-06-15;0;0;0;0;0;0;0;0;0;0;0;0;0;0;0;0;0;0
FR;8;2022-06-16;0;0;0;0;0;0;0;0;0;0;0;0;0;0;0;0;0;0
FR;8;2022-06-17;0;0;0;0;0;0;0;0;0;0;0;0;0;0;0;0;0;0
FR;8;2022-06-18;0;0;0;0;0;0;0;0;0;0;0;0;0;0;0;0;0;0
FR;8;2022-06-19;0;0;0;0;0;0;0;0;0;0;0;0;0;0;0;0;0;0
FR;8;2022-06-20;0;0;0;0;0;0;0;0;0;0;0;0;0;0;0;0;0;0
FR;8;2022-06-21;0;0;0;0;0;0;0;0;0;0;0;0;0;0;0;0;0;0
FR;8;2022-06-22;0;0;0;0;0;0;0;0;0;0;0;0;0;0;0;0;0;0
FR;8;2022-06-23;0;0;0;0;0;0;0;0;0;0;0;0;0;0;0;0;0;0
FR;8;2022-06-24;0;0;0;0;0;0;0;0;0;0;0;0;0;0;0;0;0;0
FR;8;2022-06-25;0;0;0;0;0;0;0;0;0;0;0;0;0;0;0;0;0;0
FR;8;2022-06-26;0;0;0;0;0;0;0;0;0;0;0;0;0;0;0;0;0;0
FR;8;2022-06-27;0;0;0;0;0;0;0;0;0;0;0;0;0;0;0;0;0;0
FR;8;2022-06-28;0;0;0;0;0;0;0;0;0;0;0;0;0;0;0;0;0;0
FR;8;2022-06-29;0;0;0;0;0;0;0;0;0;0;0;0;0;0;0;0;0;0
FR;8;2022-06-30;0;0;0;0;0;0;0;0;0;0;0;0;0;0;0;0;0;0
FR;8;2022-07-01;0;0;0;0;0;0;0;0;0;0;0;0;0;0;0;0;0;0
FR;8;2022-07-02;0;0;0;0;0;0;0;0;0;0;0;0;0;0;0;0;0;0
FR;8;2022-07-03;0;0;0;0;0;0;0;0;0;0;0;0;0;0;0;0;0;0
FR;8;2022-07-04;0;0;0;0;0;0;0;0;0;0;0;0;0;0;0;0;0;0
FR;8;2022-07-05;0;0;0;0;0;0;0;0;0;0;0;0;0;0;0;0;0;0
FR;8;2022-07-06;0;0;0;0;0;0;0;0;0;0;0;0;0;0;0;0;0;0
FR;8;2022-07-07;0;0;0;0;0;0;0;0;0;0;0;0;0;0;0;0;0;0
FR;8;2022-07-08;0;0;0;0;0;0;0;0;0;0;0;0;0;0;0;0;0;0
FR;8;2022-07-09;0;0;0;0;0;0;0;0;0;0;0;0;0;0;0;0;0;0
FR;8;2022-07-10;0;0;0;0;0;0;0;0;0;0;0;0;0;0;0;0;0;0
FR;8;2022-07-11;0;0;0;0;0;0;0;0;0;0;0;0;0;0;0;0;0;0
FR;8;2022-07-12;0;0;0;0;0;0;0;0;0;0;0;0;0;0;0;0;0;0
FR;8;2022-07-13;0;0;0;0;0;0;0;0;0;0;0;0;0;0;0;0;0;0
FR;8;2022-07-14;0;0;0;0;0;0;0;0;0;0;0;0;0;0;0;0;0;0
FR;8;2022-07-15;0;0;0;0;0;0;0;0;0;0;0;0;0;0;0;0;0;0
FR;8;2022-07-16;0;0;0;0;0;0;0;0;0;0;0;0;0;0;0;0;0;0
FR;8;2022-07-17;0;0;0;0;0;0;0;0;0;0;0;0;0;0;0;0;0;0
FR;8;2022-07-18;0;0;0;0;0;0;0;0;0;0;0;0;0;0;0;0;0;0
FR;8;2022-07-19;0;0;0;0;0;0;0;0;0;0;0;0;0;0;0;0;0;0
FR;8;2022-07-20;0;0;0;0;0;0;0;0;0;0;0;0;0;0;0;0;0;0
FR;8;2022-07-21;0;0;0;0;0;0;0;0;0;0;0;0;0;0;0;0;0;0
FR;8;2022-07-22;0;0;0;0;0;0;0;0;0;0;0;0;0;0;0;0;0;0
FR;8;2022-07-23;0;0;0;0;0;0;0;0;0;0;0;0;0;0;0;0;0;0
FR;8;2022-07-24;0;0;0;0;0;0;0;0;0;0;0;0;0;0;0;0;0;0
FR;8;2022-07-25;0;0;0;0;0;0;0;0;0;0;0;0;0;0;0;0;0;0
FR;8;2022-07-26;0;0;0;0;0;0;0;0;0;0;0;0;0;0;0;0;0;0
FR;8;2022-07-27;0;0;0;0;0;0;0;0;0;0;0;0;0;0;0;0;0;0
FR;8;2022-07-28;0;0;0;0;0;0;0;0;0;0;0;0;0;0;0;0;0;0
FR;8;2022-07-29;0;0;0;0;0;0;0;0;0;0;0;0;0;0;0;0;0;0
FR;8;2022-07-30;0;0;0;0;0;0;0;0;0;0;0;0;0;0;0;0;0;0
FR;8;2022-07-31;0;0;0;0;0;0;0;0;0;0;0;0;0;0;0;0;0;0
FR;8;2022-08-01;0;0;0;0;0;0;0;0;0;0;0;0;0;0;0;0;0;0
FR;8;2022-08-02;0;0;0;0;0;0;0;0;0;0;0;0;0;0;0;0;0;0
FR;8;2022-08-03;0;0;0;0;0;0;0;0;0;0;0;0;0;0;0;0;0;0
FR;8;2022-08-04;0;0;0;0;0;0;0;0;0;0;0;0;0;0;0;0;0;0
FR;8;2022-08-05;0;0;0;0;0;0;0;0;0;0;0;0;0;0;0;0;0;0
FR;8;2022-08-06;0;0;0;0;0;0;0;0;0;0;0;0;0;0;0;0;0;0
FR;8;2022-08-07;0;0;0;0;0;0;0;0;0;0;0;0;0;0;0;0;0;0
FR;8;2022-08-08;0;0;0;0;0;0;0;0;0;0;0;0;0;0;0;0;0;0
FR;8;2022-08-09;0;0;0;0;0;0;0;0;0;0;0;0;0;0;0;0;0;0
FR;8;2022-08-10;0;0;0;0;0;0;0;0;0;0;0;0;0;0;0;0;0;0
FR;8;2022-08-11;0;0;0;0;0;0;0;0;0;0;0;0;0;0;0;0;0;0
FR;8;2022-08-12;0;0;0;0;0;0;0;0;0;0;0;0;0;0;0;0;0;0
FR;8;2022-08-13;0;0;0;0;0;0;0;0;0;0;0;0;0;0;0;0;0;0
FR;8;2022-08-14;0;0;0;0;0;0;0;0;0;0;0;0;0;0;0;0;0;0
FR;8;2022-08-15;0;0;0;0;0;0;0;0;0;0;0;0;0;0;0;0;0;0
FR;8;2022-08-16;0;0;0;0;0;0;0;0;0;0;0;0;0;0;0;0;0;0
FR;8;2022-08-17;0;0;0;0;0;0;0;0;0;0;0;0;0;0;0;0;0;0
FR;8;2022-08-18;0;0;0;0;0;0;0;0;0;0;0;0;0;0;0;0;0;0
FR;8;2022-08-19;0;0;0;0;0;0;0;0;0;0;0;0;0;0;0;0;0;0
FR;8;2022-08-20;0;0;0;0;0;0;0;0;0;0;0;0;0;0;0;0;0;0
FR;8;2022-08-21;0;0;0;0;0;0;0;0;0;0;0;0;0;0;0;0;0;0
FR;8;2022-08-22;0;0;0;0;0;0;0;0;0;0;0;0;0;0;0;0;0;0
FR;8;2022-08-23;0;0;0;0;0;0;0;0;0;0;0;0;0;0;0;0;0;0
FR;8;2022-08-24;0;0;0;0;0;0;0;0;0;0;0;0;0;0;0;0;0;0
FR;8;2022-08-25;0;0;0;0;0;0;0;0;0;0;0;0;0;0;0;0;0;0
FR;8;2022-08-26;0;0;0;0;0;0;0;0;0;0;0;0;0;0;0;0;0;0
FR;8;2022-08-27;0;0;0;0;0;0;0;0;0;0;0;0;0;0;0;0;0;0
FR;8;2022-08-28;0;0;0;0;0;0;0;0;0;0;0;0;0;0;0;0;0;0
FR;8;2022-08-29;0;0;0;0;0;0;0;0;0;0;0;0;0;0;0;0;0;0
FR;8;2022-08-30;0;0;0;0;0;0;0;0;0;0;0;0;0;0;0;0;0;0
FR;8;2022-08-31;0;0;0;0;0;0;0;0;0;0;0;0;0;0;0;0;0;0
FR;8;2022-09-01;0;0;0;0;0;0;0;0;0;0;0;0;0;0;0;0;0;0
FR;8;2022-09-02;0;0;0;0;0;0;0;0;0;0;0;0;0;0;0;0;0;0
FR;8;2022-09-03;0;0;0;0;0;0;0;0;0;0;0;0;0;0;0;0;0;0
FR;8;2022-09-04;0;0;0;0;0;0;0;0;0;0;0;0;0;0;0;0;0;0
FR;8;2022-09-05;0;0;0;0;0;0;0;0;0;0;0;0;0;0;0;0;0;0
FR;8;2022-09-06;0;0;0;0;0;0;0;0;0;0;0;0;0;0;0;0;0;0
FR;8;2022-09-07;0;0;0;0;0;0;0;0;0;0;0;0;0;0;0;0;0;0
FR;8;2022-09-08;0;0;0;0;0;0;0;0;0;0;0;0;0;0;0;0;0;0
FR;8;2022-09-09;0;0;0;0;0;0;0;0;0;0;0;0;0;0;0;0;0;0
FR;8;2022-09-10;0;0;0;0;0;0;0;0;0;0;0;0;0;0;0;0;0;0
FR;8;2022-09-11;0;0;0;0;0;0;0;0;0;0;0;0;0;0;0;0;0;0
FR;8;2022-09-12;0;0;0;0;0;0;0;0;0;0;0;0;0;0;0;0;0;0
FR;8;2022-09-13;0;0;0;0;0;0;0;0;0;0;0;0;0;0;0;0;0;0
FR;8;2022-09-14;0;0;0;0;0;0;0;0;0;0;0;0;0;0;0;0;0;0
FR;8;2022-09-15;0;0;0;0;0;0;0;0;0;0;0;0;0;0;0;0;0;0
FR;8;2022-09-16;0;0;0;0;0;0;0;0;0;0;0;0;0;0;0;0;0;0
FR;8;2022-09-17;0;0;0;0;0;0;0;0;0;0;0;0;0;0;0;0;0;0
FR;8;2022-09-18;0;0;0;0;0;0;0;0;0;0;0;0;0;0;0;0;0;0
FR;8;2022-09-19;0;0;0;0;0;0;0;0;0;0;0;0;0;0;0;0;0;0
FR;8;2022-09-20;0;0;0;0;0;0;0;0;0;0;0;0;0;0;0;0;0;0
FR;8;2022-09-21;0;0;0;0;0;0;0;0;0;0;0;0;0;0;0;0;0;0
FR;8;2022-09-22;0;0;0;0;0;0;0;0;0;0;0;0;0;0;0;0;0;0
FR;8;2022-09-23;0;0;0;0;0;0;0;0;0;0;0;0;0;0;0;0;0;0
FR;8;2022-09-24;0;0;0;0;0;0;0;0;0;0;0;0;0;0;0;0;0;0
FR;8;2022-09-25;0;0;0;0;0;0;0;0;0;0;0;0;0;0;0;0;0;0
FR;8;2022-09-26;0;0;0;0;0;0;0;0;0;0;0;0;0;0;0;0;0;0
FR;8;2022-09-27;0;0;0;0;0;0;0;0;0;0;0;0;0;0;0;0;0;0
FR;8;2022-09-28;0;0;0;0;0;0;0;0;0;0;0;0;0;0;0;0;0;0
FR;8;2022-09-29;0;0;0;0;0;0;0;0;0;0;0;0;0;0;0;0;0;0
FR;8;2022-09-30;0;0;0;0;0;0;0;0;0;0;0;0;0;0;0;0;0;0
FR;8;2022-10-01;0;0;0;0;0;0;0;0;0;0;0;0;0;0;0;0;0;0
FR;8;2022-10-02;0;0;0;0;0;0;0;0;0;0;0;0;0;0;0;0;0;0
FR;8;2022-10-03;0;0;0;0;0;0;0;0;0;0;0;0;0;0;0;0;0;0
FR;8;2022-10-04;0;0;0;0;0;0;0;0;0;0;0;0;0;0;0;0;0;0
FR;8;2022-10-05;0;0;0;0;0;0;0;0;0;0;0;0;0;0;0;0;0;0
FR;8;2022-10-06;14;17;113;861;8;83;866;1059;110;14;17;113;861;8;83;866;1059;110
FR;8;2022-10-07;75;103;843;8012;63;700;8066;9846;1073;89;120;956;8873;71;783;8932;10905;1183
FR;8;2022-10-08;37;115;610;4057;50;516;4109;5310;676;126;235;1566;12930;121;1299;13041;16215;1859
FR;8;2022-10-09;17;22;145;885;13;132;913;1234;185;143;257;1711;13815;134;1431;13954;17449;2044
FR;8;2022-10-10;131;192;1351;12751;106;1044;12982;16301;2253;274;449;3062;26566;240;2475;26936;33750;4297
FR;8;2022-10-11;205;264;2477;26940;136;2013;27211;33985;4723;479;713;5539;53506;376;4488;54147;67735;9020
FR;8;2022-10-12;165;258;1831;18238;152;1441;18474;23475;3536;644;971;7370;71744;528;5929;72621;91210;12556
FR;8;2022-10-13;209;281;2512;28079;178;1905;28443;35582;5206;853;1252;9882;99823;706;7834;101064;126792;17762
FR;8;2022-10-14;257;419;3272;36247;241;2557;36672;45578;6307;1110;1671;13154;136070;947;10391;137736;172370;24069
FR;8;2022-10-15;105;182;1203;8806;79;1002;8932;11783;1829;1215;1853;14357;144876;1026;11393;146668;184153;25898
FR;8;2022-10-16;36;54;248;1522;26;215;1557;2179;402;1251;1907;14605;146398;1052;11608;148225;186332;26300
FR;8;2022-10-17;159;313;2101;21806;175;1631;22113;28301;4535;1410;2220;16706;168204;1227;13239;170338;214633;30835
FR;8;2022-10-18;276;350;3356;37862;227;2654;38245;50787;9815;1686;2570;20062;206066;1454;15893;208583;265420;40650
FR;8;2022-10-19;205;314;2632;28301;183;2188;28629;38749;7871;1891;2884;22694;234367;1637;18081;237212;304169;48521
FR;8;2022-10-20;257;368;3577;41211;229;2653;41816;55722;11168;2148;3252;26271;275578;1866;20734;279028;359891;59689
FR;8;2022-10-21;325;489;4461;49420;276;3475;50019;66310;12717;2473;3741;30732;324998;2142;24209;329047;426201;72406
FR;8;2022-10-22;127;168;1230;10665;111;927;10851;14746;2949;2600;3909;31962;335663;2253;25136;339898;440947;75355
FR;8;2022-10-23;50;53;266;1762;48;197;1841;2610;571;2650;3962;32228;337425;2301;25333;341739;443557;75926
FR;8;2022-10-24;231;312;2475;24047;175;2074;24345;33555;7085;2881;4274;34703;361472;2476;27407;366084;477112;83011
FR;8;2022-10-25;307;417;4082;43467;257;3138;44066;61317;14010;3188;4691;38785;404939;2733;30545;410150;538429;97021
FR;8;2022-10-26;228;343;2885;28761;187;2381;29040;41472;9963;3416;5034;41670;433700;2920;32926;439190;579901;106984
FR;8;2022-10-27;277;415;3330;36200;243;2636;36676;51266;11889;3693;5449;45000;469900;3163;35562;475866;631167;118873
FR;8;2022-10-28;329;466;3829;39480;259;2864;40203;55137;12001;4022;5915;48829;509380;3422;38426;516069;686304;130874
FR;8;2022-10-29;113;165;1074;8230;94;803;8374;11861;2667;4135;6080;49903;517610;3516;39229;524443;698165;133541
FR;8;2022-10-30;40;53;210;1348;38;180;1394;2063;485;4175;6133;50113;518958;3554;39409;525837;700228;134026
FR;8;2022-10-31;196;260;1665;14543;145;1277;14808;21209;5106;4371;6393;51778;533501;3699;40686;540645;721437;139132
FR;8;2022-11-01;51;43;137;963;25;171;978;1626;474;4422;6436;51915;534464;3724;40857;541623;723063;139606
FR;8;2022-11-02;207;371;2377;23320;206;1982;23716;35076;9311;4629;6807;54292;557784;3930;42839;565339;758139;148917
FR;8;2022-11-03;310;419;3487;36970;260;2604;37615;54694;14376;4939;7226;57779;594754;4190;45443;602954;812833;163293
FR;8;2022-11-04;357;497;3784;40211;262;2976;40734;58003;14182;5296;7723;61563;634965;4452;48419;643688;870836;177475
FR;8;2022-11-05;113;189;1103;8770;123;850;8937;12893;3071;5409;7912;62666;643735;4575;49269;652625;883729;180546
FR;8;2022-11-06;45;56;224;1410;38;205;1443;2252;594;5454;7968;62890;645145;4613;49474;654068;885981;181140
FR;8;2022-11-07;276;281;2324;24845;210;1799;25433;37636;10336;5730;8249;65214;669990;4823;51273;679501;923617;191476
FR;8;2022-11-08;382;508;4340;48423;308;3274;49405;71666;18825;6112;8757;69554;718413;5131;54547;728906;995283;210301
FR;8;2022-11-09;269;370;2879;29183;212;2263;29868;44486;12271;6381;9127;72433;747596;5343;56810;758774;1039769;222572
FR;8;2022-11-10;373;549;3959;40303;317;3036;41214;60602;16212;6754;9676;76392;787899;5660;59846;799988;1100371;238784
FR;8;2022-11-11;40;67;243;1480;38;204;1526;2676;933;6794;9743;76635;789379;5698;60050;801514;1103047;239717
FR;8;2022-11-12;84;166;881;6433;80;687;6636;9894;2552;6878;9909;77516;795812;5778;60737;808150;1112941;242269
FR;8;2022-11-13;36;56;213;1110;37;173;1162;1927;586;6914;9965;77729;796922;5815;60910;809312;1114868;242855
FR;8;2022-11-14;238;307;2243;22469;169;1726;23006;35133;10326;7152;10272;79972;819391;5984;62636;832318;1150001;253181
FR;8;2022-11-15;354;432;3765;42376;266;2875;43285;64846;18552;7506;10704;83737;861767;6250;65511;875603;1214847;271733
FR;8;2022-11-16;316;353;2622;26559;222;2158;27034;41791;12514;7822;11057;86359;888326;6472;67669;902637;1256638;284247
FR;8;2022-11-17;373;431;3390;36886;293;2621;37468;56702;16514;8195;11488;89749;925212;6765;70290;940105;1313340;300761
FR;8;2022-11-18;346;468;4074;42329;290;2978;43183;63704;17439;8541;11956;93823;967541;7055;73268;983288;1377044;318200
FR;8;2022-11-19;121;183;1198;8974;122;844;9156;13839;3801;8662;12139;95021;976515;7177;74112;992444;1390883;322001
FR;8;2022-11-20;35;55;260;1585;39;217;1653;2663;788;8697;12194;95281;978100;7216;74329;994097;1393546;322789
FR;8;2022-11-21;218;303;2078;20129;178;1601;20661;32199;9870;8915;12497;97359;998229;7394;75930;1014758;1425745;332659
FR;8;2022-11-22;338;409;3477;37571;252;2675;38088;58212;17338;9253;12906;100836;1035800;7646;78605;1052846;1483957;349997
FR;8;2022-11-23;234;327;2415;24442;192;2018;24872;39254;12282;9487;13233;103251;1060242;7838;80623;1077718;1523211;362279
FR;8;2022-11-24;352;391;3373;34921;238;2581;35610;55387;17097;9839;13624;106624;1095163;8076;83204;1113328;1578598;379376
FR;8;2022-11-25;311;428;3633;37739;291;2625;38537;57858;16572;10150;14052;110257;1132902;8367;85829;1151865;1636456;395948
FR;8;2022-11-26;172;195;1177;8819;127;898;8976;13689;3784;10322;14247;111434;1141721;8494;86727;1160841;1650145;399732
FR;8;2022-11-27;45;43;227;1545;38;180;1561;2472;721;10367;14290;111661;1143266;8532;86907;1162402;1652617;400453
FR;8;2022-11-28;184;301;2309;23393;172;1703;24057;37350;11516;10551;14591;113970;1166659;8704;88610;1186459;1689967;411969
FR;8;2022-11-29;293;430;3979;44097;218;2945;44783;69197;21346;10844;15021;117949;1210756;8922;91555;1231242;1759164;433315
FR;8;2022-11-30;284;415;3377;34889;232;2545;35653;54727;16411;11128;15436;121326;1245645;9154;94100;1266895;1813891;449726
FR;8;2022-12-01;334;476;4478;49383;274;3132;50162;77763;24306;11462;15912;125804;1295028;9428;97232;1317057;1891654;474032
FR;8;2022-12-02;410;522;5439;58456;308;3743;59633;89824;26258;11872;16434;131243;1353484;9736;100975;1376690;1981478;500290
FR;8;2022-12-03;178;223;1918;16861;113;1328;17273;25844;7207;12050;16657;133161;1370345;9849;102303;1393963;2007322;507497
FR;8;2022-12-04;54;90;489;4056;59;404;4116;6288;1756;12104;16747;133650;1374401;9908;102707;1398079;2013610;509253
FR;8;2022-12-05;301;407;3850;42365;250;2517;43288;66943;20989;12405;17154;137500;1416766;10158;105224;1441367;2080553;530242
FR;8;2022-12-06;435;555;6301;74330;314;4215;75753;117968;37754;12840;17709;143801;1491096;10472;109439;1517120;2198521;567996
FR;8;2022-12-07;367;438;4909;55038;266;3244;56128;87718;28151;13207;18147;148710;1546134;10738;112683;1573248;2286239;596147
FR;8;2022-12-08;454;541;6447;75454;299;4197;77036;120481;38987;13661;18688;155157;1621588;11037;116880;1650284;2406720;635134
FR;8;2022-12-09;546;609;8021;90910;361;5216;92679;143047;44882;14207;19297;163178;1712498;11398;122096;1742963;2549767;680016
FR;8;2022-12-10;264;375;3341;31718;242;2089;32564;48738;13994;14471;19672;166519;1744216;11640;124185;1775527;2598505;694010
FR;8;2022-12-11;90;109;938;7866;70;645;8085;11895;3145;14561;19781;167457;1752082;11710;124830;1783612;2610400;697155
FR;8;2022-12-12;356;465;5859;64351;256;3730;65862;103407;33617;14917;20246;173316;1816433;11966;128560;1849474;2713807;730772
FR;8;2022-12-13;541;611;8431;99134;360;5207;101573;160255;53140;15458;20857;181747;1915567;12326;133767;1951047;2874062;783912
FR;8;2022-12-14;460;535;6363;70058;308;4213;71642;113505;37380;15918;21392;188110;1985625;12634;137980;2022689;2987567;821292
FR;8;2022-12-15;494;663;8161;91749;378;5142;93960;149264;49821;16412;22055;196271;2077374;13012;143122;2116649;3136831;871113
FR;8;2022-12-16;580;714;8876;100322;390;5709;102452;161945;53409;16992;22769;205147;2177696;13402;148831;2219101;3298776;924522
FR;8;2022-12-17;235;309;3145;30075;192;2004;30844;46784;13831;17227;23078;208292;2207771;13594;150835;2249945;3345560;938353
FR;8;2022-12-18;63;94;732;5975;50;499;6124;9309;2657;17290;23172;209024;2213746;13644;151334;2256069;3354869;941010
FR;8;2022-12-19;402;453;5344;53774;265;3368;55337;87778;28891;17692;23625;214368;2267520;13909;154702;2311406;3442647;969901
FR;8;2022-12-20;556;584;7347;76591;351;4755;78688;127125;43354;18248;24209;221715;2344111;14260;159457;2390094;3569772;1013255
FR;8;2022-12-21;428;482;4970;48810;288;3325;50102;81793;28168;18676;24691;226685;2392921;14548;162782;2440196;3651565;1041423
FR;8;2022-12-22;465;526;4589;44284;317;3188;45504;74796;25949;19141;25217;231274;2437205;14865;165970;2485700;3726361;1067372
FR;8;2022-12-23;321;391;2886;25049;254;2101;25697;42333;14417;19462;25608;234160;2462254;15119;168071;2511397;3768694;1081789
FR;8;2022-12-24;70;70;395;2551;41;295;2665;4151;1174;19532;25678;234555;2464805;15160;168366;2514062;3772845;1082963
FR;8;2022-12-25;29;30;106;546;22;84;567;914;260;19561;25708;234661;2465351;15182;168450;2514629;3773759;1083223
FR;8;2022-12-26;245;278;2158;16092;180;1508;16705;26812;8504;19806;25986;236819;2481443;15362;169958;2531334;3800571;1091727
FR;8;2022-12-27;393;453;3776;32422;265;2534;33517;55333;19135;20199;26439;240595;2513865;15627;172492;2564851;3855904;1110862
FR;8;2022-12-28;345;343;2942;24667;192;2056;25255;41768;14337;20544;26782;243537;2538532;15819;174548;2590106;3897672;1125199
FR;8;2022-12-29;298;409;3159;25513;227;2187;26465;43973;15191;20842;27191;246696;2564045;16046;176735;2616571;3941645;1140390
FR;8;2022-12-30;300;345;2445;18677;218;1703;19319;31742;10612;21142;27536;249141;2582722;16264;178438;2635890;3973387;1151002
FR;8;2022-12-31;92;117;453;2962;75;364;3105;4758;1269;21234;27653;249594;2585684;16339;178802;2638995;3978145;1152271
FR;8;2023-01-01;17;30;112;661;14;85;684;995;225;21251;27683;249706;2586345;16353;178887;2639679;3979140;1152496
FR;8;2023-01-02;281;414;2267;18226;245;1615;18686;32080;11694;21532;28097;251973;2604571;16598;180502;2658365;4011220;1164190
FR;8;2023-01-03;476;547;4251;42808;327;2915;43724;80860;33898;22008;28644;256224;2647379;16925;183417;2702089;4092080;1198088
FR;8;2023-01-04;415;480;3495;29986;297;2426;30741;58281;24927;22423;29124;259719;2677365;17222;185843;2732830;4150361;1223015
FR;8;2023-01-05;504;599;4370;41821;400;2934;42712;82017;36051;22927;29723;264089;2719186;17622;188777;2775542;4232378;1259066
FR;8;2023-01-06;518;671;5108;46738;406;3346;47750;89695;38268;23445;30394;269197;2765924;18028;192123;2823292;4322073;1297334
FR;8;2023-01-07;219;290;1704;12303;183;1199;12617;22351;8435;23664;30684;270901;2778227;18211;193322;2835909;4344424;1305769
FR;8;2023-01-08;68;105;443;2744;64;312;2839;5094;1926;23732;30789;271344;2780971;18275;193634;2838748;4349518;1307695
FR;8;2023-01-09;405;482;2622;21492;315;1853;22055;44594;20466;24137;31271;273966;2802463;18590;195487;2860803;4394112;1328161
FR;8;2023-01-10;463;637;4349;40174;399;3067;40939;85043;40653;24600;31908;278315;2842637;18989;198554;2901742;4479155;1368814
FR;8;2023-01-11;350;461;2950;24116;287;2117;24626;51486;24451;24950;32369;281265;2866753;19276;200671;2926368;4530641;1393265
FR;8;2023-01-12;411;543;3657;33168;333;2574;33791;70822;34087;25361;32912;284922;2899921;19609;203245;2960159;4601463;1427352
FR;8;2023-01-13;449;590;4049;34892;340;2863;35505;72885;34138;25810;33502;288971;2934813;19949;206108;2995664;4674348;1461490
FR;8;2023-01-14;178;229;1343;8860;123;959;9043;17188;7106;25988;33731;290314;2943673;20072;207067;3004707;4691536;1468596
FR;8;2023-01-15;63;88;329;1479;54;244;1585;3186;1345;26051;33819;290643;2945152;20126;207311;3006292;4694722;1469941
FR;8;2023-01-16;267;340;1997;15750;199;1433;16011;35209;17562;26318;34159;292640;2960902;20325;208744;3022303;4729931;1487503
FR;8;2023-01-17;360;454;3248;28164;282;2321;28672;64507;33107;26678;34613;295888;2989066;20607;211065;3050975;4794438;1520610
FR;8;2023-01-18;266;407;2192;16822;247;1669;17066;38334;19344;26944;35020;298080;3005888;20854;212734;3068041;4832772;1539954
FR;8;2023-01-19;355;415;2667;22306;253;1950;22654;51220;26244;27299;35435;300747;3028194;21107;214684;3090695;4883992;1566198
FR;8;2023-01-20;406;508;3175;24804;309;2340;25286;56594;28587;27705;35943;303922;3052998;21416;217024;3115981;4940586;1594785
FR;8;2023-01-21;147;189;1004;6114;102;732;6241;12899;5829;27852;36132;304926;3059112;21518;217756;3122222;4953485;1600614
FR;8;2023-01-22;31;52;156;833;23;138;878;1880;844;27883;36184;305082;3059945;21541;217894;3123100;4955365;1601458
FR;8;2023-01-23;215;299;1588;10614;163;1162;10834;26665;14421;28098;36483;306670;3070559;21704;219056;3133934;4982030;1615879
FR;8;2023-01-24;305;419;2408;20004;250;1795;20265;49919;27441;28403;36902;309078;3090563;21954;220851;3154199;5031949;1643320
FR;8;2023-01-25;241;378;1800;12091;230;1324;12493;29960;15877;28644;37280;310878;3102654;22184;222175;3166692;5061909;1659197
FR;8;2023-01-26;299;384;2222;16489;263;1642;16766;41541;22742;28943;37664;313100;3119143;22447;223817;3183458;5103450;1681939
FR;8;2023-01-27;312;493;2459;17869;298;1841;18105;44184;23814;29255;38157;315559;3137012;22745;225658;3201563;5147634;1705753
FR;8;2023-01-28;125;187;767;4327;124;600;4442;9722;4591;29380;38344;316326;3141339;22869;226258;3206005;5157356;1710344
FR;8;2023-01-29;26;43;86;438;28;67;470;1058;513;29406;38387;316412;3141777;22897;226325;3206475;5158414;1710857
FR;8;2023-01-30;208;314;1227;7966;186;1012;8130;20458;11067;29614;38701;317639;3149743;23083;227337;3214605;5178872;1721924
FR;8;2023-01-31;272;382;1917;13605;235;1420;13840;36258;20707;29886;39083;319556;3163348;23318;228757;3228445;5215130;1742631
FR;8;2023-02-01;247;347;1332;8018;226;1089;8140;21705;12198;30133;39430;320888;3171366;23544;229846;3236585;5236835;1754829
FR;8;2023-02-02;257;385;1572;11467;234;1281;11688;31056;17725;30390;39815;322460;3182833;23778;231127;3248273;5267891;1772554
FR;8;2023-02-03;279;448;1847;12109;286;1437;12291;32952;18843;30669;40263;324307;3194942;24064;232564;3260564;5300843;1791397
FR;8;2023-02-04;118;159;568;2956;110;461;2998;7188;3658;30787;40422;324875;3197898;24174;233025;3263562;5308031;1795055
FR;8;2023-02-05;10;53;66;224;31;61;239;572;264;30797;40475;324941;3198122;24205;233086;3263801;5308603;1795319
FR;8;2023-02-06;186;242;942;5174;170;702;5359;15012;8719;30983;40717;325883;3203296;24375;233788;3269160;5323615;1804038
FR;8;2023-02-07;234;392;1458;9433;266;1184;9588;27597;16416;31217;41109;327341;3212729;24641;234972;3278748;5351212;1820454
FR;8;2023-02-08;173;250;1019;5851;171;808;5993;16567;9485;31390;41359;328360;3218580;24812;235780;3284741;5367779;1829939
FR;8;2023-02-09;235;384;1175;7553;246;983;7737;22240;13192;31625;41743;329535;3226133;25058;236763;3292478;5390019;1843131
FR;8;2023-02-10;277;365;1400;7956;247;1158;8090;23131;13501;31902;42108;330935;3234089;25305;237921;3300568;5413150;1856632
FR;8;2023-02-11;88;145;470;2015;100;402;2092;5228;2665;31990;42253;331405;3236104;25405;238323;3302660;5418378;1859297
FR;8;2023-02-12;26;31;51;166;25;45;187;428;189;32016;42284;331456;3236270;25430;238368;3302847;5418806;1859486
FR;8;2023-02-13;131;206;671;3168;129;607;3263;9302;5295;32147;42490;332127;3239438;25559;238975;3306110;5428108;1864781
FR;8;2023-02-14;192;264;1062;5707;160;891;5854;17116;10073;32339;42754;333189;3245145;25719;239866;3311964;5445224;1874854
FR;8;2023-02-15;164;255;847;3876;146;726;4048;11821;6845;32503;43009;334036;3249021;25865;240592;3316012;5457045;1881699
FR;8;2023-02-16;168;308;1001;4918;175;855;5061;14622;8456;32671;43317;335037;3253939;26040;241447;3321073;5471667;1890155
FR;8;2023-02-17;227;318;1101;5202;224;941;5425;15938;9313;32898;43635;336138;3259141;26264;242388;3326498;5487605;1899468
FR;8;2023-02-18;95;130;395;1492;86;312;1566;3913;1979;32993;43765;336533;3260633;26350;242700;3328064;5491518;1901447
FR;8;2023-02-19;22;36;43;132;31;35;135;333;159;33015;43801;336576;3260765;26381;242735;3328199;5491851;1901606
FR;8;2023-02-20;140;257;639;2680;161;593;2795;8202;4667;33155;44058;337215;3263445;26542;243328;3330994;5500053;1906273
FR;8;2023-02-21;178;307;966;4294;163;840;4497;13574;7960;33333;44365;338181;3267739;26705;244168;3335491;5513627;1914233
FR;8;2023-02-22;157;257;664;2774;173;622;2816;8653;5047;33490;44622;338845;3270513;26878;244790;3338307;5522280;1919280
FR;8;2023-02-23;151;262;826;3782;154;739;3963;11869;6888;33641;44884;339671;3274295;27032;245529;3342270;5534149;1926168
FR;8;2023-02-24;158;311;953;4116;191;829;4305;12438;7065;33799;45195;340624;3278411;27223;246358;3346575;5546587;1933233
FR;8;2023-02-25;58;102;346;1059;69;276;1114;2946;1498;33857;45297;340970;3279470;27292;246634;3347689;5549533;1934731
FR;8;2023-02-26;14;21;31;95;22;28;108;249;106;33871;45318;341001;3279565;27314;246662;3347797;5549782;1934837
FR;8;2023-02-27;92;223;506;1829;154;481;1898;6241;3725;33963;45541;341507;3281394;27468;247143;3349695;5556023;1938562
FR;8;2023-02-28;158;257;759;3343;153;717;3476;11643;7145;34121;45798;342266;3284737;27621;247860;3353171;5567666;1945707
FR;8;2023-03-01;130;195;522;1831;145;460;1983;6238;3648;34251;45993;342788;3286568;27766;248320;3355154;5573904;1949355
FR;8;2023-03-02;131;220;715;2764;135;607;2956;9696;5903;34382;46213;343503;3289332;27901;248927;3358110;5583600;1955258
FR;8;2023-03-03;182;331;897;3416;220;794;3545;11310;6657;34564;46544;344400;3292748;28121;249721;3361655;5594910;1961915
FR;8;2023-03-04;58;137;311;975;83;295;981;2632;1296;34622;46681;344711;3293723;28204;250016;3362636;5597542;1963211
FR;8;2023-03-05;12;19;22;49;15;26;49;185;99;34634;46700;344733;3293772;28219;250042;3362685;5597727;1963310
FR;8;2023-03-06;119;178;414;1309;103;394;1370;4426;2524;34753;46878;345147;3295081;28322;250436;3364055;5602153;1965834
FR;8;2023-03-07;121;211;566;2160;127;523;2236;7536;4574;34874;47089;345713;3297241;28449;250959;3366291;5609689;1970408
FR;8;2023-03-08;93;177;449;1329;110;399;1417;4718;2749;34967;47266;346162;3298570;28559;251358;3367708;5614407;1973157
FR;8;2023-03-09;119;202;559;1869;123;525;1932;6760;4131;35086;47468;346721;3300439;28682;251883;3369640;5621167;1977288
FR;8;2023-03-10;201;336;773;2426;215;699;2566;8579;5074;35287;47804;347494;3302865;28897;252582;3372206;5629746;1982362
FR;8;2023-03-11;54;115;271;734;79;236;768;2152;1096;35341;47919;347765;3303599;28976;252818;3372974;5631898;1983458
FR;8;2023-03-12;6;10;23;60;8;22;61;172;85;35347;47929;347788;3303659;28984;252840;3373035;5632070;1983543
FR;8;2023-03-13;81;138;385;991;89;344;1068;3432;1930;35428;48067;348173;3304650;29073;253184;3374103;5635502;1985473
FR;8;2023-03-14;110;211;561;1741;125;544;1816;6400;3833;35538;48278;348734;3306391;29198;253728;3375919;5641902;1989306
FR;8;2023-03-15;105;166;408;1101;117;371;1175;4069;2375;35643;48444;349142;3307492;29315;254099;3377094;5645971;1991681
FR;8;2023-03-16;99;192;505;1498;124;462;1583;5578;3338;35742;48636;349647;3308990;29439;254561;3378677;5651549;1995019
FR;8;2023-03-17;141;222;646;1834;136;563;1981;6835;4046;35883;48858;350293;3310824;29575;255124;3380658;5658384;1999065
FR;8;2023-03-18;75;111;272;528;70;258;587;1850;944;35958;48969;350565;3311352;29645;255382;3381245;5660234;2000009
FR;8;2023-03-19;3;15;24;45;15;12;52;116;49;35961;48984;350589;3311397;29660;255394;3381297;5660350;2000058
FR;8;2023-03-20;85;171;405;923;95;402;1005;3514;1976;36046;49155;350994;3312320;29755;255796;3382302;5663864;2002034
FR;8;2023-03-21;126;202;570;1509;119;547;1680;6105;3632;36172;49357;351564;3313829;29874;256343;3383982;5669969;2005666
FR;8;2023-03-22;118;158;396;936;106;370;1050;3636;2090;36290;49515;351960;3314765;29980;256713;3385032;5673605;2007756
FR;8;2023-03-23;89;161;515;1284;90;458;1371;4884;2846;36379;49676;352475;3316049;30070;257171;3386403;5678489;2010602
FR;8;2023-03-24;145;265;696;1618;157;635;1789;6233;3553;36524;49941;353171;3317667;30227;257806;3388192;5684722;2014155
FR;8;2023-03-25;60;94;274;491;71;240;545;1616;760;36584;50035;353445;3318158;30298;258046;3388737;5686338;2014915
FR;8;2023-03-26;6;9;16;30;8;13;30;83;38;36590;50044;353461;3318188;30306;258059;3388767;5686421;2014953
FR;8;2023-03-27;111;171;407;789;125;386;877;3126;1741;36701;50215;353868;3318977;30431;258445;3389644;5689547;2016694
FR;8;2023-03-28;110;179;529;1454;96;487;1587;5803;3446;36811;50394;354397;3320431;30527;258932;3391231;5695350;2020140
FR;8;2023-03-29;90;168;371;891;87;363;1028;3547;1968;36901;50562;354768;3321322;30614;259295;3392259;5698897;2022108
FR;8;2023-03-30;101;172;486;1252;88;480;1396;5065;2891;37002;50734;355254;3322574;30702;259775;3393655;5703962;2024999
FR;8;2023-03-31;129;248;641;1623;166;559;1764;6387;3699;37131;50982;355895;3324197;30868;260334;3395419;5710349;2028698
FR;8;2023-04-01;58;106;283;537;52;242;625;1831;870;37189;51088;356178;3324734;30920;260576;3396044;5712180;2029568
FR;8;2023-04-02;5;21;20;34;12;26;36;106;44;37194;51109;356198;3324768;30932;260602;3396080;5712286;2029612
FR;8;2023-04-03;77;140;362;738;91;333;834;2947;1611;37271;51249;356560;3325506;31023;260935;3396914;5715233;2031223
FR;8;2023-04-04;77;180;464;1107;119;391;1260;4901;2891;37348;51429;357024;3326613;31142;261326;3398174;5720134;2034114
FR;8;2023-04-05;69;134;345;732;85;332;820;3160;1799;37417;51563;357369;3327345;31227;261658;3398994;5723294;2035913
FR;8;2023-04-06;92;119;368;954;75;334;1062;3941;2246;37509;51682;357737;3328299;31302;261992;3400056;5727235;2038159
FR;8;2023-04-07;120;215;490;1163;131;452;1284;4646;2588;37629;51897;358227;3329462;31433;262444;3401340;5731881;2040747
FR;8;2023-04-08;33;93;211;347;57;206;382;1217;538;37662;51990;358438;3329809;31490;262650;3401722;5733098;2041285
FR;8;2023-04-09;4;16;16;12;9;19;16;55;15;37666;52006;358454;3329821;31499;262669;3401738;5733153;2041300
FR;8;2023-04-10;6;12;26;27;5;26;36;91;25;37672;52018;358480;3329848;31504;262695;3401774;5733244;2041325
FR;8;2023-04-11;73;174;463;884;91;457;986;4011;2200;37745;52192;358943;3330732;31595;263152;3402760;5737255;2043525
FR;8;2023-04-12;80;144;319;662;98;309;717;2970;1662;37825;52336;359262;3331394;31693;263461;3403477;5740225;2045187
FR;8;2023-04-13;67;166;360;862;100;350;948;3966;2274;37892;52502;359622;3332256;31793;263811;3404425;5744191;2047461
FR;8;2023-04-14;120;193;471;1116;129;423;1190;4839;2791;38012;52695;360093;3333372;31922;264234;3405615;5749030;2050252
FR;8;2023-04-15;32;80;197;366;42;195;393;1366;628;38044;52775;360290;3333738;31964;264429;3406008;5750396;2050880
FR;8;2023-04-16;14;14;12;34;11;16;30;107;46;38058;52789;360302;3333772;31975;264445;3406038;5750503;2050926
FR;8;2023-04-17;56;134;285;587;71;295;680;2786;1482;38114;52923;360587;3334359;32046;264740;3406718;5753289;2052408
FR;8;2023-04-18;96;136;352;798;85;357;886;3869;2190;38210;53059;360939;3335157;32131;265097;3407604;5757158;2054598
FR;8;2023-04-19;59;92;264;552;60;240;644;2604;1369;38269;53151;361203;3335709;32191;265337;3408248;5759762;2055967
FR;8;2023-04-20;66;138;292;735;86;285;786;3226;1755;38335;53289;361495;3336444;32277;265622;3409034;5762988;2057722
FR;8;2023-04-21;85;178;390;897;97;389;1014;4010;2114;38420;53467;361885;3337341;32374;266011;3410048;5766998;2059836
FR;8;2023-04-22;26;69;134;234;42;145;257;1016;496;38446;53536;362019;3337575;32416;266156;3410305;5768014;2060332
FR;8;2023-04-23;2;5;12;16;4;12;19;60;21;38448;53541;362031;3337591;32420;266168;3410324;5768074;2060353
FR;8;2023-04-24;70;115;246;483;68;231;560;2192;1101;38518;53656;362277;3338074;32488;266399;3410884;5770266;2061454
FR;8;2023-04-25;81;133;322;749;84;333;798;3764;2034;38599;53789;362599;3338823;32572;266732;3411682;5774030;2063488
FR;8;2023-04-26;56;97;245;451;75;237;515;2347;1196;38655;53886;362844;3339274;32647;266969;3412197;5776377;2064684
FR;8;2023-04-27;87;117;286;709;70;293;802;3452;1825;38742;54003;363130;3339983;32717;267262;3412999;5779829;2066509
FR;8;2023-04-28;110;195;362;767;101;381;877;3954;1984;38852;54198;363492;3340750;32818;267643;3413876;5783783;2068493
FR;8;2023-04-29;51;59;127;235;42;118;274;1001;459;38903;54257;363619;3340985;32860;267761;3414150;5784784;2068952
FR;8;2023-04-30;1;7;10;10;3;9;11;63;34;38904;54264;363629;3340995;32863;267770;3414161;5784847;2068986
FR;8;2023-05-01;13;6;13;10;3;13;13;62;21;38917;54270;363642;3341005;32866;267783;3414174;5784909;2069007
FR;8;2023-05-02;92;148;312;576;89;306;680;3247;1661;39009;54418;363954;3341581;32955;268089;3414854;5788156;2070668
FR;8;2023-05-03;77;94;218;429;66;217;475;2522;1272;39086;54512;364172;3342010;33021;268306;3415329;5790678;2071940
FR;8;2023-05-04;67;121;264;675;82;320;703;3768;1927;39153;54633;364436;3342685;33103;268626;3416032;5794446;2073867
FR;8;2023-05-05;90;156;306;723;89;348;803;4143;2168;39243;54789;364742;3343408;33192;268974;3416835;5798589;2076035
FR;8;2023-05-06;53;55;108;220;38;122;232;1019;475;39296;54844;364850;3343628;33230;269096;3417067;5799608;2076510
FR;8;2023-05-07;4;5;7;17;3;7;19;83;31;39300;54849;364857;3343645;33233;269103;3417086;5799691;2076541
FR;8;2023-05-08;12;9;15;17;7;17;36;123;61;39312;54858;364872;3343662;33240;269120;3417122;5799814;2076602
FR;8;2023-05-09;66;94;204;495;68;214;551;3209;1599;39378;54952;365076;3344157;33308;269334;3417673;5803023;2078201
FR;8;2023-05-10;65;89;179;472;64;217;512;3071;1447;39443;55041;365255;3344629;33372;269551;3418185;5806094;2079648
FR;8;2023-05-11;63;80;205;606;59;193;682;3760;1839;39506;55121;365460;3345235;33431;269744;3418867;5809854;2081487
FR;8;2023-05-12;69;93;235;696;63;240;731;4158;1955;39575;55214;365695;3345931;33494;269984;3419598;5814012;2083442
FR;8;2023-05-13;29;45;98;190;28;106;208;933;384;39604;55259;365793;3346121;33522;270090;3419806;5814945;2083826
FR;8;2023-05-14;3;12;6;14;7;10;15;81;29;39607;55271;365799;3346135;33529;270100;3419821;5815026;2083855
FR;8;2023-05-15;40;65;157;436;40;145;479;3059;1430;39647;55336;365956;3346571;33569;270245;3420300;5818085;2085285
FR;8;2023-05-16;65;116;202;792;78;218;933;5734;2686;39712;55452;366158;3347363;33647;270463;3421233;5823819;2087971
FR;8;2023-05-17;63;75;187;466;44;184;517;3005;1329;39775;55527;366345;3347829;33691;270647;3421750;5826824;2089300
FR;8;2023-05-18;3;5;8;25;3;10;25;160;65;39778;55532;366353;3347854;33694;270657;3421775;5826984;2089365
FR;8;2023-05-19;56;99;174;446;64;170;500;2671;1125;39834;55631;366527;3348300;33758;270827;3422275;5829655;2090490
FR;8;2023-05-20;32;31;86;110;21;79;123;776;303;39866;55662;366613;3348410;33779;270906;3422398;5830431;2090793
FR;8;2023-05-21;5;6;5;14;7;5;15;141;43;39871;55668;366618;3348424;33786;270911;3422413;5830572;2090836
FR;8;2023-05-22;42;42;134;442;33;133;500;3066;1373;39913;55710;366752;3348866;33819;271044;3422913;5833638;2092209
FR;8;2023-05-23;34;58;168;586;42;153;696;4523;2061;39947;55768;366920;3349452;33861;271197;3423609;5838161;2094270
FR;8;2023-05-24;43;53;161;482;38;157;556;3158;1402;39990;55821;367081;3349934;33899;271354;3424165;5841319;2095672
FR;8;2023-05-25;56;67;158;543;51;151;622;4471;1996;40046;55888;367239;3350477;33950;271505;3424787;5845790;2097668
FR;8;2023-05-26;56;99;176;588;66;182;641;4414;2023;40102;55987;367415;3351065;34016;271687;3425428;5850204;2099691
FR;8;2023-05-27;20;42;65;128;23;69;151;804;375;40122;56029;367480;3351193;34039;271756;3425579;5851008;2100066
FR;8;2023-05-28;2;1;3;8;2;2;14;68;32;40124;56030;367483;3351201;34041;271758;3425593;5851076;2100098
FR;8;2023-05-29;4;3;7;32;2;8;44;304;118;40128;56033;367490;3351233;34043;271766;3425637;5851380;2100216
FR;8;2023-05-30;45;74;130;559;47;136;667;4264;1787;40173;56107;367620;3351792;34090;271902;3426304;5855644;2102003
FR;8;2023-05-31;41;72;112;468;45;124;541;3315;1466;40214;56179;367732;3352260;34135;272026;3426845;5858959;2103469
FR;8;2023-06-01;56;71;148;546;49;160;642;4519;1839;40270;56250;367880;3352806;34184;272186;3427487;5863478;2105308
FR;8;2023-06-02;51;89;171;562;53;190;662;4743;2099;40321;56339;368051;3353368;34237;272376;3428149;5868221;2107407
FR;8;2023-06-03;17;38;63;143;20;68;157;960;377;40338;56377;368114;3353511;34257;272444;3428306;5869181;2107784
FR;8;2023-06-04;2;5;5;11;2;8;14;110;30;40340;56382;368119;3353522;34259;272452;3428320;5869291;2107814
FR;8;2023-06-05;49;70;144;514;50;172;581;3990;1648;40389;56452;368263;3354036;34309;272624;3428901;5873281;2109462
FR;8;2023-06-06;68;88;205;717;68;234;820;6583;2744;40457;56540;368468;3354753;34377;272858;3429721;5879864;2112206
FR;8;2023-06-07;36;65;128;487;44;118;527;3683;1520;40493;56605;368596;3355240;34421;272976;3430248;5883547;2113726
FR;8;2023-06-08;49;67;175;690;51;184;790;5779;2392;40542;56672;368771;3355930;34472;273160;3431038;5889326;2116118
FR;8;2023-06-09;44;94;172;539;74;175;587;4705;1939;40586;56766;368943;3356469;34546;273335;3431625;5894031;2118057
FR;8;2023-06-10;18;31;51;122;22;51;144;859;333;40604;56797;368994;3356591;34568;273386;3431769;5894890;2118390
FR;8;2023-06-11;1;5;4;14;5;5;17;138;58;40605;56802;368998;3356605;34573;273391;3431786;5895028;2118448
FR;8;2023-06-12;33;80;148;506;61;152;562;4332;1802;40638;56882;369146;3357111;34634;273543;3432348;5899360;2120250
FR;8;2023-06-13;46;53;212;720;42;185;850;6303;2634;40684;56935;369358;3357831;34676;273728;3433198;5905663;2122884
FR;8;2023-06-14;33;70;118;492;54;134;549;4018;1736;40717;57005;369476;3358323;34730;273862;3433747;5909681;2124620
FR;8;2023-06-15;43;47;159;566;36;162;652;5233;2238;40760;57052;369635;3358889;34766;274024;3434399;5914914;2126858
FR;8;2023-06-16;51;65;164;598;51;140;631;4982;2079;40811;57117;369799;3359487;34817;274164;3435030;5919896;2128937
FR;8;2023-06-17;12;25;42;88;16;48;106;749;271;40823;57142;369841;3359575;34833;274212;3435136;5920645;2129208
FR;8;2023-06-18;2;5;4;17;5;7;17;111;53;40825;57147;369845;3359592;34838;274219;3435153;5920756;2129261
FR;8;2023-06-19;33;33;118;349;20;124;445;3082;1191;40858;57180;369963;3359941;34858;274343;3435598;5923838;2130452
FR;9;2020-12-27;0;0;0;0;0;0;0;0;0;0;0;0;0;0;0;0;0;0
FR;9;2020-12-28;0;0;0;0;0;0;0;0;0;0;0;0;0;0;0;0;0;0
FR;9;2020-12-29;0;0;0;0;0;0;0;0;0;0;0;0;0;0;0;0;0;0
FR;9;2020-12-30;0;0;0;0;0;0;0;0;0;0;0;0;0;0;0;0;0;0
FR;9;2020-12-31;0;0;0;0;0;0;0;0;0;0;0;0;0;0;0;0;0;0
FR;9;2021-01-01;0;0;0;0;0;0;0;0;0;0;0;0;0;0;0;0;0;0
FR;9;2021-01-02;0;0;0;0;0;0;0;0;0;0;0;0;0;0;0;0;0;0
FR;9;2021-01-03;0;0;0;0;0;0;0;0;0;0;0;0;0;0;0;0;0;0
FR;9;2021-01-04;0;0;0;0;0;0;0;0;0;0;0;0;0;0;0;0;0;0
FR;9;2021-01-05;0;0;0;0;0;0;0;0;0;0;0;0;0;0;0;0;0;0
FR;9;2021-01-06;0;0;0;0;0;0;0;0;0;0;0;0;0;0;0;0;0;0
FR;9;2021-01-07;0;0;0;0;0;0;0;0;0;0;0;0;0;0;0;0;0;0
FR;9;2021-01-08;0;0;0;0;0;0;0;0;0;0;0;0;0;0;0;0;0;0
FR;9;2021-01-09;0;0;0;0;0;0;0;0;0;0;0;0;0;0;0;0;0;0
FR;9;2021-01-10;0;0;0;0;0;0;0;0;0;0;0;0;0;0;0;0;0;0
FR;9;2021-01-11;0;0;0;0;0;0;0;0;0;0;0;0;0;0;0;0;0;0
FR;9;2021-01-12;0;0;0;0;0;0;0;0;0;0;0;0;0;0;0;0;0;0
FR;9;2021-01-13;0;0;0;0;0;0;0;0;0;0;0;0;0;0;0;0;0;0
FR;9;2021-01-14;0;0;0;0;0;0;0;0;0;0;0;0;0;0;0;0;0;0
FR;9;2021-01-15;0;0;0;0;0;0;0;0;0;0;0;0;0;0;0;0;0;0
FR;9;2021-01-16;0;0;0;0;0;0;0;0;0;0;0;0;0;0;0;0;0;0
FR;9;2021-01-17;0;0;0;0;0;0;0;0;0;0;0;0;0;0;0;0;0;0
FR;9;2021-01-18;0;0;0;0;0;0;0;0;0;0;0;0;0;0;0;0;0;0
FR;9;2021-01-19;0;0;0;0;0;0;0;0;0;0;0;0;0;0;0;0;0;0
FR;9;2021-01-20;0;0;0;0;0;0;0;0;0;0;0;0;0;0;0;0;0;0
FR;9;2021-01-21;0;0;0;0;0;0;0;0;0;0;0;0;0;0;0;0;0;0
FR;9;2021-01-22;0;0;0;0;0;0;0;0;0;0;0;0;0;0;0;0;0;0
FR;9;2021-01-23;0;0;0;0;0;0;0;0;0;0;0;0;0;0;0;0;0;0
FR;9;2021-01-24;0;0;0;0;0;0;0;0;0;0;0;0;0;0;0;0;0;0
FR;9;2021-01-25;0;0;0;0;0;0;0;0;0;0;0;0;0;0;0;0;0;0
FR;9;2021-01-26;0;0;0;0;0;0;0;0;0;0;0;0;0;0;0;0;0;0
FR;9;2021-01-27;0;0;0;0;0;0;0;0;0;0;0;0;0;0;0;0;0;0
FR;9;2021-01-28;0;0;0;0;0;0;0;0;0;0;0;0;0;0;0;0;0;0
FR;9;2021-01-29;0;0;0;0;0;0;0;0;0;0;0;0;0;0;0;0;0;0
FR;9;2021-01-30;0;0;0;0;0;0;0;0;0;0;0;0;0;0;0;0;0;0
FR;9;2021-01-31;0;0;0;0;0;0;0;0;0;0;0;0;0;0;0;0;0;0
FR;9;2021-02-01;0;0;0;0;0;0;0;0;0;0;0;0;0;0;0;0;0;0
FR;9;2021-02-02;0;0;0;0;0;0;0;0;0;0;0;0;0;0;0;0;0;0
FR;9;2021-02-03;0;0;0;0;0;0;0;0;0;0;0;0;0;0;0;0;0;0
FR;9;2021-02-04;0;0;0;0;0;0;0;0;0;0;0;0;0;0;0;0;0;0
FR;9;2021-02-05;0;0;0;0;0;0;0;0;0;0;0;0;0;0;0;0;0;0
FR;9;2021-02-06;0;0;0;0;0;0;0;0;0;0;0;0;0;0;0;0;0;0
FR;9;2021-02-07;0;0;0;0;0;0;0;0;0;0;0;0;0;0;0;0;0;0
FR;9;2021-02-08;0;0;0;0;0;0;0;0;0;0;0;0;0;0;0;0;0;0
FR;9;2021-02-09;0;0;0;0;0;0;0;0;0;0;0;0;0;0;0;0;0;0
FR;9;2021-02-10;0;0;0;0;0;0;0;0;0;0;0;0;0;0;0;0;0;0
FR;9;2021-02-11;0;0;0;0;0;0;0;0;0;0;0;0;0;0;0;0;0;0
FR;9;2021-02-12;0;0;0;0;0;0;0;0;0;0;0;0;0;0;0;0;0;0
FR;9;2021-02-13;0;0;0;0;0;0;0;0;0;0;0;0;0;0;0;0;0;0
FR;9;2021-02-14;0;0;0;0;0;0;0;0;0;0;0;0;0;0;0;0;0;0
FR;9;2021-02-15;0;0;0;0;0;0;0;0;0;0;0;0;0;0;0;0;0;0
FR;9;2021-02-16;0;0;0;0;0;0;0;0;0;0;0;0;0;0;0;0;0;0
FR;9;2021-02-17;0;0;0;0;0;0;0;0;0;0;0;0;0;0;0;0;0;0
FR;9;2021-02-18;0;0;0;0;0;0;0;0;0;0;0;0;0;0;0;0;0;0
FR;9;2021-02-19;0;0;0;0;0;0;0;0;0;0;0;0;0;0;0;0;0;0
FR;9;2021-02-20;0;0;0;0;0;0;0;0;0;0;0;0;0;0;0;0;0;0
FR;9;2021-02-21;0;0;0;0;0;0;0;0;0;0;0;0;0;0;0;0;0;0
FR;9;2021-02-22;0;0;0;0;0;0;0;0;0;0;0;0;0;0;0;0;0;0
FR;9;2021-02-23;0;0;0;0;0;0;0;0;0;0;0;0;0;0;0;0;0;0
FR;9;2021-02-24;0;0;0;0;0;0;0;0;0;0;0;0;0;0;0;0;0;0
FR;9;2021-02-25;0;0;0;0;0;0;0;0;0;0;0;0;0;0;0;0;0;0
FR;9;2021-02-26;0;0;0;0;0;0;0;0;0;0;0;0;0;0;0;0;0;0
FR;9;2021-02-27;0;0;0;0;0;0;0;0;0;0;0;0;0;0;0;0;0;0
FR;9;2021-02-28;0;0;0;0;0;0;0;0;0;0;0;0;0;0;0;0;0;0
FR;9;2021-03-01;0;0;0;0;0;0;0;0;0;0;0;0;0;0;0;0;0;0
FR;9;2021-03-02;0;0;0;0;0;0;0;0;0;0;0;0;0;0;0;0;0;0
FR;9;2021-03-03;0;0;0;0;0;0;0;0;0;0;0;0;0;0;0;0;0;0
FR;9;2021-03-04;0;0;0;0;0;0;0;0;0;0;0;0;0;0;0;0;0;0
FR;9;2021-03-05;0;0;0;0;0;0;0;0;0;0;0;0;0;0;0;0;0;0
FR;9;2021-03-06;0;0;0;0;0;0;0;0;0;0;0;0;0;0;0;0;0;0
FR;9;2021-03-07;0;0;0;0;0;0;0;0;0;0;0;0;0;0;0;0;0;0
FR;9;2021-03-08;0;0;0;0;0;0;0;0;0;0;0;0;0;0;0;0;0;0
FR;9;2021-03-09;0;0;0;0;0;0;0;0;0;0;0;0;0;0;0;0;0;0
FR;9;2021-03-10;0;0;0;0;0;0;0;0;0;0;0;0;0;0;0;0;0;0
FR;9;2021-03-11;0;0;0;0;0;0;0;0;0;0;0;0;0;0;0;0;0;0
FR;9;2021-03-12;0;0;0;0;0;0;0;0;0;0;0;0;0;0;0;0;0;0
FR;9;2021-03-13;0;0;0;0;0;0;0;0;0;0;0;0;0;0;0;0;0;0
FR;9;2021-03-14;0;0;0;0;0;0;0;0;0;0;0;0;0;0;0;0;0;0
FR;9;2021-03-15;0;0;0;0;0;0;0;0;0;0;0;0;0;0;0;0;0;0
FR;9;2021-03-16;0;0;0;0;0;0;0;0;0;0;0;0;0;0;0;0;0;0
FR;9;2021-03-17;0;0;0;0;0;0;0;0;0;0;0;0;0;0;0;0;0;0
FR;9;2021-03-18;0;0;0;0;0;0;0;0;0;0;0;0;0;0;0;0;0;0
FR;9;2021-03-19;0;0;0;0;0;0;0;0;0;0;0;0;0;0;0;0;0;0
FR;9;2021-03-20;0;0;0;0;0;0;0;0;0;0;0;0;0;0;0;0;0;0
FR;9;2021-03-21;0;0;0;0;0;0;0;0;0;0;0;0;0;0;0;0;0;0
FR;9;2021-03-22;0;0;0;0;0;0;0;0;0;0;0;0;0;0;0;0;0;0
FR;9;2021-03-23;0;0;0;0;0;0;0;0;0;0;0;0;0;0;0;0;0;0
FR;9;2021-03-24;0;0;0;0;0;0;0;0;0;0;0;0;0;0;0;0;0;0
FR;9;2021-03-25;0;0;0;0;0;0;0;0;0;0;0;0;0;0;0;0;0;0
FR;9;2021-03-26;0;0;0;0;0;0;0;0;0;0;0;0;0;0;0;0;0;0
FR;9;2021-03-27;0;0;0;0;0;0;0;0;0;0;0;0;0;0;0;0;0;0
FR;9;2021-03-28;0;0;0;0;0;0;0;0;0;0;0;0;0;0;0;0;0;0
FR;9;2021-03-29;0;0;0;0;0;0;0;0;0;0;0;0;0;0;0;0;0;0
FR;9;2021-03-30;0;0;0;0;0;0;0;0;0;0;0;0;0;0;0;0;0;0
FR;9;2021-03-31;0;0;0;0;0;0;0;0;0;0;0;0;0;0;0;0;0;0
FR;9;2021-04-01;0;0;0;0;0;0;0;0;0;0;0;0;0;0;0;0;0;0
FR;9;2021-04-02;0;0;0;0;0;0;0;0;0;0;0;0;0;0;0;0;0;0
FR;9;2021-04-03;0;0;0;0;0;0;0;0;0;0;0;0;0;0;0;0;0;0
FR;9;2021-04-04;0;0;0;0;0;0;0;0;0;0;0;0;0;0;0;0;0;0
FR;9;2021-04-05;0;0;0;0;0;0;0;0;0;0;0;0;0;0;0;0;0;0
FR;9;2021-04-06;0;0;0;0;0;0;0;0;0;0;0;0;0;0;0;0;0;0
FR;9;2021-04-07;0;0;0;0;0;0;0;0;0;0;0;0;0;0;0;0;0;0
FR;9;2021-04-08;0;0;0;0;0;0;0;0;0;0;0;0;0;0;0;0;0;0
FR;9;2021-04-09;0;0;0;0;0;0;0;0;0;0;0;0;0;0;0;0;0;0
FR;9;2021-04-10;0;0;0;0;0;0;0;0;0;0;0;0;0;0;0;0;0;0
FR;9;2021-04-11;0;0;0;0;0;0;0;0;0;0;0;0;0;0;0;0;0;0
FR;9;2021-04-12;0;0;0;0;0;0;0;0;0;0;0;0;0;0;0;0;0;0
FR;9;2021-04-13;0;0;0;0;0;0;0;0;0;0;0;0;0;0;0;0;0;0
FR;9;2021-04-14;0;0;0;0;0;0;0;0;0;0;0;0;0;0;0;0;0;0
FR;9;2021-04-15;0;0;0;0;0;0;0;0;0;0;0;0;0;0;0;0;0;0
FR;9;2021-04-16;0;0;0;0;0;0;0;0;0;0;0;0;0;0;0;0;0;0
FR;9;2021-04-17;0;0;0;0;0;0;0;0;0;0;0;0;0;0;0;0;0;0
FR;9;2021-04-18;0;0;0;0;0;0;0;0;0;0;0;0;0;0;0;0;0;0
FR;9;2021-04-19;0;0;0;0;0;0;0;0;0;0;0;0;0;0;0;0;0;0
FR;9;2021-04-20;0;0;0;0;0;0;0;0;0;0;0;0;0;0;0;0;0;0
FR;9;2021-04-21;0;0;0;0;0;0;0;0;0;0;0;0;0;0;0;0;0;0
FR;9;2021-04-22;0;0;0;0;0;0;0;0;0;0;0;0;0;0;0;0;0;0
FR;9;2021-04-23;0;0;0;0;0;0;0;0;0;0;0;0;0;0;0;0;0;0
FR;9;2021-04-24;0;0;0;0;0;0;0;0;0;0;0;0;0;0;0;0;0;0
FR;9;2021-04-25;0;0;0;0;0;0;0;0;0;0;0;0;0;0;0;0;0;0
FR;9;2021-04-26;0;0;0;0;0;0;0;0;0;0;0;0;0;0;0;0;0;0
FR;9;2021-04-27;0;0;0;0;0;0;0;0;0;0;0;0;0;0;0;0;0;0
FR;9;2021-04-28;0;0;0;0;0;0;0;0;0;0;0;0;0;0;0;0;0;0
FR;9;2021-04-29;0;0;0;0;0;0;0;0;0;0;0;0;0;0;0;0;0;0
FR;9;2021-04-30;0;0;0;0;0;0;0;0;0;0;0;0;0;0;0;0;0;0
FR;9;2021-05-01;0;0;0;0;0;0;0;0;0;0;0;0;0;0;0;0;0;0
FR;9;2021-05-02;0;0;0;0;0;0;0;0;0;0;0;0;0;0;0;0;0;0
FR;9;2021-05-03;0;0;0;0;0;0;0;0;0;0;0;0;0;0;0;0;0;0
FR;9;2021-05-04;0;0;0;0;0;0;0;0;0;0;0;0;0;0;0;0;0;0
FR;9;2021-05-05;0;0;0;0;0;0;0;0;0;0;0;0;0;0;0;0;0;0
FR;9;2021-05-06;0;0;0;0;0;0;0;0;0;0;0;0;0;0;0;0;0;0
FR;9;2021-05-07;0;0;0;0;0;0;0;0;0;0;0;0;0;0;0;0;0;0
FR;9;2021-05-08;0;0;0;0;0;0;0;0;0;0;0;0;0;0;0;0;0;0
FR;9;2021-05-09;0;0;0;0;0;0;0;0;0;0;0;0;0;0;0;0;0;0
FR;9;2021-05-10;0;0;0;0;0;0;0;0;0;0;0;0;0;0;0;0;0;0
FR;9;2021-05-11;0;0;0;0;0;0;0;0;0;0;0;0;0;0;0;0;0;0
FR;9;2021-05-12;0;0;0;0;0;0;0;0;0;0;0;0;0;0;0;0;0;0
FR;9;2021-05-13;0;0;0;0;0;0;0;0;0;0;0;0;0;0;0;0;0;0
FR;9;2021-05-14;0;0;0;0;0;0;0;0;0;0;0;0;0;0;0;0;0;0
FR;9;2021-05-15;0;0;0;0;0;0;0;0;0;0;0;0;0;0;0;0;0;0
FR;9;2021-05-16;0;0;0;0;0;0;0;0;0;0;0;0;0;0;0;0;0;0
FR;9;2021-05-17;0;0;0;0;0;0;0;0;0;0;0;0;0;0;0;0;0;0
FR;9;2021-05-18;0;0;0;0;0;0;0;0;0;0;0;0;0;0;0;0;0;0
FR;9;2021-05-19;0;0;0;0;0;0;0;0;0;0;0;0;0;0;0;0;0;0
FR;9;2021-05-20;0;0;0;0;0;0;0;0;0;0;0;0;0;0;0;0;0;0
FR;9;2021-05-21;0;0;0;0;0;0;0;0;0;0;0;0;0;0;0;0;0;0
FR;9;2021-05-22;0;0;0;0;0;0;0;0;0;0;0;0;0;0;0;0;0;0
FR;9;2021-05-23;0;0;0;0;0;0;0;0;0;0;0;0;0;0;0;0;0;0
FR;9;2021-05-24;0;0;0;0;0;0;0;0;0;0;0;0;0;0;0;0;0;0
FR;9;2021-05-25;0;0;0;0;0;0;0;0;0;0;0;0;0;0;0;0;0;0
FR;9;2021-05-26;0;0;0;0;0;0;0;0;0;0;0;0;0;0;0;0;0;0
FR;9;2021-05-27;0;0;0;0;0;0;0;0;0;0;0;0;0;0;0;0;0;0
FR;9;2021-05-28;0;0;0;0;0;0;0;0;0;0;0;0;0;0;0;0;0;0
FR;9;2021-05-29;0;0;0;0;0;0;0;0;0;0;0;0;0;0;0;0;0;0
FR;9;2021-05-30;0;0;0;0;0;0;0;0;0;0;0;0;0;0;0;0;0;0
FR;9;2021-05-31;0;0;0;0;0;0;0;0;0;0;0;0;0;0;0;0;0;0
FR;9;2021-06-01;0;0;0;0;0;0;0;0;0;0;0;0;0;0;0;0;0;0
FR;9;2021-06-02;0;0;0;0;0;0;0;0;0;0;0;0;0;0;0;0;0;0
FR;9;2021-06-03;0;0;0;0;0;0;0;0;0;0;0;0;0;0;0;0;0;0
FR;9;2021-06-04;0;0;0;0;0;0;0;0;0;0;0;0;0;0;0;0;0;0
FR;9;2021-06-05;0;0;0;0;0;0;0;0;0;0;0;0;0;0;0;0;0;0
FR;9;2021-06-06;0;0;0;0;0;0;0;0;0;0;0;0;0;0;0;0;0;0
FR;9;2021-06-07;0;0;0;0;0;0;0;0;0;0;0;0;0;0;0;0;0;0
FR;9;2021-06-08;0;0;0;0;0;0;0;0;0;0;0;0;0;0;0;0;0;0
FR;9;2021-06-09;0;0;0;0;0;0;0;0;0;0;0;0;0;0;0;0;0;0
FR;9;2021-06-10;0;0;0;0;0;0;0;0;0;0;0;0;0;0;0;0;0;0
FR;9;2021-06-11;0;0;0;0;0;0;0;0;0;0;0;0;0;0;0;0;0;0
FR;9;2021-06-12;0;0;0;0;0;0;0;0;0;0;0;0;0;0;0;0;0;0
FR;9;2021-06-13;0;0;0;0;0;0;0;0;0;0;0;0;0;0;0;0;0;0
FR;9;2021-06-14;0;0;0;0;0;0;0;0;0;0;0;0;0;0;0;0;0;0
FR;9;2021-06-15;0;0;0;0;0;0;0;0;0;0;0;0;0;0;0;0;0;0
FR;9;2021-06-16;0;0;0;0;0;0;0;0;0;0;0;0;0;0;0;0;0;0
FR;9;2021-06-17;0;0;0;0;0;0;0;0;0;0;0;0;0;0;0;0;0;0
FR;9;2021-06-18;0;0;0;0;0;0;0;0;0;0;0;0;0;0;0;0;0;0
FR;9;2021-06-19;0;0;0;0;0;0;0;0;0;0;0;0;0;0;0;0;0;0
FR;9;2021-06-20;0;0;0;0;0;0;0;0;0;0;0;0;0;0;0;0;0;0
FR;9;2021-06-21;0;0;0;0;0;0;0;0;0;0;0;0;0;0;0;0;0;0
FR;9;2021-06-22;0;0;0;0;0;0;0;0;0;0;0;0;0;0;0;0;0;0
FR;9;2021-06-23;0;0;0;0;0;0;0;0;0;0;0;0;0;0;0;0;0;0
FR;9;2021-06-24;0;0;0;0;0;0;0;0;0;0;0;0;0;0;0;0;0;0
FR;9;2021-06-25;0;0;0;0;0;0;0;0;0;0;0;0;0;0;0;0;0;0
FR;9;2021-06-26;0;0;0;0;0;0;0;0;0;0;0;0;0;0;0;0;0;0
FR;9;2021-06-27;0;0;0;0;0;0;0;0;0;0;0;0;0;0;0;0;0;0
FR;9;2021-06-28;0;0;0;0;0;0;0;0;0;0;0;0;0;0;0;0;0;0
FR;9;2021-06-29;0;0;0;0;0;0;0;0;0;0;0;0;0;0;0;0;0;0
FR;9;2021-06-30;0;0;0;0;0;0;0;0;0;0;0;0;0;0;0;0;0;0
FR;9;2021-07-01;0;0;0;0;0;0;0;0;0;0;0;0;0;0;0;0;0;0
FR;9;2021-07-02;0;0;0;0;0;0;0;0;0;0;0;0;0;0;0;0;0;0
FR;9;2021-07-03;0;0;0;0;0;0;0;0;0;0;0;0;0;0;0;0;0;0
FR;9;2021-07-04;0;0;0;0;0;0;0;0;0;0;0;0;0;0;0;0;0;0
FR;9;2021-07-05;0;0;0;0;0;0;0;0;0;0;0;0;0;0;0;0;0;0
FR;9;2021-07-06;0;0;0;0;0;0;0;0;0;0;0;0;0;0;0;0;0;0
FR;9;2021-07-07;0;0;0;0;0;0;0;0;0;0;0;0;0;0;0;0;0;0
FR;9;2021-07-08;0;0;0;0;0;0;0;0;0;0;0;0;0;0;0;0;0;0
FR;9;2021-07-09;0;0;0;0;0;0;0;0;0;0;0;0;0;0;0;0;0;0
FR;9;2021-07-10;0;0;0;0;0;0;0;0;0;0;0;0;0;0;0;0;0;0
FR;9;2021-07-11;0;0;0;0;0;0;0;0;0;0;0;0;0;0;0;0;0;0
FR;9;2021-07-12;0;0;0;0;0;0;0;0;0;0;0;0;0;0;0;0;0;0
FR;9;2021-07-13;0;0;0;0;0;0;0;0;0;0;0;0;0;0;0;0;0;0
FR;9;2021-07-14;0;0;0;0;0;0;0;0;0;0;0;0;0;0;0;0;0;0
FR;9;2021-07-15;0;0;0;0;0;0;0;0;0;0;0;0;0;0;0;0;0;0
FR;9;2021-07-16;0;0;0;0;0;0;0;0;0;0;0;0;0;0;0;0;0;0
FR;9;2021-07-17;0;0;0;0;0;0;0;0;0;0;0;0;0;0;0;0;0;0
FR;9;2021-07-18;0;0;0;0;0;0;0;0;0;0;0;0;0;0;0;0;0;0
FR;9;2021-07-19;0;0;0;0;0;0;0;0;0;0;0;0;0;0;0;0;0;0
FR;9;2021-07-20;0;0;0;0;0;0;0;0;0;0;0;0;0;0;0;0;0;0
FR;9;2021-07-21;0;0;0;0;0;0;0;0;0;0;0;0;0;0;0;0;0;0
FR;9;2021-07-22;0;0;0;0;0;0;0;0;0;0;0;0;0;0;0;0;0;0
FR;9;2021-07-23;0;0;0;0;0;0;0;0;0;0;0;0;0;0;0;0;0;0
FR;9;2021-07-24;0;0;0;0;0;0;0;0;0;0;0;0;0;0;0;0;0;0
FR;9;2021-07-25;0;0;0;0;0;0;0;0;0;0;0;0;0;0;0;0;0;0
FR;9;2021-07-26;0;0;0;0;0;0;0;0;0;0;0;0;0;0;0;0;0;0
FR;9;2021-07-27;0;0;0;0;0;0;0;0;0;0;0;0;0;0;0;0;0;0
FR;9;2021-07-28;0;0;0;0;0;0;0;0;0;0;0;0;0;0;0;0;0;0
FR;9;2021-07-29;0;0;0;0;0;0;0;0;0;0;0;0;0;0;0;0;0;0
FR;9;2021-07-30;0;0;0;0;0;0;0;0;0;0;0;0;0;0;0;0;0;0
FR;9;2021-07-31;0;0;0;0;0;0;0;0;0;0;0;0;0;0;0;0;0;0
FR;9;2021-08-01;0;0;0;0;0;0;0;0;0;0;0;0;0;0;0;0;0;0
FR;9;2021-08-02;0;0;0;0;0;0;0;0;0;0;0;0;0;0;0;0;0;0
FR;9;2021-08-03;0;0;0;0;0;0;0;0;0;0;0;0;0;0;0;0;0;0
FR;9;2021-08-04;0;0;0;0;0;0;0;0;0;0;0;0;0;0;0;0;0;0
FR;9;2021-08-05;0;0;0;0;0;0;0;0;0;0;0;0;0;0;0;0;0;0
FR;9;2021-08-06;0;0;0;0;0;0;0;0;0;0;0;0;0;0;0;0;0;0
FR;9;2021-08-07;0;0;0;0;0;0;0;0;0;0;0;0;0;0;0;0;0;0
FR;9;2021-08-08;0;0;0;0;0;0;0;0;0;0;0;0;0;0;0;0;0;0
FR;9;2021-08-09;0;0;0;0;0;0;0;0;0;0;0;0;0;0;0;0;0;0
FR;9;2021-08-10;0;0;0;0;0;0;0;0;0;0;0;0;0;0;0;0;0;0
FR;9;2021-08-11;0;0;0;0;0;0;0;0;0;0;0;0;0;0;0;0;0;0
FR;9;2021-08-12;0;0;0;0;0;0;0;0;0;0;0;0;0;0;0;0;0;0
FR;9;2021-08-13;0;0;0;0;0;0;0;0;0;0;0;0;0;0;0;0;0;0
FR;9;2021-08-14;0;0;0;0;0;0;0;0;0;0;0;0;0;0;0;0;0;0
FR;9;2021-08-15;0;0;0;0;0;0;0;0;0;0;0;0;0;0;0;0;0;0
FR;9;2021-08-16;0;0;0;0;0;0;0;0;0;0;0;0;0;0;0;0;0;0
FR;9;2021-08-17;0;0;0;0;0;0;0;0;0;0;0;0;0;0;0;0;0;0
FR;9;2021-08-18;0;0;0;0;0;0;0;0;0;0;0;0;0;0;0;0;0;0
FR;9;2021-08-19;0;0;0;0;0;0;0;0;0;0;0;0;0;0;0;0;0;0
FR;9;2021-08-20;0;0;0;0;0;0;0;0;0;0;0;0;0;0;0;0;0;0
FR;9;2021-08-21;0;0;0;0;0;0;0;0;0;0;0;0;0;0;0;0;0;0
FR;9;2021-08-22;0;0;0;0;0;0;0;0;0;0;0;0;0;0;0;0;0;0
FR;9;2021-08-23;0;0;0;0;0;0;0;0;0;0;0;0;0;0;0;0;0;0
FR;9;2021-08-24;0;0;0;0;0;0;0;0;0;0;0;0;0;0;0;0;0;0
FR;9;2021-08-25;0;0;0;0;0;0;0;0;0;0;0;0;0;0;0;0;0;0
FR;9;2021-08-26;0;0;0;0;0;0;0;0;0;0;0;0;0;0;0;0;0;0
FR;9;2021-08-27;0;0;0;0;0;0;0;0;0;0;0;0;0;0;0;0;0;0
FR;9;2021-08-28;0;0;0;0;0;0;0;0;0;0;0;0;0;0;0;0;0;0
FR;9;2021-08-29;0;0;0;0;0;0;0;0;0;0;0;0;0;0;0;0;0;0
FR;9;2021-08-30;0;0;0;0;0;0;0;0;0;0;0;0;0;0;0;0;0;0
FR;9;2021-08-31;0;0;0;0;0;0;0;0;0;0;0;0;0;0;0;0;0;0
FR;9;2021-09-01;0;0;0;0;0;0;0;0;0;0;0;0;0;0;0;0;0;0
FR;9;2021-09-02;0;0;0;0;0;0;0;0;0;0;0;0;0;0;0;0;0;0
FR;9;2021-09-03;0;0;0;0;0;0;0;0;0;0;0;0;0;0;0;0;0;0
FR;9;2021-09-04;0;0;0;0;0;0;0;0;0;0;0;0;0;0;0;0;0;0
FR;9;2021-09-05;0;0;0;0;0;0;0;0;0;0;0;0;0;0;0;0;0;0
FR;9;2021-09-06;0;0;0;0;0;0;0;0;0;0;0;0;0;0;0;0;0;0
FR;9;2021-09-07;0;0;0;0;0;0;0;0;0;0;0;0;0;0;0;0;0;0
FR;9;2021-09-08;0;0;0;0;0;0;0;0;0;0;0;0;0;0;0;0;0;0
FR;9;2021-09-09;0;0;0;0;0;0;0;0;0;0;0;0;0;0;0;0;0;0
FR;9;2021-09-10;0;0;0;0;0;0;0;0;0;0;0;0;0;0;0;0;0;0
FR;9;2021-09-11;0;0;0;0;0;0;0;0;0;0;0;0;0;0;0;0;0;0
FR;9;2021-09-12;0;0;0;0;0;0;0;0;0;0;0;0;0;0;0;0;0;0
FR;9;2021-09-13;0;0;0;0;0;0;0;0;0;0;0;0;0;0;0;0;0;0
FR;9;2021-09-14;0;0;0;0;0;0;0;0;0;0;0;0;0;0;0;0;0;0
FR;9;2021-09-15;0;0;0;0;0;0;0;0;0;0;0;0;0;0;0;0;0;0
FR;9;2021-09-16;0;0;0;0;0;0;0;0;0;0;0;0;0;0;0;0;0;0
FR;9;2021-09-17;0;0;0;0;0;0;0;0;0;0;0;0;0;0;0;0;0;0
FR;9;2021-09-18;0;0;0;0;0;0;0;0;0;0;0;0;0;0;0;0;0;0
FR;9;2021-09-19;0;0;0;0;0;0;0;0;0;0;0;0;0;0;0;0;0;0
FR;9;2021-09-20;0;0;0;0;0;0;0;0;0;0;0;0;0;0;0;0;0;0
FR;9;2021-09-21;0;0;0;0;0;0;0;0;0;0;0;0;0;0;0;0;0;0
FR;9;2021-09-22;0;0;0;0;0;0;0;0;0;0;0;0;0;0;0;0;0;0
FR;9;2021-09-23;0;0;0;0;0;0;0;0;0;0;0;0;0;0;0;0;0;0
FR;9;2021-09-24;0;0;0;0;0;0;0;0;0;0;0;0;0;0;0;0;0;0
FR;9;2021-09-25;0;0;0;0;0;0;0;0;0;0;0;0;0;0;0;0;0;0
FR;9;2021-09-26;0;0;0;0;0;0;0;0;0;0;0;0;0;0;0;0;0;0
FR;9;2021-09-27;0;0;0;0;0;0;0;0;0;0;0;0;0;0;0;0;0;0
FR;9;2021-09-28;0;0;0;0;0;0;0;0;0;0;0;0;0;0;0;0;0;0
FR;9;2021-09-29;0;0;0;0;0;0;0;0;0;0;0;0;0;0;0;0;0;0
FR;9;2021-09-30;0;0;0;0;0;0;0;0;0;0;0;0;0;0;0;0;0;0
FR;9;2021-10-01;0;0;0;0;0;0;0;0;0;0;0;0;0;0;0;0;0;0
FR;9;2021-10-02;0;0;0;0;0;0;0;0;0;0;0;0;0;0;0;0;0;0
FR;9;2021-10-03;0;0;0;0;0;0;0;0;0;0;0;0;0;0;0;0;0;0
FR;9;2021-10-04;0;0;0;0;0;0;0;0;0;0;0;0;0;0;0;0;0;0
FR;9;2021-10-05;0;0;0;0;0;0;0;0;0;0;0;0;0;0;0;0;0;0
FR;9;2021-10-06;0;0;0;0;0;0;0;0;0;0;0;0;0;0;0;0;0;0
FR;9;2021-10-07;0;0;0;0;0;0;0;0;0;0;0;0;0;0;0;0;0;0
FR;9;2021-10-08;0;0;0;0;0;0;0;0;0;0;0;0;0;0;0;0;0;0
FR;9;2021-10-09;0;0;0;0;0;0;0;0;0;0;0;0;0;0;0;0;0;0
FR;9;2021-10-10;0;0;0;0;0;0;0;0;0;0;0;0;0;0;0;0;0;0
FR;9;2021-10-11;0;0;0;0;0;0;0;0;0;0;0;0;0;0;0;0;0;0
FR;9;2021-10-12;0;0;0;0;0;0;0;0;0;0;0;0;0;0;0;0;0;0
FR;9;2021-10-13;0;0;0;0;0;0;0;0;0;0;0;0;0;0;0;0;0;0
FR;9;2021-10-14;0;0;0;0;0;0;0;0;0;0;0;0;0;0;0;0;0;0
FR;9;2021-10-15;0;0;0;0;0;0;0;0;0;0;0;0;0;0;0;0;0;0
FR;9;2021-10-16;0;0;0;0;0;0;0;0;0;0;0;0;0;0;0;0;0;0
FR;9;2021-10-17;0;0;0;0;0;0;0;0;0;0;0;0;0;0;0;0;0;0
FR;9;2021-10-18;0;0;0;0;0;0;0;0;0;0;0;0;0;0;0;0;0;0
FR;9;2021-10-19;0;0;0;0;0;0;0;0;0;0;0;0;0;0;0;0;0;0
FR;9;2021-10-20;0;0;0;0;0;0;0;0;0;0;0;0;0;0;0;0;0;0
FR;9;2021-10-21;0;0;0;0;0;0;0;0;0;0;0;0;0;0;0;0;0;0
FR;9;2021-10-22;0;0;0;0;0;0;0;0;0;0;0;0;0;0;0;0;0;0
FR;9;2021-10-23;0;0;0;0;0;0;0;0;0;0;0;0;0;0;0;0;0;0
FR;9;2021-10-24;0;0;0;0;0;0;0;0;0;0;0;0;0;0;0;0;0;0
FR;9;2021-10-25;0;0;0;0;0;0;0;0;0;0;0;0;0;0;0;0;0;0
FR;9;2021-10-26;0;0;0;0;0;0;0;0;0;0;0;0;0;0;0;0;0;0
FR;9;2021-10-27;0;0;0;0;0;0;0;0;0;0;0;0;0;0;0;0;0;0
FR;9;2021-10-28;0;0;0;0;0;0;0;0;0;0;0;0;0;0;0;0;0;0
FR;9;2021-10-29;0;0;0;0;0;0;0;0;0;0;0;0;0;0;0;0;0;0
FR;9;2021-10-30;0;0;0;0;0;0;0;0;0;0;0;0;0;0;0;0;0;0
FR;9;2021-10-31;0;0;0;0;0;0;0;0;0;0;0;0;0;0;0;0;0;0
FR;9;2021-11-01;0;0;0;0;0;0;0;0;0;0;0;0;0;0;0;0;0;0
FR;9;2021-11-02;0;0;0;0;0;0;0;0;0;0;0;0;0;0;0;0;0;0
FR;9;2021-11-03;0;0;0;0;0;0;0;0;0;0;0;0;0;0;0;0;0;0
FR;9;2021-11-04;0;0;0;0;0;0;0;0;0;0;0;0;0;0;0;0;0;0
FR;9;2021-11-05;0;0;0;0;0;0;0;0;0;0;0;0;0;0;0;0;0;0
FR;9;2021-11-06;0;0;0;0;0;0;0;0;0;0;0;0;0;0;0;0;0;0
FR;9;2021-11-07;0;0;0;0;0;0;0;0;0;0;0;0;0;0;0;0;0;0
FR;9;2021-11-08;0;0;0;0;0;0;0;0;0;0;0;0;0;0;0;0;0;0
FR;9;2021-11-09;0;0;0;0;0;0;0;0;0;0;0;0;0;0;0;0;0;0
FR;9;2021-11-10;0;0;0;0;0;0;0;0;0;0;0;0;0;0;0;0;0;0
FR;9;2021-11-11;0;0;0;0;0;0;0;0;0;0;0;0;0;0;0;0;0;0
FR;9;2021-11-12;0;0;0;0;0;0;0;0;0;0;0;0;0;0;0;0;0;0
FR;9;2021-11-13;0;0;0;0;0;0;0;0;0;0;0;0;0;0;0;0;0;0
FR;9;2021-11-14;0;0;0;0;0;0;0;0;0;0;0;0;0;0;0;0;0;0
FR;9;2021-11-15;0;0;0;0;0;0;0;0;0;0;0;0;0;0;0;0;0;0
FR;9;2021-11-16;0;0;0;0;0;0;0;0;0;0;0;0;0;0;0;0;0;0
FR;9;2021-11-17;0;0;0;0;0;0;0;0;0;0;0;0;0;0;0;0;0;0
FR;9;2021-11-18;0;0;0;0;0;0;0;0;0;0;0;0;0;0;0;0;0;0
FR;9;2021-11-19;0;0;0;0;0;0;0;0;0;0;0;0;0;0;0;0;0;0
FR;9;2021-11-20;0;0;0;0;0;0;0;0;0;0;0;0;0;0;0;0;0;0
FR;9;2021-11-21;0;0;0;0;0;0;0;0;0;0;0;0;0;0;0;0;0;0
FR;9;2021-11-22;0;0;0;0;0;0;0;0;0;0;0;0;0;0;0;0;0;0
FR;9;2021-11-23;0;0;0;0;0;0;0;0;0;0;0;0;0;0;0;0;0;0
FR;9;2021-11-24;0;0;0;0;0;0;0;0;0;0;0;0;0;0;0;0;0;0
FR;9;2021-11-25;0;0;0;0;0;0;0;0;0;0;0;0;0;0;0;0;0;0
FR;9;2021-11-26;0;0;0;0;0;0;0;0;0;0;0;0;0;0;0;0;0;0
FR;9;2021-11-27;0;0;0;0;0;0;0;0;0;0;0;0;0;0;0;0;0;0
FR;9;2021-11-28;0;0;0;0;0;0;0;0;0;0;0;0;0;0;0;0;0;0
FR;9;2021-11-29;0;0;0;0;0;0;0;0;0;0;0;0;0;0;0;0;0;0
FR;9;2021-11-30;0;0;0;0;0;0;0;0;0;0;0;0;0;0;0;0;0;0
FR;9;2021-12-01;0;0;0;0;0;0;0;0;0;0;0;0;0;0;0;0;0;0
FR;9;2021-12-02;0;0;0;0;0;0;0;0;0;0;0;0;0;0;0;0;0;0
FR;9;2021-12-03;0;0;0;0;0;0;0;0;0;0;0;0;0;0;0;0;0;0
FR;9;2021-12-04;0;0;0;0;0;0;0;0;0;0;0;0;0;0;0;0;0;0
FR;9;2021-12-05;0;0;0;0;0;0;0;0;0;0;0;0;0;0;0;0;0;0
FR;9;2021-12-06;0;0;0;0;0;0;0;0;0;0;0;0;0;0;0;0;0;0
FR;9;2021-12-07;0;0;0;0;0;0;0;0;0;0;0;0;0;0;0;0;0;0
FR;9;2021-12-08;0;0;0;0;0;0;0;0;0;0;0;0;0;0;0;0;0;0
FR;9;2021-12-09;0;0;0;0;0;0;0;0;0;0;0;0;0;0;0;0;0;0
FR;9;2021-12-10;0;0;0;0;0;0;0;0;0;0;0;0;0;0;0;0;0;0
FR;9;2021-12-11;0;0;0;0;0;0;0;0;0;0;0;0;0;0;0;0;0;0
FR;9;2021-12-12;0;0;0;0;0;0;0;0;0;0;0;0;0;0;0;0;0;0
FR;9;2021-12-13;0;0;0;0;0;0;0;0;0;0;0;0;0;0;0;0;0;0
FR;9;2021-12-14;0;0;0;0;0;0;0;0;0;0;0;0;0;0;0;0;0;0
FR;9;2021-12-15;0;0;0;0;0;0;0;0;0;0;0;0;0;0;0;0;0;0
FR;9;2021-12-16;0;0;0;0;0;0;0;0;0;0;0;0;0;0;0;0;0;0
FR;9;2021-12-17;0;0;0;0;0;0;0;0;0;0;0;0;0;0;0;0;0;0
FR;9;2021-12-18;0;0;0;0;0;0;0;0;0;0;0;0;0;0;0;0;0;0
FR;9;2021-12-19;0;0;0;0;0;0;0;0;0;0;0;0;0;0;0;0;0;0
FR;9;2021-12-20;0;0;0;0;0;0;0;0;0;0;0;0;0;0;0;0;0;0
FR;9;2021-12-21;0;0;0;0;0;0;0;0;0;0;0;0;0;0;0;0;0;0
FR;9;2021-12-22;0;0;0;0;0;0;0;0;0;0;0;0;0;0;0;0;0;0
FR;9;2021-12-23;0;0;0;0;0;0;0;0;0;0;0;0;0;0;0;0;0;0
FR;9;2021-12-24;0;0;0;0;0;0;0;0;0;0;0;0;0;0;0;0;0;0
FR;9;2021-12-25;0;0;0;0;0;0;0;0;0;0;0;0;0;0;0;0;0;0
FR;9;2021-12-26;0;0;0;0;0;0;0;0;0;0;0;0;0;0;0;0;0;0
FR;9;2021-12-27;0;0;0;0;0;0;0;0;0;0;0;0;0;0;0;0;0;0
FR;9;2021-12-28;0;0;0;0;0;0;0;0;0;0;0;0;0;0;0;0;0;0
FR;9;2021-12-29;0;0;0;0;0;0;0;0;0;0;0;0;0;0;0;0;0;0
FR;9;2021-12-30;0;0;0;0;0;0;0;0;0;0;0;0;0;0;0;0;0;0
FR;9;2021-12-31;0;0;0;0;0;0;0;0;0;0;0;0;0;0;0;0;0;0
FR;9;2022-01-01;0;0;0;0;0;0;0;0;0;0;0;0;0;0;0;0;0;0
FR;9;2022-01-02;0;0;0;0;0;0;0;0;0;0;0;0;0;0;0;0;0;0
FR;9;2022-01-03;0;0;0;0;0;0;0;0;0;0;0;0;0;0;0;0;0;0
FR;9;2022-01-04;0;0;0;0;0;0;0;0;0;0;0;0;0;0;0;0;0;0
FR;9;2022-01-05;0;0;0;0;0;0;0;0;0;0;0;0;0;0;0;0;0;0
FR;9;2022-01-06;0;0;0;0;0;0;0;0;0;0;0;0;0;0;0;0;0;0
FR;9;2022-01-07;0;0;0;0;0;0;0;0;0;0;0;0;0;0;0;0;0;0
FR;9;2022-01-08;0;0;0;0;0;0;0;0;0;0;0;0;0;0;0;0;0;0
FR;9;2022-01-09;0;0;0;0;0;0;0;0;0;0;0;0;0;0;0;0;0;0
FR;9;2022-01-10;0;0;0;0;0;0;0;0;0;0;0;0;0;0;0;0;0;0
FR;9;2022-01-11;0;0;0;0;0;0;0;0;0;0;0;0;0;0;0;0;0;0
FR;9;2022-01-12;0;0;0;0;0;0;0;0;0;0;0;0;0;0;0;0;0;0
FR;9;2022-01-13;0;0;0;0;0;0;0;0;0;0;0;0;0;0;0;0;0;0
FR;9;2022-01-14;0;0;0;0;0;0;0;0;0;0;0;0;0;0;0;0;0;0
FR;9;2022-01-15;0;0;0;0;0;0;0;0;0;0;0;0;0;0;0;0;0;0
FR;9;2022-01-16;0;0;0;0;0;0;0;0;0;0;0;0;0;0;0;0;0;0
FR;9;2022-01-17;0;0;0;0;0;0;0;0;0;0;0;0;0;0;0;0;0;0
FR;9;2022-01-18;0;0;0;0;0;0;0;0;0;0;0;0;0;0;0;0;0;0
FR;9;2022-01-19;0;0;0;0;0;0;0;0;0;0;0;0;0;0;0;0;0;0
FR;9;2022-01-20;0;0;0;0;0;0;0;0;0;0;0;0;0;0;0;0;0;0
FR;9;2022-01-21;0;0;0;0;0;0;0;0;0;0;0;0;0;0;0;0;0;0
FR;9;2022-01-22;0;0;0;0;0;0;0;0;0;0;0;0;0;0;0;0;0;0
FR;9;2022-01-23;0;0;0;0;0;0;0;0;0;0;0;0;0;0;0;0;0;0
FR;9;2022-01-24;0;0;0;0;0;0;0;0;0;0;0;0;0;0;0;0;0;0
FR;9;2022-01-25;0;0;0;0;0;0;0;0;0;0;0;0;0;0;0;0;0;0
FR;9;2022-01-26;0;0;0;0;0;0;0;0;0;0;0;0;0;0;0;0;0;0
FR;9;2022-01-27;0;0;0;0;0;0;0;0;0;0;0;0;0;0;0;0;0;0
FR;9;2022-01-28;0;0;0;0;0;0;0;0;0;0;0;0;0;0;0;0;0;0
FR;9;2022-01-29;0;0;0;0;0;0;0;0;0;0;0;0;0;0;0;0;0;0
FR;9;2022-01-30;0;0;0;0;0;0;0;0;0;0;0;0;0;0;0;0;0;0
FR;9;2022-01-31;0;0;0;0;0;0;0;0;0;0;0;0;0;0;0;0;0;0
FR;9;2022-02-01;0;0;0;0;0;0;0;0;0;0;0;0;0;0;0;0;0;0
FR;9;2022-02-02;0;0;0;0;0;0;0;0;0;0;0;0;0;0;0;0;0;0
FR;9;2022-02-03;0;0;0;0;0;0;0;0;0;0;0;0;0;0;0;0;0;0
FR;9;2022-02-04;0;0;0;0;0;0;0;0;0;0;0;0;0;0;0;0;0;0
FR;9;2022-02-05;0;0;0;0;0;0;0;0;0;0;0;0;0;0;0;0;0;0
FR;9;2022-02-06;0;0;0;0;0;0;0;0;0;0;0;0;0;0;0;0;0;0
FR;9;2022-02-07;0;0;0;0;0;0;0;0;0;0;0;0;0;0;0;0;0;0
FR;9;2022-02-08;0;0;0;0;0;0;0;0;0;0;0;0;0;0;0;0;0;0
FR;9;2022-02-09;0;0;0;0;0;0;0;0;0;0;0;0;0;0;0;0;0;0
FR;9;2022-02-10;0;0;0;0;0;0;0;0;0;0;0;0;0;0;0;0;0;0
FR;9;2022-02-11;0;0;0;0;0;0;0;0;0;0;0;0;0;0;0;0;0;0
FR;9;2022-02-12;0;0;0;0;0;0;0;0;0;0;0;0;0;0;0;0;0;0
FR;9;2022-02-13;0;0;0;0;0;0;0;0;0;0;0;0;0;0;0;0;0;0
FR;9;2022-02-14;0;0;0;0;0;0;0;0;0;0;0;0;0;0;0;0;0;0
FR;9;2022-02-15;0;0;0;0;0;0;0;0;0;0;0;0;0;0;0;0;0;0
FR;9;2022-02-16;0;0;0;0;0;0;0;0;0;0;0;0;0;0;0;0;0;0
FR;9;2022-02-17;0;0;0;0;0;0;0;0;0;0;0;0;0;0;0;0;0;0
FR;9;2022-02-18;0;0;0;0;0;0;0;0;0;0;0;0;0;0;0;0;0;0
FR;9;2022-02-19;0;0;0;0;0;0;0;0;0;0;0;0;0;0;0;0;0;0
FR;9;2022-02-20;0;0;0;0;0;0;0;0;0;0;0;0;0;0;0;0;0;0
FR;9;2022-02-21;0;0;0;0;0;0;0;0;0;0;0;0;0;0;0;0;0;0
FR;9;2022-02-22;0;0;0;0;0;0;0;0;0;0;0;0;0;0;0;0;0;0
FR;9;2022-02-23;0;0;0;0;0;0;0;0;0;0;0;0;0;0;0;0;0;0
FR;9;2022-02-24;0;0;0;0;0;0;0;0;0;0;0;0;0;0;0;0;0;0
FR;9;2022-02-25;0;0;0;0;0;0;0;0;0;0;0;0;0;0;0;0;0;0
FR;9;2022-02-26;0;0;0;0;0;0;0;0;0;0;0;0;0;0;0;0;0;0
FR;9;2022-02-27;0;0;0;0;0;0;0;0;0;0;0;0;0;0;0;0;0;0
FR;9;2022-02-28;0;0;0;0;0;0;0;0;0;0;0;0;0;0;0;0;0;0
FR;9;2022-03-01;0;0;0;0;0;0;0;0;0;0;0;0;0;0;0;0;0;0
FR;9;2022-03-02;0;0;0;0;0;0;0;0;0;0;0;0;0;0;0;0;0;0
FR;9;2022-03-03;0;0;0;0;0;0;0;0;0;0;0;0;0;0;0;0;0;0
FR;9;2022-03-04;0;0;0;0;0;0;0;0;0;0;0;0;0;0;0;0;0;0
FR;9;2022-03-05;0;0;0;0;0;0;0;0;0;0;0;0;0;0;0;0;0;0
FR;9;2022-03-06;0;0;0;0;0;0;0;0;0;0;0;0;0;0;0;0;0;0
FR;9;2022-03-07;0;0;0;0;0;0;0;0;0;0;0;0;0;0;0;0;0;0
FR;9;2022-03-08;0;0;0;0;0;0;0;0;0;0;0;0;0;0;0;0;0;0
FR;9;2022-03-09;0;0;0;0;0;0;0;0;0;0;0;0;0;0;0;0;0;0
FR;9;2022-03-10;0;0;0;0;0;0;0;0;0;0;0;0;0;0;0;0;0;0
FR;9;2022-03-11;0;0;0;0;0;0;0;0;0;0;0;0;0;0;0;0;0;0
FR;9;2022-03-12;0;0;0;0;0;0;0;0;0;0;0;0;0;0;0;0;0;0
FR;9;2022-03-13;0;0;0;0;0;0;0;0;0;0;0;0;0;0;0;0;0;0
FR;9;2022-03-14;0;0;0;0;0;0;0;0;0;0;0;0;0;0;0;0;0;0
FR;9;2022-03-15;0;0;0;0;0;0;0;0;0;0;0;0;0;0;0;0;0;0
FR;9;2022-03-16;0;0;0;0;0;0;0;0;0;0;0;0;0;0;0;0;0;0
FR;9;2022-03-17;0;0;0;0;0;0;0;0;0;0;0;0;0;0;0;0;0;0
FR;9;2022-03-18;0;0;0;0;0;0;0;0;0;0;0;0;0;0;0;0;0;0
FR;9;2022-03-19;0;0;0;0;0;0;0;0;0;0;0;0;0;0;0;0;0;0
FR;9;2022-03-20;0;0;0;0;0;0;0;0;0;0;0;0;0;0;0;0;0;0
FR;9;2022-03-21;0;0;0;0;0;0;0;0;0;0;0;0;0;0;0;0;0;0
FR;9;2022-03-22;0;0;0;0;0;0;0;0;0;0;0;0;0;0;0;0;0;0
FR;9;2022-03-23;0;0;0;0;0;0;0;0;0;0;0;0;0;0;0;0;0;0
FR;9;2022-03-24;0;0;0;0;0;0;0;0;0;0;0;0;0;0;0;0;0;0
FR;9;2022-03-25;0;0;0;0;0;0;0;0;0;0;0;0;0;0;0;0;0;0
FR;9;2022-03-26;0;0;0;0;0;0;0;0;0;0;0;0;0;0;0;0;0;0
FR;9;2022-03-27;0;0;0;0;0;0;0;0;0;0;0;0;0;0;0;0;0;0
FR;9;2022-03-28;0;0;0;0;0;0;0;0;0;0;0;0;0;0;0;0;0;0
FR;9;2022-03-29;0;0;0;0;0;0;0;0;0;0;0;0;0;0;0;0;0;0
FR;9;2022-03-30;0;0;0;0;0;0;0;0;0;0;0;0;0;0;0;0;0;0
FR;9;2022-03-31;0;0;0;0;0;0;0;0;0;0;0;0;0;0;0;0;0;0
FR;9;2022-04-01;0;0;0;0;0;0;0;0;0;0;0;0;0;0;0;0;0;0
FR;9;2022-04-02;0;0;0;0;0;0;0;0;0;0;0;0;0;0;0;0;0;0
FR;9;2022-04-03;0;0;0;0;0;0;0;0;0;0;0;0;0;0;0;0;0;0
FR;9;2022-04-04;0;0;0;0;0;0;0;0;0;0;0;0;0;0;0;0;0;0
FR;9;2022-04-05;0;0;0;0;0;0;0;0;0;0;0;0;0;0;0;0;0;0
FR;9;2022-04-06;0;0;0;0;0;0;0;0;0;0;0;0;0;0;0;0;0;0
FR;9;2022-04-07;0;0;0;0;0;0;0;0;0;0;0;0;0;0;0;0;0;0
FR;9;2022-04-08;0;0;0;0;0;0;0;0;0;0;0;0;0;0;0;0;0;0
FR;9;2022-04-09;0;0;0;0;0;0;0;0;0;0;0;0;0;0;0;0;0;0
FR;9;2022-04-10;0;0;0;0;0;0;0;0;0;0;0;0;0;0;0;0;0;0
FR;9;2022-04-11;0;0;0;0;0;0;0;0;0;0;0;0;0;0;0;0;0;0
FR;9;2022-04-12;0;0;0;0;0;0;0;0;0;0;0;0;0;0;0;0;0;0
FR;9;2022-04-13;0;0;0;0;0;0;0;0;0;0;0;0;0;0;0;0;0;0
FR;9;2022-04-14;0;0;0;0;0;0;0;0;0;0;0;0;0;0;0;0;0;0
FR;9;2022-04-15;0;0;0;0;0;0;0;0;0;0;0;0;0;0;0;0;0;0
FR;9;2022-04-16;0;0;0;0;0;0;0;0;0;0;0;0;0;0;0;0;0;0
FR;9;2022-04-17;0;0;0;0;0;0;0;0;0;0;0;0;0;0;0;0;0;0
FR;9;2022-04-18;0;0;0;0;0;0;0;0;0;0;0;0;0;0;0;0;0;0
FR;9;2022-04-19;0;0;0;0;0;0;0;0;0;0;0;0;0;0;0;0;0;0
FR;9;2022-04-20;0;0;0;0;0;0;0;0;0;0;0;0;0;0;0;0;0;0
FR;9;2022-04-21;0;0;0;0;0;0;0;0;0;0;0;0;0;0;0;0;0;0
FR;9;2022-04-22;0;0;0;0;0;0;0;0;0;0;0;0;0;0;0;0;0;0
FR;9;2022-04-23;0;0;0;0;0;0;0;0;0;0;0;0;0;0;0;0;0;0
FR;9;2022-04-24;0;0;0;0;0;0;0;0;0;0;0;0;0;0;0;0;0;0
FR;9;2022-04-25;0;0;0;0;0;0;0;0;0;0;0;0;0;0;0;0;0;0
FR;9;2022-04-26;0;0;0;0;0;0;0;0;0;0;0;0;0;0;0;0;0;0
FR;9;2022-04-27;0;0;0;0;0;0;0;0;0;0;0;0;0;0;0;0;0;0
FR;9;2022-04-28;0;0;0;0;0;0;0;0;0;0;0;0;0;0;0;0;0;0
FR;9;2022-04-29;0;0;0;0;0;0;0;0;0;0;0;0;0;0;0;0;0;0
FR;9;2022-04-30;0;0;0;0;0;0;0;0;0;0;0;0;0;0;0;0;0;0
FR;9;2022-05-01;0;0;0;0;0;0;0;0;0;0;0;0;0;0;0;0;0;0
FR;9;2022-05-02;0;0;0;0;0;0;0;0;0;0;0;0;0;0;0;0;0;0
FR;9;2022-05-03;0;0;0;0;0;0;0;0;0;0;0;0;0;0;0;0;0;0
FR;9;2022-05-04;0;0;0;0;0;0;0;0;0;0;0;0;0;0;0;0;0;0
FR;9;2022-05-05;0;0;0;0;0;0;0;0;0;0;0;0;0;0;0;0;0;0
FR;9;2022-05-06;0;0;0;0;0;0;0;0;0;0;0;0;0;0;0;0;0;0
FR;9;2022-05-07;0;0;0;0;0;0;0;0;0;0;0;0;0;0;0;0;0;0
FR;9;2022-05-08;0;0;0;0;0;0;0;0;0;0;0;0;0;0;0;0;0;0
FR;9;2022-05-09;0;0;0;0;0;0;0;0;0;0;0;0;0;0;0;0;0;0
FR;9;2022-05-10;0;0;0;0;0;0;0;0;0;0;0;0;0;0;0;0;0;0
FR;9;2022-05-11;0;0;0;0;0;0;0;0;0;0;0;0;0;0;0;0;0;0
FR;9;2022-05-12;0;0;0;0;0;0;0;0;0;0;0;0;0;0;0;0;0;0
FR;9;2022-05-13;0;0;0;0;0;0;0;0;0;0;0;0;0;0;0;0;0;0
FR;9;2022-05-14;0;0;0;0;0;0;0;0;0;0;0;0;0;0;0;0;0;0
FR;9;2022-05-15;0;0;0;0;0;0;0;0;0;0;0;0;0;0;0;0;0;0
FR;9;2022-05-16;0;0;0;0;0;0;0;0;0;0;0;0;0;0;0;0;0;0
FR;9;2022-05-17;0;0;0;0;0;0;0;0;0;0;0;0;0;0;0;0;0;0
FR;9;2022-05-18;0;0;0;0;0;0;0;0;0;0;0;0;0;0;0;0;0;0
FR;9;2022-05-19;0;0;0;0;0;0;0;0;0;0;0;0;0;0;0;0;0;0
FR;9;2022-05-20;0;0;0;0;0;0;0;0;0;0;0;0;0;0;0;0;0;0
FR;9;2022-05-21;0;0;0;0;0;0;0;0;0;0;0;0;0;0;0;0;0;0
FR;9;2022-05-22;0;0;0;0;0;0;0;0;0;0;0;0;0;0;0;0;0;0
FR;9;2022-05-23;0;0;0;0;0;0;0;0;0;0;0;0;0;0;0;0;0;0
FR;9;2022-05-24;0;0;0;0;0;0;0;0;0;0;0;0;0;0;0;0;0;0
FR;9;2022-05-25;0;0;0;0;0;0;0;0;0;0;0;0;0;0;0;0;0;0
FR;9;2022-05-26;0;0;0;0;0;0;0;0;0;0;0;0;0;0;0;0;0;0
FR;9;2022-05-27;0;0;0;0;0;0;0;0;0;0;0;0;0;0;0;0;0;0
FR;9;2022-05-28;0;0;0;0;0;0;0;0;0;0;0;0;0;0;0;0;0;0
FR;9;2022-05-29;0;0;0;0;0;0;0;0;0;0;0;0;0;0;0;0;0;0
FR;9;2022-05-30;0;0;0;0;0;0;0;0;0;0;0;0;0;0;0;0;0;0
FR;9;2022-05-31;0;0;0;0;0;0;0;0;0;0;0;0;0;0;0;0;0;0
FR;9;2022-06-01;0;0;0;0;0;0;0;0;0;0;0;0;0;0;0;0;0;0
FR;9;2022-06-02;0;0;0;0;0;0;0;0;0;0;0;0;0;0;0;0;0;0
FR;9;2022-06-03;0;0;0;0;0;0;0;0;0;0;0;0;0;0;0;0;0;0
FR;9;2022-06-04;0;0;0;0;0;0;0;0;0;0;0;0;0;0;0;0;0;0
FR;9;2022-06-05;0;0;0;0;0;0;0;0;0;0;0;0;0;0;0;0;0;0
FR;9;2022-06-06;0;0;0;0;0;0;0;0;0;0;0;0;0;0;0;0;0;0
FR;9;2022-06-07;0;0;0;0;0;0;0;0;0;0;0;0;0;0;0;0;0;0
FR;9;2022-06-08;0;0;0;0;0;0;0;0;0;0;0;0;0;0;0;0;0;0
FR;9;2022-06-09;0;0;0;0;0;0;0;0;0;0;0;0;0;0;0;0;0;0
FR;9;2022-06-10;0;0;0;0;0;0;0;0;0;0;0;0;0;0;0;0;0;0
FR;9;2022-06-11;0;0;0;0;0;0;0;0;0;0;0;0;0;0;0;0;0;0
FR;9;2022-06-12;0;0;0;0;0;0;0;0;0;0;0;0;0;0;0;0;0;0
FR;9;2022-06-13;0;0;0;0;0;0;0;0;0;0;0;0;0;0;0;0;0;0
FR;9;2022-06-14;0;0;0;0;0;0;0;0;0;0;0;0;0;0;0;0;0;0
FR;9;2022-06-15;0;0;0;0;0;0;0;0;0;0;0;0;0;0;0;0;0;0
FR;9;2022-06-16;0;0;0;0;0;0;0;0;0;0;0;0;0;0;0;0;0;0
FR;9;2022-06-17;0;0;0;0;0;0;0;0;0;0;0;0;0;0;0;0;0;0
FR;9;2022-06-18;0;0;0;0;0;0;0;0;0;0;0;0;0;0;0;0;0;0
FR;9;2022-06-19;0;0;0;0;0;0;0;0;0;0;0;0;0;0;0;0;0;0
FR;9;2022-06-20;0;0;0;0;0;0;0;0;0;0;0;0;0;0;0;0;0;0
FR;9;2022-06-21;0;0;0;0;0;0;0;0;0;0;0;0;0;0;0;0;0;0
FR;9;2022-06-22;0;0;0;0;0;0;0;0;0;0;0;0;0;0;0;0;0;0
FR;9;2022-06-23;0;0;0;0;0;0;0;0;0;0;0;0;0;0;0;0;0;0
FR;9;2022-06-24;0;0;0;0;0;0;0;0;0;0;0;0;0;0;0;0;0;0
FR;9;2022-06-25;0;0;0;0;0;0;0;0;0;0;0;0;0;0;0;0;0;0
FR;9;2022-06-26;0;0;0;0;0;0;0;0;0;0;0;0;0;0;0;0;0;0
FR;9;2022-06-27;0;0;0;0;0;0;0;0;0;0;0;0;0;0;0;0;0;0
FR;9;2022-06-28;0;0;0;0;0;0;0;0;0;0;0;0;0;0;0;0;0;0
FR;9;2022-06-29;0;0;0;0;0;0;0;0;0;0;0;0;0;0;0;0;0;0
FR;9;2022-06-30;0;0;0;0;0;0;0;0;0;0;0;0;0;0;0;0;0;0
FR;9;2022-07-01;0;0;0;0;0;0;0;0;0;0;0;0;0;0;0;0;0;0
FR;9;2022-07-02;0;0;0;0;0;0;0;0;0;0;0;0;0;0;0;0;0;0
FR;9;2022-07-03;0;0;0;0;0;0;0;0;0;0;0;0;0;0;0;0;0;0
FR;9;2022-07-04;0;0;0;0;0;0;0;0;0;0;0;0;0;0;0;0;0;0
FR;9;2022-07-05;0;0;0;0;0;0;0;0;0;0;0;0;0;0;0;0;0;0
FR;9;2022-07-06;0;0;0;0;0;0;0;0;0;0;0;0;0;0;0;0;0;0
FR;9;2022-07-07;0;0;0;0;0;0;0;0;0;0;0;0;0;0;0;0;0;0
FR;9;2022-07-08;0;0;0;0;0;0;0;0;0;0;0;0;0;0;0;0;0;0
FR;9;2022-07-09;0;0;0;0;0;0;0;0;0;0;0;0;0;0;0;0;0;0
FR;9;2022-07-10;0;0;0;0;0;0;0;0;0;0;0;0;0;0;0;0;0;0
FR;9;2022-07-11;0;0;0;0;0;0;0;0;0;0;0;0;0;0;0;0;0;0
FR;9;2022-07-12;0;0;0;0;0;0;0;0;0;0;0;0;0;0;0;0;0;0
FR;9;2022-07-13;0;0;0;0;0;0;0;0;0;0;0;0;0;0;0;0;0;0
FR;9;2022-07-14;0;0;0;0;0;0;0;0;0;0;0;0;0;0;0;0;0;0
FR;9;2022-07-15;0;0;0;0;0;0;0;0;0;0;0;0;0;0;0;0;0;0
FR;9;2022-07-16;0;0;0;0;0;0;0;0;0;0;0;0;0;0;0;0;0;0
FR;9;2022-07-17;0;0;0;0;0;0;0;0;0;0;0;0;0;0;0;0;0;0
FR;9;2022-07-18;0;0;0;0;0;0;0;0;0;0;0;0;0;0;0;0;0;0
FR;9;2022-07-19;0;0;0;0;0;0;0;0;0;0;0;0;0;0;0;0;0;0
FR;9;2022-07-20;0;0;0;0;0;0;0;0;0;0;0;0;0;0;0;0;0;0
FR;9;2022-07-21;0;0;0;0;0;0;0;0;0;0;0;0;0;0;0;0;0;0
FR;9;2022-07-22;0;0;0;0;0;0;0;0;0;0;0;0;0;0;0;0;0;0
FR;9;2022-07-23;0;0;0;0;0;0;0;0;0;0;0;0;0;0;0;0;0;0
FR;9;2022-07-24;0;0;0;0;0;0;0;0;0;0;0;0;0;0;0;0;0;0
FR;9;2022-07-25;0;0;0;0;0;0;0;0;0;0;0;0;0;0;0;0;0;0
FR;9;2022-07-26;0;0;0;0;0;0;0;0;0;0;0;0;0;0;0;0;0;0
FR;9;2022-07-27;0;0;0;0;0;0;0;0;0;0;0;0;0;0;0;0;0;0
FR;9;2022-07-28;0;0;0;0;0;0;0;0;0;0;0;0;0;0;0;0;0;0
FR;9;2022-07-29;0;0;0;0;0;0;0;0;0;0;0;0;0;0;0;0;0;0
FR;9;2022-07-30;0;0;0;0;0;0;0;0;0;0;0;0;0;0;0;0;0;0
FR;9;2022-07-31;0;0;0;0;0;0;0;0;0;0;0;0;0;0;0;0;0;0
FR;9;2022-08-01;0;0;0;0;0;0;0;0;0;0;0;0;0;0;0;0;0;0
FR;9;2022-08-02;0;0;0;0;0;0;0;0;0;0;0;0;0;0;0;0;0;0
FR;9;2022-08-03;0;0;0;0;0;0;0;0;0;0;0;0;0;0;0;0;0;0
FR;9;2022-08-04;0;0;0;0;0;0;0;0;0;0;0;0;0;0;0;0;0;0
FR;9;2022-08-05;0;0;0;0;0;0;0;0;0;0;0;0;0;0;0;0;0;0
FR;9;2022-08-06;0;0;0;0;0;0;0;0;0;0;0;0;0;0;0;0;0;0
FR;9;2022-08-07;0;0;0;0;0;0;0;0;0;0;0;0;0;0;0;0;0;0
FR;9;2022-08-08;0;0;0;0;0;0;0;0;0;0;0;0;0;0;0;0;0;0
FR;9;2022-08-09;0;0;0;0;0;0;0;0;0;0;0;0;0;0;0;0;0;0
FR;9;2022-08-10;0;0;0;0;0;0;0;0;0;0;0;0;0;0;0;0;0;0
FR;9;2022-08-11;0;0;0;0;0;0;0;0;0;0;0;0;0;0;0;0;0;0
FR;9;2022-08-12;0;0;0;0;0;0;0;0;0;0;0;0;0;0;0;0;0;0
FR;9;2022-08-13;0;0;0;0;0;0;0;0;0;0;0;0;0;0;0;0;0;0
FR;9;2022-08-14;0;0;0;0;0;0;0;0;0;0;0;0;0;0;0;0;0;0
FR;9;2022-08-15;0;0;0;0;0;0;0;0;0;0;0;0;0;0;0;0;0;0
FR;9;2022-08-16;0;0;0;0;0;0;0;0;0;0;0;0;0;0;0;0;0;0
FR;9;2022-08-17;0;0;0;0;0;0;0;0;0;0;0;0;0;0;0;0;0;0
FR;9;2022-08-18;0;0;0;0;0;0;0;0;0;0;0;0;0;0;0;0;0;0
FR;9;2022-08-19;0;0;0;0;0;0;0;0;0;0;0;0;0;0;0;0;0;0
FR;9;2022-08-20;0;0;0;0;0;0;0;0;0;0;0;0;0;0;0;0;0;0
FR;9;2022-08-21;0;0;0;0;0;0;0;0;0;0;0;0;0;0;0;0;0;0
FR;9;2022-08-22;0;0;0;0;0;0;0;0;0;0;0;0;0;0;0;0;0;0
FR;9;2022-08-23;0;0;0;0;0;0;0;0;0;0;0;0;0;0;0;0;0;0
FR;9;2022-08-24;0;0;0;0;0;0;0;0;0;0;0;0;0;0;0;0;0;0
FR;9;2022-08-25;0;0;0;0;0;0;0;0;0;0;0;0;0;0;0;0;0;0
FR;9;2022-08-26;0;0;0;0;0;0;0;0;0;0;0;0;0;0;0;0;0;0
FR;9;2022-08-27;0;0;0;0;0;0;0;0;0;0;0;0;0;0;0;0;0;0
FR;9;2022-08-28;0;0;0;0;0;0;0;0;0;0;0;0;0;0;0;0;0;0
FR;9;2022-08-29;0;0;0;0;0;0;0;0;0;0;0;0;0;0;0;0;0;0
FR;9;2022-08-30;0;0;0;0;0;0;0;0;0;0;0;0;0;0;0;0;0;0
FR;9;2022-08-31;0;0;0;0;0;0;0;0;0;0;0;0;0;0;0;0;0;0
FR;9;2022-09-01;0;0;0;0;0;0;0;0;0;0;0;0;0;0;0;0;0;0
FR;9;2022-09-02;0;0;0;0;0;0;0;0;0;0;0;0;0;0;0;0;0;0
FR;9;2022-09-03;0;0;0;0;0;0;0;0;0;0;0;0;0;0;0;0;0;0
FR;9;2022-09-04;0;0;0;0;0;0;0;0;0;0;0;0;0;0;0;0;0;0
FR;9;2022-09-05;0;0;0;0;0;0;0;0;0;0;0;0;0;0;0;0;0;0
FR;9;2022-09-06;0;0;0;0;0;0;0;0;0;0;0;0;0;0;0;0;0;0
FR;9;2022-09-07;0;0;0;0;0;0;0;0;0;0;0;0;0;0;0;0;0;0
FR;9;2022-09-08;0;0;0;0;0;0;0;0;0;0;0;0;0;0;0;0;0;0
FR;9;2022-09-09;0;0;0;0;0;0;0;0;0;0;0;0;0;0;0;0;0;0
FR;9;2022-09-10;0;0;0;0;0;0;0;0;0;0;0;0;0;0;0;0;0;0
FR;9;2022-09-11;0;0;0;0;0;0;0;0;0;0;0;0;0;0;0;0;0;0
FR;9;2022-09-12;0;0;0;0;0;0;0;0;0;0;0;0;0;0;0;0;0;0
FR;9;2022-09-13;0;0;0;0;0;0;0;0;0;0;0;0;0;0;0;0;0;0
FR;9;2022-09-14;0;0;0;0;0;0;0;0;0;0;0;0;0;0;0;0;0;0
FR;9;2022-09-15;0;0;0;0;0;0;0;0;0;0;0;0;0;0;0;0;0;0
FR;9;2022-09-16;0;0;0;0;0;0;0;0;0;0;0;0;0;0;0;0;0;0
FR;9;2022-09-17;0;0;0;0;0;0;0;0;0;0;0;0;0;0;0;0;0;0
FR;9;2022-09-18;0;0;0;0;0;0;0;0;0;0;0;0;0;0;0;0;0;0
FR;9;2022-09-19;0;0;0;0;0;0;0;0;0;0;0;0;0;0;0;0;0;0
FR;9;2022-09-20;0;0;0;0;0;0;0;0;0;0;0;0;0;0;0;0;0;0
FR;9;2022-09-21;0;0;0;0;0;0;0;0;0;0;0;0;0;0;0;0;0;0
FR;9;2022-09-22;0;0;0;0;0;0;0;0;0;0;0;0;0;0;0;0;0;0
FR;9;2022-09-23;0;0;0;0;0;0;0;0;0;0;0;0;0;0;0;0;0;0
FR;9;2022-09-24;0;0;0;0;0;0;0;0;0;0;0;0;0;0;0;0;0;0
FR;9;2022-09-25;0;0;0;0;0;0;0;0;0;0;0;0;0;0;0;0;0;0
FR;9;2022-09-26;0;0;0;0;0;0;0;0;0;0;0;0;0;0;0;0;0;0
FR;9;2022-09-27;0;0;0;0;0;0;0;0;0;0;0;0;0;0;0;0;0;0
FR;9;2022-09-28;0;0;0;0;0;0;0;0;0;0;0;0;0;0;0;0;0;0
FR;9;2022-09-29;1;1;8;33;0;6;35;43;2;1;1;8;33;0;6;35;43;2
FR;9;2022-09-30;5;13;62;606;7;48;614;715;51;6;14;70;639;7;54;649;758;53
FR;9;2022-10-01;10;2;43;327;3;26;335;396;35;16;16;113;966;10;80;984;1154;88
FR;9;2022-10-02;2;1;5;50;0;4;51;66;11;18;17;118;1016;10;84;1035;1220;99
FR;9;2022-10-03;15;17;151;1714;11;129;1708;2074;234;33;34;269;2730;21;213;2743;3294;333
FR;9;2022-10-04;23;48;353;3954;18;228;4022;4704;450;56;82;622;6684;39;441;6765;7998;783
FR;9;2022-10-05;30;21;269;3000;18;203;3013;3658;433;86;103;891;9684;57;644;9778;11656;1216
FR;9;2022-10-06;23;35;400;4598;18;301;4631;5609;672;109;138;1291;14282;75;945;14409;17265;1888
FR;9;2022-10-07;29;50;499;5706;19;384;5720;7029;923;138;188;1790;19988;94;1329;20129;24294;2811
FR;9;2022-10-08;10;18;128;1090;8;86;1108;1389;191;148;206;1918;21078;102;1415;21237;25683;3002
FR;9;2022-10-09;1;7;22;197;1;29;198;277;50;149;213;1940;21275;103;1444;21435;25960;3052
FR;9;2022-10-10;11;26;207;2572;14;181;2576;3296;533;160;239;2147;23847;117;1625;24011;29256;3585
FR;9;2022-10-11;31;40;424;5043;27;312;5024;6198;851;191;279;2571;28890;144;1937;29035;35454;4436
FR;9;2022-10-12;22;26;297;2987;16;212;3044;3830;572;213;305;2868;31877;160;2149;32079;39284;5008
FR;9;2022-10-13;25;42;374;3980;16;245;4036;5027;740;238;347;3242;35857;176;2394;36115;44311;5748
FR;9;2022-10-14;27;26;383;4430;12;295;4414;5558;838;265;373;3625;40287;188;2689;40529;49869;6586
FR;9;2022-10-15;14;8;101;1052;7;79;1029;1308;198;279;381;3726;41339;195;2768;41558;51177;6784
FR;9;2022-10-16;4;1;9;132;2;12;126;168;28;283;382;3735;41471;197;2780;41684;51345;6812
FR;9;2022-10-17;4;22;165;1875;11;127;1883;2492;475;287;404;3900;43346;208;2907;43567;53837;7287
FR;9;2022-10-18;36;29;317;3430;17;237;3454;4663;963;323;433;4217;46776;225;3144;47021;58500;8250
FR;9;2022-10-19;22;19;262;2688;17;174;2717;3733;827;345;452;4479;49464;242;3318;49738;62233;9077
FR;9;2022-10-20;22;22;308;3628;8;233;3639;4813;933;367;474;4787;53092;250;3551;53377;67046;10010
FR;9;2022-10-21;14;32;327;3550;11;228;3556;4656;864;381;506;5114;56642;261;3779;56933;71702;10874
FR;9;2022-10-22;10;11;90;914;8;62;919;1193;207;391;517;5204;57556;269;3841;57852;72895;11081
FR;9;2022-10-23;2;2;17;100;2;10;105;148;33;393;519;5221;57656;271;3851;57957;73043;11114
FR;9;2022-10-24;7;17;159;1363;6;106;1434;1942;397;400;536;5380;59019;277;3957;59391;74985;11511
FR;9;2022-10-25;19;22;228;2841;16;188;2851;3938;896;419;558;5608;61860;293;4145;62242;78923;12407
FR;9;2022-10-26;14;16;169;1800;13;123;1812;2527;590;433;574;5777;63660;306;4268;64054;81450;12997
FR;9;2022-10-27;9;26;230;2303;15;173;2337;3210;689;442;600;6007;65963;321;4441;66391;84660;13686
FR;9;2022-10-28;18;27;224;2277;17;151;2303;3142;681;460;627;6231;68240;338;4592;68694;87802;14367
FR;9;2022-10-29;12;8;55;505;5;46;496;662;119;472;635;6286;68745;343;4638;69190;88464;14486
FR;9;2022-10-30;2;1;8;58;1;8;58;82;16;474;636;6294;68803;344;4646;69248;88546;14502
FR;9;2022-10-31;13;7;105;660;9;59;695;996;240;487;643;6399;69463;353;4705;69943;89542;14742
FR;9;2022-11-01;1;2;15;43;1;11;49;71;11;488;645;6414;69506;354;4716;69992;89613;14753
FR;9;2022-11-02;7;12;102;1027;4;76;1045;1577;452;495;657;6516;70533;358;4792;71037;91190;15205
FR;9;2022-11-03;17;18;157;1599;16;92;1647;2348;599;512;675;6673;72132;374;4884;72684;93538;15804
FR;9;2022-11-04;21;19;193;1751;15;120;1800;2536;611;533;694;6866;73883;389;5004;74484;96074;16415
FR;9;2022-11-05;8;10;58;403;9;39;424;573;107;541;704;6924;74286;398;5043;74908;96647;16522
FR;9;2022-11-06;5;4;5;62;6;2;61;88;25;546;708;6929;74348;404;5045;74969;96735;16547
FR;9;2022-11-07;16;19;89;942;16;110;941;1489;432;562;727;7018;75290;420;5155;75910;98224;16979
FR;9;2022-11-08;11;19;171;1827;13;137;1815;2660;703;573;746;7189;77117;433;5292;77725;100884;17682
FR;9;2022-11-09;16;16;123;1261;9;98;1322;1878;453;589;762;7312;78378;442;5390;79047;102762;18135
FR;9;2022-11-10;13;22;162;1623;14;137;1621;2281;519;602;784;7474;80001;456;5527;80668;105043;18654
FR;9;2022-11-11;1;1;13;81;1;6;83;124;35;603;785;7487;80082;457;5533;80751;105167;18689
FR;9;2022-11-12;5;8;44;259;7;19;278;395;97;608;793;7531;80341;464;5552;81029;105562;18786
FR;9;2022-11-13;2;0;4;30;0;4;31;51;16;610;793;7535;80371;464;5556;81060;105613;18802
FR;9;2022-11-14;11;12;56;713;11;44;722;1108;339;621;805;7591;81084;475;5600;81782;106721;19141
FR;9;2022-11-15;18;17;150;1346;8;103;1356;2103;638;639;822;7741;82430;483;5703;83138;108824;19779
FR;9;2022-11-16;10;5;99;979;8;58;997;1490;431;649;827;7840;83409;491;5761;84135;110314;20210
FR;9;2022-11-17;9;17;126;1086;11;78;1111;1695;501;658;844;7966;84495;502;5839;85246;112009;20711
FR;9;2022-11-18;7;16;120;1440;5;78;1455;2027;492;665;860;8086;85935;507;5917;86701;114036;21203
FR;9;2022-11-19;3;5;51;364;1;28;351;490;106;668;865;8137;86299;508;5945;87052;114526;21309
FR;9;2022-11-20;1;0;5;37;0;3;35;54;16;669;865;8142;86336;508;5948;87087;114580;21325
FR;9;2022-11-21;9;12;66;636;5;51;639;960;263;678;877;8208;86972;513;5999;87726;115540;21588
FR;9;2022-11-22;15;12;121;1037;13;74;1067;1592;449;693;889;8329;88009;526;6073;88793;117132;22037
FR;9;2022-11-23;7;10;69;735;5;33;762;1172;372;700;899;8398;88744;531;6106;89555;118304;22409
FR;9;2022-11-24;8;19;93;979;14;68;992;1472;406;708;918;8491;89723;545;6174;90547;119776;22815
FR;9;2022-11-25;8;11;107;1180;9;82;1195;1781;503;716;929;8598;90903;554;6256;91742;121557;23318
FR;9;2022-11-26;6;6;35;217;7;24;214;310;68;722;935;8633;91120;561;6280;91956;121867;23386
FR;9;2022-11-27;1;1;6;42;0;2;46;82;34;723;936;8639;91162;561;6282;92002;121949;23420
FR;9;2022-11-28;5;7;103;698;7;60;726;1135;344;728;943;8742;91860;568;6342;92728;123084;23764
FR;9;2022-11-29;6;18;142;1299;6;89;1327;1942;521;734;961;8884;93159;574;6431;94055;125026;24285
FR;9;2022-11-30;9;12;99;1032;5;76;1055;1606;470;743;973;8983;94191;579;6507;95110;126632;24755
FR;9;2022-12-01;16;14;112;1345;8;80;1331;1970;554;759;987;9095;95536;587;6587;96441;128602;25309
FR;9;2022-12-02;10;13;193;1817;10;107;1818;2631;700;769;1000;9288;97353;597;6694;98259;131233;26009
FR;9;2022-12-03;7;9;79;619;5;41;632;887;208;776;1009;9367;97972;602;6735;98891;132120;26217
FR;9;2022-12-04;11;4;15;105;5;8;105;153;40;787;1013;9382;98077;607;6743;98996;132273;26257
FR;9;2022-12-05;21;24;144;1406;18;98;1421;2110;584;808;1037;9526;99483;625;6841;100417;134383;26841
FR;9;2022-12-06;30;21;264;2453;21;148;2548;3812;1097;838;1058;9790;101936;646;6989;102965;138195;27938
FR;9;2022-12-07;15;22;181;1848;20;112;1890;2826;814;853;1080;9971;103784;666;7101;104855;141021;28752
FR;9;2022-12-08;14;22;222;2404;15;125;2467;3701;1092;867;1102;10193;106188;681;7226;107322;144722;29844
FR;9;2022-12-09;14;25;287;2888;10;143;2986;4337;1200;881;1127;10480;109076;691;7369;110308;149059;31044
FR;9;2022-12-10;12;13;122;1324;5;56;1347;1819;410;893;1140;10602;110400;696;7425;111655;150878;31454
FR;9;2022-12-11;5;5;21;277;6;10;283;363;66;898;1145;10623;110677;702;7435;111938;151241;31520
FR;9;2022-12-12;17;14;215;1958;12;109;2032;2892;746;915;1159;10838;112635;714;7544;113970;154133;32266
FR;9;2022-12-13;28;23;317;3085;15;151;3221;4720;1337;943;1182;11155;115720;729;7695;117191;158853;33603
FR;9;2022-12-14;15;10;191;2335;8;94;2405;3505;989;958;1192;11346;118055;737;7789;119596;162358;34592
FR;9;2022-12-15;17;24;257;2611;13;138;2682;4069;1238;975;1216;11603;120666;750;7927;122278;166427;35830
FR;9;2022-12-16;15;29;294;3072;21;165;3155;4603;1274;990;1245;11897;123738;771;8092;125433;171030;37104
FR;9;2022-12-17;8;11;106;1193;6;50;1208;1664;402;998;1256;12003;124931;777;8142;126641;172694;37506
FR;9;2022-12-18;1;7;30;245;6;14;251;333;67;999;1263;12033;125176;783;8156;126892;173027;37573
FR;9;2022-12-19;20;21;149;1599;15;78;1631;2507;789;1019;1284;12182;126775;798;8234;128523;175534;38362
FR;9;2022-12-20;21;19;232;2306;6;115;2349;3708;1233;1040;1303;12414;129081;804;8349;130872;179242;39595
FR;9;2022-12-21;6;14;139;1501;7;66;1554;2402;775;1046;1317;12553;130582;811;8415;132426;181644;40370
FR;9;2022-12-22;19;9;136;1402;9;78;1418;2119;615;1065;1326;12689;131984;820;8493;133844;183763;40985
FR;9;2022-12-23;11;15;77;728;9;51;730;1092;305;1076;1341;12766;132712;829;8544;134574;184855;41290
FR;9;2022-12-24;1;5;13;96;4;6;98;138;34;1077;1346;12779;132808;833;8550;134672;184993;41324
FR;9;2022-12-25;1;0;5;5;0;4;6;12;2;1078;1346;12784;132813;833;8554;134678;185005;41326
FR;9;2022-12-26;17;8;64;547;11;37;554;829;235;1095;1354;12848;133360;844;8591;135232;185834;41561
FR;9;2022-12-27;12;30;97;882;14;69;917;1422;430;1107;1384;12945;134242;858;8660;136149;187256;41991
FR;9;2022-12-28;8;9;82;749;8;40;768;1185;372;1115;1393;13027;134991;866;8700;136917;188441;42363
FR;9;2022-12-29;9;14;92;720;10;51;753;1135;324;1124;1407;13119;135711;876;8751;137670;189576;42687
FR;9;2022-12-30;12;17;77;592;9;47;612;899;237;1136;1424;13196;136303;885;8798;138282;190475;42924
FR;9;2022-12-31;2;3;17;136;2;12;139;190;38;1138;1427;13213;136439;887;8810;138421;190665;42962
FR;9;2023-01-01;0;2;3;19;1;4;19;31;8;1138;1429;13216;136458;888;8814;138440;190696;42970
FR;9;2023-01-02;11;11;56;592;4;40;585;949;320;1149;1440;13272;137050;892;8854;139025;191645;43290
FR;9;2023-01-03;19;20;122;1079;20;75;1101;1940;749;1168;1460;13394;138129;912;8929;140126;193585;44039
FR;9;2023-01-04;21;19;113;846;9;73;898;1609;633;1189;1479;13507;138975;921;9002;141024;195194;44672
FR;9;2023-01-05;5;20;115;1059;11;65;1091;2048;882;1194;1499;13622;140034;932;9067;142115;197242;45554
FR;9;2023-01-06;13;17;152;1370;4;73;1388;2410;938;1207;1516;13774;141404;936;9140;143503;199652;46492
FR;9;2023-01-07;6;13;58;436;14;36;427;687;220;1213;1529;13832;141840;950;9176;143930;200339;46712
FR;9;2023-01-08;4;11;15;92;9;12;91;137;32;1217;1540;13847;141932;959;9188;144021;200476;46744
FR;9;2023-01-09;16;15;87;623;9;62;615;1276;586;1233;1555;13934;142555;968;9250;144636;201752;47330
FR;9;2023-01-10;13;12;154;979;11;74;1033;1990;871;1246;1567;14088;143534;979;9324;145669;203742;48201
FR;9;2023-01-11;19;9;74;680;10;49;689;1387;643;1265;1576;14162;144214;989;9373;146358;205129;48844
FR;9;2023-01-12;21;9;92;845;3;77;823;1688;775;1286;1585;14254;145059;992;9450;147181;206817;49619
FR;9;2023-01-13;15;19;106;888;12;73;910;1784;785;1301;1604;14360;145947;1004;9523;148091;208601;50404
FR;9;2023-01-14;9;9;55;294;5;33;299;585;247;1310;1613;14415;146241;1009;9556;148390;209186;50651
FR;9;2023-01-15;1;3;15;37;0;9;41;82;32;1311;1616;14430;146278;1009;9565;148431;209268;50683
FR;9;2023-01-16;6;15;54;366;13;24;383;785;371;1317;1631;14484;146644;1022;9589;148814;210053;51054
FR;9;2023-01-17;7;9;83;563;4;49;577;1244;609;1324;1640;14567;147207;1026;9638;149391;211297;51663
FR;9;2023-01-18;8;14;37;380;6;32;397;841;405;1332;1654;14604;147587;1032;9670;149788;212138;52068
FR;9;2023-01-19;10;9;58;477;8;30;478;1088;569;1342;1663;14662;148064;1040;9700;150266;213226;52637
FR;9;2023-01-20;15;19;96;578;16;57;595;1190;534;1357;1682;14758;148642;1056;9757;150861;214416;53171
FR;9;2023-01-21;8;15;20;192;11;13;190;347;140;1365;1697;14778;148834;1067;9770;151051;214763;53311
FR;9;2023-01-22;0;0;8;20;0;5;21;42;16;1365;1697;14786;148854;1067;9775;151072;214805;53327
FR;9;2023-01-23;4;15;27;253;9;25;242;563;287;1369;1712;14813;149107;1076;9800;151314;215368;53614
FR;9;2023-01-24;11;10;70;461;9;42;484;1162;633;1380;1722;14883;149568;1085;9842;151798;216530;54247
FR;9;2023-01-25;11;20;50;325;9;47;336;798;410;1391;1742;14933;149893;1094;9889;152134;217328;54657
FR;9;2023-01-26;7;17;64;391;8;50;390;967;515;1398;1759;14997;150284;1102;9939;152524;218295;55172
FR;9;2023-01-27;4;7;59;381;3;31;397;906;462;1402;1766;15056;150665;1105;9970;152921;219201;55634
FR;9;2023-01-28;3;6;31;128;5;27;120;265;116;1405;1772;15087;150793;1110;9997;153041;219466;55750
FR;9;2023-01-29;3;0;3;18;2;1;17;40;22;1408;1772;15090;150811;1112;9998;153058;219506;55772
FR;9;2023-01-30;4;6;31;192;5;11;211;501;272;1412;1778;15121;151003;1117;10009;153269;220007;56044
FR;9;2023-01-31;14;7;38;260;8;18;264;649;359;1426;1785;15159;151263;1125;10027;153533;220656;56403
FR;9;2023-02-01;5;7;26;173;4;20;179;519;309;1431;1792;15185;151436;1129;10047;153712;221175;56712
FR;9;2023-02-02;4;6;31;252;6;23;233;666;395;1435;1798;15216;151688;1135;10070;153945;221841;57107
FR;9;2023-02-03;8;13;42;289;10;37;275;677;355;1443;1811;15258;151977;1145;10107;154220;222518;57462
FR;9;2023-02-04;6;5;10;70;7;8;68;160;84;1449;1816;15268;152047;1152;10115;154288;222678;57546
FR;9;2023-02-05;1;1;4;7;0;4;7;17;6;1450;1817;15272;152054;1152;10119;154295;222695;57552
FR;9;2023-02-06;3;5;17;81;4;15;78;229;134;1453;1822;15289;152135;1156;10134;154373;222924;57686
FR;9;2023-02-07;3;5;30;145;3;21;138;451;285;1456;1827;15319;152280;1159;10155;154511;223375;57971
FR;9;2023-02-08;4;6;25;116;3;13;125;301;160;1460;1833;15344;152396;1162;10168;154636;223676;58131
FR;9;2023-02-09;8;3;20;138;4;14;123;343;202;1468;1836;15364;152534;1166;10182;154759;224019;58333
FR;9;2023-02-10;8;8;19;149;10;11;145;315;153;1476;1844;15383;152683;1176;10193;154904;224334;58486
FR;9;2023-02-11;5;4;14;42;3;9;47;84;28;1481;1848;15397;152725;1179;10202;154951;224418;58514
FR;9;2023-02-12;0;0;0;1;0;0;1;8;7;1481;1848;15397;152726;1179;10202;154952;224426;58521
FR;9;2023-02-13;3;8;5;50;8;4;45;107;55;1484;1856;15402;152776;1187;10206;154997;224533;58576
FR;9;2023-02-14;10;10;16;66;10;13;63;225;146;1494;1866;15418;152842;1197;10219;155060;224758;58722
FR;9;2023-02-15;1;5;17;52;3;13;50;163;99;1495;1871;15435;152894;1200;10232;155110;224921;58821
FR;9;2023-02-16;4;6;19;77;1;17;78;197;93;1499;1877;15454;152971;1201;10249;155188;225118;58914
FR;9;2023-02-17;6;4;15;62;5;11;64;178;99;1505;1881;15469;153033;1206;10260;155252;225296;59013
FR;9;2023-02-18;1;5;1;30;5;3;25;58;29;1506;1886;15470;153063;1211;10263;155277;225354;59042
FR;9;2023-02-19;1;0;0;1;0;0;1;3;2;1507;1886;15470;153064;1211;10263;155278;225357;59044
FR;9;2023-02-20;2;3;9;60;2;6;60;123;55;1509;1889;15479;153124;1213;10269;155338;225480;59099
FR;9;2023-02-21;6;9;11;65;7;10;65;160;83;1515;1898;15490;153189;1220;10279;155403;225640;59182
FR;9;2023-02-22;2;4;18;70;3;13;72;210;118;1517;1902;15508;153259;1223;10292;155475;225850;59300
FR;9;2023-02-23;5;3;17;63;1;12;69;146;61;1522;1905;15525;153322;1224;10304;155544;225996;59361
FR;9;2023-02-24;6;5;13;80;6;8;83;211;114;1528;1910;15538;153402;1230;10312;155627;226207;59475
FR;9;2023-02-25;2;2;10;14;4;4;23;43;16;1530;1912;15548;153416;1234;10316;155650;226250;59491
FR;9;2023-02-26;3;1;0;4;3;1;4;5;0;1533;1913;15548;153420;1237;10317;155654;226255;59491
FR;9;2023-02-27;2;3;5;17;3;2;19;49;26;1535;1916;15553;153437;1240;10319;155673;226304;59517
FR;9;2023-02-28;7;13;18;55;11;16;58;155;76;1542;1929;15571;153492;1251;10335;155731;226459;59593
FR;9;2023-03-01;0;9;6;20;7;7;20;78;48;1542;1938;15577;153512;1258;10342;155751;226537;59641
FR;9;2023-03-02;0;1;7;31;1;2;36;80;41;1542;1939;15584;153543;1259;10344;155787;226617;59682
FR;9;2023-03-03;1;4;9;47;3;7;48;122;67;1543;1943;15593;153590;1262;10351;155835;226739;59749
FR;9;2023-03-04;1;2;7;19;1;4;25;41;10;1544;1945;15600;153609;1263;10355;155860;226780;59759
FR;9;2023-03-05;0;1;1;0;1;0;1;8;7;1544;1946;15601;153609;1264;10355;155861;226788;59766
FR;9;2023-03-06;1;6;6;8;3;6;9;35;19;1545;1952;15607;153617;1267;10361;155870;226823;59785
FR;9;2023-03-07;2;4;8;20;0;9;24;69;34;1547;1956;15615;153637;1267;10370;155894;226892;59819
FR;9;2023-03-08;2;4;10;6;4;4;13;39;20;1549;1960;15625;153643;1271;10374;155907;226931;59839
FR;9;2023-03-09;1;3;9;12;2;6;17;65;42;1550;1963;15634;153655;1273;10380;155924;226996;59881
FR;9;2023-03-10;3;3;6;23;3;4;20;73;47;1553;1966;15640;153678;1276;10384;155944;227069;59928
FR;9;2023-03-11;2;3;4;8;2;1;11;15;3;1555;1969;15644;153686;1278;10385;155955;227084;59931
FR;9;2023-03-12;0;1;0;0;1;0;0;0;0;1555;1970;15644;153686;1279;10385;155955;227084;59931
FR;9;2023-03-13;3;5;9;34;3;4;14;49;29;1558;1975;15653;153720;1282;10389;155969;227133;59960
FR;9;2023-03-14;3;3;7;27;1;6;29;79;41;1561;1978;15660;153747;1283;10395;155998;227212;60001
FR;9;2023-03-15;0;6;4;15;4;4;17;47;24;1561;1984;15664;153762;1287;10399;156015;227259;60025
FR;9;2023-03-16;0;9;7;15;5;8;15;77;52;1561;1993;15671;153777;1292;10407;156030;227336;60077
FR;9;2023-03-17;0;7;6;40;3;8;27;113;71;1561;2000;15677;153817;1295;10415;156057;227449;60148
FR;9;2023-03-18;2;2;5;13;1;4;16;48;26;1563;2002;15682;153830;1296;10419;156073;227497;60174
FR;9;2023-03-19;0;1;0;0;1;0;0;0;0;1563;2003;15682;153830;1297;10419;156073;227497;60174
FR;9;2023-03-20;3;7;1;25;6;1;13;54;40;1566;2010;15683;153855;1303;10420;156086;227551;60214
FR;9;2023-03-21;1;1;6;16;1;1;21;69;47;1567;2011;15689;153871;1304;10421;156107;227620;60261
FR;9;2023-03-22;1;2;4;19;2;2;22;78;49;1568;2013;15693;153890;1306;10423;156129;227698;60310
FR;9;2023-03-23;0;6;7;22;4;7;21;56;25;1568;2019;15700;153912;1310;10430;156150;227754;60335
FR;9;2023-03-24;2;2;5;25;2;5;26;53;19;1570;2021;15705;153937;1312;10435;156176;227807;60354
FR;9;2023-03-25;0;0;4;6;0;3;8;16;5;1570;2021;15709;153943;1312;10438;156184;227823;60359
FR;9;2023-03-26;0;1;0;0;0;1;0;2;1;1570;2022;15709;153943;1312;10439;156184;227825;60360
FR;9;2023-03-27;0;3;4;8;2;2;12;32;15;1570;2025;15713;153951;1314;10441;156196;227857;60375
FR;9;2023-03-28;5;13;6;17;12;7;16;49;22;1575;2038;15719;153968;1326;10448;156212;227906;60397
FR;9;2023-03-29;3;6;8;5;2;8;8;28;12;1578;2044;15727;153973;1328;10456;156220;227934;60409
FR;9;2023-03-30;2;2;2;17;2;3;17;43;20;1580;2046;15729;153990;1330;10459;156237;227977;60429
FR;9;2023-03-31;1;3;2;18;1;6;15;45;22;1581;2049;15731;154008;1331;10465;156252;228022;60451
FR;9;2023-04-01;0;1;5;2;0;4;5;12;3;1581;2050;15736;154010;1331;10469;156257;228034;60454
FR;9;2023-04-02;3;1;1;0;0;2;0;4;2;1584;2051;15737;154010;1331;10471;156257;228038;60456
FR;9;2023-04-03;0;1;3;13;0;4;10;53;34;1584;2052;15740;154023;1331;10475;156267;228091;60490
FR;9;2023-04-04;4;4;11;18;2;7;22;61;29;1588;2056;15751;154041;1333;10482;156289;228152;60519
FR;9;2023-04-05;0;2;5;27;1;3;32;78;39;1588;2058;15756;154068;1334;10485;156321;228230;60558
FR;9;2023-04-06;0;0;4;13;0;2;16;42;23;1588;2058;15760;154081;1334;10487;156337;228272;60581
FR;9;2023-04-07;1;6;1;7;2;4;7;34;19;1589;2064;15761;154088;1336;10491;156344;228306;60600
FR;9;2023-04-08;0;1;2;1;0;1;3;7;2;1589;2065;15763;154089;1336;10492;156347;228313;60602
FR;9;2023-04-09;0;1;0;0;1;0;0;2;1;1589;2066;15763;154089;1337;10492;156347;228315;60603
FR;9;2023-04-10;0;1;1;5;1;1;5;6;0;1589;2067;15764;154094;1338;10493;156352;228321;60603
FR;9;2023-04-11;2;5;4;9;4;3;8;22;8;1591;2072;15768;154103;1342;10496;156360;228343;60611
FR;9;2023-04-12;1;2;6;8;2;4;10;41;24;1592;2074;15774;154111;1344;10500;156370;228384;60635
FR;9;2023-04-13;0;0;2;4;0;2;4;15;9;1592;2074;15776;154115;1344;10502;156374;228399;60644
FR;9;2023-04-14;1;4;7;10;1;6;12;38;13;1593;2078;15783;154125;1345;10508;156386;228437;60657
FR;9;2023-04-15;0;1;2;2;1;1;2;7;4;1593;2079;15785;154127;1346;10509;156388;228444;60661
FR;9;2023-04-16;0;1;0;0;1;0;0;0;0;1593;2080;15785;154127;1347;10509;156388;228444;60661
FR;9;2023-04-17;1;2;7;11;2;3;14;45;21;1594;2082;15792;154138;1349;10512;156402;228489;60682
FR;9;2023-04-18;2;1;3;8;1;2;9;34;21;1596;2083;15795;154146;1350;10514;156411;228523;60703
FR;9;2023-04-19;1;0;2;4;0;2;4;28;16;1597;2083;15797;154150;1350;10516;156415;228551;60719
FR;9;2023-04-20;1;0;2;6;0;2;6;24;13;1598;2083;15799;154156;1350;10518;156421;228575;60732
FR;9;2023-04-21;0;2;2;5;1;3;8;31;15;1598;2085;15801;154161;1351;10521;156429;228606;60747
FR;9;2023-04-22;0;1;0;2;1;0;2;3;1;1598;2086;15801;154163;1352;10521;156431;228609;60748
FR;9;2023-04-23;0;0;0;0;0;0;0;1;0;1598;2086;15801;154163;1352;10521;156431;228610;60748
FR;9;2023-04-24;1;3;3;13;3;3;11;26;9;1599;2089;15804;154176;1355;10524;156442;228636;60757
FR;9;2023-04-25;1;2;5;11;2;1;16;87;43;1600;2091;15809;154187;1357;10525;156458;228723;60800
FR;9;2023-04-26;5;0;4;9;0;5;4;13;3;1605;2091;15813;154196;1357;10530;156462;228736;60803
FR;9;2023-04-27;0;2;4;2;2;4;1;9;3;1605;2093;15817;154198;1359;10534;156463;228745;60806
FR;9;2023-04-28;0;0;0;0;0;0;0;4;4;1605;2093;15817;154198;1359;10534;156463;228749;60810
FR;9;2023-04-29;1;2;2;0;1;1;3;8;3;1606;2095;15819;154198;1360;10535;156466;228757;60813
FR;9;2023-04-30;0;1;0;0;1;0;0;0;0;1606;2096;15819;154198;1361;10535;156466;228757;60813
FR;9;2023-05-01;0;0;0;0;0;0;0;0;0;1606;2096;15819;154198;1361;10535;156466;228757;60813
FR;9;2023-05-02;1;1;3;2;0;3;3;18;7;1607;2097;15822;154200;1361;10538;156469;228775;60820
FR;9;2023-05-03;2;2;2;2;1;3;2;9;3;1609;2099;15824;154202;1362;10541;156471;228784;60823
FR;9;2023-05-04;0;1;2;2;1;2;3;9;2;1609;2100;15826;154204;1363;10543;156474;228793;60825
FR;9;2023-05-05;0;1;2;1;1;0;3;19;11;1609;2101;15828;154205;1364;10543;156477;228812;60836
FR;9;2023-05-06;0;1;0;0;1;0;0;3;2;1609;2102;15828;154205;1365;10543;156477;228815;60838
FR;9;2023-05-07;0;1;0;0;0;1;0;1;0;1609;2103;15828;154205;1365;10544;156477;228816;60838
FR;9;2023-05-08;0;0;0;0;0;0;0;0;0;1609;2103;15828;154205;1365;10544;156477;228816;60838
FR;9;2023-05-09;0;1;3;16;1;3;14;45;28;1609;2104;15831;154221;1366;10547;156491;228861;60866
FR;9;2023-05-10;1;0;0;0;0;1;0;9;3;1610;2104;15831;154221;1366;10548;156491;228870;60869
FR;9;2023-05-11;0;0;1;0;0;1;0;7;5;1610;2104;15832;154221;1366;10549;156491;228877;60874
FR;9;2023-05-12;1;1;4;1;0;3;3;14;7;1611;2105;15836;154222;1366;10552;156494;228891;60881
FR;9;2023-05-13;0;0;0;0;0;0;0;2;1;1611;2105;15836;154222;1366;10552;156494;228893;60882
FR;9;2023-05-14;0;0;0;0;0;0;0;0;0;1611;2105;15836;154222;1366;10552;156494;228893;60882
FR;9;2023-05-15;0;0;0;1;0;0;1;9;2;1611;2105;15836;154223;1366;10552;156495;228902;60884
FR;9;2023-05-16;0;1;0;3;1;0;3;11;4;1611;2106;15836;154226;1367;10552;156498;228913;60888
FR;9;2023-05-17;0;0;1;4;0;1;3;7;0;1611;2106;15837;154230;1367;10553;156501;228920;60888
FR;9;2023-05-18;0;0;0;0;0;0;0;0;0;1611;2106;15837;154230;1367;10553;156501;228920;60888
FR;9;2023-05-19;0;1;1;1;1;0;2;6;4;1611;2107;15838;154231;1368;10553;156503;228926;60892
FR;9;2023-05-20;0;0;0;0;0;0;0;2;0;1611;2107;15838;154231;1368;10553;156503;228928;60892
FR;9;2023-05-21;0;0;0;0;0;0;0;0;0;1611;2107;15838;154231;1368;10553;156503;228928;60892
FR;9;2023-05-22;0;1;0;0;1;0;0;4;4;1611;2108;15838;154231;1369;10553;156503;228932;60896
FR;9;2023-05-23;1;1;0;1;0;1;1;10;3;1612;2109;15838;154232;1369;10554;156504;228942;60899
FR;9;2023-05-24;0;1;0;2;1;0;2;4;0;1612;2110;15838;154234;1370;10554;156506;228946;60899
FR;9;2023-05-25;0;0;0;0;0;0;0;3;0;1612;2110;15838;154234;1370;10554;156506;228949;60899
FR;9;2023-05-26;0;0;2;4;0;3;2;14;8;1612;2110;15840;154238;1370;10557;156508;228963;60907
FR;9;2023-05-27;0;0;0;0;0;0;0;0;0;1612;2110;15840;154238;1370;10557;156508;228963;60907
FR;9;2023-05-28;0;0;0;0;0;0;0;0;0;1612;2110;15840;154238;1370;10557;156508;228963;60907
FR;9;2023-05-29;0;0;0;0;0;0;0;0;0;1612;2110;15840;154238;1370;10557;156508;228963;60907
FR;9;2023-05-30;0;0;1;1;0;0;1;15;9;1612;2110;15841;154239;1370;10557;156509;228978;60916
FR;9;2023-05-31;0;0;2;1;0;1;0;5;1;1612;2110;15843;154240;1370;10558;156509;228983;60917
FR;9;2023-06-01;0;0;0;1;0;0;1;8;5;1612;2110;15843;154241;1370;10558;156510;228991;60922
FR;9;2023-06-02;0;0;1;2;0;1;2;15;6;1612;2110;15844;154243;1370;10559;156512;229006;60928
FR;9;2023-06-03;0;0;1;2;0;0;6;9;3;1612;2110;15845;154245;1370;10559;156518;229015;60931
FR;9;2023-06-04;0;0;0;0;0;0;0;0;0;1612;2110;15845;154245;1370;10559;156518;229015;60931
FR;9;2023-06-05;0;0;0;0;0;0;0;1;0;1612;2110;15845;154245;1370;10559;156518;229016;60931
FR;9;2023-06-06;0;0;0;0;0;0;0;9;3;1612;2110;15845;154245;1370;10559;156518;229025;60934
FR;9;2023-06-07;0;0;0;2;0;0;2;8;3;1612;2110;15845;154247;1370;10559;156520;229033;60937
FR;9;2023-06-08;0;0;1;1;0;1;1;7;4;1612;2110;15846;154248;1370;10560;156521;229040;60941
FR;9;2023-06-09;0;0;0;0;0;0;0;9;1;1612;2110;15846;154248;1370;10560;156521;229049;60942
FR;9;2023-06-10;0;1;1;1;0;1;2;8;1;1612;2111;15847;154249;1370;10561;156523;229057;60943
FR;9;2023-06-11;0;0;0;0;0;0;0;0;0;1612;2111;15847;154249;1370;10561;156523;229057;60943
FR;9;2023-06-12;0;0;0;0;0;0;0;4;3;1612;2111;15847;154249;1370;10561;156523;229061;60946
FR;9;2023-06-13;0;0;0;0;0;0;0;4;3;1612;2111;15847;154249;1370;10561;156523;229065;60949
FR;9;2023-06-14;0;0;0;0;0;0;0;2;1;1612;2111;15847;154249;1370;10561;156523;229067;60950
FR;9;2023-06-15;0;0;0;2;0;0;2;9;2;1612;2111;15847;154251;1370;10561;156525;229076;60952
FR;9;2023-06-16;0;1;0;1;1;0;1;12;10;1612;2112;15847;154252;1371;10561;156526;229088;60962
FR;9;2023-06-17;0;0;0;0;0;0;0;3;1;1612;2112;15847;154252;1371;10561;156526;229091;60963
FR;9;2023-06-18;0;0;0;0;0;0;0;0;0;1612;2112;15847;154252;1371;10561;156526;229091;60963
FR;9;2023-06-19;0;0;0;0;0;0;0;9;2;1612;2112;15847;154252;1371;10561;156526;229100;60965
FR;10;2020-12-27;0;0;0;0;0;0;0;0;0;0;0;0;0;0;0;0;0;0
FR;10;2020-12-28;0;0;0;0;0;0;0;0;0;0;0;0;0;0;0;0;0;0
FR;10;2020-12-29;0;0;0;0;0;0;0;0;0;0;0;0;0;0;0;0;0;0
FR;10;2020-12-30;0;0;0;0;0;0;0;0;0;0;0;0;0;0;0;0;0;0
FR;10;2020-12-31;0;0;0;0;0;0;0;0;0;0;0;0;0;0;0;0;0;0
FR;10;2021-01-01;0;0;0;0;0;0;0;0;0;0;0;0;0;0;0;0;0;0
FR;10;2021-01-02;0;0;0;0;0;0;0;0;0;0;0;0;0;0;0;0;0;0
FR;10;2021-01-03;0;0;0;0;0;0;0;0;0;0;0;0;0;0;0;0;0;0
FR;10;2021-01-04;0;0;0;0;0;0;0;0;0;0;0;0;0;0;0;0;0;0
FR;10;2021-01-05;0;0;0;0;0;0;0;0;0;0;0;0;0;0;0;0;0;0
FR;10;2021-01-06;0;0;0;0;0;0;0;0;0;0;0;0;0;0;0;0;0;0
FR;10;2021-01-07;0;0;0;0;0;0;0;0;0;0;0;0;0;0;0;0;0;0
FR;10;2021-01-08;0;0;0;0;0;0;0;0;0;0;0;0;0;0;0;0;0;0
FR;10;2021-01-09;0;0;0;0;0;0;0;0;0;0;0;0;0;0;0;0;0;0
FR;10;2021-01-10;0;0;0;0;0;0;0;0;0;0;0;0;0;0;0;0;0;0
FR;10;2021-01-11;0;0;0;0;0;0;0;0;0;0;0;0;0;0;0;0;0;0
FR;10;2021-01-12;0;0;0;0;0;0;0;0;0;0;0;0;0;0;0;0;0;0
FR;10;2021-01-13;0;0;0;0;0;0;0;0;0;0;0;0;0;0;0;0;0;0
FR;10;2021-01-14;0;0;0;0;0;0;0;0;0;0;0;0;0;0;0;0;0;0
FR;10;2021-01-15;0;0;0;0;0;0;0;0;0;0;0;0;0;0;0;0;0;0
FR;10;2021-01-16;0;0;0;0;0;0;0;0;0;0;0;0;0;0;0;0;0;0
FR;10;2021-01-17;0;0;0;0;0;0;0;0;0;0;0;0;0;0;0;0;0;0
FR;10;2021-01-18;0;0;0;0;0;0;0;0;0;0;0;0;0;0;0;0;0;0
FR;10;2021-01-19;0;0;0;0;0;0;0;0;0;0;0;0;0;0;0;0;0;0
FR;10;2021-01-20;0;0;0;0;0;0;0;0;0;0;0;0;0;0;0;0;0;0
FR;10;2021-01-21;0;0;0;0;0;0;0;0;0;0;0;0;0;0;0;0;0;0
FR;10;2021-01-22;0;0;0;0;0;0;0;0;0;0;0;0;0;0;0;0;0;0
FR;10;2021-01-23;0;0;0;0;0;0;0;0;0;0;0;0;0;0;0;0;0;0
FR;10;2021-01-24;0;0;0;0;0;0;0;0;0;0;0;0;0;0;0;0;0;0
FR;10;2021-01-25;0;0;0;0;0;0;0;0;0;0;0;0;0;0;0;0;0;0
FR;10;2021-01-26;0;0;0;0;0;0;0;0;0;0;0;0;0;0;0;0;0;0
FR;10;2021-01-27;0;0;0;0;0;0;0;0;0;0;0;0;0;0;0;0;0;0
FR;10;2021-01-28;0;0;0;0;0;0;0;0;0;0;0;0;0;0;0;0;0;0
FR;10;2021-01-29;0;0;0;0;0;0;0;0;0;0;0;0;0;0;0;0;0;0
FR;10;2021-01-30;0;0;0;0;0;0;0;0;0;0;0;0;0;0;0;0;0;0
FR;10;2021-01-31;0;0;0;0;0;0;0;0;0;0;0;0;0;0;0;0;0;0
FR;10;2021-02-01;0;0;0;0;0;0;0;0;0;0;0;0;0;0;0;0;0;0
FR;10;2021-02-02;0;0;0;0;0;0;0;0;0;0;0;0;0;0;0;0;0;0
FR;10;2021-02-03;0;0;0;0;0;0;0;0;0;0;0;0;0;0;0;0;0;0
FR;10;2021-02-04;0;0;0;0;0;0;0;0;0;0;0;0;0;0;0;0;0;0
FR;10;2021-02-05;0;0;0;0;0;0;0;0;0;0;0;0;0;0;0;0;0;0
FR;10;2021-02-06;0;0;0;0;0;0;0;0;0;0;0;0;0;0;0;0;0;0
FR;10;2021-02-07;0;0;0;0;0;0;0;0;0;0;0;0;0;0;0;0;0;0
FR;10;2021-02-08;0;0;0;0;0;0;0;0;0;0;0;0;0;0;0;0;0;0
FR;10;2021-02-09;0;0;0;0;0;0;0;0;0;0;0;0;0;0;0;0;0;0
FR;10;2021-02-10;0;0;0;0;0;0;0;0;0;0;0;0;0;0;0;0;0;0
FR;10;2021-02-11;0;0;0;0;0;0;0;0;0;0;0;0;0;0;0;0;0;0
FR;10;2021-02-12;0;0;0;0;0;0;0;0;0;0;0;0;0;0;0;0;0;0
FR;10;2021-02-13;0;0;0;0;0;0;0;0;0;0;0;0;0;0;0;0;0;0
FR;10;2021-02-14;0;0;0;0;0;0;0;0;0;0;0;0;0;0;0;0;0;0
FR;10;2021-02-15;0;0;0;0;0;0;0;0;0;0;0;0;0;0;0;0;0;0
FR;10;2021-02-16;0;0;0;0;0;0;0;0;0;0;0;0;0;0;0;0;0;0
FR;10;2021-02-17;0;0;0;0;0;0;0;0;0;0;0;0;0;0;0;0;0;0
FR;10;2021-02-18;0;0;0;0;0;0;0;0;0;0;0;0;0;0;0;0;0;0
FR;10;2021-02-19;0;0;0;0;0;0;0;0;0;0;0;0;0;0;0;0;0;0
FR;10;2021-02-20;0;0;0;0;0;0;0;0;0;0;0;0;0;0;0;0;0;0
FR;10;2021-02-21;0;0;0;0;0;0;0;0;0;0;0;0;0;0;0;0;0;0
FR;10;2021-02-22;0;0;0;0;0;0;0;0;0;0;0;0;0;0;0;0;0;0
FR;10;2021-02-23;0;0;0;0;0;0;0;0;0;0;0;0;0;0;0;0;0;0
FR;10;2021-02-24;0;0;0;0;0;0;0;0;0;0;0;0;0;0;0;0;0;0
FR;10;2021-02-25;0;0;0;0;0;0;0;0;0;0;0;0;0;0;0;0;0;0
FR;10;2021-02-26;0;0;0;0;0;0;0;0;0;0;0;0;0;0;0;0;0;0
FR;10;2021-02-27;0;0;0;0;0;0;0;0;0;0;0;0;0;0;0;0;0;0
FR;10;2021-02-28;0;0;0;0;0;0;0;0;0;0;0;0;0;0;0;0;0;0
FR;10;2021-03-01;0;0;0;0;0;0;0;0;0;0;0;0;0;0;0;0;0;0
FR;10;2021-03-02;0;0;0;0;0;0;0;0;0;0;0;0;0;0;0;0;0;0
FR;10;2021-03-03;0;0;0;0;0;0;0;0;0;0;0;0;0;0;0;0;0;0
FR;10;2021-03-04;0;0;0;0;0;0;0;0;0;0;0;0;0;0;0;0;0;0
FR;10;2021-03-05;0;0;0;0;0;0;0;0;0;0;0;0;0;0;0;0;0;0
FR;10;2021-03-06;0;0;0;0;0;0;0;0;0;0;0;0;0;0;0;0;0;0
FR;10;2021-03-07;0;0;0;0;0;0;0;0;0;0;0;0;0;0;0;0;0;0
FR;10;2021-03-08;0;0;0;0;0;0;0;0;0;0;0;0;0;0;0;0;0;0
FR;10;2021-03-09;0;0;0;0;0;0;0;0;0;0;0;0;0;0;0;0;0;0
FR;10;2021-03-10;0;0;0;0;0;0;0;0;0;0;0;0;0;0;0;0;0;0
FR;10;2021-03-11;0;0;0;0;0;0;0;0;0;0;0;0;0;0;0;0;0;0
FR;10;2021-03-12;0;0;0;0;0;0;0;0;0;0;0;0;0;0;0;0;0;0
FR;10;2021-03-13;0;0;0;0;0;0;0;0;0;0;0;0;0;0;0;0;0;0
FR;10;2021-03-14;0;0;0;0;0;0;0;0;0;0;0;0;0;0;0;0;0;0
FR;10;2021-03-15;0;0;0;0;0;0;0;0;0;0;0;0;0;0;0;0;0;0
FR;10;2021-03-16;0;0;0;0;0;0;0;0;0;0;0;0;0;0;0;0;0;0
FR;10;2021-03-17;0;0;0;0;0;0;0;0;0;0;0;0;0;0;0;0;0;0
FR;10;2021-03-18;0;0;0;0;0;0;0;0;0;0;0;0;0;0;0;0;0;0
FR;10;2021-03-19;0;0;0;0;0;0;0;0;0;0;0;0;0;0;0;0;0;0
FR;10;2021-03-20;0;0;0;0;0;0;0;0;0;0;0;0;0;0;0;0;0;0
FR;10;2021-03-21;0;0;0;0;0;0;0;0;0;0;0;0;0;0;0;0;0;0
FR;10;2021-03-22;0;0;0;0;0;0;0;0;0;0;0;0;0;0;0;0;0;0
FR;10;2021-03-23;0;0;0;0;0;0;0;0;0;0;0;0;0;0;0;0;0;0
FR;10;2021-03-24;0;0;0;0;0;0;0;0;0;0;0;0;0;0;0;0;0;0
FR;10;2021-03-25;0;0;0;0;0;0;0;0;0;0;0;0;0;0;0;0;0;0
FR;10;2021-03-26;0;0;0;0;0;0;0;0;0;0;0;0;0;0;0;0;0;0
FR;10;2021-03-27;0;0;0;0;0;0;0;0;0;0;0;0;0;0;0;0;0;0
FR;10;2021-03-28;0;0;0;0;0;0;0;0;0;0;0;0;0;0;0;0;0;0
FR;10;2021-03-29;0;0;0;0;0;0;0;0;0;0;0;0;0;0;0;0;0;0
FR;10;2021-03-30;0;0;0;0;0;0;0;0;0;0;0;0;0;0;0;0;0;0
FR;10;2021-03-31;0;0;0;0;0;0;0;0;0;0;0;0;0;0;0;0;0;0
FR;10;2021-04-01;0;0;0;0;0;0;0;0;0;0;0;0;0;0;0;0;0;0
FR;10;2021-04-02;0;0;0;0;0;0;0;0;0;0;0;0;0;0;0;0;0;0
FR;10;2021-04-03;0;0;0;0;0;0;0;0;0;0;0;0;0;0;0;0;0;0
FR;10;2021-04-04;0;0;0;0;0;0;0;0;0;0;0;0;0;0;0;0;0;0
FR;10;2021-04-05;0;0;0;0;0;0;0;0;0;0;0;0;0;0;0;0;0;0
FR;10;2021-04-06;0;0;0;0;0;0;0;0;0;0;0;0;0;0;0;0;0;0
FR;10;2021-04-07;0;0;0;0;0;0;0;0;0;0;0;0;0;0;0;0;0;0
FR;10;2021-04-08;0;0;0;0;0;0;0;0;0;0;0;0;0;0;0;0;0;0
FR;10;2021-04-09;0;0;0;0;0;0;0;0;0;0;0;0;0;0;0;0;0;0
FR;10;2021-04-10;0;0;0;0;0;0;0;0;0;0;0;0;0;0;0;0;0;0
FR;10;2021-04-11;0;0;0;0;0;0;0;0;0;0;0;0;0;0;0;0;0;0
FR;10;2021-04-12;0;0;0;0;0;0;0;0;0;0;0;0;0;0;0;0;0;0
FR;10;2021-04-13;0;0;0;0;0;0;0;0;0;0;0;0;0;0;0;0;0;0
FR;10;2021-04-14;0;0;0;0;0;0;0;0;0;0;0;0;0;0;0;0;0;0
FR;10;2021-04-15;0;0;0;0;0;0;0;0;0;0;0;0;0;0;0;0;0;0
FR;10;2021-04-16;0;0;0;0;0;0;0;0;0;0;0;0;0;0;0;0;0;0
FR;10;2021-04-17;0;0;0;0;0;0;0;0;0;0;0;0;0;0;0;0;0;0
FR;10;2021-04-18;0;0;0;0;0;0;0;0;0;0;0;0;0;0;0;0;0;0
FR;10;2021-04-19;0;0;0;0;0;0;0;0;0;0;0;0;0;0;0;0;0;0
FR;10;2021-04-20;0;0;0;0;0;0;0;0;0;0;0;0;0;0;0;0;0;0
FR;10;2021-04-21;0;0;0;0;0;0;0;0;0;0;0;0;0;0;0;0;0;0
FR;10;2021-04-22;0;0;0;0;0;0;0;0;0;0;0;0;0;0;0;0;0;0
FR;10;2021-04-23;0;0;0;0;0;0;0;0;0;0;0;0;0;0;0;0;0;0
FR;10;2021-04-24;0;0;0;0;0;0;0;0;0;0;0;0;0;0;0;0;0;0
FR;10;2021-04-25;0;0;0;0;0;0;0;0;0;0;0;0;0;0;0;0;0;0
FR;10;2021-04-26;0;0;0;0;0;0;0;0;0;0;0;0;0;0;0;0;0;0
FR;10;2021-04-27;0;0;0;0;0;0;0;0;0;0;0;0;0;0;0;0;0;0
FR;10;2021-04-28;0;0;0;0;0;0;0;0;0;0;0;0;0;0;0;0;0;0
FR;10;2021-04-29;0;0;0;0;0;0;0;0;0;0;0;0;0;0;0;0;0;0
FR;10;2021-04-30;0;0;0;0;0;0;0;0;0;0;0;0;0;0;0;0;0;0
FR;10;2021-05-01;0;0;0;0;0;0;0;0;0;0;0;0;0;0;0;0;0;0
FR;10;2021-05-02;0;0;0;0;0;0;0;0;0;0;0;0;0;0;0;0;0;0
FR;10;2021-05-03;0;0;0;0;0;0;0;0;0;0;0;0;0;0;0;0;0;0
FR;10;2021-05-04;0;0;0;0;0;0;0;0;0;0;0;0;0;0;0;0;0;0
FR;10;2021-05-05;0;0;0;0;0;0;0;0;0;0;0;0;0;0;0;0;0;0
FR;10;2021-05-06;0;0;0;0;0;0;0;0;0;0;0;0;0;0;0;0;0;0
FR;10;2021-05-07;0;0;0;0;0;0;0;0;0;0;0;0;0;0;0;0;0;0
FR;10;2021-05-08;0;0;0;0;0;0;0;0;0;0;0;0;0;0;0;0;0;0
FR;10;2021-05-09;0;0;0;0;0;0;0;0;0;0;0;0;0;0;0;0;0;0
FR;10;2021-05-10;0;0;0;0;0;0;0;0;0;0;0;0;0;0;0;0;0;0
FR;10;2021-05-11;0;0;0;0;0;0;0;0;0;0;0;0;0;0;0;0;0;0
FR;10;2021-05-12;0;0;0;0;0;0;0;0;0;0;0;0;0;0;0;0;0;0
FR;10;2021-05-13;0;0;0;0;0;0;0;0;0;0;0;0;0;0;0;0;0;0
FR;10;2021-05-14;0;0;0;0;0;0;0;0;0;0;0;0;0;0;0;0;0;0
FR;10;2021-05-15;0;0;0;0;0;0;0;0;0;0;0;0;0;0;0;0;0;0
FR;10;2021-05-16;0;0;0;0;0;0;0;0;0;0;0;0;0;0;0;0;0;0
FR;10;2021-05-17;0;0;0;0;0;0;0;0;0;0;0;0;0;0;0;0;0;0
FR;10;2021-05-18;0;0;0;0;0;0;0;0;0;0;0;0;0;0;0;0;0;0
FR;10;2021-05-19;0;0;0;0;0;0;0;0;0;0;0;0;0;0;0;0;0;0
FR;10;2021-05-20;0;0;0;0;0;0;0;0;0;0;0;0;0;0;0;0;0;0
FR;10;2021-05-21;0;0;0;0;0;0;0;0;0;0;0;0;0;0;0;0;0;0
FR;10;2021-05-22;0;0;0;0;0;0;0;0;0;0;0;0;0;0;0;0;0;0
FR;10;2021-05-23;0;0;0;0;0;0;0;0;0;0;0;0;0;0;0;0;0;0
FR;10;2021-05-24;0;0;0;0;0;0;0;0;0;0;0;0;0;0;0;0;0;0
FR;10;2021-05-25;0;0;0;0;0;0;0;0;0;0;0;0;0;0;0;0;0;0
FR;10;2021-05-26;0;0;0;0;0;0;0;0;0;0;0;0;0;0;0;0;0;0
FR;10;2021-05-27;0;0;0;0;0;0;0;0;0;0;0;0;0;0;0;0;0;0
FR;10;2021-05-28;0;0;0;0;0;0;0;0;0;0;0;0;0;0;0;0;0;0
FR;10;2021-05-29;0;0;0;0;0;0;0;0;0;0;0;0;0;0;0;0;0;0
FR;10;2021-05-30;0;0;0;0;0;0;0;0;0;0;0;0;0;0;0;0;0;0
FR;10;2021-05-31;0;0;0;0;0;0;0;0;0;0;0;0;0;0;0;0;0;0
FR;10;2021-06-01;0;0;0;0;0;0;0;0;0;0;0;0;0;0;0;0;0;0
FR;10;2021-06-02;0;0;0;0;0;0;0;0;0;0;0;0;0;0;0;0;0;0
FR;10;2021-06-03;0;0;0;0;0;0;0;0;0;0;0;0;0;0;0;0;0;0
FR;10;2021-06-04;0;0;0;0;0;0;0;0;0;0;0;0;0;0;0;0;0;0
FR;10;2021-06-05;0;0;0;0;0;0;0;0;0;0;0;0;0;0;0;0;0;0
FR;10;2021-06-06;0;0;0;0;0;0;0;0;0;0;0;0;0;0;0;0;0;0
FR;10;2021-06-07;0;0;0;0;0;0;0;0;0;0;0;0;0;0;0;0;0;0
FR;10;2021-06-08;0;0;0;0;0;0;0;0;0;0;0;0;0;0;0;0;0;0
FR;10;2021-06-09;0;0;0;0;0;0;0;0;0;0;0;0;0;0;0;0;0;0
FR;10;2021-06-10;0;0;0;0;0;0;0;0;0;0;0;0;0;0;0;0;0;0
FR;10;2021-06-11;0;0;0;0;0;0;0;0;0;0;0;0;0;0;0;0;0;0
FR;10;2021-06-12;0;0;0;0;0;0;0;0;0;0;0;0;0;0;0;0;0;0
FR;10;2021-06-13;0;0;0;0;0;0;0;0;0;0;0;0;0;0;0;0;0;0
FR;10;2021-06-14;0;0;0;0;0;0;0;0;0;0;0;0;0;0;0;0;0;0
FR;10;2021-06-15;0;0;0;0;0;0;0;0;0;0;0;0;0;0;0;0;0;0
FR;10;2021-06-16;0;0;0;0;0;0;0;0;0;0;0;0;0;0;0;0;0;0
FR;10;2021-06-17;0;0;0;0;0;0;0;0;0;0;0;0;0;0;0;0;0;0
FR;10;2021-06-18;0;0;0;0;0;0;0;0;0;0;0;0;0;0;0;0;0;0
FR;10;2021-06-19;0;0;0;0;0;0;0;0;0;0;0;0;0;0;0;0;0;0
FR;10;2021-06-20;0;0;0;0;0;0;0;0;0;0;0;0;0;0;0;0;0;0
FR;10;2021-06-21;0;0;0;0;0;0;0;0;0;0;0;0;0;0;0;0;0;0
FR;10;2021-06-22;0;0;0;0;0;0;0;0;0;0;0;0;0;0;0;0;0;0
FR;10;2021-06-23;0;0;0;0;0;0;0;0;0;0;0;0;0;0;0;0;0;0
FR;10;2021-06-24;0;0;0;0;0;0;0;0;0;0;0;0;0;0;0;0;0;0
FR;10;2021-06-25;0;0;0;0;0;0;0;0;0;0;0;0;0;0;0;0;0;0
FR;10;2021-06-26;0;0;0;0;0;0;0;0;0;0;0;0;0;0;0;0;0;0
FR;10;2021-06-27;0;0;0;0;0;0;0;0;0;0;0;0;0;0;0;0;0;0
FR;10;2021-06-28;0;0;0;0;0;0;0;0;0;0;0;0;0;0;0;0;0;0
FR;10;2021-06-29;0;0;0;0;0;0;0;0;0;0;0;0;0;0;0;0;0;0
FR;10;2021-06-30;0;0;0;0;0;0;0;0;0;0;0;0;0;0;0;0;0;0
FR;10;2021-07-01;0;0;0;0;0;0;0;0;0;0;0;0;0;0;0;0;0;0
FR;10;2021-07-02;0;0;0;0;0;0;0;0;0;0;0;0;0;0;0;0;0;0
FR;10;2021-07-03;0;0;0;0;0;0;0;0;0;0;0;0;0;0;0;0;0;0
FR;10;2021-07-04;0;0;0;0;0;0;0;0;0;0;0;0;0;0;0;0;0;0
FR;10;2021-07-05;0;0;0;0;0;0;0;0;0;0;0;0;0;0;0;0;0;0
FR;10;2021-07-06;0;0;0;0;0;0;0;0;0;0;0;0;0;0;0;0;0;0
FR;10;2021-07-07;0;0;0;0;0;0;0;0;0;0;0;0;0;0;0;0;0;0
FR;10;2021-07-08;0;0;0;0;0;0;0;0;0;0;0;0;0;0;0;0;0;0
FR;10;2021-07-09;0;0;0;0;0;0;0;0;0;0;0;0;0;0;0;0;0;0
FR;10;2021-07-10;0;0;0;0;0;0;0;0;0;0;0;0;0;0;0;0;0;0
FR;10;2021-07-11;0;0;0;0;0;0;0;0;0;0;0;0;0;0;0;0;0;0
FR;10;2021-07-12;0;0;0;0;0;0;0;0;0;0;0;0;0;0;0;0;0;0
FR;10;2021-07-13;0;0;0;0;0;0;0;0;0;0;0;0;0;0;0;0;0;0
FR;10;2021-07-14;0;0;0;0;0;0;0;0;0;0;0;0;0;0;0;0;0;0
FR;10;2021-07-15;0;0;0;0;0;0;0;0;0;0;0;0;0;0;0;0;0;0
FR;10;2021-07-16;0;0;0;0;0;0;0;0;0;0;0;0;0;0;0;0;0;0
FR;10;2021-07-17;0;0;0;0;0;0;0;0;0;0;0;0;0;0;0;0;0;0
FR;10;2021-07-18;0;0;0;0;0;0;0;0;0;0;0;0;0;0;0;0;0;0
FR;10;2021-07-19;0;0;0;0;0;0;0;0;0;0;0;0;0;0;0;0;0;0
FR;10;2021-07-20;0;0;0;0;0;0;0;0;0;0;0;0;0;0;0;0;0;0
FR;10;2021-07-21;0;0;0;0;0;0;0;0;0;0;0;0;0;0;0;0;0;0
FR;10;2021-07-22;0;0;0;0;0;0;0;0;0;0;0;0;0;0;0;0;0;0
FR;10;2021-07-23;0;0;0;0;0;0;0;0;0;0;0;0;0;0;0;0;0;0
FR;10;2021-07-24;0;0;0;0;0;0;0;0;0;0;0;0;0;0;0;0;0;0
FR;10;2021-07-25;0;0;0;0;0;0;0;0;0;0;0;0;0;0;0;0;0;0
FR;10;2021-07-26;0;0;0;0;0;0;0;0;0;0;0;0;0;0;0;0;0;0
FR;10;2021-07-27;0;0;0;0;0;0;0;0;0;0;0;0;0;0;0;0;0;0
FR;10;2021-07-28;0;0;0;0;0;0;0;0;0;0;0;0;0;0;0;0;0;0
FR;10;2021-07-29;0;0;0;0;0;0;0;0;0;0;0;0;0;0;0;0;0;0
FR;10;2021-07-30;0;0;0;0;0;0;0;0;0;0;0;0;0;0;0;0;0;0
FR;10;2021-07-31;0;0;0;0;0;0;0;0;0;0;0;0;0;0;0;0;0;0
FR;10;2021-08-01;0;0;0;0;0;0;0;0;0;0;0;0;0;0;0;0;0;0
FR;10;2021-08-02;0;0;0;0;0;0;0;0;0;0;0;0;0;0;0;0;0;0
FR;10;2021-08-03;0;0;0;0;0;0;0;0;0;0;0;0;0;0;0;0;0;0
FR;10;2021-08-04;0;0;0;0;0;0;0;0;0;0;0;0;0;0;0;0;0;0
FR;10;2021-08-05;0;0;0;0;0;0;0;0;0;0;0;0;0;0;0;0;0;0
FR;10;2021-08-06;0;0;0;0;0;0;0;0;0;0;0;0;0;0;0;0;0;0
FR;10;2021-08-07;0;0;0;0;0;0;0;0;0;0;0;0;0;0;0;0;0;0
FR;10;2021-08-08;0;0;0;0;0;0;0;0;0;0;0;0;0;0;0;0;0;0
FR;10;2021-08-09;0;0;0;0;0;0;0;0;0;0;0;0;0;0;0;0;0;0
FR;10;2021-08-10;0;0;0;0;0;0;0;0;0;0;0;0;0;0;0;0;0;0
FR;10;2021-08-11;0;0;0;0;0;0;0;0;0;0;0;0;0;0;0;0;0;0
FR;10;2021-08-12;0;0;0;0;0;0;0;0;0;0;0;0;0;0;0;0;0;0
FR;10;2021-08-13;0;0;0;0;0;0;0;0;0;0;0;0;0;0;0;0;0;0
FR;10;2021-08-14;0;0;0;0;0;0;0;0;0;0;0;0;0;0;0;0;0;0
FR;10;2021-08-15;0;0;0;0;0;0;0;0;0;0;0;0;0;0;0;0;0;0
FR;10;2021-08-16;0;0;0;0;0;0;0;0;0;0;0;0;0;0;0;0;0;0
FR;10;2021-08-17;0;0;0;0;0;0;0;0;0;0;0;0;0;0;0;0;0;0
FR;10;2021-08-18;0;0;0;0;0;0;0;0;0;0;0;0;0;0;0;0;0;0
FR;10;2021-08-19;0;0;0;0;0;0;0;0;0;0;0;0;0;0;0;0;0;0
FR;10;2021-08-20;0;0;0;0;0;0;0;0;0;0;0;0;0;0;0;0;0;0
FR;10;2021-08-21;0;0;0;0;0;0;0;0;0;0;0;0;0;0;0;0;0;0
FR;10;2021-08-22;0;0;0;0;0;0;0;0;0;0;0;0;0;0;0;0;0;0
FR;10;2021-08-23;0;0;0;0;0;0;0;0;0;0;0;0;0;0;0;0;0;0
FR;10;2021-08-24;0;0;0;0;0;0;0;0;0;0;0;0;0;0;0;0;0;0
FR;10;2021-08-25;0;0;0;0;0;0;0;0;0;0;0;0;0;0;0;0;0;0
FR;10;2021-08-26;0;0;0;0;0;0;0;0;0;0;0;0;0;0;0;0;0;0
FR;10;2021-08-27;0;0;0;0;0;0;0;0;0;0;0;0;0;0;0;0;0;0
FR;10;2021-08-28;0;0;0;0;0;0;0;0;0;0;0;0;0;0;0;0;0;0
FR;10;2021-08-29;0;0;0;0;0;0;0;0;0;0;0;0;0;0;0;0;0;0
FR;10;2021-08-30;0;0;0;0;0;0;0;0;0;0;0;0;0;0;0;0;0;0
FR;10;2021-08-31;0;0;0;0;0;0;0;0;0;0;0;0;0;0;0;0;0;0
FR;10;2021-09-01;0;0;0;0;0;0;0;0;0;0;0;0;0;0;0;0;0;0
FR;10;2021-09-02;0;0;0;0;0;0;0;0;0;0;0;0;0;0;0;0;0;0
FR;10;2021-09-03;0;0;0;0;0;0;0;0;0;0;0;0;0;0;0;0;0;0
FR;10;2021-09-04;0;0;0;0;0;0;0;0;0;0;0;0;0;0;0;0;0;0
FR;10;2021-09-05;0;0;0;0;0;0;0;0;0;0;0;0;0;0;0;0;0;0
FR;10;2021-09-06;0;0;0;0;0;0;0;0;0;0;0;0;0;0;0;0;0;0
FR;10;2021-09-07;0;0;0;0;0;0;0;0;0;0;0;0;0;0;0;0;0;0
FR;10;2021-09-08;0;0;0;0;0;0;0;0;0;0;0;0;0;0;0;0;0;0
FR;10;2021-09-09;0;0;0;0;0;0;0;0;0;0;0;0;0;0;0;0;0;0
FR;10;2021-09-10;0;0;0;0;0;0;0;0;0;0;0;0;0;0;0;0;0;0
FR;10;2021-09-11;0;0;0;0;0;0;0;0;0;0;0;0;0;0;0;0;0;0
FR;10;2021-09-12;0;0;0;0;0;0;0;0;0;0;0;0;0;0;0;0;0;0
FR;10;2021-09-13;0;0;0;0;0;0;0;0;0;0;0;0;0;0;0;0;0;0
FR;10;2021-09-14;0;0;0;0;0;0;0;0;0;0;0;0;0;0;0;0;0;0
FR;10;2021-09-15;0;0;0;0;0;0;0;0;0;0;0;0;0;0;0;0;0;0
FR;10;2021-09-16;0;0;0;0;0;0;0;0;0;0;0;0;0;0;0;0;0;0
FR;10;2021-09-17;0;0;0;0;0;0;0;0;0;0;0;0;0;0;0;0;0;0
FR;10;2021-09-18;0;0;0;0;0;0;0;0;0;0;0;0;0;0;0;0;0;0
FR;10;2021-09-19;0;0;0;0;0;0;0;0;0;0;0;0;0;0;0;0;0;0
FR;10;2021-09-20;0;0;0;0;0;0;0;0;0;0;0;0;0;0;0;0;0;0
FR;10;2021-09-21;0;0;0;0;0;0;0;0;0;0;0;0;0;0;0;0;0;0
FR;10;2021-09-22;0;0;0;0;0;0;0;0;0;0;0;0;0;0;0;0;0;0
FR;10;2021-09-23;0;0;0;0;0;0;0;0;0;0;0;0;0;0;0;0;0;0
FR;10;2021-09-24;0;0;0;0;0;0;0;0;0;0;0;0;0;0;0;0;0;0
FR;10;2021-09-25;0;0;0;0;0;0;0;0;0;0;0;0;0;0;0;0;0;0
FR;10;2021-09-26;0;0;0;0;0;0;0;0;0;0;0;0;0;0;0;0;0;0
FR;10;2021-09-27;0;0;0;0;0;0;0;0;0;0;0;0;0;0;0;0;0;0
FR;10;2021-09-28;0;0;0;0;0;0;0;0;0;0;0;0;0;0;0;0;0;0
FR;10;2021-09-29;0;0;0;0;0;0;0;0;0;0;0;0;0;0;0;0;0;0
FR;10;2021-09-30;0;0;0;0;0;0;0;0;0;0;0;0;0;0;0;0;0;0
FR;10;2021-10-01;0;0;0;0;0;0;0;0;0;0;0;0;0;0;0;0;0;0
FR;10;2021-10-02;0;0;0;0;0;0;0;0;0;0;0;0;0;0;0;0;0;0
FR;10;2021-10-03;0;0;0;0;0;0;0;0;0;0;0;0;0;0;0;0;0;0
FR;10;2021-10-04;0;0;0;0;0;0;0;0;0;0;0;0;0;0;0;0;0;0
FR;10;2021-10-05;0;0;0;0;0;0;0;0;0;0;0;0;0;0;0;0;0;0
FR;10;2021-10-06;0;0;0;0;0;0;0;0;0;0;0;0;0;0;0;0;0;0
FR;10;2021-10-07;0;0;0;0;0;0;0;0;0;0;0;0;0;0;0;0;0;0
FR;10;2021-10-08;0;0;0;0;0;0;0;0;0;0;0;0;0;0;0;0;0;0
FR;10;2021-10-09;0;0;0;0;0;0;0;0;0;0;0;0;0;0;0;0;0;0
FR;10;2021-10-10;0;0;0;0;0;0;0;0;0;0;0;0;0;0;0;0;0;0
FR;10;2021-10-11;0;0;0;0;0;0;0;0;0;0;0;0;0;0;0;0;0;0
FR;10;2021-10-12;0;0;0;0;0;0;0;0;0;0;0;0;0;0;0;0;0;0
FR;10;2021-10-13;0;0;0;0;0;0;0;0;0;0;0;0;0;0;0;0;0;0
FR;10;2021-10-14;0;0;0;0;0;0;0;0;0;0;0;0;0;0;0;0;0;0
FR;10;2021-10-15;0;0;0;0;0;0;0;0;0;0;0;0;0;0;0;0;0;0
FR;10;2021-10-16;0;0;0;0;0;0;0;0;0;0;0;0;0;0;0;0;0;0
FR;10;2021-10-17;0;0;0;0;0;0;0;0;0;0;0;0;0;0;0;0;0;0
FR;10;2021-10-18;0;0;0;0;0;0;0;0;0;0;0;0;0;0;0;0;0;0
FR;10;2021-10-19;0;0;0;0;0;0;0;0;0;0;0;0;0;0;0;0;0;0
FR;10;2021-10-20;0;0;0;0;0;0;0;0;0;0;0;0;0;0;0;0;0;0
FR;10;2021-10-21;0;0;0;0;0;0;0;0;0;0;0;0;0;0;0;0;0;0
FR;10;2021-10-22;0;0;0;0;0;0;0;0;0;0;0;0;0;0;0;0;0;0
FR;10;2021-10-23;0;0;0;0;0;0;0;0;0;0;0;0;0;0;0;0;0;0
FR;10;2021-10-24;0;0;0;0;0;0;0;0;0;0;0;0;0;0;0;0;0;0
FR;10;2021-10-25;0;0;0;0;0;0;0;0;0;0;0;0;0;0;0;0;0;0
FR;10;2021-10-26;0;0;0;0;0;0;0;0;0;0;0;0;0;0;0;0;0;0
FR;10;2021-10-27;0;0;0;0;0;0;0;0;0;0;0;0;0;0;0;0;0;0
FR;10;2021-10-28;0;0;0;0;0;0;0;0;0;0;0;0;0;0;0;0;0;0
FR;10;2021-10-29;0;0;0;0;0;0;0;0;0;0;0;0;0;0;0;0;0;0
FR;10;2021-10-30;0;0;0;0;0;0;0;0;0;0;0;0;0;0;0;0;0;0
FR;10;2021-10-31;0;0;0;0;0;0;0;0;0;0;0;0;0;0;0;0;0;0
FR;10;2021-11-01;0;0;0;0;0;0;0;0;0;0;0;0;0;0;0;0;0;0
FR;10;2021-11-02;0;0;0;0;0;0;0;0;0;0;0;0;0;0;0;0;0;0
FR;10;2021-11-03;0;0;0;0;0;0;0;0;0;0;0;0;0;0;0;0;0;0
FR;10;2021-11-04;0;0;0;0;0;0;0;0;0;0;0;0;0;0;0;0;0;0
FR;10;2021-11-05;0;0;0;0;0;0;0;0;0;0;0;0;0;0;0;0;0;0
FR;10;2021-11-06;0;0;0;0;0;0;0;0;0;0;0;0;0;0;0;0;0;0
FR;10;2021-11-07;0;0;0;0;0;0;0;0;0;0;0;0;0;0;0;0;0;0
FR;10;2021-11-08;0;0;0;0;0;0;0;0;0;0;0;0;0;0;0;0;0;0
FR;10;2021-11-09;0;0;0;0;0;0;0;0;0;0;0;0;0;0;0;0;0;0
FR;10;2021-11-10;0;0;0;0;0;0;0;0;0;0;0;0;0;0;0;0;0;0
FR;10;2021-11-11;0;0;0;0;0;0;0;0;0;0;0;0;0;0;0;0;0;0
FR;10;2021-11-12;0;0;0;0;0;0;0;0;0;0;0;0;0;0;0;0;0;0
FR;10;2021-11-13;0;0;0;0;0;0;0;0;0;0;0;0;0;0;0;0;0;0
FR;10;2021-11-14;0;0;0;0;0;0;0;0;0;0;0;0;0;0;0;0;0;0
FR;10;2021-11-15;0;0;0;0;0;0;0;0;0;0;0;0;0;0;0;0;0;0
FR;10;2021-11-16;0;0;0;0;0;0;0;0;0;0;0;0;0;0;0;0;0;0
FR;10;2021-11-17;0;0;0;0;0;0;0;0;0;0;0;0;0;0;0;0;0;0
FR;10;2021-11-18;0;0;0;0;0;0;0;0;0;0;0;0;0;0;0;0;0;0
FR;10;2021-11-19;0;0;0;0;0;0;0;0;0;0;0;0;0;0;0;0;0;0
FR;10;2021-11-20;0;0;0;0;0;0;0;0;0;0;0;0;0;0;0;0;0;0
FR;10;2021-11-21;0;0;0;0;0;0;0;0;0;0;0;0;0;0;0;0;0;0
FR;10;2021-11-22;0;0;0;0;0;0;0;0;0;0;0;0;0;0;0;0;0;0
FR;10;2021-11-23;0;0;0;0;0;0;0;0;0;0;0;0;0;0;0;0;0;0
FR;10;2021-11-24;0;0;0;0;0;0;0;0;0;0;0;0;0;0;0;0;0;0
FR;10;2021-11-25;0;0;0;0;0;0;0;0;0;0;0;0;0;0;0;0;0;0
FR;10;2021-11-26;0;0;0;0;0;0;0;0;0;0;0;0;0;0;0;0;0;0
FR;10;2021-11-27;0;0;0;0;0;0;0;0;0;0;0;0;0;0;0;0;0;0
FR;10;2021-11-28;0;0;0;0;0;0;0;0;0;0;0;0;0;0;0;0;0;0
FR;10;2021-11-29;0;0;0;0;0;0;0;0;0;0;0;0;0;0;0;0;0;0
FR;10;2021-11-30;0;0;0;0;0;0;0;0;0;0;0;0;0;0;0;0;0;0
FR;10;2021-12-01;0;0;0;0;0;0;0;0;0;0;0;0;0;0;0;0;0;0
FR;10;2021-12-02;0;0;0;0;0;0;0;0;0;0;0;0;0;0;0;0;0;0
FR;10;2021-12-03;0;0;0;0;0;0;0;0;0;0;0;0;0;0;0;0;0;0
FR;10;2021-12-04;0;0;0;0;0;0;0;0;0;0;0;0;0;0;0;0;0;0
FR;10;2021-12-05;0;0;0;0;0;0;0;0;0;0;0;0;0;0;0;0;0;0
FR;10;2021-12-06;0;0;0;0;0;0;0;0;0;0;0;0;0;0;0;0;0;0
FR;10;2021-12-07;0;0;0;0;0;0;0;0;0;0;0;0;0;0;0;0;0;0
FR;10;2021-12-08;0;0;0;0;0;0;0;0;0;0;0;0;0;0;0;0;0;0
FR;10;2021-12-09;0;0;0;0;0;0;0;0;0;0;0;0;0;0;0;0;0;0
FR;10;2021-12-10;0;0;0;0;0;0;0;0;0;0;0;0;0;0;0;0;0;0
FR;10;2021-12-11;0;0;0;0;0;0;0;0;0;0;0;0;0;0;0;0;0;0
FR;10;2021-12-12;0;0;0;0;0;0;0;0;0;0;0;0;0;0;0;0;0;0
FR;10;2021-12-13;0;0;0;0;0;0;0;0;0;0;0;0;0;0;0;0;0;0
FR;10;2021-12-14;0;0;0;0;0;0;0;0;0;0;0;0;0;0;0;0;0;0
FR;10;2021-12-15;0;0;0;0;0;0;0;0;0;0;0;0;0;0;0;0;0;0
FR;10;2021-12-16;0;0;0;0;0;0;0;0;0;0;0;0;0;0;0;0;0;0
FR;10;2021-12-17;0;0;0;0;0;0;0;0;0;0;0;0;0;0;0;0;0;0
FR;10;2021-12-18;0;0;0;0;0;0;0;0;0;0;0;0;0;0;0;0;0;0
FR;10;2021-12-19;0;0;0;0;0;0;0;0;0;0;0;0;0;0;0;0;0;0
FR;10;2021-12-20;0;0;0;0;0;0;0;0;0;0;0;0;0;0;0;0;0;0
FR;10;2021-12-21;0;0;0;0;0;0;0;0;0;0;0;0;0;0;0;0;0;0
FR;10;2021-12-22;0;0;0;0;0;0;0;0;0;0;0;0;0;0;0;0;0;0
FR;10;2021-12-23;0;0;0;0;0;0;0;0;0;0;0;0;0;0;0;0;0;0
FR;10;2021-12-24;0;0;0;0;0;0;0;0;0;0;0;0;0;0;0;0;0;0
FR;10;2021-12-25;0;0;0;0;0;0;0;0;0;0;0;0;0;0;0;0;0;0
FR;10;2021-12-26;0;0;0;0;0;0;0;0;0;0;0;0;0;0;0;0;0;0
FR;10;2021-12-27;0;0;0;0;0;0;0;0;0;0;0;0;0;0;0;0;0;0
FR;10;2021-12-28;0;0;0;0;0;0;0;0;0;0;0;0;0;0;0;0;0;0
FR;10;2021-12-29;0;0;0;0;0;0;0;0;0;0;0;0;0;0;0;0;0;0
FR;10;2021-12-30;0;0;0;0;0;0;0;0;0;0;0;0;0;0;0;0;0;0
FR;10;2021-12-31;0;0;0;0;0;0;0;0;0;0;0;0;0;0;0;0;0;0
FR;10;2022-01-01;0;0;0;0;0;0;0;0;0;0;0;0;0;0;0;0;0;0
FR;10;2022-01-02;0;0;0;0;0;0;0;0;0;0;0;0;0;0;0;0;0;0
FR;10;2022-01-03;0;0;0;0;0;0;0;0;0;0;0;0;0;0;0;0;0;0
FR;10;2022-01-04;0;0;0;0;0;0;0;0;0;0;0;0;0;0;0;0;0;0
FR;10;2022-01-05;0;0;0;0;0;0;0;0;0;0;0;0;0;0;0;0;0;0
FR;10;2022-01-06;0;0;0;0;0;0;0;0;0;0;0;0;0;0;0;0;0;0
FR;10;2022-01-07;0;0;0;0;0;0;0;0;0;0;0;0;0;0;0;0;0;0
FR;10;2022-01-08;0;0;0;0;0;0;0;0;0;0;0;0;0;0;0;0;0;0
FR;10;2022-01-09;0;0;0;0;0;0;0;0;0;0;0;0;0;0;0;0;0;0
FR;10;2022-01-10;0;0;0;0;0;0;0;0;0;0;0;0;0;0;0;0;0;0
FR;10;2022-01-11;0;0;0;0;0;0;0;0;0;0;0;0;0;0;0;0;0;0
FR;10;2022-01-12;0;0;0;0;0;0;0;0;0;0;0;0;0;0;0;0;0;0
FR;10;2022-01-13;0;0;0;0;0;0;0;0;0;0;0;0;0;0;0;0;0;0
FR;10;2022-01-14;0;0;0;0;0;0;0;0;0;0;0;0;0;0;0;0;0;0
FR;10;2022-01-15;0;0;0;0;0;0;0;0;0;0;0;0;0;0;0;0;0;0
FR;10;2022-01-16;0;0;0;0;0;0;0;0;0;0;0;0;0;0;0;0;0;0
FR;10;2022-01-17;0;0;0;0;0;0;0;0;0;0;0;0;0;0;0;0;0;0
FR;10;2022-01-18;0;0;0;0;0;0;0;0;0;0;0;0;0;0;0;0;0;0
FR;10;2022-01-19;0;0;0;0;0;0;0;0;0;0;0;0;0;0;0;0;0;0
FR;10;2022-01-20;0;0;0;0;0;0;0;0;0;0;0;0;0;0;0;0;0;0
FR;10;2022-01-21;0;0;0;0;0;0;0;0;0;0;0;0;0;0;0;0;0;0
FR;10;2022-01-22;0;0;0;0;0;0;0;0;0;0;0;0;0;0;0;0;0;0
FR;10;2022-01-23;0;0;0;0;0;0;0;0;0;0;0;0;0;0;0;0;0;0
FR;10;2022-01-24;0;0;0;0;0;0;0;0;0;0;0;0;0;0;0;0;0;0
FR;10;2022-01-25;0;0;0;0;0;0;0;0;0;0;0;0;0;0;0;0;0;0
FR;10;2022-01-26;0;0;0;0;0;0;0;0;0;0;0;0;0;0;0;0;0;0
FR;10;2022-01-27;0;0;0;0;0;0;0;0;0;0;0;0;0;0;0;0;0;0
FR;10;2022-01-28;0;0;0;0;0;0;0;0;0;0;0;0;0;0;0;0;0;0
FR;10;2022-01-29;0;0;0;0;0;0;0;0;0;0;0;0;0;0;0;0;0;0
FR;10;2022-01-30;0;0;0;0;0;0;0;0;0;0;0;0;0;0;0;0;0;0
FR;10;2022-01-31;0;0;0;0;0;0;0;0;0;0;0;0;0;0;0;0;0;0
FR;10;2022-02-01;0;0;0;0;0;0;0;0;0;0;0;0;0;0;0;0;0;0
FR;10;2022-02-02;0;0;0;0;0;0;0;0;0;0;0;0;0;0;0;0;0;0
FR;10;2022-02-03;0;0;0;0;0;0;0;0;0;0;0;0;0;0;0;0;0;0
FR;10;2022-02-04;0;0;0;0;0;0;0;0;0;0;0;0;0;0;0;0;0;0
FR;10;2022-02-05;0;0;0;0;0;0;0;0;0;0;0;0;0;0;0;0;0;0
FR;10;2022-02-06;0;0;0;0;0;0;0;0;0;0;0;0;0;0;0;0;0;0
FR;10;2022-02-07;0;0;0;0;0;0;0;0;0;0;0;0;0;0;0;0;0;0
FR;10;2022-02-08;0;0;0;0;0;0;0;0;0;0;0;0;0;0;0;0;0;0
FR;10;2022-02-09;0;0;0;0;0;0;0;0;0;0;0;0;0;0;0;0;0;0
FR;10;2022-02-10;0;0;0;0;0;0;0;0;0;0;0;0;0;0;0;0;0;0
FR;10;2022-02-11;0;0;0;0;0;0;0;0;0;0;0;0;0;0;0;0;0;0
FR;10;2022-02-12;0;0;0;0;0;0;0;0;0;0;0;0;0;0;0;0;0;0
FR;10;2022-02-13;0;0;0;0;0;0;0;0;0;0;0;0;0;0;0;0;0;0
FR;10;2022-02-14;0;0;0;0;0;0;0;0;0;0;0;0;0;0;0;0;0;0
FR;10;2022-02-15;0;0;0;0;0;0;0;0;0;0;0;0;0;0;0;0;0;0
FR;10;2022-02-16;0;0;0;0;0;0;0;0;0;0;0;0;0;0;0;0;0;0
FR;10;2022-02-17;0;0;0;0;0;0;0;0;0;0;0;0;0;0;0;0;0;0
FR;10;2022-02-18;0;0;0;0;0;0;0;0;0;0;0;0;0;0;0;0;0;0
FR;10;2022-02-19;0;0;0;0;0;0;0;0;0;0;0;0;0;0;0;0;0;0
FR;10;2022-02-20;0;0;0;0;0;0;0;0;0;0;0;0;0;0;0;0;0;0
FR;10;2022-02-21;0;0;0;0;0;0;0;0;0;0;0;0;0;0;0;0;0;0
FR;10;2022-02-22;0;0;0;0;0;0;0;0;0;0;0;0;0;0;0;0;0;0
FR;10;2022-02-23;0;0;0;0;0;0;0;0;0;0;0;0;0;0;0;0;0;0
FR;10;2022-02-24;0;0;0;0;0;0;0;0;0;0;0;0;0;0;0;0;0;0
FR;10;2022-02-25;0;0;0;0;0;0;0;0;0;0;0;0;0;0;0;0;0;0
FR;10;2022-02-26;0;0;0;0;0;0;0;0;0;0;0;0;0;0;0;0;0;0
FR;10;2022-02-27;0;0;0;0;0;0;0;0;0;0;0;0;0;0;0;0;0;0
FR;10;2022-02-28;0;0;0;0;0;0;0;0;0;0;0;0;0;0;0;0;0;0
FR;10;2022-03-01;0;0;0;0;0;0;0;0;0;0;0;0;0;0;0;0;0;0
FR;10;2022-03-02;0;0;0;0;0;0;0;0;0;0;0;0;0;0;0;0;0;0
FR;10;2022-03-03;0;0;0;0;0;0;0;0;0;0;0;0;0;0;0;0;0;0
FR;10;2022-03-04;0;0;0;0;0;0;0;0;0;0;0;0;0;0;0;0;0;0
FR;10;2022-03-05;0;0;0;0;0;0;0;0;0;0;0;0;0;0;0;0;0;0
FR;10;2022-03-06;0;0;0;0;0;0;0;0;0;0;0;0;0;0;0;0;0;0
FR;10;2022-03-07;0;0;0;0;0;0;0;0;0;0;0;0;0;0;0;0;0;0
FR;10;2022-03-08;0;0;0;0;0;0;0;0;0;0;0;0;0;0;0;0;0;0
FR;10;2022-03-09;0;0;0;0;0;0;0;0;0;0;0;0;0;0;0;0;0;0
FR;10;2022-03-10;0;0;0;0;0;0;0;0;0;0;0;0;0;0;0;0;0;0
FR;10;2022-03-11;0;0;0;0;0;0;0;0;0;0;0;0;0;0;0;0;0;0
FR;10;2022-03-12;0;0;0;0;0;0;0;0;0;0;0;0;0;0;0;0;0;0
FR;10;2022-03-13;0;0;0;0;0;0;0;0;0;0;0;0;0;0;0;0;0;0
FR;10;2022-03-14;0;0;0;0;0;0;0;0;0;0;0;0;0;0;0;0;0;0
FR;10;2022-03-15;0;0;0;0;0;0;0;0;0;0;0;0;0;0;0;0;0;0
FR;10;2022-03-16;0;0;0;0;0;0;0;0;0;0;0;0;0;0;0;0;0;0
FR;10;2022-03-17;0;0;0;0;0;0;0;0;0;0;0;0;0;0;0;0;0;0
FR;10;2022-03-18;0;0;0;0;0;0;0;0;0;0;0;0;0;0;0;0;0;0
FR;10;2022-03-19;0;0;0;0;0;0;0;0;0;0;0;0;0;0;0;0;0;0
FR;10;2022-03-20;0;0;0;0;0;0;0;0;0;0;0;0;0;0;0;0;0;0
FR;10;2022-03-21;0;0;0;0;0;0;0;0;0;0;0;0;0;0;0;0;0;0
FR;10;2022-03-22;0;0;0;0;0;0;0;0;0;0;0;0;0;0;0;0;0;0
FR;10;2022-03-23;0;0;0;0;0;0;0;0;0;0;0;0;0;0;0;0;0;0
FR;10;2022-03-24;0;0;0;0;0;0;0;0;0;0;0;0;0;0;0;0;0;0
FR;10;2022-03-25;0;0;0;0;0;0;0;0;0;0;0;0;0;0;0;0;0;0
FR;10;2022-03-26;0;0;0;0;0;0;0;0;0;0;0;0;0;0;0;0;0;0
FR;10;2022-03-27;0;0;0;0;0;0;0;0;0;0;0;0;0;0;0;0;0;0
FR;10;2022-03-28;0;0;0;0;0;0;0;0;0;0;0;0;0;0;0;0;0;0
FR;10;2022-03-29;0;0;0;0;0;0;0;0;0;0;0;0;0;0;0;0;0;0
FR;10;2022-03-30;0;0;0;0;0;0;0;0;0;0;0;0;0;0;0;0;0;0
FR;10;2022-03-31;0;0;0;0;0;0;0;0;0;0;0;0;0;0;0;0;0;0
FR;10;2022-04-01;0;0;0;0;0;0;0;0;0;0;0;0;0;0;0;0;0;0
FR;10;2022-04-02;0;0;0;0;0;0;0;0;0;0;0;0;0;0;0;0;0;0
FR;10;2022-04-03;0;0;0;0;0;0;0;0;0;0;0;0;0;0;0;0;0;0
FR;10;2022-04-04;0;0;0;0;0;0;0;0;0;0;0;0;0;0;0;0;0;0
FR;10;2022-04-05;0;0;0;0;0;0;0;0;0;0;0;0;0;0;0;0;0;0
FR;10;2022-04-06;0;0;0;0;0;0;0;0;0;0;0;0;0;0;0;0;0;0
FR;10;2022-04-07;0;0;0;0;0;0;0;0;0;0;0;0;0;0;0;0;0;0
FR;10;2022-04-08;0;0;0;0;0;0;0;0;0;0;0;0;0;0;0;0;0;0
FR;10;2022-04-09;0;0;0;0;0;0;0;0;0;0;0;0;0;0;0;0;0;0
FR;10;2022-04-10;0;0;0;0;0;0;0;0;0;0;0;0;0;0;0;0;0;0
FR;10;2022-04-11;0;0;0;0;0;0;0;0;0;0;0;0;0;0;0;0;0;0
FR;10;2022-04-12;0;0;0;0;0;0;0;0;0;0;0;0;0;0;0;0;0;0
FR;10;2022-04-13;0;0;0;0;0;0;0;0;0;0;0;0;0;0;0;0;0;0
FR;10;2022-04-14;0;0;0;0;0;0;0;0;0;0;0;0;0;0;0;0;0;0
FR;10;2022-04-15;0;0;0;0;0;0;0;0;0;0;0;0;0;0;0;0;0;0
FR;10;2022-04-16;0;0;0;0;0;0;0;0;0;0;0;0;0;0;0;0;0;0
FR;10;2022-04-17;0;0;0;0;0;0;0;0;0;0;0;0;0;0;0;0;0;0
FR;10;2022-04-18;0;0;0;0;0;0;0;0;0;0;0;0;0;0;0;0;0;0
FR;10;2022-04-19;0;0;0;0;0;0;0;0;0;0;0;0;0;0;0;0;0;0
FR;10;2022-04-20;0;0;0;0;0;0;0;0;0;0;0;0;0;0;0;0;0;0
FR;10;2022-04-21;0;0;0;0;0;0;0;0;0;0;0;0;0;0;0;0;0;0
FR;10;2022-04-22;0;0;0;0;0;0;0;0;0;0;0;0;0;0;0;0;0;0
FR;10;2022-04-23;0;0;0;0;0;0;0;0;0;0;0;0;0;0;0;0;0;0
FR;10;2022-04-24;0;0;0;0;0;0;0;0;0;0;0;0;0;0;0;0;0;0
FR;10;2022-04-25;0;0;0;0;0;0;0;0;0;0;0;0;0;0;0;0;0;0
FR;10;2022-04-26;0;0;0;0;0;0;0;0;0;0;0;0;0;0;0;0;0;0
FR;10;2022-04-27;0;0;0;0;0;0;0;0;0;0;0;0;0;0;0;0;0;0
FR;10;2022-04-28;0;0;0;0;0;0;0;0;0;0;0;0;0;0;0;0;0;0
FR;10;2022-04-29;0;0;0;0;0;0;0;0;0;0;0;0;0;0;0;0;0;0
FR;10;2022-04-30;0;0;0;0;0;0;0;0;0;0;0;0;0;0;0;0;0;0
FR;10;2022-05-01;0;0;0;0;0;0;0;0;0;0;0;0;0;0;0;0;0;0
FR;10;2022-05-02;0;0;0;0;0;0;0;0;0;0;0;0;0;0;0;0;0;0
FR;10;2022-05-03;0;0;0;0;0;0;0;0;0;0;0;0;0;0;0;0;0;0
FR;10;2022-05-04;0;0;0;0;0;0;0;0;0;0;0;0;0;0;0;0;0;0
FR;10;2022-05-05;0;0;0;0;0;0;0;0;0;0;0;0;0;0;0;0;0;0
FR;10;2022-05-06;0;0;0;0;0;0;0;0;0;0;0;0;0;0;0;0;0;0
FR;10;2022-05-07;0;0;0;0;0;0;0;0;0;0;0;0;0;0;0;0;0;0
FR;10;2022-05-08;0;0;0;0;0;0;0;0;0;0;0;0;0;0;0;0;0;0
FR;10;2022-05-09;0;0;0;0;0;0;0;0;0;0;0;0;0;0;0;0;0;0
FR;10;2022-05-10;0;0;0;0;0;0;0;0;0;0;0;0;0;0;0;0;0;0
FR;10;2022-05-11;0;0;0;0;0;0;0;0;0;0;0;0;0;0;0;0;0;0
FR;10;2022-05-12;0;0;0;0;0;0;0;0;0;0;0;0;0;0;0;0;0;0
FR;10;2022-05-13;0;0;0;0;0;0;0;0;0;0;0;0;0;0;0;0;0;0
FR;10;2022-05-14;0;0;0;0;0;0;0;0;0;0;0;0;0;0;0;0;0;0
FR;10;2022-05-15;0;0;0;0;0;0;0;0;0;0;0;0;0;0;0;0;0;0
FR;10;2022-05-16;0;0;0;0;0;0;0;0;0;0;0;0;0;0;0;0;0;0
FR;10;2022-05-17;0;0;0;0;0;0;0;0;0;0;0;0;0;0;0;0;0;0
FR;10;2022-05-18;0;0;0;0;0;0;0;0;0;0;0;0;0;0;0;0;0;0
FR;10;2022-05-19;0;0;0;0;0;0;0;0;0;0;0;0;0;0;0;0;0;0
FR;10;2022-05-20;0;0;0;0;0;0;0;0;0;0;0;0;0;0;0;0;0;0
FR;10;2022-05-21;0;0;0;0;0;0;0;0;0;0;0;0;0;0;0;0;0;0
FR;10;2022-05-22;0;0;0;0;0;0;0;0;0;0;0;0;0;0;0;0;0;0
FR;10;2022-05-23;0;0;0;0;0;0;0;0;0;0;0;0;0;0;0;0;0;0
FR;10;2022-05-24;0;0;0;0;0;0;0;0;0;0;0;0;0;0;0;0;0;0
FR;10;2022-05-25;0;0;0;0;0;0;0;0;0;0;0;0;0;0;0;0;0;0
FR;10;2022-05-26;0;0;0;0;0;0;0;0;0;0;0;0;0;0;0;0;0;0
FR;10;2022-05-27;0;0;0;0;0;0;0;0;0;0;0;0;0;0;0;0;0;0
FR;10;2022-05-28;0;0;0;0;0;0;0;0;0;0;0;0;0;0;0;0;0;0
FR;10;2022-05-29;0;0;0;0;0;0;0;0;0;0;0;0;0;0;0;0;0;0
FR;10;2022-05-30;0;0;0;0;0;0;0;0;0;0;0;0;0;0;0;0;0;0
FR;10;2022-05-31;0;0;0;0;0;0;0;0;0;0;0;0;0;0;0;0;0;0
FR;10;2022-06-01;0;0;0;0;0;0;0;0;0;0;0;0;0;0;0;0;0;0
FR;10;2022-06-02;0;0;0;0;0;0;0;0;0;0;0;0;0;0;0;0;0;0
FR;10;2022-06-03;0;0;0;0;0;0;0;0;0;0;0;0;0;0;0;0;0;0
FR;10;2022-06-04;0;0;0;0;0;0;0;0;0;0;0;0;0;0;0;0;0;0
FR;10;2022-06-05;0;0;0;0;0;0;0;0;0;0;0;0;0;0;0;0;0;0
FR;10;2022-06-06;0;0;0;0;0;0;0;0;0;0;0;0;0;0;0;0;0;0
FR;10;2022-06-07;0;0;0;0;0;0;0;0;0;0;0;0;0;0;0;0;0;0
FR;10;2022-06-08;0;0;0;0;0;0;0;0;0;0;0;0;0;0;0;0;0;0
FR;10;2022-06-09;0;0;0;0;0;0;0;0;0;0;0;0;0;0;0;0;0;0
FR;10;2022-06-10;0;0;0;0;0;0;0;0;0;0;0;0;0;0;0;0;0;0
FR;10;2022-06-11;0;0;0;0;0;0;0;0;0;0;0;0;0;0;0;0;0;0
FR;10;2022-06-12;0;0;0;0;0;0;0;0;0;0;0;0;0;0;0;0;0;0
FR;10;2022-06-13;0;0;0;0;0;0;0;0;0;0;0;0;0;0;0;0;0;0
FR;10;2022-06-14;0;0;0;0;0;0;0;0;0;0;0;0;0;0;0;0;0;0
FR;10;2022-06-15;0;0;0;0;0;0;0;0;0;0;0;0;0;0;0;0;0;0
FR;10;2022-06-16;0;0;0;0;0;0;0;0;0;0;0;0;0;0;0;0;0;0
FR;10;2022-06-17;0;0;0;0;0;0;0;0;0;0;0;0;0;0;0;0;0;0
FR;10;2022-06-18;0;0;0;0;0;0;0;0;0;0;0;0;0;0;0;0;0;0
FR;10;2022-06-19;0;0;0;0;0;0;0;0;0;0;0;0;0;0;0;0;0;0
FR;10;2022-06-20;0;0;0;0;0;0;0;0;0;0;0;0;0;0;0;0;0;0
FR;10;2022-06-21;0;0;0;0;0;0;0;0;0;0;0;0;0;0;0;0;0;0
FR;10;2022-06-22;0;0;0;0;0;0;0;0;0;0;0;0;0;0;0;0;0;0
FR;10;2022-06-23;0;0;0;0;0;0;0;0;0;0;0;0;0;0;0;0;0;0
FR;10;2022-06-24;0;0;0;0;0;0;0;0;0;0;0;0;0;0;0;0;0;0
FR;10;2022-06-25;0;0;0;0;0;0;0;0;0;0;0;0;0;0;0;0;0;0
FR;10;2022-06-26;0;0;0;0;0;0;0;0;0;0;0;0;0;0;0;0;0;0
FR;10;2022-06-27;0;0;0;0;0;0;0;0;0;0;0;0;0;0;0;0;0;0
FR;10;2022-06-28;0;0;0;0;0;0;0;0;0;0;0;0;0;0;0;0;0;0
FR;10;2022-06-29;0;0;0;0;0;0;0;0;0;0;0;0;0;0;0;0;0;0
FR;10;2022-06-30;0;0;0;0;0;0;0;0;0;0;0;0;0;0;0;0;0;0
FR;10;2022-07-01;0;0;0;0;0;0;0;0;0;0;0;0;0;0;0;0;0;0
FR;10;2022-07-02;0;0;0;0;0;0;0;0;0;0;0;0;0;0;0;0;0;0
FR;10;2022-07-03;0;0;0;0;0;0;0;0;0;0;0;0;0;0;0;0;0;0
FR;10;2022-07-04;0;0;0;0;0;0;0;0;0;0;0;0;0;0;0;0;0;0
FR;10;2022-07-05;0;0;0;0;0;0;0;0;0;0;0;0;0;0;0;0;0;0
FR;10;2022-07-06;0;0;0;0;0;0;0;0;0;0;0;0;0;0;0;0;0;0
FR;10;2022-07-07;0;0;0;0;0;0;0;0;0;0;0;0;0;0;0;0;0;0
FR;10;2022-07-08;0;0;0;0;0;0;0;0;0;0;0;0;0;0;0;0;0;0
FR;10;2022-07-09;0;0;0;0;0;0;0;0;0;0;0;0;0;0;0;0;0;0
FR;10;2022-07-10;0;0;0;0;0;0;0;0;0;0;0;0;0;0;0;0;0;0
FR;10;2022-07-11;0;0;0;0;0;0;0;0;0;0;0;0;0;0;0;0;0;0
FR;10;2022-07-12;0;0;0;0;0;0;0;0;0;0;0;0;0;0;0;0;0;0
FR;10;2022-07-13;0;0;0;0;0;0;0;0;0;0;0;0;0;0;0;0;0;0
FR;10;2022-07-14;0;0;0;0;0;0;0;0;0;0;0;0;0;0;0;0;0;0
FR;10;2022-07-15;0;0;0;0;0;0;0;0;0;0;0;0;0;0;0;0;0;0
FR;10;2022-07-16;0;0;0;0;0;0;0;0;0;0;0;0;0;0;0;0;0;0
FR;10;2022-07-17;0;0;0;0;0;0;0;0;0;0;0;0;0;0;0;0;0;0
FR;10;2022-07-18;0;0;0;0;0;0;0;0;0;0;0;0;0;0;0;0;0;0
FR;10;2022-07-19;0;0;0;0;0;0;0;0;0;0;0;0;0;0;0;0;0;0
FR;10;2022-07-20;0;0;0;0;0;0;0;0;0;0;0;0;0;0;0;0;0;0
FR;10;2022-07-21;0;0;0;0;0;0;0;0;0;0;0;0;0;0;0;0;0;0
FR;10;2022-07-22;0;0;0;0;0;0;0;0;0;0;0;0;0;0;0;0;0;0
FR;10;2022-07-23;0;0;0;0;0;0;0;0;0;0;0;0;0;0;0;0;0;0
FR;10;2022-07-24;0;0;0;0;0;0;0;0;0;0;0;0;0;0;0;0;0;0
FR;10;2022-07-25;0;0;0;0;0;0;0;0;0;0;0;0;0;0;0;0;0;0
FR;10;2022-07-26;0;0;0;0;0;0;0;0;0;0;0;0;0;0;0;0;0;0
FR;10;2022-07-27;0;0;0;0;0;0;0;0;0;0;0;0;0;0;0;0;0;0
FR;10;2022-07-28;0;0;0;0;0;0;0;0;0;0;0;0;0;0;0;0;0;0
FR;10;2022-07-29;0;0;0;0;0;0;0;0;0;0;0;0;0;0;0;0;0;0
FR;10;2022-07-30;0;0;0;0;0;0;0;0;0;0;0;0;0;0;0;0;0;0
FR;10;2022-07-31;0;0;0;0;0;0;0;0;0;0;0;0;0;0;0;0;0;0
FR;10;2022-08-01;0;0;0;0;0;0;0;0;0;0;0;0;0;0;0;0;0;0
FR;10;2022-08-02;0;0;0;0;0;0;0;0;0;0;0;0;0;0;0;0;0;0
FR;10;2022-08-03;0;0;0;0;0;0;0;0;0;0;0;0;0;0;0;0;0;0
FR;10;2022-08-04;0;0;0;0;0;0;0;0;0;0;0;0;0;0;0;0;0;0
FR;10;2022-08-05;0;0;0;0;0;0;0;0;0;0;0;0;0;0;0;0;0;0
FR;10;2022-08-06;0;0;0;0;0;0;0;0;0;0;0;0;0;0;0;0;0;0
FR;10;2022-08-07;0;0;0;0;0;0;0;0;0;0;0;0;0;0;0;0;0;0
FR;10;2022-08-08;0;0;0;0;0;0;0;0;0;0;0;0;0;0;0;0;0;0
FR;10;2022-08-09;0;0;0;0;0;0;0;0;0;0;0;0;0;0;0;0;0;0
FR;10;2022-08-10;0;0;0;0;0;0;0;0;0;0;0;0;0;0;0;0;0;0
FR;10;2022-08-11;0;0;0;0;0;0;0;0;0;0;0;0;0;0;0;0;0;0
FR;10;2022-08-12;0;0;0;0;0;0;0;0;0;0;0;0;0;0;0;0;0;0
FR;10;2022-08-13;0;0;0;0;0;0;0;0;0;0;0;0;0;0;0;0;0;0
FR;10;2022-08-14;0;0;0;0;0;0;0;0;0;0;0;0;0;0;0;0;0;0
FR;10;2022-08-15;0;0;0;0;0;0;0;0;0;0;0;0;0;0;0;0;0;0
FR;10;2022-08-16;0;0;0;0;0;0;0;0;0;0;0;0;0;0;0;0;0;0
FR;10;2022-08-17;0;0;0;0;0;0;0;0;0;0;0;0;0;0;0;0;0;0
FR;10;2022-08-18;0;0;0;0;0;0;0;0;0;0;0;0;0;0;0;0;0;0
FR;10;2022-08-19;0;0;0;0;0;0;0;0;0;0;0;0;0;0;0;0;0;0
FR;10;2022-08-20;0;0;0;0;0;0;0;0;0;0;0;0;0;0;0;0;0;0
FR;10;2022-08-21;0;0;0;0;0;0;0;0;0;0;0;0;0;0;0;0;0;0
FR;10;2022-08-22;0;0;0;0;0;0;0;0;0;0;0;0;0;0;0;0;0;0
FR;10;2022-08-23;0;0;0;0;0;0;0;0;0;0;0;0;0;0;0;0;0;0
FR;10;2022-08-24;0;0;0;0;0;0;0;0;0;0;0;0;0;0;0;0;0;0
FR;10;2022-08-25;0;0;0;0;0;0;0;0;0;0;0;0;0;0;0;0;0;0
FR;10;2022-08-26;0;0;0;0;0;0;0;0;0;0;0;0;0;0;0;0;0;0
FR;10;2022-08-27;0;0;0;0;0;0;0;0;0;0;0;0;0;0;0;0;0;0
FR;10;2022-08-28;0;0;0;0;0;0;0;0;0;0;0;0;0;0;0;0;0;0
FR;10;2022-08-29;0;0;0;0;0;0;0;0;0;0;0;0;0;0;0;0;0;0
FR;10;2022-08-30;0;0;0;0;0;0;0;0;0;0;0;0;0;0;0;0;0;0
FR;10;2022-08-31;0;0;0;0;0;0;0;0;0;0;0;0;0;0;0;0;0;0
FR;10;2022-09-01;0;0;0;0;0;0;0;0;0;0;0;0;0;0;0;0;0;0
FR;10;2022-09-02;0;0;0;0;0;0;0;0;0;0;0;0;0;0;0;0;0;0
FR;10;2022-09-03;0;0;0;0;0;0;0;0;0;0;0;0;0;0;0;0;0;0
FR;10;2022-09-04;0;0;0;0;0;0;0;0;0;0;0;0;0;0;0;0;0;0
FR;10;2022-09-05;0;0;0;0;0;0;0;0;0;0;0;0;0;0;0;0;0;0
FR;10;2022-09-06;0;0;0;0;0;0;0;0;0;0;0;0;0;0;0;0;0;0
FR;10;2022-09-07;0;0;0;0;0;0;0;0;0;0;0;0;0;0;0;0;0;0
FR;10;2022-09-08;0;0;0;0;0;0;0;0;0;0;0;0;0;0;0;0;0;0
FR;10;2022-09-09;0;0;0;0;0;0;0;0;0;0;0;0;0;0;0;0;0;0
FR;10;2022-09-10;0;0;0;0;0;0;0;0;0;0;0;0;0;0;0;0;0;0
FR;10;2022-09-11;0;0;0;0;0;0;0;0;0;0;0;0;0;0;0;0;0;0
FR;10;2022-09-12;0;0;0;0;0;0;0;0;0;0;0;0;0;0;0;0;0;0
FR;10;2022-09-13;0;0;0;0;0;0;0;0;0;0;0;0;0;0;0;0;0;0
FR;10;2022-09-14;0;0;0;0;0;0;0;0;0;0;0;0;0;0;0;0;0;0
FR;10;2022-09-15;0;0;0;0;0;0;0;0;0;0;0;0;0;0;0;0;0;0
FR;10;2022-09-16;0;0;0;0;0;0;0;0;0;0;0;0;0;0;0;0;0;0
FR;10;2022-09-17;0;0;0;0;0;0;0;0;0;0;0;0;0;0;0;0;0;0
FR;10;2022-09-18;0;0;0;0;0;0;0;0;0;0;0;0;0;0;0;0;0;0
FR;10;2022-09-19;0;0;0;0;0;0;0;0;0;0;0;0;0;0;0;0;0;0
FR;10;2022-09-20;0;0;0;0;0;0;0;0;0;0;0;0;0;0;0;0;0;0
FR;10;2022-09-21;0;0;0;0;0;0;0;0;0;0;0;0;0;0;0;0;0;0
FR;10;2022-09-22;0;0;0;0;0;0;0;0;0;0;0;0;0;0;0;0;0;0
FR;10;2022-09-23;0;0;0;0;0;0;0;0;0;0;0;0;0;0;0;0;0;0
FR;10;2022-09-24;0;0;0;0;0;0;0;0;0;0;0;0;0;0;0;0;0;0
FR;10;2022-09-25;0;0;0;0;0;0;0;0;0;0;0;0;0;0;0;0;0;0
FR;10;2022-09-26;0;0;0;0;0;0;0;0;0;0;0;0;0;0;0;0;0;0
FR;10;2022-09-27;0;0;0;0;0;0;0;0;0;0;0;0;0;0;0;0;0;0
FR;10;2022-09-28;0;0;0;0;0;0;0;0;0;0;0;0;0;0;0;0;0;0
FR;10;2022-09-29;0;0;0;0;0;0;0;0;0;0;0;0;0;0;0;0;0;0
FR;10;2022-09-30;0;0;0;0;0;0;0;0;0;0;0;0;0;0;0;0;0;0
FR;10;2022-10-01;0;0;0;0;0;0;0;0;0;0;0;0;0;0;0;0;0;0
FR;10;2022-10-02;0;0;0;0;0;0;0;0;0;0;0;0;0;0;0;0;0;0
FR;10;2022-10-03;0;0;0;0;0;0;0;0;0;0;0;0;0;0;0;0;0;0
FR;10;2022-10-04;0;0;0;0;0;0;0;0;0;0;0;0;0;0;0;0;0;0
FR;10;2022-10-05;0;0;0;0;0;0;0;0;0;0;0;0;0;0;0;0;0;0
FR;10;2022-10-06;0;0;0;0;0;0;0;0;0;0;0;0;0;0;0;0;0;0
FR;10;2022-10-07;0;0;0;0;0;0;0;0;0;0;0;0;0;0;0;0;0;0
FR;10;2022-10-08;0;0;0;0;0;0;0;0;0;0;0;0;0;0;0;0;0;0
FR;10;2022-10-09;0;0;0;0;0;0;0;0;0;0;0;0;0;0;0;0;0;0
FR;10;2022-10-10;0;0;0;0;0;0;0;0;0;0;0;0;0;0;0;0;0;0
FR;10;2022-10-11;0;0;0;0;0;0;0;0;0;0;0;0;0;0;0;0;0;0
FR;10;2022-10-12;0;0;0;0;0;0;0;0;0;0;0;0;0;0;0;0;0;0
FR;10;2022-10-13;0;0;0;0;0;0;0;0;0;0;0;0;0;0;0;0;0;0
FR;10;2022-10-14;0;0;0;0;0;0;0;0;0;0;0;0;0;0;0;0;0;0
FR;10;2022-10-15;0;0;0;0;0;0;0;0;0;0;0;0;0;0;0;0;0;0
FR;10;2022-10-16;0;0;0;0;0;0;0;0;0;0;0;0;0;0;0;0;0;0
FR;10;2022-10-17;0;0;0;0;0;0;0;0;0;0;0;0;0;0;0;0;0;0
FR;10;2022-10-18;0;0;0;0;0;0;0;0;0;0;0;0;0;0;0;0;0;0
FR;10;2022-10-19;0;0;0;0;0;0;0;0;0;0;0;0;0;0;0;0;0;0
FR;10;2022-10-20;0;0;0;0;0;0;0;0;0;0;0;0;0;0;0;0;0;0
FR;10;2022-10-21;0;0;0;0;0;0;0;0;0;0;0;0;0;0;0;0;0;0
FR;10;2022-10-22;0;0;0;0;0;0;0;0;0;0;0;0;0;0;0;0;0;0
FR;10;2022-10-23;0;0;0;0;0;0;0;0;0;0;0;0;0;0;0;0;0;0
FR;10;2022-10-24;0;0;0;0;0;0;0;0;0;0;0;0;0;0;0;0;0;0
FR;10;2022-10-25;0;0;0;0;0;0;0;0;0;0;0;0;0;0;0;0;0;0
FR;10;2022-10-26;0;0;0;0;0;0;0;0;0;0;0;0;0;0;0;0;0;0
FR;10;2022-10-27;0;0;0;0;0;0;0;0;0;0;0;0;0;0;0;0;0;0
FR;10;2022-10-28;0;0;0;0;0;0;0;0;0;0;0;0;0;0;0;0;0;0
FR;10;2022-10-29;0;0;0;0;0;0;0;0;0;0;0;0;0;0;0;0;0;0
FR;10;2022-10-30;0;0;0;0;0;0;0;0;0;0;0;0;0;0;0;0;0;0
FR;10;2022-10-31;0;0;0;0;0;0;0;0;0;0;0;0;0;0;0;0;0;0
FR;10;2022-11-01;0;0;0;0;0;0;0;0;0;0;0;0;0;0;0;0;0;0
FR;10;2022-11-02;0;0;0;0;0;0;0;0;0;0;0;0;0;0;0;0;0;0
FR;10;2022-11-03;0;0;0;0;0;0;0;0;0;0;0;0;0;0;0;0;0;0
FR;10;2022-11-04;0;0;0;0;0;0;0;0;0;0;0;0;0;0;0;0;0;0
FR;10;2022-11-05;0;0;0;0;0;0;0;0;0;0;0;0;0;0;0;0;0;0
FR;10;2022-11-06;0;0;0;0;0;0;0;0;0;0;0;0;0;0;0;0;0;0
FR;10;2022-11-07;0;0;0;0;0;0;0;0;0;0;0;0;0;0;0;0;0;0
FR;10;2022-11-08;0;0;0;0;0;0;0;0;0;0;0;0;0;0;0;0;0;0
FR;10;2022-11-09;0;0;0;0;0;0;0;0;0;0;0;0;0;0;0;0;0;0
FR;10;2022-11-10;0;0;0;0;0;0;0;0;0;0;0;0;0;0;0;0;0;0
FR;10;2022-11-11;0;0;0;0;0;0;0;0;0;0;0;0;0;0;0;0;0;0
FR;10;2022-11-12;0;0;0;0;0;0;0;0;0;0;0;0;0;0;0;0;0;0
FR;10;2022-11-13;0;0;0;0;0;0;0;0;0;0;0;0;0;0;0;0;0;0
FR;10;2022-11-14;0;0;0;0;0;0;0;0;0;0;0;0;0;0;0;0;0;0
FR;10;2022-11-15;0;0;0;0;0;0;0;0;0;0;0;0;0;0;0;0;0;0
FR;10;2022-11-16;0;0;0;0;0;0;0;0;0;0;0;0;0;0;0;0;0;0
FR;10;2022-11-17;0;0;0;0;0;0;0;0;0;0;0;0;0;0;0;0;0;0
FR;10;2022-11-18;0;0;0;0;0;0;0;0;0;0;0;0;0;0;0;0;0;0
FR;10;2022-11-19;0;0;0;0;0;0;0;0;0;0;0;0;0;0;0;0;0;0
FR;10;2022-11-20;0;0;0;0;0;0;0;0;0;0;0;0;0;0;0;0;0;0
FR;10;2022-11-21;0;0;0;0;0;0;0;0;0;0;0;0;0;0;0;0;0;0
FR;10;2022-11-22;0;0;0;0;0;0;0;0;0;0;0;0;0;0;0;0;0;0
FR;10;2022-11-23;0;0;0;0;0;0;0;0;0;0;0;0;0;0;0;0;0;0
FR;10;2022-11-24;0;0;0;0;0;0;0;0;0;0;0;0;0;0;0;0;0;0
FR;10;2022-11-25;0;0;0;0;0;0;0;0;0;0;0;0;0;0;0;0;0;0
FR;10;2022-11-26;0;0;0;0;0;0;0;0;0;0;0;0;0;0;0;0;0;0
FR;10;2022-11-27;0;0;0;0;0;0;0;0;0;0;0;0;0;0;0;0;0;0
FR;10;2022-11-28;0;0;0;0;0;0;0;0;0;0;0;0;0;0;0;0;0;0
FR;10;2022-11-29;0;0;0;0;0;0;0;0;0;0;0;0;0;0;0;0;0;0
FR;10;2022-11-30;0;0;0;0;0;0;0;0;0;0;0;0;0;0;0;0;0;0
FR;10;2022-12-01;0;0;0;0;0;0;0;0;0;0;0;0;0;0;0;0;0;0
FR;10;2022-12-02;0;0;0;0;0;0;0;0;0;0;0;0;0;0;0;0;0;0
FR;10;2022-12-03;0;0;0;0;0;0;0;0;0;0;0;0;0;0;0;0;0;0
FR;10;2022-12-04;0;0;0;0;0;0;0;0;0;0;0;0;0;0;0;0;0;0
FR;10;2022-12-05;0;0;0;0;0;0;0;0;0;0;0;0;0;0;0;0;0;0
FR;10;2022-12-06;0;0;0;0;0;0;0;0;0;0;0;0;0;0;0;0;0;0
FR;10;2022-12-07;0;0;0;0;0;0;0;0;0;0;0;0;0;0;0;0;0;0
FR;10;2022-12-08;0;0;0;0;0;0;0;0;0;0;0;0;0;0;0;0;0;0
FR;10;2022-12-09;0;0;0;0;0;0;0;0;0;0;0;0;0;0;0;0;0;0
FR;10;2022-12-10;0;0;0;0;0;0;0;0;0;0;0;0;0;0;0;0;0;0
FR;10;2022-12-11;0;0;0;0;0;0;0;0;0;0;0;0;0;0;0;0;0;0
FR;10;2022-12-12;0;0;0;0;0;0;0;0;0;0;0;0;0;0;0;0;0;0
FR;10;2022-12-13;0;0;0;0;0;0;0;0;0;0;0;0;0;0;0;0;0;0
FR;10;2022-12-14;0;0;0;0;0;0;0;0;0;0;0;0;0;0;0;0;0;0
FR;10;2022-12-15;0;0;0;0;0;0;0;0;0;0;0;0;0;0;0;0;0;0
FR;10;2022-12-16;0;0;0;0;0;0;0;0;0;0;0;0;0;0;0;0;0;0
FR;10;2022-12-17;0;0;0;0;0;0;0;0;0;0;0;0;0;0;0;0;0;0
FR;10;2022-12-18;0;0;0;0;0;0;0;0;0;0;0;0;0;0;0;0;0;0
FR;10;2022-12-19;0;0;0;0;0;0;0;0;0;0;0;0;0;0;0;0;0;0
FR;10;2022-12-20;0;0;0;0;0;0;0;0;0;0;0;0;0;0;0;0;0;0
FR;10;2022-12-21;0;0;1;0;0;1;0;0;0;0;0;1;0;0;1;0;0;0
FR;10;2022-12-22;0;0;0;1;0;0;1;0;0;0;0;1;1;0;1;1;0;0
FR;10;2022-12-23;0;0;1;14;0;2;14;0;7;0;0;2;15;0;3;15;0;7
FR;10;2022-12-24;0;0;0;3;0;0;3;0;1;0;0;2;18;0;3;18;0;8
FR;10;2022-12-25;0;0;0;0;0;0;0;0;0;0;0;2;18;0;3;18;0;8
FR;10;2022-12-26;3;1;11;35;0;8;39;0;5;3;1;13;53;0;11;57;0;13
FR;10;2022-12-27;1;1;14;35;1;11;38;0;10;4;2;27;88;1;22;95;0;23
FR;10;2022-12-28;0;0;2;15;0;1;14;0;3;4;2;29;103;1;23;109;0;26
FR;10;2022-12-29;0;0;6;48;0;1;48;0;17;4;2;35;151;1;24;157;0;43
FR;10;2022-12-30;0;1;5;33;0;8;31;0;6;4;3;40;184;1;32;188;0;49
FR;10;2022-12-31;0;0;3;12;0;4;10;0;4;4;3;43;196;1;36;198;0;53
FR;10;2023-01-01;0;0;1;6;0;0;7;0;2;4;3;44;202;1;36;205;0;55
FR;10;2023-01-02;0;4;4;37;1;6;36;0;21;4;7;48;239;2;42;241;0;76
FR;10;2023-01-03;1;2;6;63;2;5;64;0;25;5;9;54;302;4;47;305;0;101
FR;10;2023-01-04;0;1;7;52;0;6;53;0;53;5;10;61;354;4;53;358;0;154
FR;10;2023-01-05;1;2;16;74;0;12;76;0;37;6;12;77;428;4;65;434;0;191
FR;10;2023-01-06;2;3;16;107;2;13;107;0;52;8;15;93;535;6;78;541;0;243
FR;10;2023-01-07;3;1;3;41;1;3;40;0;13;11;16;96;576;7;81;581;0;256
FR;10;2023-01-08;1;0;0;9;0;0;7;0;5;12;16;96;585;7;81;588;0;261
FR;10;2023-01-09;3;2;7;67;1;7;66;0;26;15;18;103;652;8;88;654;0;287
FR;10;2023-01-10;6;1;21;118;0;13;124;0;57;21;19;124;770;8;101;778;0;344
FR;10;2023-01-11;5;4;19;77;1;16;79;0;38;26;23;143;847;9;117;857;0;382
FR;10;2023-01-12;13;1;7;77;2;3;80;0;51;39;24;150;924;11;120;937;0;433
FR;10;2023-01-13;0;6;15;122;1;8;129;0;77;39;30;165;1046;12;128;1066;0;510
FR;10;2023-01-14;2;1;8;43;0;5;47;0;3;41;31;173;1089;12;133;1113;0;513
FR;10;2023-01-15;0;0;2;10;0;1;7;0;8;41;31;175;1099;12;134;1120;0;521
FR;10;2023-01-16;0;1;11;70;1;7;73;0;68;41;32;186;1169;13;141;1193;0;589
FR;10;2023-01-17;0;7;22;109;2;11;118;0;61;41;39;208;1278;15;152;1311;0;650
FR;10;2023-01-18;2;1;13;92;1;9;104;0;15;43;40;221;1370;16;161;1415;0;665
FR;10;2023-01-19;6;6;24;142;3;22;135;0;56;49;46;245;1512;19;183;1550;0;721
FR;10;2023-01-20;2;1;11;111;0;9;106;0;73;51;47;256;1623;19;192;1656;0;794
FR;10;2023-01-21;2;1;5;26;0;5;23;0;15;53;48;261;1649;19;197;1679;0;809
FR;10;2023-01-22;0;0;0;5;0;0;5;0;0;53;48;261;1654;19;197;1684;0;809
FR;10;2023-01-23;1;2;5;62;1;5;59;0;23;54;50;266;1716;20;202;1743;0;832
FR;10;2023-01-24;6;6;27;148;2;19;152;0;75;60;56;293;1864;22;221;1895;0;907
FR;10;2023-01-25;2;1;9;81;1;5;82;0;55;62;57;302;1945;23;226;1977;0;962
FR;10;2023-01-26;4;5;33;147;1;22;159;0;52;66;62;335;2092;24;248;2136;0;1014
FR;10;2023-01-27;1;1;16;117;1;6;118;0;78;67;63;351;2209;25;254;2254;0;1092
FR;10;2023-01-28;0;1;3;18;1;1;21;0;15;67;64;354;2227;26;255;2275;0;1107
FR;10;2023-01-29;0;0;1;0;0;1;0;0;1;67;64;355;2227;26;256;2275;0;1108
FR;10;2023-01-30;2;1;11;60;1;5;63;0;40;69;65;366;2287;27;261;2338;0;1148
FR;10;2023-01-31;5;2;25;121;3;18;121;0;51;74;67;391;2408;30;279;2459;0;1199
FR;10;2023-02-01;0;2;11;49;2;10;49;0;28;74;69;402;2457;32;289;2508;0;1227
FR;10;2023-02-02;3;0;21;104;0;16;108;0;48;77;69;423;2561;32;305;2616;0;1275
FR;10;2023-02-03;6;5;18;48;4;11;51;0;64;83;74;441;2609;36;316;2667;0;1339
FR;10;2023-02-04;1;0;1;8;0;0;10;0;6;84;74;442;2617;36;316;2677;0;1345
FR;10;2023-02-05;7;1;2;3;2;1;4;0;5;91;75;444;2620;38;317;2681;0;1350
FR;10;2023-02-06;1;0;9;28;0;8;22;0;46;92;75;453;2648;38;325;2703;0;1396
FR;10;2023-02-07;2;2;2;12;1;3;12;0;13;94;77;455;2660;39;328;2715;0;1409
FR;10;2023-02-08;1;3;3;15;2;4;15;0;12;95;80;458;2675;41;332;2730;0;1421
FR;10;2023-02-09;2;1;11;91;2;7;97;0;41;97;81;469;2766;43;339;2827;0;1462
FR;10;2023-02-10;8;3;12;29;0;6;37;0;25;105;84;481;2795;43;345;2864;0;1487
FR;10;2023-02-11;1;0;2;2;0;2;2;0;1;106;84;483;2797;43;347;2866;0;1488
FR;10;2023-02-12;1;1;0;0;1;0;0;0;0;107;85;483;2797;44;347;2866;0;1488
FR;10;2023-02-13;3;1;9;15;0;7;18;0;10;110;86;492;2812;44;354;2884;0;1498
FR;10;2023-02-14;2;4;11;49;3;9;50;0;17;112;90;503;2861;47;363;2934;0;1515
FR;10;2023-02-15;7;3;2;10;2;3;8;0;8;119;93;505;2871;49;366;2942;0;1523
FR;10;2023-02-16;0;0;8;17;0;5;18;0;8;119;93;513;2888;49;371;2960;0;1531
FR;10;2023-02-17;13;5;7;28;5;2;22;0;17;132;98;520;2916;54;373;2982;0;1548
FR;10;2023-02-18;2;0;3;11;0;3;10;0;6;134;98;523;2927;54;376;2992;0;1554
FR;10;2023-02-19;0;0;0;0;0;0;0;0;0;134;98;523;2927;54;376;2992;0;1554
FR;10;2023-02-20;2;1;2;25;1;1;23;0;23;136;99;525;2952;55;377;3015;0;1577
FR;10;2023-02-21;2;3;12;27;1;6;35;0;30;138;102;537;2979;56;383;3050;0;1607
FR;10;2023-02-22;5;4;2;7;3;3;6;0;1;143;106;539;2986;59;386;3056;0;1608
FR;10;2023-02-23;3;2;17;31;2;14;37;0;12;146;108;556;3017;61;400;3093;0;1620
FR;10;2023-02-24;1;2;8;27;0;5;27;0;29;147;110;564;3044;61;405;3120;0;1649
FR;10;2023-02-25;0;0;2;3;0;2;3;0;7;147;110;566;3047;61;407;3123;0;1656
FR;10;2023-02-26;0;0;0;0;0;0;0;0;0;147;110;566;3047;61;407;3123;0;1656
FR;10;2023-02-27;3;3;3;20;4;3;21;0;15;150;113;569;3067;65;410;3144;0;1671
FR;10;2023-02-28;3;2;3;10;2;1;11;0;10;153;115;572;3077;67;411;3155;0;1681
FR;10;2023-03-01;2;6;34;12;6;33;12;0;14;155;121;606;3089;73;444;3167;0;1695
FR;10;2023-03-02;2;1;10;22;2;6;22;0;31;157;122;616;3111;75;450;3189;0;1726
FR;10;2023-03-03;7;2;5;21;0;6;20;0;18;164;124;621;3132;75;456;3209;0;1744
FR;10;2023-03-04;0;1;0;6;1;0;6;0;2;164;125;621;3138;76;456;3215;0;1746
FR;10;2023-03-05;0;0;0;1;0;0;0;0;2;164;125;621;3139;76;456;3215;0;1748
FR;10;2023-03-06;2;2;8;8;3;7;9;0;8;166;127;629;3147;79;463;3224;0;1756
FR;10;2023-03-07;2;3;0;11;1;2;11;0;8;168;130;629;3158;80;465;3235;0;1764
FR;10;2023-03-08;1;4;4;20;3;3;22;0;9;169;134;633;3178;83;468;3257;0;1773
FR;10;2023-03-09;0;3;1;9;1;2;8;0;8;169;137;634;3187;84;470;3265;0;1781
FR;10;2023-03-10;1;2;1;8;2;1;9;0;9;170;139;635;3195;86;471;3274;0;1790
FR;10;2023-03-11;2;1;5;4;0;3;7;0;2;172;140;640;3199;86;474;3281;0;1792
FR;10;2023-03-12;0;0;0;0;0;0;0;0;0;172;140;640;3199;86;474;3281;0;1792
FR;10;2023-03-13;0;2;2;3;2;2;3;0;5;172;142;642;3202;88;476;3284;0;1797
FR;10;2023-03-14;2;0;6;25;0;4;27;0;21;174;142;648;3227;88;480;3311;0;1818
FR;10;2023-03-15;0;2;5;5;1;7;4;0;6;174;144;653;3232;89;487;3315;0;1824
FR;10;2023-03-16;3;1;7;12;0;5;15;0;11;177;145;660;3244;89;492;3330;0;1835
FR;10;2023-03-17;3;5;8;18;4;4;22;0;19;180;150;668;3262;93;496;3352;0;1854
FR;10;2023-03-18;0;1;1;3;0;2;2;0;3;180;151;669;3265;93;498;3354;0;1857
FR;10;2023-03-19;6;0;0;0;0;0;0;0;0;186;151;669;3265;93;498;3354;0;1857
FR;10;2023-03-20;5;4;0;12;3;1;13;0;12;191;155;669;3277;96;499;3367;0;1869
FR;10;2023-03-21;1;2;2;7;0;3;9;0;14;192;157;671;3284;96;502;3376;0;1883
FR;10;2023-03-22;0;0;3;4;0;3;3;0;3;192;157;674;3288;96;505;3379;0;1886
FR;10;2023-03-23;9;9;4;6;9;1;8;0;13;201;166;678;3294;105;506;3387;0;1899
FR;10;2023-03-24;3;3;2;14;2;1;10;0;17;204;169;680;3308;107;507;3397;0;1916
FR;10;2023-03-25;1;3;0;4;1;3;5;0;8;205;172;680;3312;108;510;3402;0;1924
FR;10;2023-03-26;1;1;0;0;1;0;0;0;0;206;173;680;3312;109;510;3402;0;1924
FR;10;2023-03-27;0;2;3;4;2;3;2;0;16;206;175;683;3316;111;513;3404;0;1940
FR;10;2023-03-28;9;8;3;5;8;1;6;0;6;215;183;686;3321;119;514;3410;0;1946
FR;10;2023-03-29;7;7;3;2;6;4;2;0;6;222;190;689;3323;125;518;3412;0;1952
FR;10;2023-03-30;16;13;3;7;13;2;8;0;6;238;203;692;3330;138;520;3420;0;1958
FR;10;2023-03-31;8;6;4;12;5;4;13;0;19;246;209;696;3342;143;524;3433;0;1977
FR;10;2023-04-01;9;8;1;0;8;1;0;0;0;255;217;697;3342;151;525;3433;0;1977
FR;10;2023-04-02;1;0;0;0;0;0;0;0;1;256;217;697;3342;151;525;3433;0;1978
FR;10;2023-04-03;2;1;0;3;1;0;2;0;5;258;218;697;3345;152;525;3435;0;1983
FR;10;2023-04-04;0;1;0;3;1;0;3;0;5;258;219;697;3348;153;525;3438;0;1988
FR;10;2023-04-05;0;0;2;1;0;2;3;0;2;258;219;699;3349;153;527;3441;0;1990
FR;10;2023-04-06;2;2;4;4;2;1;7;0;2;260;221;703;3353;155;528;3448;0;1992
FR;10;2023-04-07;3;0;2;3;0;1;3;0;9;263;221;705;3356;155;529;3451;0;2001
FR;10;2023-04-08;0;0;1;0;0;1;0;0;0;263;221;706;3356;155;530;3451;0;2001
FR;10;2023-04-09;0;0;0;0;0;0;0;0;0;263;221;706;3356;155;530;3451;0;2001
FR;10;2023-04-10;0;0;2;0;0;0;2;0;0;263;221;708;3356;155;530;3453;0;2001
FR;10;2023-04-11;1;0;1;3;0;1;2;0;3;264;221;709;3359;155;531;3455;0;2004
FR;10;2023-04-12;0;0;2;1;0;1;2;0;4;264;221;711;3360;155;532;3457;0;2008
FR;10;2023-04-13;0;1;0;5;1;0;5;0;5;264;222;711;3365;156;532;3462;0;2013
FR;10;2023-04-14;3;0;1;7;0;1;4;0;5;267;222;712;3372;156;533;3466;0;2018
FR;10;2023-04-15;0;1;1;3;1;0;4;0;0;267;223;713;3375;157;533;3470;0;2018
FR;10;2023-04-16;0;0;0;2;0;0;2;0;0;267;223;713;3377;157;533;3472;0;2018
FR;10;2023-04-17;1;2;2;0;1;2;0;0;0;268;225;715;3377;158;535;3472;0;2018
FR;10;2023-04-18;2;2;1;3;2;1;0;0;2;270;227;716;3380;160;536;3472;0;2020
FR;10;2023-04-19;0;0;1;0;0;1;0;0;1;270;227;717;3380;160;537;3472;0;2021
FR;10;2023-04-20;0;2;1;1;1;2;1;0;2;270;229;718;3381;161;539;3473;0;2023
FR;10;2023-04-21;0;1;5;7;0;4;9;0;3;270;230;723;3388;161;543;3482;0;2026
FR;10;2023-04-22;1;1;0;2;1;0;2;0;1;271;231;723;3390;162;543;3484;0;2027
FR;10;2023-04-23;0;0;0;0;0;0;0;0;0;271;231;723;3390;162;543;3484;0;2027
FR;10;2023-04-24;0;1;0;0;1;0;0;0;4;271;232;723;3390;163;543;3484;0;2031
FR;10;2023-04-25;0;0;1;0;0;1;0;0;2;271;232;724;3390;163;544;3484;0;2033
FR;10;2023-04-26;1;0;2;1;1;2;1;0;1;272;232;726;3391;164;546;3485;0;2034
FR;10;2023-04-27;0;0;1;1;0;1;1;0;1;272;232;727;3392;164;547;3486;0;2035
FR;10;2023-04-28;0;1;3;5;1;0;6;0;6;272;233;730;3397;165;547;3492;0;2041
FR;10;2023-04-29;0;0;0;1;0;0;0;0;1;272;233;730;3398;165;547;3492;0;2042
FR;10;2023-04-30;0;0;0;0;0;0;0;0;0;272;233;730;3398;165;547;3492;0;2042
FR;10;2023-05-01;0;0;0;0;0;0;0;0;0;272;233;730;3398;165;547;3492;0;2042
FR;10;2023-05-02;2;1;0;2;2;0;2;0;4;274;234;730;3400;167;547;3494;0;2046
FR;10;2023-05-03;0;1;1;2;1;1;1;0;17;274;235;731;3402;168;548;3495;0;2063
FR;10;2023-05-04;0;1;1;0;1;1;0;0;1;274;236;732;3402;169;549;3495;0;2064
FR;10;2023-05-05;0;1;2;6;0;2;6;0;9;274;237;734;3408;169;551;3501;0;2073
FR;10;2023-05-06;0;0;3;3;0;2;4;0;1;274;237;737;3411;169;553;3505;0;2074
FR;10;2023-05-07;0;0;0;0;0;0;0;0;0;274;237;737;3411;169;553;3505;0;2074
FR;10;2023-05-08;0;0;0;0;0;0;0;0;0;274;237;737;3411;169;553;3505;0;2074
FR;10;2023-05-09;0;1;1;0;0;1;1;0;1;274;238;738;3411;169;554;3506;0;2075
FR;10;2023-05-10;15;5;1;1;5;0;2;0;0;289;243;739;3412;174;554;3508;0;2075
FR;10;2023-05-11;0;0;0;2;0;0;2;0;4;289;243;739;3414;174;554;3510;0;2079
FR;10;2023-05-12;1;0;1;6;0;2;5;0;9;290;243;740;3420;174;556;3515;0;2088
FR;10;2023-05-13;0;0;1;0;0;0;1;0;0;290;243;741;3420;174;556;3516;0;2088
FR;10;2023-05-14;0;0;0;0;0;0;0;0;0;290;243;741;3420;174;556;3516;0;2088
FR;10;2023-05-15;0;1;0;0;0;1;0;0;1;290;244;741;3420;174;557;3516;0;2089
FR;10;2023-05-16;0;0;0;2;0;0;2;0;3;290;244;741;3422;174;557;3518;0;2092
FR;10;2023-05-17;0;0;0;1;0;0;1;0;1;290;244;741;3423;174;557;3519;0;2093
FR;10;2023-05-18;0;0;0;0;0;0;0;0;0;290;244;741;3423;174;557;3519;0;2093
FR;10;2023-05-19;1;0;1;2;0;1;2;0;0;291;244;742;3425;174;558;3521;0;2093
FR;10;2023-05-20;1;0;0;1;0;0;1;0;1;292;244;742;3426;174;558;3522;0;2094
FR;10;2023-05-21;0;0;0;0;0;0;0;0;0;292;244;742;3426;174;558;3522;0;2094
FR;10;2023-05-22;1;0;1;3;0;1;3;0;0;293;244;743;3429;174;559;3525;0;2094
FR;10;2023-05-23;0;0;3;1;0;1;4;0;2;293;244;746;3430;174;560;3529;0;2096
FR;10;2023-05-24;1;2;0;0;3;0;1;0;5;294;246;746;3430;177;560;3530;0;2101
FR;10;2023-05-25;1;1;1;1;2;0;2;0;4;295;247;747;3431;179;560;3532;0;2105
FR;10;2023-05-26;1;0;2;5;0;2;5;0;6;296;247;749;3436;179;562;3537;0;2111
FR;10;2023-05-27;1;0;0;0;0;0;0;0;0;297;247;749;3436;179;562;3537;0;2111
FR;10;2023-05-28;1;0;0;0;1;0;0;0;0;298;247;749;3436;180;562;3537;0;2111
FR;10;2023-05-29;1;1;0;0;1;0;0;0;0;299;248;749;3436;181;562;3537;0;2111
FR;10;2023-05-30;0;0;1;3;0;1;4;0;1;299;248;750;3439;181;563;3541;0;2112
FR;10;2023-05-31;1;2;0;2;1;1;2;0;5;300;250;750;3441;182;564;3543;0;2117
FR;10;2023-06-01;0;0;2;0;0;2;0;0;8;300;250;752;3441;182;566;3543;0;2125
FR;10;2023-06-02;0;1;0;3;1;0;2;0;5;300;251;752;3444;183;566;3545;0;2130
FR;10;2023-06-03;0;0;0;1;0;0;1;0;1;300;251;752;3445;183;566;3546;0;2131
FR;10;2023-06-04;0;0;0;0;0;0;0;0;0;300;251;752;3445;183;566;3546;0;2131
FR;10;2023-06-05;0;0;0;2;0;0;2;0;1;300;251;752;3447;183;566;3548;0;2132
FR;10;2023-06-06;0;0;2;6;0;1;7;0;11;300;251;754;3453;183;567;3555;0;2143
FR;10;2023-06-07;0;0;0;0;0;0;0;0;0;300;251;754;3453;183;567;3555;0;2143
FR;10;2023-06-08;1;1;0;3;1;0;3;0;6;301;252;754;3456;184;567;3558;0;2149
FR;10;2023-06-09;1;0;0;0;0;0;0;0;0;302;252;754;3456;184;567;3558;0;2149
FR;10;2023-06-10;0;0;0;0;0;0;0;0;1;302;252;754;3456;184;567;3558;0;2150
FR;10;2023-06-11;0;0;0;0;0;0;0;0;0;302;252;754;3456;184;567;3558;0;2150
FR;10;2023-06-12;0;0;1;0;0;1;0;0;1;302;252;755;3456;184;568;3558;0;2151
FR;10;2023-06-13;1;1;0;0;1;0;0;0;5;303;253;755;3456;185;568;3558;0;2156
FR;10;2023-06-14;0;0;0;3;0;0;6;0;3;303;253;755;3459;185;568;3564;0;2159
FR;10;2023-06-15;0;0;2;3;0;1;4;0;5;303;253;757;3462;185;569;3568;0;2164
FR;10;2023-06-16;0;0;0;5;0;0;4;0;5;303;253;757;3467;185;569;3572;0;2169
FR;10;2023-06-17;0;0;0;2;0;0;2;0;2;303;253;757;3469;185;569;3574;0;2171
FR;10;2023-06-18;0;0;0;0;0;0;0;0;0;303;253;757;3469;185;569;3574;0;2171
FR;10;2023-06-19;0;1;0;1;0;1;1;0;0;303;254;757;3470;185;570;3575;0;2171
FR;11;2020-12-27;0;0;0;0;0;0;0;0;0;0;0;0;0;0;0;0;0;0
FR;11;2020-12-28;0;0;0;0;0;0;0;0;0;0;0;0;0;0;0;0;0;0
FR;11;2020-12-29;0;0;0;0;0;0;0;0;0;0;0;0;0;0;0;0;0;0
FR;11;2020-12-30;0;0;0;0;0;0;0;0;0;0;0;0;0;0;0;0;0;0
FR;11;2020-12-31;0;0;0;0;0;0;0;0;0;0;0;0;0;0;0;0;0;0
FR;11;2021-01-01;0;0;0;0;0;0;0;0;0;0;0;0;0;0;0;0;0;0
FR;11;2021-01-02;0;0;0;0;0;0;0;0;0;0;0;0;0;0;0;0;0;0
FR;11;2021-01-03;0;0;0;0;0;0;0;0;0;0;0;0;0;0;0;0;0;0
FR;11;2021-01-04;0;0;0;0;0;0;0;0;0;0;0;0;0;0;0;0;0;0
FR;11;2021-01-05;0;0;0;0;0;0;0;0;0;0;0;0;0;0;0;0;0;0
FR;11;2021-01-06;0;0;0;0;0;0;0;0;0;0;0;0;0;0;0;0;0;0
FR;11;2021-01-07;0;0;0;0;0;0;0;0;0;0;0;0;0;0;0;0;0;0
FR;11;2021-01-08;0;0;0;0;0;0;0;0;0;0;0;0;0;0;0;0;0;0
FR;11;2021-01-09;0;0;0;0;0;0;0;0;0;0;0;0;0;0;0;0;0;0
FR;11;2021-01-10;0;0;0;0;0;0;0;0;0;0;0;0;0;0;0;0;0;0
FR;11;2021-01-11;0;0;0;0;0;0;0;0;0;0;0;0;0;0;0;0;0;0
FR;11;2021-01-12;0;0;0;0;0;0;0;0;0;0;0;0;0;0;0;0;0;0
FR;11;2021-01-13;0;0;0;0;0;0;0;0;0;0;0;0;0;0;0;0;0;0
FR;11;2021-01-14;0;0;0;0;0;0;0;0;0;0;0;0;0;0;0;0;0;0
FR;11;2021-01-15;0;0;0;0;0;0;0;0;0;0;0;0;0;0;0;0;0;0
FR;11;2021-01-16;0;0;0;0;0;0;0;0;0;0;0;0;0;0;0;0;0;0
FR;11;2021-01-17;0;0;0;0;0;0;0;0;0;0;0;0;0;0;0;0;0;0
FR;11;2021-01-18;0;0;0;0;0;0;0;0;0;0;0;0;0;0;0;0;0;0
FR;11;2021-01-19;0;0;0;0;0;0;0;0;0;0;0;0;0;0;0;0;0;0
FR;11;2021-01-20;0;0;0;0;0;0;0;0;0;0;0;0;0;0;0;0;0;0
FR;11;2021-01-21;0;0;0;0;0;0;0;0;0;0;0;0;0;0;0;0;0;0
FR;11;2021-01-22;0;0;0;0;0;0;0;0;0;0;0;0;0;0;0;0;0;0
FR;11;2021-01-23;0;0;0;0;0;0;0;0;0;0;0;0;0;0;0;0;0;0
FR;11;2021-01-24;0;0;0;0;0;0;0;0;0;0;0;0;0;0;0;0;0;0
FR;11;2021-01-25;0;0;0;0;0;0;0;0;0;0;0;0;0;0;0;0;0;0
FR;11;2021-01-26;0;0;0;0;0;0;0;0;0;0;0;0;0;0;0;0;0;0
FR;11;2021-01-27;0;0;0;0;0;0;0;0;0;0;0;0;0;0;0;0;0;0
FR;11;2021-01-28;0;0;0;0;0;0;0;0;0;0;0;0;0;0;0;0;0;0
FR;11;2021-01-29;0;0;0;0;0;0;0;0;0;0;0;0;0;0;0;0;0;0
FR;11;2021-01-30;0;0;0;0;0;0;0;0;0;0;0;0;0;0;0;0;0;0
FR;11;2021-01-31;0;0;0;0;0;0;0;0;0;0;0;0;0;0;0;0;0;0
FR;11;2021-02-01;0;0;0;0;0;0;0;0;0;0;0;0;0;0;0;0;0;0
FR;11;2021-02-02;0;0;0;0;0;0;0;0;0;0;0;0;0;0;0;0;0;0
FR;11;2021-02-03;0;0;0;0;0;0;0;0;0;0;0;0;0;0;0;0;0;0
FR;11;2021-02-04;0;0;0;0;0;0;0;0;0;0;0;0;0;0;0;0;0;0
FR;11;2021-02-05;0;0;0;0;0;0;0;0;0;0;0;0;0;0;0;0;0;0
FR;11;2021-02-06;0;0;0;0;0;0;0;0;0;0;0;0;0;0;0;0;0;0
FR;11;2021-02-07;0;0;0;0;0;0;0;0;0;0;0;0;0;0;0;0;0;0
FR;11;2021-02-08;0;0;0;0;0;0;0;0;0;0;0;0;0;0;0;0;0;0
FR;11;2021-02-09;0;0;0;0;0;0;0;0;0;0;0;0;0;0;0;0;0;0
FR;11;2021-02-10;0;0;0;0;0;0;0;0;0;0;0;0;0;0;0;0;0;0
FR;11;2021-02-11;0;0;0;0;0;0;0;0;0;0;0;0;0;0;0;0;0;0
FR;11;2021-02-12;0;0;0;0;0;0;0;0;0;0;0;0;0;0;0;0;0;0
FR;11;2021-02-13;0;0;0;0;0;0;0;0;0;0;0;0;0;0;0;0;0;0
FR;11;2021-02-14;0;0;0;0;0;0;0;0;0;0;0;0;0;0;0;0;0;0
FR;11;2021-02-15;0;0;0;0;0;0;0;0;0;0;0;0;0;0;0;0;0;0
FR;11;2021-02-16;0;0;0;0;0;0;0;0;0;0;0;0;0;0;0;0;0;0
FR;11;2021-02-17;0;0;0;0;0;0;0;0;0;0;0;0;0;0;0;0;0;0
FR;11;2021-02-18;0;0;0;0;0;0;0;0;0;0;0;0;0;0;0;0;0;0
FR;11;2021-02-19;0;0;0;0;0;0;0;0;0;0;0;0;0;0;0;0;0;0
FR;11;2021-02-20;0;0;0;0;0;0;0;0;0;0;0;0;0;0;0;0;0;0
FR;11;2021-02-21;0;0;0;0;0;0;0;0;0;0;0;0;0;0;0;0;0;0
FR;11;2021-02-22;0;0;0;0;0;0;0;0;0;0;0;0;0;0;0;0;0;0
FR;11;2021-02-23;0;0;0;0;0;0;0;0;0;0;0;0;0;0;0;0;0;0
FR;11;2021-02-24;0;0;0;0;0;0;0;0;0;0;0;0;0;0;0;0;0;0
FR;11;2021-02-25;0;0;0;0;0;0;0;0;0;0;0;0;0;0;0;0;0;0
FR;11;2021-02-26;0;0;0;0;0;0;0;0;0;0;0;0;0;0;0;0;0;0
FR;11;2021-02-27;0;0;0;0;0;0;0;0;0;0;0;0;0;0;0;0;0;0
FR;11;2021-02-28;0;0;0;0;0;0;0;0;0;0;0;0;0;0;0;0;0;0
FR;11;2021-03-01;0;0;0;0;0;0;0;0;0;0;0;0;0;0;0;0;0;0
FR;11;2021-03-02;0;0;0;0;0;0;0;0;0;0;0;0;0;0;0;0;0;0
FR;11;2021-03-03;0;0;0;0;0;0;0;0;0;0;0;0;0;0;0;0;0;0
FR;11;2021-03-04;0;0;0;0;0;0;0;0;0;0;0;0;0;0;0;0;0;0
FR;11;2021-03-05;0;0;0;0;0;0;0;0;0;0;0;0;0;0;0;0;0;0
FR;11;2021-03-06;0;0;0;0;0;0;0;0;0;0;0;0;0;0;0;0;0;0
FR;11;2021-03-07;0;0;0;0;0;0;0;0;0;0;0;0;0;0;0;0;0;0
FR;11;2021-03-08;0;0;0;0;0;0;0;0;0;0;0;0;0;0;0;0;0;0
FR;11;2021-03-09;0;0;0;0;0;0;0;0;0;0;0;0;0;0;0;0;0;0
FR;11;2021-03-10;0;0;0;0;0;0;0;0;0;0;0;0;0;0;0;0;0;0
FR;11;2021-03-11;0;0;0;0;0;0;0;0;0;0;0;0;0;0;0;0;0;0
FR;11;2021-03-12;0;0;0;0;0;0;0;0;0;0;0;0;0;0;0;0;0;0
FR;11;2021-03-13;0;0;0;0;0;0;0;0;0;0;0;0;0;0;0;0;0;0
FR;11;2021-03-14;0;0;0;0;0;0;0;0;0;0;0;0;0;0;0;0;0;0
FR;11;2021-03-15;0;0;0;0;0;0;0;0;0;0;0;0;0;0;0;0;0;0
FR;11;2021-03-16;0;0;0;0;0;0;0;0;0;0;0;0;0;0;0;0;0;0
FR;11;2021-03-17;0;0;0;0;0;0;0;0;0;0;0;0;0;0;0;0;0;0
FR;11;2021-03-18;0;0;0;0;0;0;0;0;0;0;0;0;0;0;0;0;0;0
FR;11;2021-03-19;0;0;0;0;0;0;0;0;0;0;0;0;0;0;0;0;0;0
FR;11;2021-03-20;0;0;0;0;0;0;0;0;0;0;0;0;0;0;0;0;0;0
FR;11;2021-03-21;0;0;0;0;0;0;0;0;0;0;0;0;0;0;0;0;0;0
FR;11;2021-03-22;0;0;0;0;0;0;0;0;0;0;0;0;0;0;0;0;0;0
FR;11;2021-03-23;0;0;0;0;0;0;0;0;0;0;0;0;0;0;0;0;0;0
FR;11;2021-03-24;0;0;0;0;0;0;0;0;0;0;0;0;0;0;0;0;0;0
FR;11;2021-03-25;0;0;0;0;0;0;0;0;0;0;0;0;0;0;0;0;0;0
FR;11;2021-03-26;0;0;0;0;0;0;0;0;0;0;0;0;0;0;0;0;0;0
FR;11;2021-03-27;0;0;0;0;0;0;0;0;0;0;0;0;0;0;0;0;0;0
FR;11;2021-03-28;0;0;0;0;0;0;0;0;0;0;0;0;0;0;0;0;0;0
FR;11;2021-03-29;0;0;0;0;0;0;0;0;0;0;0;0;0;0;0;0;0;0
FR;11;2021-03-30;0;0;0;0;0;0;0;0;0;0;0;0;0;0;0;0;0;0
FR;11;2021-03-31;0;0;0;0;0;0;0;0;0;0;0;0;0;0;0;0;0;0
FR;11;2021-04-01;0;0;0;0;0;0;0;0;0;0;0;0;0;0;0;0;0;0
FR;11;2021-04-02;0;0;0;0;0;0;0;0;0;0;0;0;0;0;0;0;0;0
FR;11;2021-04-03;0;0;0;0;0;0;0;0;0;0;0;0;0;0;0;0;0;0
FR;11;2021-04-04;0;0;0;0;0;0;0;0;0;0;0;0;0;0;0;0;0;0
FR;11;2021-04-05;0;0;0;0;0;0;0;0;0;0;0;0;0;0;0;0;0;0
FR;11;2021-04-06;0;0;0;0;0;0;0;0;0;0;0;0;0;0;0;0;0;0
FR;11;2021-04-07;0;0;0;0;0;0;0;0;0;0;0;0;0;0;0;0;0;0
FR;11;2021-04-08;0;0;0;0;0;0;0;0;0;0;0;0;0;0;0;0;0;0
FR;11;2021-04-09;0;0;0;0;0;0;0;0;0;0;0;0;0;0;0;0;0;0
FR;11;2021-04-10;0;0;0;0;0;0;0;0;0;0;0;0;0;0;0;0;0;0
FR;11;2021-04-11;0;0;0;0;0;0;0;0;0;0;0;0;0;0;0;0;0;0
FR;11;2021-04-12;0;0;0;0;0;0;0;0;0;0;0;0;0;0;0;0;0;0
FR;11;2021-04-13;0;0;0;0;0;0;0;0;0;0;0;0;0;0;0;0;0;0
FR;11;2021-04-14;0;0;0;0;0;0;0;0;0;0;0;0;0;0;0;0;0;0
FR;11;2021-04-15;0;0;0;0;0;0;0;0;0;0;0;0;0;0;0;0;0;0
FR;11;2021-04-16;0;0;0;0;0;0;0;0;0;0;0;0;0;0;0;0;0;0
FR;11;2021-04-17;0;0;0;0;0;0;0;0;0;0;0;0;0;0;0;0;0;0
FR;11;2021-04-18;0;0;0;0;0;0;0;0;0;0;0;0;0;0;0;0;0;0
FR;11;2021-04-19;0;0;0;0;0;0;0;0;0;0;0;0;0;0;0;0;0;0
FR;11;2021-04-20;0;0;0;0;0;0;0;0;0;0;0;0;0;0;0;0;0;0
FR;11;2021-04-21;0;0;0;0;0;0;0;0;0;0;0;0;0;0;0;0;0;0
FR;11;2021-04-22;0;0;0;0;0;0;0;0;0;0;0;0;0;0;0;0;0;0
FR;11;2021-04-23;0;0;0;0;0;0;0;0;0;0;0;0;0;0;0;0;0;0
FR;11;2021-04-24;0;0;0;0;0;0;0;0;0;0;0;0;0;0;0;0;0;0
FR;11;2021-04-25;0;0;0;0;0;0;0;0;0;0;0;0;0;0;0;0;0;0
FR;11;2021-04-26;0;0;0;0;0;0;0;0;0;0;0;0;0;0;0;0;0;0
FR;11;2021-04-27;0;0;0;0;0;0;0;0;0;0;0;0;0;0;0;0;0;0
FR;11;2021-04-28;0;0;0;0;0;0;0;0;0;0;0;0;0;0;0;0;0;0
FR;11;2021-04-29;0;0;0;0;0;0;0;0;0;0;0;0;0;0;0;0;0;0
FR;11;2021-04-30;0;0;0;0;0;0;0;0;0;0;0;0;0;0;0;0;0;0
FR;11;2021-05-01;0;0;0;0;0;0;0;0;0;0;0;0;0;0;0;0;0;0
FR;11;2021-05-02;0;0;0;0;0;0;0;0;0;0;0;0;0;0;0;0;0;0
FR;11;2021-05-03;0;0;0;0;0;0;0;0;0;0;0;0;0;0;0;0;0;0
FR;11;2021-05-04;0;0;0;0;0;0;0;0;0;0;0;0;0;0;0;0;0;0
FR;11;2021-05-05;0;0;0;0;0;0;0;0;0;0;0;0;0;0;0;0;0;0
FR;11;2021-05-06;0;0;0;0;0;0;0;0;0;0;0;0;0;0;0;0;0;0
FR;11;2021-05-07;0;0;0;0;0;0;0;0;0;0;0;0;0;0;0;0;0;0
FR;11;2021-05-08;0;0;0;0;0;0;0;0;0;0;0;0;0;0;0;0;0;0
FR;11;2021-05-09;0;0;0;0;0;0;0;0;0;0;0;0;0;0;0;0;0;0
FR;11;2021-05-10;0;0;0;0;0;0;0;0;0;0;0;0;0;0;0;0;0;0
FR;11;2021-05-11;0;0;0;0;0;0;0;0;0;0;0;0;0;0;0;0;0;0
FR;11;2021-05-12;0;0;0;0;0;0;0;0;0;0;0;0;0;0;0;0;0;0
FR;11;2021-05-13;0;0;0;0;0;0;0;0;0;0;0;0;0;0;0;0;0;0
FR;11;2021-05-14;0;0;0;0;0;0;0;0;0;0;0;0;0;0;0;0;0;0
FR;11;2021-05-15;0;0;0;0;0;0;0;0;0;0;0;0;0;0;0;0;0;0
FR;11;2021-05-16;0;0;0;0;0;0;0;0;0;0;0;0;0;0;0;0;0;0
FR;11;2021-05-17;0;0;0;0;0;0;0;0;0;0;0;0;0;0;0;0;0;0
FR;11;2021-05-18;0;0;0;0;0;0;0;0;0;0;0;0;0;0;0;0;0;0
FR;11;2021-05-19;0;0;0;0;0;0;0;0;0;0;0;0;0;0;0;0;0;0
FR;11;2021-05-20;0;0;0;0;0;0;0;0;0;0;0;0;0;0;0;0;0;0
FR;11;2021-05-21;0;0;0;0;0;0;0;0;0;0;0;0;0;0;0;0;0;0
FR;11;2021-05-22;0;0;0;0;0;0;0;0;0;0;0;0;0;0;0;0;0;0
FR;11;2021-05-23;0;0;0;0;0;0;0;0;0;0;0;0;0;0;0;0;0;0
FR;11;2021-05-24;0;0;0;0;0;0;0;0;0;0;0;0;0;0;0;0;0;0
FR;11;2021-05-25;0;0;0;0;0;0;0;0;0;0;0;0;0;0;0;0;0;0
FR;11;2021-05-26;0;0;0;0;0;0;0;0;0;0;0;0;0;0;0;0;0;0
FR;11;2021-05-27;0;0;0;0;0;0;0;0;0;0;0;0;0;0;0;0;0;0
FR;11;2021-05-28;0;0;0;0;0;0;0;0;0;0;0;0;0;0;0;0;0;0
FR;11;2021-05-29;0;0;0;0;0;0;0;0;0;0;0;0;0;0;0;0;0;0
FR;11;2021-05-30;0;0;0;0;0;0;0;0;0;0;0;0;0;0;0;0;0;0
FR;11;2021-05-31;0;0;0;0;0;0;0;0;0;0;0;0;0;0;0;0;0;0
FR;11;2021-06-01;0;0;0;0;0;0;0;0;0;0;0;0;0;0;0;0;0;0
FR;11;2021-06-02;0;0;0;0;0;0;0;0;0;0;0;0;0;0;0;0;0;0
FR;11;2021-06-03;0;0;0;0;0;0;0;0;0;0;0;0;0;0;0;0;0;0
FR;11;2021-06-04;0;0;0;0;0;0;0;0;0;0;0;0;0;0;0;0;0;0
FR;11;2021-06-05;0;0;0;0;0;0;0;0;0;0;0;0;0;0;0;0;0;0
FR;11;2021-06-06;0;0;0;0;0;0;0;0;0;0;0;0;0;0;0;0;0;0
FR;11;2021-06-07;0;0;0;0;0;0;0;0;0;0;0;0;0;0;0;0;0;0
FR;11;2021-06-08;0;0;0;0;0;0;0;0;0;0;0;0;0;0;0;0;0;0
FR;11;2021-06-09;0;0;0;0;0;0;0;0;0;0;0;0;0;0;0;0;0;0
FR;11;2021-06-10;0;0;0;0;0;0;0;0;0;0;0;0;0;0;0;0;0;0
FR;11;2021-06-11;0;0;0;0;0;0;0;0;0;0;0;0;0;0;0;0;0;0
FR;11;2021-06-12;0;0;0;0;0;0;0;0;0;0;0;0;0;0;0;0;0;0
FR;11;2021-06-13;0;0;0;0;0;0;0;0;0;0;0;0;0;0;0;0;0;0
FR;11;2021-06-14;0;0;0;0;0;0;0;0;0;0;0;0;0;0;0;0;0;0
FR;11;2021-06-15;0;0;0;0;0;0;0;0;0;0;0;0;0;0;0;0;0;0
FR;11;2021-06-16;0;0;0;0;0;0;0;0;0;0;0;0;0;0;0;0;0;0
FR;11;2021-06-17;0;0;0;0;0;0;0;0;0;0;0;0;0;0;0;0;0;0
FR;11;2021-06-18;0;0;0;0;0;0;0;0;0;0;0;0;0;0;0;0;0;0
FR;11;2021-06-19;0;0;0;0;0;0;0;0;0;0;0;0;0;0;0;0;0;0
FR;11;2021-06-20;0;0;0;0;0;0;0;0;0;0;0;0;0;0;0;0;0;0
FR;11;2021-06-21;0;0;0;0;0;0;0;0;0;0;0;0;0;0;0;0;0;0
FR;11;2021-06-22;0;0;0;0;0;0;0;0;0;0;0;0;0;0;0;0;0;0
FR;11;2021-06-23;0;0;0;0;0;0;0;0;0;0;0;0;0;0;0;0;0;0
FR;11;2021-06-24;0;0;0;0;0;0;0;0;0;0;0;0;0;0;0;0;0;0
FR;11;2021-06-25;0;0;0;0;0;0;0;0;0;0;0;0;0;0;0;0;0;0
FR;11;2021-06-26;0;0;0;0;0;0;0;0;0;0;0;0;0;0;0;0;0;0
FR;11;2021-06-27;0;0;0;0;0;0;0;0;0;0;0;0;0;0;0;0;0;0
FR;11;2021-06-28;0;0;0;0;0;0;0;0;0;0;0;0;0;0;0;0;0;0
FR;11;2021-06-29;0;0;0;0;0;0;0;0;0;0;0;0;0;0;0;0;0;0
FR;11;2021-06-30;0;0;0;0;0;0;0;0;0;0;0;0;0;0;0;0;0;0
FR;11;2021-07-01;0;0;0;0;0;0;0;0;0;0;0;0;0;0;0;0;0;0
FR;11;2021-07-02;0;0;0;0;0;0;0;0;0;0;0;0;0;0;0;0;0;0
FR;11;2021-07-03;0;0;0;0;0;0;0;0;0;0;0;0;0;0;0;0;0;0
FR;11;2021-07-04;0;0;0;0;0;0;0;0;0;0;0;0;0;0;0;0;0;0
FR;11;2021-07-05;0;0;0;0;0;0;0;0;0;0;0;0;0;0;0;0;0;0
FR;11;2021-07-06;0;0;0;0;0;0;0;0;0;0;0;0;0;0;0;0;0;0
FR;11;2021-07-07;0;0;0;0;0;0;0;0;0;0;0;0;0;0;0;0;0;0
FR;11;2021-07-08;0;0;0;0;0;0;0;0;0;0;0;0;0;0;0;0;0;0
FR;11;2021-07-09;0;0;0;0;0;0;0;0;0;0;0;0;0;0;0;0;0;0
FR;11;2021-07-10;0;0;0;0;0;0;0;0;0;0;0;0;0;0;0;0;0;0
FR;11;2021-07-11;0;0;0;0;0;0;0;0;0;0;0;0;0;0;0;0;0;0
FR;11;2021-07-12;0;0;0;0;0;0;0;0;0;0;0;0;0;0;0;0;0;0
FR;11;2021-07-13;0;0;0;0;0;0;0;0;0;0;0;0;0;0;0;0;0;0
FR;11;2021-07-14;0;0;0;0;0;0;0;0;0;0;0;0;0;0;0;0;0;0
FR;11;2021-07-15;0;0;0;0;0;0;0;0;0;0;0;0;0;0;0;0;0;0
FR;11;2021-07-16;0;0;0;0;0;0;0;0;0;0;0;0;0;0;0;0;0;0
FR;11;2021-07-17;0;0;0;0;0;0;0;0;0;0;0;0;0;0;0;0;0;0
FR;11;2021-07-18;0;0;0;0;0;0;0;0;0;0;0;0;0;0;0;0;0;0
FR;11;2021-07-19;0;0;0;0;0;0;0;0;0;0;0;0;0;0;0;0;0;0
FR;11;2021-07-20;0;0;0;0;0;0;0;0;0;0;0;0;0;0;0;0;0;0
FR;11;2021-07-21;0;0;0;0;0;0;0;0;0;0;0;0;0;0;0;0;0;0
FR;11;2021-07-22;0;0;0;0;0;0;0;0;0;0;0;0;0;0;0;0;0;0
FR;11;2021-07-23;0;0;0;0;0;0;0;0;0;0;0;0;0;0;0;0;0;0
FR;11;2021-07-24;0;0;0;0;0;0;0;0;0;0;0;0;0;0;0;0;0;0
FR;11;2021-07-25;0;0;0;0;0;0;0;0;0;0;0;0;0;0;0;0;0;0
FR;11;2021-07-26;0;0;0;0;0;0;0;0;0;0;0;0;0;0;0;0;0;0
FR;11;2021-07-27;0;0;0;0;0;0;0;0;0;0;0;0;0;0;0;0;0;0
FR;11;2021-07-28;0;0;0;0;0;0;0;0;0;0;0;0;0;0;0;0;0;0
FR;11;2021-07-29;0;0;0;0;0;0;0;0;0;0;0;0;0;0;0;0;0;0
FR;11;2021-07-30;0;0;0;0;0;0;0;0;0;0;0;0;0;0;0;0;0;0
FR;11;2021-07-31;0;0;0;0;0;0;0;0;0;0;0;0;0;0;0;0;0;0
FR;11;2021-08-01;0;0;0;0;0;0;0;0;0;0;0;0;0;0;0;0;0;0
FR;11;2021-08-02;0;0;0;0;0;0;0;0;0;0;0;0;0;0;0;0;0;0
FR;11;2021-08-03;0;0;0;0;0;0;0;0;0;0;0;0;0;0;0;0;0;0
FR;11;2021-08-04;0;0;0;0;0;0;0;0;0;0;0;0;0;0;0;0;0;0
FR;11;2021-08-05;0;0;0;0;0;0;0;0;0;0;0;0;0;0;0;0;0;0
FR;11;2021-08-06;0;0;0;0;0;0;0;0;0;0;0;0;0;0;0;0;0;0
FR;11;2021-08-07;0;0;0;0;0;0;0;0;0;0;0;0;0;0;0;0;0;0
FR;11;2021-08-08;0;0;0;0;0;0;0;0;0;0;0;0;0;0;0;0;0;0
FR;11;2021-08-09;0;0;0;0;0;0;0;0;0;0;0;0;0;0;0;0;0;0
FR;11;2021-08-10;0;0;0;0;0;0;0;0;0;0;0;0;0;0;0;0;0;0
FR;11;2021-08-11;0;0;0;0;0;0;0;0;0;0;0;0;0;0;0;0;0;0
FR;11;2021-08-12;0;0;0;0;0;0;0;0;0;0;0;0;0;0;0;0;0;0
FR;11;2021-08-13;0;0;0;0;0;0;0;0;0;0;0;0;0;0;0;0;0;0
FR;11;2021-08-14;0;0;0;0;0;0;0;0;0;0;0;0;0;0;0;0;0;0
FR;11;2021-08-15;0;0;0;0;0;0;0;0;0;0;0;0;0;0;0;0;0;0
FR;11;2021-08-16;0;0;0;0;0;0;0;0;0;0;0;0;0;0;0;0;0;0
FR;11;2021-08-17;0;0;0;0;0;0;0;0;0;0;0;0;0;0;0;0;0;0
FR;11;2021-08-18;0;0;0;0;0;0;0;0;0;0;0;0;0;0;0;0;0;0
FR;11;2021-08-19;0;0;0;0;0;0;0;0;0;0;0;0;0;0;0;0;0;0
FR;11;2021-08-20;0;0;0;0;0;0;0;0;0;0;0;0;0;0;0;0;0;0
FR;11;2021-08-21;0;0;0;0;0;0;0;0;0;0;0;0;0;0;0;0;0;0
FR;11;2021-08-22;0;0;0;0;0;0;0;0;0;0;0;0;0;0;0;0;0;0
FR;11;2021-08-23;0;0;0;0;0;0;0;0;0;0;0;0;0;0;0;0;0;0
FR;11;2021-08-24;0;0;0;0;0;0;0;0;0;0;0;0;0;0;0;0;0;0
FR;11;2021-08-25;0;0;0;0;0;0;0;0;0;0;0;0;0;0;0;0;0;0
FR;11;2021-08-26;0;0;0;0;0;0;0;0;0;0;0;0;0;0;0;0;0;0
FR;11;2021-08-27;0;0;0;0;0;0;0;0;0;0;0;0;0;0;0;0;0;0
FR;11;2021-08-28;0;0;0;0;0;0;0;0;0;0;0;0;0;0;0;0;0;0
FR;11;2021-08-29;0;0;0;0;0;0;0;0;0;0;0;0;0;0;0;0;0;0
FR;11;2021-08-30;0;0;0;0;0;0;0;0;0;0;0;0;0;0;0;0;0;0
FR;11;2021-08-31;0;0;0;0;0;0;0;0;0;0;0;0;0;0;0;0;0;0
FR;11;2021-09-01;0;0;0;0;0;0;0;0;0;0;0;0;0;0;0;0;0;0
FR;11;2021-09-02;0;0;0;0;0;0;0;0;0;0;0;0;0;0;0;0;0;0
FR;11;2021-09-03;0;0;0;0;0;0;0;0;0;0;0;0;0;0;0;0;0;0
FR;11;2021-09-04;0;0;0;0;0;0;0;0;0;0;0;0;0;0;0;0;0;0
FR;11;2021-09-05;0;0;0;0;0;0;0;0;0;0;0;0;0;0;0;0;0;0
FR;11;2021-09-06;0;0;0;0;0;0;0;0;0;0;0;0;0;0;0;0;0;0
FR;11;2021-09-07;0;0;0;0;0;0;0;0;0;0;0;0;0;0;0;0;0;0
FR;11;2021-09-08;0;0;0;0;0;0;0;0;0;0;0;0;0;0;0;0;0;0
FR;11;2021-09-09;0;0;0;0;0;0;0;0;0;0;0;0;0;0;0;0;0;0
FR;11;2021-09-10;0;0;0;0;0;0;0;0;0;0;0;0;0;0;0;0;0;0
FR;11;2021-09-11;0;0;0;0;0;0;0;0;0;0;0;0;0;0;0;0;0;0
FR;11;2021-09-12;0;0;0;0;0;0;0;0;0;0;0;0;0;0;0;0;0;0
FR;11;2021-09-13;0;0;0;0;0;0;0;0;0;0;0;0;0;0;0;0;0;0
FR;11;2021-09-14;0;0;0;0;0;0;0;0;0;0;0;0;0;0;0;0;0;0
FR;11;2021-09-15;0;0;0;0;0;0;0;0;0;0;0;0;0;0;0;0;0;0
FR;11;2021-09-16;0;0;0;0;0;0;0;0;0;0;0;0;0;0;0;0;0;0
FR;11;2021-09-17;0;0;0;0;0;0;0;0;0;0;0;0;0;0;0;0;0;0
FR;11;2021-09-18;0;0;0;0;0;0;0;0;0;0;0;0;0;0;0;0;0;0
FR;11;2021-09-19;0;0;0;0;0;0;0;0;0;0;0;0;0;0;0;0;0;0
FR;11;2021-09-20;0;0;0;0;0;0;0;0;0;0;0;0;0;0;0;0;0;0
FR;11;2021-09-21;0;0;0;0;0;0;0;0;0;0;0;0;0;0;0;0;0;0
FR;11;2021-09-22;0;0;0;0;0;0;0;0;0;0;0;0;0;0;0;0;0;0
FR;11;2021-09-23;0;0;0;0;0;0;0;0;0;0;0;0;0;0;0;0;0;0
FR;11;2021-09-24;0;0;0;0;0;0;0;0;0;0;0;0;0;0;0;0;0;0
FR;11;2021-09-25;0;0;0;0;0;0;0;0;0;0;0;0;0;0;0;0;0;0
FR;11;2021-09-26;0;0;0;0;0;0;0;0;0;0;0;0;0;0;0;0;0;0
FR;11;2021-09-27;0;0;0;0;0;0;0;0;0;0;0;0;0;0;0;0;0;0
FR;11;2021-09-28;0;0;0;0;0;0;0;0;0;0;0;0;0;0;0;0;0;0
FR;11;2021-09-29;0;0;0;0;0;0;0;0;0;0;0;0;0;0;0;0;0;0
FR;11;2021-09-30;0;0;0;0;0;0;0;0;0;0;0;0;0;0;0;0;0;0
FR;11;2021-10-01;0;0;0;0;0;0;0;0;0;0;0;0;0;0;0;0;0;0
FR;11;2021-10-02;0;0;0;0;0;0;0;0;0;0;0;0;0;0;0;0;0;0
FR;11;2021-10-03;0;0;0;0;0;0;0;0;0;0;0;0;0;0;0;0;0;0
FR;11;2021-10-04;0;0;0;0;0;0;0;0;0;0;0;0;0;0;0;0;0;0
FR;11;2021-10-05;0;0;0;0;0;0;0;0;0;0;0;0;0;0;0;0;0;0
FR;11;2021-10-06;0;0;0;0;0;0;0;0;0;0;0;0;0;0;0;0;0;0
FR;11;2021-10-07;0;0;0;0;0;0;0;0;0;0;0;0;0;0;0;0;0;0
FR;11;2021-10-08;0;0;0;0;0;0;0;0;0;0;0;0;0;0;0;0;0;0
FR;11;2021-10-09;0;0;0;0;0;0;0;0;0;0;0;0;0;0;0;0;0;0
FR;11;2021-10-10;0;0;0;0;0;0;0;0;0;0;0;0;0;0;0;0;0;0
FR;11;2021-10-11;0;0;0;0;0;0;0;0;0;0;0;0;0;0;0;0;0;0
FR;11;2021-10-12;0;0;0;0;0;0;0;0;0;0;0;0;0;0;0;0;0;0
FR;11;2021-10-13;0;0;0;0;0;0;0;0;0;0;0;0;0;0;0;0;0;0
FR;11;2021-10-14;0;0;0;0;0;0;0;0;0;0;0;0;0;0;0;0;0;0
FR;11;2021-10-15;0;0;0;0;0;0;0;0;0;0;0;0;0;0;0;0;0;0
FR;11;2021-10-16;0;0;0;0;0;0;0;0;0;0;0;0;0;0;0;0;0;0
FR;11;2021-10-17;0;0;0;0;0;0;0;0;0;0;0;0;0;0;0;0;0;0
FR;11;2021-10-18;0;0;0;0;0;0;0;0;0;0;0;0;0;0;0;0;0;0
FR;11;2021-10-19;0;0;0;0;0;0;0;0;0;0;0;0;0;0;0;0;0;0
FR;11;2021-10-20;0;0;0;0;0;0;0;0;0;0;0;0;0;0;0;0;0;0
FR;11;2021-10-21;0;0;0;0;0;0;0;0;0;0;0;0;0;0;0;0;0;0
FR;11;2021-10-22;0;0;0;0;0;0;0;0;0;0;0;0;0;0;0;0;0;0
FR;11;2021-10-23;0;0;0;0;0;0;0;0;0;0;0;0;0;0;0;0;0;0
FR;11;2021-10-24;0;0;0;0;0;0;0;0;0;0;0;0;0;0;0;0;0;0
FR;11;2021-10-25;0;0;0;0;0;0;0;0;0;0;0;0;0;0;0;0;0;0
FR;11;2021-10-26;0;0;0;0;0;0;0;0;0;0;0;0;0;0;0;0;0;0
FR;11;2021-10-27;0;0;0;0;0;0;0;0;0;0;0;0;0;0;0;0;0;0
FR;11;2021-10-28;0;0;0;0;0;0;0;0;0;0;0;0;0;0;0;0;0;0
FR;11;2021-10-29;0;0;0;0;0;0;0;0;0;0;0;0;0;0;0;0;0;0
FR;11;2021-10-30;0;0;0;0;0;0;0;0;0;0;0;0;0;0;0;0;0;0
FR;11;2021-10-31;0;0;0;0;0;0;0;0;0;0;0;0;0;0;0;0;0;0
FR;11;2021-11-01;0;0;0;0;0;0;0;0;0;0;0;0;0;0;0;0;0;0
FR;11;2021-11-02;0;0;0;0;0;0;0;0;0;0;0;0;0;0;0;0;0;0
FR;11;2021-11-03;0;0;0;0;0;0;0;0;0;0;0;0;0;0;0;0;0;0
FR;11;2021-11-04;0;0;0;0;0;0;0;0;0;0;0;0;0;0;0;0;0;0
FR;11;2021-11-05;0;0;0;0;0;0;0;0;0;0;0;0;0;0;0;0;0;0
FR;11;2021-11-06;0;0;0;0;0;0;0;0;0;0;0;0;0;0;0;0;0;0
FR;11;2021-11-07;0;0;0;0;0;0;0;0;0;0;0;0;0;0;0;0;0;0
FR;11;2021-11-08;0;0;0;0;0;0;0;0;0;0;0;0;0;0;0;0;0;0
FR;11;2021-11-09;0;0;0;0;0;0;0;0;0;0;0;0;0;0;0;0;0;0
FR;11;2021-11-10;0;0;0;0;0;0;0;0;0;0;0;0;0;0;0;0;0;0
FR;11;2021-11-11;0;0;0;0;0;0;0;0;0;0;0;0;0;0;0;0;0;0
FR;11;2021-11-12;0;0;0;0;0;0;0;0;0;0;0;0;0;0;0;0;0;0
FR;11;2021-11-13;0;0;0;0;0;0;0;0;0;0;0;0;0;0;0;0;0;0
FR;11;2021-11-14;0;0;0;0;0;0;0;0;0;0;0;0;0;0;0;0;0;0
FR;11;2021-11-15;0;0;0;0;0;0;0;0;0;0;0;0;0;0;0;0;0;0
FR;11;2021-11-16;0;0;0;0;0;0;0;0;0;0;0;0;0;0;0;0;0;0
FR;11;2021-11-17;0;0;0;0;0;0;0;0;0;0;0;0;0;0;0;0;0;0
FR;11;2021-11-18;0;0;0;0;0;0;0;0;0;0;0;0;0;0;0;0;0;0
FR;11;2021-11-19;0;0;0;0;0;0;0;0;0;0;0;0;0;0;0;0;0;0
FR;11;2021-11-20;0;0;0;0;0;0;0;0;0;0;0;0;0;0;0;0;0;0
FR;11;2021-11-21;0;0;0;0;0;0;0;0;0;0;0;0;0;0;0;0;0;0
FR;11;2021-11-22;0;0;0;0;0;0;0;0;0;0;0;0;0;0;0;0;0;0
FR;11;2021-11-23;0;0;0;0;0;0;0;0;0;0;0;0;0;0;0;0;0;0
FR;11;2021-11-24;0;0;0;0;0;0;0;0;0;0;0;0;0;0;0;0;0;0
FR;11;2021-11-25;0;0;0;0;0;0;0;0;0;0;0;0;0;0;0;0;0;0
FR;11;2021-11-26;0;0;0;0;0;0;0;0;0;0;0;0;0;0;0;0;0;0
FR;11;2021-11-27;0;0;0;0;0;0;0;0;0;0;0;0;0;0;0;0;0;0
FR;11;2021-11-28;0;0;0;0;0;0;0;0;0;0;0;0;0;0;0;0;0;0
FR;11;2021-11-29;0;0;0;0;0;0;0;0;0;0;0;0;0;0;0;0;0;0
FR;11;2021-11-30;0;0;0;0;0;0;0;0;0;0;0;0;0;0;0;0;0;0
FR;11;2021-12-01;0;0;0;0;0;0;0;0;0;0;0;0;0;0;0;0;0;0
FR;11;2021-12-02;0;0;0;0;0;0;0;0;0;0;0;0;0;0;0;0;0;0
FR;11;2021-12-03;0;0;0;0;0;0;0;0;0;0;0;0;0;0;0;0;0;0
FR;11;2021-12-04;0;0;0;0;0;0;0;0;0;0;0;0;0;0;0;0;0;0
FR;11;2021-12-05;0;0;0;0;0;0;0;0;0;0;0;0;0;0;0;0;0;0
FR;11;2021-12-06;0;0;0;0;0;0;0;0;0;0;0;0;0;0;0;0;0;0
FR;11;2021-12-07;0;0;0;0;0;0;0;0;0;0;0;0;0;0;0;0;0;0
FR;11;2021-12-08;0;0;0;0;0;0;0;0;0;0;0;0;0;0;0;0;0;0
FR;11;2021-12-09;0;0;0;0;0;0;0;0;0;0;0;0;0;0;0;0;0;0
FR;11;2021-12-10;0;0;0;0;0;0;0;0;0;0;0;0;0;0;0;0;0;0
FR;11;2021-12-11;0;0;0;0;0;0;0;0;0;0;0;0;0;0;0;0;0;0
FR;11;2021-12-12;0;0;0;0;0;0;0;0;0;0;0;0;0;0;0;0;0;0
FR;11;2021-12-13;0;0;0;0;0;0;0;0;0;0;0;0;0;0;0;0;0;0
FR;11;2021-12-14;0;0;0;0;0;0;0;0;0;0;0;0;0;0;0;0;0;0
FR;11;2021-12-15;0;0;0;0;0;0;0;0;0;0;0;0;0;0;0;0;0;0
FR;11;2021-12-16;0;0;0;0;0;0;0;0;0;0;0;0;0;0;0;0;0;0
FR;11;2021-12-17;0;0;0;0;0;0;0;0;0;0;0;0;0;0;0;0;0;0
FR;11;2021-12-18;0;0;0;0;0;0;0;0;0;0;0;0;0;0;0;0;0;0
FR;11;2021-12-19;0;0;0;0;0;0;0;0;0;0;0;0;0;0;0;0;0;0
FR;11;2021-12-20;0;0;0;0;0;0;0;0;0;0;0;0;0;0;0;0;0;0
FR;11;2021-12-21;0;0;0;0;0;0;0;0;0;0;0;0;0;0;0;0;0;0
FR;11;2021-12-22;0;0;0;0;0;0;0;0;0;0;0;0;0;0;0;0;0;0
FR;11;2021-12-23;0;0;0;0;0;0;0;0;0;0;0;0;0;0;0;0;0;0
FR;11;2021-12-24;0;0;0;0;0;0;0;0;0;0;0;0;0;0;0;0;0;0
FR;11;2021-12-25;0;0;0;0;0;0;0;0;0;0;0;0;0;0;0;0;0;0
FR;11;2021-12-26;0;0;0;0;0;0;0;0;0;0;0;0;0;0;0;0;0;0
FR;11;2021-12-27;0;0;0;0;0;0;0;0;0;0;0;0;0;0;0;0;0;0
FR;11;2021-12-28;0;0;0;0;0;0;0;0;0;0;0;0;0;0;0;0;0;0
FR;11;2021-12-29;0;0;0;0;0;0;0;0;0;0;0;0;0;0;0;0;0;0
FR;11;2021-12-30;0;0;0;0;0;0;0;0;0;0;0;0;0;0;0;0;0;0
FR;11;2021-12-31;0;0;0;0;0;0;0;0;0;0;0;0;0;0;0;0;0;0
FR;11;2022-01-01;0;0;0;0;0;0;0;0;0;0;0;0;0;0;0;0;0;0
FR;11;2022-01-02;0;0;0;0;0;0;0;0;0;0;0;0;0;0;0;0;0;0
FR;11;2022-01-03;0;0;0;0;0;0;0;0;0;0;0;0;0;0;0;0;0;0
FR;11;2022-01-04;0;0;0;0;0;0;0;0;0;0;0;0;0;0;0;0;0;0
FR;11;2022-01-05;0;0;0;0;0;0;0;0;0;0;0;0;0;0;0;0;0;0
FR;11;2022-01-06;0;0;0;0;0;0;0;0;0;0;0;0;0;0;0;0;0;0
FR;11;2022-01-07;0;0;0;0;0;0;0;0;0;0;0;0;0;0;0;0;0;0
FR;11;2022-01-08;0;0;0;0;0;0;0;0;0;0;0;0;0;0;0;0;0;0
FR;11;2022-01-09;0;0;0;0;0;0;0;0;0;0;0;0;0;0;0;0;0;0
FR;11;2022-01-10;0;0;0;0;0;0;0;0;0;0;0;0;0;0;0;0;0;0
FR;11;2022-01-11;0;0;0;0;0;0;0;0;0;0;0;0;0;0;0;0;0;0
FR;11;2022-01-12;0;0;0;0;0;0;0;0;0;0;0;0;0;0;0;0;0;0
FR;11;2022-01-13;0;0;0;0;0;0;0;0;0;0;0;0;0;0;0;0;0;0
FR;11;2022-01-14;0;0;0;0;0;0;0;0;0;0;0;0;0;0;0;0;0;0
FR;11;2022-01-15;0;0;0;0;0;0;0;0;0;0;0;0;0;0;0;0;0;0
FR;11;2022-01-16;0;0;0;0;0;0;0;0;0;0;0;0;0;0;0;0;0;0
FR;11;2022-01-17;0;0;0;0;0;0;0;0;0;0;0;0;0;0;0;0;0;0
FR;11;2022-01-18;0;0;0;0;0;0;0;0;0;0;0;0;0;0;0;0;0;0
FR;11;2022-01-19;0;0;0;0;0;0;0;0;0;0;0;0;0;0;0;0;0;0
FR;11;2022-01-20;0;0;0;0;0;0;0;0;0;0;0;0;0;0;0;0;0;0
FR;11;2022-01-21;0;0;0;0;0;0;0;0;0;0;0;0;0;0;0;0;0;0
FR;11;2022-01-22;0;0;0;0;0;0;0;0;0;0;0;0;0;0;0;0;0;0
FR;11;2022-01-23;0;0;0;0;0;0;0;0;0;0;0;0;0;0;0;0;0;0
FR;11;2022-01-24;0;0;0;0;0;0;0;0;0;0;0;0;0;0;0;0;0;0
FR;11;2022-01-25;0;0;0;0;0;0;0;0;0;0;0;0;0;0;0;0;0;0
FR;11;2022-01-26;0;0;0;0;0;0;0;0;0;0;0;0;0;0;0;0;0;0
FR;11;2022-01-27;0;0;0;0;0;0;0;0;0;0;0;0;0;0;0;0;0;0
FR;11;2022-01-28;0;0;0;0;0;0;0;0;0;0;0;0;0;0;0;0;0;0
FR;11;2022-01-29;0;0;0;0;0;0;0;0;0;0;0;0;0;0;0;0;0;0
FR;11;2022-01-30;0;0;0;0;0;0;0;0;0;0;0;0;0;0;0;0;0;0
FR;11;2022-01-31;0;0;0;0;0;0;0;0;0;0;0;0;0;0;0;0;0;0
FR;11;2022-02-01;0;0;0;0;0;0;0;0;0;0;0;0;0;0;0;0;0;0
FR;11;2022-02-02;0;0;0;0;0;0;0;0;0;0;0;0;0;0;0;0;0;0
FR;11;2022-02-03;0;0;0;0;0;0;0;0;0;0;0;0;0;0;0;0;0;0
FR;11;2022-02-04;0;0;0;0;0;0;0;0;0;0;0;0;0;0;0;0;0;0
FR;11;2022-02-05;0;0;0;0;0;0;0;0;0;0;0;0;0;0;0;0;0;0
FR;11;2022-02-06;0;0;0;0;0;0;0;0;0;0;0;0;0;0;0;0;0;0
FR;11;2022-02-07;0;0;0;0;0;0;0;0;0;0;0;0;0;0;0;0;0;0
FR;11;2022-02-08;0;0;0;0;0;0;0;0;0;0;0;0;0;0;0;0;0;0
FR;11;2022-02-09;0;0;0;0;0;0;0;0;0;0;0;0;0;0;0;0;0;0
FR;11;2022-02-10;0;0;0;0;0;0;0;0;0;0;0;0;0;0;0;0;0;0
FR;11;2022-02-11;0;0;0;0;0;0;0;0;0;0;0;0;0;0;0;0;0;0
FR;11;2022-02-12;0;0;0;0;0;0;0;0;0;0;0;0;0;0;0;0;0;0
FR;11;2022-02-13;0;0;0;0;0;0;0;0;0;0;0;0;0;0;0;0;0;0
FR;11;2022-02-14;0;0;0;0;0;0;0;0;0;0;0;0;0;0;0;0;0;0
FR;11;2022-02-15;0;0;0;0;0;0;0;0;0;0;0;0;0;0;0;0;0;0
FR;11;2022-02-16;0;0;0;0;0;0;0;0;0;0;0;0;0;0;0;0;0;0
FR;11;2022-02-17;0;0;0;0;0;0;0;0;0;0;0;0;0;0;0;0;0;0
FR;11;2022-02-18;0;0;0;0;0;0;0;0;0;0;0;0;0;0;0;0;0;0
FR;11;2022-02-19;0;0;0;0;0;0;0;0;0;0;0;0;0;0;0;0;0;0
FR;11;2022-02-20;0;0;0;0;0;0;0;0;0;0;0;0;0;0;0;0;0;0
FR;11;2022-02-21;0;0;0;0;0;0;0;0;0;0;0;0;0;0;0;0;0;0
FR;11;2022-02-22;0;0;0;0;0;0;0;0;0;0;0;0;0;0;0;0;0;0
FR;11;2022-02-23;0;0;0;0;0;0;0;0;0;0;0;0;0;0;0;0;0;0
FR;11;2022-02-24;0;0;0;0;0;0;0;0;0;0;0;0;0;0;0;0;0;0
FR;11;2022-02-25;0;0;0;0;0;0;0;0;0;0;0;0;0;0;0;0;0;0
FR;11;2022-02-26;0;0;0;0;0;0;0;0;0;0;0;0;0;0;0;0;0;0
FR;11;2022-02-27;0;0;0;0;0;0;0;0;0;0;0;0;0;0;0;0;0;0
FR;11;2022-02-28;0;0;0;0;0;0;0;0;0;0;0;0;0;0;0;0;0;0
FR;11;2022-03-01;0;0;0;0;0;0;0;0;0;0;0;0;0;0;0;0;0;0
FR;11;2022-03-02;0;0;0;0;0;0;0;0;0;0;0;0;0;0;0;0;0;0
FR;11;2022-03-03;0;0;0;0;0;0;0;0;0;0;0;0;0;0;0;0;0;0
FR;11;2022-03-04;0;0;0;0;0;0;0;0;0;0;0;0;0;0;0;0;0;0
FR;11;2022-03-05;0;0;0;0;0;0;0;0;0;0;0;0;0;0;0;0;0;0
FR;11;2022-03-06;0;0;0;0;0;0;0;0;0;0;0;0;0;0;0;0;0;0
FR;11;2022-03-07;0;0;0;0;0;0;0;0;0;0;0;0;0;0;0;0;0;0
FR;11;2022-03-08;0;0;0;0;0;0;0;0;0;0;0;0;0;0;0;0;0;0
FR;11;2022-03-09;0;0;0;0;0;0;0;0;0;0;0;0;0;0;0;0;0;0
FR;11;2022-03-10;0;0;0;0;0;0;0;0;0;0;0;0;0;0;0;0;0;0
FR;11;2022-03-11;0;0;0;0;0;0;0;0;0;0;0;0;0;0;0;0;0;0
FR;11;2022-03-12;0;0;0;0;0;0;0;0;0;0;0;0;0;0;0;0;0;0
FR;11;2022-03-13;0;0;0;0;0;0;0;0;0;0;0;0;0;0;0;0;0;0
FR;11;2022-03-14;0;0;0;0;0;0;0;0;0;0;0;0;0;0;0;0;0;0
FR;11;2022-03-15;0;0;0;0;0;0;0;0;0;0;0;0;0;0;0;0;0;0
FR;11;2022-03-16;0;0;0;0;0;0;0;0;0;0;0;0;0;0;0;0;0;0
FR;11;2022-03-17;0;0;0;0;0;0;0;0;0;0;0;0;0;0;0;0;0;0
FR;11;2022-03-18;0;0;0;0;0;0;0;0;0;0;0;0;0;0;0;0;0;0
FR;11;2022-03-19;0;0;0;0;0;0;0;0;0;0;0;0;0;0;0;0;0;0
FR;11;2022-03-20;0;0;0;0;0;0;0;0;0;0;0;0;0;0;0;0;0;0
FR;11;2022-03-21;0;0;0;0;0;0;0;0;0;0;0;0;0;0;0;0;0;0
FR;11;2022-03-22;0;0;0;0;0;0;0;0;0;0;0;0;0;0;0;0;0;0
FR;11;2022-03-23;0;0;0;0;0;0;0;0;0;0;0;0;0;0;0;0;0;0
FR;11;2022-03-24;0;0;0;0;0;0;0;0;0;0;0;0;0;0;0;0;0;0
FR;11;2022-03-25;0;0;0;0;0;0;0;0;0;0;0;0;0;0;0;0;0;0
FR;11;2022-03-26;0;0;0;0;0;0;0;0;0;0;0;0;0;0;0;0;0;0
FR;11;2022-03-27;0;0;0;0;0;0;0;0;0;0;0;0;0;0;0;0;0;0
FR;11;2022-03-28;0;0;0;0;0;0;0;0;0;0;0;0;0;0;0;0;0;0
FR;11;2022-03-29;0;0;0;0;0;0;0;0;0;0;0;0;0;0;0;0;0;0
FR;11;2022-03-30;0;0;0;0;0;0;0;0;0;0;0;0;0;0;0;0;0;0
FR;11;2022-03-31;0;0;0;0;0;0;0;0;0;0;0;0;0;0;0;0;0;0
FR;11;2022-04-01;0;0;0;0;0;0;0;0;0;0;0;0;0;0;0;0;0;0
FR;11;2022-04-02;0;0;0;0;0;0;0;0;0;0;0;0;0;0;0;0;0;0
FR;11;2022-04-03;0;0;0;0;0;0;0;0;0;0;0;0;0;0;0;0;0;0
FR;11;2022-04-04;0;0;0;0;0;0;0;0;0;0;0;0;0;0;0;0;0;0
FR;11;2022-04-05;0;0;0;0;0;0;0;0;0;0;0;0;0;0;0;0;0;0
FR;11;2022-04-06;0;0;0;0;0;0;0;0;0;0;0;0;0;0;0;0;0;0
FR;11;2022-04-07;0;0;0;0;0;0;0;0;0;0;0;0;0;0;0;0;0;0
FR;11;2022-04-08;0;0;0;0;0;0;0;0;0;0;0;0;0;0;0;0;0;0
FR;11;2022-04-09;0;0;0;0;0;0;0;0;0;0;0;0;0;0;0;0;0;0
FR;11;2022-04-10;0;0;0;0;0;0;0;0;0;0;0;0;0;0;0;0;0;0
FR;11;2022-04-11;0;0;0;0;0;0;0;0;0;0;0;0;0;0;0;0;0;0
FR;11;2022-04-12;0;0;0;0;0;0;0;0;0;0;0;0;0;0;0;0;0;0
FR;11;2022-04-13;0;0;0;0;0;0;0;0;0;0;0;0;0;0;0;0;0;0
FR;11;2022-04-14;0;0;0;0;0;0;0;0;0;0;0;0;0;0;0;0;0;0
FR;11;2022-04-15;0;0;0;0;0;0;0;0;0;0;0;0;0;0;0;0;0;0
FR;11;2022-04-16;0;0;0;0;0;0;0;0;0;0;0;0;0;0;0;0;0;0
FR;11;2022-04-17;0;0;0;0;0;0;0;0;0;0;0;0;0;0;0;0;0;0
FR;11;2022-04-18;0;0;0;0;0;0;0;0;0;0;0;0;0;0;0;0;0;0
FR;11;2022-04-19;0;0;0;0;0;0;0;0;0;0;0;0;0;0;0;0;0;0
FR;11;2022-04-20;0;0;0;0;0;0;0;0;0;0;0;0;0;0;0;0;0;0
FR;11;2022-04-21;0;0;0;0;0;0;0;0;0;0;0;0;0;0;0;0;0;0
FR;11;2022-04-22;0;0;0;0;0;0;0;0;0;0;0;0;0;0;0;0;0;0
FR;11;2022-04-23;0;0;0;0;0;0;0;0;0;0;0;0;0;0;0;0;0;0
FR;11;2022-04-24;0;0;0;0;0;0;0;0;0;0;0;0;0;0;0;0;0;0
FR;11;2022-04-25;0;0;0;0;0;0;0;0;0;0;0;0;0;0;0;0;0;0
FR;11;2022-04-26;0;0;0;0;0;0;0;0;0;0;0;0;0;0;0;0;0;0
FR;11;2022-04-27;0;0;0;0;0;0;0;0;0;0;0;0;0;0;0;0;0;0
FR;11;2022-04-28;0;0;0;0;0;0;0;0;0;0;0;0;0;0;0;0;0;0
FR;11;2022-04-29;0;0;0;0;0;0;0;0;0;0;0;0;0;0;0;0;0;0
FR;11;2022-04-30;0;0;0;0;0;0;0;0;0;0;0;0;0;0;0;0;0;0
FR;11;2022-05-01;0;0;0;0;0;0;0;0;0;0;0;0;0;0;0;0;0;0
FR;11;2022-05-02;0;0;0;0;0;0;0;0;0;0;0;0;0;0;0;0;0;0
FR;11;2022-05-03;0;0;0;0;0;0;0;0;0;0;0;0;0;0;0;0;0;0
FR;11;2022-05-04;0;0;0;0;0;0;0;0;0;0;0;0;0;0;0;0;0;0
FR;11;2022-05-05;0;0;0;0;0;0;0;0;0;0;0;0;0;0;0;0;0;0
FR;11;2022-05-06;0;0;0;0;0;0;0;0;0;0;0;0;0;0;0;0;0;0
FR;11;2022-05-07;0;0;0;0;0;0;0;0;0;0;0;0;0;0;0;0;0;0
FR;11;2022-05-08;0;0;0;0;0;0;0;0;0;0;0;0;0;0;0;0;0;0
FR;11;2022-05-09;0;0;0;0;0;0;0;0;0;0;0;0;0;0;0;0;0;0
FR;11;2022-05-10;0;0;0;0;0;0;0;0;0;0;0;0;0;0;0;0;0;0
FR;11;2022-05-11;0;0;0;0;0;0;0;0;0;0;0;0;0;0;0;0;0;0
FR;11;2022-05-12;0;0;0;0;0;0;0;0;0;0;0;0;0;0;0;0;0;0
FR;11;2022-05-13;0;0;0;0;0;0;0;0;0;0;0;0;0;0;0;0;0;0
FR;11;2022-05-14;0;0;0;0;0;0;0;0;0;0;0;0;0;0;0;0;0;0
FR;11;2022-05-15;0;0;0;0;0;0;0;0;0;0;0;0;0;0;0;0;0;0
FR;11;2022-05-16;0;0;0;0;0;0;0;0;0;0;0;0;0;0;0;0;0;0
FR;11;2022-05-17;0;0;0;0;0;0;0;0;0;0;0;0;0;0;0;0;0;0
FR;11;2022-05-18;0;0;0;0;0;0;0;0;0;0;0;0;0;0;0;0;0;0
FR;11;2022-05-19;0;0;0;0;0;0;0;0;0;0;0;0;0;0;0;0;0;0
FR;11;2022-05-20;0;0;0;0;0;0;0;0;0;0;0;0;0;0;0;0;0;0
FR;11;2022-05-21;0;0;0;0;0;0;0;0;0;0;0;0;0;0;0;0;0;0
FR;11;2022-05-22;0;0;0;0;0;0;0;0;0;0;0;0;0;0;0;0;0;0
FR;11;2022-05-23;0;0;0;0;0;0;0;0;0;0;0;0;0;0;0;0;0;0
FR;11;2022-05-24;0;0;0;0;0;0;0;0;0;0;0;0;0;0;0;0;0;0
FR;11;2022-05-25;0;0;0;0;0;0;0;0;0;0;0;0;0;0;0;0;0;0
FR;11;2022-05-26;0;0;0;0;0;0;0;0;0;0;0;0;0;0;0;0;0;0
FR;11;2022-05-27;0;0;0;0;0;0;0;0;0;0;0;0;0;0;0;0;0;0
FR;11;2022-05-28;0;0;0;0;0;0;0;0;0;0;0;0;0;0;0;0;0;0
FR;11;2022-05-29;0;0;0;0;0;0;0;0;0;0;0;0;0;0;0;0;0;0
FR;11;2022-05-30;0;0;0;0;0;0;0;0;0;0;0;0;0;0;0;0;0;0
FR;11;2022-05-31;0;0;0;0;0;0;0;0;0;0;0;0;0;0;0;0;0;0
FR;11;2022-06-01;0;0;0;0;0;0;0;0;0;0;0;0;0;0;0;0;0;0
FR;11;2022-06-02;0;0;0;0;0;0;0;0;0;0;0;0;0;0;0;0;0;0
FR;11;2022-06-03;0;0;0;0;0;0;0;0;0;0;0;0;0;0;0;0;0;0
FR;11;2022-06-04;0;0;0;0;0;0;0;0;0;0;0;0;0;0;0;0;0;0
FR;11;2022-06-05;0;0;0;0;0;0;0;0;0;0;0;0;0;0;0;0;0;0
FR;11;2022-06-06;0;0;0;0;0;0;0;0;0;0;0;0;0;0;0;0;0;0
FR;11;2022-06-07;0;0;0;0;0;0;0;0;0;0;0;0;0;0;0;0;0;0
FR;11;2022-06-08;0;0;0;0;0;0;0;0;0;0;0;0;0;0;0;0;0;0
FR;11;2022-06-09;0;0;0;0;0;0;0;0;0;0;0;0;0;0;0;0;0;0
FR;11;2022-06-10;0;0;0;0;0;0;0;0;0;0;0;0;0;0;0;0;0;0
FR;11;2022-06-11;0;0;0;0;0;0;0;0;0;0;0;0;0;0;0;0;0;0
FR;11;2022-06-12;0;0;0;0;0;0;0;0;0;0;0;0;0;0;0;0;0;0
FR;11;2022-06-13;0;0;0;0;0;0;0;0;0;0;0;0;0;0;0;0;0;0
FR;11;2022-06-14;0;0;0;0;0;0;0;0;0;0;0;0;0;0;0;0;0;0
FR;11;2022-06-15;0;0;0;0;0;0;0;0;0;0;0;0;0;0;0;0;0;0
FR;11;2022-06-16;0;0;0;0;0;0;0;0;0;0;0;0;0;0;0;0;0;0
FR;11;2022-06-17;0;0;0;0;0;0;0;0;0;0;0;0;0;0;0;0;0;0
FR;11;2022-06-18;0;0;0;0;0;0;0;0;0;0;0;0;0;0;0;0;0;0
FR;11;2022-06-19;0;0;0;0;0;0;0;0;0;0;0;0;0;0;0;0;0;0
FR;11;2022-06-20;0;0;0;0;0;0;0;0;0;0;0;0;0;0;0;0;0;0
FR;11;2022-06-21;0;0;0;0;0;0;0;0;0;0;0;0;0;0;0;0;0;0
FR;11;2022-06-22;0;0;0;0;0;0;0;0;0;0;0;0;0;0;0;0;0;0
FR;11;2022-06-23;0;0;0;0;0;0;0;0;0;0;0;0;0;0;0;0;0;0
FR;11;2022-06-24;0;0;0;0;0;0;0;0;0;0;0;0;0;0;0;0;0;0
FR;11;2022-06-25;0;0;0;0;0;0;0;0;0;0;0;0;0;0;0;0;0;0
FR;11;2022-06-26;0;0;0;0;0;0;0;0;0;0;0;0;0;0;0;0;0;0
FR;11;2022-06-27;0;0;0;0;0;0;0;0;0;0;0;0;0;0;0;0;0;0
FR;11;2022-06-28;0;0;0;0;0;0;0;0;0;0;0;0;0;0;0;0;0;0
FR;11;2022-06-29;0;0;0;0;0;0;0;0;0;0;0;0;0;0;0;0;0;0
FR;11;2022-06-30;0;0;0;0;0;0;0;0;0;0;0;0;0;0;0;0;0;0
FR;11;2022-07-01;0;0;0;0;0;0;0;0;0;0;0;0;0;0;0;0;0;0
FR;11;2022-07-02;0;0;0;0;0;0;0;0;0;0;0;0;0;0;0;0;0;0
FR;11;2022-07-03;0;0;0;0;0;0;0;0;0;0;0;0;0;0;0;0;0;0
FR;11;2022-07-04;0;0;0;0;0;0;0;0;0;0;0;0;0;0;0;0;0;0
FR;11;2022-07-05;0;0;0;0;0;0;0;0;0;0;0;0;0;0;0;0;0;0
FR;11;2022-07-06;0;0;0;0;0;0;0;0;0;0;0;0;0;0;0;0;0;0
FR;11;2022-07-07;0;0;0;0;0;0;0;0;0;0;0;0;0;0;0;0;0;0
FR;11;2022-07-08;0;0;0;0;0;0;0;0;0;0;0;0;0;0;0;0;0;0
FR;11;2022-07-09;0;0;0;0;0;0;0;0;0;0;0;0;0;0;0;0;0;0
FR;11;2022-07-10;0;0;0;0;0;0;0;0;0;0;0;0;0;0;0;0;0;0
FR;11;2022-07-11;0;0;0;0;0;0;0;0;0;0;0;0;0;0;0;0;0;0
FR;11;2022-07-12;0;0;0;0;0;0;0;0;0;0;0;0;0;0;0;0;0;0
FR;11;2022-07-13;0;0;0;0;0;0;0;0;0;0;0;0;0;0;0;0;0;0
FR;11;2022-07-14;0;0;0;0;0;0;0;0;0;0;0;0;0;0;0;0;0;0
FR;11;2022-07-15;0;0;0;0;0;0;0;0;0;0;0;0;0;0;0;0;0;0
FR;11;2022-07-16;0;0;0;0;0;0;0;0;0;0;0;0;0;0;0;0;0;0
FR;11;2022-07-17;0;0;0;0;0;0;0;0;0;0;0;0;0;0;0;0;0;0
FR;11;2022-07-18;0;0;0;0;0;0;0;0;0;0;0;0;0;0;0;0;0;0
FR;11;2022-07-19;0;0;0;0;0;0;0;0;0;0;0;0;0;0;0;0;0;0
FR;11;2022-07-20;0;0;0;0;0;0;0;0;0;0;0;0;0;0;0;0;0;0
FR;11;2022-07-21;0;0;0;0;0;0;0;0;0;0;0;0;0;0;0;0;0;0
FR;11;2022-07-22;0;0;0;0;0;0;0;0;0;0;0;0;0;0;0;0;0;0
FR;11;2022-07-23;0;0;0;0;0;0;0;0;0;0;0;0;0;0;0;0;0;0
FR;11;2022-07-24;0;0;0;0;0;0;0;0;0;0;0;0;0;0;0;0;0;0
FR;11;2022-07-25;0;0;0;0;0;0;0;0;0;0;0;0;0;0;0;0;0;0
FR;11;2022-07-26;0;0;0;0;0;0;0;0;0;0;0;0;0;0;0;0;0;0
FR;11;2022-07-27;0;0;0;0;0;0;0;0;0;0;0;0;0;0;0;0;0;0
FR;11;2022-07-28;0;0;0;0;0;0;0;0;0;0;0;0;0;0;0;0;0;0
FR;11;2022-07-29;0;0;0;0;0;0;0;0;0;0;0;0;0;0;0;0;0;0
FR;11;2022-07-30;0;0;0;0;0;0;0;0;0;0;0;0;0;0;0;0;0;0
FR;11;2022-07-31;0;0;0;0;0;0;0;0;0;0;0;0;0;0;0;0;0;0
FR;11;2022-08-01;0;0;0;0;0;0;0;0;0;0;0;0;0;0;0;0;0;0
FR;11;2022-08-02;0;0;0;0;0;0;0;0;0;0;0;0;0;0;0;0;0;0
FR;11;2022-08-03;0;0;0;0;0;0;0;0;0;0;0;0;0;0;0;0;0;0
FR;11;2022-08-04;0;0;0;0;0;0;0;0;0;0;0;0;0;0;0;0;0;0
FR;11;2022-08-05;0;0;0;0;0;0;0;0;0;0;0;0;0;0;0;0;0;0
FR;11;2022-08-06;0;0;0;0;0;0;0;0;0;0;0;0;0;0;0;0;0;0
FR;11;2022-08-07;0;0;0;0;0;0;0;0;0;0;0;0;0;0;0;0;0;0
FR;11;2022-08-08;0;0;0;0;0;0;0;0;0;0;0;0;0;0;0;0;0;0
FR;11;2022-08-09;0;0;0;0;0;0;0;0;0;0;0;0;0;0;0;0;0;0
FR;11;2022-08-10;0;0;0;0;0;0;0;0;0;0;0;0;0;0;0;0;0;0
FR;11;2022-08-11;0;0;0;0;0;0;0;0;0;0;0;0;0;0;0;0;0;0
FR;11;2022-08-12;0;0;0;0;0;0;0;0;0;0;0;0;0;0;0;0;0;0
FR;11;2022-08-13;0;0;0;0;0;0;0;0;0;0;0;0;0;0;0;0;0;0
FR;11;2022-08-14;0;0;0;0;0;0;0;0;0;0;0;0;0;0;0;0;0;0
FR;11;2022-08-15;0;0;0;0;0;0;0;0;0;0;0;0;0;0;0;0;0;0
FR;11;2022-08-16;0;0;0;0;0;0;0;0;0;0;0;0;0;0;0;0;0;0
FR;11;2022-08-17;0;0;0;0;0;0;0;0;0;0;0;0;0;0;0;0;0;0
FR;11;2022-08-18;0;0;0;0;0;0;0;0;0;0;0;0;0;0;0;0;0;0
FR;11;2022-08-19;0;0;0;0;0;0;0;0;0;0;0;0;0;0;0;0;0;0
FR;11;2022-08-20;0;0;0;0;0;0;0;0;0;0;0;0;0;0;0;0;0;0
FR;11;2022-08-21;0;0;0;0;0;0;0;0;0;0;0;0;0;0;0;0;0;0
FR;11;2022-08-22;0;0;0;0;0;0;0;0;0;0;0;0;0;0;0;0;0;0
FR;11;2022-08-23;0;0;0;0;0;0;0;0;0;0;0;0;0;0;0;0;0;0
FR;11;2022-08-24;0;0;0;0;0;0;0;0;0;0;0;0;0;0;0;0;0;0
FR;11;2022-08-25;0;0;0;0;0;0;0;0;0;0;0;0;0;0;0;0;0;0
FR;11;2022-08-26;0;0;0;0;0;0;0;0;0;0;0;0;0;0;0;0;0;0
FR;11;2022-08-27;0;0;0;0;0;0;0;0;0;0;0;0;0;0;0;0;0;0
FR;11;2022-08-28;0;0;0;0;0;0;0;0;0;0;0;0;0;0;0;0;0;0
FR;11;2022-08-29;0;0;0;0;0;0;0;0;0;0;0;0;0;0;0;0;0;0
FR;11;2022-08-30;0;0;0;0;0;0;0;0;0;0;0;0;0;0;0;0;0;0
FR;11;2022-08-31;0;0;0;0;0;0;0;0;0;0;0;0;0;0;0;0;0;0
FR;11;2022-09-01;0;0;0;0;0;0;0;0;0;0;0;0;0;0;0;0;0;0
FR;11;2022-09-02;0;0;0;0;0;0;0;0;0;0;0;0;0;0;0;0;0;0
FR;11;2022-09-03;0;0;0;0;0;0;0;0;0;0;0;0;0;0;0;0;0;0
FR;11;2022-09-04;0;0;0;0;0;0;0;0;0;0;0;0;0;0;0;0;0;0
FR;11;2022-09-05;0;0;0;0;0;0;0;0;0;0;0;0;0;0;0;0;0;0
FR;11;2022-09-06;0;0;0;0;0;0;0;0;0;0;0;0;0;0;0;0;0;0
FR;11;2022-09-07;0;0;0;0;0;0;0;0;0;0;0;0;0;0;0;0;0;0
FR;11;2022-09-08;0;0;0;0;0;0;0;0;0;0;0;0;0;0;0;0;0;0
FR;11;2022-09-09;0;0;0;0;0;0;0;0;0;0;0;0;0;0;0;0;0;0
FR;11;2022-09-10;0;0;0;0;0;0;0;0;0;0;0;0;0;0;0;0;0;0
FR;11;2022-09-11;0;0;0;0;0;0;0;0;0;0;0;0;0;0;0;0;0;0
FR;11;2022-09-12;0;0;0;0;0;0;0;0;0;0;0;0;0;0;0;0;0;0
FR;11;2022-09-13;0;0;0;0;0;0;0;0;0;0;0;0;0;0;0;0;0;0
FR;11;2022-09-14;0;0;0;0;0;0;0;0;0;0;0;0;0;0;0;0;0;0
FR;11;2022-09-15;0;0;0;0;0;0;0;0;0;0;0;0;0;0;0;0;0;0
FR;11;2022-09-16;0;0;0;0;0;0;0;0;0;0;0;0;0;0;0;0;0;0
FR;11;2022-09-17;0;0;0;0;0;0;0;0;0;0;0;0;0;0;0;0;0;0
FR;11;2022-09-18;0;0;0;0;0;0;0;0;0;0;0;0;0;0;0;0;0;0
FR;11;2022-09-19;0;0;0;0;0;0;0;0;0;0;0;0;0;0;0;0;0;0
FR;11;2022-09-20;0;0;0;0;0;0;0;0;0;0;0;0;0;0;0;0;0;0
FR;11;2022-09-21;0;0;0;0;0;0;0;0;0;0;0;0;0;0;0;0;0;0
FR;11;2022-09-22;0;0;0;0;0;0;0;0;0;0;0;0;0;0;0;0;0;0
FR;11;2022-09-23;0;0;0;0;0;0;0;0;0;0;0;0;0;0;0;0;0;0
FR;11;2022-09-24;0;0;0;0;0;0;0;0;0;0;0;0;0;0;0;0;0;0
FR;11;2022-09-25;0;0;0;0;0;0;0;0;0;0;0;0;0;0;0;0;0;0
FR;11;2022-09-26;0;0;0;0;0;0;0;0;0;0;0;0;0;0;0;0;0;0
FR;11;2022-09-27;0;0;0;0;0;0;0;0;0;0;0;0;0;0;0;0;0;0
FR;11;2022-09-28;0;0;0;0;0;0;0;0;0;0;0;0;0;0;0;0;0;0
FR;11;2022-09-29;0;0;0;0;0;0;0;0;0;0;0;0;0;0;0;0;0;0
FR;11;2022-09-30;0;0;0;0;0;0;0;0;0;0;0;0;0;0;0;0;0;0
FR;11;2022-10-01;0;0;0;0;0;0;0;0;0;0;0;0;0;0;0;0;0;0
FR;11;2022-10-02;0;0;0;0;0;0;0;0;0;0;0;0;0;0;0;0;0;0
FR;11;2022-10-03;0;0;0;0;0;0;0;0;0;0;0;0;0;0;0;0;0;0
FR;11;2022-10-04;0;0;0;0;0;0;0;0;0;0;0;0;0;0;0;0;0;0
FR;11;2022-10-05;0;0;0;0;0;0;0;0;0;0;0;0;0;0;0;0;0;0
FR;11;2022-10-06;0;0;0;0;0;0;0;0;0;0;0;0;0;0;0;0;0;0
FR;11;2022-10-07;0;0;0;0;0;0;0;0;0;0;0;0;0;0;0;0;0;0
FR;11;2022-10-08;0;0;0;0;0;0;0;0;0;0;0;0;0;0;0;0;0;0
FR;11;2022-10-09;0;0;0;0;0;0;0;0;0;0;0;0;0;0;0;0;0;0
FR;11;2022-10-10;0;0;0;0;0;0;0;0;0;0;0;0;0;0;0;0;0;0
FR;11;2022-10-11;0;0;0;0;0;0;0;0;0;0;0;0;0;0;0;0;0;0
FR;11;2022-10-12;0;0;0;0;0;0;0;0;0;0;0;0;0;0;0;0;0;0
FR;11;2022-10-13;0;0;0;0;0;0;0;0;0;0;0;0;0;0;0;0;0;0
FR;11;2022-10-14;0;0;0;0;0;0;0;0;0;0;0;0;0;0;0;0;0;0
FR;11;2022-10-15;0;0;0;0;0;0;0;0;0;0;0;0;0;0;0;0;0;0
FR;11;2022-10-16;0;0;0;0;0;0;0;0;0;0;0;0;0;0;0;0;0;0
FR;11;2022-10-17;0;0;0;0;0;0;0;0;0;0;0;0;0;0;0;0;0;0
FR;11;2022-10-18;0;0;0;0;0;0;0;0;0;0;0;0;0;0;0;0;0;0
FR;11;2022-10-19;0;0;0;0;0;0;0;0;0;0;0;0;0;0;0;0;0;0
FR;11;2022-10-20;0;0;0;0;0;0;0;0;0;0;0;0;0;0;0;0;0;0
FR;11;2022-10-21;0;0;0;0;0;0;0;0;0;0;0;0;0;0;0;0;0;0
FR;11;2022-10-22;0;0;0;0;0;0;0;0;0;0;0;0;0;0;0;0;0;0
FR;11;2022-10-23;0;0;0;0;0;0;0;0;0;0;0;0;0;0;0;0;0;0
FR;11;2022-10-24;0;0;0;0;0;0;0;0;0;0;0;0;0;0;0;0;0;0
FR;11;2022-10-25;0;0;0;0;0;0;0;0;0;0;0;0;0;0;0;0;0;0
FR;11;2022-10-26;0;0;0;0;0;0;0;0;0;0;0;0;0;0;0;0;0;0
FR;11;2022-10-27;0;0;0;0;0;0;0;0;0;0;0;0;0;0;0;0;0;0
FR;11;2022-10-28;0;0;0;0;0;0;0;0;0;0;0;0;0;0;0;0;0;0
FR;11;2022-10-29;0;0;0;0;0;0;0;0;0;0;0;0;0;0;0;0;0;0
FR;11;2022-10-30;0;0;0;0;0;0;0;0;0;0;0;0;0;0;0;0;0;0
FR;11;2022-10-31;0;0;0;0;0;0;0;0;0;0;0;0;0;0;0;0;0;0
FR;11;2022-11-01;0;0;0;0;0;0;0;0;0;0;0;0;0;0;0;0;0;0
FR;11;2022-11-02;0;0;0;0;0;0;0;0;0;0;0;0;0;0;0;0;0;0
FR;11;2022-11-03;0;0;0;0;0;0;0;0;0;0;0;0;0;0;0;0;0;0
FR;11;2022-11-04;0;0;0;0;0;0;0;0;0;0;0;0;0;0;0;0;0;0
FR;11;2022-11-05;0;0;0;0;0;0;0;0;0;0;0;0;0;0;0;0;0;0
FR;11;2022-11-06;0;0;0;0;0;0;0;0;0;0;0;0;0;0;0;0;0;0
FR;11;2022-11-07;0;0;0;0;0;0;0;0;0;0;0;0;0;0;0;0;0;0
FR;11;2022-11-08;0;0;0;0;0;0;0;0;0;0;0;0;0;0;0;0;0;0
FR;11;2022-11-09;0;0;0;0;0;0;0;0;0;0;0;0;0;0;0;0;0;0
FR;11;2022-11-10;0;0;0;0;0;0;0;0;0;0;0;0;0;0;0;0;0;0
FR;11;2022-11-11;0;0;0;0;0;0;0;0;0;0;0;0;0;0;0;0;0;0
FR;11;2022-11-12;0;0;0;0;0;0;0;0;0;0;0;0;0;0;0;0;0;0
FR;11;2022-11-13;0;0;0;0;0;0;0;0;0;0;0;0;0;0;0;0;0;0
FR;11;2022-11-14;0;0;0;0;0;0;0;0;0;0;0;0;0;0;0;0;0;0
FR;11;2022-11-15;0;0;0;0;0;0;0;0;0;0;0;0;0;0;0;0;0;0
FR;11;2022-11-16;0;0;0;0;0;0;0;0;0;0;0;0;0;0;0;0;0;0
FR;11;2022-11-17;0;0;0;0;0;0;0;0;0;0;0;0;0;0;0;0;0;0
FR;11;2022-11-18;0;0;0;0;0;0;0;0;0;0;0;0;0;0;0;0;0;0
FR;11;2022-11-19;0;0;0;0;0;0;0;0;0;0;0;0;0;0;0;0;0;0
FR;11;2022-11-20;0;0;0;0;0;0;0;0;0;0;0;0;0;0;0;0;0;0
FR;11;2022-11-21;0;0;0;0;0;0;0;0;0;0;0;0;0;0;0;0;0;0
FR;11;2022-11-22;0;0;0;0;0;0;0;0;0;0;0;0;0;0;0;0;0;0
FR;11;2022-11-23;0;0;0;0;0;0;0;0;0;0;0;0;0;0;0;0;0;0
FR;11;2022-11-24;0;0;0;0;0;0;0;0;0;0;0;0;0;0;0;0;0;0
FR;11;2022-11-25;0;0;0;0;0;0;0;0;0;0;0;0;0;0;0;0;0;0
FR;11;2022-11-26;0;0;0;0;0;0;0;0;0;0;0;0;0;0;0;0;0;0
FR;11;2022-11-27;0;0;0;0;0;0;0;0;0;0;0;0;0;0;0;0;0;0
FR;11;2022-11-28;0;0;0;0;0;0;0;0;0;0;0;0;0;0;0;0;0;0
FR;11;2022-11-29;0;0;0;0;0;0;0;0;0;0;0;0;0;0;0;0;0;0
FR;11;2022-11-30;0;0;0;0;0;0;0;0;0;0;0;0;0;0;0;0;0;0
FR;11;2022-12-01;0;0;0;0;0;0;0;0;0;0;0;0;0;0;0;0;0;0
FR;11;2022-12-02;0;0;0;0;0;0;0;0;0;0;0;0;0;0;0;0;0;0
FR;11;2022-12-03;0;0;0;0;0;0;0;0;0;0;0;0;0;0;0;0;0;0
FR;11;2022-12-04;0;0;0;0;0;0;0;0;0;0;0;0;0;0;0;0;0;0
FR;11;2022-12-05;0;0;0;0;0;0;0;0;0;0;0;0;0;0;0;0;0;0
FR;11;2022-12-06;0;0;0;0;0;0;0;0;0;0;0;0;0;0;0;0;0;0
FR;11;2022-12-07;0;0;0;0;0;0;0;0;0;0;0;0;0;0;0;0;0;0
FR;11;2022-12-08;0;0;0;0;0;0;0;0;0;0;0;0;0;0;0;0;0;0
FR;11;2022-12-09;0;0;0;0;0;0;0;0;0;0;0;0;0;0;0;0;0;0
FR;11;2022-12-10;0;0;0;0;0;0;0;0;0;0;0;0;0;0;0;0;0;0
FR;11;2022-12-11;0;0;0;0;0;0;0;0;0;0;0;0;0;0;0;0;0;0
FR;11;2022-12-12;0;0;0;0;0;0;0;0;0;0;0;0;0;0;0;0;0;0
FR;11;2022-12-13;0;0;0;0;0;0;0;0;0;0;0;0;0;0;0;0;0;0
FR;11;2022-12-14;0;0;0;0;0;0;0;0;0;0;0;0;0;0;0;0;0;0
FR;11;2022-12-15;0;0;0;0;0;0;0;0;0;0;0;0;0;0;0;0;0;0
FR;11;2022-12-16;0;0;0;0;0;0;0;0;0;0;0;0;0;0;0;0;0;0
FR;11;2022-12-17;0;0;0;0;0;0;0;0;0;0;0;0;0;0;0;0;0;0
FR;11;2022-12-18;0;0;0;0;0;0;0;0;0;0;0;0;0;0;0;0;0;0
FR;11;2022-12-19;0;0;0;0;0;0;0;0;0;0;0;0;0;0;0;0;0;0
FR;11;2022-12-20;0;0;0;0;0;0;0;0;0;0;0;0;0;0;0;0;0;0
FR;11;2022-12-21;0;0;0;0;0;0;0;0;0;0;0;0;0;0;0;0;0;0
FR;11;2022-12-22;0;0;0;0;0;0;0;0;0;0;0;0;0;0;0;0;0;0
FR;11;2022-12-23;0;0;0;0;0;0;0;0;0;0;0;0;0;0;0;0;0;0
FR;11;2022-12-24;0;0;0;0;0;0;0;0;0;0;0;0;0;0;0;0;0;0
FR;11;2022-12-25;0;0;0;0;0;0;0;0;0;0;0;0;0;0;0;0;0;0
FR;11;2022-12-26;0;0;0;0;0;0;0;0;0;0;0;0;0;0;0;0;0;0
FR;11;2022-12-27;0;0;0;0;0;0;0;0;0;0;0;0;0;0;0;0;0;0
FR;11;2022-12-28;0;0;0;0;0;0;0;0;0;0;0;0;0;0;0;0;0;0
FR;11;2022-12-29;0;0;0;0;0;0;0;0;0;0;0;0;0;0;0;0;0;0
FR;11;2022-12-30;0;0;0;0;0;0;0;0;0;0;0;0;0;0;0;0;0;0
FR;11;2022-12-31;0;0;0;0;0;0;0;0;0;0;0;0;0;0;0;0;0;0
FR;11;2023-01-01;0;0;0;0;0;0;0;0;0;0;0;0;0;0;0;0;0;0
FR;11;2023-01-02;0;0;0;0;0;0;0;0;0;0;0;0;0;0;0;0;0;0
FR;11;2023-01-03;0;0;0;0;0;0;0;0;0;0;0;0;0;0;0;0;0;0
FR;11;2023-01-04;0;0;0;0;0;0;0;0;0;0;0;0;0;0;0;0;0;0
FR;11;2023-01-05;0;0;0;0;0;0;0;0;0;0;0;0;0;0;0;0;0;0
FR;11;2023-01-06;0;0;0;0;0;0;0;0;0;0;0;0;0;0;0;0;0;0
FR;11;2023-01-07;0;0;0;0;0;0;0;0;0;0;0;0;0;0;0;0;0;0
FR;11;2023-01-08;0;0;0;0;0;0;0;0;0;0;0;0;0;0;0;0;0;0
FR;11;2023-01-09;0;0;0;0;0;0;0;0;0;0;0;0;0;0;0;0;0;0
FR;11;2023-01-10;0;0;0;0;0;0;0;0;0;0;0;0;0;0;0;0;0;0
FR;11;2023-01-11;0;0;0;0;0;0;0;0;0;0;0;0;0;0;0;0;0;0
FR;11;2023-01-12;0;0;0;0;0;0;0;0;0;0;0;0;0;0;0;0;0;0
FR;11;2023-01-13;0;0;0;0;0;0;0;0;0;0;0;0;0;0;0;0;0;0
FR;11;2023-01-14;0;0;0;0;0;0;0;0;0;0;0;0;0;0;0;0;0;0
FR;11;2023-01-15;0;0;0;0;0;0;0;0;0;0;0;0;0;0;0;0;0;0
FR;11;2023-01-16;0;0;0;0;0;0;0;0;0;0;0;0;0;0;0;0;0;0
FR;11;2023-01-17;0;0;0;0;0;0;0;0;0;0;0;0;0;0;0;0;0;0
FR;11;2023-01-18;0;0;0;0;0;0;0;0;0;0;0;0;0;0;0;0;0;0
FR;11;2023-01-19;0;0;0;0;0;0;0;0;0;0;0;0;0;0;0;0;0;0
FR;11;2023-01-20;0;0;0;0;0;0;0;0;0;0;0;0;0;0;0;0;0;0
FR;11;2023-01-21;0;0;0;0;0;0;0;0;0;0;0;0;0;0;0;0;0;0
FR;11;2023-01-22;0;0;0;0;0;0;0;0;0;0;0;0;0;0;0;0;0;0
FR;11;2023-01-23;0;0;0;0;0;0;0;0;0;0;0;0;0;0;0;0;0;0
FR;11;2023-01-24;0;0;0;0;0;0;0;0;0;0;0;0;0;0;0;0;0;0
FR;11;2023-01-25;0;0;0;0;0;0;0;0;0;0;0;0;0;0;0;0;0;0
FR;11;2023-01-26;0;0;0;0;0;0;0;0;0;0;0;0;0;0;0;0;0;0
FR;11;2023-01-27;0;0;0;0;0;0;0;0;0;0;0;0;0;0;0;0;0;0
FR;11;2023-01-28;0;0;0;0;0;0;0;0;0;0;0;0;0;0;0;0;0;0
FR;11;2023-01-29;0;0;0;0;0;0;0;0;0;0;0;0;0;0;0;0;0;0
FR;11;2023-01-30;0;0;0;0;0;0;0;0;0;0;0;0;0;0;0;0;0;0
FR;11;2023-01-31;0;0;0;0;0;0;0;0;0;0;0;0;0;0;0;0;0;0
FR;11;2023-02-01;0;0;0;0;0;0;0;0;0;0;0;0;0;0;0;0;0;0
FR;11;2023-02-02;0;0;0;0;0;0;0;0;0;0;0;0;0;0;0;0;0;0
FR;11;2023-02-03;0;0;0;0;0;0;0;0;0;0;0;0;0;0;0;0;0;0
FR;11;2023-02-04;0;0;0;0;0;0;0;0;0;0;0;0;0;0;0;0;0;0
FR;11;2023-02-05;0;0;0;0;0;0;0;0;0;0;0;0;0;0;0;0;0;0
FR;11;2023-02-06;1;0;0;0;0;0;0;0;0;1;0;0;0;0;0;0;0;0
FR;11;2023-02-07;0;0;0;0;0;0;0;0;0;1;0;0;0;0;0;0;0;0
FR;11;2023-02-08;2;0;0;0;0;0;0;0;0;3;0;0;0;0;0;0;0;0
FR;11;2023-02-09;2;0;0;0;0;0;0;0;0;5;0;0;0;0;0;0;0;0
FR;11;2023-02-10;0;0;0;0;0;0;0;0;0;5;0;0;0;0;0;0;0;0
FR;11;2023-02-11;0;0;0;0;0;0;0;0;0;5;0;0;0;0;0;0;0;0
FR;11;2023-02-12;0;0;0;0;0;0;0;0;0;5;0;0;0;0;0;0;0;0
FR;11;2023-02-13;2;0;0;0;0;0;0;0;0;7;0;0;0;0;0;0;0;0
FR;11;2023-02-14;0;0;0;0;0;0;0;0;0;7;0;0;0;0;0;0;0;0
FR;11;2023-02-15;2;0;0;0;0;0;0;0;0;9;0;0;0;0;0;0;0;0
FR;11;2023-02-16;0;0;0;0;0;0;0;0;0;9;0;0;0;0;0;0;0;0
FR;11;2023-02-17;0;0;0;0;0;0;0;0;0;9;0;0;0;0;0;0;0;0
FR;11;2023-02-18;0;0;0;0;0;0;0;0;0;9;0;0;0;0;0;0;0;0
FR;11;2023-02-19;0;0;0;0;0;0;0;0;0;9;0;0;0;0;0;0;0;0
FR;11;2023-02-20;0;0;0;0;0;0;0;0;0;9;0;0;0;0;0;0;0;0
FR;11;2023-02-21;1;0;0;0;0;0;0;0;0;10;0;0;0;0;0;0;0;0
FR;11;2023-02-22;0;0;0;0;0;0;0;0;0;10;0;0;0;0;0;0;0;0
FR;11;2023-02-23;0;0;0;0;0;0;0;0;0;10;0;0;0;0;0;0;0;0
FR;11;2023-02-24;0;0;0;0;0;0;0;0;0;10;0;0;0;0;0;0;0;0
FR;11;2023-02-25;0;0;0;0;0;0;0;0;0;10;0;0;0;0;0;0;0;0
FR;11;2023-02-26;0;0;2;0;0;2;0;0;0;10;0;2;0;0;2;0;0;0
FR;11;2023-02-27;0;0;0;0;0;0;0;0;0;10;0;2;0;0;2;0;0;0
FR;11;2023-02-28;1;1;0;0;1;0;0;0;0;11;1;2;0;1;2;0;0;0
FR;11;2023-03-01;0;1;0;0;1;0;0;0;0;11;2;2;0;2;2;0;0;0
FR;11;2023-03-02;0;0;0;0;0;0;0;0;0;11;2;2;0;2;2;0;0;0
FR;11;2023-03-03;0;0;0;0;0;0;0;0;0;11;2;2;0;2;2;0;0;0
FR;11;2023-03-04;2;1;0;0;1;0;0;0;0;13;3;2;0;3;2;0;0;0
FR;11;2023-03-05;0;0;0;0;0;0;0;0;0;13;3;2;0;3;2;0;0;0
FR;11;2023-03-06;4;0;1;0;1;1;0;0;0;17;3;3;0;4;3;0;0;0
FR;11;2023-03-07;0;1;0;0;1;0;0;0;0;17;4;3;0;5;3;0;0;0
FR;11;2023-03-08;1;1;0;0;1;0;0;0;0;18;5;3;0;6;3;0;0;0
FR;11;2023-03-09;0;0;0;0;0;0;0;0;0;18;5;3;0;6;3;0;0;0
FR;11;2023-03-10;0;0;0;0;0;0;0;0;0;18;5;3;0;6;3;0;0;0
FR;11;2023-03-11;2;0;0;0;0;0;0;0;0;20;5;3;0;6;3;0;0;0
FR;11;2023-03-12;0;1;0;0;1;0;0;0;0;20;6;3;0;7;3;0;0;0
FR;11;2023-03-13;0;0;0;0;0;0;0;0;0;20;6;3;0;7;3;0;0;0
FR;11;2023-03-14;0;0;0;0;0;0;0;0;0;20;6;3;0;7;3;0;0;0
FR;11;2023-03-15;0;1;0;0;1;0;0;0;0;20;7;3;0;8;3;0;0;0
FR;11;2023-03-16;0;0;0;0;0;0;0;0;0;20;7;3;0;8;3;0;0;0
FR;11;2023-03-17;0;0;0;0;0;0;0;0;0;20;7;3;0;8;3;0;0;0
FR;11;2023-03-18;1;0;0;0;0;0;0;0;0;21;7;3;0;8;3;0;0;0
FR;11;2023-03-19;0;0;0;0;0;0;0;0;0;21;7;3;0;8;3;0;0;0
FR;11;2023-03-20;0;0;0;0;0;0;0;0;0;21;7;3;0;8;3;0;0;0
FR;11;2023-03-21;1;0;0;0;0;0;0;0;0;22;7;3;0;8;3;0;0;0
FR;11;2023-03-22;2;0;0;0;0;0;0;0;0;24;7;3;0;8;3;0;0;0
FR;11;2023-03-23;0;0;0;1;0;0;1;0;0;24;7;3;1;8;3;1;0;0
FR;11;2023-03-24;0;0;0;0;0;0;0;0;0;24;7;3;1;8;3;1;0;0
FR;11;2023-03-25;1;1;0;0;1;0;0;0;0;25;8;3;1;9;3;1;0;0
FR;11;2023-03-26;0;0;0;0;0;0;0;0;0;25;8;3;1;9;3;1;0;0
FR;11;2023-03-27;0;1;0;0;0;1;0;0;0;25;9;3;1;9;4;1;0;0
FR;11;2023-03-28;0;0;0;0;0;0;0;0;0;25;9;3;1;9;4;1;0;0
FR;11;2023-03-29;0;1;0;0;1;0;0;0;0;25;10;3;1;10;4;1;0;0
FR;11;2023-03-30;1;1;0;0;1;0;0;0;0;26;11;3;1;11;4;1;0;0
FR;11;2023-03-31;0;0;0;0;0;0;0;0;0;26;11;3;1;11;4;1;0;0
FR;11;2023-04-01;0;2;0;0;2;0;0;0;0;26;13;3;1;13;4;1;0;0
FR;11;2023-04-02;0;0;0;0;0;0;0;0;0;26;13;3;1;13;4;1;0;0
FR;11;2023-04-03;0;3;0;0;3;0;0;0;0;26;16;3;1;16;4;1;0;0
FR;11;2023-04-04;0;0;0;0;0;0;0;0;0;26;16;3;1;16;4;1;0;0
FR;11;2023-04-05;0;0;0;0;0;0;0;0;0;26;16;3;1;16;4;1;0;0
FR;11;2023-04-06;0;0;0;0;0;0;0;0;0;26;16;3;1;16;4;1;0;0
FR;11;2023-04-07;0;1;0;0;1;0;0;0;0;26;17;3;1;17;4;1;0;0
FR;11;2023-04-08;0;0;0;0;0;0;0;0;0;26;17;3;1;17;4;1;0;0
FR;11;2023-04-09;0;0;0;0;0;0;0;0;0;26;17;3;1;17;4;1;0;0
FR;11;2023-04-10;0;0;0;0;0;0;0;0;0;26;17;3;1;17;4;1;0;0
FR;11;2023-04-11;0;1;0;0;1;0;0;0;0;26;18;3;1;18;4;1;0;0
FR;11;2023-04-12;1;1;0;0;1;0;0;0;0;27;19;3;1;19;4;1;0;0
FR;11;2023-04-13;0;0;0;0;0;0;0;0;0;27;19;3;1;19;4;1;0;0
FR;11;2023-04-14;0;0;0;0;0;0;0;0;0;27;19;3;1;19;4;1;0;0
FR;11;2023-04-15;0;1;0;0;1;0;0;0;0;27;20;3;1;20;4;1;0;0
FR;11;2023-04-16;0;0;0;0;0;0;0;0;0;27;20;3;1;20;4;1;0;0
FR;11;2023-04-17;0;1;0;0;1;0;0;0;0;27;21;3;1;21;4;1;0;0
FR;11;2023-04-18;0;0;0;0;0;0;0;0;0;27;21;3;1;21;4;1;0;0
FR;11;2023-04-19;1;0;0;0;0;0;0;0;0;28;21;3;1;21;4;1;0;0
FR;11;2023-04-20;0;1;0;0;1;0;0;0;0;28;22;3;1;22;4;1;0;0
FR;11;2023-04-21;2;0;0;0;0;0;0;0;0;30;22;3;1;22;4;1;0;0
FR;11;2023-04-22;0;2;0;0;2;0;0;0;0;30;24;3;1;24;4;1;0;0
FR;11;2023-04-23;0;0;0;0;0;0;0;0;0;30;24;3;1;24;4;1;0;0
FR;11;2023-04-24;0;0;1;0;0;1;0;0;0;30;24;4;1;24;5;1;0;0
FR;11;2023-04-25;0;0;0;0;0;0;0;0;0;30;24;4;1;24;5;1;0;0
FR;11;2023-04-26;0;0;0;0;0;0;0;0;0;30;24;4;1;24;5;1;0;0
FR;11;2023-04-27;0;0;0;0;0;0;0;0;0;30;24;4;1;24;5;1;0;0
FR;11;2023-04-28;0;0;0;0;0;0;0;0;0;30;24;4;1;24;5;1;0;0
FR;11;2023-04-29;0;0;0;0;0;0;0;0;0;30;24;4;1;24;5;1;0;0
FR;11;2023-04-30;0;0;0;0;0;0;0;0;0;30;24;4;1;24;5;1;0;0
FR;11;2023-05-01;0;0;0;0;0;0;0;0;0;30;24;4;1;24;5;1;0;0
FR;11;2023-05-02;0;0;0;0;0;0;0;0;0;30;24;4;1;24;5;1;0;0
FR;11;2023-05-03;0;0;2;0;0;2;0;0;0;30;24;6;1;24;7;1;0;0
FR;11;2023-05-04;0;0;0;0;0;0;0;0;0;30;24;6;1;24;7;1;0;0
FR;11;2023-05-05;0;0;0;0;0;0;0;0;0;30;24;6;1;24;7;1;0;0
FR;11;2023-05-06;0;0;0;0;0;0;0;0;0;30;24;6;1;24;7;1;0;0
FR;11;2023-05-07;0;0;0;0;0;0;0;0;0;30;24;6;1;24;7;1;0;0
FR;11;2023-05-08;0;0;0;0;0;0;0;0;0;30;24;6;1;24;7;1;0;0
FR;11;2023-05-09;0;0;0;0;0;0;0;0;0;30;24;6;1;24;7;1;0;0
FR;11;2023-05-10;2;2;0;0;2;0;0;0;0;32;26;6;1;26;7;1;0;0
FR;11;2023-05-11;0;0;0;0;0;0;0;0;0;32;26;6;1;26;7;1;0;0
FR;11;2023-05-12;0;0;0;0;0;0;0;0;0;32;26;6;1;26;7;1;0;0
FR;11;2023-05-13;0;0;0;0;0;0;0;0;0;32;26;6;1;26;7;1;0;0
FR;11;2023-05-14;0;0;0;0;0;0;0;0;0;32;26;6;1;26;7;1;0;0
FR;11;2023-05-15;0;0;0;0;0;0;0;0;0;32;26;6;1;26;7;1;0;0
FR;11;2023-05-16;0;0;0;0;0;0;0;0;0;32;26;6;1;26;7;1;0;0
FR;11;2023-05-17;0;0;0;0;0;0;0;0;0;32;26;6;1;26;7;1;0;0
FR;11;2023-05-18;0;0;0;0;0;0;0;0;0;32;26;6;1;26;7;1;0;0
FR;11;2023-05-19;0;0;0;0;0;0;0;0;0;32;26;6;1;26;7;1;0;0
FR;11;2023-05-20;0;0;0;0;0;0;0;0;0;32;26;6;1;26;7;1;0;0
FR;11;2023-05-21;0;0;0;0;0;0;0;0;0;32;26;6;1;26;7;1;0;0
FR;11;2023-05-22;0;0;0;0;0;0;0;0;0;32;26;6;1;26;7;1;0;0
FR;11;2023-05-23;0;0;0;0;0;0;0;0;0;32;26;6;1;26;7;1;0;0
FR;11;2023-05-24;1;0;1;0;0;0;0;0;0;33;26;7;1;26;7;1;0;0
FR;11;2023-05-25;0;0;0;0;0;0;0;0;0;33;26;7;1;26;7;1;0;0
FR;11;2023-05-26;0;0;0;0;0;0;0;0;0;33;26;7;1;26;7;1;0;0
FR;11;2023-05-27;0;0;3;0;0;3;0;0;0;33;26;10;1;26;10;1;0;0
FR;11;2023-05-28;0;0;0;0;0;0;0;0;0;33;26;10;1;26;10;1;0;0
FR;11;2023-05-29;0;0;0;0;0;0;0;0;0;33;26;10;1;26;10;1;0;0
FR;11;2023-05-30;0;1;3;0;1;3;0;0;0;33;27;13;1;27;13;1;0;0
FR;11;2023-05-31;0;0;1;0;0;0;1;0;0;33;27;14;1;27;13;2;0;0
FR;11;2023-06-01;0;0;0;0;0;0;0;0;0;33;27;14;1;27;13;2;0;0
FR;11;2023-06-02;0;0;1;0;0;1;0;0;0;33;27;15;1;27;14;2;0;0
FR;11;2023-06-03;0;0;0;0;0;0;0;0;0;33;27;15;1;27;14;2;0;0
FR;11;2023-06-04;0;0;0;0;0;0;0;0;0;33;27;15;1;27;14;2;0;0
FR;11;2023-06-05;0;0;0;0;0;0;0;0;0;33;27;15;1;27;14;2;0;0
FR;11;2023-06-06;0;0;1;0;0;0;0;0;0;33;27;16;1;27;14;2;0;0
FR;11;2023-06-07;2;0;1;0;0;1;0;0;0;35;27;17;1;27;15;2;0;0
FR;11;2023-06-08;3;0;0;0;0;0;0;0;0;38;27;17;1;27;15;2;0;0
FR;11;2023-06-09;0;0;0;0;0;0;0;0;0;38;27;17;1;27;15;2;0;0
FR;11;2023-06-10;0;0;0;0;0;0;0;0;0;38;27;17;1;27;15;2;0;0
FR;11;2023-06-11;2;0;0;0;0;0;0;0;0;40;27;17;1;27;15;2;0;0
FR;11;2023-06-12;0;0;0;0;0;0;0;0;0;40;27;17;1;27;15;2;0;0
FR;11;2023-06-13;0;0;0;0;0;0;0;0;0;40;27;17;1;27;15;2;0;0
FR;11;2023-06-14;0;0;0;0;0;0;0;0;0;40;27;17;1;27;15;2;0;0
FR;11;2023-06-15;0;0;1;0;0;1;0;0;0;40;27;18;1;27;16;2;0;0
FR;11;2023-06-16;0;0;1;0;0;1;0;0;0;40;27;19;1;27;17;2;0;0
FR;11;2023-06-17;0;0;0;0;0;0;0;0;0;40;27;19;1;27;17;2;0;0
FR;11;2023-06-18;0;0;1;0;0;1;0;0;0;40;27;20;1;27;18;2;0;0
FR;11;2023-06-19;0;0;0;0;0;0;0;0;0;40;27;20;1;27;18;2;0;0
FR;12;2020-12-27;0;0;0;0;0;0;0;0;0;0;0;0;0;0;0;0;0;0
FR;12;2020-12-28;0;0;0;0;0;0;0;0;0;0;0;0;0;0;0;0;0;0
FR;12;2020-12-29;0;0;0;0;0;0;0;0;0;0;0;0;0;0;0;0;0;0
FR;12;2020-12-30;0;0;0;0;0;0;0;0;0;0;0;0;0;0;0;0;0;0
FR;12;2020-12-31;0;0;0;0;0;0;0;0;0;0;0;0;0;0;0;0;0;0
FR;12;2021-01-01;0;0;0;0;0;0;0;0;0;0;0;0;0;0;0;0;0;0
FR;12;2021-01-02;0;0;0;0;0;0;0;0;0;0;0;0;0;0;0;0;0;0
FR;12;2021-01-03;0;0;0;0;0;0;0;0;0;0;0;0;0;0;0;0;0;0
FR;12;2021-01-04;0;0;0;0;0;0;0;0;0;0;0;0;0;0;0;0;0;0
FR;12;2021-01-05;0;0;0;0;0;0;0;0;0;0;0;0;0;0;0;0;0;0
FR;12;2021-01-06;0;0;0;0;0;0;0;0;0;0;0;0;0;0;0;0;0;0
FR;12;2021-01-07;0;0;0;0;0;0;0;0;0;0;0;0;0;0;0;0;0;0
FR;12;2021-01-08;0;0;0;0;0;0;0;0;0;0;0;0;0;0;0;0;0;0
FR;12;2021-01-09;0;0;0;0;0;0;0;0;0;0;0;0;0;0;0;0;0;0
FR;12;2021-01-10;0;0;0;0;0;0;0;0;0;0;0;0;0;0;0;0;0;0
FR;12;2021-01-11;0;0;0;0;0;0;0;0;0;0;0;0;0;0;0;0;0;0
FR;12;2021-01-12;0;0;0;0;0;0;0;0;0;0;0;0;0;0;0;0;0;0
FR;12;2021-01-13;0;0;0;0;0;0;0;0;0;0;0;0;0;0;0;0;0;0
FR;12;2021-01-14;0;0;0;0;0;0;0;0;0;0;0;0;0;0;0;0;0;0
FR;12;2021-01-15;0;0;0;0;0;0;0;0;0;0;0;0;0;0;0;0;0;0
FR;12;2021-01-16;0;0;0;0;0;0;0;0;0;0;0;0;0;0;0;0;0;0
FR;12;2021-01-17;0;0;0;0;0;0;0;0;0;0;0;0;0;0;0;0;0;0
FR;12;2021-01-18;0;0;0;0;0;0;0;0;0;0;0;0;0;0;0;0;0;0
FR;12;2021-01-19;0;0;0;0;0;0;0;0;0;0;0;0;0;0;0;0;0;0
FR;12;2021-01-20;0;0;0;0;0;0;0;0;0;0;0;0;0;0;0;0;0;0
FR;12;2021-01-21;0;0;0;0;0;0;0;0;0;0;0;0;0;0;0;0;0;0
FR;12;2021-01-22;0;0;0;0;0;0;0;0;0;0;0;0;0;0;0;0;0;0
FR;12;2021-01-23;0;0;0;0;0;0;0;0;0;0;0;0;0;0;0;0;0;0
FR;12;2021-01-24;0;0;0;0;0;0;0;0;0;0;0;0;0;0;0;0;0;0
FR;12;2021-01-25;0;0;0;0;0;0;0;0;0;0;0;0;0;0;0;0;0;0
FR;12;2021-01-26;0;0;0;0;0;0;0;0;0;0;0;0;0;0;0;0;0;0
FR;12;2021-01-27;0;0;0;0;0;0;0;0;0;0;0;0;0;0;0;0;0;0
FR;12;2021-01-28;0;0;0;0;0;0;0;0;0;0;0;0;0;0;0;0;0;0
FR;12;2021-01-29;0;0;0;0;0;0;0;0;0;0;0;0;0;0;0;0;0;0
FR;12;2021-01-30;0;0;0;0;0;0;0;0;0;0;0;0;0;0;0;0;0;0
FR;12;2021-01-31;0;0;0;0;0;0;0;0;0;0;0;0;0;0;0;0;0;0
FR;12;2021-02-01;0;0;0;0;0;0;0;0;0;0;0;0;0;0;0;0;0;0
FR;12;2021-02-02;0;0;0;0;0;0;0;0;0;0;0;0;0;0;0;0;0;0
FR;12;2021-02-03;0;0;0;0;0;0;0;0;0;0;0;0;0;0;0;0;0;0
FR;12;2021-02-04;0;0;0;0;0;0;0;0;0;0;0;0;0;0;0;0;0;0
FR;12;2021-02-05;0;0;0;0;0;0;0;0;0;0;0;0;0;0;0;0;0;0
FR;12;2021-02-06;0;0;0;0;0;0;0;0;0;0;0;0;0;0;0;0;0;0
FR;12;2021-02-07;0;0;0;0;0;0;0;0;0;0;0;0;0;0;0;0;0;0
FR;12;2021-02-08;0;0;0;0;0;0;0;0;0;0;0;0;0;0;0;0;0;0
FR;12;2021-02-09;0;0;0;0;0;0;0;0;0;0;0;0;0;0;0;0;0;0
FR;12;2021-02-10;0;0;0;0;0;0;0;0;0;0;0;0;0;0;0;0;0;0
FR;12;2021-02-11;0;0;0;0;0;0;0;0;0;0;0;0;0;0;0;0;0;0
FR;12;2021-02-12;0;0;0;0;0;0;0;0;0;0;0;0;0;0;0;0;0;0
FR;12;2021-02-13;0;0;0;0;0;0;0;0;0;0;0;0;0;0;0;0;0;0
FR;12;2021-02-14;0;0;0;0;0;0;0;0;0;0;0;0;0;0;0;0;0;0
FR;12;2021-02-15;0;0;0;0;0;0;0;0;0;0;0;0;0;0;0;0;0;0
FR;12;2021-02-16;0;0;0;0;0;0;0;0;0;0;0;0;0;0;0;0;0;0
FR;12;2021-02-17;0;0;0;0;0;0;0;0;0;0;0;0;0;0;0;0;0;0
FR;12;2021-02-18;0;0;0;0;0;0;0;0;0;0;0;0;0;0;0;0;0;0
FR;12;2021-02-19;0;0;0;0;0;0;0;0;0;0;0;0;0;0;0;0;0;0
FR;12;2021-02-20;0;0;0;0;0;0;0;0;0;0;0;0;0;0;0;0;0;0
FR;12;2021-02-21;0;0;0;0;0;0;0;0;0;0;0;0;0;0;0;0;0;0
FR;12;2021-02-22;0;0;0;0;0;0;0;0;0;0;0;0;0;0;0;0;0;0
FR;12;2021-02-23;0;0;0;0;0;0;0;0;0;0;0;0;0;0;0;0;0;0
FR;12;2021-02-24;0;0;0;0;0;0;0;0;0;0;0;0;0;0;0;0;0;0
FR;12;2021-02-25;0;0;0;0;0;0;0;0;0;0;0;0;0;0;0;0;0;0
FR;12;2021-02-26;0;0;0;0;0;0;0;0;0;0;0;0;0;0;0;0;0;0
FR;12;2021-02-27;0;0;0;0;0;0;0;0;0;0;0;0;0;0;0;0;0;0
FR;12;2021-02-28;0;0;0;0;0;0;0;0;0;0;0;0;0;0;0;0;0;0
FR;12;2021-03-01;0;0;0;0;0;0;0;0;0;0;0;0;0;0;0;0;0;0
FR;12;2021-03-02;0;0;0;0;0;0;0;0;0;0;0;0;0;0;0;0;0;0
FR;12;2021-03-03;0;0;0;0;0;0;0;0;0;0;0;0;0;0;0;0;0;0
FR;12;2021-03-04;0;0;0;0;0;0;0;0;0;0;0;0;0;0;0;0;0;0
FR;12;2021-03-05;0;0;0;0;0;0;0;0;0;0;0;0;0;0;0;0;0;0
FR;12;2021-03-06;0;0;0;0;0;0;0;0;0;0;0;0;0;0;0;0;0;0
FR;12;2021-03-07;0;0;0;0;0;0;0;0;0;0;0;0;0;0;0;0;0;0
FR;12;2021-03-08;0;0;0;0;0;0;0;0;0;0;0;0;0;0;0;0;0;0
FR;12;2021-03-09;0;0;0;0;0;0;0;0;0;0;0;0;0;0;0;0;0;0
FR;12;2021-03-10;0;0;0;0;0;0;0;0;0;0;0;0;0;0;0;0;0;0
FR;12;2021-03-11;0;0;0;0;0;0;0;0;0;0;0;0;0;0;0;0;0;0
FR;12;2021-03-12;0;0;0;0;0;0;0;0;0;0;0;0;0;0;0;0;0;0
FR;12;2021-03-13;0;0;0;0;0;0;0;0;0;0;0;0;0;0;0;0;0;0
FR;12;2021-03-14;0;0;0;0;0;0;0;0;0;0;0;0;0;0;0;0;0;0
FR;12;2021-03-15;0;0;0;0;0;0;0;0;0;0;0;0;0;0;0;0;0;0
FR;12;2021-03-16;0;0;0;0;0;0;0;0;0;0;0;0;0;0;0;0;0;0
FR;12;2021-03-17;0;0;0;0;0;0;0;0;0;0;0;0;0;0;0;0;0;0
FR;12;2021-03-18;0;0;0;0;0;0;0;0;0;0;0;0;0;0;0;0;0;0
FR;12;2021-03-19;0;0;0;0;0;0;0;0;0;0;0;0;0;0;0;0;0;0
FR;12;2021-03-20;0;0;0;0;0;0;0;0;0;0;0;0;0;0;0;0;0;0
FR;12;2021-03-21;0;0;0;0;0;0;0;0;0;0;0;0;0;0;0;0;0;0
FR;12;2021-03-22;0;0;0;0;0;0;0;0;0;0;0;0;0;0;0;0;0;0
FR;12;2021-03-23;0;0;0;0;0;0;0;0;0;0;0;0;0;0;0;0;0;0
FR;12;2021-03-24;0;0;0;0;0;0;0;0;0;0;0;0;0;0;0;0;0;0
FR;12;2021-03-25;0;0;0;0;0;0;0;0;0;0;0;0;0;0;0;0;0;0
FR;12;2021-03-26;0;0;0;0;0;0;0;0;0;0;0;0;0;0;0;0;0;0
FR;12;2021-03-27;0;0;0;0;0;0;0;0;0;0;0;0;0;0;0;0;0;0
FR;12;2021-03-28;0;0;0;0;0;0;0;0;0;0;0;0;0;0;0;0;0;0
FR;12;2021-03-29;0;0;0;0;0;0;0;0;0;0;0;0;0;0;0;0;0;0
FR;12;2021-03-30;0;0;0;0;0;0;0;0;0;0;0;0;0;0;0;0;0;0
FR;12;2021-03-31;0;0;0;0;0;0;0;0;0;0;0;0;0;0;0;0;0;0
FR;12;2021-04-01;0;0;0;0;0;0;0;0;0;0;0;0;0;0;0;0;0;0
FR;12;2021-04-02;0;0;0;0;0;0;0;0;0;0;0;0;0;0;0;0;0;0
FR;12;2021-04-03;0;0;0;0;0;0;0;0;0;0;0;0;0;0;0;0;0;0
FR;12;2021-04-04;0;0;0;0;0;0;0;0;0;0;0;0;0;0;0;0;0;0
FR;12;2021-04-05;0;0;0;0;0;0;0;0;0;0;0;0;0;0;0;0;0;0
FR;12;2021-04-06;0;0;0;0;0;0;0;0;0;0;0;0;0;0;0;0;0;0
FR;12;2021-04-07;0;0;0;0;0;0;0;0;0;0;0;0;0;0;0;0;0;0
FR;12;2021-04-08;0;0;0;0;0;0;0;0;0;0;0;0;0;0;0;0;0;0
FR;12;2021-04-09;0;0;0;0;0;0;0;0;0;0;0;0;0;0;0;0;0;0
FR;12;2021-04-10;0;0;0;0;0;0;0;0;0;0;0;0;0;0;0;0;0;0
FR;12;2021-04-11;0;0;0;0;0;0;0;0;0;0;0;0;0;0;0;0;0;0
FR;12;2021-04-12;0;0;0;0;0;0;0;0;0;0;0;0;0;0;0;0;0;0
FR;12;2021-04-13;0;0;0;0;0;0;0;0;0;0;0;0;0;0;0;0;0;0
FR;12;2021-04-14;0;0;0;0;0;0;0;0;0;0;0;0;0;0;0;0;0;0
FR;12;2021-04-15;0;0;0;0;0;0;0;0;0;0;0;0;0;0;0;0;0;0
FR;12;2021-04-16;0;0;0;0;0;0;0;0;0;0;0;0;0;0;0;0;0;0
FR;12;2021-04-17;0;0;0;0;0;0;0;0;0;0;0;0;0;0;0;0;0;0
FR;12;2021-04-18;0;0;0;0;0;0;0;0;0;0;0;0;0;0;0;0;0;0
FR;12;2021-04-19;0;0;0;0;0;0;0;0;0;0;0;0;0;0;0;0;0;0
FR;12;2021-04-20;0;0;0;0;0;0;0;0;0;0;0;0;0;0;0;0;0;0
FR;12;2021-04-21;0;0;0;0;0;0;0;0;0;0;0;0;0;0;0;0;0;0
FR;12;2021-04-22;0;0;0;0;0;0;0;0;0;0;0;0;0;0;0;0;0;0
FR;12;2021-04-23;0;0;0;0;0;0;0;0;0;0;0;0;0;0;0;0;0;0
FR;12;2021-04-24;0;0;0;0;0;0;0;0;0;0;0;0;0;0;0;0;0;0
FR;12;2021-04-25;0;0;0;0;0;0;0;0;0;0;0;0;0;0;0;0;0;0
FR;12;2021-04-26;0;0;0;0;0;0;0;0;0;0;0;0;0;0;0;0;0;0
FR;12;2021-04-27;0;0;0;0;0;0;0;0;0;0;0;0;0;0;0;0;0;0
FR;12;2021-04-28;0;0;0;0;0;0;0;0;0;0;0;0;0;0;0;0;0;0
FR;12;2021-04-29;0;0;0;0;0;0;0;0;0;0;0;0;0;0;0;0;0;0
FR;12;2021-04-30;0;0;0;0;0;0;0;0;0;0;0;0;0;0;0;0;0;0
FR;12;2021-05-01;0;0;0;0;0;0;0;0;0;0;0;0;0;0;0;0;0;0
FR;12;2021-05-02;0;0;0;0;0;0;0;0;0;0;0;0;0;0;0;0;0;0
FR;12;2021-05-03;0;0;0;0;0;0;0;0;0;0;0;0;0;0;0;0;0;0
FR;12;2021-05-04;0;0;0;0;0;0;0;0;0;0;0;0;0;0;0;0;0;0
FR;12;2021-05-05;0;0;0;0;0;0;0;0;0;0;0;0;0;0;0;0;0;0
FR;12;2021-05-06;0;0;0;0;0;0;0;0;0;0;0;0;0;0;0;0;0;0
FR;12;2021-05-07;0;0;0;0;0;0;0;0;0;0;0;0;0;0;0;0;0;0
FR;12;2021-05-08;0;0;0;0;0;0;0;0;0;0;0;0;0;0;0;0;0;0
FR;12;2021-05-09;0;0;0;0;0;0;0;0;0;0;0;0;0;0;0;0;0;0
FR;12;2021-05-10;0;0;0;0;0;0;0;0;0;0;0;0;0;0;0;0;0;0
FR;12;2021-05-11;0;0;0;0;0;0;0;0;0;0;0;0;0;0;0;0;0;0
FR;12;2021-05-12;0;0;0;0;0;0;0;0;0;0;0;0;0;0;0;0;0;0
FR;12;2021-05-13;0;0;0;0;0;0;0;0;0;0;0;0;0;0;0;0;0;0
FR;12;2021-05-14;0;0;0;0;0;0;0;0;0;0;0;0;0;0;0;0;0;0
FR;12;2021-05-15;0;0;0;0;0;0;0;0;0;0;0;0;0;0;0;0;0;0
FR;12;2021-05-16;0;0;0;0;0;0;0;0;0;0;0;0;0;0;0;0;0;0
FR;12;2021-05-17;0;0;0;0;0;0;0;0;0;0;0;0;0;0;0;0;0;0
FR;12;2021-05-18;0;0;0;0;0;0;0;0;0;0;0;0;0;0;0;0;0;0
FR;12;2021-05-19;0;0;0;0;0;0;0;0;0;0;0;0;0;0;0;0;0;0
FR;12;2021-05-20;0;0;0;0;0;0;0;0;0;0;0;0;0;0;0;0;0;0
FR;12;2021-05-21;0;0;0;0;0;0;0;0;0;0;0;0;0;0;0;0;0;0
FR;12;2021-05-22;0;0;0;0;0;0;0;0;0;0;0;0;0;0;0;0;0;0
FR;12;2021-05-23;0;0;0;0;0;0;0;0;0;0;0;0;0;0;0;0;0;0
FR;12;2021-05-24;0;0;0;0;0;0;0;0;0;0;0;0;0;0;0;0;0;0
FR;12;2021-05-25;0;0;0;0;0;0;0;0;0;0;0;0;0;0;0;0;0;0
FR;12;2021-05-26;0;0;0;0;0;0;0;0;0;0;0;0;0;0;0;0;0;0
FR;12;2021-05-27;0;0;0;0;0;0;0;0;0;0;0;0;0;0;0;0;0;0
FR;12;2021-05-28;0;0;0;0;0;0;0;0;0;0;0;0;0;0;0;0;0;0
FR;12;2021-05-29;0;0;0;0;0;0;0;0;0;0;0;0;0;0;0;0;0;0
FR;12;2021-05-30;0;0;0;0;0;0;0;0;0;0;0;0;0;0;0;0;0;0
FR;12;2021-05-31;0;0;0;0;0;0;0;0;0;0;0;0;0;0;0;0;0;0
FR;12;2021-06-01;0;0;0;0;0;0;0;0;0;0;0;0;0;0;0;0;0;0
FR;12;2021-06-02;0;0;0;0;0;0;0;0;0;0;0;0;0;0;0;0;0;0
FR;12;2021-06-03;0;0;0;0;0;0;0;0;0;0;0;0;0;0;0;0;0;0
FR;12;2021-06-04;0;0;0;0;0;0;0;0;0;0;0;0;0;0;0;0;0;0
FR;12;2021-06-05;0;0;0;0;0;0;0;0;0;0;0;0;0;0;0;0;0;0
FR;12;2021-06-06;0;0;0;0;0;0;0;0;0;0;0;0;0;0;0;0;0;0
FR;12;2021-06-07;0;0;0;0;0;0;0;0;0;0;0;0;0;0;0;0;0;0
FR;12;2021-06-08;0;0;0;0;0;0;0;0;0;0;0;0;0;0;0;0;0;0
FR;12;2021-06-09;0;0;0;0;0;0;0;0;0;0;0;0;0;0;0;0;0;0
FR;12;2021-06-10;0;0;0;0;0;0;0;0;0;0;0;0;0;0;0;0;0;0
FR;12;2021-06-11;0;0;0;0;0;0;0;0;0;0;0;0;0;0;0;0;0;0
FR;12;2021-06-12;0;0;0;0;0;0;0;0;0;0;0;0;0;0;0;0;0;0
FR;12;2021-06-13;0;0;0;0;0;0;0;0;0;0;0;0;0;0;0;0;0;0
FR;12;2021-06-14;0;0;0;0;0;0;0;0;0;0;0;0;0;0;0;0;0;0
FR;12;2021-06-15;0;0;0;0;0;0;0;0;0;0;0;0;0;0;0;0;0;0
FR;12;2021-06-16;0;0;0;0;0;0;0;0;0;0;0;0;0;0;0;0;0;0
FR;12;2021-06-17;0;0;0;0;0;0;0;0;0;0;0;0;0;0;0;0;0;0
FR;12;2021-06-18;0;0;0;0;0;0;0;0;0;0;0;0;0;0;0;0;0;0
FR;12;2021-06-19;0;0;0;0;0;0;0;0;0;0;0;0;0;0;0;0;0;0
FR;12;2021-06-20;0;0;0;0;0;0;0;0;0;0;0;0;0;0;0;0;0;0
FR;12;2021-06-21;0;0;0;0;0;0;0;0;0;0;0;0;0;0;0;0;0;0
FR;12;2021-06-22;0;0;0;0;0;0;0;0;0;0;0;0;0;0;0;0;0;0
FR;12;2021-06-23;0;0;0;0;0;0;0;0;0;0;0;0;0;0;0;0;0;0
FR;12;2021-06-24;0;0;0;0;0;0;0;0;0;0;0;0;0;0;0;0;0;0
FR;12;2021-06-25;0;0;0;0;0;0;0;0;0;0;0;0;0;0;0;0;0;0
FR;12;2021-06-26;0;0;0;0;0;0;0;0;0;0;0;0;0;0;0;0;0;0
FR;12;2021-06-27;0;0;0;0;0;0;0;0;0;0;0;0;0;0;0;0;0;0
FR;12;2021-06-28;0;0;0;0;0;0;0;0;0;0;0;0;0;0;0;0;0;0
FR;12;2021-06-29;0;0;0;0;0;0;0;0;0;0;0;0;0;0;0;0;0;0
FR;12;2021-06-30;0;0;0;0;0;0;0;0;0;0;0;0;0;0;0;0;0;0
FR;12;2021-07-01;0;0;0;0;0;0;0;0;0;0;0;0;0;0;0;0;0;0
FR;12;2021-07-02;0;0;0;0;0;0;0;0;0;0;0;0;0;0;0;0;0;0
FR;12;2021-07-03;0;0;0;0;0;0;0;0;0;0;0;0;0;0;0;0;0;0
FR;12;2021-07-04;0;0;0;0;0;0;0;0;0;0;0;0;0;0;0;0;0;0
FR;12;2021-07-05;0;0;0;0;0;0;0;0;0;0;0;0;0;0;0;0;0;0
FR;12;2021-07-06;0;0;0;0;0;0;0;0;0;0;0;0;0;0;0;0;0;0
FR;12;2021-07-07;0;0;0;0;0;0;0;0;0;0;0;0;0;0;0;0;0;0
FR;12;2021-07-08;0;0;0;0;0;0;0;0;0;0;0;0;0;0;0;0;0;0
FR;12;2021-07-09;0;0;0;0;0;0;0;0;0;0;0;0;0;0;0;0;0;0
FR;12;2021-07-10;0;0;0;0;0;0;0;0;0;0;0;0;0;0;0;0;0;0
FR;12;2021-07-11;0;0;0;0;0;0;0;0;0;0;0;0;0;0;0;0;0;0
FR;12;2021-07-12;0;0;0;0;0;0;0;0;0;0;0;0;0;0;0;0;0;0
FR;12;2021-07-13;0;0;0;0;0;0;0;0;0;0;0;0;0;0;0;0;0;0
FR;12;2021-07-14;0;0;0;0;0;0;0;0;0;0;0;0;0;0;0;0;0;0
FR;12;2021-07-15;0;0;0;0;0;0;0;0;0;0;0;0;0;0;0;0;0;0
FR;12;2021-07-16;0;0;0;0;0;0;0;0;0;0;0;0;0;0;0;0;0;0
FR;12;2021-07-17;0;0;0;0;0;0;0;0;0;0;0;0;0;0;0;0;0;0
FR;12;2021-07-18;0;0;0;0;0;0;0;0;0;0;0;0;0;0;0;0;0;0
FR;12;2021-07-19;0;0;0;0;0;0;0;0;0;0;0;0;0;0;0;0;0;0
FR;12;2021-07-20;0;0;0;0;0;0;0;0;0;0;0;0;0;0;0;0;0;0
FR;12;2021-07-21;0;0;0;0;0;0;0;0;0;0;0;0;0;0;0;0;0;0
FR;12;2021-07-22;0;0;0;0;0;0;0;0;0;0;0;0;0;0;0;0;0;0
FR;12;2021-07-23;0;0;0;0;0;0;0;0;0;0;0;0;0;0;0;0;0;0
FR;12;2021-07-24;0;0;0;0;0;0;0;0;0;0;0;0;0;0;0;0;0;0
FR;12;2021-07-25;0;0;0;0;0;0;0;0;0;0;0;0;0;0;0;0;0;0
FR;12;2021-07-26;0;0;0;0;0;0;0;0;0;0;0;0;0;0;0;0;0;0
FR;12;2021-07-27;0;0;0;0;0;0;0;0;0;0;0;0;0;0;0;0;0;0
FR;12;2021-07-28;0;0;0;0;0;0;0;0;0;0;0;0;0;0;0;0;0;0
FR;12;2021-07-29;0;0;0;0;0;0;0;0;0;0;0;0;0;0;0;0;0;0
FR;12;2021-07-30;0;0;0;0;0;0;0;0;0;0;0;0;0;0;0;0;0;0
FR;12;2021-07-31;0;0;0;0;0;0;0;0;0;0;0;0;0;0;0;0;0;0
FR;12;2021-08-01;0;0;0;0;0;0;0;0;0;0;0;0;0;0;0;0;0;0
FR;12;2021-08-02;0;0;0;0;0;0;0;0;0;0;0;0;0;0;0;0;0;0
FR;12;2021-08-03;0;0;0;0;0;0;0;0;0;0;0;0;0;0;0;0;0;0
FR;12;2021-08-04;0;0;0;0;0;0;0;0;0;0;0;0;0;0;0;0;0;0
FR;12;2021-08-05;0;0;0;0;0;0;0;0;0;0;0;0;0;0;0;0;0;0
FR;12;2021-08-06;0;0;0;0;0;0;0;0;0;0;0;0;0;0;0;0;0;0
FR;12;2021-08-07;0;0;0;0;0;0;0;0;0;0;0;0;0;0;0;0;0;0
FR;12;2021-08-08;0;0;0;0;0;0;0;0;0;0;0;0;0;0;0;0;0;0
FR;12;2021-08-09;0;0;0;0;0;0;0;0;0;0;0;0;0;0;0;0;0;0
FR;12;2021-08-10;0;0;0;0;0;0;0;0;0;0;0;0;0;0;0;0;0;0
FR;12;2021-08-11;0;0;0;0;0;0;0;0;0;0;0;0;0;0;0;0;0;0
FR;12;2021-08-12;0;0;0;0;0;0;0;0;0;0;0;0;0;0;0;0;0;0
FR;12;2021-08-13;0;0;0;0;0;0;0;0;0;0;0;0;0;0;0;0;0;0
FR;12;2021-08-14;0;0;0;0;0;0;0;0;0;0;0;0;0;0;0;0;0;0
FR;12;2021-08-15;0;0;0;0;0;0;0;0;0;0;0;0;0;0;0;0;0;0
FR;12;2021-08-16;0;0;0;0;0;0;0;0;0;0;0;0;0;0;0;0;0;0
FR;12;2021-08-17;0;0;0;0;0;0;0;0;0;0;0;0;0;0;0;0;0;0
FR;12;2021-08-18;0;0;0;0;0;0;0;0;0;0;0;0;0;0;0;0;0;0
FR;12;2021-08-19;0;0;0;0;0;0;0;0;0;0;0;0;0;0;0;0;0;0
FR;12;2021-08-20;0;0;0;0;0;0;0;0;0;0;0;0;0;0;0;0;0;0
FR;12;2021-08-21;0;0;0;0;0;0;0;0;0;0;0;0;0;0;0;0;0;0
FR;12;2021-08-22;0;0;0;0;0;0;0;0;0;0;0;0;0;0;0;0;0;0
FR;12;2021-08-23;0;0;0;0;0;0;0;0;0;0;0;0;0;0;0;0;0;0
FR;12;2021-08-24;0;0;0;0;0;0;0;0;0;0;0;0;0;0;0;0;0;0
FR;12;2021-08-25;0;0;0;0;0;0;0;0;0;0;0;0;0;0;0;0;0;0
FR;12;2021-08-26;0;0;0;0;0;0;0;0;0;0;0;0;0;0;0;0;0;0
FR;12;2021-08-27;0;0;0;0;0;0;0;0;0;0;0;0;0;0;0;0;0;0
FR;12;2021-08-28;0;0;0;0;0;0;0;0;0;0;0;0;0;0;0;0;0;0
FR;12;2021-08-29;0;0;0;0;0;0;0;0;0;0;0;0;0;0;0;0;0;0
FR;12;2021-08-30;0;0;0;0;0;0;0;0;0;0;0;0;0;0;0;0;0;0
FR;12;2021-08-31;0;0;0;0;0;0;0;0;0;0;0;0;0;0;0;0;0;0
FR;12;2021-09-01;0;0;0;0;0;0;0;0;0;0;0;0;0;0;0;0;0;0
FR;12;2021-09-02;0;0;0;0;0;0;0;0;0;0;0;0;0;0;0;0;0;0
FR;12;2021-09-03;0;0;0;0;0;0;0;0;0;0;0;0;0;0;0;0;0;0
FR;12;2021-09-04;0;0;0;0;0;0;0;0;0;0;0;0;0;0;0;0;0;0
FR;12;2021-09-05;0;0;0;0;0;0;0;0;0;0;0;0;0;0;0;0;0;0
FR;12;2021-09-06;0;0;0;0;0;0;0;0;0;0;0;0;0;0;0;0;0;0
FR;12;2021-09-07;0;0;0;0;0;0;0;0;0;0;0;0;0;0;0;0;0;0
FR;12;2021-09-08;0;0;0;0;0;0;0;0;0;0;0;0;0;0;0;0;0;0
FR;12;2021-09-09;0;0;0;0;0;0;0;0;0;0;0;0;0;0;0;0;0;0
FR;12;2021-09-10;0;0;0;0;0;0;0;0;0;0;0;0;0;0;0;0;0;0
FR;12;2021-09-11;0;0;0;0;0;0;0;0;0;0;0;0;0;0;0;0;0;0
FR;12;2021-09-12;0;0;0;0;0;0;0;0;0;0;0;0;0;0;0;0;0;0
FR;12;2021-09-13;0;0;0;0;0;0;0;0;0;0;0;0;0;0;0;0;0;0
FR;12;2021-09-14;0;0;0;0;0;0;0;0;0;0;0;0;0;0;0;0;0;0
FR;12;2021-09-15;0;0;0;0;0;0;0;0;0;0;0;0;0;0;0;0;0;0
FR;12;2021-09-16;0;0;0;0;0;0;0;0;0;0;0;0;0;0;0;0;0;0
FR;12;2021-09-17;0;0;0;0;0;0;0;0;0;0;0;0;0;0;0;0;0;0
FR;12;2021-09-18;0;0;0;0;0;0;0;0;0;0;0;0;0;0;0;0;0;0
FR;12;2021-09-19;0;0;0;0;0;0;0;0;0;0;0;0;0;0;0;0;0;0
FR;12;2021-09-20;0;0;0;0;0;0;0;0;0;0;0;0;0;0;0;0;0;0
FR;12;2021-09-21;0;0;0;0;0;0;0;0;0;0;0;0;0;0;0;0;0;0
FR;12;2021-09-22;0;0;0;0;0;0;0;0;0;0;0;0;0;0;0;0;0;0
FR;12;2021-09-23;0;0;0;0;0;0;0;0;0;0;0;0;0;0;0;0;0;0
FR;12;2021-09-24;0;0;0;0;0;0;0;0;0;0;0;0;0;0;0;0;0;0
FR;12;2021-09-25;0;0;0;0;0;0;0;0;0;0;0;0;0;0;0;0;0;0
FR;12;2021-09-26;0;0;0;0;0;0;0;0;0;0;0;0;0;0;0;0;0;0
FR;12;2021-09-27;0;0;0;0;0;0;0;0;0;0;0;0;0;0;0;0;0;0
FR;12;2021-09-28;0;0;0;0;0;0;0;0;0;0;0;0;0;0;0;0;0;0
FR;12;2021-09-29;0;0;0;0;0;0;0;0;0;0;0;0;0;0;0;0;0;0
FR;12;2021-09-30;0;0;0;0;0;0;0;0;0;0;0;0;0;0;0;0;0;0
FR;12;2021-10-01;0;0;0;0;0;0;0;0;0;0;0;0;0;0;0;0;0;0
FR;12;2021-10-02;0;0;0;0;0;0;0;0;0;0;0;0;0;0;0;0;0;0
FR;12;2021-10-03;0;0;0;0;0;0;0;0;0;0;0;0;0;0;0;0;0;0
FR;12;2021-10-04;0;0;0;0;0;0;0;0;0;0;0;0;0;0;0;0;0;0
FR;12;2021-10-05;0;0;0;0;0;0;0;0;0;0;0;0;0;0;0;0;0;0
FR;12;2021-10-06;0;0;0;0;0;0;0;0;0;0;0;0;0;0;0;0;0;0
FR;12;2021-10-07;0;0;0;0;0;0;0;0;0;0;0;0;0;0;0;0;0;0
FR;12;2021-10-08;0;0;0;0;0;0;0;0;0;0;0;0;0;0;0;0;0;0
FR;12;2021-10-09;0;0;0;0;0;0;0;0;0;0;0;0;0;0;0;0;0;0
FR;12;2021-10-10;0;0;0;0;0;0;0;0;0;0;0;0;0;0;0;0;0;0
FR;12;2021-10-11;0;0;0;0;0;0;0;0;0;0;0;0;0;0;0;0;0;0
FR;12;2021-10-12;0;0;0;0;0;0;0;0;0;0;0;0;0;0;0;0;0;0
FR;12;2021-10-13;0;0;0;0;0;0;0;0;0;0;0;0;0;0;0;0;0;0
FR;12;2021-10-14;0;0;0;0;0;0;0;0;0;0;0;0;0;0;0;0;0;0
FR;12;2021-10-15;0;0;0;0;0;0;0;0;0;0;0;0;0;0;0;0;0;0
FR;12;2021-10-16;0;0;0;0;0;0;0;0;0;0;0;0;0;0;0;0;0;0
FR;12;2021-10-17;0;0;0;0;0;0;0;0;0;0;0;0;0;0;0;0;0;0
FR;12;2021-10-18;0;0;0;0;0;0;0;0;0;0;0;0;0;0;0;0;0;0
FR;12;2021-10-19;0;0;0;0;0;0;0;0;0;0;0;0;0;0;0;0;0;0
FR;12;2021-10-20;0;0;0;0;0;0;0;0;0;0;0;0;0;0;0;0;0;0
FR;12;2021-10-21;0;0;0;0;0;0;0;0;0;0;0;0;0;0;0;0;0;0
FR;12;2021-10-22;0;0;0;0;0;0;0;0;0;0;0;0;0;0;0;0;0;0
FR;12;2021-10-23;0;0;0;0;0;0;0;0;0;0;0;0;0;0;0;0;0;0
FR;12;2021-10-24;0;0;0;0;0;0;0;0;0;0;0;0;0;0;0;0;0;0
FR;12;2021-10-25;0;0;0;0;0;0;0;0;0;0;0;0;0;0;0;0;0;0
FR;12;2021-10-26;0;0;0;0;0;0;0;0;0;0;0;0;0;0;0;0;0;0
FR;12;2021-10-27;0;0;0;0;0;0;0;0;0;0;0;0;0;0;0;0;0;0
FR;12;2021-10-28;0;0;0;0;0;0;0;0;0;0;0;0;0;0;0;0;0;0
FR;12;2021-10-29;0;0;0;0;0;0;0;0;0;0;0;0;0;0;0;0;0;0
FR;12;2021-10-30;0;0;0;0;0;0;0;0;0;0;0;0;0;0;0;0;0;0
FR;12;2021-10-31;0;0;0;0;0;0;0;0;0;0;0;0;0;0;0;0;0;0
FR;12;2021-11-01;0;0;0;0;0;0;0;0;0;0;0;0;0;0;0;0;0;0
FR;12;2021-11-02;0;0;0;0;0;0;0;0;0;0;0;0;0;0;0;0;0;0
FR;12;2021-11-03;0;0;0;0;0;0;0;0;0;0;0;0;0;0;0;0;0;0
FR;12;2021-11-04;0;0;0;0;0;0;0;0;0;0;0;0;0;0;0;0;0;0
FR;12;2021-11-05;0;0;0;0;0;0;0;0;0;0;0;0;0;0;0;0;0;0
FR;12;2021-11-06;0;0;0;0;0;0;0;0;0;0;0;0;0;0;0;0;0;0
FR;12;2021-11-07;0;0;0;0;0;0;0;0;0;0;0;0;0;0;0;0;0;0
FR;12;2021-11-08;0;0;0;0;0;0;0;0;0;0;0;0;0;0;0;0;0;0
FR;12;2021-11-09;0;0;0;0;0;0;0;0;0;0;0;0;0;0;0;0;0;0
FR;12;2021-11-10;0;0;0;0;0;0;0;0;0;0;0;0;0;0;0;0;0;0
FR;12;2021-11-11;0;0;0;0;0;0;0;0;0;0;0;0;0;0;0;0;0;0
FR;12;2021-11-12;0;0;0;0;0;0;0;0;0;0;0;0;0;0;0;0;0;0
FR;12;2021-11-13;0;0;0;0;0;0;0;0;0;0;0;0;0;0;0;0;0;0
FR;12;2021-11-14;0;0;0;0;0;0;0;0;0;0;0;0;0;0;0;0;0;0
FR;12;2021-11-15;0;0;0;0;0;0;0;0;0;0;0;0;0;0;0;0;0;0
FR;12;2021-11-16;0;0;0;0;0;0;0;0;0;0;0;0;0;0;0;0;0;0
FR;12;2021-11-17;0;0;0;0;0;0;0;0;0;0;0;0;0;0;0;0;0;0
FR;12;2021-11-18;0;0;0;0;0;0;0;0;0;0;0;0;0;0;0;0;0;0
FR;12;2021-11-19;0;0;0;0;0;0;0;0;0;0;0;0;0;0;0;0;0;0
FR;12;2021-11-20;0;0;0;0;0;0;0;0;0;0;0;0;0;0;0;0;0;0
FR;12;2021-11-21;0;0;0;0;0;0;0;0;0;0;0;0;0;0;0;0;0;0
FR;12;2021-11-22;0;0;0;0;0;0;0;0;0;0;0;0;0;0;0;0;0;0
FR;12;2021-11-23;0;0;0;0;0;0;0;0;0;0;0;0;0;0;0;0;0;0
FR;12;2021-11-24;0;0;0;0;0;0;0;0;0;0;0;0;0;0;0;0;0;0
FR;12;2021-11-25;0;0;0;0;0;0;0;0;0;0;0;0;0;0;0;0;0;0
FR;12;2021-11-26;0;0;0;0;0;0;0;0;0;0;0;0;0;0;0;0;0;0
FR;12;2021-11-27;0;0;0;0;0;0;0;0;0;0;0;0;0;0;0;0;0;0
FR;12;2021-11-28;0;0;0;0;0;0;0;0;0;0;0;0;0;0;0;0;0;0
FR;12;2021-11-29;0;0;0;0;0;0;0;0;0;0;0;0;0;0;0;0;0;0
FR;12;2021-11-30;0;0;0;0;0;0;0;0;0;0;0;0;0;0;0;0;0;0
FR;12;2021-12-01;0;0;0;0;0;0;0;0;0;0;0;0;0;0;0;0;0;0
FR;12;2021-12-02;0;0;0;0;0;0;0;0;0;0;0;0;0;0;0;0;0;0
FR;12;2021-12-03;0;0;0;0;0;0;0;0;0;0;0;0;0;0;0;0;0;0
FR;12;2021-12-04;0;0;0;0;0;0;0;0;0;0;0;0;0;0;0;0;0;0
FR;12;2021-12-05;0;0;0;0;0;0;0;0;0;0;0;0;0;0;0;0;0;0
FR;12;2021-12-06;0;0;0;0;0;0;0;0;0;0;0;0;0;0;0;0;0;0
FR;12;2021-12-07;0;0;0;0;0;0;0;0;0;0;0;0;0;0;0;0;0;0
FR;12;2021-12-08;0;0;0;0;0;0;0;0;0;0;0;0;0;0;0;0;0;0
FR;12;2021-12-09;0;0;0;0;0;0;0;0;0;0;0;0;0;0;0;0;0;0
FR;12;2021-12-10;0;0;0;0;0;0;0;0;0;0;0;0;0;0;0;0;0;0
FR;12;2021-12-11;0;0;0;0;0;0;0;0;0;0;0;0;0;0;0;0;0;0
FR;12;2021-12-12;0;0;0;0;0;0;0;0;0;0;0;0;0;0;0;0;0;0
FR;12;2021-12-13;0;0;0;0;0;0;0;0;0;0;0;0;0;0;0;0;0;0
FR;12;2021-12-14;0;0;0;0;0;0;0;0;0;0;0;0;0;0;0;0;0;0
FR;12;2021-12-15;0;0;0;0;0;0;0;0;0;0;0;0;0;0;0;0;0;0
FR;12;2021-12-16;0;0;0;0;0;0;0;0;0;0;0;0;0;0;0;0;0;0
FR;12;2021-12-17;0;0;0;0;0;0;0;0;0;0;0;0;0;0;0;0;0;0
FR;12;2021-12-18;0;0;0;0;0;0;0;0;0;0;0;0;0;0;0;0;0;0
FR;12;2021-12-19;0;0;0;0;0;0;0;0;0;0;0;0;0;0;0;0;0;0
FR;12;2021-12-20;0;0;0;0;0;0;0;0;0;0;0;0;0;0;0;0;0;0
FR;12;2021-12-21;0;0;0;0;0;0;0;0;0;0;0;0;0;0;0;0;0;0
FR;12;2021-12-22;0;0;0;0;0;0;0;0;0;0;0;0;0;0;0;0;0;0
FR;12;2021-12-23;0;0;0;0;0;0;0;0;0;0;0;0;0;0;0;0;0;0
FR;12;2021-12-24;0;0;0;0;0;0;0;0;0;0;0;0;0;0;0;0;0;0
FR;12;2021-12-25;0;0;0;0;0;0;0;0;0;0;0;0;0;0;0;0;0;0
FR;12;2021-12-26;0;0;0;0;0;0;0;0;0;0;0;0;0;0;0;0;0;0
FR;12;2021-12-27;0;0;0;0;0;0;0;0;0;0;0;0;0;0;0;0;0;0
FR;12;2021-12-28;0;0;0;0;0;0;0;0;0;0;0;0;0;0;0;0;0;0
FR;12;2021-12-29;0;0;0;0;0;0;0;0;0;0;0;0;0;0;0;0;0;0
FR;12;2021-12-30;0;0;0;0;0;0;0;0;0;0;0;0;0;0;0;0;0;0
FR;12;2021-12-31;0;0;0;0;0;0;0;0;0;0;0;0;0;0;0;0;0;0
FR;12;2022-01-01;0;0;0;0;0;0;0;0;0;0;0;0;0;0;0;0;0;0
FR;12;2022-01-02;0;0;0;0;0;0;0;0;0;0;0;0;0;0;0;0;0;0
FR;12;2022-01-03;0;0;0;0;0;0;0;0;0;0;0;0;0;0;0;0;0;0
FR;12;2022-01-04;0;0;0;0;0;0;0;0;0;0;0;0;0;0;0;0;0;0
FR;12;2022-01-05;0;0;0;0;0;0;0;0;0;0;0;0;0;0;0;0;0;0
FR;12;2022-01-06;0;0;0;0;0;0;0;0;0;0;0;0;0;0;0;0;0;0
FR;12;2022-01-07;0;0;0;0;0;0;0;0;0;0;0;0;0;0;0;0;0;0
FR;12;2022-01-08;0;0;0;0;0;0;0;0;0;0;0;0;0;0;0;0;0;0
FR;12;2022-01-09;0;0;0;0;0;0;0;0;0;0;0;0;0;0;0;0;0;0
FR;12;2022-01-10;0;0;0;0;0;0;0;0;0;0;0;0;0;0;0;0;0;0
FR;12;2022-01-11;0;0;0;0;0;0;0;0;0;0;0;0;0;0;0;0;0;0
FR;12;2022-01-12;0;0;0;0;0;0;0;0;0;0;0;0;0;0;0;0;0;0
FR;12;2022-01-13;0;0;0;0;0;0;0;0;0;0;0;0;0;0;0;0;0;0
FR;12;2022-01-14;0;0;0;0;0;0;0;0;0;0;0;0;0;0;0;0;0;0
FR;12;2022-01-15;0;0;0;0;0;0;0;0;0;0;0;0;0;0;0;0;0;0
FR;12;2022-01-16;0;0;0;0;0;0;0;0;0;0;0;0;0;0;0;0;0;0
FR;12;2022-01-17;0;0;0;0;0;0;0;0;0;0;0;0;0;0;0;0;0;0
FR;12;2022-01-18;0;0;0;0;0;0;0;0;0;0;0;0;0;0;0;0;0;0
FR;12;2022-01-19;0;0;0;0;0;0;0;0;0;0;0;0;0;0;0;0;0;0
FR;12;2022-01-20;0;0;0;0;0;0;0;0;0;0;0;0;0;0;0;0;0;0
FR;12;2022-01-21;0;0;0;0;0;0;0;0;0;0;0;0;0;0;0;0;0;0
FR;12;2022-01-22;0;0;0;0;0;0;0;0;0;0;0;0;0;0;0;0;0;0
FR;12;2022-01-23;0;0;0;0;0;0;0;0;0;0;0;0;0;0;0;0;0;0
FR;12;2022-01-24;0;0;0;0;0;0;0;0;0;0;0;0;0;0;0;0;0;0
FR;12;2022-01-25;0;0;0;0;0;0;0;0;0;0;0;0;0;0;0;0;0;0
FR;12;2022-01-26;0;0;0;0;0;0;0;0;0;0;0;0;0;0;0;0;0;0
FR;12;2022-01-27;0;0;0;0;0;0;0;0;0;0;0;0;0;0;0;0;0;0
FR;12;2022-01-28;0;0;0;0;0;0;0;0;0;0;0;0;0;0;0;0;0;0
FR;12;2022-01-29;0;0;0;0;0;0;0;0;0;0;0;0;0;0;0;0;0;0
FR;12;2022-01-30;0;0;0;0;0;0;0;0;0;0;0;0;0;0;0;0;0;0
FR;12;2022-01-31;0;0;0;0;0;0;0;0;0;0;0;0;0;0;0;0;0;0
FR;12;2022-02-01;0;0;0;0;0;0;0;0;0;0;0;0;0;0;0;0;0;0
FR;12;2022-02-02;0;0;0;0;0;0;0;0;0;0;0;0;0;0;0;0;0;0
FR;12;2022-02-03;0;0;0;0;0;0;0;0;0;0;0;0;0;0;0;0;0;0
FR;12;2022-02-04;0;0;0;0;0;0;0;0;0;0;0;0;0;0;0;0;0;0
FR;12;2022-02-05;0;0;0;0;0;0;0;0;0;0;0;0;0;0;0;0;0;0
FR;12;2022-02-06;0;0;0;0;0;0;0;0;0;0;0;0;0;0;0;0;0;0
FR;12;2022-02-07;0;0;0;0;0;0;0;0;0;0;0;0;0;0;0;0;0;0
FR;12;2022-02-08;0;0;0;0;0;0;0;0;0;0;0;0;0;0;0;0;0;0
FR;12;2022-02-09;0;0;0;0;0;0;0;0;0;0;0;0;0;0;0;0;0;0
FR;12;2022-02-10;0;0;0;0;0;0;0;0;0;0;0;0;0;0;0;0;0;0
FR;12;2022-02-11;0;0;0;0;0;0;0;0;0;0;0;0;0;0;0;0;0;0
FR;12;2022-02-12;0;0;0;0;0;0;0;0;0;0;0;0;0;0;0;0;0;0
FR;12;2022-02-13;0;0;0;0;0;0;0;0;0;0;0;0;0;0;0;0;0;0
FR;12;2022-02-14;0;0;0;0;0;0;0;0;0;0;0;0;0;0;0;0;0;0
FR;12;2022-02-15;0;0;0;0;0;0;0;0;0;0;0;0;0;0;0;0;0;0
FR;12;2022-02-16;0;0;0;0;0;0;0;0;0;0;0;0;0;0;0;0;0;0
FR;12;2022-02-17;0;0;0;0;0;0;0;0;0;0;0;0;0;0;0;0;0;0
FR;12;2022-02-18;0;0;0;0;0;0;0;0;0;0;0;0;0;0;0;0;0;0
FR;12;2022-02-19;0;0;0;0;0;0;0;0;0;0;0;0;0;0;0;0;0;0
FR;12;2022-02-20;0;0;0;0;0;0;0;0;0;0;0;0;0;0;0;0;0;0
FR;12;2022-02-21;0;0;0;0;0;0;0;0;0;0;0;0;0;0;0;0;0;0
FR;12;2022-02-22;0;0;0;0;0;0;0;0;0;0;0;0;0;0;0;0;0;0
FR;12;2022-02-23;0;0;0;0;0;0;0;0;0;0;0;0;0;0;0;0;0;0
FR;12;2022-02-24;0;0;0;0;0;0;0;0;0;0;0;0;0;0;0;0;0;0
FR;12;2022-02-25;0;0;0;0;0;0;0;0;0;0;0;0;0;0;0;0;0;0
FR;12;2022-02-26;0;0;0;0;0;0;0;0;0;0;0;0;0;0;0;0;0;0
FR;12;2022-02-27;0;0;0;0;0;0;0;0;0;0;0;0;0;0;0;0;0;0
FR;12;2022-02-28;0;0;0;0;0;0;0;0;0;0;0;0;0;0;0;0;0;0
FR;12;2022-03-01;0;0;0;0;0;0;0;0;0;0;0;0;0;0;0;0;0;0
FR;12;2022-03-02;0;0;0;0;0;0;0;0;0;0;0;0;0;0;0;0;0;0
FR;12;2022-03-03;0;0;0;0;0;0;0;0;0;0;0;0;0;0;0;0;0;0
FR;12;2022-03-04;0;0;0;0;0;0;0;0;0;0;0;0;0;0;0;0;0;0
FR;12;2022-03-05;0;0;0;0;0;0;0;0;0;0;0;0;0;0;0;0;0;0
FR;12;2022-03-06;0;0;0;0;0;0;0;0;0;0;0;0;0;0;0;0;0;0
FR;12;2022-03-07;0;0;0;0;0;0;0;0;0;0;0;0;0;0;0;0;0;0
FR;12;2022-03-08;0;0;0;0;0;0;0;0;0;0;0;0;0;0;0;0;0;0
FR;12;2022-03-09;0;0;0;0;0;0;0;0;0;0;0;0;0;0;0;0;0;0
FR;12;2022-03-10;0;0;0;0;0;0;0;0;0;0;0;0;0;0;0;0;0;0
FR;12;2022-03-11;0;0;0;0;0;0;0;0;0;0;0;0;0;0;0;0;0;0
FR;12;2022-03-12;0;0;0;0;0;0;0;0;0;0;0;0;0;0;0;0;0;0
FR;12;2022-03-13;0;0;0;0;0;0;0;0;0;0;0;0;0;0;0;0;0;0
FR;12;2022-03-14;0;0;0;0;0;0;0;0;0;0;0;0;0;0;0;0;0;0
FR;12;2022-03-15;0;0;0;0;0;0;0;0;0;0;0;0;0;0;0;0;0;0
FR;12;2022-03-16;0;0;0;0;0;0;0;0;0;0;0;0;0;0;0;0;0;0
FR;12;2022-03-17;0;0;0;0;0;0;0;0;0;0;0;0;0;0;0;0;0;0
FR;12;2022-03-18;0;0;0;0;0;0;0;0;0;0;0;0;0;0;0;0;0;0
FR;12;2022-03-19;0;0;0;0;0;0;0;0;0;0;0;0;0;0;0;0;0;0
FR;12;2022-03-20;0;0;0;0;0;0;0;0;0;0;0;0;0;0;0;0;0;0
FR;12;2022-03-21;0;0;0;0;0;0;0;0;0;0;0;0;0;0;0;0;0;0
FR;12;2022-03-22;0;0;0;0;0;0;0;0;0;0;0;0;0;0;0;0;0;0
FR;12;2022-03-23;0;0;0;0;0;0;0;0;0;0;0;0;0;0;0;0;0;0
FR;12;2022-03-24;0;0;0;0;0;0;0;0;0;0;0;0;0;0;0;0;0;0
FR;12;2022-03-25;0;0;0;0;0;0;0;0;0;0;0;0;0;0;0;0;0;0
FR;12;2022-03-26;0;0;0;0;0;0;0;0;0;0;0;0;0;0;0;0;0;0
FR;12;2022-03-27;0;0;0;0;0;0;0;0;0;0;0;0;0;0;0;0;0;0
FR;12;2022-03-28;0;0;0;0;0;0;0;0;0;0;0;0;0;0;0;0;0;0
FR;12;2022-03-29;0;0;0;0;0;0;0;0;0;0;0;0;0;0;0;0;0;0
FR;12;2022-03-30;0;0;0;0;0;0;0;0;0;0;0;0;0;0;0;0;0;0
FR;12;2022-03-31;0;0;0;0;0;0;0;0;0;0;0;0;0;0;0;0;0;0
FR;12;2022-04-01;0;0;0;0;0;0;0;0;0;0;0;0;0;0;0;0;0;0
FR;12;2022-04-02;0;0;0;0;0;0;0;0;0;0;0;0;0;0;0;0;0;0
FR;12;2022-04-03;0;0;0;0;0;0;0;0;0;0;0;0;0;0;0;0;0;0
FR;12;2022-04-04;0;0;0;0;0;0;0;0;0;0;0;0;0;0;0;0;0;0
FR;12;2022-04-05;0;0;0;0;0;0;0;0;0;0;0;0;0;0;0;0;0;0
FR;12;2022-04-06;0;0;0;0;0;0;0;0;0;0;0;0;0;0;0;0;0;0
FR;12;2022-04-07;0;0;0;0;0;0;0;0;0;0;0;0;0;0;0;0;0;0
FR;12;2022-04-08;0;0;0;0;0;0;0;0;0;0;0;0;0;0;0;0;0;0
FR;12;2022-04-09;0;0;0;0;0;0;0;0;0;0;0;0;0;0;0;0;0;0
FR;12;2022-04-10;0;0;0;0;0;0;0;0;0;0;0;0;0;0;0;0;0;0
FR;12;2022-04-11;0;0;0;0;0;0;0;0;0;0;0;0;0;0;0;0;0;0
FR;12;2022-04-12;0;0;0;0;0;0;0;0;0;0;0;0;0;0;0;0;0;0
FR;12;2022-04-13;0;0;0;0;0;0;0;0;0;0;0;0;0;0;0;0;0;0
FR;12;2022-04-14;0;0;0;0;0;0;0;0;0;0;0;0;0;0;0;0;0;0
FR;12;2022-04-15;0;0;0;0;0;0;0;0;0;0;0;0;0;0;0;0;0;0
FR;12;2022-04-16;0;0;0;0;0;0;0;0;0;0;0;0;0;0;0;0;0;0
FR;12;2022-04-17;0;0;0;0;0;0;0;0;0;0;0;0;0;0;0;0;0;0
FR;12;2022-04-18;0;0;0;0;0;0;0;0;0;0;0;0;0;0;0;0;0;0
FR;12;2022-04-19;0;0;0;0;0;0;0;0;0;0;0;0;0;0;0;0;0;0
FR;12;2022-04-20;0;0;0;0;0;0;0;0;0;0;0;0;0;0;0;0;0;0
FR;12;2022-04-21;0;0;0;0;0;0;0;0;0;0;0;0;0;0;0;0;0;0
FR;12;2022-04-22;0;0;0;0;0;0;0;0;0;0;0;0;0;0;0;0;0;0
FR;12;2022-04-23;0;0;0;0;0;0;0;0;0;0;0;0;0;0;0;0;0;0
FR;12;2022-04-24;0;0;0;0;0;0;0;0;0;0;0;0;0;0;0;0;0;0
FR;12;2022-04-25;0;0;0;0;0;0;0;0;0;0;0;0;0;0;0;0;0;0
FR;12;2022-04-26;0;0;0;0;0;0;0;0;0;0;0;0;0;0;0;0;0;0
FR;12;2022-04-27;0;0;0;0;0;0;0;0;0;0;0;0;0;0;0;0;0;0
FR;12;2022-04-28;0;0;0;0;0;0;0;0;0;0;0;0;0;0;0;0;0;0
FR;12;2022-04-29;0;0;0;0;0;0;0;0;0;0;0;0;0;0;0;0;0;0
FR;12;2022-04-30;0;0;0;0;0;0;0;0;0;0;0;0;0;0;0;0;0;0
FR;12;2022-05-01;0;0;0;0;0;0;0;0;0;0;0;0;0;0;0;0;0;0
FR;12;2022-05-02;0;0;0;0;0;0;0;0;0;0;0;0;0;0;0;0;0;0
FR;12;2022-05-03;0;0;0;0;0;0;0;0;0;0;0;0;0;0;0;0;0;0
FR;12;2022-05-04;0;0;0;0;0;0;0;0;0;0;0;0;0;0;0;0;0;0
FR;12;2022-05-05;0;0;0;0;0;0;0;0;0;0;0;0;0;0;0;0;0;0
FR;12;2022-05-06;0;0;0;0;0;0;0;0;0;0;0;0;0;0;0;0;0;0
FR;12;2022-05-07;0;0;0;0;0;0;0;0;0;0;0;0;0;0;0;0;0;0
FR;12;2022-05-08;0;0;0;0;0;0;0;0;0;0;0;0;0;0;0;0;0;0
FR;12;2022-05-09;0;0;0;0;0;0;0;0;0;0;0;0;0;0;0;0;0;0
FR;12;2022-05-10;0;0;0;0;0;0;0;0;0;0;0;0;0;0;0;0;0;0
FR;12;2022-05-11;0;0;0;0;0;0;0;0;0;0;0;0;0;0;0;0;0;0
FR;12;2022-05-12;0;0;0;0;0;0;0;0;0;0;0;0;0;0;0;0;0;0
FR;12;2022-05-13;0;0;0;0;0;0;0;0;0;0;0;0;0;0;0;0;0;0
FR;12;2022-05-14;0;0;0;0;0;0;0;0;0;0;0;0;0;0;0;0;0;0
FR;12;2022-05-15;0;0;0;0;0;0;0;0;0;0;0;0;0;0;0;0;0;0
FR;12;2022-05-16;0;0;0;0;0;0;0;0;0;0;0;0;0;0;0;0;0;0
FR;12;2022-05-17;0;0;0;0;0;0;0;0;0;0;0;0;0;0;0;0;0;0
FR;12;2022-05-18;0;0;0;0;0;0;0;0;0;0;0;0;0;0;0;0;0;0
FR;12;2022-05-19;0;0;0;0;0;0;0;0;0;0;0;0;0;0;0;0;0;0
FR;12;2022-05-20;0;0;0;0;0;0;0;0;0;0;0;0;0;0;0;0;0;0
FR;12;2022-05-21;0;0;0;0;0;0;0;0;0;0;0;0;0;0;0;0;0;0
FR;12;2022-05-22;0;0;0;0;0;0;0;0;0;0;0;0;0;0;0;0;0;0
FR;12;2022-05-23;0;0;0;0;0;0;0;0;0;0;0;0;0;0;0;0;0;0
FR;12;2022-05-24;0;0;0;0;0;0;0;0;0;0;0;0;0;0;0;0;0;0
FR;12;2022-05-25;0;0;0;0;0;0;0;0;0;0;0;0;0;0;0;0;0;0
FR;12;2022-05-26;0;0;0;0;0;0;0;0;0;0;0;0;0;0;0;0;0;0
FR;12;2022-05-27;0;0;0;0;0;0;0;0;0;0;0;0;0;0;0;0;0;0
FR;12;2022-05-28;0;0;0;0;0;0;0;0;0;0;0;0;0;0;0;0;0;0
FR;12;2022-05-29;0;0;0;0;0;0;0;0;0;0;0;0;0;0;0;0;0;0
FR;12;2022-05-30;0;0;0;0;0;0;0;0;0;0;0;0;0;0;0;0;0;0
FR;12;2022-05-31;0;0;0;0;0;0;0;0;0;0;0;0;0;0;0;0;0;0
FR;12;2022-06-01;0;0;0;0;0;0;0;0;0;0;0;0;0;0;0;0;0;0
FR;12;2022-06-02;0;0;0;0;0;0;0;0;0;0;0;0;0;0;0;0;0;0
FR;12;2022-06-03;0;0;0;0;0;0;0;0;0;0;0;0;0;0;0;0;0;0
FR;12;2022-06-04;0;0;0;0;0;0;0;0;0;0;0;0;0;0;0;0;0;0
FR;12;2022-06-05;0;0;0;0;0;0;0;0;0;0;0;0;0;0;0;0;0;0
FR;12;2022-06-06;0;0;0;0;0;0;0;0;0;0;0;0;0;0;0;0;0;0
FR;12;2022-06-07;0;0;0;0;0;0;0;0;0;0;0;0;0;0;0;0;0;0
FR;12;2022-06-08;0;0;0;0;0;0;0;0;0;0;0;0;0;0;0;0;0;0
FR;12;2022-06-09;0;0;0;0;0;0;0;0;0;0;0;0;0;0;0;0;0;0
FR;12;2022-06-10;0;0;0;0;0;0;0;0;0;0;0;0;0;0;0;0;0;0
FR;12;2022-06-11;0;0;0;0;0;0;0;0;0;0;0;0;0;0;0;0;0;0
FR;12;2022-06-12;0;0;0;0;0;0;0;0;0;0;0;0;0;0;0;0;0;0
FR;12;2022-06-13;0;0;0;0;0;0;0;0;0;0;0;0;0;0;0;0;0;0
FR;12;2022-06-14;0;0;0;0;0;0;0;0;0;0;0;0;0;0;0;0;0;0
FR;12;2022-06-15;0;0;0;0;0;0;0;0;0;0;0;0;0;0;0;0;0;0
FR;12;2022-06-16;0;0;0;0;0;0;0;0;0;0;0;0;0;0;0;0;0;0
FR;12;2022-06-17;0;0;0;0;0;0;0;0;0;0;0;0;0;0;0;0;0;0
FR;12;2022-06-18;0;0;0;0;0;0;0;0;0;0;0;0;0;0;0;0;0;0
FR;12;2022-06-19;0;0;0;0;0;0;0;0;0;0;0;0;0;0;0;0;0;0
FR;12;2022-06-20;0;0;0;0;0;0;0;0;0;0;0;0;0;0;0;0;0;0
FR;12;2022-06-21;0;0;0;0;0;0;0;0;0;0;0;0;0;0;0;0;0;0
FR;12;2022-06-22;0;0;0;0;0;0;0;0;0;0;0;0;0;0;0;0;0;0
FR;12;2022-06-23;0;0;0;0;0;0;0;0;0;0;0;0;0;0;0;0;0;0
FR;12;2022-06-24;0;0;0;0;0;0;0;0;0;0;0;0;0;0;0;0;0;0
FR;12;2022-06-25;0;0;0;0;0;0;0;0;0;0;0;0;0;0;0;0;0;0
FR;12;2022-06-26;0;0;0;0;0;0;0;0;0;0;0;0;0;0;0;0;0;0
FR;12;2022-06-27;0;0;0;0;0;0;0;0;0;0;0;0;0;0;0;0;0;0
FR;12;2022-06-28;0;0;0;0;0;0;0;0;0;0;0;0;0;0;0;0;0;0
FR;12;2022-06-29;0;0;0;0;0;0;0;0;0;0;0;0;0;0;0;0;0;0
FR;12;2022-06-30;0;0;0;0;0;0;0;0;0;0;0;0;0;0;0;0;0;0
FR;12;2022-07-01;0;0;0;0;0;0;0;0;0;0;0;0;0;0;0;0;0;0
FR;12;2022-07-02;0;0;0;0;0;0;0;0;0;0;0;0;0;0;0;0;0;0
FR;12;2022-07-03;0;0;0;0;0;0;0;0;0;0;0;0;0;0;0;0;0;0
FR;12;2022-07-04;0;0;0;0;0;0;0;0;0;0;0;0;0;0;0;0;0;0
FR;12;2022-07-05;0;0;0;0;0;0;0;0;0;0;0;0;0;0;0;0;0;0
FR;12;2022-07-06;0;0;0;0;0;0;0;0;0;0;0;0;0;0;0;0;0;0
FR;12;2022-07-07;0;0;0;0;0;0;0;0;0;0;0;0;0;0;0;0;0;0
FR;12;2022-07-08;0;0;0;0;0;0;0;0;0;0;0;0;0;0;0;0;0;0
FR;12;2022-07-09;0;0;0;0;0;0;0;0;0;0;0;0;0;0;0;0;0;0
FR;12;2022-07-10;0;0;0;0;0;0;0;0;0;0;0;0;0;0;0;0;0;0
FR;12;2022-07-11;0;0;0;0;0;0;0;0;0;0;0;0;0;0;0;0;0;0
FR;12;2022-07-12;0;0;0;0;0;0;0;0;0;0;0;0;0;0;0;0;0;0
FR;12;2022-07-13;0;0;0;0;0;0;0;0;0;0;0;0;0;0;0;0;0;0
FR;12;2022-07-14;0;0;0;0;0;0;0;0;0;0;0;0;0;0;0;0;0;0
FR;12;2022-07-15;0;0;0;0;0;0;0;0;0;0;0;0;0;0;0;0;0;0
FR;12;2022-07-16;0;0;0;0;0;0;0;0;0;0;0;0;0;0;0;0;0;0
FR;12;2022-07-17;0;0;0;0;0;0;0;0;0;0;0;0;0;0;0;0;0;0
FR;12;2022-07-18;0;0;0;0;0;0;0;0;0;0;0;0;0;0;0;0;0;0
FR;12;2022-07-19;0;0;0;0;0;0;0;0;0;0;0;0;0;0;0;0;0;0
FR;12;2022-07-20;0;0;0;0;0;0;0;0;0;0;0;0;0;0;0;0;0;0
FR;12;2022-07-21;0;0;0;0;0;0;0;0;0;0;0;0;0;0;0;0;0;0
FR;12;2022-07-22;0;0;0;0;0;0;0;0;0;0;0;0;0;0;0;0;0;0
FR;12;2022-07-23;0;0;0;0;0;0;0;0;0;0;0;0;0;0;0;0;0;0
FR;12;2022-07-24;0;0;0;0;0;0;0;0;0;0;0;0;0;0;0;0;0;0
FR;12;2022-07-25;0;0;0;0;0;0;0;0;0;0;0;0;0;0;0;0;0;0
FR;12;2022-07-26;0;0;0;0;0;0;0;0;0;0;0;0;0;0;0;0;0;0
FR;12;2022-07-27;0;0;0;0;0;0;0;0;0;0;0;0;0;0;0;0;0;0
FR;12;2022-07-28;0;0;0;0;0;0;0;0;0;0;0;0;0;0;0;0;0;0
FR;12;2022-07-29;0;0;0;0;0;0;0;0;0;0;0;0;0;0;0;0;0;0
FR;12;2022-07-30;0;0;0;0;0;0;0;0;0;0;0;0;0;0;0;0;0;0
FR;12;2022-07-31;0;0;0;0;0;0;0;0;0;0;0;0;0;0;0;0;0;0
FR;12;2022-08-01;0;0;0;0;0;0;0;0;0;0;0;0;0;0;0;0;0;0
FR;12;2022-08-02;0;0;0;0;0;0;0;0;0;0;0;0;0;0;0;0;0;0
FR;12;2022-08-03;0;0;0;0;0;0;0;0;0;0;0;0;0;0;0;0;0;0
FR;12;2022-08-04;0;0;0;0;0;0;0;0;0;0;0;0;0;0;0;0;0;0
FR;12;2022-08-05;0;0;0;0;0;0;0;0;0;0;0;0;0;0;0;0;0;0
FR;12;2022-08-06;0;0;0;0;0;0;0;0;0;0;0;0;0;0;0;0;0;0
FR;12;2022-08-07;0;0;0;0;0;0;0;0;0;0;0;0;0;0;0;0;0;0
FR;12;2022-08-08;0;0;0;0;0;0;0;0;0;0;0;0;0;0;0;0;0;0
FR;12;2022-08-09;0;0;0;0;0;0;0;0;0;0;0;0;0;0;0;0;0;0
FR;12;2022-08-10;0;0;0;0;0;0;0;0;0;0;0;0;0;0;0;0;0;0
FR;12;2022-08-11;0;0;0;0;0;0;0;0;0;0;0;0;0;0;0;0;0;0
FR;12;2022-08-12;0;0;0;0;0;0;0;0;0;0;0;0;0;0;0;0;0;0
FR;12;2022-08-13;0;0;0;0;0;0;0;0;0;0;0;0;0;0;0;0;0;0
FR;12;2022-08-14;0;0;0;0;0;0;0;0;0;0;0;0;0;0;0;0;0;0
FR;12;2022-08-15;0;0;0;0;0;0;0;0;0;0;0;0;0;0;0;0;0;0
FR;12;2022-08-16;0;0;0;0;0;0;0;0;0;0;0;0;0;0;0;0;0;0
FR;12;2022-08-17;0;0;0;0;0;0;0;0;0;0;0;0;0;0;0;0;0;0
FR;12;2022-08-18;0;0;0;0;0;0;0;0;0;0;0;0;0;0;0;0;0;0
FR;12;2022-08-19;0;0;0;0;0;0;0;0;0;0;0;0;0;0;0;0;0;0
FR;12;2022-08-20;0;0;0;0;0;0;0;0;0;0;0;0;0;0;0;0;0;0
FR;12;2022-08-21;0;0;0;0;0;0;0;0;0;0;0;0;0;0;0;0;0;0
FR;12;2022-08-22;0;0;0;0;0;0;0;0;0;0;0;0;0;0;0;0;0;0
FR;12;2022-08-23;0;0;0;0;0;0;0;0;0;0;0;0;0;0;0;0;0;0
FR;12;2022-08-24;0;0;0;0;0;0;0;0;0;0;0;0;0;0;0;0;0;0
FR;12;2022-08-25;0;0;0;0;0;0;0;0;0;0;0;0;0;0;0;0;0;0
FR;12;2022-08-26;0;0;0;0;0;0;0;0;0;0;0;0;0;0;0;0;0;0
FR;12;2022-08-27;0;0;0;0;0;0;0;0;0;0;0;0;0;0;0;0;0;0
FR;12;2022-08-28;0;0;0;0;0;0;0;0;0;0;0;0;0;0;0;0;0;0
FR;12;2022-08-29;0;0;0;0;0;0;0;0;0;0;0;0;0;0;0;0;0;0
FR;12;2022-08-30;0;0;0;0;0;0;0;0;0;0;0;0;0;0;0;0;0;0
FR;12;2022-08-31;0;0;0;0;0;0;0;0;0;0;0;0;0;0;0;0;0;0
FR;12;2022-09-01;0;0;0;0;0;0;0;0;0;0;0;0;0;0;0;0;0;0
FR;12;2022-09-02;0;0;0;0;0;0;0;0;0;0;0;0;0;0;0;0;0;0
FR;12;2022-09-03;0;0;0;0;0;0;0;0;0;0;0;0;0;0;0;0;0;0
FR;12;2022-09-04;0;0;0;0;0;0;0;0;0;0;0;0;0;0;0;0;0;0
FR;12;2022-09-05;0;0;0;0;0;0;0;0;0;0;0;0;0;0;0;0;0;0
FR;12;2022-09-06;0;0;0;0;0;0;0;0;0;0;0;0;0;0;0;0;0;0
FR;12;2022-09-07;0;0;0;0;0;0;0;0;0;0;0;0;0;0;0;0;0;0
FR;12;2022-09-08;0;0;0;0;0;0;0;0;0;0;0;0;0;0;0;0;0;0
FR;12;2022-09-09;0;0;0;0;0;0;0;0;0;0;0;0;0;0;0;0;0;0
FR;12;2022-09-10;0;0;0;0;0;0;0;0;0;0;0;0;0;0;0;0;0;0
FR;12;2022-09-11;0;0;0;0;0;0;0;0;0;0;0;0;0;0;0;0;0;0
FR;12;2022-09-12;0;0;0;0;0;0;0;0;0;0;0;0;0;0;0;0;0;0
FR;12;2022-09-13;0;0;0;0;0;0;0;0;0;0;0;0;0;0;0;0;0;0
FR;12;2022-09-14;0;0;0;0;0;0;0;0;0;0;0;0;0;0;0;0;0;0
FR;12;2022-09-15;0;0;0;0;0;0;0;0;0;0;0;0;0;0;0;0;0;0
FR;12;2022-09-16;0;0;0;0;0;0;0;0;0;0;0;0;0;0;0;0;0;0
FR;12;2022-09-17;0;0;0;0;0;0;0;0;0;0;0;0;0;0;0;0;0;0
FR;12;2022-09-18;0;0;0;0;0;0;0;0;0;0;0;0;0;0;0;0;0;0
FR;12;2022-09-19;0;0;0;0;0;0;0;0;0;0;0;0;0;0;0;0;0;0
FR;12;2022-09-20;0;0;0;0;0;0;0;0;0;0;0;0;0;0;0;0;0;0
FR;12;2022-09-21;0;0;0;0;0;0;0;0;0;0;0;0;0;0;0;0;0;0
FR;12;2022-09-22;0;0;0;0;0;0;0;0;0;0;0;0;0;0;0;0;0;0
FR;12;2022-09-23;0;0;0;0;0;0;0;0;0;0;0;0;0;0;0;0;0;0
FR;12;2022-09-24;0;0;0;0;0;0;0;0;0;0;0;0;0;0;0;0;0;0
FR;12;2022-09-25;0;0;0;0;0;0;0;0;0;0;0;0;0;0;0;0;0;0
FR;12;2022-09-26;0;0;0;0;0;0;0;0;0;0;0;0;0;0;0;0;0;0
FR;12;2022-09-27;0;0;0;0;0;0;0;0;0;0;0;0;0;0;0;0;0;0
FR;12;2022-09-28;0;0;0;0;0;0;0;0;0;0;0;0;0;0;0;0;0;0
FR;12;2022-09-29;0;0;0;0;0;0;0;0;0;0;0;0;0;0;0;0;0;0
FR;12;2022-09-30;0;0;0;0;0;0;0;0;0;0;0;0;0;0;0;0;0;0
FR;12;2022-10-01;0;0;0;0;0;0;0;0;0;0;0;0;0;0;0;0;0;0
FR;12;2022-10-02;0;0;0;0;0;0;0;0;0;0;0;0;0;0;0;0;0;0
FR;12;2022-10-03;0;0;0;0;0;0;0;0;0;0;0;0;0;0;0;0;0;0
FR;12;2022-10-04;0;0;0;0;0;0;0;0;0;0;0;0;0;0;0;0;0;0
FR;12;2022-10-05;0;0;0;0;0;0;0;0;0;0;0;0;0;0;0;0;0;0
FR;12;2022-10-06;0;0;0;0;0;0;0;0;0;0;0;0;0;0;0;0;0;0
FR;12;2022-10-07;0;0;0;0;0;0;0;0;0;0;0;0;0;0;0;0;0;0
FR;12;2022-10-08;0;0;0;0;0;0;0;0;0;0;0;0;0;0;0;0;0;0
FR;12;2022-10-09;0;0;0;0;0;0;0;0;0;0;0;0;0;0;0;0;0;0
FR;12;2022-10-10;0;0;0;0;0;0;0;0;0;0;0;0;0;0;0;0;0;0
FR;12;2022-10-11;0;0;0;0;0;0;0;0;0;0;0;0;0;0;0;0;0;0
FR;12;2022-10-12;0;0;0;0;0;0;0;0;0;0;0;0;0;0;0;0;0;0
FR;12;2022-10-13;0;0;0;0;0;0;0;0;0;0;0;0;0;0;0;0;0;0
FR;12;2022-10-14;0;0;0;0;0;0;0;0;0;0;0;0;0;0;0;0;0;0
FR;12;2022-10-15;0;0;0;0;0;0;0;0;0;0;0;0;0;0;0;0;0;0
FR;12;2022-10-16;0;0;0;0;0;0;0;0;0;0;0;0;0;0;0;0;0;0
FR;12;2022-10-17;0;0;0;0;0;0;0;0;0;0;0;0;0;0;0;0;0;0
FR;12;2022-10-18;0;0;0;0;0;0;0;0;0;0;0;0;0;0;0;0;0;0
FR;12;2022-10-19;0;0;0;0;0;0;0;0;0;0;0;0;0;0;0;0;0;0
FR;12;2022-10-20;0;0;0;0;0;0;0;0;0;0;0;0;0;0;0;0;0;0
FR;12;2022-10-21;0;0;0;0;0;0;0;0;0;0;0;0;0;0;0;0;0;0
FR;12;2022-10-22;0;0;0;0;0;0;0;0;0;0;0;0;0;0;0;0;0;0
FR;12;2022-10-23;0;0;0;0;0;0;0;0;0;0;0;0;0;0;0;0;0;0
FR;12;2022-10-24;0;0;0;0;0;0;0;0;0;0;0;0;0;0;0;0;0;0
FR;12;2022-10-25;0;0;0;0;0;0;0;0;0;0;0;0;0;0;0;0;0;0
FR;12;2022-10-26;0;0;0;0;0;0;0;0;0;0;0;0;0;0;0;0;0;0
FR;12;2022-10-27;0;0;0;0;0;0;0;0;0;0;0;0;0;0;0;0;0;0
FR;12;2022-10-28;0;0;0;0;0;0;0;0;0;0;0;0;0;0;0;0;0;0
FR;12;2022-10-29;0;0;0;0;0;0;0;0;0;0;0;0;0;0;0;0;0;0
FR;12;2022-10-30;0;0;0;0;0;0;0;0;0;0;0;0;0;0;0;0;0;0
FR;12;2022-10-31;0;0;0;0;0;0;0;0;0;0;0;0;0;0;0;0;0;0
FR;12;2022-11-01;0;0;0;0;0;0;0;0;0;0;0;0;0;0;0;0;0;0
FR;12;2022-11-02;0;0;0;0;0;0;0;0;0;0;0;0;0;0;0;0;0;0
FR;12;2022-11-03;0;0;0;0;0;0;0;0;0;0;0;0;0;0;0;0;0;0
FR;12;2022-11-04;0;0;0;0;0;0;0;0;0;0;0;0;0;0;0;0;0;0
FR;12;2022-11-05;0;0;0;0;0;0;0;0;0;0;0;0;0;0;0;0;0;0
FR;12;2022-11-06;0;0;0;0;0;0;0;0;0;0;0;0;0;0;0;0;0;0
FR;12;2022-11-07;0;0;0;0;0;0;0;0;0;0;0;0;0;0;0;0;0;0
FR;12;2022-11-08;0;0;0;0;0;0;0;0;0;0;0;0;0;0;0;0;0;0
FR;12;2022-11-09;0;0;0;0;0;0;0;0;0;0;0;0;0;0;0;0;0;0
FR;12;2022-11-10;0;0;0;0;0;0;0;0;0;0;0;0;0;0;0;0;0;0
FR;12;2022-11-11;0;0;0;0;0;0;0;0;0;0;0;0;0;0;0;0;0;0
FR;12;2022-11-12;0;0;0;0;0;0;0;0;0;0;0;0;0;0;0;0;0;0
FR;12;2022-11-13;0;0;0;0;0;0;0;0;0;0;0;0;0;0;0;0;0;0
FR;12;2022-11-14;0;0;0;0;0;0;0;0;0;0;0;0;0;0;0;0;0;0
FR;12;2022-11-15;0;0;0;0;0;0;0;0;0;0;0;0;0;0;0;0;0;0
FR;12;2022-11-16;0;0;0;0;0;0;0;0;0;0;0;0;0;0;0;0;0;0
FR;12;2022-11-17;0;0;0;0;0;0;0;0;0;0;0;0;0;0;0;0;0;0
FR;12;2022-11-18;0;0;0;0;0;0;0;0;0;0;0;0;0;0;0;0;0;0
FR;12;2022-11-19;0;0;0;0;0;0;0;0;0;0;0;0;0;0;0;0;0;0
FR;12;2022-11-20;0;0;0;0;0;0;0;0;0;0;0;0;0;0;0;0;0;0
FR;12;2022-11-21;0;0;0;0;0;0;0;0;0;0;0;0;0;0;0;0;0;0
FR;12;2022-11-22;0;0;0;0;0;0;0;0;0;0;0;0;0;0;0;0;0;0
FR;12;2022-11-23;0;0;0;0;0;0;0;0;0;0;0;0;0;0;0;0;0;0
FR;12;2022-11-24;0;0;0;0;0;0;0;0;0;0;0;0;0;0;0;0;0;0
FR;12;2022-11-25;0;0;0;0;0;0;0;0;0;0;0;0;0;0;0;0;0;0
FR;12;2022-11-26;0;0;0;0;0;0;0;0;0;0;0;0;0;0;0;0;0;0
FR;12;2022-11-27;0;0;0;0;0;0;0;0;0;0;0;0;0;0;0;0;0;0
FR;12;2022-11-28;0;0;0;0;0;0;0;0;0;0;0;0;0;0;0;0;0;0
FR;12;2022-11-29;0;0;0;0;0;0;0;0;0;0;0;0;0;0;0;0;0;0
FR;12;2022-11-30;0;0;0;0;0;0;0;0;0;0;0;0;0;0;0;0;0;0
FR;12;2022-12-01;0;0;0;0;0;0;0;0;0;0;0;0;0;0;0;0;0;0
FR;12;2022-12-02;0;0;0;0;0;0;0;0;0;0;0;0;0;0;0;0;0;0
FR;12;2022-12-03;0;0;0;0;0;0;0;0;0;0;0;0;0;0;0;0;0;0
FR;12;2022-12-04;0;0;0;0;0;0;0;0;0;0;0;0;0;0;0;0;0;0
FR;12;2022-12-05;0;0;0;0;0;0;0;0;0;0;0;0;0;0;0;0;0;0
FR;12;2022-12-06;0;0;0;0;0;0;0;0;0;0;0;0;0;0;0;0;0;0
FR;12;2022-12-07;0;0;0;0;0;0;0;0;0;0;0;0;0;0;0;0;0;0
FR;12;2022-12-08;0;0;0;0;0;0;0;0;0;0;0;0;0;0;0;0;0;0
FR;12;2022-12-09;0;0;0;0;0;0;0;0;0;0;0;0;0;0;0;0;0;0
FR;12;2022-12-10;0;0;0;0;0;0;0;0;0;0;0;0;0;0;0;0;0;0
FR;12;2022-12-11;0;0;0;0;0;0;0;0;0;0;0;0;0;0;0;0;0;0
FR;12;2022-12-12;0;0;0;0;0;0;0;0;0;0;0;0;0;0;0;0;0;0
FR;12;2022-12-13;0;0;0;0;0;0;0;0;0;0;0;0;0;0;0;0;0;0
FR;12;2022-12-14;0;0;0;0;0;0;0;0;0;0;0;0;0;0;0;0;0;0
FR;12;2022-12-15;0;0;0;0;0;0;0;0;0;0;0;0;0;0;0;0;0;0
FR;12;2022-12-16;0;0;0;0;0;0;0;0;0;0;0;0;0;0;0;0;0;0
FR;12;2022-12-17;0;0;0;0;0;0;0;0;0;0;0;0;0;0;0;0;0;0
FR;12;2022-12-18;0;0;0;0;0;0;0;0;0;0;0;0;0;0;0;0;0;0
FR;12;2022-12-19;0;0;0;0;0;0;0;0;0;0;0;0;0;0;0;0;0;0
FR;12;2022-12-20;0;0;0;0;0;0;0;0;0;0;0;0;0;0;0;0;0;0
FR;12;2022-12-21;0;0;0;0;0;0;0;0;0;0;0;0;0;0;0;0;0;0
FR;12;2022-12-22;0;0;0;0;0;0;0;0;0;0;0;0;0;0;0;0;0;0
FR;12;2022-12-23;0;0;0;0;0;0;0;0;0;0;0;0;0;0;0;0;0;0
FR;12;2022-12-24;0;0;0;0;0;0;0;0;0;0;0;0;0;0;0;0;0;0
FR;12;2022-12-25;0;0;0;0;0;0;0;0;0;0;0;0;0;0;0;0;0;0
FR;12;2022-12-26;0;0;0;0;0;0;0;0;0;0;0;0;0;0;0;0;0;0
FR;12;2022-12-27;0;0;0;0;0;0;0;0;0;0;0;0;0;0;0;0;0;0
FR;12;2022-12-28;0;0;0;0;0;0;0;0;0;0;0;0;0;0;0;0;0;0
FR;12;2022-12-29;0;0;0;0;0;0;0;0;0;0;0;0;0;0;0;0;0;0
FR;12;2022-12-30;0;0;0;0;0;0;0;0;0;0;0;0;0;0;0;0;0;0
FR;12;2022-12-31;0;0;0;0;0;0;0;0;0;0;0;0;0;0;0;0;0;0
FR;12;2023-01-01;0;0;0;0;0;0;0;0;0;0;0;0;0;0;0;0;0;0
FR;12;2023-01-02;0;0;0;0;0;0;0;0;0;0;0;0;0;0;0;0;0;0
FR;12;2023-01-03;0;0;0;0;0;0;0;0;0;0;0;0;0;0;0;0;0;0
FR;12;2023-01-04;0;0;0;0;0;0;0;0;0;0;0;0;0;0;0;0;0;0
FR;12;2023-01-05;0;0;0;0;0;0;0;0;0;0;0;0;0;0;0;0;0;0
FR;12;2023-01-06;0;0;0;0;0;0;0;0;0;0;0;0;0;0;0;0;0;0
FR;12;2023-01-07;0;0;0;0;0;0;0;0;0;0;0;0;0;0;0;0;0;0
FR;12;2023-01-08;0;0;0;0;0;0;0;0;0;0;0;0;0;0;0;0;0;0
FR;12;2023-01-09;0;0;0;0;0;0;0;0;0;0;0;0;0;0;0;0;0;0
FR;12;2023-01-10;0;0;0;0;0;0;0;0;0;0;0;0;0;0;0;0;0;0
FR;12;2023-01-11;0;0;0;0;0;0;0;0;0;0;0;0;0;0;0;0;0;0
FR;12;2023-01-12;0;0;0;0;0;0;0;0;0;0;0;0;0;0;0;0;0;0
FR;12;2023-01-13;0;0;0;0;0;0;0;0;0;0;0;0;0;0;0;0;0;0
FR;12;2023-01-14;0;0;0;0;0;0;0;0;0;0;0;0;0;0;0;0;0;0
FR;12;2023-01-15;0;0;0;0;0;0;0;0;0;0;0;0;0;0;0;0;0;0
FR;12;2023-01-16;0;0;0;0;0;0;0;0;0;0;0;0;0;0;0;0;0;0
FR;12;2023-01-17;0;0;0;0;0;0;0;0;0;0;0;0;0;0;0;0;0;0
FR;12;2023-01-18;0;0;0;0;0;0;0;0;0;0;0;0;0;0;0;0;0;0
FR;12;2023-01-19;0;0;0;0;0;0;0;0;0;0;0;0;0;0;0;0;0;0
FR;12;2023-01-20;0;0;0;0;0;0;0;0;0;0;0;0;0;0;0;0;0;0
FR;12;2023-01-21;0;0;0;0;0;0;0;0;0;0;0;0;0;0;0;0;0;0
FR;12;2023-01-22;0;0;0;0;0;0;0;0;0;0;0;0;0;0;0;0;0;0
FR;12;2023-01-23;0;0;0;0;0;0;0;0;0;0;0;0;0;0;0;0;0;0
FR;12;2023-01-24;0;0;0;0;0;0;0;0;0;0;0;0;0;0;0;0;0;0
FR;12;2023-01-25;0;0;0;0;0;0;0;0;0;0;0;0;0;0;0;0;0;0
FR;12;2023-01-26;0;0;0;0;0;0;0;0;0;0;0;0;0;0;0;0;0;0
FR;12;2023-01-27;0;0;0;0;0;0;0;0;0;0;0;0;0;0;0;0;0;0
FR;12;2023-01-28;0;0;0;0;0;0;0;0;0;0;0;0;0;0;0;0;0;0
FR;12;2023-01-29;0;0;0;0;0;0;0;0;0;0;0;0;0;0;0;0;0;0
FR;12;2023-01-30;0;0;0;0;0;0;0;0;0;0;0;0;0;0;0;0;0;0
FR;12;2023-01-31;0;0;0;0;0;0;0;0;0;0;0;0;0;0;0;0;0;0
FR;12;2023-02-01;0;0;0;0;0;0;0;0;0;0;0;0;0;0;0;0;0;0
FR;12;2023-02-02;0;0;0;1;0;0;0;2;2;0;0;0;1;0;0;0;2;2
FR;12;2023-02-03;0;1;6;57;0;4;58;141;77;0;1;6;58;0;4;58;143;79
FR;12;2023-02-04;1;3;6;51;1;5;52;110;52;1;4;12;109;1;9;110;253;131
FR;12;2023-02-05;0;0;0;0;0;0;0;1;1;1;4;12;109;1;9;110;254;132
FR;12;2023-02-06;3;2;13;63;0;11;69;154;69;4;6;25;172;1;20;179;408;201
FR;12;2023-02-07;2;7;18;95;4;13;98;237;121;6;13;43;267;5;33;277;645;322
FR;12;2023-02-08;1;3;10;62;1;10;69;170;89;7;16;53;329;6;43;346;815;411
FR;12;2023-02-09;5;3;12;75;2;13;78;284;190;12;19;65;404;8;56;424;1099;601
FR;12;2023-02-10;4;2;22;140;4;12;150;327;162;16;21;87;544;12;68;574;1426;763
FR;12;2023-02-11;0;2;8;59;1;3;58;123;60;16;23;95;603;13;71;632;1549;823
FR;12;2023-02-12;0;0;0;3;0;0;3;7;3;16;23;95;606;13;71;635;1556;826
FR;12;2023-02-13;0;0;17;78;0;8;85;217;114;16;23;112;684;13;79;720;1773;940
FR;12;2023-02-14;3;5;17;96;5;14;99;229;108;19;28;129;780;18;93;819;2002;1048
FR;12;2023-02-15;3;5;19;85;0;13;86;236;132;22;33;148;865;18;106;905;2238;1180
FR;12;2023-02-16;5;3;16;107;3;13;103;247;129;27;36;164;972;21;119;1008;2485;1309
FR;12;2023-02-17;2;4;12;115;3;11;110;280;153;29;40;176;1087;24;130;1118;2765;1462
FR;12;2023-02-18;1;4;10;51;2;12;52;102;36;30;44;186;1138;26;142;1170;2867;1498
FR;12;2023-02-19;0;0;0;2;0;0;1;2;1;30;44;186;1140;26;142;1171;2869;1499
FR;12;2023-02-20;10;2;11;65;6;11;69;219;132;40;46;197;1205;32;153;1240;3088;1631
FR;12;2023-02-21;6;6;19;98;4;14;94;280;167;46;52;216;1303;36;167;1334;3368;1798
FR;12;2023-02-22;2;4;19;74;2;20;78;231;125;48;56;235;1377;38;187;1412;3599;1923
FR;12;2023-02-23;4;3;20;88;2;16;87;265;155;52;59;255;1465;40;203;1499;3864;2078
FR;12;2023-02-24;3;7;20;135;3;17;142;360;189;55;66;275;1600;43;220;1641;4224;2267
FR;12;2023-02-25;7;1;19;92;1;10;106;200;77;62;67;294;1692;44;230;1747;4424;2344
FR;12;2023-02-26;0;0;0;0;0;0;0;2;2;62;67;294;1692;44;230;1747;4426;2346
FR;12;2023-02-27;6;10;20;92;8;16;95;270;156;68;77;314;1784;52;246;1842;4696;2502
FR;12;2023-02-28;6;9;21;125;0;23;128;385;227;74;86;335;1909;52;269;1970;5081;2729
FR;12;2023-03-01;3;7;23;78;2;18;91;292;175;77;93;358;1987;54;287;2061;5373;2904
FR;12;2023-03-02;9;9;21;110;6;18;117;304;163;86;102;379;2097;60;305;2178;5677;3067
FR;12;2023-03-03;10;8;45;142;7;39;148;418;220;96;110;424;2239;67;344;2326;6095;3287
FR;12;2023-03-04;3;2;12;55;0;10;53;119;49;99;112;436;2294;67;354;2379;6214;3336
FR;12;2023-03-05;0;1;1;2;1;1;2;8;5;99;113;437;2296;68;355;2381;6222;3341
FR;12;2023-03-06;4;5;27;74;2;20;82;268;157;103;118;464;2370;70;375;2463;6490;3498
FR;12;2023-03-07;6;10;29;130;9;24;132;356;191;109;128;493;2500;79;399;2595;6846;3689
FR;12;2023-03-08;4;7;27;71;5;22;77;249;137;113;135;520;2571;84;421;2672;7095;3826
FR;12;2023-03-09;4;8;18;91;4;22;85;323;197;117;143;538;2662;88;443;2757;7418;4023
FR;12;2023-03-10;11;7;23;137;9;23;133;368;209;128;150;561;2799;97;466;2890;7786;4232
FR;12;2023-03-11;1;4;15;45;4;9;50;132;72;129;154;576;2844;101;475;2940;7918;4304
FR;12;2023-03-12;0;2;0;2;0;2;1;5;2;129;156;576;2846;101;477;2941;7923;4306
FR;12;2023-03-13;3;4;32;102;1;28;104;297;158;132;160;608;2948;102;505;3045;8220;4464
FR;12;2023-03-14;3;7;16;85;2;15;83;322;210;135;167;624;3033;104;520;3128;8542;4674
FR;12;2023-03-15;1;4;20;66;2;19;69;225;124;136;171;644;3099;106;539;3197;8767;4798
FR;12;2023-03-16;5;5;20;100;5;13;116;300;157;141;176;664;3199;111;552;3313;9067;4955
FR;12;2023-03-17;4;11;30;112;4;28;113;388;224;145;187;694;3311;115;580;3426;9455;5179
FR;12;2023-03-18;1;4;21;53;4;17;59;144;64;146;191;715;3364;119;597;3485;9599;5243
FR;12;2023-03-19;0;0;0;6;0;0;5;10;5;146;191;715;3370;119;597;3490;9609;5248
FR;12;2023-03-20;9;8;27;87;7;23;90;258;134;155;199;742;3457;126;620;3580;9867;5382
FR;12;2023-03-21;2;7;42;81;3;36;93;355;209;157;206;784;3538;129;656;3673;10222;5591
FR;12;2023-03-22;6;4;36;50;5;29;58;241;139;163;210;820;3588;134;685;3731;10463;5730
FR;12;2023-03-23;3;8;26;80;5;25;82;264;147;166;218;846;3668;139;710;3813;10727;5877
FR;12;2023-03-24;6;2;25;99;3;22;109;347;203;172;220;871;3767;142;732;3922;11074;6080
FR;12;2023-03-25;7;8;25;61;3;14;75;162;62;179;228;896;3828;145;746;3997;11236;6142
FR;12;2023-03-26;0;1;0;1;1;0;1;7;6;179;229;896;3829;146;746;3998;11243;6148
FR;12;2023-03-27;5;10;28;77;7;23;85;283;159;184;239;924;3906;153;769;4083;11526;6307
FR;12;2023-03-28;2;5;29;95;2;25;91;344;207;186;244;953;4001;155;794;4174;11870;6514
FR;12;2023-03-29;4;8;18;52;5;20;56;201;105;190;252;971;4053;160;814;4230;12071;6619
FR;12;2023-03-30;9;2;27;65;4;19;81;281;168;199;254;998;4118;164;833;4311;12352;6787
FR;12;2023-03-31;4;14;41;120;4;39;126;424;233;203;268;1039;4238;168;872;4437;12776;7020
FR;12;2023-04-01;1;8;17;44;4;13;48;139;63;204;276;1056;4282;172;885;4485;12915;7083
FR;12;2023-04-02;0;2;1;0;0;3;0;6;3;204;278;1057;4282;172;888;4485;12921;7086
FR;12;2023-04-03;6;3;35;90;4;18;112;300;159;210;281;1092;4372;176;906;4597;13221;7245
FR;12;2023-04-04;4;7;22;85;0;26;87;383;247;214;288;1114;4457;176;932;4684;13604;7492
FR;12;2023-04-05;4;9;21;60;5;23;57;231;138;218;297;1135;4517;181;955;4741;13835;7630
FR;12;2023-04-06;10;8;25;57;3;23;67;280;164;228;305;1160;4574;184;978;4808;14115;7794
FR;12;2023-04-07;4;11;29;98;8;25;110;389;221;232;316;1189;4672;192;1003;4918;14504;8015
FR;12;2023-04-08;1;5;11;38;3;9;38;117;56;233;321;1200;4710;195;1012;4956;14621;8071
FR;12;2023-04-09;0;0;2;1;0;1;2;5;2;233;321;1202;4711;195;1013;4958;14626;8073
FR;12;2023-04-10;0;1;2;2;1;0;5;9;4;233;322;1204;4713;196;1013;4963;14635;8077
FR;12;2023-04-11;5;8;27;87;6;16;98;297;161;238;330;1231;4800;202;1029;5061;14932;8238
FR;12;2023-04-12;5;12;16;52;5;23;60;260;154;243;342;1247;4852;207;1052;5121;15192;8392
FR;12;2023-04-13;3;5;22;58;2;17;64;251;140;246;347;1269;4910;209;1069;5185;15443;8532
FR;12;2023-04-14;6;15;21;91;9;18;97;397;248;252;362;1290;5001;218;1087;5282;15840;8780
FR;12;2023-04-15;5;0;14;34;0;8;40;110;49;257;362;1304;5035;218;1095;5322;15950;8829
FR;12;2023-04-16;0;0;1;2;0;0;2;4;2;257;362;1305;5037;218;1095;5324;15954;8831
FR;12;2023-04-17;3;2;18;40;2;19;40;181;97;260;364;1323;5077;220;1114;5364;16135;8928
FR;12;2023-04-18;6;6;18;56;2;14;63;273;145;266;370;1341;5133;222;1128;5427;16408;9073
FR;12;2023-04-19;3;7;11;40;2;11;38;149;81;269;377;1352;5173;224;1139;5465;16557;9154
FR;12;2023-04-20;2;3;15;51;1;11;58;212;117;271;380;1367;5224;225;1150;5523;16769;9271
FR;12;2023-04-21;4;6;25;60;5;19;68;255;148;275;386;1392;5284;230;1169;5591;17024;9419
FR;12;2023-04-22;3;8;11;22;6;9;29;94;36;278;394;1403;5306;236;1178;5620;17118;9455
FR;12;2023-04-23;0;0;1;0;0;1;1;3;1;278;394;1404;5306;236;1179;5621;17121;9456
FR;12;2023-04-24;2;6;11;42;5;11;49;172;99;280;400;1415;5348;241;1190;5670;17293;9555
FR;12;2023-04-25;1;3;15;46;1;15;51;207;120;281;403;1430;5394;242;1205;5721;17500;9675
FR;12;2023-04-26;3;4;16;36;2;14;42;170;88;284;407;1446;5430;244;1219;5763;17670;9763
FR;12;2023-04-27;4;4;13;46;3;13;46;193;108;288;411;1459;5476;247;1232;5809;17863;9871
FR;12;2023-04-28;5;9;24;63;3;24;74;317;181;293;420;1483;5539;250;1256;5883;18180;10052
FR;12;2023-04-29;2;4;10;25;4;6;30;94;44;295;424;1493;5564;254;1262;5913;18274;10096
FR;12;2023-04-30;0;0;0;0;0;0;0;0;0;295;424;1493;5564;254;1262;5913;18274;10096
FR;12;2023-05-01;0;0;0;0;0;0;0;4;3;295;424;1493;5564;254;1262;5913;18278;10099
FR;12;2023-05-02;8;3;12;48;2;15;48;248;128;303;427;1505;5612;256;1277;5961;18526;10227
FR;12;2023-05-03;7;6;10;44;7;9;47;228;122;310;433;1515;5656;263;1286;6008;18754;10349
FR;12;2023-05-04;5;4;20;37;1;17;51;222;110;315;437;1535;5693;264;1303;6059;18976;10459
FR;12;2023-05-05;4;12;18;49;5;19;48;284;151;319;449;1553;5742;269;1322;6107;19260;10610
FR;12;2023-05-06;2;5;7;15;2;11;15;69;29;321;454;1560;5757;271;1333;6122;19329;10639
FR;12;2023-05-07;2;0;1;0;2;1;2;3;0;323;454;1561;5757;273;1334;6124;19332;10639
FR;12;2023-05-08;0;1;1;0;1;0;1;5;2;323;455;1562;5757;274;1334;6125;19337;10641
FR;12;2023-05-09;1;6;11;46;3;14;53;246;119;324;461;1573;5803;277;1348;6178;19583;10760
FR;12;2023-05-10;5;8;10;39;7;13;42;208;105;329;469;1583;5842;284;1361;6220;19791;10865
FR;12;2023-05-11;4;6;8;43;4;8;45;208;108;333;475;1591;5885;288;1369;6265;19999;10973
FR;12;2023-05-12;3;3;8;58;1;7;56;308;165;336;478;1599;5943;289;1376;6321;20307;11138
FR;12;2023-05-13;3;3;4;18;1;7;20;75;39;339;481;1603;5961;290;1383;6341;20382;11177
FR;12;2023-05-14;0;0;0;0;0;0;0;1;1;339;481;1603;5961;290;1383;6341;20383;11178
FR;12;2023-05-15;2;1;6;35;2;4;40;203;99;341;482;1609;5996;292;1387;6381;20586;11277
FR;12;2023-05-16;5;9;7;39;4;11;42;268;142;346;491;1616;6035;296;1398;6423;20854;11419
FR;12;2023-05-17;3;7;10;31;5;8;34;194;86;349;498;1626;6066;301;1406;6457;21048;11505
FR;12;2023-05-18;1;0;1;2;0;0;3;4;1;350;498;1627;6068;301;1406;6460;21052;11506
FR;12;2023-05-19;1;4;11;32;3;10;39;175;82;351;502;1638;6100;304;1416;6499;21227;11588
FR;12;2023-05-20;1;3;3;6;2;2;9;51;20;352;505;1641;6106;306;1418;6508;21278;11608
FR;12;2023-05-21;0;3;0;2;0;3;2;10;1;352;508;1641;6108;306;1421;6510;21288;11609
FR;12;2023-05-22;3;5;9;24;1;13;27;137;61;355;513;1650;6132;307;1434;6537;21425;11670
FR;12;2023-05-23;4;5;12;67;4;13;72;251;102;359;518;1662;6199;311;1447;6609;21676;11772
FR;12;2023-05-24;4;5;5;32;4;6;37;169;77;363;523;1667;6231;315;1453;6646;21845;11849
FR;12;2023-05-25;5;3;8;17;3;10;24;174;79;368;526;1675;6248;318;1463;6670;22019;11928
FR;12;2023-05-26;5;9;11;29;9;10;33;248;107;373;535;1686;6277;327;1473;6703;22267;12035
FR;12;2023-05-27;3;2;7;9;1;4;13;68;36;376;537;1693;6286;328;1477;6716;22335;12071
FR;12;2023-05-28;0;0;0;0;0;0;0;1;0;376;537;1693;6286;328;1477;6716;22336;12071
FR;12;2023-05-29;0;2;0;0;1;1;0;1;0;376;539;1693;6286;329;1478;6716;22337;12071
FR;12;2023-05-30;6;5;10;28;2;12;33;240;104;382;544;1703;6314;331;1490;6749;22577;12175
FR;12;2023-05-31;4;5;6;24;6;6;25;167;77;386;549;1709;6338;337;1496;6774;22744;12252
FR;12;2023-06-01;1;2;12;22;2;7;32;221;95;387;551;1721;6360;339;1503;6806;22965;12347
FR;12;2023-06-02;7;2;9;34;1;9;35;312;151;394;553;1730;6394;340;1512;6841;23277;12498
FR;12;2023-06-03;2;2;3;11;1;3;15;87;25;396;555;1733;6405;341;1515;6856;23364;12523
FR;12;2023-06-04;0;0;0;2;0;0;1;8;5;396;555;1733;6407;341;1515;6857;23372;12528
FR;12;2023-06-05;5;4;3;25;2;7;28;238;110;401;559;1736;6432;343;1522;6885;23610;12638
FR;12;2023-06-06;2;7;15;24;4;11;33;278;127;403;566;1751;6456;347;1533;6918;23888;12765
FR;12;2023-06-07;2;5;7;16;1;12;22;190;74;405;571;1758;6472;348;1545;6940;24078;12839
FR;12;2023-06-08;4;6;8;16;5;10;18;185;84;409;577;1766;6488;353;1555;6958;24263;12923
FR;12;2023-06-09;5;3;8;25;2;7;31;272;128;414;580;1774;6513;355;1562;6989;24535;13051
FR;12;2023-06-10;1;3;1;11;4;1;12;81;32;415;583;1775;6524;359;1563;7001;24616;13083
FR;12;2023-06-11;0;1;0;0;0;1;0;2;0;415;584;1775;6524;359;1564;7001;24618;13083
FR;12;2023-06-12;2;2;2;23;0;3;22;173;82;417;586;1777;6547;359;1567;7023;24791;13165
FR;12;2023-06-13;0;1;10;24;1;7;27;204;87;417;587;1787;6571;360;1574;7050;24995;13252
FR;12;2023-06-14;1;1;9;17;0;4;25;174;59;418;588;1796;6588;360;1578;7075;25169;13311
FR;12;2023-06-15;1;2;8;20;1;2;28;224;83;419;590;1804;6608;361;1580;7103;25393;13394
FR;12;2023-06-16;6;2;9;25;4;13;22;298;116;425;592;1813;6633;365;1593;7125;25691;13510
FR;12;2023-06-17;0;3;6;10;3;2;10;101;51;425;595;1819;6643;368;1595;7135;25792;13561
FR;12;2023-06-18;0;0;0;0;0;0;0;0;0;425;595;1819;6643;368;1595;7135;25792;13561
FR;12;2023-06-19;3;7;6;28;6;4;31;214;78;428;602;1825;6671;374;1599;7166;26006;13639
FR;0;2020-12-27;616;0;0;0;55;0;0;0;0;616;0;0;0;55;0;0;0;0
FR;0;2020-12-28;710;1;0;0;44;0;0;0;0;1326;1;0;0;99;0;0;0;0
FR;0;2020-12-29;389;0;0;0;19;0;0;0;0;1715;1;0;0;118;0;0;0;0
FR;0;2020-12-30;456;0;0;0;20;0;0;0;0;2171;1;0;0;138;0;0;0;0
FR;0;2020-12-31;451;1;0;0;21;0;0;0;0;2622;2;0;0;159;0;0;0;0
FR;0;2021-01-01;1199;2;0;0;66;0;0;0;0;3821;4;0;0;225;0;0;0;0
FR;0;2021-01-02;370;4;0;0;29;0;0;0;0;4191;8;0;0;254;0;0;0;0
FR;0;2021-01-03;419;0;0;0;23;0;0;0;0;4610;8;0;0;277;0;0;0;0
FR;0;2021-01-04;2152;5;0;0;51;0;0;0;0;6762;13;0;0;328;0;0;0;0
FR;0;2021-01-05;7794;6;0;0;128;0;0;0;0;14556;19;0;0;456;0;0;0;0
FR;0;2021-01-06;12491;23;0;0;128;0;0;0;0;27047;42;0;0;584;0;0;0;0
FR;0;2021-01-07;29481;24;0;0;159;0;0;0;0;56528;66;0;0;743;0;0;0;0
FR;0;2021-01-08;37170;36;0;0;205;0;0;0;0;93698;102;0;0;948;0;0;0;0
FR;0;2021-01-09;11221;9;0;0;77;0;0;0;0;104919;111;0;0;1025;0;0;0;0
FR;0;2021-01-10;6017;8;0;0;28;0;0;0;0;110936;119;0;0;1053;0;0;0;0
FR;0;2021-01-11;39956;39;0;0;232;0;0;0;0;150892;158;0;0;1285;0;0;0;0
FR;0;2021-01-12;62166;31;0;0;296;0;0;0;0;213058;189;0;0;1581;0;0;0;0
FR;0;2021-01-13;65150;62;0;0;433;0;0;0;0;278208;251;0;0;2014;0;0;0;0
FR;0;2021-01-14;83109;263;0;0;1166;0;0;0;0;361317;514;0;0;3180;0;0;0;0
FR;0;2021-01-15;69039;103;1;0;555;0;0;0;0;430356;617;1;0;3735;0;0;0;0
FR;0;2021-01-16;20219;73;0;0;183;0;0;0;0;450575;690;1;0;3918;0;0;0;0
FR;0;2021-01-17;10993;54;0;0;137;0;0;0;0;461568;744;1;0;4055;0;0;0;0
FR;0;2021-01-18;85924;179;0;0;614;0;0;0;0;547492;923;1;0;4669;0;0;0;0
FR;0;2021-01-19;130615;211;0;0;861;0;0;0;0;678107;1134;1;0;5530;0;0;0;0
FR;0;2021-01-20;137578;197;0;0;837;0;0;0;0;815685;1331;1;0;6367;0;0;0;0
FR;0;2021-01-21;158435;205;0;0;947;0;0;0;0;974120;1536;1;0;7314;0;0;0;0
FR;0;2021-01-22;121091;259;0;0;846;0;0;0;0;1095211;1795;1;0;8160;0;0;0;0
FR;0;2021-01-23;38494;86;0;0;223;0;0;0;0;1133705;1881;1;0;8383;0;0;0;0
FR;0;2021-01-24;9752;131;0;0;196;0;0;0;0;1143457;2012;1;0;8579;0;0;0;0
FR;0;2021-01-25;78257;1458;0;0;1808;0;0;0;0;1221714;3470;1;0;10387;0;0;0;0
FR;0;2021-01-26;100401;3712;1;0;4188;0;0;0;0;1322115;7182;2;0;14575;0;0;0;0
FR;0;2021-01-27;107266;6447;0;0;7162;0;0;0;0;1429381;13629;2;0;21737;0;0;0;0
FR;0;2021-01-28;124384;16427;0;0;17249;0;0;0;0;1553765;30056;2;0;38986;0;0;0;0
FR;0;2021-01-29;92204;18802;0;0;19379;0;0;0;0;1645969;48858;2;0;58365;0;0;0;0
FR;0;2021-01-30;29128;4541;0;0;4678;0;0;0;0;1675097;53399;2;0;63043;0;0;0;0
FR;0;2021-01-31;5241;1900;0;0;1945;0;0;0;0;1680338;55299;2;0;64988;0;0;0;0
FR;0;2021-02-01;53161;23064;0;0;23338;0;0;0;0;1733499;78363;2;0;88326;0;0;0;0
FR;0;2021-02-02;72337;38240;0;0;38732;0;0;0;0;1805836;116603;2;0;127058;0;0;0;0
FR;0;2021-02-03;72329;40306;0;0;40812;0;0;0;0;1878165;156909;2;0;167870;0;0;0;0
FR;0;2021-02-04;82100;55155;0;0;55750;0;0;0;0;1960265;212064;2;0;223620;0;0;0;0
FR;0;2021-02-05;68252;48258;0;0;48696;0;0;0;0;2028517;260322;2;0;272316;0;0;0;0
FR;0;2021-02-06;22949;11436;0;0;11674;0;0;0;0;2051466;271758;2;0;283990;0;0;0;0
FR;0;2021-02-07;5195;6080;0;0;6206;0;0;0;0;2056661;277838;2;0;290196;0;0;0;0
FR;0;2021-02-08;46857;48827;0;0;49316;0;0;0;0;2103518;326665;2;0;339512;0;0;0;0
FR;0;2021-02-09;66051;78489;0;0;79587;0;0;0;0;2169569;405154;2;0;419099;0;0;0;0
FR;0;2021-02-10;71049;83550;0;0;84849;0;0;0;0;2240618;488704;2;0;503948;0;0;0;0
FR;0;2021-02-11;87309;105765;0;0;107714;0;0;0;0;2327927;594469;2;0;611662;0;0;0;0
FR;0;2021-02-12;79358;76084;0;0;77831;0;0;0;0;2407285;670553;2;0;689493;0;0;0;0
FR;0;2021-02-13;22391;19531;0;0;19898;0;0;0;0;2429676;690084;2;0;709391;0;0;0;0
FR;0;2021-02-14;5080;7324;0;0;7452;0;0;0;0;2434756;697408;2;0;716843;0;0;0;0
FR;0;2021-02-15;38132;76800;0;0;77824;0;0;0;0;2472888;774208;2;0;794667;0;0;0;0
FR;0;2021-02-16;50420;99690;0;0;101044;0;0;0;0;2523308;873898;2;0;895711;0;0;0;0
FR;0;2021-02-17;50560;106937;20;0;108389;0;0;0;0;2573868;980835;22;0;1004100;0;0;0;0
FR;0;2021-02-18;69815;123784;0;0;125834;0;0;0;0;2643683;1104619;22;0;1129934;0;0;0;0
FR;0;2021-02-19;65093;92328;1;0;94218;0;0;0;0;2708776;1196947;23;0;1224152;0;0;0;0
FR;0;2021-02-20;18602;28544;0;0;28915;0;0;0;0;2727378;1225491;23;0;1253067;0;0;0;0
FR;0;2021-02-21;3335;6038;0;0;6143;0;0;0;0;2730713;1231529;23;0;1259210;0;0;0;0
FR;0;2021-02-22;37511;73170;2;0;74187;0;0;0;0;2768224;1304699;25;0;1333397;0;0;0;0
FR;0;2021-02-23;53802;85295;1;0;86819;0;0;0;0;2822026;1389994;26;0;1420216;0;0;0;0
FR;0;2021-02-24;60039;82937;1;0;84519;0;0;0;0;2882065;1472931;27;0;1504735;0;0;0;0
FR;0;2021-02-25;100613;91203;1;0;94203;0;0;0;0;2982678;1564134;28;0;1598938;0;0;0;0
FR;0;2021-02-26;113492;70748;1;0;73899;0;0;0;0;3096170;1634882;29;0;1672837;0;0;0;0
FR;0;2021-02-27;52131;22440;1;0;23686;0;0;0;0;3148301;1657322;30;0;1696523;0;0;0;0
FR;0;2021-02-28;6209;4109;2;0;4307;0;0;0;0;3154510;1661431;32;0;1700830;0;0;0;0
FR;0;2021-03-01;65946;54078;1;0;55951;0;0;0;0;3220456;1715509;33;0;1756781;0;0;0;0
FR;0;2021-03-02;101417;67181;3;0;70227;0;0;0;0;3321873;1782690;36;0;1827008;0;0;0;0
FR;0;2021-03-03;116567;65481;0;0;69176;0;0;0;0;3438440;1848171;36;0;1896184;0;0;0;0
FR;0;2021-03-04;163664;72643;3;0;78217;0;0;0;0;3602104;1920814;39;0;1974401;0;0;0;0
FR;0;2021-03-05;200962;62701;3;0;69435;0;0;0;0;3803066;1983515;42;0;2043836;0;0;0;0
FR;0;2021-03-06;207995;17478;3;0;22781;0;0;0;0;4011061;2000993;45;0;2066617;0;0;0;0
FR;0;2021-03-07;121293;3968;1;0;7263;0;0;0;0;4132354;2004961;46;0;2073880;0;0;0;0
FR;0;2021-03-08;107180;49548;2;0;53038;0;0;0;0;4239534;2054509;48;0;2126918;0;0;0;0
FR;0;2021-03-09;172489;56025;2;0;61526;0;0;0;0;4412023;2110534;50;0;2188444;0;0;0;0
FR;0;2021-03-10;179044;57063;5;0;62740;0;0;0;0;4591067;2167597;55;0;2251184;0;0;0;0
FR;0;2021-03-11;242934;64037;2;0;72134;0;0;0;0;4834001;2231634;57;0;2323318;0;0;0;0
FR;0;2021-03-12;294876;53369;1;0;62827;0;0;0;0;5128877;2285003;58;0;2386145;0;0;0;0
FR;0;2021-03-13;231445;15263;1;0;21242;0;0;0;0;5360322;2300266;59;0;2407387;0;0;0;0
FR;0;2021-03-14;63365;3032;1;0;5068;0;0;0;0;5423687;2303298;60;0;2412455;0;0;0;0
FR;0;2021-03-15;158701;31490;3;0;36146;0;0;0;0;5582388;2334788;63;0;2448601;0;0;0;0
FR;0;2021-03-16;141599;38815;6;0;42967;0;0;0;0;5723987;2373603;69;0;2491568;0;0;0;0
FR;0;2021-03-17;150519;37569;4;0;42338;0;0;0;0;5874506;2411172;73;0;2533906;0;0;0;0
FR;0;2021-03-18;167873;44320;5;0;49887;0;0;0;0;6042379;2455492;78;0;2583793;0;0;0;0
FR;0;2021-03-19;230056;36747;2;0;44107;0;0;0;0;6272435;2492239;80;0;2627900;0;0;0;0
FR;0;2021-03-20;166721;11385;1;0;16010;0;0;0;0;6439156;2503624;81;0;2643910;0;0;0;0
FR;0;2021-03-21;49959;2129;1;0;3888;0;0;0;0;6489115;2505753;82;0;2647798;0;0;0;0
FR;0;2021-03-22;170085;33532;2;0;39037;0;0;0;0;6659200;2539285;84;0;2686835;0;0;0;0
FR;0;2021-03-23;250442;42364;1;0;50211;0;0;0;0;6909642;2581649;85;0;2737046;0;0;0;0
FR;0;2021-03-24;256953;43597;0;0;51700;0;0;0;0;7166595;2625246;85;0;2788746;0;0;0;0
FR;0;2021-03-25;341875;45292;5;0;56293;0;0;0;0;7508470;2670538;90;0;2845039;0;0;0;0
FR;0;2021-03-26;358850;41801;5;1;53559;0;0;0;0;7867320;2712339;95;1;2898598;0;0;0;0
FR;0;2021-03-27;195297;16952;1;0;23396;0;0;0;0;8062617;2729291;96;1;2921994;0;0;0;0
FR;0;2021-03-28;59361;4587;3;0;6652;0;0;0;0;8121978;2733878;99;1;2928646;0;0;0;0
FR;0;2021-03-29;203028;53395;4;0;60160;0;0;0;0;8325006;2787273;103;1;2988806;0;0;0;0
FR;0;2021-03-30;285550;70043;5;0;80457;0;0;0;0;8610556;2857316;108;1;3069263;0;0;0;0
FR;0;2021-03-31;263083;74060;4;0;84732;0;0;0;0;8873639;2931376;112;1;3153995;0;0;0;0
FR;0;2021-04-01;315587;92823;11;0;106408;0;0;0;0;9189226;3024199;123;1;3260403;0;0;0;0
FR;0;2021-04-02;281385;94824;7;0;106657;0;0;0;0;9470611;3119023;130;1;3367060;0;0;0;0
FR;0;2021-04-03;141097;62619;6;0;67881;0;0;0;0;9611708;3181642;136;1;3434941;0;0;0;0
FR;0;2021-04-04;46552;19022;2;0;21076;0;0;0;0;9658260;3200664;138;1;3456017;0;0;0;0
FR;0;2021-04-05;63373;10402;11;0;13059;0;0;0;0;9721633;3211066;149;1;3469076;0;0;0;0
FR;0;2021-04-06;217276;113150;17;0;122021;0;0;0;0;9938909;3324216;166;1;3591097;0;0;0;0
FR;0;2021-04-07;260325;115284;17;0;126639;0;0;0;0;10199234;3439500;183;1;3717736;0;0;0;0
FR;0;2021-04-08;337917;123225;15;0;138858;0;0;0;0;10537151;3562725;198;1;3856594;0;0;0;0
FR;0;2021-04-09;410245;116881;50;0;134293;0;0;0;0;10947396;3679606;248;1;3990887;0;0;0;0
FR;0;2021-04-10;212666;82881;15;0;91275;0;0;0;0;11160062;3762487;263;1;4082162;0;0;0;0
FR;0;2021-04-11;56162;34179;7;0;36705;0;0;0;0;11216224;3796666;270;1;4118867;0;0;0;0
FR;0;2021-04-12;237130;115833;46;0;125445;0;0;0;0;11453354;3912499;316;1;4244312;0;0;0;0
FR;0;2021-04-13;309558;144152;98;1;157114;0;0;0;0;11762912;4056651;414;2;4401426;0;0;0;0
FR;0;2021-04-14;294609;139860;215;0;153240;0;0;0;0;12057521;4196511;629;2;4554666;0;0;0;0
FR;0;2021-04-15;337206;150550;340;0;166094;0;0;0;0;12394727;4347061;969;2;4720760;0;0;0;0
FR;0;2021-04-16;339363;147041;354;0;161700;0;0;0;0;12734090;4494102;1323;2;4882460;0;0;0;0
FR;0;2021-04-17;188689;89983;109;0;97683;0;0;0;0;12922779;4584085;1432;2;4980143;0;0;0;0
FR;0;2021-04-18;51645;35461;48;0;37883;0;0;0;0;12974424;4619546;1480;2;5018026;0;0;0;0
FR;0;2021-04-19;205751;138299;457;0;147459;0;0;0;0;13180175;4757845;1937;2;5165485;0;0;0;0
FR;0;2021-04-20;254496;172049;569;0;183711;0;0;0;0;13434671;4929894;2506;2;5349196;0;0;0;0
FR;0;2021-04-21;253346;170239;837;0;182262;0;0;0;0;13688017;5100133;3343;2;5531458;0;0;0;0
FR;0;2021-04-22;287635;190458;820;0;205054;0;0;0;0;13975652;5290591;4163;2;5736512;0;0;0;0
FR;0;2021-04-23;297686;184749;747;0;203510;0;0;0;0;14273338;5475340;4910;2;5940022;0;0;0;0
FR;0;2021-04-24;190483;112058;252;0;122513;0;0;0;0;14463821;5587398;5162;2;6062535;0;0;0;0
FR;0;2021-04-25;69578;38861;51;0;42591;0;0;0;0;14533399;5626259;5213;2;6105126;0;0;0;0
FR;0;2021-04-26;221007;158708;564;0;171909;0;0;0;0;14754406;5784967;5777;2;6277035;0;0;0;0
FR;0;2021-04-27;284658;188079;941;0;211394;0;0;0;0;15039064;5973046;6718;2;6488429;0;0;0;0
FR;0;2021-04-28;299598;184732;1427;1;209812;1;0;0;0;15338662;6157778;8145;3;6698241;1;0;0;0
FR;0;2021-04-29;357220;198332;1281;0;233417;0;0;0;0;15695882;6356110;9426;3;6931658;1;0;0;0
FR;0;2021-04-30;372271;186155;1124;1;225494;0;0;0;0;16068153;6542265;10550;4;7157152;1;0;0;0
FR;0;2021-05-01;167680;52538;179;0;63784;0;0;0;0;16235833;6594803;10729;4;7220936;1;0;0;0
FR;0;2021-05-02;91771;37869;83;0;43598;0;0;0;0;16327604;6632672;10812;4;7264534;1;0;0;0
FR;0;2021-05-03;288988;165105;843;0;185631;0;0;0;0;16616592;6797777;11655;4;7450165;1;0;0;0
FR;0;2021-05-04;315761;225643;1237;0;251817;0;0;0;0;16932353;7023420;12892;4;7701982;1;0;0;0
FR;0;2021-05-05;327323;226691;1316;0;251771;0;0;0;0;17259676;7250111;14208;4;7953753;1;0;0;0
FR;0;2021-05-06;379657;241298;1634;0;275545;0;0;0;0;17639333;7491409;15842;4;8229298;1;0;0;0
FR;0;2021-05-07;372837;258920;1225;0;299976;0;0;0;0;18012170;7750329;17067;4;8529274;1;0;0;0
FR;0;2021-05-08;222192;71531;300;0;86740;0;0;0;0;18234362;7821860;17367;4;8616014;1;0;0;0
FR;0;2021-05-09;129735;44487;243;0;53125;0;0;0;0;18364097;7866347;17610;4;8669139;1;0;0;0
FR;0;2021-05-10;313436;229742;1239;0;255523;0;0;0;0;18677533;8096089;18849;4;8924662;1;0;0;0
FR;0;2021-05-11;403986;258457;1566;0;296885;0;0;0;0;19081519;8354546;20415;4;9221547;1;0;0;0
FR;0;2021-05-12;434233;233896;1545;0;270184;0;0;0;0;19515752;8588442;21960;4;9491731;1;0;0;0
FR;0;2021-05-13;338644;56435;432;0;77927;0;0;0;0;19854396;8644877;22392;4;9569658;1;0;0;0
FR;0;2021-05-14;454194;167502;1130;0;203113;0;0;0;0;20308590;8812379;23522;4;9772771;1;0;0;0
FR;0;2021-05-15;375023;94403;445;0;120802;0;0;0;0;20683613;8906782;23967;4;9893573;1;0;0;0
FR;0;2021-05-16;202779;20694;168;0;34095;0;0;0;0;20886392;8927476;24135;4;9927668;1;0;0;0
FR;0;2021-05-17;376171;148884;1555;0;178674;0;0;0;0;21262563;9076360;25690;4;10106342;1;0;0;0
FR;0;2021-05-18;460232;154152;1991;0;193306;0;0;0;0;21722795;9230512;27681;4;10299648;1;0;0;0
FR;0;2021-05-19;467483;142581;2466;0;179844;0;0;0;0;22190278;9373093;30147;4;10479492;1;0;0;0
FR;0;2021-05-20;507610;160261;2340;0;204214;0;0;0;0;22697888;9533354;32487;4;10683706;1;0;0;0
FR;0;2021-05-21;489737;175271;1997;0;221817;0;0;0;0;23187625;9708625;34484;4;10905523;1;0;0;0
FR;0;2021-05-22;347231;80251;670;0;108682;0;0;0;0;23534856;9788876;35154;4;11014205;1;0;0;0
FR;0;2021-05-23;161720;14211;246;0;26680;0;0;0;0;23696576;9803087;35400;4;11040885;1;0;0;0
FR;0;2021-05-24;263223;33111;604;0;52946;0;0;0;0;23959799;9836198;36004;4;11093831;1;0;0;0
FR;0;2021-05-25;400322;190461;2357;1;227028;0;0;0;0;24360121;10026659;38361;5;11320859;1;0;0;0
FR;0;2021-05-26;413524;191303;2227;0;229353;0;0;0;0;24773645;10217962;40588;5;11550212;1;0;0;0
FR;0;2021-05-27;449888;220134;2163;0;267274;0;0;0;0;25223533;10438096;42751;5;11817486;1;0;0;0
FR;0;2021-05-28;429618;261176;1895;0;319276;0;0;0;0;25653151;10699272;44646;5;12136762;1;0;0;0
FR;0;2021-05-29;299010;150536;586;0;183389;0;0;0;0;25952161;10849808;45232;5;12320151;1;0;0;0
FR;0;2021-05-30;107156;32504;164;0;42087;0;0;0;0;26059317;10882312;45396;5;12362238;1;0;0;0
FR;0;2021-05-31;358084;203495;1474;1;241776;1;0;0;0;26417401;11085807;46870;6;12604014;2;0;0;0
FR;0;2021-06-01;431165;251295;1969;1;302940;1;0;0;0;26848566;11337102;48839;7;12906954;3;0;0;0
FR;0;2021-06-02;420194;232819;1986;0;280207;0;0;0;0;27268760;11569921;50825;7;13187161;3;0;0;0
FR;0;2021-06-03;465724;257781;1826;0;312555;0;0;0;0;27734484;11827702;52651;7;13499716;3;0;0;0
FR;0;2021-06-04;456313;305908;1735;1;363321;1;0;0;0;28190797;12133610;54386;8;13863037;4;0;0;0
FR;0;2021-06-05;304841;189571;653;0;222794;0;0;0;0;28495638;12323181;55039;8;14085831;4;0;0;0
FR;0;2021-06-06;133344;49020;227;0;61159;0;0;0;0;28628982;12372201;55266;8;14146990;4;0;0;0
FR;0;2021-06-07;340029;261517;1529;0;298609;0;0;0;0;28969011;12633718;56795;8;14445599;4;0;0;0
FR;0;2021-06-08;393974;291418;1806;0;338284;0;0;0;0;29362985;12925136;58601;8;14783883;4;0;0;0
FR;0;2021-06-09;384976;273770;1734;0;318165;0;0;0;0;29747961;13198906;60335;8;15102048;4;0;0;0
FR;0;2021-06-10;404263;286271;1729;1;335721;0;0;0;0;30152224;13485177;62064;9;15437769;4;0;0;0
FR;0;2021-06-11;386737;356531;1468;1;406977;0;0;0;0;30538961;13841708;63532;10;15844746;4;0;0;0
FR;0;2021-06-12;283301;210996;497;0;243141;0;0;0;0;30822262;14052704;64029;10;16087887;4;0;0;0
FR;0;2021-06-13;104907;73842;204;0;84835;0;0;0;0;30927169;14126546;64233;10;16172722;4;0;0;0
FR;0;2021-06-14;240893;354030;1429;1;383227;0;0;0;0;31168062;14480576;65662;11;16555949;4;0;0;0
FR;0;2021-06-15;308239;384332;1574;1;423108;0;0;0;0;31476301;14864908;67236;12;16979057;4;0;0;0
FR;0;2021-06-16;314028;357605;1419;1;395371;0;0;0;0;31790329;15222513;68655;13;17374428;4;0;0;0
FR;0;2021-06-17;317744;373165;1432;1;414363;0;0;0;0;32108073;15595678;70087;14;17788791;4;0;0;0
FR;0;2021-06-18;321786;442593;1342;2;486001;0;0;0;0;32429859;16038271;71429;16;18274792;4;0;0;0
FR;0;2021-06-19;224368;274026;449;0;301219;0;0;0;0;32654227;16312297;71878;16;18576011;4;0;0;0
FR;0;2021-06-20;74459;102286;131;0;111479;0;0;0;0;32728686;16414583;72009;16;18687490;4;0;0;0
FR;0;2021-06-21;195820;401757;1038;1;427723;1;0;0;0;32924506;16816340;73047;17;19115213;5;0;0;0
FR;0;2021-06-22;223247;467826;1266;10;500500;1;0;0;0;33147753;17284166;74313;27;19615713;6;0;0;0
FR;0;2021-06-23;234087;440145;1198;1;474256;1;0;0;0;33381840;17724311;75511;28;20089969;7;0;0;0
FR;0;2021-06-24;241909;409778;1359;0;447271;0;0;0;0;33623749;18134089;76870;28;20537240;7;0;0;0
FR;0;2021-06-25;227678;523087;1404;0;562088;0;0;0;0;33851427;18657176;78274;28;21099328;7;0;0;0
FR;0;2021-06-26;153296;371101;589;1;395908;0;0;0;0;34004723;19028277;78863;29;21495236;7;0;0;0
FR;0;2021-06-27;55925;155943;169;1;164853;0;0;0;0;34060648;19184220;79032;30;21660089;7;0;0;0
FR;0;2021-06-28;154813;452528;1178;0;478127;0;0;0;0;34215461;19636748;80210;30;22138216;7;0;0;0
FR;0;2021-06-29;182753;507864;2124;0;539234;0;0;0;0;34398214;20144612;82334;30;22677450;7;0;0;0
FR;0;2021-06-30;204047;485260;2016;21;519524;2;0;0;0;34602261;20629872;84350;51;23196974;9;0;0;0
FR;0;2021-07-01;231467;458577;2226;5;498514;0;0;0;0;34833728;21088449;86576;56;23695488;9;0;0;0
FR;0;2021-07-02;228707;520027;2120;5;562335;2;0;0;0;35062435;21608476;88696;61;24257823;11;0;0;0
FR;0;2021-07-03;142058;368761;908;3;395248;1;0;0;0;35204493;21977237;89604;64;24653071;12;0;0;0
FR;0;2021-07-04;56765;141008;265;0;150697;0;0;0;0;35261258;22118245;89869;64;24803768;12;0;0;0
FR;0;2021-07-05;168555;418642;1668;8;448585;0;0;0;0;35429813;22536887;91537;72;25252353;12;0;0;0
FR;0;2021-07-06;196812;474524;1830;45;511114;8;0;0;0;35626625;23011411;93367;117;25763467;20;0;0;0
FR;0;2021-07-07;213258;438971;1881;25;477431;2;0;0;0;35839883;23450382;95248;142;26240898;22;0;0;0
FR;0;2021-07-08;231680;424138;2090;20;468067;2;0;0;0;36071563;23874520;97338;162;26708965;24;0;0;0
FR;0;2021-07-09;228644;511070;2185;4;557354;1;0;0;0;36300207;24385590;99523;166;27266319;25;0;0;0
FR;0;2021-07-10;148640;339925;986;1;368866;0;0;0;0;36448847;24725515;100509;167;27635185;25;0;0;0
FR;0;2021-07-11;60217;110048;284;0;120957;0;0;0;0;36509064;24835563;100793;167;27756142;25;0;0;0
FR;0;2021-07-12;169444;477699;1766;4;512426;0;0;0;0;36678508;25313262;102559;171;28268568;25;0;0;0
FR;0;2021-07-13;287312;526601;2050;8;585620;0;0;0;0;36965820;25839863;104609;179;28854188;25;0;0;0
FR;0;2021-07-14;181123;157330;435;0;186637;0;0;0;0;37146943;25997193;105044;179;29040825;25;0;0;0
FR;0;2021-07-15;347131;501597;2100;1;571556;0;0;0;0;37494074;26498790;107144;180;29612381;25;0;0;0
FR;0;2021-07-16;380125;494959;2023;3;574127;1;0;0;0;37874199;26993749;109167;183;30186508;26;0;0;0
FR;0;2021-07-17;259757;319632;877;1;368586;0;0;0;0;38133956;27313381;110044;184;30555094;26;0;0;0
FR;0;2021-07-18;109747;114565;310;0;133000;0;0;0;0;38243703;27427946;110354;184;30688094;26;0;0;0
FR;0;2021-07-19;285528;423871;1631;3;478874;0;0;0;0;38529231;27851817;111985;187;31166968;26;0;0;0
FR;0;2021-07-20;376945;451201;1725;0;523531;0;0;0;0;38906176;28303018;113710;187;31690499;26;0;0;0
FR;0;2021-07-21;395847;406819;1550;4;481800;1;0;0;0;39302023;28709837;115260;191;32172299;27;0;0;0
FR;0;2021-07-22;441092;387298;1715;4;471765;1;0;0;0;39743115;29097135;116975;195;32644064;28;0;0;0
FR;0;2021-07-23;440353;421953;1883;4;509910;1;0;0;0;40183468;29519088;118858;199;33153974;29;0;0;0
FR;0;2021-07-24;285264;269309;804;1;321989;0;0;0;0;40468732;29788397;119662;200;33475963;29;0;0;0
FR;0;2021-07-25;121130;79918;234;0;100271;0;0;0;0;40589862;29868315;119896;200;33576234;29;0;0;0
FR;0;2021-07-26;347454;322126;1614;3;384679;1;0;0;0;40937316;30190441;121510;203;33960913;30;0;0;0
FR;0;2021-07-27;464124;319258;1699;4;400406;1;0;0;0;41401440;30509699;123209;207;34361319;31;0;0;0
FR;0;2021-07-28;459483;289369;1637;4;366979;1;0;0;0;41860923;30799068;124846;211;34728298;32;0;0;0
FR;0;2021-07-29;489868;276100;1797;2;356969;0;0;0;0;42350791;31075168;126643;213;35085267;32;0;0;0
FR;0;2021-07-30;461863;302327;1942;5;380806;1;0;0;0;42812654;31377495;128585;218;35466073;33;0;0;0
FR;0;2021-07-31;285426;185023;916;1;231508;0;0;0;0;43098080;31562518;129501;219;35697581;33;0;0;0
FR;0;2021-08-01;112056;49908;257;0;65686;0;0;0;0;43210136;31612426;129758;219;35763267;33;0;0;0
FR;0;2021-08-02;341681;234026;1603;2;284714;0;0;0;0;43551817;31846452;131361;221;36047981;33;0;0;0
FR;0;2021-08-03;398648;244428;1729;2;304496;1;0;0;0;43950465;32090880;133090;223;36352477;34;0;0;0
FR;0;2021-08-04;384887;209510;1594;6;265629;3;0;0;0;44335352;32300390;134684;229;36618106;37;0;0;0
FR;0;2021-08-05;366206;228339;1711;0;281712;0;0;0;0;44701558;32528729;136395;229;36899818;37;0;0;0
FR;0;2021-08-06;359762;271206;1835;4;326582;0;0;0;0;45061320;32799935;138230;233;37226400;37;0;0;0
FR;0;2021-08-07;213152;178315;756;5;210040;1;0;0;0;45274472;32978250;138986;238;37436440;38;0;0;0
FR;0;2021-08-08;74213;63190;276;0;73623;0;0;0;0;45348685;33041440;139262;238;37510063;38;0;0;0
FR;0;2021-08-09;258779;258570;1549;4;297479;2;0;0;0;45607464;33300010;140811;242;37807542;40;0;0;0
FR;0;2021-08-10;306900;277039;1662;2;323421;0;0;0;0;45914364;33577049;142473;244;38130963;40;0;0;0
FR;0;2021-08-11;279770;259535;1442;5;301602;0;0;0;0;46194134;33836584;143915;249;38432565;40;0;0;0
FR;0;2021-08-12;271575;277997;1669;3;320250;0;0;0;0;46465709;34114581;145584;252;38752815;40;0;0;0
FR;0;2021-08-13;252181;278119;1595;3;316951;2;0;0;0;46717890;34392700;147179;255;39069766;42;0;0;0
FR;0;2021-08-14;145366;197059;740;0;218980;0;0;0;0;46863256;34589759;147919;255;39288746;42;0;0;0
FR;0;2021-08-15;39403;50088;218;1;55668;0;0;0;0;46902659;34639847;148137;256;39344414;42;0;0;0
FR;0;2021-08-16;186198;317462;1543;0;345380;0;0;0;0;47088857;34957309;149680;256;39689794;42;0;0;0
FR;0;2021-08-17;215721;335792;1638;7;368824;0;0;0;0;47304578;35293101;151318;263;40058618;42;0;0;0
FR;0;2021-08-18;199083;324368;1599;7;354529;3;0;0;0;47503661;35617469;152917;270;40413147;45;0;0;0
FR;0;2021-08-19;192054;325390;1642;1;355945;0;0;0;0;47695715;35942859;154559;271;40769092;45;0;0;0
FR;0;2021-08-20;186495;366174;1823;3;396600;2;0;0;0;47882210;36309033;156382;274;41165692;47;0;0;0
FR;0;2021-08-21;104815;238131;709;0;254561;0;0;0;0;47987025;36547164;157091;274;41420253;47;0;0;0
FR;0;2021-08-22;31950;87210;256;1;92162;1;0;0;0;48018975;36634374;157347;275;41512415;48;0;0;0
FR;0;2021-08-23;141003;356998;1561;3;379587;0;0;0;0;48159978;36991372;158908;278;41892002;48;0;0;0
FR;0;2021-08-24;162524;376571;1850;5;402817;0;0;0;0;48322502;37367943;160758;283;42294819;48;0;0;0
FR;0;2021-08-25;151165;350712;2038;8;375398;2;0;0;0;48473667;37718655;162796;291;42670217;50;0;0;0
FR;0;2021-08-26;142899;342771;2564;10;367560;0;0;0;0;48616566;38061426;165360;301;43037777;50;0;0;0
FR;0;2021-08-27;148457;388231;2791;11;414864;1;0;0;0;48765023;38449657;168151;312;43452641;51;0;0;0
FR;0;2021-08-28;90682;249640;1407;0;264964;0;0;0;0;48855705;38699297;169558;312;43717605;51;0;0;0
FR;0;2021-08-29;27325;83357;518;1;88273;0;0;0;0;48883030;38782654;170076;313;43805878;51;0;0;0
FR;0;2021-08-30;117432;324564;4714;6;342386;5831;0;0;0;49000462;39107218;174790;319;44148264;5882;0;0;0
FR;0;2021-08-31;128834;334446;10189;19;353925;11765;2;0;0;49129296;39441664;184979;338;44502189;17647;2;0;0
FR;0;2021-09-01;136168;285658;22437;8;302400;24411;1;0;0;49265464;39727322;207416;346;44804589;42058;3;0;0
FR;0;2021-09-02;114655;247200;26525;20;262098;29009;0;0;0;49380119;39974522;233941;366;45066687;71067;3;0;0
FR;0;2021-09-03;118331;292647;29968;24;309303;33076;1;0;0;49498450;40267169;263909;390;45375990;104143;4;0;0
FR;0;2021-09-04;89894;217797;12587;12;230488;14157;7;0;0;49588344;40484966;276496;402;45606478;118300;11;0;0
FR;0;2021-09-05;21366;44794;4397;2;48279;4714;0;0;0;49609710;40529760;280893;404;45654757;123014;11;0;0
FR;0;2021-09-06;75701;180485;31957;16;190661;34305;2;0;0;49685411;40710245;312850;420;45845418;157319;13;0;0
FR;0;2021-09-07;80317;181181;33251;43;191039;36322;2;0;0;49765728;40891426;346101;463;46036457;193641;15;0;0
FR;0;2021-09-08;91014;206087;29666;28;216566;32572;4;0;0;49856742;41097513;375767;491;46253023;226213;19;0;0
FR;0;2021-09-09;76986;165314;33085;27;174118;36699;5;0;0;49933728;41262827;408852;518;46427141;262912;24;0;0
FR;0;2021-09-10;96051;203819;35743;28;214895;40790;7;0;0;50029779;41466646;444595;546;46642036;303702;31;0;0
FR;0;2021-09-11;67169;169343;12140;19;178186;14414;0;0;0;50096948;41635989;456735;565;46820222;318116;31;0;0
FR;0;2021-09-12;12830;32092;2784;1;34138;3190;2;0;0;50109778;41668081;459519;566;46854360;321306;33;0;0
FR;0;2021-09-13;64582;126155;41249;35;134171;44268;17;0;0;50174360;41794236;500768;601;46988531;365574;50;0;0
FR;0;2021-09-14;73504;129010;56393;80;135749;62454;39;0;0;50247864;41923246;557161;681;47124280;428028;89;0;0
FR;0;2021-09-15;76668;167735;55671;58;174677;54852;76;0;0;50324532;42090981;612832;739;47298957;482880;165;0;0
FR;0;2021-09-16;63898;114504;60099;82;117880;60179;59;0;0;50388430;42205485;672931;821;47416837;543059;224;0;0
FR;0;2021-09-17;75093;156853;53871;71;159730;57366;67;0;0;50463523;42362338;726802;892;47576567;600425;291;0;0
FR;0;2021-09-18;48244;139637;15603;25;144317;17321;20;0;0;50511767;42501975;742405;917;47720884;617746;311;0;0
FR;0;2021-09-19;7908;23645;2443;1;24875;2619;1;0;0;50519675;42525620;744848;918;47745759;620365;312;0;0
FR;0;2021-09-20;44580;93752;50086;72;96242;50346;34;0;0;50564255;42619372;794934;990;47842001;670711;346;0;0
FR;0;2021-09-21;45918;98368;62772;77;98385;63506;79;0;0;50610173;42717740;857706;1067;47940386;734217;425;0;0
FR;0;2021-09-22;48710;142398;55385;82;144842;55486;47;0;0;50658883;42860138;913091;1149;48085228;789703;472;0;0
FR;0;2021-09-23;43298;92065;62408;95;91272;63589;86;0;0;50702181;42952203;975499;1244;48176500;853292;558;0;0
FR;0;2021-09-24;52324;133289;54570;107;132385;59232;78;0;0;50754505;43085492;1030069;1351;48308885;912524;636;0;0
FR;0;2021-09-25;35225;115667;16277;36;118648;18318;22;0;0;50789730;43201159;1046346;1387;48427533;930842;658;0;0
FR;0;2021-09-26;5561;17803;2273;5;18690;2331;5;0;0;50795291;43218962;1048619;1392;48446223;933173;663;0;0
FR;0;2021-09-27;33986;76896;47221;97;78782;48207;80;0;1;50829277;43295858;1095840;1489;48525005;981380;743;0;1
FR;0;2021-09-28;36524;75245;54983;90;74325;56602;45;0;0;50865801;43371103;1150823;1579;48599330;1037982;788;0;1
FR;0;2021-09-29;44426;100686;53376;113;102846;54911;41;0;0;50910227;43471789;1204199;1692;48702176;1092893;829;0;1
FR;0;2021-09-30;36349;72979;57047;96;71481;59613;57;0;0;50946576;43544768;1261246;1788;48773657;1152506;886;0;1
FR;0;2021-10-01;61720;102863;57836;108;101413;64019;23;0;0;51008296;43647631;1319082;1896;48875070;1216525;909;0;1
FR;0;2021-10-02;39473;78460;20965;39;81737;23386;12;0;0;51047769;43726091;1340047;1935;48956807;1239911;921;0;1
FR;0;2021-10-03;5290;10489;2536;4;11255;2542;4;0;0;51053059;43736580;1342583;1939;48968062;1242453;925;0;1
FR;0;2021-10-04;35208;58501;52638;84;59500;54860;37;0;0;51088267;43795081;1395221;2023;49027562;1297313;962;0;1
FR;0;2021-10-05;33937;64382;61032;135;62111;65122;47;0;0;51122204;43859463;1456253;2158;49089673;1362435;1009;0;1
FR;0;2021-10-06;42728;79308;65764;112;80181;68385;28;0;0;51164932;43938771;1522017;2270;49169854;1430820;1037;0;1
FR;0;2021-10-07;30576;62280;65450;88;59498;68898;38;0;0;51195508;44001051;1587467;2358;49229352;1499718;1075;0;1
FR;0;2021-10-08;49486;91947;77772;111;89888;84806;39;0;0;51244994;44092998;1665239;2469;49319240;1584524;1114;0;1
FR;0;2021-10-09;33677;60950;31549;35;64140;33933;17;0;0;51278671;44153948;1696788;2504;49383380;1618457;1131;0;1
FR;0;2021-10-10;4722;7424;3199;9;7940;3475;2;0;0;51283393;44161372;1699987;2513;49391320;1621932;1133;0;1
FR;0;2021-10-11;30736;49886;61050;105;50602;64120;46;0;0;51314129;44211258;1761037;2618;49441922;1686052;1179;0;1
FR;0;2021-10-12;31651;54483;70635;141;51309;76050;27;0;0;51345780;44265741;1831672;2759;49493231;1762102;1206;0;1
FR;0;2021-10-13;40168;62851;74443;137;62799;79398;29;0;1;51385948;44328592;1906115;2896;49556030;1841500;1235;0;2
FR;0;2021-10-14;30364;52874;68779;116;49695;73871;31;0;0;51416312;44381466;1974894;3012;49605725;1915371;1266;0;2
FR;0;2021-10-15;44961;75240;93255;191;70332;103058;26;0;0;51461273;44456706;2068149;3203;49676057;2018429;1292;0;2
FR;0;2021-10-16;31335;44081;36701;45;46701;39650;15;0;0;51492608;44500787;2104850;3248;49722758;2058079;1307;0;2
FR;0;2021-10-17;3898;5230;3603;2;5677;3674;4;0;0;51496506;44506017;2108453;3250;49728435;2061753;1311;0;2
FR;0;2021-10-18;29217;42343;67522;134;42560;71384;27;0;0;51525723;44548360;2175975;3384;49770995;2133137;1338;0;2
FR;0;2021-10-19;27196;45547;76431;140;43203;81679;43;0;0;51552919;44593907;2252406;3524;49814198;2214816;1381;0;2
FR;0;2021-10-20;35347;52403;96961;181;51809;101580;45;0;0;51588266;44646310;2349367;3705;49866007;2316396;1426;0;2
FR;0;2021-10-21;26169;45173;83999;112;41969;89196;30;0;0;51614435;44691483;2433366;3817;49907976;2405592;1456;0;2
FR;0;2021-10-22;38450;62488;104928;200;59355;112654;61;0;0;51652885;44753971;2538294;4017;49967331;2518246;1517;0;2
FR;0;2021-10-23;27034;41204;45467;57;42426;48637;14;0;0;51679919;44795175;2583761;4074;50009757;2566883;1531;0;2
FR;0;2021-10-24;2947;4763;3686;6;5014;3923;1;0;0;51682866;44799938;2587447;4080;50014771;2570806;1532;0;2
FR;0;2021-10-25;26109;36208;82347;144;35481;86681;38;0;0;51708975;44836146;2669794;4224;50050252;2657487;1570;0;2
FR;0;2021-10-26;23770;34993;87283;166;32158;92413;35;0;0;51732745;44871139;2757077;4390;50082410;2749900;1605;0;2
FR;0;2021-10-27;30115;46298;109035;257;44037;114753;48;0;0;51762860;44917437;2866112;4647;50126447;2864653;1653;0;2
FR;0;2021-10-28;23611;34927;88745;153;31194;94543;35;0;0;51786471;44952364;2954857;4800;50157641;2959196;1688;0;2
FR;0;2021-10-29;31589;51450;117349;206;46497;125438;52;0;0;51818060;45003814;3072206;5006;50204138;3084634;1740;0;2
FR;0;2021-10-30;20578;33237;50361;76;32919;53430;20;0;0;51838638;45037051;3122567;5082;50237057;3138064;1760;0;2
FR;0;2021-10-31;2519;3732;3595;3;3844;3881;3;0;0;51841157;45040783;3126162;5085;50240901;3141945;1763;0;2
FR;0;2021-11-01;8544;4869;3224;3;5020;3587;10;0;0;51849701;45045652;3129386;5088;50245921;3145532;1773;0;2
FR;0;2021-11-02;26387;40099;93612;156;36237;99674;44;0;1;51876088;45085751;3222998;5244;50282158;3245206;1817;0;3
FR;0;2021-11-03;30134;47902;118933;222;43555;125912;62;0;0;51906222;45133653;3341931;5466;50325713;3371118;1879;0;3
FR;0;2021-11-04;23824;37459;107603;217;31572;114483;46;0;0;51930046;45171112;3449534;5683;50357285;3485601;1925;0;3
FR;0;2021-11-05;32422;52937;141679;236;44652;151469;54;0;0;51962468;45224049;3591213;5919;50401937;3637070;1979;0;3
FR;0;2021-11-06;21554;34551;64911;123;32384;68353;26;0;0;51984022;45258600;3656124;6042;50434321;3705423;2005;0;3
FR;0;2021-11-07;2430;4154;5209;6;4000;5598;7;0;0;51986452;45262754;3661333;6048;50438321;3711021;2012;0;3
FR;0;2021-11-08;20634;37741;127237;227;30950;134364;50;0;0;52007086;45300495;3788570;6275;50469271;3845385;2062;0;3
FR;0;2021-11-09;22443;44652;161745;339;32855;172360;65;0;0;52029529;45345147;3950315;6614;50502126;4017745;2127;0;3
FR;0;2021-11-10;31621;54875;187071;447;44022;198891;91;0;0;52061150;45400022;4137386;7061;50546148;4216636;2218;0;3
FR;0;2021-11-11;4750;6744;12999;28;5906;13982;17;0;0;52065900;45406766;4150385;7089;50552054;4230618;2235;0;3
FR;0;2021-11-12;29103;55051;183839;252;41714;197506;86;0;0;52095003;45461817;4334224;7341;50593768;4428124;2321;0;3
FR;0;2021-11-13;20357;32596;80730;118;28226;86354;44;0;0;52115360;45494413;4414954;7459;50621994;4514478;2365;0;3
FR;0;2021-11-14;2367;3854;7184;6;3362;7847;9;0;0;52117727;45498267;4422138;7465;50625356;4522325;2374;0;3
FR;0;2021-11-15;20525;38546;160911;314;27780;171651;77;0;0;52138252;45536813;4583049;7779;50653136;4693976;2451;0;3
FR;0;2021-11-16;23675;43824;200492;394;27699;215192;115;0;1;52161927;45580637;4783541;8173;50680835;4909168;2566;0;4
FR;0;2021-11-17;30545;50238;199905;406;36445;212973;98;0;0;52192472;45630875;4983446;8579;50717280;5122141;2664;0;4
FR;0;2021-11-18;23460;45680;191758;469;29389;205745;94;0;0;52215932;45676555;5175204;9048;50746669;5327886;2758;0;4
FR;0;2021-11-19;33696;61268;243294;551;39904;262313;147;0;0;52249628;45737823;5418498;9599;50786573;5590199;2905;0;4
FR;0;2021-11-20;25426;36658;102195;207;29266;109768;43;0;0;52275054;45774481;5520693;9806;50815839;5699967;2948;0;4
FR;0;2021-11-21;2666;4444;9683;19;3443;10609;19;0;0;52277720;45778925;5530376;9825;50819282;5710576;2967;0;4
FR;0;2021-11-22;22824;33111;180437;472;18911;194924;90;0;0;52300544;45812036;5710813;10297;50838193;5905500;3057;0;4
FR;0;2021-11-23;25738;45456;229496;549;24111;247986;85;0;0;52326282;45857492;5940309;10846;50862304;6153486;3142;0;4
FR;0;2021-11-24;31822;53591;224910;715;34472;243364;80;0;0;52358104;45911083;6165219;11561;50896776;6396850;3222;0;4
FR;0;2021-11-25;25654;49132;256032;739;25045;277943;112;0;0;52383758;45960215;6421251;12300;50921821;6674793;3334;0;4
FR;0;2021-11-26;33255;74669;379565;867;37392;414799;172;0;0;52417013;46034884;6800816;13167;50959213;7089592;3506;0;4
FR;0;2021-11-27;23508;49551;214980;391;28440;236786;135;0;0;52440521;46084435;7015796;13558;50987653;7326378;3641;0;4
FR;0;2021-11-28;3528;10442;56787;66;4057;63333;42;0;0;52444049;46094877;7072583;13624;50991710;7389711;3683;0;4
FR;0;2021-11-29;19449;54062;341574;864;23090;371912;178;0;0;52463498;46148939;7414157;14488;51014800;7761623;3861;0;4
FR;0;2021-11-30;24789;71793;457493;988;26790;500936;291;0;0;52488287;46220732;7871650;15476;51041590;8262559;4152;0;4
FR;0;2021-12-01;27401;75418;469225;1162;31307;511449;304;0;0;52515688;46296150;8340875;16638;51072897;8774008;4456;0;4
FR;0;2021-12-02;22133;71460;527255;1282;20994;575058;309;0;0;52537821;46367610;8868130;17920;51093891;9349066;4765;0;4
FR;0;2021-12-03;25582;92765;596539;1421;34325;651332;343;0;0;52563403;46460375;9464669;19341;51128216;10000398;5108;0;4
FR;0;2021-12-04;18342;60285;336314;692;25660;369891;197;0;0;52581745;46520660;9800983;20033;51153876;10370289;5305;0;4
FR;0;2021-12-05;4158;16083;95820;157;4852;107050;92;0;0;52585903;46536743;9896803;20190;51158728;10477339;5397;0;4
FR;0;2021-12-06;28452;72658;493295;1175;25215;540115;386;0;0;52614355;46609401;10390098;21365;51183943;11017454;5783;0;4
FR;0;2021-12-07;23569;91184;645590;1774;28503;706602;416;0;0;52637924;46700585;11035688;23139;51212446;11724056;6199;0;4
FR;0;2021-12-08;25526;91861;591910;1875;34933;647777;439;0;0;52663450;46792446;11627598;25014;51247379;12371833;6638;0;4
FR;0;2021-12-09;24088;94006;663385;2179;28951;726830;463;0;0;52687538;46886452;12290983;27193;51276330;13098663;7101;0;4
FR;0;2021-12-10;28080;110827;736224;2075;37926;806401;471;0;1;52715618;46997279;13027207;29268;51314256;13905064;7572;0;5
FR;0;2021-12-11;20254;76040;435258;990;29934;480485;343;0;0;52735872;47073319;13462465;30258;51344190;14385549;7915;0;5
FR;0;2021-12-12;5685;23105;142363;262;6385;159236;108;0;0;52741557;47096424;13604828;30520;51350575;14544785;8023;0;5
FR;0;2021-12-13;21371;90672;587854;1699;29628;649469;397;0;0;52762928;47187096;14192682;32219;51380203;15194254;8420;0;5
FR;0;2021-12-14;27991;118201;765826;2658;35394;847808;701;0;1;52790919;47305297;14958508;34877;51415597;16042062;9121;0;6
FR;0;2021-12-15;28458;114128;694536;2267;39484;769317;503;0;1;52819377;47419425;15653044;37144;51455081;16811379;9624;0;7
FR;0;2021-12-16;28059;115559;764276;2559;35074;844700;516;0;0;52847436;47534984;16417320;39703;51490155;17656079;10140;0;7
FR;0;2021-12-17;31665;128217;808044;2713;43318;892197;611;0;0;52879101;47663201;17225364;42416;51533473;18548276;10751;0;7
FR;0;2021-12-18;24945;81470;470067;1179;30038;522271;353;0;0;52904046;47744671;17695431;43595;51563511;19070547;11104;0;7
FR;0;2021-12-19;8771;28505;169449;376;7834;191056;143;0;0;52912817;47773176;17864880;43971;51571345;19261603;11247;0;7
FR;0;2021-12-20;31785;97011;591633;1789;33807;658847;503;0;0;52944602;47870187;18456513;45760;51605152;19920450;11750;0;7
FR;0;2021-12-21;39484;111839;682566;2391;38746;759701;607;0;0;52984086;47982026;19139079;48151;51643898;20680151;12357;0;7
FR;0;2021-12-22;39566;99105;575911;2169;37075;642229;687;0;2;53023652;48081131;19714990;50320;51680973;21322380;13044;0;9
FR;0;2021-12-23;33794;79316;441114;1659;30089;494450;589;0;0;53057446;48160447;20156104;51979;51711062;21816830;13633;0;9
FR;0;2021-12-24;10701;26012;111060;398;11636;126676;236;0;1;53068147;48186459;20267164;52377;51722698;21943506;13869;0;10
FR;0;2021-12-25;779;3565;7603;25;2046;9022;72;0;0;53068926;48190024;20274767;52402;51724744;21952528;13941;0;10
FR;0;2021-12-26;4699;11876;52128;142;4735;60172;170;0;0;53073625;48201900;20326895;52544;51729479;22012700;14111;0;10
FR;0;2021-12-27;30510;83906;453633;1364;33013;509282;665;0;0;53104135;48285806;20780528;53908;51762492;22521982;14776;0;10
FR;0;2021-12-28;38369;98787;564242;1769;35082;632338;1558;0;2;53142504;48384593;21344770;55677;51797574;23154320;16334;0;12
FR;0;2021-12-29;39882;88134;501292;1687;33082;561058;1738;0;1;53182386;48472727;21846062;57364;51830656;23715378;18072;0;13
FR;0;2021-12-30;35928;75050;421076;1521;29499;471184;1880;0;0;53218314;48547777;22267138;58885;51860155;24186562;19952;0;13
FR;0;2021-12-31;12053;25073;116896;405;11263;131680;741;0;0;53230367;48572850;22384034;59290;51871418;24318242;20693;0;13
FR;0;2022-01-01;1597;3217;8533;37;1808;9942;103;0;0;53231964;48576067;22392567;59327;51873226;24328184;20796;0;13
FR;0;2022-01-02;6131;13015;58437;126;5110;66975;408;0;0;53238095;48589082;22451004;59453;51878336;24395159;21204;0;13
FR;0;2022-01-03;39750;90136;494909;1597;36875;551789;2650;0;1;53277845;48679218;22945913;61050;51915211;24946948;23854;0;14
FR;0;2022-01-04;42316;110969;641488;2309;40641;714497;3836;0;3;53320161;48790187;23587401;63359;51955852;25661445;27690;0;17
FR;0;2022-01-05;61226;103576;569288;1985;43794;634323;3429;0;2;53381387;48893763;24156689;65344;51999646;26295768;31119;0;19
FR;0;2022-01-06;44321;110305;639068;2702;40219;711591;4556;0;2;53425708;49004068;24795757;68046;52039865;27007359;35675;0;21
FR;0;2022-01-07;50848;123278;711079;2811;46837;790563;4995;0;2;53476556;49127346;25506836;70857;52086702;27797922;40670;0;23
FR;0;2022-01-08;45015;80263;423847;1213;35042;472911;2447;0;3;53521571;49207609;25930683;72070;52121744;28270833;43117;0;26
FR;0;2022-01-09;15614;26592;128585;300;11482;145663;829;0;0;53537185;49234201;26059268;72370;52133226;28416496;43946;0;26
FR;0;2022-01-10;35425;93245;469404;1816;43020;522790;3722;0;1;53572610;49327446;26528672;74186;52176246;28939286;47668;0;27
FR;0;2022-01-11;41956;100433;548349;2311;42392;608599;5218;0;2;53614566;49427879;27077021;76497;52218638;29547885;52886;0;29
FR;0;2022-01-12;60425;95680;452752;1969;49482;504416;4497;0;8;53674991;49523559;27529773;78466;52268120;30052301;57383;0;37
FR;0;2022-01-13;38275;92511;487422;2084;40547;541103;5467;0;8;53713266;49616070;28017195;80550;52308667;30593404;62850;0;45
FR;0;2022-01-14;42590;103286;568676;2286;43496;629062;6463;0;2;53755856;49719356;28585871;82836;52352163;31222466;69313;0;47
FR;0;2022-01-15;39433;65880;340169;985;31449;377582;3296;0;1;53795289;49785236;28926040;83821;52383612;31600048;72609;0;48
FR;0;2022-01-16;11415;19194;87447;216;9016;99404;764;0;0;53806704;49804430;29013487;84037;52392628;31699452;73373;0;48
FR;0;2022-01-17;24756;59979;320338;1384;28036;354176;3960;0;4;53831460;49864409;29333825;85421;52420664;32053628;77333;0;52
FR;0;2022-01-18;28332;68678;361152;1802;32012;397600;5771;0;1;53859792;49933087;29694977;87223;52452676;32451228;83104;0;53
FR;0;2022-01-19;43231;67008;281355;1452;40384;311093;4392;0;5;53903023;50000095;29976332;88675;52493060;32762321;87496;0;58
FR;0;2022-01-20;23681;59591;299074;1750;29562;328542;5637;0;4;53926704;50059686;30275406;90425;52522622;33090863;93133;0;62
FR;0;2022-01-21;28215;68765;366414;2086;33071;401221;6580;0;3;53954919;50128451;30641820;92511;52555693;33492084;99713;0;65
FR;0;2022-01-22;27630;47971;218811;840;27302;241796;2838;0;2;53982549;50176422;30860631;93351;52582995;33733880;102551;0;67
FR;0;2022-01-23;6740;12962;48695;173;7502;55169;591;0;1;53989289;50189384;30909326;93524;52590497;33789049;103142;0;68
FR;0;2022-01-24;16287;47437;217357;1149;25400;239356;4103;0;3;54005576;50236821;31126683;94673;52615897;34028405;107245;0;71
FR;0;2022-01-25;19034;54317;243104;1548;28808;267104;6067;0;5;54024610;50291138;31369787;96221;52644705;34295509;113312;0;76
FR;0;2022-01-26;28148;60550;209319;1299;41362;229548;4479;0;3;54052758;50351688;31579106;97520;52686067;34525057;117791;0;79
FR;0;2022-01-27;16338;46487;207675;1287;26148;226065;5693;0;4;54069096;50398175;31786781;98807;52712215;34751122;123484;0;83
FR;0;2022-01-28;21594;78648;290091;1574;44968;321349;7411;0;4;54090690;50476823;32076872;100381;52757183;35072471;130895;0;87
FR;0;2022-01-29;18424;52844;184145;689;32751;204575;3255;0;2;54109114;50529667;32261017;101070;52789934;35277046;134150;0;89
FR;0;2022-01-30;4477;14462;39152;124;9129;45056;637;0;1;54113591;50544129;32300169;101194;52799063;35322102;134787;0;90
FR;0;2022-01-31;11261;43903;148219;742;26128;164721;4230;0;5;54124852;50588032;32448388;101936;52825191;35486823;139017;0;95
FR;0;2022-02-01;13653;48291;174148;1145;27329;191335;7036;0;1;54138505;50636323;32622536;103081;52852520;35678158;146053;0;96
FR;0;2022-02-02;20761;66294;171561;1035;46158;190079;5969;0;10;54159266;50702617;32794097;104116;52898678;35868237;152022;0;106
FR;0;2022-02-03;11760;44790;157585;990;25346;173287;6932;0;6;54171026;50747407;32951682;105106;52924024;36041524;158954;0;112
FR;0;2022-02-04;14647;67979;239263;1267;37603;264080;9153;0;6;54185673;50815386;33190945;106373;52961627;36305604;168107;0;118
FR;0;2022-02-05;12903;51439;153565;523;31977;172293;3784;0;3;54198576;50866825;33344510;106896;52993604;36477897;171891;0;121
FR;0;2022-02-06;2726;12168;28898;103;7289;33830;663;0;0;54201302;50878993;33373408;106999;53000893;36511727;172554;0;121
FR;0;2022-02-07;9620;46620;156905;594;24516;176302;5294;0;6;54210922;50925613;33530313;107593;53025409;36688029;177848;0;127
FR;0;2022-02-08;9817;43102;166665;870;20967;184460;7054;0;6;54220739;50968715;33696978;108463;53046376;36872489;184902;0;133
FR;0;2022-02-09;14463;58262;172360;876;35361;193068;5788;0;9;54235202;51026977;33869338;109339;53081737;37065557;190690;0;142
FR;0;2022-02-10;8731;39229;150244;881;18706;166722;6503;0;2;54243933;51066206;34019582;110220;53100443;37232279;197193;0;144
FR;0;2022-02-11;10864;55704;218522;1101;25847;243117;8322;0;3;54254797;51121910;34238104;111321;53126290;37475396;205515;0;147
FR;0;2022-02-12;8409;40970;134740;465;22637;151768;3509;0;4;54263206;51162880;34372844;111786;53148927;37627164;209024;0;151
FR;0;2022-02-13;1940;8605;26568;86;4411;30930;544;0;3;54265146;51171485;34399412;111872;53153338;37658094;209568;0;154
FR;0;2022-02-14;6998;35260;148389;487;14672;166385;4789;0;5;54272144;51206745;34547801;112359;53168010;37824479;214357;0;159
FR;0;2022-02-15;7070;36238;147003;751;16008;162588;6849;0;3;54279214;51242983;34694804;113110;53184018;37987067;221206;0;162
FR;0;2022-02-16;9417;42994;132550;722;25985;146769;5727;0;6;54288631;51285977;34827354;113832;53210003;38133836;226933;0;168
FR;0;2022-02-17;5582;24348;87320;587;13147;94895;5408;0;5;54294213;51310325;34914674;114419;53223150;38228731;232341;0;173
FR;0;2022-02-18;7003;33597;119673;807;18769;129339;7416;0;2;54301216;51343922;35034347;115226;53241919;38358070;239757;0;175
FR;0;2022-02-19;5372;24558;70030;371;15910;77340;3020;0;2;54306588;51368480;35104377;115597;53257829;38435410;242777;0;177
FR;0;2022-02-20;1152;4661;12175;39;2916;13957;460;0;1;54307740;51373141;35116552;115636;53260745;38449367;243237;0;178
FR;0;2022-02-21;4100;17896;61958;351;10173;67188;4059;0;2;54311840;51391037;35178510;115987;53270918;38516555;247296;0;180
FR;0;2022-02-22;4468;18669;60840;577;11271;64481;5255;0;1;54316308;51409706;35239350;116564;53282189;38581036;252551;0;181
FR;0;2022-02-23;6593;27364;66512;593;19632;71911;4595;0;3;54322901;51437070;35305862;117157;53301821;38652947;257146;0;184
FR;0;2022-02-24;3852;15564;50435;519;9524;53259;4531;0;2;54326753;51452634;35356297;117676;53311345;38706206;261677;0;186
FR;0;2022-02-25;5287;24299;76372;804;15274;80104;7336;0;7;54332040;51476933;35432669;118480;53326619;38786310;269013;0;193
FR;0;2022-02-26;3995;17772;47421;359;12174;51488;3083;0;3;54336035;51494705;35480090;118839;53338793;38837798;272096;0;196
FR;0;2022-02-27;881;3011;8040;47;1980;8949;531;0;0;54336916;51497716;35488130;118886;53340773;38846747;272627;0;196
FR;0;2022-02-28;3127;12563;40496;359;7597;42930;3857;0;0;54340043;51510279;35528626;119245;53348370;38889677;276484;0;196
FR;0;2022-03-01;4013;12615;44203;438;7639;44875;5519;0;6;54344056;51522894;35572829;119683;53356009;38934552;282003;0;202
FR;0;2022-03-02;5338;17901;47155;448;12961;49087;4931;0;2;54349394;51540795;35619984;120131;53368970;38983639;286934;0;204
FR;0;2022-03-03;2830;9362;29902;371;6260;30025;4050;0;2;54352224;51550157;35649886;120502;53375230;39013664;290984;0;206
FR;0;2022-03-04;3230;12524;40343;669;8522;39493;6235;0;4;54355454;51562681;35690229;121171;53383752;39053157;297219;0;210
FR;0;2022-03-05;3074;9291;24962;315;7133;25126;3136;0;1;54358528;51571972;35715191;121486;53390885;39078283;300355;0;211
FR;0;2022-03-06;522;1410;3199;43;1031;3444;379;0;0;54359050;51573382;35718390;121529;53391916;39081727;300734;0;211
FR;0;2022-03-07;2499;5636;18439;315;3853;17710;3308;0;4;54361549;51579018;35736829;121844;53395769;39099437;304042;0;215
FR;0;2022-03-08;2155;6082;19452;363;4336;17925;4093;0;3;54363704;51585100;35756281;122207;53400105;39117362;308135;0;218
FR;0;2022-03-09;3583;10572;22200;408;8799;21295;4042;0;4;54367287;51595672;35778481;122615;53408904;39138657;312177;0;222
FR;0;2022-03-10;1833;5849;17013;345;4398;15839;3408;0;3;54369120;51601521;35795494;122960;53413302;39154496;315585;0;225
FR;0;2022-03-11;2422;7568;24511;545;5446;22280;5479;0;2;54371542;51609089;35820005;123505;53418748;39176776;321064;0;227
FR;0;2022-03-12;2699;6776;17168;309;5494;16522;3137;0;2;54374241;51615865;35837173;123814;53424242;39193298;324201;0;229
FR;0;2022-03-13;407;795;2323;150;605;2272;538;0;0;54374648;51616660;35839496;123964;53424847;39195570;324739;0;229
FR;0;2022-03-14;1563;4278;14990;4412;2813;13843;7295;0;8;54376211;51620938;35854486;128376;53427660;39209413;332034;0;237
FR;0;2022-03-15;1751;6295;16387;7556;4810;14618;11036;0;9;54377962;51627233;35870873;135932;53432470;39224031;343070;0;246
FR;0;2022-03-16;3041;7415;19436;13142;6217;18113;16299;0;8;54381003;51634648;35890309;149074;53438687;39242144;359369;0;254
FR;0;2022-03-17;1466;3988;13157;10846;2809;11996;13315;0;9;54382469;51638636;35903466;159920;53441496;39254140;372684;0;263
FR;0;2022-03-18;2268;5758;20019;18307;4099;18115;22039;0;15;54384737;51644394;35923485;178227;53445595;39272255;394723;0;278
FR;0;2022-03-19;2294;4806;13116;9406;4142;12421;11409;0;6;54387031;51649200;35936601;187633;53449737;39284676;406132;0;284
FR;0;2022-03-20;302;738;1920;1074;530;1933;1340;0;2;54387333;51649938;35938521;188707;53450267;39286609;407472;0;286
FR;0;2022-03-21;1395;3222;12736;14951;2157;11962;16910;0;11;54388728;51653160;35951257;203658;53452424;39298571;424382;0;297
FR;0;2022-03-22;1557;3743;13808;20554;2581;12564;22846;0;5;54390285;51656903;35965065;224212;53455005;39311135;447228;0;302
FR;0;2022-03-23;2692;6300;17743;23152;5232;17251;25269;0;40;54392977;51663203;35982808;247364;53460237;39328386;472497;0;342
FR;0;2022-03-24;1411;3160;11600;17619;2248;10685;19394;0;23;54394388;51666363;35994408;264983;53462485;39339071;491891;0;365
FR;0;2022-03-25;2090;5160;18583;27777;3691;16922;30810;0;31;54396478;51671523;36012991;292760;53466176;39355993;522701;0;396
FR;0;2022-03-26;2232;4418;12080;12680;3866;11521;14402;0;26;54398710;51675941;36025071;305440;53470042;39367514;537103;0;422
FR;0;2022-03-27;365;693;1909;1483;515;1943;1740;0;1;54399075;51676634;36026980;306923;53470557;39369457;538843;0;423
FR;0;2022-03-28;1468;3082;11133;17490;2120;10621;19070;0;16;54400543;51679716;36038113;324413;53472677;39380078;557913;0;439
FR;0;2022-03-29;1452;3284;12913;27586;2098;12055;29285;0;34;54401995;51683000;36051026;351999;53474775;39392133;587198;0;473
FR;0;2022-03-30;2854;5589;15691;27435;4773;15091;29341;0;21;54404849;51688589;36066717;379434;53479548;39407224;616539;0;494
FR;0;2022-03-31;1615;3585;12992;25041;2570;12331;26651;0;43;54406464;51692174;36079709;404475;53482118;39419555;643190;0;537
FR;0;2022-04-01;2690;4588;20084;30896;2974;18726;33489;0;62;54409154;51696762;36099793;435371;53485092;39438281;676679;0;599
FR;0;2022-04-02;1532;2649;9054;10136;2009;8728;11298;0;29;54410686;51699411;36108847;445507;53487101;39447009;687977;0;628
FR;0;2022-04-03;294;516;1562;1171;360;1580;1382;0;2;54410980;51699927;36110409;446678;53487461;39448589;689359;0;630
FR;0;2022-04-04;4568;3032;12390;19132;2053;11598;20605;0;35;54415548;51702959;36122799;465810;53489514;39460187;709964;0;665
FR;0;2022-04-05;2608;3178;14354;34151;2055;13207;35769;0;85;54418156;51706137;36137153;499961;53491569;39473394;745733;0;750
FR;0;2022-04-06;2613;3964;13545;26549;3030;12820;28018;0;72;54420769;51710101;36150698;526510;53494599;39486214;773751;0;822
FR;0;2022-04-07;1989;3151;13687;33822;1999;12901;35178;0;76;54422758;51713252;36164385;560332;53496598;39499115;808929;0;898
FR;0;2022-04-08;2310;4345;19236;44016;2675;17862;46369;0;89;54425068;51717597;36183621;604348;53499273;39516977;855298;0;987
FR;0;2022-04-09;1374;2682;9315;13568;1905;8869;14800;0;30;54426442;51720279;36192936;617916;53501178;39525846;870098;0;1017
FR;0;2022-04-10;296;757;1985;2017;555;2007;2279;0;7;54426738;51721036;36194921;619933;53501733;39527853;872377;0;1024
FR;0;2022-04-11;1351;2634;11876;23935;1655;11483;25207;0;74;54428089;51723670;36206797;643868;53503388;39539336;897584;0;1098
FR;0;2022-04-12;1729;3083;14025;40929;1967;13397;41819;0;127;54429818;51726753;36220822;684797;53505355;39552733;939403;0;1225
FR;0;2022-04-13;1980;3723;13416;33118;2720;13038;34087;0;96;54431798;51730476;36234238;717915;53508075;39565771;973490;0;1321
FR;0;2022-04-14;1510;3016;13216;36354;1944;13074;37023;0;105;54433308;51733492;36247454;754269;53510019;39578845;1010513;0;1426
FR;0;2022-04-15;1883;3882;15645;35584;2623;14927;37235;0;115;54435191;51737374;36263099;789853;53512642;39593772;1047748;0;1541
FR;0;2022-04-16;1046;1834;6400;8553;1263;6263;9435;0;40;54436237;51739208;36269499;798406;53513905;39600035;1057183;0;1581
FR;0;2022-04-17;195;340;993;1174;224;1036;1242;0;7;54436432;51739548;36270492;799580;53514129;39601071;1058425;0;1588
FR;0;2022-04-18;201;561;2768;1072;358;2787;1287;0;5;54436633;51740109;36273260;800652;53514487;39603858;1059712;0;1593
FR;0;2022-04-19;1547;3031;12919;29691;1879;12480;30738;0;78;54438180;51743140;36286179;830343;53516366;39616338;1090450;0;1671
FR;0;2022-04-20;2009;3499;13308;29072;2612;12996;30088;0;96;54440189;51746639;36299487;859415;53518978;39629334;1120538;0;1767
FR;0;2022-04-21;1516;2857;12554;35212;1828;12647;35786;0;117;54441705;51749496;36312041;894627;53520806;39641981;1156324;0;1884
FR;0;2022-04-22;1880;3627;16482;37646;2402;15847;39178;0;132;54443585;51753123;36328523;932273;53523208;39657828;1195502;0;2016
FR;0;2022-04-23;1151;2072;7391;10659;1482;7242;11444;0;38;54444736;51755195;36335914;942932;53524690;39665070;1206946;0;2054
FR;0;2022-04-24;249;467;1478;1592;326;1414;1850;0;7;54444985;51755662;36337392;944524;53525016;39666484;1208796;0;2061
FR;0;2022-04-25;1308;2535;10687;21074;1614;10492;22096;0;79;54446293;51758197;36348079;965598;53526630;39676976;1230892;0;2140
FR;0;2022-04-26;1627;3008;13671;38665;1967;13114;39462;0;181;54447920;51761205;36361750;1004263;53528597;39690090;1270354;0;2321
FR;0;2022-04-27;1965;3068;11540;31089;2283;11597;31507;0;131;54449885;51764273;36373290;1035352;53530880;39701687;1301861;0;2452
FR;0;2022-04-28;1571;2783;12530;36269;1865;12271;36586;0;139;54451456;51767056;36385820;1071621;53532745;39713958;1338447;0;2591
FR;0;2022-04-29;2011;4834;15561;37281;3639;14938;38751;0;164;54453467;51771890;36401381;1108902;53536384;39728896;1377198;0;2755
FR;0;2022-04-30;1225;4702;6929;9717;4196;6758;10608;0;44;54454692;51776592;36408310;1118619;53540580;39735654;1387806;0;2799
FR;0;2022-05-01;221;325;916;1000;229;911;1141;0;6;54454913;51776917;36409226;1119619;53540809;39736565;1388947;0;2805
FR;0;2022-05-02;2364;2970;11160;18182;2066;10994;19026;0;69;54457277;51779887;36420386;1137801;53542875;39747559;1407973;0;2874
FR;0;2022-05-03;2067;3269;13726;34703;2130;13567;35624;0;163;54459344;51783156;36434112;1172504;53545005;39761126;1443597;0;3037
FR;0;2022-05-04;1926;3304;12188;25650;2304;12305;26202;0;110;54461270;51786460;36446300;1198154;53547309;39773431;1469799;0;3147
FR;0;2022-05-05;1796;3041;13070;33602;2019;12916;34270;0;180;54463066;51789501;36459370;1231756;53549328;39786347;1504069;0;3327
FR;0;2022-05-06;2218;3667;15360;36824;2325;14873;38283;0;182;54465284;51793168;36474730;1268580;53551653;39801220;1542352;0;3509
FR;0;2022-05-07;1210;1783;6464;9614;1255;6456;10339;0;48;54466494;51794951;36481194;1278194;53552908;39807676;1552691;0;3557
FR;0;2022-05-08;267;400;1175;1548;288;1236;1654;0;8;54466761;51795351;36482369;1279742;53553196;39808912;1554345;0;3565
FR;0;2022-05-09;1404;2307;9927;20259;1414;9798;21175;0;102;54468165;51797658;36492296;1300001;53554610;39818710;1575520;0;3667
FR;0;2022-05-10;1803;3432;13576;38999;2296;13132;40026;0;200;54469968;51801090;36505872;1339000;53556906;39831842;1615546;0;3867
FR;0;2022-05-11;2004;3022;10756;27943;2326;10701;28447;0;146;54471972;51804112;36516628;1366943;53559232;39842543;1643993;0;4013
FR;0;2022-05-12;1595;2746;11386;35758;1816;11055;36523;0;211;54473567;51806858;36528014;1402701;53561048;39853598;1680516;0;4224
FR;0;2022-05-13;1985;3224;13761;37981;2068;13350;39246;0;162;54475552;51810082;36541775;1440682;53563116;39866948;1719762;0;4386
FR;0;2022-05-14;1150;1648;5938;10778;1206;5801;11366;0;58;54476702;51811730;36547713;1451460;53564322;39872749;1731128;0;4444
FR;0;2022-05-15;283;480;1278;1440;303;1361;1593;0;6;54476985;51812210;36548991;1452900;53564625;39874110;1732721;0;4450
FR;0;2022-05-16;1196;2047;8695;21070;1248;8701;21597;0;128;54478181;51814257;36557686;1473970;53565873;39882811;1754318;0;4578
FR;0;2022-05-17;1593;2605;11828;37881;1671;11404;38723;0;180;54479774;51816862;36569514;1511851;53567544;39894215;1793041;0;4758
FR;0;2022-05-18;1816;2655;9694;27166;1957;9667;27785;0;109;54481590;51819517;36579208;1539017;53569501;39903882;1820826;0;4867
FR;0;2022-05-19;1451;2660;10580;35846;1636;10720;36037;0;162;54483041;51822177;36589788;1574863;53571137;39914602;1856863;0;5029
FR;0;2022-05-20;1876;3118;13426;39369;2080;12913;40389;0;168;54484917;51825295;36603214;1614232;53573217;39927515;1897252;0;5197
FR;0;2022-05-21;1159;1718;5662;9897;1314;5533;10534;0;45;54486076;51827013;36608876;1624129;53574531;39933048;1907786;0;5242
FR;0;2022-05-22;241;341;1032;1440;263;1017;1585;0;10;54486317;51827354;36609908;1625569;53574794;39934065;1909371;0;5252
FR;0;2022-05-23;1176;2127;8880;20375;1411;8830;21030;0;86;54487493;51829481;36618788;1645944;53576205;39942895;1930401;0;5338
FR;0;2022-05-24;1542;2759;11367;38882;1736;11239;39511;0;190;54489035;51832240;36630155;1684826;53577941;39954134;1969912;0;5528
FR;0;2022-05-25;1814;2842;9343;24847;2080;9481;25323;0;116;54490849;51835082;36639498;1709673;53580021;39963615;1995235;0;5644
FR;0;2022-05-26;216;430;1666;1201;293;1677;1344;0;26;54491065;51835512;36641164;1710874;53580314;39965292;1996579;0;5670
FR;0;2022-05-27;1390;2477;9266;21291;1670;9006;22325;0;94;54492455;51837989;36650430;1732165;53581984;39974298;2018904;0;5764
FR;0;2022-05-28;669;1272;3919;6795;852;3968;7204;0;38;54493124;51839261;36654349;1738960;53582836;39978266;2026108;0;5802
FR;0;2022-05-29;157;315;753;921;200;774;1033;0;4;54493281;51839576;36655102;1739881;53583036;39979040;2027141;0;5806
FR;0;2022-05-30;1026;1969;6995;19296;1249;7013;19808;0;91;54494307;51841545;36662097;1759177;53584285;39986053;2046949;0;5897
FR;0;2022-05-31;1488;2522;9823;35664;1649;9645;36295;0;171;54495795;51844067;36671920;1794841;53585934;39995698;2083244;0;6068
FR;0;2022-06-01;1754;3106;11029;24538;2256;10896;25491;0;122;54497549;51847173;36682949;1819379;53588190;40006594;2108735;0;6190
FR;0;2022-06-02;1480;2615;11311;35606;1718;10866;36552;0;174;54499029;51849788;36694260;1854985;53589908;40017460;2145287;0;6364
FR;0;2022-06-03;1729;3085;13424;38731;2054;12789;40001;0;176;54500758;51852873;36707684;1893716;53591962;40030249;2185288;0;6540
FR;0;2022-06-04;975;1517;5046;9114;1077;5117;9650;0;73;54501733;51854390;36712730;1902830;53593039;40035366;2194938;0;6613
FR;0;2022-06-05;181;336;876;1108;207;887;1230;0;4;54501914;51854726;36713606;1903938;53593246;40036253;2196168;0;6617
FR;0;2022-06-06;896;1255;2124;1329;1081;2141;1510;0;13;54502810;51855981;36715730;1905267;53594327;40038394;2197678;0;6630
FR;0;2022-06-07;1499;2713;9857;35597;1794;9435;36824;0;153;54504309;51858694;36725587;1940864;53596121;40047829;2234502;0;6783
FR;0;2022-06-08;1585;2699;9178;28790;1942;9021;29756;0;112;54505894;51861393;36734765;1969654;53598063;40056850;2264258;0;6895
FR;0;2022-06-09;1297;2443;10622;39505;1556;10267;40280;0;167;54507191;51863836;36745387;2009159;53599619;40067117;2304538;0;7062
FR;0;2022-06-10;1631;3195;13107;44828;2161;12669;46153;0;223;54508822;51867031;36758494;2053987;53601780;40079786;2350691;0;7285
FR;0;2022-06-11;962;1739;5432;11627;1125;5465;12212;0;55;54509784;51868770;36763926;2065614;53602905;40085251;2362903;0;7340
FR;0;2022-06-12;203;446;1079;1765;255;1143;1866;0;11;54509987;51869216;36765005;2067379;53603160;40086394;2364769;0;7351
FR;0;2022-06-13;1127;2070;7440;23183;1344;7270;24099;0;90;54511114;51871286;36772445;2090562;53604504;40093664;2388868;0;7441
FR;0;2022-06-14;1347;2550;10449;44949;1598;9808;46144;0;200;54512461;51873836;36782894;2135511;53606102;40103472;2435012;0;7641
FR;0;2022-06-15;1529;2466;9326;30910;1935;8965;31600;0;180;54513990;51876302;36792220;2166421;53608037;40112437;2466612;0;7821
FR;0;2022-06-16;1189;2041;9919;39932;1277;9328;40953;0;201;54515179;51878343;36802139;2206353;53609314;40121765;2507565;0;8022
FR;0;2022-06-17;1494;2859;12513;46699;1788;11920;47935;0;240;54516673;51881202;36814652;2253052;53611102;40133685;2555500;0;8262
FR;0;2022-06-18;857;1527;4567;11125;1038;4501;11720;0;67;54517530;51882729;36819219;2264177;53612140;40138186;2567220;0;8329
FR;0;2022-06-19;183;363;1059;1615;208;1131;1701;0;14;54517713;51883092;36820278;2265792;53612348;40139317;2568921;0;8343
FR;0;2022-06-20;1027;1928;8908;26080;1204;8569;27021;0;156;54518740;51885020;36829186;2291872;53613552;40147886;2595942;0;8499
FR;0;2022-06-21;1329;2404;10310;49898;1539;9339;51283;0;264;54520069;51887424;36839496;2341770;53615091;40157225;2647225;0;8763
FR;0;2022-06-22;1398;2519;8920;39066;1809;8430;40008;0;256;54521467;51889943;36848416;2380836;53616900;40165655;2687233;0;9019
FR;0;2022-06-23;1229;2371;10681;55113;1366;9887;56245;0;320;54522696;51892314;36859097;2435949;53618266;40175542;2743478;0;9339
FR;0;2022-06-24;1493;2997;13647;69186;1751;12309;71005;0;405;54524189;51895311;36872744;2505135;53620017;40187851;2814483;0;9744
FR;0;2022-06-25;939;1781;6236;19923;1112;5989;20778;0;177;54525128;51897092;36878980;2525058;53621129;40193840;2835261;0;9921
FR;0;2022-06-26;229;459;1953;3688;259;1818;3966;0;39;54525357;51897551;36880933;2528746;53621388;40195658;2839227;0;9960
FR;0;2022-06-27;1134;2026;10493;48494;1179;9636;49762;0;339;54526491;51899577;36891426;2577240;53622567;40205294;2888989;0;10299
FR;0;2022-06-28;1464;2816;14672;91420;1585;13090;93189;0;624;54527955;51902393;36906098;2668660;53624152;40218384;2982178;0;10923
FR;0;2022-06-29;1713;2835;12294;71899;1848;11242;73040;0;548;54529668;51905228;36918392;2740559;53626000;40229626;3055218;0;11471
FR;0;2022-06-30;1538;2737;14395;95168;1661;12477;97185;0;724;54531206;51907965;36932787;2835727;53627661;40242103;3152403;0;12195
FR;0;2022-07-01;2017;3807;21509;115937;2310;18861;118587;0;954;54533223;51911772;36954296;2951664;53629971;40260964;3270990;0;13149
FR;0;2022-07-02;1088;1859;8529;35755;1108;7705;36876;0;342;54534311;51913631;36962825;2987419;53631079;40268669;3307866;0;13491
FR;0;2022-07-03;294;539;2095;6456;320;1898;6805;0;79;54534605;51914170;36964920;2993875;53631399;40270567;3314671;0;13570
FR;0;2022-07-04;1971;3471;14714;79236;2337;12993;81308;0;639;54536576;51917641;36979634;3073111;53633736;40283560;3395979;0;14209
FR;0;2022-07-05;1799;3172;18842;133280;1804;16025;135571;0;1146;54538375;51920813;36998476;3206391;53635540;40299585;3531550;0;15355
FR;0;2022-07-06;1849;2794;15858;99604;1856;13651;101172;0;900;54540224;51923607;37014334;3305995;53637396;40313236;3632722;0;16255
FR;0;2022-07-07;1717;2872;18010;126041;1712;14789;128368;0;1179;54541941;51926479;37032344;3432036;53639108;40328025;3761090;0;17434
FR;0;2022-07-08;1894;3153;20756;137093;1857;16769;140085;0;1347;54543835;51929632;37053100;3569129;53640965;40344794;3901175;0;18781
FR;0;2022-07-09;868;1464;7746;37928;883;6693;38769;0;426;54544703;51931096;37060846;3607057;53641848;40351487;3939944;0;19207
FR;0;2022-07-10;272;687;2346;7004;441;2125;7395;0;94;54544975;51931783;37063192;3614061;53642289;40353612;3947339;0;19301
FR;0;2022-07-11;1459;2483;15020;88290;1405;12514;90477;0;801;54546434;51934266;37078212;3702351;53643694;40366126;4037816;0;20102
FR;0;2022-07-12;1844;3121;20538;143974;1716;16735;146678;0;1604;54548278;51937387;37098750;3846325;53645410;40382861;4184494;0;21706
FR;0;2022-07-13;1784;2755;15697;94543;1666;13278;96402;0;1080;54550062;51940142;37114447;3940868;53647076;40396139;4280896;0;22786
FR;0;2022-07-14;187;371;1957;5540;221;1836;5707;0;82;54550249;51940513;37116404;3946408;53647297;40397975;4286603;0;22868
FR;0;2022-07-15;1487;2575;15117;84465;1441;12600;86624;0;1035;54551736;51943088;37131521;4030873;53648738;40410575;4373227;0;23903
FR;0;2022-07-16;628;1193;5949;24982;699;5155;25674;0;327;54552364;51944281;37137470;4055855;53649437;40415730;4398901;0;24230
FR;0;2022-07-17;182;395;1738;4666;218;1570;4938;0;66;54552546;51944676;37139208;4060521;53649655;40417300;4403839;0;24296
FR;0;2022-07-18;1132;2252;11829;61809;1342;9979;63672;0;780;54553678;51946928;37151037;4122330;53650997;40427279;4467511;0;25076
FR;0;2022-07-19;1423;2355;15475;103709;1396;12296;105898;0;1459;54555101;51949283;37166512;4226039;53652393;40439575;4573409;0;26535
FR;0;2022-07-20;1429;2302;12970;77586;1470;10744;79173;0;1051;54556530;51951585;37179482;4303625;53653863;40450319;4652582;0;27586
FR;0;2022-07-21;1289;2172;13098;88244;1372;10500;89729;0;1316;54557819;51953757;37192580;4391869;53655235;40460819;4742311;0;28902
FR;0;2022-07-22;1433;2490;14833;89553;1470;11974;91419;0;1347;54559252;51956247;37207413;4481422;53656705;40472793;4833730;0;30249
FR;0;2022-07-23;685;1310;5536;22482;821;4858;23081;0;411;54559937;51957557;37212949;4503904;53657526;40477651;4856811;0;30660
FR;0;2022-07-24;186;353;1401;3905;204;1243;4132;0;72;54560123;51957910;37214350;4507809;53657730;40478894;4860943;0;30732
FR;0;2022-07-25;1061;1797;9493;48082;1149;7845;49519;0;737;54561184;51959707;37223843;4555891;53658879;40486739;4910462;0;31469
FR;0;2022-07-26;1301;2213;13307;85438;1322;10828;87136;0;1311;54562485;51961920;37237150;4641329;53660201;40497567;4997598;0;32780
FR;0;2022-07-27;1226;2008;10236;61318;1341;8530;62522;0;971;54563711;51963928;37247386;4702647;53661542;40506097;5060120;0;33751
FR;0;2022-07-28;1094;1864;10313;64420;1261;8226;65648;0;1046;54564805;51965792;37257699;4767067;53662803;40514323;5125768;0;34797
FR;0;2022-07-29;1282;2078;11011;65900;1387;8765;67330;0;1140;54566087;51967870;37268710;4832967;53664190;40523088;5193098;0;35937
FR;0;2022-07-30;503;867;3523;15283;604;2974;15666;0;303;54566590;51968737;37272233;4848250;53664794;40526062;5208764;0;36240
FR;0;2022-07-31;154;289;929;2439;185;788;2588;0;49;54566744;51969026;37273162;4850689;53664979;40526850;5211352;0;36289
FR;0;2022-08-01;1005;1670;7600;30240;1262;6399;31314;0;549;54567749;51970696;37280762;4880929;53666241;40533249;5242666;0;36838
FR;0;2022-08-02;1056;1650;8582;56131;1157;6895;56808;0;1170;54568805;51972346;37289344;4937060;53667398;40540144;5299474;0;38008
FR;0;2022-08-03;852;1266;6430;38683;903;5150;39421;0;702;54569657;51973612;37295774;4975743;53668301;40545294;5338895;0;38710
FR;0;2022-08-04;741;1187;6575;43161;783;5307;43726;0;917;54570398;51974799;37302349;5018904;53669084;40550601;5382621;0;39627
FR;0;2022-08-05;859;1364;7099;44976;972;5681;45631;0;993;54571257;51976163;37309448;5063880;53670056;40556282;5428252;0;40620
FR;0;2022-08-06;341;560;2101;9368;401;1759;9568;0;228;54571598;51976723;37311549;5073248;53670457;40558041;5437820;0;40848
FR;0;2022-08-07;104;163;536;1627;120;453;1703;0;38;54571702;51976886;37312085;5074875;53670577;40558494;5439523;0;40886
FR;0;2022-08-08;674;1165;4030;22109;921;3293;22544;0;490;54572376;51978051;37316115;5096984;53671498;40561787;5462067;0;41376
FR;0;2022-08-09;748;1167;5973;39963;854;4804;40446;0;844;54573124;51979218;37322088;5136947;53672352;40566591;5502513;0;42220
FR;0;2022-08-10;673;1292;4656;28058;1007;3797;28392;0;652;54573797;51980510;37326744;5165005;53673359;40570388;5530905;0;42872
FR;0;2022-08-11;640;1030;4493;29253;742;3713;29589;0;676;54574437;51981540;37331237;5194258;53674101;40574101;5560494;0;43548
FR;0;2022-08-12;849;1167;4747;28219;851;3920;28656;0;704;54575286;51982707;37335984;5222477;53674952;40578021;5589150;0;44252
FR;0;2022-08-13;363;428;1295;5260;325;1120;5419;0;121;54575649;51983135;37337279;5227737;53675277;40579141;5594569;0;44373
FR;0;2022-08-14;74;121;289;923;104;247;995;0;25;54575723;51983256;37337568;5228660;53675381;40579388;5595564;0;44398
FR;0;2022-08-15;117;232;610;564;198;558;618;0;19;54575840;51983488;37338178;5229224;53675579;40579946;5596182;0;44417
FR;0;2022-08-16;646;1078;3961;22179;840;3355;22372;0;615;54576486;51984566;37342139;5251403;53676419;40583301;5618554;0;45032
FR;0;2022-08-17;654;1041;3890;22900;816;3294;23141;0;620;54577140;51985607;37346029;5274303;53677235;40586595;5641695;0;45652
FR;0;2022-08-18;637;1002;4124;26312;806;3262;26545;0;673;54577777;51986609;37350153;5300615;53678041;40589857;5668240;0;46325
FR;0;2022-08-19;607;1167;4493;27259;875;3694;27565;0;766;54578384;51987776;37354646;5327874;53678916;40593551;5695805;0;47091
FR;0;2022-08-20;311;504;1356;5569;402;1171;5728;0;146;54578695;51988280;37356002;5333443;53679318;40594722;5701533;0;47237
FR;0;2022-08-21;97;135;305;1009;96;267;1044;0;27;54578792;51988415;37356307;5334452;53679414;40594989;5702577;0;47264
FR;0;2022-08-22;584;1002;3274;15358;780;2798;15688;0;425;54579376;51989417;37359581;5349810;53680194;40597787;5718265;0;47689
FR;0;2022-08-23;732;1180;4299;29002;853;3610;29091;0;870;54580108;51990597;37363880;5378812;53681047;40601397;5747356;0;48559
FR;0;2022-08-24;670;940;3498;19539;786;2860;19729;0;608;54580778;51991537;37367378;5398351;53681833;40604257;5767085;0;49167
FR;0;2022-08-25;626;1025;3947;23402;731;3295;23666;0;673;54581404;51992562;37371325;5421753;53682564;40607552;5790751;0;49840
FR;0;2022-08-26;862;1266;4478;25884;961;3671;26257;0;777;54582266;51993828;37375803;5447637;53683525;40611223;5817008;0;50617
FR;0;2022-08-27;299;500;1379;5469;362;1244;5533;0;194;54582565;51994328;37377182;5453106;53683887;40612467;5822541;0;50811
FR;0;2022-08-28;125;163;303;921;117;288;966;0;38;54582690;51994491;37377485;5454027;53684004;40612755;5823507;0;50849
FR;0;2022-08-29;623;970;3076;14679;770;2614;14985;0;433;54583313;51995461;37380561;5468706;53684774;40615369;5838492;0;51282
FR;0;2022-08-30;855;1224;4796;28553;900;3914;28883;0;823;54584168;51996685;37385357;5497259;53685674;40619283;5867375;0;52105
FR;0;2022-08-31;697;958;3207;17647;745;2718;17911;0;508;54584865;51997643;37388564;5514906;53686419;40622001;5885286;0;52613
FR;0;2022-09-01;763;997;4480;22502;709;3827;22768;0;623;54585628;51998640;37393044;5537408;53687128;40625828;5908054;0;53236
FR;0;2022-09-02;998;1159;5045;28615;847;4258;28909;0;914;54586626;51999799;37398089;5566023;53687975;40630086;5936963;0;54150
FR;0;2022-09-03;421;571;1920;6086;425;1667;6323;0;181;54587047;52000370;37400009;5572109;53688400;40631753;5943286;0;54331
FR;0;2022-09-04;135;150;351;876;85;347;945;0;24;54587182;52000520;37400360;5572985;53688485;40632100;5944231;0;54355
FR;0;2022-09-05;779;918;3178;16065;739;2658;16379;0;523;54587961;52001438;37403538;5589050;53689224;40634758;5960610;0;54878
FR;0;2022-09-06;925;1051;4740;31853;681;3873;32082;0;1040;54588886;52002489;37408278;5620903;53689905;40638631;5992692;0;55918
FR;0;2022-09-07;713;791;3000;16822;573;2482;16972;0;573;54589599;52003280;37411278;5637725;53690478;40641113;6009664;0;56491
FR;0;2022-09-08;635;862;3810;24866;597;3142;24957;0;818;54590234;52004142;37415088;5662591;53691075;40644255;6034621;0;57309
FR;0;2022-09-09;852;1039;4444;27660;681;3686;27836;0;951;54591086;52005181;37419532;5690251;53691756;40647941;6062457;0;58260
FR;0;2022-09-10;408;654;1739;5711;480;1539;5917;0;207;54591494;52005835;37421271;5695962;53692236;40649480;6068374;0;58467
FR;0;2022-09-11;124;131;324;657;93;307;716;0;17;54591618;52005966;37421595;5696619;53692329;40649787;6069090;0;58484
FR;0;2022-09-12;523;646;2691;13297;463;2296;13590;0;478;54592141;52006612;37424286;5709916;53692792;40652083;6082680;0;58962
FR;0;2022-09-13;683;873;4000;26521;562;3489;26398;0;875;54592824;52007485;37428286;5736437;53693354;40655572;6109078;0;59837
FR;0;2022-09-14;710;803;2968;16188;595;2485;16421;0;573;54593534;52008288;37431254;5752625;53693949;40658057;6125499;0;60410
FR;0;2022-09-15;579;849;3478;23587;602;2967;23656;0;728;54594113;52009137;37434732;5776212;53694551;40661024;6149155;0;61138
FR;0;2022-09-16;799;1051;4147;25919;734;3489;26139;0;932;54594912;52010188;37438879;5802131;53695285;40664513;6175294;0;62070
FR;0;2022-09-17;395;513;1454;6146;392;1284;6238;0;243;54595307;52010701;37440333;5808277;53695677;40665797;6181532;0;62313
FR;0;2022-09-18;117;144;323;962;123;291;1017;0;37;54595424;52010845;37440656;5809239;53695800;40666088;6182549;0;62350
FR;0;2022-09-19;482;648;2262;13219;451;1936;13402;0;436;54595906;52011493;37442918;5822458;53696251;40668024;6195951;0;62786
FR;0;2022-09-20;646;904;3791;26462;659;3158;26516;0;893;54596552;52012397;37446709;5848920;53696910;40671182;6222467;0;63679
FR;0;2022-09-21;591;776;2740;16259;580;2355;16250;0;587;54597143;52013173;37449449;5865179;53697490;40673537;6238717;0;64266
FR;0;2022-09-22;601;852;3426;23625;575;2809;23839;0;775;54597744;52014025;37452875;5888804;53698065;40676346;6262556;0;65041
FR;0;2022-09-23;838;1053;4495;28732;776;3764;28903;0;1021;54598582;52015078;37457370;5917536;53698841;40680110;6291459;0;66062
FR;0;2022-09-24;427;615;1648;6906;474;1422;7091;0;307;54599009;52015693;37459018;5924442;53699315;40681532;6298550;0;66369
FR;0;2022-09-25;99;194;336;1101;149;307;1143;0;37;54599108;52015887;37459354;5925543;53699464;40681839;6299693;0;66406
FR;0;2022-09-26;437;715;2300;13545;485;2019;13650;0;435;54599545;52016602;37461654;5939088;53699949;40683858;6313343;0;66841
FR;0;2022-09-27;615;845;3627;25944;615;2910;26099;0;959;54600160;52017447;37465281;5965032;53700564;40686768;6339442;0;67800
FR;0;2022-09-28;635;828;2557;15403;635;2305;15516;0;622;54600795;52018275;37467838;5980435;53701199;40689073;6354958;0;68422
FR;0;2022-09-29;566;770;3138;21057;547;2651;21087;43;810;54601361;52019045;37470976;6001492;53701746;40691724;6376045;43;69232
FR;0;2022-09-30;787;1125;3958;25563;845;3303;25831;715;1052;54602148;52020170;37474934;6027055;53702591;40695027;6401876;758;70284
FR;0;2022-10-01;431;718;2009;5975;566;1737;6212;396;318;54602579;52020888;37476943;6033030;53703157;40696764;6408088;1154;70602
FR;0;2022-10-02;63;136;218;639;97;215;665;66;42;54602642;52021024;37477161;6033669;53703254;40696979;6408753;1220;70644
FR;0;2022-10-03;632;951;2469;12053;785;2195;12231;2074;745;54603274;52021975;37479630;6045722;53704039;40699174;6420984;3294;71389
FR;0;2022-10-04;756;833;3394;23508;579;2786;23685;4704;1585;54604030;52022808;37483024;6069230;53704618;40701960;6444669;7998;72974
FR;0;2022-10-05;606;854;2448;14609;633;2163;14750;3658;1210;54604636;52023662;37485472;6083839;53705251;40704123;6459419;11656;74184
FR;0;2022-10-06;552;742;3090;21689;543;2522;21898;6668;1910;54605188;52024404;37488562;6105528;53705794;40706645;6481317;18324;76094
FR;0;2022-10-07;735;1015;4129;30310;742;3478;30398;16875;3207;54605923;52025419;37492691;6135838;53706536;40710123;6511715;35199;79301
FR;0;2022-10-08;356;521;1651;8432;383;1410;8601;6699;1171;54606279;52025940;37494342;6144270;53706919;40711533;6520316;41898;80472
FR;0;2022-10-09;109;143;337;1587;117;312;1650;1511;297;54606388;52026083;37494679;6145857;53707036;40711845;6521966;43409;80769
FR;0;2022-10-10;509;842;2932;20565;658;2523;20887;19597;3272;54606897;52026925;37497611;6166422;53707694;40714368;6542853;63006;84041
FR;0;2022-10-11;620;814;4270;40335;555;3573;40679;40183;6387;54607517;52027739;37501881;6206757;53708249;40717941;6583532;103189;90428
FR;0;2022-10-12;604;858;3268;26759;639;2776;27089;27305;4693;54608121;52028597;37505149;6233516;53708888;40720717;6610621;130494;95121
FR;0;2022-10-13;627;818;4017;38465;609;3138;38924;40609;6608;54608748;52029415;37509166;6271981;53709497;40723855;6649545;171103;101729
FR;0;2022-10-14;761;1074;4873;47668;784;3959;48143;51136;7863;54609509;52030489;37514039;6319649;53710281;40727814;6697688;222239;109592
FR;0;2022-10-15;368;590;1868;11851;429;1630;11965;13091;2274;54609877;52031079;37515907;6331500;53710710;40729444;6709653;235330;111866
FR;0;2022-10-16;94;136;372;1967;86;356;2012;2347;479;54609971;52031215;37516279;6333467;53710796;40729800;6711665;237677;112345
FR;0;2022-10-17;440;712;3044;26466;497;2487;26838;30793;5409;54610411;52031927;37519323;6359933;53711293;40732287;6738503;268470;117754
FR;0;2022-10-18;610;736;4706;46102;535;3762;46667;55450;11701;54611021;52032663;37524029;6406035;53711828;40736049;6785170;323920;129455
FR;0;2022-10-19;570;820;3645;34378;625;3076;34756;42482;9263;54611591;52033483;37527674;6440413;53712453;40739125;6819926;366402;138718
FR;0;2022-10-20;617;807;4843;49466;595;3730;50123;60535;12937;54612208;52034290;37532517;6489879;53713048;40742855;6870049;426937;151655
FR;0;2022-10-21;690;995;5710;57044;710;4519;57714;70966;14299;54612898;52035285;37538227;6546923;53713758;40747374;6927763;497903;165954
FR;0;2022-10-22;335;413;1654;12950;334;1320;13107;15939;3386;54613233;52035698;37539881;6559873;53714092;40748694;6940870;513842;169340
FR;0;2022-10-23;98;107;350;2064;102;266;2166;2758;631;54613331;52035805;37540231;6561937;53714194;40748960;6943036;516600;169971
FR;0;2022-10-24;552;599;3137;27137;424;2687;27565;35497;7810;54613883;52036404;37543368;6589074;53714618;40751647;6970601;552097;177781
FR;0;2022-10-25;598;726;4873;49117;535;3805;49791;65255;15450;54614481;52037130;37548241;6638191;53715153;40755452;7020392;617352;193231
FR;0;2022-10-26;535;645;3475;32622;485;2901;32928;43999;11024;54615016;52037775;37551716;6670813;53715638;40758353;7053320;661351;204255
FR;0;2022-10-27;592;698;4081;40795;499;3348;41272;54476;13137;54615608;52038473;37555797;6711608;53716137;40761701;7094592;715827;217392
FR;0;2022-10-28;705;872;4610;44190;637;3505;45009;58279;13188;54616313;52039345;37560407;6755798;53716774;40765206;7139601;774106;230580
FR;0;2022-10-29;260;364;1328;9499;262;1082;9633;12523;3012;54616573;52039709;37561735;6765297;53717036;40766288;7149234;786629;233592
FR;0;2022-10-30;87;122;287;1598;98;249;1646;2145;540;54616660;52039831;37562022;6766895;53717134;40766537;7150880;788774;234132
FR;0;2022-10-31;381;489;2075;16062;358;1626;16427;22205;5503;54617041;52040320;37564097;6782957;53717492;40768163;7167307;810979;239635
FR;0;2022-11-01;135;196;929;1123;153;963;1166;1697;504;54617176;52040516;37565026;6784080;53717645;40769126;7168473;812676;240139
FR;0;2022-11-02;527;676;3038;25403;506;2584;25881;36653;10142;54617703;52041192;37568064;6809483;53718151;40771710;7194354;849329;250281
FR;0;2022-11-03;645;703;4114;40066;537;3119;40799;57042;15379;54618348;52041895;37572178;6849549;53718688;40774829;7235153;906371;265660
FR;0;2022-11-04;660;831;4426;43660;578;3518;44280;60539;15251;54619008;52042726;37576604;6893209;53719266;40778347;7279433;966910;280911
FR;0;2022-11-05;255;389;1450;9718;312;1166;9927;13466;3295;54619263;52043115;37578054;6902927;53719578;40779513;7289360;980376;284206
FR;0;2022-11-06;94;119;263;1604;102;246;1633;2340;654;54619357;52043234;37578317;6904531;53719680;40779759;7290993;982716;284860
FR;0;2022-11-07;561;609;2763;26770;525;2249;27402;39125;11011;54619918;52043843;37581080;6931301;53720205;40782008;7318395;1021841;295871
FR;0;2022-11-08;685;820;5004;52022;606;3848;53029;74326;20083;54620603;52044663;37586084;6983323;53720811;40785856;7371424;1096167;315954
FR;0;2022-11-09;532;699;3363;31611;523;2691;32387;46364;13233;54621135;52045362;37589447;7014934;53721334;40788547;7403811;1142531;329187
FR;0;2022-11-10;632;1001;4581;43693;751;3639;44592;62883;17360;54621767;52046363;37594028;7058627;53722085;40792186;7448403;1205414;346547
FR;0;2022-11-11;82;124;370;1666;92;313;1729;2800;1012;54621849;52046487;37594398;7060293;53722177;40792499;7450132;1208214;347559
FR;0;2022-11-12;212;353;1195;7102;261;979;7337;10289;2765;54622061;52046840;37595593;7067395;53722438;40793478;7457469;1218503;350324
FR;0;2022-11-13;73;118;249;1208;97;213;1262;1978;628;54622134;52046958;37595842;7068603;53722535;40793691;7458731;1220481;350952
FR;0;2022-11-14;452;531;2590;24012;379;2067;24632;36241;10921;54622586;52047489;37598432;7092615;53722914;40795758;7483363;1256722;361873
FR;0;2022-11-15;626;895;4329;45071;720;3377;46021;66949;19635;54623212;52048384;37602761;7137686;53723634;40799135;7529384;1323671;381508
FR;0;2022-11-16;572;681;3073;28599;553;2579;29137;43281;13331;54623784;52049065;37605834;7166285;53724187;40801714;7558521;1366952;394839
FR;0;2022-11-17;571;692;3830;39264;539;2990;39873;58397;17430;54624355;52049757;37609664;7205549;53724726;40804704;7598394;1425349;412269
FR;0;2022-11-18;628;786;4608;45148;601;3458;46057;65731;18359;54624983;52050543;37614272;7250697;53725327;40808162;7644451;1491080;430628
FR;0;2022-11-19;270;346;1502;9806;279;1098;10001;14329;4015;54625253;52050889;37615774;7260503;53725606;40809260;7654452;1505409;434643
FR;0;2022-11-20;79;190;305;1698;172;262;1772;2717;859;54625332;52051079;37616079;7262201;53725778;40809522;7656224;1508126;435502
FR;0;2022-11-21;437;516;2425;21453;354;1956;22024;33159;10369;54625769;52051595;37618504;7283654;53726132;40811478;7678248;1541285;445871
FR;0;2022-11-22;542;611;4036;39838;438;3171;40414;59804;18268;54626311;52052206;37622540;7323492;53726570;40814649;7718662;1601089;464139
FR;0;2022-11-23;477;569;2759;26032;416;2325;26524;40426;12912;54626788;52052775;37625299;7349524;53726986;40816974;7745186;1641515;477051
FR;0;2022-11-24;517;609;3768;37177;432;2965;37889;56859;17962;54627305;52053384;37629067;7386701;53727418;40819939;7783075;1698374;495013
FR;0;2022-11-25;581;735;4190;40153;589;3151;40996;59639;17481;54627886;52054119;37633257;7426854;53728007;40823090;7824071;1758013;512494
FR;0;2022-11-26;301;339;1335;9371;263;1064;9512;13999;3971;54628187;52054458;37634592;7436225;53728270;40824154;7833583;1772012;516465
FR;0;2022-11-27;74;88;268;1661;70;228;1689;2554;805;54628261;52054546;37634860;7437886;53728340;40824382;7835272;1774566;517270
FR;0;2022-11-28;421;483;2638;24813;365;1982;25553;38485;12208;54628682;52055029;37637498;7462699;53728705;40826364;7860825;1813051;529478
FR;0;2022-11-29;500;613;4402;46539;382;3293;47267;71139;22341;54629182;52055642;37641900;7509238;53729087;40829657;7908092;1884190;551819
FR;0;2022-11-30;509;708;3741;36931;510;2899;37737;56333;17235;54629691;52056350;37645641;7546169;53729597;40832556;7945829;1940523;569054
FR;0;2022-12-01;569;685;5323;51908;464;3915;52719;79733;25272;54630260;52057035;37650964;7598077;53730061;40836471;7998548;2020256;594326
FR;0;2022-12-02;646;751;6175;61549;536;4385;62781;92455;27458;54630906;52057786;37657139;7659626;53730597;40840856;8061329;2112711;621784
FR;0;2022-12-03;305;354;2289;18052;232;1630;18482;26731;7618;54631211;52058140;37659428;7677678;53730829;40842486;8079811;2139442;629402
FR;0;2022-12-04;98;125;524;4305;92;434;4356;6441;1856;54631309;52058265;37659952;7681983;53730921;40842920;8084167;2145883;631258
FR;0;2022-12-05;488;620;4317;44706;457;2928;45675;69053;21915;54631797;52058885;37664269;7726689;53731378;40845848;8129842;2214936;653173
FR;0;2022-12-06;641;777;6859;78307;516;4662;79832;121780;39611;54632438;52059662;37671128;7804996;53731894;40850510;8209674;2336716;692784
FR;0;2022-12-07;562;657;5367;58171;491;3613;59322;90544;29582;54633000;52060319;37676495;7863167;53732385;40854123;8268996;2427260;722366
FR;0;2022-12-08;611;725;6990;79678;465;4594;81371;124182;40873;54633611;52061044;37683485;7942845;53732850;40858717;8350367;2551442;763239
FR;0;2022-12-09;784;849;8684;95694;561;5739;97589;147384;46827;54634395;52061893;37692169;8038539;53733411;40864456;8447956;2698826;810066
FR;0;2022-12-10;410;561;3827;33958;405;2481;34855;50557;14712;54634805;52062454;37695996;8072497;53733816;40866937;8482811;2749383;824778
FR;0;2022-12-11;133;146;994;8364;105;688;8570;12258;3276;54634938;52062600;37696990;8080861;53733921;40867625;8491381;2761641;828054
FR;0;2022-12-12;523;598;6385;67488;389;4139;69081;106299;34850;54635461;52063198;37703375;8148349;53734310;40871764;8560462;2867940;862904
FR;0;2022-12-13;716;795;9055;103629;507;5646;106217;164975;55123;54636177;52063993;37712430;8251978;53734817;40877410;8666679;3032915;918027
FR;0;2022-12-14;596;726;6826;73348;489;4558;75031;117010;38772;54636773;52064719;37719256;8325326;53735306;40881968;8741710;3149925;956799
FR;0;2022-12-15;664;893;8902;95933;582;5727;98248;153333;51776;54637437;52065612;37728158;8421259;53735888;40887695;8839958;3303258;1008575
FR;0;2022-12-16;826;981;9783;104833;655;6464;107075;166548;55335;54638263;52066593;37737941;8526092;53736543;40894159;8947033;3469806;1063910
FR;0;2022-12-17;346;430;3504;31808;295;2296;32598;48448;14450;54638609;52067023;37741445;8557900;53736838;40896455;8979631;3518254;1078360
FR;0;2022-12-18;93;127;791;6336;81;544;6487;9642;2763;54638702;52067150;37742236;8564236;53736919;40896999;8986118;3527896;1081123
FR;0;2022-12-19;593;620;5757;56226;436;3684;57858;90285;30101;54639295;52067770;37747993;8620462;53737355;40900683;9043976;3618181;1111224
FR;0;2022-12-20;747;796;7954;79863;532;5249;82009;130833;45060;54640042;52068566;37755947;8700325;53737887;40905932;9125985;3749014;1156284
FR;0;2022-12-21;604;629;5341;50981;441;3592;52333;84195;29344;54640646;52069195;37761288;8751306;53738328;40909524;9178318;3833209;1185628
FR;0;2022-12-22;649;668;4917;46292;468;3437;47529;76915;26914;54641295;52069863;37766205;8797598;53738796;40912961;9225847;3910124;1212542
FR;0;2022-12-23;479;588;3451;26235;426;2634;26896;43425;14918;54641774;52070451;37769656;8823833;53739222;40915595;9252743;3953549;1227460
FR;0;2022-12-24;105;108;447;2708;80;338;2832;4289;1231;54641879;52070559;37770103;8826541;53739302;40915933;9255575;3957838;1228691
FR;0;2022-12-25;34;43;134;566;34;106;592;926;273;54641913;52070602;37770237;8827107;53739336;40916039;9256167;3958764;1228964
FR;0;2022-12-26;370;393;2500;16947;293;1830;17577;27641;8843;54642283;52070995;37772737;8844054;53739629;40917869;9273744;3986405;1237807
FR;0;2022-12-27;540;662;4220;33739;447;2956;34889;56755;19759;54642823;52071657;37776957;8877793;53740076;40920825;9308633;4043160;1257566
FR;0;2022-12-28;480;523;3243;25722;357;2319;26343;42953;14847;54643303;52072180;37780200;8903515;53740433;40923144;9334976;4086113;1272413
FR;0;2022-12-29;431;552;3424;26589;364;2408;27596;45108;15660;54643734;52072732;37783624;8930104;53740797;40925552;9362572;4131221;1288073
FR;0;2022-12-30;464;507;2632;19576;365;1868;20248;32641;11003;54644198;52073239;37786256;8949680;53741162;40927420;9382820;4163862;1299076
FR;0;2022-12-31;137;157;508;3192;121;413;3336;4948;1338;54644335;52073396;37786764;8952872;53741283;40927833;9386156;4168810;1300414
FR;0;2023-01-01;25;46;177;711;27;150;737;1026;246;54644360;52073442;37786941;8953583;53741310;40927983;9386893;4169836;1300660
FR;0;2023-01-02;924;606;3019;19048;432;2335;19528;33029;12101;54645284;52074048;37789960;8972631;53741742;40930318;9406421;4202865;1312761
FR;0;2023-01-03;675;699;4767;44192;479;3378;45136;82800;34832;54645959;52074747;37794727;9016823;53742221;40933696;9451557;4285665;1347593
FR;0;2023-01-04;548;616;3878;31105;424;2771;31919;59890;25826;54646507;52075363;37798605;9047928;53742645;40936467;9483476;4345555;1373419
FR;0;2023-01-05;668;770;4693;43320;569;3197;44251;84065;37187;54647175;52076133;37803298;9091248;53743214;40939664;9527727;4429620;1410606
FR;0;2023-01-06;753;861;5530;48579;582;3670;49637;92105;39512;54647928;52076994;37808828;9139827;53743796;40943334;9577364;4521725;1450118
FR;0;2023-01-07;350;413;1949;12939;302;1415;13260;23038;8767;54648278;52077407;37810777;9152766;53744098;40944749;9590624;4544763;1458885
FR;0;2023-01-08;105;144;496;2918;100;357;3015;5231;1992;54648383;52077551;37811273;9155684;53744198;40945106;9593639;4549994;1460877
FR;0;2023-01-09;585;641;2866;22361;464;2078;22936;45870;21215;54648968;52078192;37814139;9178045;53744662;40947184;9616575;4595864;1482092
FR;0;2023-01-10;619;816;4825;41579;572;3459;42410;87033;41788;54649587;52079008;37818964;9219624;53745234;40950643;9658985;4682897;1523880
FR;0;2023-01-11;506;605;3147;25105;441;2290;25639;52873;25243;54650093;52079613;37822111;9244729;53745675;40952933;9684624;4735770;1549123
FR;0;2023-01-12;607;698;3986;34351;476;2887;34977;72510;35102;54650700;52080311;37826097;9279080;53746151;40955820;9719601;4808280;1584225
FR;0;2023-01-13;801;815;4385;36238;570;3158;36905;74669;35223;54651501;52081126;37830482;9315318;53746721;40958978;9756506;4882949;1619448
FR;0;2023-01-14;354;346;1590;9310;237;1201;9503;17773;7419;54651855;52081472;37832072;9324628;53746958;40960179;9766009;4900722;1626867
FR;0;2023-01-15;100;138;378;1571;94;290;1682;3268;1415;54651955;52081610;37832450;9326199;53747052;40960469;9767691;4903990;1628282
FR;0;2023-01-16;425;484;2382;16349;337;1789;16610;35994;18105;54652380;52082094;37834832;9342548;53747389;40962258;9784301;4939984;1646387
FR;0;2023-01-17;504;598;3540;29064;413;2568;29627;65751;33910;54652884;52082692;37838372;9371612;53747802;40964826;9813928;5005735;1680297
FR;0;2023-01-18;472;562;2372;17448;409;1840;17763;39175;19886;54653356;52083254;37840744;9389060;53748211;40966666;9831691;5044910;1700183
FR;0;2023-01-19;506;523;2878;23076;357;2143;23421;52308;27018;54653862;52083777;37843622;9412136;53748568;40968809;9855112;5097218;1727201
FR;0;2023-01-20;637;708;3473;25811;508;2628;26296;57784;29431;54654499;52084485;37847095;9437947;53749076;40971437;9881408;5155002;1756632
FR;0;2023-01-21;261;306;1143;6423;221;881;6533;13246;6020;54654760;52084791;37848238;9444370;53749297;40972318;9887941;5168248;1762652
FR;0;2023-01-22;47;65;181;880;34;156;931;1922;874;54654807;52084856;37848419;9445250;53749331;40972474;9888872;5170170;1763526
FR;0;2023-01-23;324;415;1739;11043;273;1304;11268;27228;14820;54655131;52085271;37850158;9456293;53749604;40973778;9900140;5197398;1778346
FR;0;2023-01-24;478;533;2597;20754;377;1945;21057;51081;28342;54655609;52085804;37852755;9477047;53749981;40975723;9921197;5248479;1806688
FR;0;2023-01-25;408;556;1954;12616;399;1483;13047;30758;16453;54656017;52086360;37854709;9489663;53750380;40977206;9934244;5279237;1823141
FR;0;2023-01-26;435;531;2393;17197;385;1796;17510;42508;23429;54656452;52086891;37857102;9506860;53750765;40979002;9951754;5321745;1846570
FR;0;2023-01-27;528;1140;2657;18541;964;2018;18790;45090;24585;54656980;52088031;37859759;9525401;53751729;40981020;9970544;5366835;1871155
FR;0;2023-01-28;237;291;868;4521;234;693;4640;9987;4751;54657217;52088322;37860627;9529922;53751963;40981713;9975184;5376822;1875906
FR;0;2023-01-29;42;72;124;466;55;102;504;1098;548;54657259;52088394;37860751;9530388;53752018;40981815;9975688;5377920;1876454
FR;0;2023-01-30;367;451;1346;8297;325;1113;8491;20959;11439;54657626;52088845;37862097;9538685;53752343;40982928;9984179;5398879;1887893
FR;0;2023-01-31;426;493;2056;14133;335;1536;14385;36907;21265;54658052;52089338;37864153;9552818;53752678;40984464;9998564;5435786;1909158
FR;0;2023-02-01;412;544;1727;8351;418;1472;8511;22224;12616;54658464;52089882;37865880;9561169;53753096;40985936;10007075;5458010;1921774
FR;0;2023-02-02;370;513;1730;11936;355;1438;12145;31724;18274;54658834;52090395;37867610;9573105;53753451;40987374;10019220;5489734;1940048
FR;0;2023-02-03;480;658;2064;12631;492;1648;12809;33770;19458;54659314;52091053;37869674;9585736;53753943;40989022;10032029;5523504;1959506
FR;0;2023-02-04;200;278;672;3138;240;565;3183;7458;3826;54659514;52091331;37870346;9588874;53754183;40989587;10035212;5530962;1963332
FR;0;2023-02-05;25;65;91;245;42;89;261;590;284;54659539;52091396;37870437;9589119;53754225;40989676;10035473;5531552;1963616
FR;0;2023-02-06;313;360;1106;5429;291;869;5615;15395;9057;54659852;52091756;37871543;9594548;53754516;40990545;10041088;5546947;1972673
FR;0;2023-02-07;351;504;1611;9770;373;1324;9940;28285;16954;54660203;52092260;37873154;9604318;53754889;40991869;10051028;5575232;1989627
FR;0;2023-02-08;302;394;1135;6078;312;921;6242;17038;9799;54660505;52092654;37874289;9610396;53755201;40992790;10057270;5592270;1999426
FR;0;2023-02-09;339;475;1308;7926;346;1115;8107;22867;13709;54660844;52093129;37875597;9618322;53755547;40993905;10065377;5615137;2013135
FR;0;2023-02-10;468;554;1522;8361;440;1279;8508;23773;13966;54661312;52093683;37877119;9626683;53755987;40995184;10073885;5638910;2027101
FR;0;2023-02-11;169;225;583;2149;182;512;2237;5435;2770;54661481;52093908;37877702;9628832;53756169;40995696;10076122;5644345;2029871
FR;0;2023-02-12;42;49;62;178;48;56;200;443;208;54661523;52093957;37877764;9629010;53756217;40995752;10076322;5644788;2030079
FR;0;2023-02-13;250;346;756;3358;271;688;3450;9626;5506;54661773;52094303;37878520;9632368;53756488;40996440;10079772;5654414;2035585
FR;0;2023-02-14;300;381;1185;5984;278;1011;6129;17570;10421;54662073;52094684;37879705;9638352;53756766;40997451;10085901;5671984;2046006
FR;0;2023-02-15;293;407;970;4078;302;846;4255;12220;7169;54662366;52095091;37880675;9642430;53757068;40998297;10090156;5684204;2053175
FR;0;2023-02-16;266;406;1163;5206;270;1019;5350;15066;8765;54662632;52095497;37881838;9647636;53757338;40999316;10095506;5699270;2061940
FR;0;2023-02-17;372;476;1320;5481;386;1159;5703;16396;9638;54663004;52095973;37883158;9653117;53757724;41000475;10101209;5715666;2071578
FR;0;2023-02-18;162;218;565;1628;173;494;1698;4073;2060;54663166;52096191;37883723;9654745;53757897;41000969;10102907;5719739;2073638
FR;0;2023-02-19;37;38;49;139;35;40;141;338;167;54663203;52096229;37883772;9654884;53757932;41001009;10103048;5720077;2073805
FR;0;2023-02-20;249;350;720;2861;263;678;2981;8544;4895;54663452;52096579;37884492;9657745;53758195;41001687;10106029;5728621;2078700
FR;0;2023-02-21;270;413;1075;4539;268;939;4747;14014;8281;54663722;52096992;37885567;9662284;53758463;41002626;10110776;5742635;2086981
FR;0;2023-02-22;246;375;741;2949;288;702;2997;9094;5318;54663968;52097367;37886308;9665233;53758751;41003328;10113773;5751729;2092299
FR;0;2023-02-23;227;365;936;4003;251;847;4192;12280;7174;54664195;52097732;37887244;9669236;53759002;41004175;10117965;5764009;2099473
FR;0;2023-02-24;291;472;1049;4414;350;922;4613;13009;7450;54664486;52098204;37888293;9673650;53759352;41005097;10122578;5777018;2106923
FR;0;2023-02-25;126;169;448;1193;148;364;1273;3189;1624;54664612;52098373;37888741;9674843;53759500;41005461;10123851;5780207;2108547
FR;0;2023-02-26;20;28;34;101;28;35;113;256;111;54664632;52098401;37888775;9674944;53759528;41005496;10123964;5780463;2108658
FR;0;2023-02-27;213;329;602;1995;256;584;2066;6560;3945;54664845;52098730;37889377;9676939;53759784;41006080;10126030;5787023;2112603
FR;0;2023-02-28;270;370;842;3587;252;809;3731;12183;7493;54665115;52099100;37890219;9680526;53760036;41006889;10129761;5799206;2120096
FR;0;2023-03-01;227;345;834;1997;284;762;2179;6608;3928;54665342;52099445;37891053;9682523;53760320;41007651;10131940;5805814;2124024
FR;0;2023-03-02;223;318;852;2986;231;730;3203;10080;6261;54665565;52099763;37891905;9685509;53760551;41008381;10135143;5815894;2130285
FR;0;2023-03-03;333;469;1039;3687;357;931;3826;11850;7016;54665898;52100232;37892944;9689196;53760908;41009312;10138969;5827744;2137301
FR;0;2023-03-04;131;220;409;1081;160;392;1096;2792;1372;54666029;52100452;37893353;9690277;53761068;41009704;10140065;5830536;2138673
FR;0;2023-03-05;23;26;29;52;23;32;53;201;113;54666052;52100478;37893382;9690329;53761091;41009736;10140118;5830737;2138786
FR;0;2023-03-06;226;268;539;1418;192;520;1495;4729;2725;54666278;52100746;37893921;9691747;53761283;41010256;10141613;5835466;2141511
FR;0;2023-03-07;190;316;656;2363;220;612;2454;7961;4884;54666468;52101062;37894577;9694110;53761503;41010868;10144067;5843427;2146395
FR;0;2023-03-08;161;286;525;1442;221;465;1551;5006;2923;54666629;52101348;37895102;9695552;53761724;41011333;10145618;5848433;2149318
FR;0;2023-03-09;169;283;633;2005;190;608;2076;7148;4408;54666798;52101631;37895735;9697557;53761914;41011941;10147694;5855581;2153726
FR;0;2023-03-10;323;461;894;2645;345;821;2785;9020;5373;54667121;52102092;37896629;9700202;53762259;41012762;10150479;5864601;2159099
FR;0;2023-03-11;126;178;352;801;136;311;853;2299;1179;54667247;52102270;37896981;9701003;53762395;41013073;10151332;5866900;2160278
FR;0;2023-03-12;10;26;30;62;25;30;63;177;87;54667257;52102296;37897011;9701065;53762420;41013103;10151395;5867077;2160365
FR;0;2023-03-13;146;236;473;1149;180;429;1207;3778;2143;54667403;52102532;37897484;9702214;53762600;41013532;10152602;5870855;2162508
FR;0;2023-03-14;198;283;648;1900;194;635;1979;6801;4136;54667601;52102815;37898132;9704114;53762794;41014167;10154581;5877656;2166644
FR;0;2023-03-15;160;263;515;1254;214;484;1338;4341;2578;54667761;52103078;37898647;9705368;53763008;41014651;10155919;5881997;2169222
FR;0;2023-03-16;174;269;629;1649;200;579;1758;5955;3578;54667935;52103347;37899276;9707017;53763208;41015230;10157677;5887952;2172800
FR;0;2023-03-17;282;361;800;2047;272;720;2190;7336;4398;54668217;52103708;37900076;9709064;53763480;41015950;10159867;5895288;2177198
FR;0;2023-03-18;123;163;452;607;115;440;679;2042;1043;54668340;52103871;37900528;9709671;53763595;41016390;10160546;5897330;2178241
FR;0;2023-03-19;20;20;27;53;21;14;60;126;54;54668360;52103891;37900555;9709724;53763616;41016404;10160606;5897456;2178295
FR;0;2023-03-20;152;265;486;1083;176;490;1159;3826;2190;54668512;52104156;37901041;9710807;53763792;41016894;10161765;5901282;2180485
FR;0;2023-03-21;211;282;670;1630;200;638;1827;6529;3929;54668723;52104438;37901711;9712437;53763992;41017532;10163592;5907811;2184414
FR;0;2023-03-22;195;244;483;1040;191;462;1160;3955;2298;54668918;52104682;37902194;9713477;53764183;41017994;10164752;5911766;2186712
FR;0;2023-03-23;166;241;593;1418;167;536;1510;5204;3079;54669084;52104923;37902787;9714895;53764350;41018530;10166262;5916970;2189791
FR;0;2023-03-24;241;394;925;1787;289;869;1971;6633;3817;54669325;52105317;37903712;9716682;53764639;41019399;10168233;5923603;2193608
FR;0;2023-03-25;129;172;354;575;141;315;650;1794;840;54669454;52105489;37904066;9717257;53764780;41019714;10168883;5925397;2194448
FR;0;2023-03-26;10;18;26;31;12;26;33;92;47;54669464;52105507;37904092;9717288;53764792;41019740;10168916;5925489;2194495
FR;0;2023-03-27;230;256;515;891;209;493;992;3441;1954;54669694;52105763;37904607;9718179;53765001;41020233;10169908;5928930;2196449
FR;0;2023-03-28;186;250;592;1594;170;547;1723;6196;3715;54669880;52106013;37905199;9719773;53765171;41020780;10171631;5935126;2200164
FR;0;2023-03-29;172;253;437;980;165;441;1121;3776;2105;54670052;52106266;37905636;9720753;53765336;41021221;10172752;5938902;2202269
FR;0;2023-03-30;192;242;577;1360;163;564;1528;5389;3116;54670244;52106508;37906213;9722113;53765499;41021785;10174280;5944291;2205385
FR;0;2023-03-31;215;366;721;1795;272;647;1934;6856;4019;54670459;52106874;37906934;9723908;53765771;41022432;10176214;5951147;2209404
FR;0;2023-04-01;109;196;437;594;134;394;698;1982;949;54670568;52107070;37907371;9724502;53765905;41022826;10176912;5953129;2210353
FR;0;2023-04-02;10;26;30;34;14;38;37;116;50;54670578;52107096;37907401;9724536;53765919;41022864;10176949;5953245;2210403
FR;0;2023-04-03;184;214;552;875;160;509;997;3300;1831;54670762;52107310;37907953;9725411;53766079;41023373;10177946;5956545;2212234
FR;0;2023-04-04;131;257;539;1230;177;474;1391;5345;3204;54670893;52107567;37908492;9726641;53766256;41023847;10179337;5961890;2215438
FR;0;2023-04-05;101;199;411;839;141;393;939;3469;1995;54670994;52107766;37908903;9727480;53766397;41024240;10180276;5965359;2217433
FR;0;2023-04-06;153;184;438;1040;129;402;1169;4263;2452;54671147;52107950;37909341;9728520;53766526;41024642;10181445;5969622;2219885
FR;0;2023-04-07;193;308;558;1289;218;524;1421;5069;2850;54671340;52108258;37909899;9729809;53766744;41025166;10182866;5974691;2222735
FR;0;2023-04-08;67;142;240;399;96;239;436;1341;609;54671407;52108400;37910139;9730208;53766840;41025405;10183302;5976032;2223344
FR;0;2023-04-09;9;19;19;15;11;22;20;62;19;54671416;52108419;37910158;9730223;53766851;41025427;10183322;5976094;2223363
FR;0;2023-04-10;12;31;53;35;24;52;49;106;30;54671428;52108450;37910211;9730258;53766875;41025479;10183371;5976200;2223393
FR;0;2023-04-11;125;254;518;995;165;501;1108;4330;2391;54671553;52108704;37910729;9731253;53767040;41025980;10184479;5980530;2225784
FR;0;2023-04-12;131;207;382;742;154;381;811;3271;1872;54671684;52108911;37911111;9731995;53767194;41026361;10185290;5983801;2227656
FR;0;2023-04-13;109;218;408;946;148;400;1035;4232;2456;54671793;52109129;37911519;9732941;53767342;41026761;10186325;5988033;2230112
FR;0;2023-04-14;198;292;634;1240;231;576;1326;5274;3075;54671991;52109421;37912153;9734181;53767573;41027337;10187651;5993307;2233187
FR;0;2023-04-15;75;117;251;416;81;244;452;1483;683;54672066;52109538;37912404;9734597;53767654;41027581;10188103;5994790;2233870
FR;0;2023-04-16;18;19;13;38;15;17;34;111;48;54672084;52109557;37912417;9734635;53767669;41027598;10188137;5994901;2233918
FR;0;2023-04-17;107;192;378;654;132;390;749;3012;1611;54672191;52109749;37912795;9735289;53767801;41027988;10188886;5997913;2235529
FR;0;2023-04-18;149;189;403;874;129;417;972;4176;2383;54672340;52109938;37913198;9736163;53767930;41028405;10189858;6002089;2237912
FR;0;2023-04-19;111;166;291;605;125;274;699;2781;1481;54672451;52110104;37913489;9736768;53768055;41028679;10190557;6004870;2239393
FR;0;2023-04-20;106;190;350;810;135;343;869;3462;1902;54672557;52110294;37913839;9737578;53768190;41029022;10191426;6008332;2241295
FR;0;2023-04-21;146;260;542;989;169;542;1123;4296;2299;54672703;52110554;37914381;9738567;53768359;41029564;10192549;6012628;2243594
FR;0;2023-04-22;56;113;185;271;79;200;300;1113;540;54672759;52110667;37914566;9738838;53768438;41029764;10192849;6013741;2244134
FR;0;2023-04-23;5;8;15;17;7;16;21;64;22;54672764;52110675;37914581;9738855;53768445;41029780;10192870;6013805;2244156
FR;0;2023-04-24;137;177;293;544;126;284;628;2390;1221;54672901;52110852;37914874;9739399;53768571;41030064;10193498;6016195;2245377
FR;0;2023-04-25;120;175;366;825;121;374;888;4058;2215;54673021;52111027;37915240;9740224;53768692;41030438;10194386;6020253;2247592
FR;0;2023-04-26;104;134;277;503;109;275;570;2530;1298;54673125;52111161;37915517;9740727;53768801;41030713;10194956;6022783;2248890
FR;0;2023-04-27;134;171;337;783;117;351;879;3654;1953;54673259;52111332;37915854;9741510;53768918;41031064;10195835;6026437;2250843
FR;0;2023-04-28;192;265;411;850;158;434;978;4275;2190;54673451;52111597;37916265;9742360;53769076;41031498;10196813;6030712;2253033
FR;0;2023-04-29;82;96;155;269;78;139;320;1103;516;54673533;52111693;37916420;9742629;53769154;41031637;10197133;6031815;2253549
FR;0;2023-04-30;7;8;10;11;4;9;12;63;34;54673540;52111701;37916430;9742640;53769158;41031646;10197145;6031878;2253583
FR;0;2023-05-01;14;20;58;11;17;59;14;66;24;54673554;52111721;37916488;9742651;53769175;41031705;10197159;6031944;2253607
FR;0;2023-05-02;202;213;466;641;157;458;759;3513;1821;54673756;52111934;37916954;9743292;53769332;41032163;10197918;6035457;2255428
FR;0;2023-05-03;143;139;275;482;105;280;532;2759;1425;54673899;52112073;37917229;9743774;53769437;41032443;10198450;6038216;2256853
FR;0;2023-05-04;95;167;358;741;126;429;796;3999;2059;54673994;52112240;37917587;9744515;53769563;41032872;10199246;6042215;2258912
FR;0;2023-05-05;125;205;349;783;132;386;868;4446;2348;54674119;52112445;37917936;9745298;53769695;41033258;10200114;6046661;2261260
FR;0;2023-05-06;68;71;126;242;51;145;256;1091;514;54674187;52112516;37918062;9745540;53769746;41033403;10200370;6047752;2261774
FR;0;2023-05-07;9;9;12;21;8;12;23;87;32;54674196;52112525;37918074;9745561;53769754;41033415;10200393;6047839;2261806
FR;0;2023-05-08;20;15;28;18;12;26;42;128;63;54674216;52112540;37918102;9745579;53769766;41033441;10200435;6047967;2261869
FR;0;2023-05-09;86;126;232;561;95;246;626;3500;1756;54674302;52112666;37918334;9746140;53769861;41033687;10201061;6051467;2263625
FR;0;2023-05-10;114;132;199;523;107;241;565;3288;1558;54674416;52112798;37918533;9746663;53769968;41033928;10201626;6054755;2265183
FR;0;2023-05-11;84;108;224;661;85;214;739;3975;1980;54674500;52112906;37918757;9747324;53770053;41034142;10202365;6058730;2267163
FR;0;2023-05-12;93;143;274;776;108;283;813;4480;2148;54674593;52113049;37919031;9748100;53770161;41034425;10203178;6063210;2269311
FR;0;2023-05-13;50;80;116;210;56;132;233;1010;428;54674643;52113129;37919147;9748310;53770217;41034557;10203411;6064220;2269739
FR;0;2023-05-14;15;13;7;14;8;11;15;82;30;54674658;52113142;37919154;9748324;53770225;41034568;10203426;6064302;2269769
FR;0;2023-05-15;64;88;201;476;61;189;526;3271;1542;54674722;52113230;37919355;9748800;53770286;41034757;10203952;6067573;2271311
FR;0;2023-05-16;89;157;227;866;111;247;1015;6013;2885;54674811;52113387;37919582;9749666;53770397;41035004;10204967;6073586;2274196
FR;0;2023-05-17;97;139;206;509;107;202;563;3206;1433;54674908;52113526;37919788;9750175;53770504;41035206;10205530;6076792;2275629
FR;0;2023-05-18;4;9;10;28;7;11;29;164;67;54674912;52113535;37919798;9750203;53770511;41035217;10205559;6076956;2275696
FR;0;2023-05-19;74;134;244;493;94;242;558;2852;1226;54674986;52113669;37920042;9750696;53770605;41035459;10206117;6079808;2276922
FR;0;2023-05-20;46;45;100;123;32;92;142;829;330;54675032;52113714;37920142;9750819;53770637;41035551;10206259;6080637;2277252
FR;0;2023-05-21;11;9;5;16;7;8;17;151;45;54675043;52113723;37920147;9750835;53770644;41035559;10206276;6080788;2277297
FR;0;2023-05-22;89;68;175;476;55;177;539;3207;1445;54675132;52113791;37920322;9751311;53770699;41035736;10206815;6083995;2278742
FR;0;2023-05-23;48;86;190;663;68;175;782;4784;2182;54675180;52113877;37920512;9751974;53770767;41035911;10207597;6088779;2280924
FR;0;2023-05-24;70;87;183;534;72;178;617;3331;1514;54675250;52113964;37920695;9752508;53770839;41036089;10208214;6092110;2282438
FR;0;2023-05-25;78;87;179;567;68;177;656;4648;2109;54675328;52114051;37920874;9753075;53770907;41036266;10208870;6096758;2284547
FR;0;2023-05-26;92;138;217;639;104;225;696;4676;2158;54675420;52114189;37921091;9753714;53771011;41036491;10209566;6101434;2286705
FR;0;2023-05-27;35;64;79;140;45;81;168;872;416;54675455;52114253;37921170;9753854;53771056;41036572;10209734;6102306;2287121
FR;0;2023-05-28;4;5;4;8;7;3;14;69;32;54675459;52114258;37921174;9753862;53771063;41036575;10209748;6102375;2287153
FR;0;2023-05-29;5;7;7;32;4;10;44;305;118;54675464;52114265;37921181;9753894;53771067;41036585;10209792;6102680;2287271
FR;0;2023-05-30;95;102;162;617;71;173;735;4519;1933;54675559;52114367;37921343;9754511;53771138;41036758;10210527;6107199;2289204
FR;0;2023-05-31;72;117;130;507;81;146;587;3487;1578;54675631;52114484;37921473;9755018;53771219;41036904;10211114;6110686;2290782
FR;0;2023-06-01;69;97;196;581;70;206;688;4748;1968;54675700;52114581;37921669;9755599;53771289;41037110;10211802;6115434;2292750
FR;0;2023-06-02;71;119;191;605;79;215;709;5070;2275;54675771;52114700;37921860;9756204;53771368;41037325;10212511;6120504;2295025
FR;0;2023-06-03;26;52;73;159;33;77;183;1056;406;54675797;52114752;37921933;9756363;53771401;41037402;10212694;6121560;2295431
FR;0;2023-06-04;2;17;5;13;14;8;15;118;35;54675799;52114769;37921938;9756376;53771415;41037410;10212709;6121678;2295466
FR;0;2023-06-05;111;93;155;546;71;188;618;4229;1769;54675910;52114862;37922093;9756922;53771486;41037598;10213327;6125907;2297235
FR;0;2023-06-06;94;116;232;752;92;255;869;6870;2900;54676004;52114978;37922325;9757674;53771578;41037853;10214196;6132777;2300135
FR;0;2023-06-07;60;83;142;508;56;138;555;3881;1602;54676064;52115061;37922467;9758182;53771634;41037991;10214751;6136658;2301737
FR;0;2023-06-08;72;81;189;712;64;203;818;5971;2523;54676136;52115142;37922656;9758894;53771698;41038194;10215569;6142629;2304260
FR;0;2023-06-09;70;134;189;580;112;192;634;4986;2102;54676206;52115276;37922845;9759474;53771810;41038386;10216203;6147615;2306362
FR;0;2023-06-10;31;43;63;136;34;61;165;948;368;54676237;52115319;37922908;9759610;53771844;41038447;10216368;6148563;2306730
FR;0;2023-06-11;3;6;5;14;5;7;17;140;58;54676240;52115325;37922913;9759624;53771849;41038454;10216385;6148703;2306788
FR;0;2023-06-12;40;93;155;533;72;160;592;4509;1900;54676280;52115418;37923068;9760157;53771921;41038614;10216977;6153212;2308688
FR;0;2023-06-13;56;62;227;750;50;199;884;6511;2733;54676336;52115480;37923295;9760907;53771971;41038813;10217861;6159723;2311421
FR;0;2023-06-14;44;115;130;522;98;143;588;4194;1812;54676380;52115595;37923425;9761429;53772069;41038956;10218449;6163917;2313233
FR;0;2023-06-15;50;64;174;610;50;175;703;5466;2376;54676430;52115659;37923599;9762039;53772119;41039131;10219152;6169383;2315609
FR;0;2023-06-16;64;88;180;644;78;158;675;5292;2227;54676494;52115747;37923779;9762683;53772197;41039289;10219827;6174675;2317836
FR;0;2023-06-17;20;46;51;101;36;54;119;853;330;54676514;52115793;37923830;9762784;53772233;41039343;10219946;6175528;2318166
FR;0;2023-06-18;3;6;5;17;6;8;17;111;53;54676517;52115799;37923835;9762801;53772239;41039351;10219963;6175639;2318219
FR;0;2023-06-19;51;50;126;381;36;129;482;3305;1275;54676568;52115849;37923961;9763182;53772275;41039480;10220445;6178944;2319494
