fra;vaccin;jour;n_dose1;n_dose2;n_cum_dose1;n_cum_dose2
FR;1;2020-12-27;20;0;20;0
FR;1;2020-12-28;71;0;91;0
FR;1;2020-12-29;108;0;199;0
FR;1;2020-12-30;123;0;322;0
FR;1;2020-12-31;88;0;410;0
FR;1;2021-01-01;73;0;483;0
FR;1;2021-01-02;88;0;571;0
FR;1;2021-01-03;92;0;663;0
FR;1;2021-01-04;1479;0;2142;0
FR;1;2021-01-05;5415;0;7557;0
FR;1;2021-01-06;11322;0;18879;0
FR;1;2021-01-07;28577;0;47456;0
FR;1;2021-01-08;36294;0;83750;0
FR;1;2021-01-09;10939;0;94689;0
FR;1;2021-01-10;5637;0;100326;0
FR;1;2021-01-11;39112;0;139438;0
FR;1;2021-01-12;60997;0;200435;0
FR;1;2021-01-13;63934;0;264369;0
FR;1;2021-01-14;79835;0;344204;0
FR;1;2021-01-15;67372;0;411576;0
FR;1;2021-01-16;19561;87;431137;87
FR;1;2021-01-17;10472;42;441609;129
FR;1;2021-01-18;81578;164;523187;293
FR;1;2021-01-19;124040;128;647227;421
FR;1;2021-01-20;130459;160;777686;581
FR;1;2021-01-21;150437;141;928123;722
FR;1;2021-01-22;113935;163;1042058;885
FR;1;2021-01-23;36127;52;1078185;937
FR;1;2021-01-24;9269;28;1087454;965
FR;1;2021-01-25;73286;1219;1160740;2184
FR;1;2021-01-26;95177;3113;1255917;5297
FR;1;2021-01-27;102292;5599;1358209;10896
FR;1;2021-01-28;118956;14361;1477165;25257
FR;1;2021-01-29;87871;17293;1565036;42550
FR;1;2021-01-30;27616;4225;1592652;46775
FR;1;2021-01-31;4872;1679;1597524;48454
FR;1;2021-02-01;48372;21128;1645896;69582
FR;1;2021-02-02;66451;34568;1712347;104150
FR;1;2021-02-03;66026;36961;1778373;141111
FR;1;2021-02-04;75956;50059;1854329;191170
FR;1;2021-02-05;62594;45337;1916923;236507
FR;1;2021-02-06;19089;10396;1936012;246903
FR;1;2021-02-07;3436;5041;1939448;251944
FR;1;2021-02-08;35883;45986;1975331;297930
FR;1;2021-02-09;49968;72392;2025299;370322
FR;1;2021-02-10;50971;76646;2076270;446968
FR;1;2021-02-11;62303;99077;2138573;546045
FR;1;2021-02-12;54973;74038;2193546;620083
FR;1;2021-02-13;15184;19270;2208730;639353
FR;1;2021-02-14;3431;7190;2212161;646543
FR;1;2021-02-15;23602;73440;2235763;719983
FR;1;2021-02-16;32146;96865;2267909;816848
FR;1;2021-02-17;34418;98569;2302327;915417
FR;1;2021-02-18;48263;113474;2350590;1028891
FR;1;2021-02-19;44532;86414;2395122;1115305
FR;1;2021-02-20;13069;26920;2408191;1142225
FR;1;2021-02-21;2119;6287;2410310;1148512
FR;1;2021-02-22;24127;69415;2434437;1217927
FR;1;2021-02-23;36746;80366;2471183;1298293
FR;1;2021-02-24;39493;77662;2510676;1375955
FR;1;2021-02-25;49095;87994;2559771;1463949
FR;1;2021-02-26;46208;67888;2605979;1531837
FR;1;2021-02-27;15245;20931;2621224;1552768
FR;1;2021-02-28;3234;4386;2624458;1557154
FR;1;2021-03-01;38795;49031;2663253;1606185
FR;1;2021-03-02;54779;61506;2718032;1667691
FR;1;2021-03-03;59676;60653;2777708;1728344
FR;1;2021-03-04;71360;64894;2849068;1793238
FR;1;2021-03-05;73311;59274;2922379;1852512
FR;1;2021-03-06;81458;16094;3003837;1868606
FR;1;2021-03-07;63001;5424;3066838;1874030
FR;1;2021-03-08;58911;42480;3125749;1916510
FR;1;2021-03-09;84579;48318;3210328;1964828
FR;1;2021-03-10;89190;48067;3299518;2012895
FR;1;2021-03-11;103408;53866;3402926;2066761
FR;1;2021-03-12;102318;45270;3505244;2112031
FR;1;2021-03-13;87882;12722;3593126;2124753
FR;1;2021-03-14;43752;3031;3636878;2127784
FR;1;2021-03-15;94029;29153;3730907;2156937
FR;1;2021-03-16;122096;34908;3853003;2191845
FR;1;2021-03-17;127697;34869;3980700;2226714
FR;1;2021-03-18;141173;39756;4121873;2266470
FR;1;2021-03-19;134472;32914;4256345;2299384
FR;1;2021-03-20;75076;10212;4331421;2309596
FR;1;2021-03-21;25777;2477;4357198;2312073
FR;1;2021-03-22;113094;31191;4470292;2343264
FR;1;2021-03-23;141150;38176;4611442;2381440
FR;1;2021-03-24;140041;38791;4751483;2420231
FR;1;2021-03-25;162961;39620;4914444;2459851
FR;1;2021-03-26;164450;37500;5078894;2497351
FR;1;2021-03-27;109955;15260;5188849;2512611
FR;1;2021-03-28;41737;3624;5230586;2516235
FR;1;2021-03-29;128439;49969;5359025;2566204
FR;1;2021-03-30;165773;63600;5524798;2629804
FR;1;2021-03-31;168990;66916;5693788;2696720
FR;1;2021-04-01;191389;79256;5885177;2775976
FR;1;2021-04-02;162433;84319;6047610;2860295
FR;1;2021-04-03;87205;58188;6134815;2918483
FR;1;2021-04-04;32341;17733;6167156;2936216
FR;1;2021-04-05;42433;10178;6209589;2946394
FR;1;2021-04-06;157823;100891;6367412;3047285
FR;1;2021-04-07;194291;108272;6561703;3155557
FR;1;2021-04-08;218861;112406;6780564;3267963
FR;1;2021-04-09;211700;107520;6992264;3375483
FR;1;2021-04-10;115993;73465;7108257;3448948
FR;1;2021-04-11;40043;30288;7148300;3479236
FR;1;2021-04-12;166529;103797;7314829;3583033
FR;1;2021-04-13;201133;128263;7515962;3711296
FR;1;2021-04-14;205514;122820;7721476;3834116
FR;1;2021-04-15;218298;126766;7939774;3960882
FR;1;2021-04-16;203847;125155;8143621;4086037
FR;1;2021-04-17;120958;67490;8264579;4153527
FR;1;2021-04-18;35222;20997;8299801;4174524
FR;1;2021-04-19;161889;121935;8461690;4296459
FR;1;2021-04-20;187112;148803;8648802;4445262
FR;1;2021-04-21;191627;146761;8840429;4592023
FR;1;2021-04-22;206378;162652;9046807;4754675
FR;1;2021-04-23;196652;156940;9243459;4911615
FR;1;2021-04-24;124991;95520;9368450;5007135
FR;1;2021-04-25;52876;30144;9421326;5037279
FR;1;2021-04-26;179224;138282;9600550;5175561
FR;1;2021-04-27;219006;162011;9819556;5337572
FR;1;2021-04-28;236098;155142;10055654;5492714
FR;1;2021-04-29;267510;160093;10323164;5652807
FR;1;2021-04-30;269242;148183;10592406;5800990
FR;1;2021-05-01;138188;40719;10730594;5841709
FR;1;2021-05-02;80426;28165;10811020;5869874
FR;1;2021-05-03;247155;146549;11058175;6016423
FR;1;2021-05-04;262399;186879;11320574;6203302
FR;1;2021-05-05;278976;184603;11599550;6387905
FR;1;2021-05-06;305442;183075;11904992;6570980
FR;1;2021-05-07;280204;195761;12185196;6766741
FR;1;2021-05-08;184556;48340;12369752;6815081
FR;1;2021-05-09;112788;36234;12482540;6851315
FR;1;2021-05-10;250930;194294;12733470;7045609
FR;1;2021-05-11;313548;211459;13047018;7257068
FR;1;2021-05-12;348279;185960;13395297;7443028
FR;1;2021-05-13;277820;47685;13673117;7490713
FR;1;2021-05-14;364120;128946;14037237;7619659
FR;1;2021-05-15;291953;66180;14329190;7685839
FR;1;2021-05-16;155406;15588;14484596;7701427
FR;1;2021-05-17;313385;116749;14797981;7818176
FR;1;2021-05-18;373480;111416;15171461;7929592
FR;1;2021-05-19;388240;103022;15559701;8032614
FR;1;2021-05-20;413258;96425;15972959;8129039
FR;1;2021-05-21;392227;97538;16365186;8226577
FR;1;2021-05-22;271548;42191;16636734;8268768
FR;1;2021-05-23;121082;11256;16757816;8280024
FR;1;2021-05-24;238948;26394;16996764;8306418
FR;1;2021-05-25;358668;132083;17355432;8438501
FR;1;2021-05-26;370423;125871;17725855;8564372
FR;1;2021-05-27;398958;128460;18124813;8692832
FR;1;2021-05-28;359573;145744;18484386;8838576
FR;1;2021-05-29;250362;81092;18734748;8919668
FR;1;2021-05-30;99073;22619;18833821;8942287
FR;1;2021-05-31;309171;148973;19142992;9091260
FR;1;2021-06-01;346027;166978;19489019;9258238
FR;1;2021-06-02;347575;153500;19836594;9411738
FR;1;2021-06-03;378257;147941;20214851;9559679
FR;1;2021-06-04;351421;175825;20566272;9735504
FR;1;2021-06-05;253153;112887;20819425;9848391
FR;1;2021-06-06;123134;37572;20942559;9885963
FR;1;2021-06-07;290319;208378;21232878;10094341
FR;1;2021-06-08;324413;224304;21557291;10318645
FR;1;2021-06-09;322651;216738;21879942;10535383
FR;1;2021-06-10;327141;202541;22207083;10737924
FR;1;2021-06-11;301242;235696;22508325;10973620
FR;1;2021-06-12;237591;150986;22745916;11124606
FR;1;2021-06-13;97330;61134;22843246;11185740
FR;1;2021-06-14;197498;289340;23040744;11475080
FR;1;2021-06-15;243845;282767;23284589;11757847
FR;1;2021-06-16;263025;270779;23547614;12028626
FR;1;2021-06-17;256969;244702;23804583;12273328
FR;2;2020-12-27;0;0;0;0
FR;2;2020-12-28;0;0;0;0
FR;2;2020-12-29;0;0;0;0
FR;2;2020-12-30;0;0;0;0
FR;2;2020-12-31;0;0;0;0
FR;2;2021-01-01;0;0;0;0
FR;2;2021-01-02;0;0;0;0
FR;2;2021-01-03;0;0;0;0
FR;2;2021-01-04;0;0;0;0
FR;2;2021-01-05;0;0;0;0
FR;2;2021-01-06;0;0;0;0
FR;2;2021-01-07;0;0;0;0
FR;2;2021-01-08;0;0;0;0
FR;2;2021-01-09;0;0;0;0
FR;2;2021-01-10;0;0;0;0
FR;2;2021-01-11;0;0;0;0
FR;2;2021-01-12;0;0;0;0
FR;2;2021-01-13;0;0;0;0
FR;2;2021-01-14;152;0;152;0
FR;2;2021-01-15;218;0;370;0
FR;2;2021-01-16;186;0;556;0
FR;2;2021-01-17;3;0;559;0
FR;2;2021-01-18;2914;0;3473;0
FR;2;2021-01-19;4515;0;7988;0
FR;2;2021-01-20;4921;0;12909;0
FR;2;2021-01-21;5126;0;18035;0
FR;2;2021-01-22;4882;0;22917;0
FR;2;2021-01-23;1734;0;24651;0
FR;2;2021-01-24;102;0;24753;0
FR;2;2021-01-25;3635;0;28388;0
FR;2;2021-01-26;3750;0;32138;0
FR;2;2021-01-27;3442;0;35580;0
FR;2;2021-01-28;3514;0;39094;0
FR;2;2021-01-29;3082;0;42176;0
FR;2;2021-01-30;1064;0;43240;0
FR;2;2021-01-31;0;0;43240;0
FR;2;2021-02-01;3259;0;46499;0
FR;2;2021-02-02;4308;0;50807;0
FR;2;2021-02-03;5032;0;55839;0
FR;2;2021-02-04;4735;4;60574;4
FR;2;2021-02-05;4621;6;65195;10
FR;2;2021-02-06;1931;3;67126;13
FR;2;2021-02-07;42;0;67168;13
FR;2;2021-02-08;7428;8;74596;21
FR;2;2021-02-09;8258;16;82854;37
FR;2;2021-02-10;9141;49;91995;86
FR;2;2021-02-11;10056;67;102051;153
FR;2;2021-02-12;9815;238;111866;391
FR;2;2021-02-13;3016;222;114882;613
FR;2;2021-02-14;296;0;115178;613
FR;2;2021-02-15;3359;3067;118537;3680
FR;2;2021-02-16;4909;3881;123446;7561
FR;2;2021-02-17;4105;4403;127551;11964
FR;2;2021-02-18;5234;5089;132785;17053
FR;2;2021-02-19;5213;4323;137998;21376
FR;2;2021-02-20;1764;1509;139762;22885
FR;2;2021-02-21;197;86;139959;22971
FR;2;2021-02-22;3515;3723;143474;26694
FR;2;2021-02-23;4837;3693;148311;30387
FR;2;2021-02-24;4759;3468;153070;33855
FR;2;2021-02-25;5293;3426;158363;37281
FR;2;2021-02-26;4197;3125;162560;40406
FR;2;2021-02-27;1502;1042;164062;41448
FR;2;2021-02-28;99;28;164161;41476
FR;2;2021-03-01;4961;3764;169122;45240
FR;2;2021-03-02;6308;4727;175430;49967
FR;2;2021-03-03;6244;4883;181674;54850
FR;2;2021-03-04;8072;3967;189746;58817
FR;2;2021-03-05;7769;4060;197515;62877
FR;2;2021-03-06;4621;1682;202136;64559
FR;2;2021-03-07;2284;29;204420;64588
FR;2;2021-03-08;3975;8311;208395;72899
FR;2;2021-03-09;7268;8429;215663;81328
FR;2;2021-03-10;6862;9109;222525;90437
FR;2;2021-03-11;9085;9208;231610;99645
FR;2;2021-03-12;7719;8170;239329;107815
FR;2;2021-03-13;9873;2511;249202;110326
FR;2;2021-03-14;4753;402;253955;110728
FR;2;2021-03-15;10651;3484;264606;114212
FR;2;2021-03-16;16457;4621;281063;118833
FR;2;2021-03-17;19900;3952;300963;122785
FR;2;2021-03-18;22958;4910;323921;127695
FR;2;2021-03-19;22886;4538;346807;132233
FR;2;2021-03-20;25146;1540;371953;133773
FR;2;2021-03-21;17472;147;389425;133920
FR;2;2021-03-22;17399;3078;406824;136998
FR;2;2021-03-23;22268;4183;429092;141181
FR;2;2021-03-24;23552;4988;452644;146169
FR;2;2021-03-25;26281;5022;478925;151191
FR;2;2021-03-26;26592;4262;505517;155453
FR;2;2021-03-27;15639;1309;521156;156762
FR;2;2021-03-28;10395;94;531551;156856
FR;2;2021-03-29;18650;4281;550201;161137
FR;2;2021-03-30;24175;6002;574376;167139
FR;2;2021-03-31;28126;5958;602502;173097
FR;2;2021-04-01;33986;8496;636488;181593
FR;2;2021-04-02;29558;7662;666046;189255
FR;2;2021-04-03;16728;3582;682774;192837
FR;2;2021-04-04;9161;918;691935;193755
FR;2;2021-04-05;12122;811;704057;194566
FR;2;2021-04-06;26769;6933;730826;201499
FR;2;2021-04-07;30583;7174;761409;208673
FR;2;2021-04-08;36499;8818;797908;217491
FR;2;2021-04-09;33397;8602;831305;226093
FR;2;2021-04-10;19449;8969;850754;235062
FR;2;2021-04-11;7815;4272;858569;239334
FR;2;2021-04-12;16806;11255;875375;250589
FR;2;2021-04-13;19112;16426;894487;267015
FR;2;2021-04-14;17663;16285;912150;283300
FR;2;2021-04-15;21847;20757;933997;304057
FR;2;2021-04-16;20388;20073;954385;324130
FR;2;2021-04-17;13057;22462;967442;346592
FR;2;2021-04-18;5786;14405;973228;360997
FR;2;2021-04-19;16485;16263;989713;377260
FR;2;2021-04-20;18993;21595;1008706;398855
FR;2;2021-04-21;19783;21665;1028489;420520
FR;2;2021-04-22;23415;24863;1051904;445383
FR;2;2021-04-23;24217;25352;1076121;470735
FR;2;2021-04-24;25107;15111;1101228;485846
FR;2;2021-04-25;9495;8589;1110723;494435
FR;2;2021-04-26;16904;17196;1127627;511631
FR;2;2021-04-27;19022;24307;1146649;535938
FR;2;2021-04-28;21944;26188;1168593;562126
FR;2;2021-04-29;25200;30137;1193793;592263
FR;2;2021-04-30;25337;27782;1219130;620045
FR;2;2021-05-01;14796;9863;1233926;629908
FR;2;2021-05-02;6517;9184;1240443;639092
FR;2;2021-05-03;19595;19328;1260038;658420
FR;2;2021-05-04;18043;29056;1278081;687476
FR;2;2021-05-05;17985;29415;1296066;716891
FR;2;2021-05-06;23248;35292;1319314;752183
FR;2;2021-05-07;24838;33245;1344152;785428
FR;2;2021-05-08;20449;9704;1364601;795132
FR;2;2021-05-09;12973;7894;1377574;803026
FR;2;2021-05-10;32279;22222;1409853;825248
FR;2;2021-05-11;43020;21078;1452873;846326
FR;2;2021-05-12;48972;19907;1501845;866233
FR;2;2021-05-13;50513;5770;1552358;872003
FR;2;2021-05-14;60475;12957;1612833;884960
FR;2;2021-05-15;65215;7153;1678048;892113
FR;2;2021-05-16;42979;2576;1721027;894689
FR;2;2021-05-17;44091;12591;1765118;907280
FR;2;2021-05-18;53447;12256;1818565;919536
FR;2;2021-05-19;56257;10636;1874822;930172
FR;2;2021-05-20;62467;10900;1937289;941072
FR;2;2021-05-21;63205;11686;2000494;952758
FR;2;2021-05-22;60746;4528;2061240;957286
FR;2;2021-05-23;36928;577;2098168;957863
FR;2;2021-05-24;16825;2033;2114993;959896
FR;2;2021-05-25;20517;12244;2135510;972140
FR;2;2021-05-26;19055;11469;2154565;983609
FR;2;2021-05-27;22390;12670;2176955;996279
FR;2;2021-05-28;28743;14992;2205698;1011271
FR;2;2021-05-29;29957;8191;2235655;1019462
FR;2;2021-05-30;4473;1811;2240128;1021273
FR;2;2021-05-31;27998;18761;2268126;1040034
FR;2;2021-06-01;44272;20077;2312398;1060111
FR;2;2021-06-02;36426;19319;2348824;1079430
FR;2;2021-06-03;50261;23409;2399085;1102839
FR;2;2021-06-04;64379;24107;2463464;1126946
FR;2;2021-06-05;33797;24053;2497261;1150999
FR;2;2021-06-06;4726;6206;2501987;1157205
FR;2;2021-06-07;27486;23113;2529473;1180318
FR;2;2021-06-08;45663;23264;2575136;1203582
FR;2;2021-06-09;32995;21511;2608131;1225093
FR;2;2021-06-10;40964;19162;2649095;1244255
FR;2;2021-06-11;53974;25257;2703069;1269512
FR;2;2021-06-12;29712;19823;2732781;1289335
FR;2;2021-06-13;3094;9190;2735875;1298525
FR;2;2021-06-14;24542;24198;2760417;1322723
FR;2;2021-06-15;37920;22898;2798337;1345621
FR;2;2021-06-16;29184;21552;2827521;1367173
FR;2;2021-06-17;35413;25905;2862934;1393078
FR;3;2020-12-27;0;0;0;0
FR;3;2020-12-28;0;0;0;0
FR;3;2020-12-29;0;0;0;0
FR;3;2020-12-30;0;0;0;0
FR;3;2020-12-31;0;0;0;0
FR;3;2021-01-01;0;0;0;0
FR;3;2021-01-02;0;0;0;0
FR;3;2021-01-03;0;0;0;0
FR;3;2021-01-04;0;0;0;0
FR;3;2021-01-05;0;0;0;0
FR;3;2021-01-06;0;0;0;0
FR;3;2021-01-07;0;0;0;0
FR;3;2021-01-08;0;0;0;0
FR;3;2021-01-09;0;0;0;0
FR;3;2021-01-10;0;0;0;0
FR;3;2021-01-11;0;0;0;0
FR;3;2021-01-12;0;0;0;0
FR;3;2021-01-13;0;0;0;0
FR;3;2021-01-14;0;0;0;0
FR;3;2021-01-15;0;0;0;0
FR;3;2021-01-16;0;0;0;0
FR;3;2021-01-17;0;0;0;0
FR;3;2021-01-18;0;0;0;0
FR;3;2021-01-19;0;0;0;0
FR;3;2021-01-20;0;0;0;0
FR;3;2021-01-21;0;0;0;0
FR;3;2021-01-22;0;0;0;0
FR;3;2021-01-23;0;0;0;0
FR;3;2021-01-24;0;0;0;0
FR;3;2021-01-25;0;0;0;0
FR;3;2021-01-26;0;0;0;0
FR;3;2021-01-27;0;0;0;0
FR;3;2021-01-28;0;0;0;0
FR;3;2021-01-29;0;0;0;0
FR;3;2021-01-30;0;0;0;0
FR;3;2021-01-31;0;0;0;0
FR;3;2021-02-01;0;0;0;0
FR;3;2021-02-02;0;0;0;0
FR;3;2021-02-03;0;0;0;0
FR;3;2021-02-04;0;0;0;0
FR;3;2021-02-05;0;0;0;0
FR;3;2021-02-06;329;0;329;0
FR;3;2021-02-07;1348;0;1677;0
FR;3;2021-02-08;2635;0;4312;0
FR;3;2021-02-09;6644;0;10956;0
FR;3;2021-02-10;9240;0;20196;0
FR;3;2021-02-11;13363;0;33559;0
FR;3;2021-02-12;13049;0;46608;0
FR;3;2021-02-13;3517;0;50125;0
FR;3;2021-02-14;869;0;50994;0
FR;3;2021-02-15;10132;0;61126;0
FR;3;2021-02-16;12182;0;73308;0
FR;3;2021-02-17;10819;0;84127;0
FR;3;2021-02-18;14581;0;98708;0
FR;3;2021-02-19;14123;0;112831;0
FR;3;2021-02-20;3181;0;116012;0
FR;3;2021-02-21;544;0;116556;0
FR;3;2021-02-22;8917;0;125473;0
FR;3;2021-02-23;11117;0;136590;0
FR;3;2021-02-24;13912;0;150502;0
FR;3;2021-02-25;44428;0;194930;0
FR;3;2021-02-26;61439;0;256369;0
FR;3;2021-02-27;34485;8;290854;8
FR;3;2021-02-28;2347;0;293201;8
FR;3;2021-03-01;19954;9;313155;17
FR;3;2021-03-02;38367;14;351522;31
FR;3;2021-03-03;47940;18;399462;49
FR;3;2021-03-04;81273;23;480735;72
FR;3;2021-03-05;117135;61;597870;133
FR;3;2021-03-06;119378;51;717248;184
FR;3;2021-03-07;54642;28;771890;212
FR;3;2021-03-08;42152;20;814042;232
FR;3;2021-03-09;78131;31;892173;263
FR;3;2021-03-10;79957;39;972130;302
FR;3;2021-03-11;127324;49;1099454;351
FR;3;2021-03-12;181398;70;1280852;421
FR;3;2021-03-13;131160;56;1412012;477
FR;3;2021-03-14;13795;4;1425807;481
FR;3;2021-03-15;51504;37;1477311;518
FR;3;2021-03-16;932;13;1478243;531
FR;3;2021-03-17;664;6;1478907;537
FR;3;2021-03-18;1223;4;1480130;541
FR;3;2021-03-19;69781;36;1549911;577
FR;3;2021-03-20;64667;38;1614578;615
FR;3;2021-03-21;5519;4;1620097;619
FR;3;2021-03-22;36907;32;1657004;651
FR;3;2021-03-23;83804;50;1740808;701
FR;3;2021-03-24;90163;93;1830971;794
FR;3;2021-03-25;149064;115;1980035;909
FR;3;2021-03-26;164256;155;2144291;1064
FR;3;2021-03-27;67673;90;2211964;1154
FR;3;2021-03-28;6241;19;2218205;1173
FR;3;2021-03-29;53535;61;2271740;1234
FR;3;2021-03-30;92325;88;2364065;1322
FR;3;2021-03-31;62722;82;2426787;1404
FR;3;2021-04-01;85113;103;2511900;1507
FR;3;2021-04-02;86043;147;2597943;1654
FR;3;2021-04-03;35320;109;2633263;1763
FR;3;2021-04-04;3392;15;2636655;1778
FR;3;2021-04-05;4248;21;2640903;1799
FR;3;2021-04-06;29058;76;2669961;1875
FR;3;2021-04-07;31643;60;2701604;1935
FR;3;2021-04-08;77759;234;2779363;2169
FR;3;2021-04-09;160270;410;2939633;2579
FR;3;2021-04-10;74723;331;3014356;2910
FR;3;2021-04-11;7042;44;3021398;2954
FR;3;2021-04-12;50653;197;3072051;3151
FR;3;2021-04-13;85211;315;3157262;3466
FR;3;2021-04-14;66682;341;3223944;3807
FR;3;2021-04-15;91876;369;3315820;4176
FR;3;2021-04-16;111136;571;3426956;4747
FR;3;2021-04-17;52357;327;3479313;5074
FR;3;2021-04-18;9440;32;3488753;5106
FR;3;2021-04-19;24480;234;3513233;5340
FR;3;2021-04-20;44849;395;3558082;5735
FR;3;2021-04-21;38060;450;3596142;6185
FR;3;2021-04-22;53745;791;3649887;6976
FR;3;2021-04-23;69497;1019;3719384;7995
FR;3;2021-04-24;36532;976;3755916;8971
FR;3;2021-04-25;5917;154;3761833;9125
FR;3;2021-04-26;19103;662;3780936;9787
FR;3;2021-04-27;33720;1246;3814656;11033
FR;3;2021-04-28;28285;1925;3842941;12958
FR;3;2021-04-29;44575;5956;3887516;18914
FR;3;2021-04-30;54599;8932;3942115;27846
FR;3;2021-05-01;9182;1968;3951297;29814
FR;3;2021-05-02;2798;500;3954095;30314
FR;3;2021-05-03;12522;3881;3966617;34195
FR;3;2021-05-04;22446;8454;3989063;42649
FR;3;2021-05-05;18052;10574;4007115;53223
FR;3;2021-05-06;33878;20906;4040993;74129
FR;3;2021-05-07;43377;28410;4084370;102539
FR;3;2021-05-08;6357;8901;4090727;111440
FR;3;2021-05-09;1563;2655;4092290;114095
FR;3;2021-05-10;14426;12567;4106716;126662
FR;3;2021-05-11;26401;25738;4133117;152400
FR;3;2021-05-12;16710;27453;4149827;179853
FR;3;2021-05-13;2001;3480;4151828;183333
FR;3;2021-05-14;14065;25742;4165893;209075
FR;3;2021-05-15;6914;20734;4172807;229809
FR;3;2021-05-16;811;2679;4173618;232488
FR;3;2021-05-17;7504;19915;4181122;252403
FR;3;2021-05-18;12907;29634;4194029;282037
FR;3;2021-05-19;8797;31866;4202826;313903
FR;3;2021-05-20;12281;53220;4215107;367123
FR;3;2021-05-21;12247;65540;4227354;432663
FR;3;2021-05-22;4670;33300;4232024;465963
FR;3;2021-05-23;536;2665;4232560;468628
FR;3;2021-05-24;581;4920;4233141;473548
FR;3;2021-05-25;4980;45189;4238121;518737
FR;3;2021-05-26;4555;51055;4242676;569792
FR;3;2021-05-27;5940;77848;4248616;647640
FR;3;2021-05-28;7127;99104;4255743;746744
FR;3;2021-05-29;3069;60285;4258812;807029
FR;3;2021-05-30;379;8243;4259191;815272
FR;3;2021-05-31;2060;36000;4261251;851272
FR;3;2021-06-01;2974;64820;4264225;916092
FR;3;2021-06-02;2354;58361;4266579;974453
FR;3;2021-06-03;3181;87588;4269760;1062041
FR;3;2021-06-04;3842;105129;4273602;1167170
FR;3;2021-06-05;1761;52247;4275363;1219417
FR;3;2021-06-06;263;5400;4275626;1224817
FR;3;2021-06-07;1094;31186;4276720;1256003
FR;3;2021-06-08;2226;47886;4278946;1303889
FR;3;2021-06-09;1396;42455;4280342;1346344
FR;3;2021-06-10;1868;68014;4282210;1414358
FR;3;2021-06-11;2208;96814;4284418;1511172
FR;3;2021-06-12;1000;40841;4285418;1552013
FR;3;2021-06-13;138;3823;4285556;1555836
FR;3;2021-06-14;736;42670;4286292;1598506
FR;3;2021-06-15;1180;80696;4287472;1679202
FR;3;2021-06-16;1012;65787;4288484;1744989
FR;3;2021-06-17;1396;101860;4289880;1846849
FR;4;2020-12-27;0;0;0;0
FR;4;2020-12-28;0;0;0;0
FR;4;2020-12-29;0;0;0;0
FR;4;2020-12-30;0;0;0;0
FR;4;2020-12-31;0;0;0;0
FR;4;2021-01-01;0;0;0;0
FR;4;2021-01-02;0;0;0;0
FR;4;2021-01-03;0;0;0;0
FR;4;2021-01-04;0;0;0;0
FR;4;2021-01-05;0;0;0;0
FR;4;2021-01-06;0;0;0;0
FR;4;2021-01-07;0;0;0;0
FR;4;2021-01-08;0;0;0;0
FR;4;2021-01-09;0;0;0;0
FR;4;2021-01-10;0;0;0;0
FR;4;2021-01-11;0;0;0;0
FR;4;2021-01-12;0;0;0;0
FR;4;2021-01-13;0;0;0;0
FR;4;2021-01-14;0;0;0;0
FR;4;2021-01-15;0;0;0;0
FR;4;2021-01-16;0;0;0;0
FR;4;2021-01-17;0;0;0;0
FR;4;2021-01-18;0;0;0;0
FR;4;2021-01-19;0;0;0;0
FR;4;2021-01-20;0;0;0;0
FR;4;2021-01-21;0;0;0;0
FR;4;2021-01-22;0;0;0;0
FR;4;2021-01-23;0;0;0;0
FR;4;2021-01-24;0;0;0;0
FR;4;2021-01-25;0;0;0;0
FR;4;2021-01-26;0;0;0;0
FR;4;2021-01-27;0;0;0;0
FR;4;2021-01-28;0;0;0;0
FR;4;2021-01-29;0;0;0;0
FR;4;2021-01-30;0;0;0;0
FR;4;2021-01-31;0;0;0;0
FR;4;2021-02-01;0;0;0;0
FR;4;2021-02-02;0;0;0;0
FR;4;2021-02-03;0;0;0;0
FR;4;2021-02-04;0;0;0;0
FR;4;2021-02-05;0;0;0;0
FR;4;2021-02-06;0;0;0;0
FR;4;2021-02-07;0;0;0;0
FR;4;2021-02-08;0;0;0;0
FR;4;2021-02-09;0;0;0;0
FR;4;2021-02-10;0;0;0;0
FR;4;2021-02-11;0;0;0;0
FR;4;2021-02-12;0;0;0;0
FR;4;2021-02-13;0;0;0;0
FR;4;2021-02-14;0;0;0;0
FR;4;2021-02-15;0;0;0;0
FR;4;2021-02-16;0;0;0;0
FR;4;2021-02-17;0;0;0;0
FR;4;2021-02-18;0;0;0;0
FR;4;2021-02-19;0;0;0;0
FR;4;2021-02-20;0;0;0;0
FR;4;2021-02-21;0;0;0;0
FR;4;2021-02-22;0;0;0;0
FR;4;2021-02-23;0;0;0;0
FR;4;2021-02-24;0;0;0;0
FR;4;2021-02-25;0;0;0;0
FR;4;2021-02-26;0;0;0;0
FR;4;2021-02-27;0;0;0;0
FR;4;2021-02-28;0;0;0;0
FR;4;2021-03-01;0;0;0;0
FR;4;2021-03-02;0;0;0;0
FR;4;2021-03-03;0;0;0;0
FR;4;2021-03-04;0;0;0;0
FR;4;2021-03-05;0;0;0;0
FR;4;2021-03-06;0;0;0;0
FR;4;2021-03-07;0;0;0;0
FR;4;2021-03-08;0;0;0;0
FR;4;2021-03-09;0;0;0;0
FR;4;2021-03-10;0;0;0;0
FR;4;2021-03-11;0;0;0;0
FR;4;2021-03-12;0;0;0;0
FR;4;2021-03-13;0;0;0;0
FR;4;2021-03-14;0;0;0;0
FR;4;2021-03-15;0;0;0;0
FR;4;2021-03-16;0;0;0;0
FR;4;2021-03-17;0;0;0;0
FR;4;2021-03-18;0;0;0;0
FR;4;2021-03-19;0;0;0;0
FR;4;2021-03-20;0;0;0;0
FR;4;2021-03-21;0;0;0;0
FR;4;2021-03-22;0;0;0;0
FR;4;2021-03-23;0;0;0;0
FR;4;2021-03-24;0;0;0;0
FR;4;2021-03-25;0;0;0;0
FR;4;2021-03-26;0;0;0;0
FR;4;2021-03-27;0;0;0;0
FR;4;2021-03-28;0;0;0;0
FR;4;2021-03-29;0;0;0;0
FR;4;2021-03-30;0;0;0;0
FR;4;2021-03-31;0;0;0;0
FR;4;2021-04-01;0;0;0;0
FR;4;2021-04-02;0;0;0;0
FR;4;2021-04-03;0;0;0;0
FR;4;2021-04-04;0;0;0;0
FR;4;2021-04-05;0;0;0;0
FR;4;2021-04-06;0;0;0;0
FR;4;2021-04-07;0;0;0;0
FR;4;2021-04-08;0;0;0;0
FR;4;2021-04-09;0;0;0;0
FR;4;2021-04-10;0;0;0;0
FR;4;2021-04-11;0;0;0;0
FR;4;2021-04-12;0;0;0;0
FR;4;2021-04-13;0;0;0;0
FR;4;2021-04-14;0;0;0;0
FR;4;2021-04-15;0;0;0;0
FR;4;2021-04-16;0;0;0;0
FR;4;2021-04-17;0;0;0;0
FR;4;2021-04-18;0;0;0;0
FR;4;2021-04-19;0;0;0;0
FR;4;2021-04-20;0;0;0;0
FR;4;2021-04-21;0;0;0;0
FR;4;2021-04-22;0;0;0;0
FR;4;2021-04-23;792;0;792;0
FR;4;2021-04-24;1552;0;2344;0
FR;4;2021-04-25;117;0;2461;0
FR;4;2021-04-26;2829;0;5290;0
FR;4;2021-04-27;9387;4;14677;4
FR;4;2021-04-28;9772;3;24449;7
FR;4;2021-04-29;15885;7;40334;14
FR;4;2021-04-30;19082;7;59416;21
FR;4;2021-05-01;1897;5;61313;26
FR;4;2021-05-02;440;0;61753;26
FR;4;2021-05-03;4928;1;66681;27
FR;4;2021-05-04;8249;8;74930;35
FR;4;2021-05-05;6006;7;80936;42
FR;4;2021-05-06;11257;11;92193;53
FR;4;2021-05-07;18907;8;111100;61
FR;4;2021-05-08;2260;5;113360;66
FR;4;2021-05-09;629;2;113989;68
FR;4;2021-05-10;7092;8;121081;76
FR;4;2021-05-11;14118;12;135199;88
FR;4;2021-05-12;9955;14;145154;102
FR;4;2021-05-13;1441;2;146595;104
FR;4;2021-05-14;7597;8;154192;112
FR;4;2021-05-15;3586;9;157778;121
FR;4;2021-05-16;356;1;158134;122
FR;4;2021-05-17;4340;2;162474;124
FR;4;2021-05-18;8583;10;171057;134
FR;4;2021-05-19;5516;5;176573;139
FR;4;2021-05-20;9215;6;185788;145
FR;4;2021-05-21;12516;26;198304;171
FR;4;2021-05-22;4928;13;203232;184
FR;4;2021-05-23;424;2;203656;186
FR;4;2021-05-24;938;3;204594;189
FR;4;2021-05-25;7396;16;211990;205
FR;4;2021-05-26;7549;12;219539;217
FR;4;2021-05-27;14094;34;233633;251
FR;4;2021-05-28;26242;74;259875;325
FR;4;2021-05-29;11128;18;271003;343
FR;4;2021-05-30;858;2;271861;345
FR;4;2021-05-31;12428;19;284289;364
FR;4;2021-06-01;19804;42;304093;406
FR;4;2021-06-02;14199;34;318292;440
FR;4;2021-06-03;19124;24;337416;464
FR;4;2021-06-04;22074;45;359490;509
FR;4;2021-06-05;9427;28;368917;537
FR;4;2021-06-06;914;0;369831;537
FR;4;2021-06-07;8881;16;378712;553
FR;4;2021-06-08;14221;51;392933;604
FR;4;2021-06-09;11501;423;404434;1027
FR;4;2021-06-10;14926;28;419360;1055
FR;4;2021-06-11;16526;53;435886;1108
FR;4;2021-06-12;7144;26;443030;1134
FR;4;2021-06-13;806;8;443836;1142
FR;4;2021-06-14;6336;22;450172;1164
FR;4;2021-06-15;10463;32;460635;1196
FR;4;2021-06-16;8437;13;469072;1209
FR;4;2021-06-17;10233;26;479305;1235
FR;0;2020-12-27;20;0;20;0
FR;0;2020-12-28;71;0;91;0
FR;0;2020-12-29;108;0;199;0
FR;0;2020-12-30;123;0;322;0
FR;0;2020-12-31;88;0;410;0
FR;0;2021-01-01;73;0;483;0
FR;0;2021-01-02;88;0;571;0
FR;0;2021-01-03;92;0;663;0
FR;0;2021-01-04;1479;0;2142;0
FR;0;2021-01-05;5415;0;7557;0
FR;0;2021-01-06;11322;0;18879;0
FR;0;2021-01-07;28577;0;47456;0
FR;0;2021-01-08;36294;0;83750;0
FR;0;2021-01-09;10939;0;94689;0
FR;0;2021-01-10;5637;0;100326;0
FR;0;2021-01-11;39112;0;139438;0
FR;0;2021-01-12;60997;0;200435;0
FR;0;2021-01-13;63934;0;264369;0
FR;0;2021-01-14;79987;0;344356;0
FR;0;2021-01-15;67590;0;411946;0
FR;0;2021-01-16;19747;87;431693;87
FR;0;2021-01-17;10475;42;442168;129
FR;0;2021-01-18;84492;164;526660;293
FR;0;2021-01-19;128555;128;655215;421
FR;0;2021-01-20;135380;160;790595;581
FR;0;2021-01-21;155563;141;946158;722
FR;0;2021-01-22;118817;163;1064975;885
FR;0;2021-01-23;37861;52;1102836;937
FR;0;2021-01-24;9371;28;1112207;965
FR;0;2021-01-25;76921;1219;1189128;2184
FR;0;2021-01-26;98927;3113;1288055;5297
FR;0;2021-01-27;105734;5599;1393789;10896
FR;0;2021-01-28;122470;14361;1516259;25257
FR;0;2021-01-29;90953;17293;1607212;42550
FR;0;2021-01-30;28680;4225;1635892;46775
FR;0;2021-01-31;4872;1679;1640764;48454
FR;0;2021-02-01;51631;21128;1692395;69582
FR;0;2021-02-02;70759;34568;1763154;104150
FR;0;2021-02-03;71058;36961;1834212;141111
FR;0;2021-02-04;80691;50063;1914903;191174
FR;0;2021-02-05;67215;45343;1982118;236517
FR;0;2021-02-06;21349;10399;2003467;246916
FR;0;2021-02-07;4826;5041;2008293;251957
FR;0;2021-02-08;45946;45994;2054239;297951
FR;0;2021-02-09;64870;72408;2119109;370359
FR;0;2021-02-10;69352;76695;2188461;447054
FR;0;2021-02-11;85722;99144;2274183;546198
FR;0;2021-02-12;77837;74276;2352020;620474
FR;0;2021-02-13;21717;19492;2373737;639966
FR;0;2021-02-14;4596;7190;2378333;647156
FR;0;2021-02-15;37093;76507;2415426;723663
FR;0;2021-02-16;49237;100746;2464663;824409
FR;0;2021-02-17;49342;102972;2514005;927381
FR;0;2021-02-18;68078;118563;2582083;1045944
FR;0;2021-02-19;63868;90737;2645951;1136681
FR;0;2021-02-20;18014;28429;2663965;1165110
FR;0;2021-02-21;2860;6373;2666825;1171483
FR;0;2021-02-22;36559;73138;2703384;1244621
FR;0;2021-02-23;52700;84059;2756084;1328680
FR;0;2021-02-24;58164;81130;2814248;1409810
FR;0;2021-02-25;98816;91420;2913064;1501230
FR;0;2021-02-26;111844;71013;3024908;1572243
FR;0;2021-02-27;51232;21981;3076140;1594224
FR;0;2021-02-28;5680;4414;3081820;1598638
FR;0;2021-03-01;63710;52804;3145530;1651442
FR;0;2021-03-02;99454;66247;3244984;1717689
FR;0;2021-03-03;113860;65554;3358844;1783243
FR;0;2021-03-04;160705;68884;3519549;1852127
FR;0;2021-03-05;198215;63395;3717764;1915522
FR;0;2021-03-06;205457;17827;3923221;1933349
FR;0;2021-03-07;119927;5481;4043148;1938830
FR;0;2021-03-08;105038;50811;4148186;1989641
FR;0;2021-03-09;169978;56778;4318164;2046419
FR;0;2021-03-10;176009;57215;4494173;2103634
FR;0;2021-03-11;239817;63123;4733990;2166757
FR;0;2021-03-12;291435;53510;5025425;2220267
FR;0;2021-03-13;228915;15289;5254340;2235556
FR;0;2021-03-14;62300;3437;5316640;2238993
FR;0;2021-03-15;156184;32674;5472824;2271667
FR;0;2021-03-16;139485;39542;5612309;2311209
FR;0;2021-03-17;148261;38827;5760570;2350036
FR;0;2021-03-18;165354;44670;5925924;2394706
FR;0;2021-03-19;227139;37488;6153063;2432194
FR;0;2021-03-20;164889;11790;6317952;2443984
FR;0;2021-03-21;48768;2628;6366720;2446612
FR;0;2021-03-22;167400;34301;6534120;2480913
FR;0;2021-03-23;247222;42409;6781342;2523322
FR;0;2021-03-24;253756;43872;7035098;2567194
FR;0;2021-03-25;338306;44757;7373404;2611951
FR;0;2021-03-26;355298;41917;7728702;2653868
FR;0;2021-03-27;193267;16659;7921969;2670527
FR;0;2021-03-28;58373;3737;7980342;2674264
FR;0;2021-03-29;200624;54311;8180966;2728575
FR;0;2021-03-30;282273;69690;8463239;2798265
FR;0;2021-03-31;259838;72956;8723077;2871221
FR;0;2021-04-01;310488;87855;9033565;2959076
FR;0;2021-04-02;278034;92128;9311599;3051204
FR;0;2021-04-03;139253;61879;9450852;3113083
FR;0;2021-04-04;44894;18666;9495746;3131749
FR;0;2021-04-05;58803;11010;9554549;3142759
FR;0;2021-04-06;213650;107900;9768199;3250659
FR;0;2021-04-07;256517;115506;10024716;3366165
FR;0;2021-04-08;333119;121458;10357835;3487623
FR;0;2021-04-09;405367;116532;10763202;3604155
FR;0;2021-04-10;210165;82765;10973367;3686920
FR;0;2021-04-11;54900;34604;11028267;3721524
FR;0;2021-04-12;233988;115249;11262255;3836773
FR;0;2021-04-13;305456;145004;11567711;3981777
FR;0;2021-04-14;289859;139446;11857570;4121223
FR;0;2021-04-15;332021;147892;12189591;4269115
FR;0;2021-04-16;335371;145799;12524962;4414914
FR;0;2021-04-17;186372;90279;12711334;4505193
FR;0;2021-04-18;50448;35434;12761782;4540627
FR;0;2021-04-19;202854;138432;12964636;4679059
FR;0;2021-04-20;250954;170793;13215590;4849852
FR;0;2021-04-21;249470;168876;13465060;5018728
FR;0;2021-04-22;283538;188306;13748598;5207034
FR;0;2021-04-23;291158;183311;14039756;5390345
FR;0;2021-04-24;188182;111607;14227938;5501952
FR;0;2021-04-25;68405;38887;14296343;5540839
FR;0;2021-04-26;218060;156140;14514403;5696979
FR;0;2021-04-27;281135;187568;14795538;5884547
FR;0;2021-04-28;296099;183258;15091637;6067805
FR;0;2021-04-29;353170;196193;15444807;6263998
FR;0;2021-04-30;368260;184904;15813067;6448902
FR;0;2021-05-01;164063;52555;15977130;6501457
FR;0;2021-05-02;90181;37849;16067311;6539306
FR;0;2021-05-03;284200;169759;16351511;6709065
FR;0;2021-05-04;311137;224397;16662648;6933462
FR;0;2021-05-05;321019;224599;16983667;7158061
FR;0;2021-05-06;373825;239284;17357492;7397345
FR;0;2021-05-07;367326;257424;17724818;7654769
FR;0;2021-05-08;213622;66950;17938440;7721719
FR;0;2021-05-09;127953;46785;18066393;7768504
FR;0;2021-05-10;304727;229091;18371120;7997595
FR;0;2021-05-11;397087;258287;18768207;8255882
FR;0;2021-05-12;423916;233334;19192123;8489216
FR;0;2021-05-13;331775;56937;19523898;8546153
FR;0;2021-05-14;446257;167653;19970155;8713806
FR;0;2021-05-15;367668;94076;20337823;8807882
FR;0;2021-05-16;199552;20844;20537375;8828726
FR;0;2021-05-17;369320;149257;20906695;8977983
FR;0;2021-05-18;448417;153316;21355112;9131299
FR;0;2021-05-19;458810;145529;21813922;9276828
FR;0;2021-05-20;497221;160551;22311143;9437379
FR;0;2021-05-21;480195;174790;22791338;9612169
FR;0;2021-05-22;341892;80032;23133230;9692201
FR;0;2021-05-23;158970;14500;23292200;9706701
FR;0;2021-05-24;257292;33350;23549492;9740051
FR;0;2021-05-25;391561;189532;23941053;9929583
FR;0;2021-05-26;401582;188407;24342635;10117990
FR;0;2021-05-27;441382;219012;24784017;10337002
FR;0;2021-05-28;421685;259914;25205702;10596916
FR;0;2021-05-29;294516;149586;25500218;10746502
FR;0;2021-05-30;104783;32675;25605001;10779177
FR;0;2021-05-31;351657;203753;25956658;10982930
FR;0;2021-06-01;413077;251917;26369735;11234847
FR;0;2021-06-02;400554;231214;26770289;11466061
FR;0;2021-06-03;450823;258962;27221112;11725023
FR;0;2021-06-04;441716;305106;27662828;12030129
FR;0;2021-06-05;298138;189215;27960966;12219344
FR;0;2021-06-06;129037;49178;28090003;12268522
FR;0;2021-06-07;327780;262693;28417783;12531215
FR;0;2021-06-08;386523;295505;28804306;12826720
FR;0;2021-06-09;368543;281127;29172849;13107847
FR;0;2021-06-10;384899;289745;29557748;13397592
FR;0;2021-06-11;373950;357820;29931698;13755412
FR;0;2021-06-12;275447;211676;30207145;13967088
FR;0;2021-06-13;101368;74155;30308513;14041243
FR;0;2021-06-14;229112;356230;30537625;14397473
FR;0;2021-06-15;293408;386393;30831033;14783866
FR;0;2021-06-16;301658;358131;31132691;15141997
FR;0;2021-06-17;304011;372493;31436702;15514490
