fra;vaccin;jour;n_dose1;n_dose2;n_dose3;n_dose4;n_complet;n_rappel;n_2_rappel;n_rappel_biv;n_3_rappel;n_cum_dose1;n_cum_dose2;n_cum_dose3;n_cum_dose4;n_cum_complet;n_cum_rappel;n_cum_2_rappel;n_cum_rappel_biv;n_cum_3_rappel
FR;1;2020-12-27;616;0;0;0;55;0;0;0;0;616;0;0;0;55;0;0;0;0
FR;1;2020-12-28;710;1;0;0;44;0;0;0;0;1326;1;0;0;99;0;0;0;0
FR;1;2020-12-29;390;0;0;0;19;0;0;0;0;1716;1;0;0;118;0;0;0;0
FR;1;2020-12-30;456;0;0;0;20;0;0;0;0;2172;1;0;0;138;0;0;0;0
FR;1;2020-12-31;451;1;0;0;21;0;0;0;0;2623;2;0;0;159;0;0;0;0
FR;1;2021-01-01;1199;2;0;0;66;0;0;0;0;3822;4;0;0;225;0;0;0;0
FR;1;2021-01-02;370;4;0;0;29;0;0;0;0;4192;8;0;0;254;0;0;0;0
FR;1;2021-01-03;419;0;0;0;23;0;0;0;0;4611;8;0;0;277;0;0;0;0
FR;1;2021-01-04;2152;5;0;0;51;0;0;0;0;6763;13;0;0;328;0;0;0;0
FR;1;2021-01-05;7794;6;0;0;128;0;0;0;0;14557;19;0;0;456;0;0;0;0
FR;1;2021-01-06;12491;23;0;0;128;0;0;0;0;27048;42;0;0;584;0;0;0;0
FR;1;2021-01-07;29481;25;0;0;160;0;0;0;0;56529;67;0;0;744;0;0;0;0
FR;1;2021-01-08;37170;36;0;0;205;0;0;0;0;93699;103;0;0;949;0;0;0;0
FR;1;2021-01-09;11221;9;0;0;77;0;0;0;0;104920;112;0;0;1026;0;0;0;0
FR;1;2021-01-10;6017;8;0;0;28;0;0;0;0;110937;120;0;0;1054;0;0;0;0
FR;1;2021-01-11;39956;39;0;0;232;0;0;0;0;150893;159;0;0;1286;0;0;0;0
FR;1;2021-01-12;62166;31;0;0;296;0;0;0;0;213059;190;0;0;1582;0;0;0;0
FR;1;2021-01-13;65150;63;0;0;432;0;0;0;0;278209;253;0;0;2014;0;0;0;0
FR;1;2021-01-14;81473;263;0;0;953;0;0;0;0;359682;516;0;0;2967;0;0;0;0
FR;1;2021-01-15;68642;103;1;0;527;0;0;0;0;428324;619;1;0;3494;0;0;0;0
FR;1;2021-01-16;19903;73;0;0;171;0;0;0;0;448227;692;1;0;3665;0;0;0;0
FR;1;2021-01-17;10909;54;0;0;130;0;0;0;0;459136;746;1;0;3795;0;0;0;0
FR;1;2021-01-18;82849;176;0;0;587;0;0;0;0;541985;922;1;0;4382;0;0;0;0
FR;1;2021-01-19;125935;209;0;0;829;0;0;0;0;667920;1131;1;0;5211;0;0;0;0
FR;1;2021-01-20;132440;191;0;0;778;0;0;0;0;800360;1322;1;0;5989;0;0;0;0
FR;1;2021-01-21;153089;196;0;0;892;0;0;0;0;953449;1518;1;0;6881;0;0;0;0
FR;1;2021-01-22;115972;240;0;0;776;0;0;0;0;1069421;1758;1;0;7657;0;0;0;0
FR;1;2021-01-23;36619;84;0;0;207;0;0;0;0;1106040;1842;1;0;7864;0;0;0;0
FR;1;2021-01-24;9589;129;0;0;188;0;0;0;0;1115629;1971;1;0;8052;0;0;0;0
FR;1;2021-01-25;74443;1454;0;0;1771;0;0;0;0;1190072;3425;1;0;9823;0;0;0;0
FR;1;2021-01-26;96471;3707;1;0;4147;0;0;0;0;1286543;7132;2;0;13970;0;0;0;0
FR;1;2021-01-27;103660;6443;0;0;7125;0;0;0;0;1390203;13575;2;0;21095;0;0;0;0
FR;1;2021-01-28;120627;16419;0;0;17206;0;0;0;0;1510830;29994;2;0;38301;0;0;0;0
FR;1;2021-01-29;88911;18803;0;0;19344;0;0;0;0;1599741;48797;2;0;57645;0;0;0;0
FR;1;2021-01-30;27995;4538;0;0;4662;0;0;0;0;1627736;53335;2;0;62307;0;0;0;0
FR;1;2021-01-31;5194;1898;0;0;1936;0;0;0;0;1632930;55233;2;0;64243;0;0;0;0
FR;1;2021-02-01;49752;23074;0;0;23317;0;0;0;0;1682682;78307;2;0;87560;0;0;0;0
FR;1;2021-02-02;67841;38208;0;0;38667;0;0;0;0;1750523;116515;2;0;126227;0;0;0;0
FR;1;2021-02-03;67106;40309;0;0;40744;0;0;0;0;1817629;156824;2;0;166971;0;0;0;0
FR;1;2021-02-04;77159;55161;0;0;55731;0;0;0;0;1894788;211985;2;0;222702;0;0;0;0
FR;1;2021-02-05;63435;48245;0;0;48650;0;0;0;0;1958223;260230;2;0;271352;0;0;0;0
FR;1;2021-02-06;19428;11419;0;0;11526;0;0;0;0;1977651;271649;2;0;282878;0;0;0;0
FR;1;2021-02-07;3669;6080;0;0;6107;0;0;0;0;1981320;277729;2;0;288985;0;0;0;0
FR;1;2021-02-08;36508;48802;0;0;49056;0;0;0;0;2017828;326531;2;0;338041;0;0;0;0
FR;1;2021-02-09;50830;78482;0;0;79009;0;0;0;0;2068658;405013;2;0;417050;0;0;0;0
FR;1;2021-02-10;52088;83509;0;0;83993;0;0;0;0;2120746;488522;2;0;501043;0;0;0;0
FR;1;2021-02-11;63397;105650;0;0;106561;0;0;0;0;2184143;594172;2;0;607604;0;0;0;0
FR;1;2021-02-12;55889;75828;0;0;76514;0;0;0;0;2240032;670000;2;0;684118;0;0;0;0
FR;1;2021-02-13;15470;19307;0;0;19419;0;0;0;0;2255502;689307;2;0;703537;0;0;0;0
FR;1;2021-02-14;3747;7313;0;0;7379;0;0;0;0;2259249;696620;2;0;710916;0;0;0;0
FR;1;2021-02-15;24175;73669;0;0;73930;0;0;0;0;2283424;770289;2;0;784846;0;0;0;0
FR;1;2021-02-16;32788;95507;0;0;95922;0;0;0;0;2316212;865796;2;0;880768;0;0;0;0
FR;1;2021-02-17;35143;102397;20;0;103056;0;0;0;0;2351355;968193;22;0;983824;0;0;0;0
FR;1;2021-02-18;49465;118617;0;0;119614;0;0;0;0;2400820;1086810;22;0;1103438;0;0;0;0
FR;1;2021-02-19;45400;87845;1;0;88790;0;0;0;0;2446220;1174655;23;0;1192228;0;0;0;0
FR;1;2021-02-20;13398;27023;0;0;27199;0;0;0;0;2459618;1201678;23;0;1219427;0;0;0;0
FR;1;2021-02-21;2471;5942;0;0;6010;0;0;0;0;2462089;1207620;23;0;1225437;0;0;0;0
FR;1;2021-02-22;24726;69372;2;0;69674;0;0;0;0;2486815;1276992;25;0;1295111;0;0;0;0
FR;1;2021-02-23;37441;81581;1;0;82286;0;0;0;0;2524256;1358573;26;0;1377397;0;0;0;0
FR;1;2021-02-24;40717;79399;1;0;80100;0;0;0;0;2564973;1437972;27;0;1457497;0;0;0;0
FR;1;2021-02-25;50178;87699;1;0;88798;0;0;0;0;2615151;1525671;28;0;1546295;0;0;0;0
FR;1;2021-02-26;47235;67559;1;0;68449;0;0;0;0;2662386;1593230;29;0;1614744;0;0;0;0
FR;1;2021-02-27;15691;21359;1;0;21572;0;0;0;0;2678077;1614589;30;0;1636316;0;0;0;0
FR;1;2021-02-28;3566;4087;2;0;4160;0;0;0;0;2681643;1618676;32;0;1640476;0;0;0;0
FR;1;2021-03-01;40232;50292;1;0;51031;0;0;0;0;2721875;1668968;33;0;1691507;0;0;0;0
FR;1;2021-03-02;55997;62429;3;0;63610;0;0;0;0;2777872;1731397;36;0;1755117;0;0;0;0
FR;1;2021-03-03;61273;60511;0;0;61953;0;0;0;0;2839145;1791908;36;0;1817070;0;0;0;0
FR;1;2021-03-04;73023;68414;3;0;70633;0;0;0;0;2912168;1860322;39;0;1887703;0;0;0;0
FR;1;2021-03-05;74787;58605;3;0;60506;0;0;0;0;2986955;1918927;42;0;1948209;0;0;0;0
FR;1;2021-03-06;82477;15730;2;0;17439;0;0;0;0;3069432;1934657;44;0;1965648;0;0;0;0
FR;1;2021-03-07;63734;3908;1;0;5453;0;0;0;0;3133166;1938565;45;0;1971101;0;0;0;0
FR;1;2021-03-08;60200;41121;2;0;42409;0;0;0;0;3193366;1979686;47;0;2013510;0;0;0;0
FR;1;2021-03-09;86016;47365;1;0;49370;0;0;0;0;3279382;2027051;48;0;2062880;0;0;0;0
FR;1;2021-03-10;90951;47748;5;0;50021;0;0;0;0;3370333;2074799;53;0;2112901;0;0;0;0
FR;1;2021-03-11;105108;54613;1;0;57689;0;0;0;0;3475441;2129412;54;0;2170590;0;0;0;0
FR;1;2021-03-12;104169;44870;1;0;47868;0;0;0;0;3579610;2174282;55;0;2218458;0;0;0;0
FR;1;2021-03-13;89226;12579;1;0;14797;0;0;0;0;3668836;2186861;56;0;2233255;0;0;0;0
FR;1;2021-03-14;44463;2646;1;0;3979;0;0;0;0;3713299;2189507;57;0;2237234;0;0;0;0
FR;1;2021-03-15;95539;27925;3;0;30278;0;0;0;0;3808838;2217432;60;0;2267512;0;0;0;0
FR;1;2021-03-16;123608;34030;5;0;37579;0;0;0;0;3932446;2251462;65;0;2305091;0;0;0;0
FR;1;2021-03-17;129327;33524;4;0;37580;0;0;0;0;4061773;2284986;69;0;2342671;0;0;0;0
FR;1;2021-03-18;142921;39151;5;0;43829;0;0;0;0;4204694;2324137;74;0;2386500;0;0;0;0
FR;1;2021-03-19;136282;32009;2;0;36602;0;0;0;0;4340976;2356146;76;0;2423102;0;0;0;0
FR;1;2021-03-20;76028;9745;1;0;11962;0;0;0;0;4417004;2365891;77;0;2435064;0;0;0;0
FR;1;2021-03-21;26523;1967;1;0;2957;0;0;0;0;4443527;2367858;78;0;2438021;0;0;0;0
FR;1;2021-03-22;114783;30209;2;0;34043;0;0;0;0;4558310;2398067;80;0;2472064;0;0;0;0
FR;1;2021-03-23;143065;37988;1;0;42780;0;0;0;0;4701375;2436055;81;0;2514844;0;0;0;0
FR;1;2021-03-24;142031;38396;0;0;43270;0;0;0;0;4843406;2474451;81;0;2558114;0;0;0;0
FR;1;2021-03-25;165047;39885;4;0;46046;0;0;0;0;5008453;2514336;85;0;2604160;0;0;0;0
FR;1;2021-03-26;166427;37396;5;1;44017;0;0;0;0;5174880;2551732;90;1;2648177;0;0;0;0
FR;1;2021-03-27;110909;15484;1;0;19495;0;0;0;0;5285789;2567216;91;1;2667672;0;0;0;0
FR;1;2021-03-28;42317;4432;3;0;5987;0;0;0;0;5328106;2571648;94;1;2673659;0;0;0;0
FR;1;2021-03-29;129853;48957;4;0;53625;0;0;0;0;5457959;2620605;98;1;2727284;0;0;0;0
FR;1;2021-03-30;167768;63833;5;0;70847;0;0;0;0;5625727;2684438;103;1;2798131;0;0;0;0
FR;1;2021-03-31;170974;68021;4;0;75546;0;0;0;0;5796701;2752459;107;1;2873677;0;0;0;0
FR;1;2021-04-01;194890;84135;10;0;93647;0;0;0;0;5991591;2836594;117;1;2967324;0;0;0;0
FR;1;2021-04-02;164477;86896;7;0;94720;0;0;0;0;6156068;2923490;124;1;3062044;0;0;0;0
FR;1;2021-04-03;88262;58225;6;0;61775;0;0;0;0;6244330;2981715;130;1;3123819;0;0;0;0
FR;1;2021-04-04;33666;17734;0;0;19236;0;0;0;0;6277996;2999449;130;1;3143055;0;0;0;0
FR;1;2021-04-05;46433;9565;11;0;11442;0;0;0;0;6324429;3009014;141;1;3154497;0;0;0;0
FR;1;2021-04-06;160354;105690;17;0;112183;0;0;0;0;6484783;3114704;158;1;3266680;0;0;0;0
FR;1;2021-04-07;197044;108112;16;0;116953;0;0;0;0;6681827;3222816;174;1;3383633;0;0;0;0
FR;1;2021-04-08;222196;114366;14;0;125729;0;0;0;0;6904023;3337182;188;1;3509362;0;0;0;0
FR;1;2021-04-09;214625;108037;22;0;118939;0;0;0;0;7118648;3445219;210;1;3628301;0;0;0;0
FR;1;2021-04-10;117212;73243;14;0;78393;0;0;0;0;7235860;3518462;224;1;3706694;0;0;0;0
FR;1;2021-04-11;40903;29892;6;0;31796;0;0;0;0;7276763;3548354;230;1;3738490;0;0;0;0
FR;1;2021-04-12;168509;104584;46;0;111836;0;0;0;0;7445272;3652938;276;1;3850326;0;0;0;0
FR;1;2021-04-13;203857;127752;97;1;137100;0;0;0;0;7649129;3780690;373;2;3987426;0;0;0;0
FR;1;2021-04-14;208691;123044;208;0;133276;0;0;0;0;7857820;3903734;581;2;4120702;0;0;0;0
FR;1;2021-04-15;221751;128259;313;0;139310;0;0;0;0;8079571;4031993;894;2;4260012;0;0;0;0
FR;1;2021-04-16;206110;125774;309;0;135445;0;0;0;0;8285681;4157767;1203;2;4395457;0;0;0;0
FR;1;2021-04-17;122112;67118;103;0;72181;0;0;0;0;8407793;4224885;1306;2;4467638;0;0;0;0
FR;1;2021-04-18;35982;21014;42;0;22722;0;0;0;0;8443775;4245899;1348;2;4490360;0;0;0;0
FR;1;2021-04-19;163785;121622;433;0;129173;0;0;0;0;8607560;4367521;1781;2;4619533;0;0;0;0
FR;1;2021-04-20;189492;149806;531;0;158935;0;0;0;0;8797052;4517327;2312;2;4778468;0;0;0;0
FR;1;2021-04-21;194065;147793;761;0;157322;0;0;0;0;8991117;4665120;3073;2;4935790;0;0;0;0
FR;1;2021-04-22;209088;164635;779;0;175866;0;0;0;0;9200205;4829755;3852;2;5111656;0;0;0;0
FR;1;2021-04-23;198999;158152;671;0;169177;0;0;0;0;9399204;4987907;4523;2;5280833;0;0;0;0
FR;1;2021-04-24;126355;95888;148;0;101958;0;0;0;0;9525559;5083795;4671;2;5382791;0;0;0;0
FR;1;2021-04-25;53644;30079;46;0;32836;0;0;0;0;9579203;5113874;4717;2;5415627;0;0;0;0
FR;1;2021-04-26;181174;140326;543;0;149045;0;0;0;0;9760377;5254200;5260;2;5564672;0;0;0;0
FR;1;2021-04-27;221406;162633;901;0;174008;0;0;0;0;9981783;5416833;6161;2;5738680;0;0;0;0
FR;1;2021-04-28;238374;156222;1314;1;168906;1;0;0;0;10220157;5573055;7475;3;5907586;1;0;0;0
FR;1;2021-04-29;270354;161702;1211;0;177307;0;0;0;0;10490511;5734757;8686;3;6084893;1;0;0;0
FR;1;2021-04-30;272030;149050;1074;0;165149;0;0;0;0;10762541;5883807;9760;3;6250042;1;0;0;0
FR;1;2021-05-01;141180;40613;173;0;48641;0;0;0;0;10903721;5924420;9933;3;6298683;1;0;0;0
FR;1;2021-05-02;81564;28243;81;0;32999;0;0;0;0;10985285;5952663;10014;3;6331682;1;0;0;0
FR;1;2021-05-03;250829;142024;803;0;155718;0;0;0;0;11236114;6094687;10817;3;6487400;1;0;0;0
FR;1;2021-05-04;265939;188059;1204;0;203630;0;0;0;0;11502053;6282746;12021;3;6691030;1;0;0;0
FR;1;2021-05-05;283977;186328;1268;0;202990;0;0;0;0;11786030;6469074;13289;3;6894020;1;0;0;0
FR;1;2021-05-06;310085;184613;1502;0;204362;0;0;0;0;12096115;6653687;14791;3;7098382;1;0;0;0
FR;1;2021-05-07;284152;196769;1128;0;214585;0;0;0;0;12380267;6850456;15919;3;7312967;1;0;0;0
FR;1;2021-05-08;191687;51633;285;0;63016;0;0;0;0;12571954;6902089;16204;3;7375983;1;0;0;0
FR;1;2021-05-09;114076;34206;236;0;41378;0;0;0;0;12686030;6936295;16440;3;7417361;1;0;0;0
FR;1;2021-05-10;258240;195102;1188;0;211095;0;0;0;0;12944270;7131397;17628;3;7628456;1;0;0;0
FR;1;2021-05-11;318947;211268;1465;0;231505;0;0;0;0;13263217;7342665;19093;3;7859961;1;0;0;0
FR;1;2021-05-12;356715;186094;1402;0;208399;0;0;0;0;13619932;7528759;20495;3;8068360;1;0;0;0
FR;1;2021-05-13;283474;47322;401;0;64245;0;0;0;0;13903406;7576081;20896;3;8132605;1;0;0;0
FR;1;2021-05-14;370544;128528;998;0;151949;0;0;0;0;14273950;7704609;21894;3;8284554;1;0;0;0
FR;1;2021-05-15;298131;66210;404;0;84916;0;0;0;0;14572081;7770819;22298;3;8369470;1;0;0;0
FR;1;2021-05-16;157797;15472;158;0;26040;0;0;0;0;14729878;7786291;22456;3;8395510;1;0;0;0
FR;1;2021-05-17;318963;116202;1441;0;138165;0;0;0;0;15048841;7902493;23897;3;8533675;1;0;0;0
FR;1;2021-05-18;383396;111699;1801;0;137647;0;0;0;0;15432237;8014192;25698;3;8671322;1;0;0;0
FR;1;2021-05-19;395327;101588;2185;0;128523;0;0;0;0;15827564;8115780;27883;3;8799845;1;0;0;0
FR;1;2021-05-20;421862;95607;2049;0;125066;0;0;0;0;16249426;8211387;29932;3;8924911;1;0;0;0
FR;1;2021-05-21;399844;97449;1765;0;125845;0;0;0;0;16649270;8308836;31697;3;9050756;1;0;0;0
FR;1;2021-05-22;275713;41925;604;0;60948;0;0;0;0;16924983;8350761;32301;3;9111704;1;0;0;0
FR;1;2021-05-23;123034;10969;224;0;20572;0;0;0;0;17048017;8361730;32525;3;9132276;1;0;0;0
FR;1;2021-05-24;244028;26267;569;0;43792;0;0;0;0;17292045;8387997;33094;3;9176068;1;0;0;0
FR;1;2021-05-25;366248;131455;2115;1;158388;0;0;0;0;17658293;8519452;35209;4;9334456;1;0;0;0
FR;1;2021-05-26;380865;127560;1996;0;155882;0;0;0;0;18039158;8647012;37205;4;9490338;1;0;0;0
FR;1;2021-05-27;406209;128354;1978;0;158830;0;0;0;0;18445367;8775366;39183;4;9649168;1;0;0;0
FR;1;2021-05-28;366081;145689;1702;0;174251;0;0;0;0;18811448;8921055;40885;4;9823419;1;0;0;0
FR;1;2021-05-29;253850;81137;527;0;100334;0;0;0;0;19065298;9002192;41412;4;9923753;1;0;0;0
FR;1;2021-05-30;100983;22600;158;0;30833;0;0;0;0;19166281;9024792;41570;4;9954586;1;0;0;0
FR;1;2021-05-31;314351;149251;1287;1;172508;1;0;0;0;19480632;9174043;42857;5;10127094;2;0;0;0
FR;1;2021-06-01;361723;166425;1733;1;194129;1;0;0;0;19842355;9340468;44590;6;10321223;3;0;0;0
FR;1;2021-06-02;365452;154530;1798;0;184072;0;0;0;0;20207807;9494998;46388;6;10505295;3;0;0;0
FR;1;2021-06-03;391508;147426;1654;0;178397;0;0;0;0;20599315;9642424;48042;6;10683692;3;0;0;0
FR;1;2021-06-04;364149;175903;1496;1;205195;1;0;0;0;20963464;9818327;49538;7;10888887;4;0;0;0
FR;1;2021-06-05;258534;112823;597;0;133184;0;0;0;0;21221998;9931150;50135;7;11022071;4;0;0;0
FR;1;2021-06-06;126834;37555;216;0;48192;0;0;0;0;21348832;9968705;50351;7;11070263;4;0;0;0
FR;1;2021-06-07;301134;207764;1368;0;233039;0;0;0;0;21649966;10176469;51719;7;11303302;4;0;0;0
FR;1;2021-06-08;330916;221016;1645;0;248975;0;0;0;0;21980882;10397485;53364;7;11552277;4;0;0;0
FR;1;2021-06-09;336665;210940;1614;0;239697;0;0;0;0;22317547;10608425;54978;7;11791974;4;0;0;0
FR;1;2021-06-10;343951;199493;1616;0;229238;0;0;0;0;22661498;10807918;56594;7;12021212;4;0;0;0
FR;1;2021-06-11;311947;234704;1300;1;262615;0;0;0;0;22973445;11042622;57894;8;12283827;4;0;0;0
FR;1;2021-06-12;244101;150609;438;0;172217;0;0;0;0;23217546;11193231;58332;8;12456044;4;0;0;0
FR;1;2021-06-13;100383;61036;188;0;70698;0;0;0;0;23317929;11254267;58520;8;12526742;4;0;0;0
FR;1;2021-06-14;207887;287565;1320;1;307378;0;0;0;0;23525816;11541832;59840;9;12834120;4;0;0;0
FR;1;2021-06-15;256917;281122;1400;1;304972;0;0;0;0;23782733;11822954;61240;10;13139092;4;0;0;0
FR;1;2021-06-16;273687;270716;1264;1;296156;0;0;0;0;24056420;12093670;62504;11;13435248;4;0;0;0
FR;1;2021-06-17;268262;245101;1241;1;271172;0;0;0;0;24324682;12338771;63745;12;13706420;4;0;0;0
FR;1;2021-06-18;260626;295192;1156;2;321018;0;0;0;0;24585308;12633963;64901;14;14027438;4;0;0;0
FR;1;2021-06-19;193469;209605;388;0;228266;0;0;0;0;24778777;12843568;65289;14;14255704;4;0;0;0
FR;1;2021-06-20;69724;89030;122;0;96868;0;0;0;0;24848501;12932598;65411;14;14352572;4;0;0;0
FR;1;2021-06-21;172401;319784;934;1;338494;1;0;0;0;25020902;13252382;66345;15;14691066;5;0;0;0
FR;1;2021-06-22;185902;348094;1102;10;369163;1;0;0;0;25206804;13600476;67447;25;15060229;6;0;0;0
FR;1;2021-06-23;204245;339667;1050;0;363567;0;0;0;0;25411049;13940143;68497;25;15423796;6;0;0;0
FR;1;2021-06-24;203557;282114;1176;0;306861;0;0;0;0;25614606;14222257;69673;25;15730657;6;0;0;0
FR;1;2021-06-25;182687;371701;1200;0;395709;0;0;0;0;25797293;14593958;70873;25;16126366;6;0;0;0
FR;1;2021-06-26;131415;278613;506;0;295988;0;0;0;0;25928708;14872571;71379;25;16422354;6;0;0;0
FR;1;2021-06-27;52422;122845;146;0;130382;0;0;0;0;25981130;14995416;71525;25;16552736;6;0;0;0
FR;1;2021-06-28;136682;368246;1066;0;386846;0;0;0;0;26117812;15363662;72591;25;16939582;6;0;0;0
FR;1;2021-06-29;154930;391186;1849;0;412278;0;0;0;0;26272742;15754848;74440;25;17351860;6;0;0;0
FR;1;2021-06-30;180077;381972;1668;4;406568;1;0;0;0;26452819;16136820;76108;29;17758428;7;0;0;0
FR;1;2021-07-01;201593;332533;1890;5;360600;0;0;0;0;26654412;16469353;77998;34;18119028;7;0;0;0
FR;1;2021-07-02;193888;367288;1765;5;395482;2;0;0;0;26848300;16836641;79763;39;18514510;9;0;0;0
FR;1;2021-07-03;124487;280407;704;3;299511;1;0;0;0;26972787;17117048;80467;42;18814021;10;0;0;0
FR;1;2021-07-04;53970;113731;244;0;122136;0;0;0;0;27026757;17230779;80711;42;18936157;10;0;0;0
FR;1;2021-07-05;153987;355760;1500;8;379098;0;0;0;0;27180744;17586539;82211;50;19315255;10;0;0;0
FR;1;2021-07-06;173534;382283;1603;45;408170;8;0;0;0;27354278;17968822;83814;95;19723425;18;0;0;0
FR;1;2021-07-07;190875;362301;1659;25;390644;2;0;0;0;27545153;18331123;85473;120;20114069;20;0;0;0
FR;1;2021-07-08;201595;322963;1827;20;353607;2;0;0;0;27746748;18654086;87300;140;20467676;22;0;0;0
FR;1;2021-07-09;189996;387758;1854;3;418155;1;0;0;0;27936744;19041844;89154;143;20885831;23;0;0;0
FR;1;2021-07-10;129968;281186;818;1;302613;0;0;0;0;28066712;19323030;89972;144;21188444;23;0;0;0
FR;1;2021-07-11;57688;102527;263;0;112404;0;0;0;0;28124400;19425557;90235;144;21300848;23;0;0;0
FR;1;2021-07-12;149932;416804;1588;4;442790;0;0;0;0;28274332;19842361;91823;148;21743638;23;0;0;0
FR;1;2021-07-13;234313;438999;1808;8;476175;0;0;0;0;28508645;20281360;93631;156;22219813;23;0;0;0
FR;1;2021-07-14;171932;151300;418;0;176927;0;0;0;0;28680577;20432660;94049;156;22396740;23;0;0;0
FR;1;2021-07-15;279707;424128;1859;1;467097;0;0;0;0;28960284;20856788;95908;157;22863837;23;0;0;0
FR;1;2021-07-16;290447;400506;1711;3;445141;1;0;0;0;29250731;21257294;97619;160;23308978;24;0;0;0
FR;1;2021-07-17;217362;281968;755;1;315428;0;0;0;0;29468093;21539262;98374;161;23624406;24;0;0;0
FR;1;2021-07-18;102032;107205;288;0;123090;0;0;0;0;29570125;21646467;98662;161;23747496;24;0;0;0
FR;1;2021-07-19;238250;378359;1498;3;414395;0;0;0;0;29808375;22024826;100160;164;24161891;24;0;0;0
FR;1;2021-07-20;305779;379721;1471;0;425540;0;0;0;0;30114154;22404547;101631;164;24587431;24;0;0;0
FR;1;2021-07-21;333316;352691;1413;4;404055;1;0;0;0;30447470;22757238;103044;168;24991486;25;0;0;0
FR;1;2021-07-22;364711;318525;1502;3;374928;1;0;0;0;30812181;23075763;104546;171;25366414;26;0;0;0
FR;1;2021-07-23;349412;342714;1589;4;398250;1;0;0;0;31161593;23418477;106135;175;25764664;27;0;0;0
FR;1;2021-07-24;238968;240735;697;1;278063;0;0;0;0;31400561;23659212;106832;176;26042727;27;0;0;0
FR;1;2021-07-25;112813;76013;223;0;93706;0;0;0;0;31513374;23735225;107055;176;26136433;27;0;0;0
FR;1;2021-07-26;299152;289259;1495;2;334966;1;0;0;0;31812526;24024484;108550;178;26471399;28;0;0;0
FR;1;2021-07-27;385873;267855;1460;4;324819;1;0;0;0;32198399;24292339;110010;182;26796218;29;0;0;0
FR;1;2021-07-28;390231;250917;1463;4;307201;1;0;0;0;32588630;24543256;111473;186;27103419;30;0;0;0
FR;1;2021-07-29;406163;227574;1541;2;284259;0;0;0;0;32994793;24770830;113014;188;27387678;30;0;0;0
FR;1;2021-07-30;370762;246472;1639;4;298299;1;0;0;0;33365555;25017302;114653;192;27685977;31;0;0;0
FR;1;2021-07-31;243396;165089;794;1;199408;0;0;0;0;33608951;25182391;115447;193;27885385;31;0;0;0
FR;1;2021-08-01;105617;47203;237;0;61196;0;0;0;0;33714568;25229594;115684;193;27946581;31;0;0;0
FR;1;2021-08-02;297440;212826;1480;2;250603;0;0;0;0;34012008;25442420;117164;195;28197184;31;0;0;0
FR;1;2021-08-03;331357;208665;1557;2;250627;1;0;0;0;34343365;25651085;118721;197;28447811;32;0;0;0
FR;1;2021-08-04;328059;183821;1440;5;223967;3;0;0;0;34671424;25834906;120161;202;28671778;35;0;0;0
FR;1;2021-08-05;301302;193081;1483;0;229374;0;0;0;0;34972726;26027987;121644;202;28901152;35;0;0;0
FR;1;2021-08-06;291006;224079;1560;3;261358;0;0;0;0;35263732;26252066;123204;205;29162510;35;0;0;0
FR;1;2021-08-07;182687;158757;655;5;181660;1;0;0;0;35446419;26410823;123859;210;29344170;36;0;0;0
FR;1;2021-08-08;68897;59099;253;0;67626;0;0;0;0;35515316;26469922;124112;210;29411796;36;0;0;0
FR;1;2021-08-09;222802;235136;1446;4;263837;2;0;0;0;35738118;26705058;125558;214;29675633;38;0;0;0
FR;1;2021-08-10;252764;239816;1492;2;271643;0;0;0;0;35990882;26944874;127050;216;29947276;38;0;0;0
FR;1;2021-08-11;236257;231717;1272;5;261225;0;0;0;0;36227139;27176591;128322;221;30208501;38;0;0;0
FR;1;2021-08-12;220806;239711;1492;3;267798;0;0;0;0;36447945;27416302;129814;224;30476299;38;0;0;0
FR;1;2021-08-13;201733;238482;1361;2;264017;2;0;0;0;36649678;27654784;131175;226;30740316;40;0;0;0
FR;1;2021-08-14;122877;174034;645;0;189536;0;0;0;0;36772555;27828818;131820;226;30929852;40;0;0;0
FR;1;2021-08-15;34711;46113;201;1;50330;0;0;0;0;36807266;27874931;132021;227;30980182;40;0;0;0
FR;1;2021-08-16;156967;289318;1424;0;309886;0;0;0;0;36964233;28164249;133445;227;31290068;40;0;0;0
FR;1;2021-08-17;171626;290947;1422;5;313346;0;0;0;0;37135859;28455196;134867;232;31603414;40;0;0;0
FR;1;2021-08-18;161452;286670;1394;6;307295;3;0;0;0;37297311;28741866;136261;238;31910709;43;0;0;0
FR;1;2021-08-19;148963;277410;1405;1;297248;0;0;0;0;37446274;29019276;137666;239;32207957;43;0;0;0
FR;1;2021-08-20;140535;308904;1535;2;328133;2;0;0;0;37586809;29328180;139201;241;32536090;45;0;0;0
FR;1;2021-08-21;84289;213210;589;0;224528;0;0;0;0;37671098;29541390;139790;241;32760618;45;0;0;0
FR;1;2021-08-22;28585;82695;233;0;86699;0;0;0;0;37699683;29624085;140023;241;32847317;45;0;0;0
FR;1;2021-08-23;118674;320943;1422;2;337672;0;0;0;0;37818357;29945028;141445;243;33184989;45;0;0;0
FR;1;2021-08-24;126689;319596;1604;5;337408;0;0;0;0;37945046;30264624;143049;248;33522397;45;0;0;0
FR;1;2021-08-25;121548;306406;1783;8;323577;2;0;0;0;38066594;30571030;144832;256;33845974;47;0;0;0
FR;1;2021-08-26;106649;286081;2165;10;302376;0;0;0;0;38173243;30857111;146997;266;34148350;47;0;0;0
FR;1;2021-08-27;107659;321584;2303;9;338836;1;0;0;0;38280902;31178695;149300;275;34487186;48;0;0;0
FR;1;2021-08-28;71030;220701;1102;0;231221;0;0;0;0;38351932;31399396;150402;275;34718407;48;0;0;0
FR;1;2021-08-29;24156;78209;469;1;82099;0;0;0;0;38376088;31477605;150871;276;34800506;48;0;0;0
FR;1;2021-08-30;96904;286250;4315;6;299752;4950;0;0;0;38472992;31763855;155186;282;35100258;4998;0;0;0
FR;1;2021-08-31;98137;276226;9295;15;289898;10058;2;0;0;38571129;32040081;164481;297;35390156;15056;2;0;0
FR;1;2021-09-01;112367;245283;21122;8;257666;22156;1;0;0;38683496;32285364;185603;305;35647822;37212;3;0;0
FR;1;2021-09-02;86760;197906;24536;18;208301;25517;0;0;0;38770256;32483270;210139;323;35856123;62729;3;0;0
FR;1;2021-09-03;82435;227476;26958;21;238914;28038;0;0;0;38852691;32710746;237097;344;36095037;90767;3;0;0
FR;1;2021-09-04;71632;189720;11141;11;199297;11712;7;0;0;38924323;32900466;248238;355;36294334;102479;10;0;0
FR;1;2021-09-05;18616;41142;4126;2;43849;4275;0;0;0;38942939;32941608;252364;357;36338183;106754;10;0;0
FR;1;2021-09-06;59826;151361;30182;15;158891;31206;2;0;0;39002765;33092969;282546;372;36497074;137960;12;0;0
FR;1;2021-09-07;57400;139620;30215;30;146739;31252;2;0;0;39060165;33232589;312761;402;36643813;169212;14;0;0
FR;1;2021-09-08;72358;173796;26926;22;182264;27967;4;0;0;39132523;33406385;339687;424;36826077;197179;18;0;0
FR;1;2021-09-09;54516;124428;28639;24;131187;29745;5;0;0;39187039;33530813;368326;448;36957264;226924;23;0;0
FR;1;2021-09-10;66225;152070;30452;24;161154;31694;5;0;0;39253264;33682883;398778;472;37118418;258618;28;0;0
FR;1;2021-09-11;52689;146638;9731;14;154126;10356;0;0;0;39305953;33829521;408509;486;37272544;268974;28;0;0
FR;1;2021-09-12;10800;29268;2491;1;30966;2661;2;0;0;39316753;33858789;411000;487;37303510;271635;30;0;0
FR;1;2021-09-13;51519;104392;38767;31;110925;40097;16;0;0;39368272;33963181;449767;518;37414435;311732;46;0;0
FR;1;2021-09-14;53343;96009;51293;67;102366;53303;37;0;0;39421615;34059190;501060;585;37516801;365035;83;0;0
FR;1;2021-09-15;60592;139228;50499;55;146396;47072;67;0;0;39482207;34198418;551559;640;37663197;412107;150;0;0
FR;1;2021-09-16;46646;81362;53354;70;86256;49617;55;0;0;39528853;34279780;604913;710;37749453;461724;205;0;0
FR;1;2021-09-17;53227;109322;45085;61;115657;42717;61;0;0;39582080;34389102;649998;771;37865110;504441;266;0;0
FR;1;2021-09-18;37887;118499;11797;19;124081;11280;19;0;0;39619967;34507601;661795;790;37989191;515721;285;0;0
FR;1;2021-09-19;6531;21022;2045;1;22126;1985;1;0;0;39626498;34528623;663840;791;38011317;517706;286;0;0
FR;1;2021-09-20;36543;74842;46230;65;78562;44197;30;0;0;39663041;34603465;710070;856;38089879;561903;316;0;0
FR;1;2021-09-21;34209;68100;56270;72;71135;52747;76;0;0;39697250;34671565;766340;928;38161014;614650;392;0;0
FR;1;2021-09-22;38852;118606;49893;76;123023;46948;38;0;0;39736102;34790171;816233;1004;38284037;661598;430;0;0
FR;1;2021-09-23;32043;62885;54515;85;65788;50921;76;0;0;39768145;34853056;870748;1089;38349825;712519;506;0;0
FR;1;2021-09-24;36804;90016;43679;89;94373;41961;56;0;0;39804949;34943072;914427;1178;38444198;754480;562;0;0
FR;1;2021-09-25;27655;96713;12308;27;101063;12190;19;0;0;39832604;35039785;926735;1205;38545261;766670;581;0;0
FR;1;2021-09-26;4390;15202;1777;5;16067;1699;4;0;0;39836994;35054987;928512;1210;38561328;768369;585;0;0
FR;1;2021-09-27;27357;60204;42930;89;63434;41661;78;0;1;39864351;35115191;971442;1299;38624762;810030;663;0;1
FR;1;2021-09-28;26913;49420;47208;76;52035;44499;37;0;0;39891264;35164611;1018650;1375;38676797;854529;700;0;1
FR;1;2021-09-29;35927;80248;47298;88;84635;45624;33;0;0;39927191;35244859;1065948;1463;38761432;900153;733;0;1
FR;1;2021-09-30;26077;46900;47531;80;49257;45482;51;0;0;39953268;35291759;1113479;1543;38810689;945635;784;0;1
FR;1;2021-10-01;47307;66913;44910;83;70794;44634;14;0;0;40000575;35358672;1158389;1626;38881483;990269;798;0;1
FR;1;2021-10-02;32385;62416;16114;32;67224;16325;6;0;0;40032960;35421088;1174503;1658;38948707;1006594;804;0;1
FR;1;2021-10-03;4344;8561;2043;3;9310;2038;4;0;0;40037304;35429649;1176546;1661;38958017;1008632;808;0;1
FR;1;2021-10-04;28986;44424;47117;79;46836;46986;31;0;0;40066290;35474073;1223663;1740;39004853;1055618;839;0;1
FR;1;2021-10-05;24576;41642;49895;116;43137;49354;46;0;0;40090866;35515715;1273558;1856;39047990;1104972;885;0;1
FR;1;2021-10-06;34660;61397;57511;101;64503;57268;24;0;0;40125526;35577112;1331069;1957;39112493;1162240;909;0;1
FR;1;2021-10-07;21085;39908;53057;74;41087;52003;31;0;0;40146611;35617020;1384126;2031;39153580;1214243;940;0;1
FR;1;2021-10-08;35672;59639;60412;83;62866;61168;28;0;0;40182283;35676659;1444538;2114;39216446;1275411;968;0;1
FR;1;2021-10-09;27466;48026;25498;29;52492;26028;10;0;0;40209749;35724685;1470036;2143;39268938;1301439;978;0;1
FR;1;2021-10-10;3727;5812;2759;7;6290;2865;1;0;0;40213476;35730497;1472795;2150;39275228;1304304;979;0;1
FR;1;2021-10-11;24860;38211;54590;88;40296;55272;43;0;0;40238336;35768708;1527385;2238;39315524;1359576;1022;0;1
FR;1;2021-10-12;23387;36581;58078;128;37078;59242;18;0;0;40261723;35805289;1585463;2366;39352602;1418818;1040;0;1
FR;1;2021-10-13;32975;47837;64177;125;50641;65703;22;0;1;40294698;35853126;1649640;2491;39403243;1484521;1062;0;2
FR;1;2021-10-14;21715;34773;53776;103;35679;54373;21;0;0;40316413;35887899;1703416;2594;39438922;1538894;1083;0;2
FR;1;2021-10-15;32757;48766;72340;165;50458;75037;22;0;0;40349170;35936665;1775756;2759;39489380;1613931;1105;0;2
FR;1;2021-10-16;26014;35280;34874;45;38296;36431;13;0;0;40375184;35971945;1810630;2804;39527676;1650362;1118;0;2
FR;1;2021-10-17;3161;4053;3419;2;4497;3319;3;0;0;40378345;35975998;1814049;2806;39532173;1653681;1121;0;2
FR;1;2021-10-18;24353;34879;66854;132;34916;69740;27;0;0;40402698;36010877;1880903;2938;39567089;1723421;1148;0;2
FR;1;2021-10-19;20724;35571;75678;135;33220;79612;38;0;0;40423422;36046448;1956581;3073;39600309;1803033;1186;0;2
FR;1;2021-10-20;29918;44201;96192;178;43274;99885;44;0;0;40453340;36090649;2052773;3251;39643583;1902918;1230;0;2
FR;1;2021-10-21;19807;35053;83202;107;31764;87064;29;0;0;40473147;36125702;2135975;3358;39675347;1989982;1259;0;2
FR;1;2021-10-22;29756;47757;103757;196;44555;109722;58;0;0;40502903;36173459;2239732;3554;39719902;2099704;1317;0;2
FR;1;2021-10-23;23055;35142;44876;57;36130;47385;11;0;0;40525958;36208601;2284608;3611;39756032;2147089;1328;0;2
FR;1;2021-10-24;2407;3841;3585;6;4041;3718;1;0;0;40528365;36212442;2288193;3617;39760073;2150807;1329;0;2
FR;1;2021-10-25;22505;30717;82031;143;29599;85840;36;0;0;40550870;36243159;2370224;3760;39789672;2236647;1365;0;2
FR;1;2021-10-26;19368;27645;86127;162;24737;90358;30;0;0;40570238;36270804;2456351;3922;39814409;2327005;1395;0;2
FR;1;2021-10-27;26224;39608;107828;252;37299;112743;45;0;0;40596462;36310412;2564179;4174;39851708;2439748;1440;0;2
FR;1;2021-10-28;18804;27108;86970;150;23480;91740;34;0;0;40615266;36337520;2651149;4324;39875188;2531488;1474;0;2
FR;1;2021-10-29;25937;40252;114845;202;35486;121683;49;0;0;40641203;36377772;2765994;4526;39910674;2653171;1523;0;2
FR;1;2021-10-30;17714;28717;49373;74;28301;51970;18;0;0;40658917;36406489;2815367;4600;39938975;2705141;1541;0;2
FR;1;2021-10-31;2088;3169;3452;2;3215;3686;2;0;0;40661005;36409658;2818819;4602;39942190;2708827;1543;0;2
FR;1;2021-11-01;8027;4274;3037;3;4357;3295;6;0;0;40669032;36413932;2821856;4605;39946547;2712122;1549;0;2
FR;1;2021-11-02;22918;33218;92416;156;29172;97870;39;0;1;40691950;36447150;2914272;4761;39975719;2809992;1588;0;3
FR;1;2021-11-03;26639;41550;117526;219;36998;123912;54;0;0;40718589;36488700;3031798;4980;40012717;2933904;1642;0;3
FR;1;2021-11-04;19630;30289;105827;213;24184;111971;42;0;0;40738219;36518989;3137625;5193;40036901;3045875;1684;0;3
FR;1;2021-11-05;27036;42298;138800;230;34178;147490;47;0;0;40765255;36561287;3276425;5423;40071079;3193365;1731;0;3
FR;1;2021-11-06;18864;29807;63500;123;27605;66520;24;0;0;40784119;36591094;3339925;5546;40098684;3259885;1755;0;3
FR;1;2021-11-07;1835;3266;4985;6;3023;5302;5;0;0;40785954;36594360;3344910;5552;40101707;3265187;1760;0;3
FR;1;2021-11-08;17882;32249;126022;224;25390;132661;47;0;0;40803836;36626609;3470932;5776;40127097;3397848;1807;0;3
FR;1;2021-11-09;19520;37608;159334;334;26127;169159;63;0;0;40823356;36664217;3630266;6110;40153224;3567007;1870;0;3
FR;1;2021-11-10;28895;49046;181931;441;39012;192547;82;0;0;40852251;36713263;3812197;6551;40192236;3759554;1952;0;3
FR;1;2021-11-11;4192;5931;12240;26;5108;13030;14;0;0;40856443;36719194;3824437;6577;40197344;3772584;1966;0;3
FR;1;2021-11-12;26029;46817;174849;244;35280;186551;76;0;0;40882472;36766011;3999286;6821;40232624;3959135;2042;0;3
FR;1;2021-11-13;18736;29143;76848;111;25369;81793;40;0;0;40901208;36795154;4076134;6932;40257993;4040928;2082;0;3
FR;1;2021-11-14;2051;3240;6828;5;2796;7358;6;0;0;40903259;36798394;4082962;6937;40260789;4048286;2088;0;3
FR;1;2021-11-15;18798;34706;156449;306;24613;166287;59;0;0;40922057;36833100;4239411;7243;40285402;4214573;2147;0;3
FR;1;2021-11-16;21369;37809;192164;380;23315;205081;99;0;1;40943426;36870909;4431575;7623;40308717;4419654;2246;0;4
FR;1;2021-11-17;28675;45553;193256;398;33021;205084;92;0;0;40972101;36916462;4624831;8021;40341738;4624738;2338;0;4
FR;1;2021-11-18;21149;39594;182545;459;25133;194672;85;0;0;40993250;36956056;4807376;8480;40366871;4819410;2423;0;4
FR;1;2021-11-19;30894;53315;230287;532;34810;246782;134;0;0;41024144;37009371;5037663;9012;40401681;5066192;2557;0;4
FR;1;2021-11-20;23776;33217;97003;202;26736;103656;40;0;0;41047920;37042588;5134666;9214;40428417;5169848;2597;0;4
FR;1;2021-11-21;2342;3909;9134;19;2957;9940;16;0;0;41050262;37046497;5143800;9233;40431374;5179788;2613;0;4
FR;1;2021-11-22;21426;30326;175932;467;16941;189483;79;0;0;41071688;37076823;5319732;9700;40448315;5369271;2692;0;4
FR;1;2021-11-23;24033;40969;221267;540;21318;238020;77;0;0;41095721;37117792;5540999;10240;40469633;5607291;2769;0;4
FR;1;2021-11-24;30298;49640;217403;701;31959;234586;67;0;0;41126019;37167432;5758402;10941;40501592;5841877;2836;0;4
FR;1;2021-11-25;23732;44046;244527;718;22072;264227;101;0;0;41149751;37211478;6002929;11659;40523664;6106104;2937;0;4
FR;1;2021-11-26;30619;66640;356842;836;33241;388629;154;0;0;41180370;37278118;6359771;12495;40556905;6494733;3091;0;4
FR;1;2021-11-27;21960;45262;202667;372;26148;222699;112;0;0;41202330;37323380;6562438;12867;40583053;6717432;3203;0;4
FR;1;2021-11-28;3180;9542;54804;63;3468;61015;37;0;0;41205510;37332922;6617242;12930;40586521;6778447;3240;0;4
FR;1;2021-11-29;17905;49468;326438;841;20781;354581;150;0;0;41223415;37382390;6943680;13771;40607302;7133028;3390;0;4
FR;1;2021-11-30;22790;64820;431197;952;23793;470850;266;0;0;41246205;37447210;7374877;14723;40631095;7603878;3656;0;4
FR;1;2021-12-01;25365;69037;442956;1131;28429;481822;271;0;0;41271570;37516247;7817833;15854;40659524;8085700;3927;0;4
FR;1;2021-12-02;20094;64295;489466;1230;18430;532973;274;0;0;41291664;37580542;8307299;17084;40677954;8618673;4201;0;4
FR;1;2021-12-03;22912;82289;542843;1310;30262;591858;308;0;0;41314576;37662831;8850142;18394;40708216;9210531;4509;0;4
FR;1;2021-12-04;16416;53777;299138;654;23202;328999;180;0;0;41330992;37716608;9149280;19048;40731418;9539530;4689;0;4
FR;1;2021-12-05;3635;13773;81549;143;4193;91048;85;0;0;41334627;37730381;9230829;19191;40735611;9630578;4774;0;4
FR;1;2021-12-06;25847;62419;415527;1066;22058;455255;359;0;0;41360474;37792800;9646356;20257;40757669;10085833;5133;0;4
FR;1;2021-12-07;20020;75449;523088;1536;24268;572747;372;0;0;41380494;37868249;10169444;21793;40781937;10658580;5505;0;4
FR;1;2021-12-08;21719;75488;458639;1545;30645;502296;377;0;0;41402213;37943737;10628083;23338;40812582;11160876;5882;0;4
FR;1;2021-12-09;19472;73924;493120;1624;24308;541133;398;0;0;41421685;38017661;11121203;24962;40836890;11702009;6280;0;4
FR;1;2021-12-10;23329;87513;547478;1585;32408;600121;393;0;1;41445014;38105174;11668681;26547;40869298;12302130;6673;0;5
FR;1;2021-12-11;16534;59089;302772;751;25947;335507;278;0;0;41461548;38164263;11971453;27298;40895245;12637637;6951;0;5
FR;1;2021-12-12;4398;15876;83241;179;5241;94049;96;0;0;41465946;38180139;12054694;27477;40900486;12731686;7047;0;5
FR;1;2021-12-13;15762;63388;367089;1094;23898;406371;236;0;0;41481708;38243527;12421783;28571;40924384;13138057;7283;0;5
FR;1;2021-12-14;20870;80107;464907;1749;28629;515370;507;0;1;41502578;38323634;12886690;30320;40953013;13653427;7790;0;6
FR;1;2021-12-15;21629;77280;409191;1309;32998;453259;311;0;1;41524207;38400914;13295881;31629;40986011;14106686;8101;0;7
FR;1;2021-12-16;20068;77042;452017;1577;27916;500753;324;0;0;41544275;38477956;13747898;33206;41013927;14607439;8425;0;7
FR;1;2021-12-17;22628;86367;480033;1737;34638;531058;371;0;0;41566903;38564323;14227931;34943;41048565;15138497;8796;0;7
FR;1;2021-12-18;17610;54543;257664;731;24678;288531;232;0;0;41584513;38618866;14485595;35674;41073243;15427028;9028;0;7
FR;1;2021-12-19;5563;16906;79205;194;5918;90678;117;0;0;41590076;38635772;14564800;35868;41079161;15517706;9145;0;7
FR;1;2021-12-20;20957;62859;316308;1082;26481;355336;286;0;0;41611033;38698631;14881108;36950;41105642;15873042;9431;0;7
FR;1;2021-12-21;26344;72854;372823;1422;30550;418150;338;0;0;41637377;38771485;15253931;38372;41136192;16291192;9769;0;7
FR;1;2021-12-22;24989;65639;310708;1217;29569;349632;361;0;1;41662366;38837124;15564639;39589;41165761;16640824;10130;0;8
FR;1;2021-12-23;21280;52097;241543;958;23334;273073;362;0;0;41683646;38889221;15806182;40547;41189095;16913897;10492;0;8
FR;1;2021-12-24;7130;18267;67172;258;9242;77064;154;0;1;41690776;38907488;15873354;40805;41198337;16990961;10646;0;9
FR;1;2021-12-25;510;2864;5595;15;1797;6539;55;0;0;41691286;38910352;15878949;40820;41200134;16997500;10701;0;9
FR;1;2021-12-26;2751;7565;26961;71;3489;31471;100;0;0;41694037;38917917;15905910;40891;41203623;17028971;10801;0;9
FR;1;2021-12-27;18311;53456;235148;705;25446;265808;365;0;0;41712348;38971373;16141058;41596;41229069;17294779;11166;0;9
FR;1;2021-12-28;23302;61879;292072;1026;26987;330248;595;0;1;41735650;39033252;16433130;42622;41256056;17625027;11761;0;10
FR;1;2021-12-29;22218;55369;255051;921;25252;288247;645;0;1;41757868;39088621;16688181;43543;41281308;17913274;12406;0;11
FR;1;2021-12-30;21240;46408;212186;858;22444;239636;718;0;0;41779108;39135029;16900367;44401;41303752;18152910;13124;0;11
FR;1;2021-12-31;7468;16536;61882;229;8713;70417;347;0;0;41786576;39151565;16962249;44630;41312465;18223327;13471;0;11
FR;1;2022-01-01;1173;2492;5668;30;1546;6577;73;0;0;41787749;39154057;16967917;44660;41314011;18229904;13544;0;11
FR;1;2022-01-02;3096;8072;28896;50;3671;33536;190;0;0;41790845;39162129;16996813;44710;41317682;18263440;13734;0;11
FR;1;2022-01-03;27026;54162;228289;790;27529;257750;964;0;1;41817871;39216291;17225102;45500;41345211;18521190;14698;0;12
FR;1;2022-01-04;26374;64967;299328;1241;29773;337371;1367;0;2;41844245;39281258;17524430;46741;41374984;18858561;16065;0;14
FR;1;2022-01-05;30572;64234;274940;1099;32504;310318;1264;0;0;41874817;39345492;17799370;47840;41407488;19168879;17329;0;14
FR;1;2022-01-06;26862;66195;306958;1404;29267;346635;1568;0;1;41901679;39411687;18106328;49244;41436755;19515514;18897;0;15
FR;1;2022-01-07;31583;74957;349881;1538;34384;394008;1822;0;1;41933262;39486644;18456209;50782;41471139;19909522;20719;0;16
FR;1;2022-01-08;23391;51355;222512;698;25570;251138;913;0;1;41956653;39537999;18678721;51480;41496709;20160660;21632;0;17
FR;1;2022-01-09;7091;17130;66036;163;8165;76142;335;0;0;41963744;39555129;18744757;51643;41504874;20236802;21967;0;17
FR;1;2022-01-10;21815;60571;236840;957;32914;267629;1258;0;1;41985559;39615700;18981597;52600;41537788;20504431;23225;0;18
FR;1;2022-01-11;26786;63430;282352;1281;31189;317869;1838;0;1;42012345;39679130;19263949;53881;41568977;20822300;25063;0;19
FR;1;2022-01-12;28969;62475;246306;1106;35040;278095;1686;0;3;42041314;39741605;19510255;54987;41604017;21100395;26749;0;22
FR;1;2022-01-13;24791;60153;262846;1253;30023;296167;1993;0;4;42066105;39801758;19773101;56240;41634040;21396562;28742;0;26
FR;1;2022-01-14;27972;66680;314057;1366;32103;351307;2475;0;1;42094077;39868438;20087158;57606;41666143;21747869;31217;0;27
FR;1;2022-01-15;19371;44409;199333;619;22462;223870;1363;0;1;42113448;39912847;20286491;58225;41688605;21971739;32580;0;28
FR;1;2022-01-16;5161;12954;51537;135;6017;59558;338;0;0;42118609;39925801;20338028;58360;41694622;22031297;32918;0;28
FR;1;2022-01-17;16885;39655;184868;783;20105;206845;1690;0;2;42135494;39965456;20522896;59143;41714727;22238142;34608;0;30
FR;1;2022-01-18;19460;45956;212464;1154;22980;237066;2456;0;1;42154954;40011412;20735360;60297;41737707;22475208;37064;0;31
FR;1;2022-01-19;20314;43936;176151;898;25463;197206;1977;0;4;42175268;40055348;20911511;61195;41763170;22672414;39041;0;35
FR;1;2022-01-20;16853;40568;183727;1147;20814;204772;2517;0;2;42192121;40095916;21095238;62342;41783984;22877186;41558;0;37
FR;1;2022-01-21;19923;46999;228985;1405;23878;253362;3106;0;1;42212044;40142915;21324223;63747;41807862;23130548;44664;0;38
FR;1;2022-01-22;13845;33330;144509;579;18431;161398;1404;0;2;42225889;40176245;21468732;64326;41826293;23291946;46068;0;40
FR;1;2022-01-23;3379;8761;33440;132;4575;38324;352;0;1;42229268;40185006;21502172;64458;41830868;23330270;46420;0;41
FR;1;2022-01-24;11817;32969;142245;718;17787;158283;2105;0;1;42241085;40217975;21644417;65176;41848655;23488553;48525;0;42
FR;1;2022-01-25;14217;38159;163436;1049;20282;181572;3181;0;1;42255302;40256134;21807853;66225;41868937;23670125;51706;0;43
FR;1;2022-01-26;14865;37722;150273;934;22633;166402;2516;0;1;42270167;40293856;21958126;67159;41891570;23836527;54222;0;44
FR;1;2022-01-27;12341;33337;143472;896;18497;158051;3230;0;3;42282508;40327193;22101598;68055;41910067;23994578;57452;0;47
FR;1;2022-01-28;16331;56906;198337;1144;32660;222398;4007;0;3;42298839;40384099;22299935;69199;41942727;24216976;61459;0;50
FR;1;2022-01-29;10270;35466;135216;525;19613;151539;1879;0;1;42309109;40419565;22435151;69724;41962340;24368515;63338;0;51
FR;1;2022-01-30;2485;9252;29688;86;4826;34448;434;0;1;42311594;40428817;22464839;69810;41967166;24402963;63772;0;52
FR;1;2022-01-31;8760;32461;104354;533;19470;117343;2340;0;3;42320354;40461278;22569193;70343;41986636;24520306;66112;0;55
FR;1;2022-02-01;11011;36444;127095;866;20630;141215;4320;0;1;42331365;40497722;22696288;71209;42007266;24661521;70432;0;56
FR;1;2022-02-02;12169;41570;130371;783;25261;145817;3773;0;9;42343534;40539292;22826659;71992;42032527;24807338;74205;0;65
FR;1;2022-02-03;9520;34054;117034;785;19122;130333;4284;0;4;42353054;40573346;22943693;72777;42051649;24937671;78489;0;69
FR;1;2022-02-04;11544;49691;172589;968;26983;192723;5479;0;5;42364598;40623037;23116282;73745;42078632;25130394;83968;0;74
FR;1;2022-02-05;8000;33921;117593;391;18170;133023;2414;0;3;42372598;40656958;23233875;74136;42096802;25263417;86382;0;77
FR;1;2022-02-06;1706;7995;22754;86;3873;26905;444;0;0;42374304;40664953;23256629;74222;42100675;25290322;86826;0;77
FR;1;2022-02-07;7369;35386;119115;460;18174;134970;3398;0;4;42381673;40700339;23375744;74682;42118849;25425292;90224;0;81
FR;1;2022-02-08;7772;31960;125678;696;14891;140668;4301;0;5;42389445;40732299;23501422;75378;42133740;25565960;94525;0;86
FR;1;2022-02-09;8741;36529;135267;702;17930;152510;3884;0;7;42398186;40768828;23636689;76080;42151670;25718470;98409;0;93
FR;1;2022-02-10;7032;30145;116383;677;13910;130171;4445;0;1;42405218;40798973;23753072;76757;42165580;25848641;102854;0;94
FR;1;2022-02-11;8662;41569;165150;878;18383;185374;5430;0;3;42413880;40840542;23918222;77635;42183963;26034015;108284;0;97
FR;1;2022-02-12;5346;27617;106716;379;12540;120902;2395;0;2;42419226;40868159;24024938;78014;42196503;26154917;110679;0;99
FR;1;2022-02-13;1269;5721;21721;66;2188;25339;402;0;3;42420495;40873880;24046659;78080;42198691;26180256;111081;0;102
FR;1;2022-02-14;5462;27230;118095;395;10644;133123;3385;0;4;42425957;40901110;24164754;78475;42209335;26313379;114466;0;106
FR;1;2022-02-15;5797;28872;118941;611;12221;132572;4883;0;1;42431754;40929982;24283695;79086;42221556;26445951;119349;0;107
FR;1;2022-02-16;5763;28497;110429;597;13764;123059;4153;0;3;42437517;40958479;24394124;79683;42235320;26569010;123502;0;110
FR;1;2022-02-17;4617;19749;73156;489;10129;80263;3999;0;3;42442134;40978228;24467280;80172;42245449;26649273;127501;0;113
FR;1;2022-02-18;5615;26805;99209;673;14178;108171;5519;0;2;42447749;41005033;24566489;80845;42259627;26757444;133020;0;115
FR;1;2022-02-19;3552;17178;59479;305;9571;66060;2267;0;0;42451301;41022211;24625968;81150;42269198;26823504;135287;0;115
FR;1;2022-02-20;794;3258;10706;36;1651;12333;360;0;1;42452095;41025469;24636674;81186;42270849;26835837;135647;0;116
FR;1;2022-02-21;3430;14599;52830;286;7919;57678;3126;0;2;42455525;41040068;24689504;81472;42278768;26893515;138773;0;118
FR;1;2022-02-22;3804;15551;51919;500;9048;55657;4070;0;1;42459329;41055619;24741423;81972;42287816;26949172;142843;0;119
FR;1;2022-02-23;4235;17827;57487;510;10747;62589;3568;0;3;42463564;41073446;24798910;82482;42298563;27011761;146411;0;122
FR;1;2022-02-24;3345;13146;43620;436;7841;46410;3658;0;2;42466909;41086592;24842530;82918;42306404;27058171;150069;0;124
FR;1;2022-02-25;4478;20133;64928;697;12250;68799;5768;0;4;42471387;41106725;24907458;83615;42318654;27126970;155837;0;128
FR;1;2022-02-26;2697;12806;41371;310;7653;45124;2494;0;2;42474084;41119531;24948829;83925;42326307;27172094;158331;0;130
FR;1;2022-02-27;644;2192;7131;42;1207;7994;433;0;0;42474728;41121723;24955960;83967;42327514;27180088;158764;0;130
FR;1;2022-02-28;2614;10502;34968;306;6082;37395;3123;0;0;42477342;41132225;24990928;84273;42333596;27217483;161887;0;130
FR;1;2022-03-01;3592;10762;38706;392;6364;39662;4549;0;4;42480934;41142987;25029634;84665;42339960;27257145;166436;0;134
FR;1;2022-03-02;3685;12287;41871;400;7554;43941;4112;0;1;42484619;41155274;25071505;85065;42347514;27301086;170548;0;135
FR;1;2022-03-03;2464;7994;26185;330;5249;26523;3381;0;1;42487083;41163268;25097690;85395;42352763;27327609;173929;0;136
FR;1;2022-03-04;2692;10555;35468;594;6986;34963;5280;0;3;42489775;41173823;25133158;85989;42359749;27362572;179209;0;139
FR;1;2022-03-05;1824;6370;21972;281;4208;22370;2573;0;1;42491599;41180193;25155130;86270;42363957;27384942;181782;0;140
FR;1;2022-03-06;360;959;2918;38;605;3121;327;0;0;42491959;41181152;25158048;86308;42364562;27388063;182109;0;140
FR;1;2022-03-07;1925;4724;16442;245;3046;15909;2832;0;4;42493884;41185876;25174490;86553;42367608;27403972;184941;0;144
FR;1;2022-03-08;1719;5261;17172;309;3672;16001;3471;0;3;42495603;41191137;25191662;86862;42371280;27419973;188412;0;147
FR;1;2022-03-09;1988;6749;19821;371;4824;19179;3424;0;4;42497591;41197886;25211483;87233;42376104;27439152;191836;0;151
FR;1;2022-03-10;1417;5024;15302;309;3677;14340;2944;0;2;42499008;41202910;25226785;87542;42379781;27453492;194780;0;153
FR;1;2022-03-11;1761;6416;21717;487;4450;19873;4737;0;1;42500769;41209326;25248502;88029;42384231;27473365;199517;0;154
FR;1;2022-03-12;1264;4651;15367;281;3092;14915;2687;0;2;42502033;41213977;25263869;88310;42387323;27488280;202204;0;156
FR;1;2022-03-13;258;614;2119;120;416;2065;469;0;0;42502291;41214591;25265988;88430;42387739;27490345;202673;0;156
FR;1;2022-03-14;1160;3682;13408;3882;2297;12529;6342;0;8;42503451;41218273;25279396;92312;42390036;27502874;209015;0;164
FR;1;2022-03-15;1409;5736;14665;6865;4320;13262;9847;0;8;42504860;41224009;25294061;99177;42394356;27516136;218862;0;172
FR;1;2022-03-16;1700;5092;17402;11522;3603;16465;14128;0;6;42506560;41229101;25311463;110699;42397959;27532601;232990;0;178
FR;1;2022-03-17;1182;3442;11735;9648;2367;10829;11733;0;8;42507742;41232543;25323198;120347;42400326;27543430;244723;0;186
FR;1;2022-03-18;1725;4931;17980;16508;3324;16419;19722;0;14;42509467;41237474;25341178;136855;42403650;27559849;264445;0;200
FR;1;2022-03-19;1126;3302;11891;8460;2277;11362;10142;0;6;42510593;41240776;25353069;145315;42405927;27571211;274587;0;206
FR;1;2022-03-20;225;562;1726;1015;364;1761;1224;0;2;42510818;41241338;25354795;146330;42406291;27572972;275811;0;208
FR;1;2022-03-21;1088;2768;11506;13462;1787;10857;15142;0;10;42511906;41244106;25366301;159792;42408078;27583829;290953;0;218
FR;1;2022-03-22;1282;3216;12265;18716;2156;11254;20619;0;5;42513188;41247322;25378566;178508;42410234;27595083;311572;0;223
FR;1;2022-03-23;1517;4365;16037;20112;2961;15718;21884;0;34;42514705;41251687;25394603;198620;42413195;27610801;333456;0;257
FR;1;2022-03-24;1121;2754;10406;16060;1910;9666;17566;0;15;42515826;41254441;25405009;214680;42415105;27620467;351022;0;272
FR;1;2022-03-25;1541;4364;16758;25317;2882;15411;27960;0;23;42517367;41258805;25421767;239997;42417987;27635878;378982;0;295
FR;1;2022-03-26;1110;3018;10856;11452;2065;10518;12864;0;20;42518477;41261823;25432623;251449;42420052;27646396;391846;0;315
FR;1;2022-03-27;237;546;1751;1383;334;1804;1594;0;1;42518714;41262369;25434374;252832;42420386;27648200;393440;0;316
FR;1;2022-03-28;1086;2491;9981;15885;1559;9602;17230;0;10;42519800;41264860;25444355;268717;42421945;27657802;410670;0;326
FR;1;2022-03-29;1140;2756;11562;25112;1604;10926;26509;0;30;42520940;41267616;25455917;293829;42423549;27668728;437179;0;356
FR;1;2022-03-30;1632;3681;14176;24233;2455;13716;25897;0;19;42522572;41271297;25470093;318062;42426004;27682444;463076;0;375
FR;1;2022-03-31;1281;3033;11702;22705;2061;11215;24026;0;40;42523853;41274330;25481795;340767;42428065;27693659;487102;0;415
FR;1;2022-04-01;2243;4025;18493;28533;2482;17363;30805;0;54;42526096;41278355;25500288;369300;42430547;27711022;517907;0;469
FR;1;2022-04-02;911;1894;8197;9241;1106;7960;10234;0;28;42527007;41280249;25508485;378541;42431653;27718982;528141;0;497
FR;1;2022-04-03;207;382;1434;1058;219;1436;1249;0;1;42527214;41280631;25509919;379599;42431872;27720418;529390;0;498
FR;1;2022-04-04;4275;2608;11386;17683;1698;10777;18903;0;30;42531489;41283239;25521305;397282;42433570;27731195;548293;0;528
FR;1;2022-04-05;2262;2725;13008;31222;1708;12034;32603;0;68;42533751;41285964;25534313;428504;42435278;27743229;580896;0;596
FR;1;2022-04-06;1893;3018;12209;23994;1926;11646;25291;0;62;42535644;41288982;25546522;452498;42437204;27754875;606187;0;658
FR;1;2022-04-07;1694;2754;12361;31122;1651;11830;32196;0;68;42537338;41291736;25558883;483620;42438855;27766705;638383;0;726
FR;1;2022-04-08;1847;3714;17571;40649;2100;16501;42702;0;76;42539185;41295450;25576454;524269;42440955;27783206;681085;0;802
FR;1;2022-04-09;828;2000;8406;12504;1079;8106;13502;0;26;42540013;41297450;25584860;536773;42442034;27791312;694587;0;828
FR;1;2022-04-10;202;655;1837;1855;420;1883;2075;0;6;42540215;41298105;25586697;538628;42442454;27793195;696662;0;834
FR;1;2022-04-11;1108;2269;10973;22373;1322;10687;23481;0;68;42541323;41300374;25597670;561001;42443776;27803882;720143;0;902
FR;1;2022-04-12;1352;2680;12830;38148;1594;12318;38900;0;119;42542675;41303054;25610500;599149;42445370;27816200;759043;0;1021
FR;1;2022-04-13;1282;2895;12279;30627;1790;12010;31399;0;85;42543957;41305949;25622779;629776;42447160;27828210;790442;0;1106
FR;1;2022-04-14;1240;2629;12119;33662;1632;12133;34099;0;87;42545197;41308578;25634898;663438;42448792;27840343;824541;0;1193
FR;1;2022-04-15;1513;3352;14408;33269;2167;13815;34671;0;107;42546710;41311930;25649306;696707;42450959;27854158;859212;0;1300
FR;1;2022-04-16;663;1410;5845;8003;767;5777;8757;0;31;42547373;41313340;25655151;704710;42451726;27859935;867969;0;1331
FR;1;2022-04-17;157;290;930;1121;177;975;1171;0;7;42547530;41313630;25656081;705831;42451903;27860910;869140;0;1338
FR;1;2022-04-18;170;499;2636;1002;313;2660;1187;0;5;42547700;41314129;25658717;706833;42452216;27863570;870327;0;1343
FR;1;2022-04-19;1260;2610;11788;27937;1501;11519;28792;0;69;42548960;41316739;25670505;734770;42453717;27875089;899119;0;1412
FR;1;2022-04-20;1361;2676;12179;26886;1679;12031;27711;0;82;42550321;41319415;25682684;761656;42455396;27887120;926830;0;1494
FR;1;2022-04-21;1245;2466;11554;33286;1515;11785;33624;0;107;42551566;41321881;25694238;794942;42456911;27898905;960454;0;1601
FR;1;2022-04-22;1527;3094;15219;35528;1927;14803;36719;0;121;42553093;41324975;25709457;830470;42458838;27913708;997173;0;1722
FR;1;2022-04-23;767;1591;6738;9896;928;6644;10580;0;30;42553860;41326566;25716195;840366;42459766;27920352;1007753;0;1752
FR;1;2022-04-24;195;378;1376;1524;242;1329;1749;0;7;42554055;41326944;25717571;841890;42460008;27921681;1009502;0;1759
FR;1;2022-04-25;1042;2133;9859;19744;1255;9767;20558;0;64;42555097;41329077;25727430;861634;42461263;27931448;1030060;0;1823
FR;1;2022-04-26;1351;2627;12608;36641;1608;12207;37229;0;163;42556448;41331704;25740038;898275;42462871;27943655;1067289;0;1986
FR;1;2022-04-27;1331;2411;10655;29292;1471;10791;29677;0;123;42557779;41334115;25750693;927567;42464342;27954446;1096966;0;2109
FR;1;2022-04-28;1285;2423;11565;34331;1531;11406;34481;0;127;42559064;41336538;25762258;961898;42465873;27965852;1131447;0;2236
FR;1;2022-04-29;1616;4296;14407;35563;3169;13860;36852;0;153;42560680;41340834;25776665;997461;42469042;27979712;1168299;0;2389
FR;1;2022-04-30;841;4335;6448;9173;3762;6292;9974;0;35;42561521;41345169;25783113;1006634;42472804;27986004;1178273;0;2424
FR;1;2022-05-01;179;288;832;951;190;826;1080;0;5;42561700;41345457;25783945;1007585;42472994;27986830;1179353;0;2429
FR;1;2022-05-02;2098;2629;10383;16956;1784;10308;17637;0;64;42563798;41348086;25794328;1024541;42474778;27997138;1196990;0;2493
FR;1;2022-05-03;1689;2880;12713;32916;1763;12605;33715;0;149;42565487;41350966;25807041;1057457;42476541;28009743;1230705;0;2642
FR;1;2022-05-04;1384;2749;11235;23825;1694;11396;24365;0;96;42566871;41353715;25818276;1081282;42478235;28021139;1255070;0;2738
FR;1;2022-05-05;1501;2739;12201;31862;1722;12124;32410;0;170;42568372;41356454;25830477;1113144;42479957;28033263;1287480;0;2908
FR;1;2022-05-06;1823;3243;14246;34957;1920;13833;36216;0;166;42570195;41359697;25844723;1148101;42481877;28047096;1323696;0;3074
FR;1;2022-05-07;860;1473;5979;9097;878;6013;9731;0;44;42571055;41361170;25850702;1157198;42482755;28053109;1333427;0;3118
FR;1;2022-05-08;190;329;1062;1472;221;1124;1548;0;8;42571245;41361499;25851764;1158670;42482976;28054233;1334975;0;3126
FR;1;2022-05-09;1168;2020;9249;19262;1160;9164;20034;0;93;42572413;41363519;25861013;1177932;42484136;28063397;1355009;0;3219
FR;1;2022-05-10;1513;3050;12620;37147;1961;12220;38044;0;177;42573926;41366569;25873633;1215079;42486097;28075617;1393053;0;3396
FR;1;2022-05-11;1440;2480;9913;26043;1698;9860;26561;0;138;42575366;41369049;25883546;1241122;42487795;28085477;1419614;0;3534
FR;1;2022-05-12;1326;2459;10531;33658;1551;10231;34304;0;188;42576692;41371508;25894077;1274780;42489346;28095708;1453918;0;3722
FR;1;2022-05-13;1620;2808;12770;35855;1689;12418;36950;0;149;42578312;41374316;25906847;1310635;42491035;28108126;1490868;0;3871
FR;1;2022-05-14;783;1331;5481;10217;818;5365;10732;0;52;42579095;41375647;25912328;1320852;42491853;28113491;1501600;0;3923
FR;1;2022-05-15;223;423;1182;1352;247;1252;1497;0;5;42579318;41376070;25913510;1322204;42492100;28114743;1503097;0;3928
FR;1;2022-05-16;972;1786;8082;20140;1005;8146;20552;0;117;42580290;41377856;25921592;1342344;42493105;28122889;1523649;0;4045
FR;1;2022-05-17;1298;2303;11126;36191;1387;10731;36976;0;172;42581588;41380159;25932718;1378535;42494492;28133620;1560625;0;4217
FR;1;2022-05-18;1313;2137;9042;25730;1369;8991;26290;0;99;42582901;41382296;25941760;1404265;42495861;28142611;1586915;0;4316
FR;1;2022-05-19;1207;2404;9857;34005;1415;9952;34208;0;150;42584108;41384700;25951617;1438270;42497276;28152563;1621123;0;4466
FR;1;2022-05-20;1563;2757;12533;37655;1721;12113;38516;0;151;42585671;41387457;25964150;1475925;42498997;28164676;1659639;0;4617
FR;1;2022-05-21;775;1387;5247;9374;880;5164;9944;0;37;42586446;41388844;25969397;1485299;42499877;28169840;1669583;0;4654
FR;1;2022-05-22;194;292;955;1398;204;953;1522;0;10;42586640;41389136;25970352;1486697;42500081;28170793;1671105;0;4664
FR;1;2022-05-23;971;1891;8372;19439;1179;8348;20056;0;79;42587611;41391027;25978724;1506136;42501260;28179141;1691161;0;4743
FR;1;2022-05-24;1289;2448;10728;37256;1440;10598;37829;0;173;42588900;41393475;25989452;1543392;42502700;28189739;1728990;0;4916
FR;1;2022-05-25;1272;2305;8793;23694;1430;8957;24056;0;111;42590172;41395780;25998245;1567086;42504130;28198696;1753046;0;5027
FR;1;2022-05-26;175;385;1585;1155;261;1580;1288;0;24;42590347;41396165;25999830;1568241;42504391;28200276;1754334;0;5051
FR;1;2022-05-27;1120;2192;8790;20457;1377;8538;21410;0;84;42591467;41398357;26008620;1588698;42505768;28208814;1775744;0;5135
FR;1;2022-05-28;486;1059;3692;6543;627;3729;6930;0;37;42591953;41399416;26012312;1595241;42506395;28212543;1782674;0;5172
FR;1;2022-05-29;121;257;708;896;149;719;1005;0;4;42592074;41399673;26013020;1596137;42506544;28213262;1783679;0;5176
FR;1;2022-05-30;832;1745;6559;18536;1046;6592;18990;0;85;42592906;41401418;26019579;1614673;42507590;28219854;1802669;0;5261
FR;1;2022-05-31;1266;2241;9248;34376;1372;9118;34976;0;159;42594172;41403659;26028827;1649049;42508962;28228972;1837645;0;5420
FR;1;2022-06-01;1336;2605;10438;23460;1752;10302;24306;0;116;42595508;41406264;26039265;1672509;42510714;28239274;1861951;0;5536
FR;1;2022-06-02;1228;2309;10669;34153;1450;10247;34986;0;162;42596736;41408573;26049934;1706662;42512164;28249521;1896937;0;5698
FR;1;2022-06-03;1447;2749;12735;37113;1740;12156;38289;0;157;42598183;41411322;26062669;1743775;42513904;28261677;1935226;0;5855
FR;1;2022-06-04;686;1263;4750;8678;760;4826;9168;0;62;42598869;41412585;26067419;1752453;42514664;28266503;1944394;0;5917
FR;1;2022-06-05;134;293;811;1049;151;835;1154;0;3;42599003;41412878;26068230;1753502;42514815;28267338;1945548;0;5920
FR;1;2022-06-06;851;1196;2029;1252;1020;2048;1427;0;9;42599854;41414074;26070259;1754754;42515835;28269386;1946975;0;5929
FR;1;2022-06-07;1264;2343;9186;34057;1440;8846;35156;0;143;42601118;41416417;26079445;1788811;42517275;28278232;1982131;0;6072
FR;1;2022-06-08;1140;2240;8682;27616;1403;8566;28487;0;107;42602258;41418657;26088127;1816427;42518678;28286798;2010618;0;6179
FR;1;2022-06-09;1076;2152;9988;37576;1283;9673;38343;0;148;42603334;41420809;26098115;1854003;42519961;28296471;2048961;0;6327
FR;1;2022-06-10;1337;2862;12426;43134;1825;12017;44363;0;200;42604671;41423671;26110541;1897137;42521786;28308488;2093324;0;6527
FR;1;2022-06-11;661;1451;5136;11085;798;5185;11614;0;50;42605332;41425122;26115677;1908222;42522584;28313673;2104938;0;6577
FR;1;2022-06-12;158;377;1019;1687;189;1077;1788;0;11;42605490;41425499;26116696;1909909;42522773;28314750;2106726;0;6588
FR;1;2022-06-13;951;1841;7015;22226;1136;6872;23067;0;84;42606441;41427340;26123711;1932135;42523909;28321622;2129793;0;6672
FR;1;2022-06-14;1118;2234;9841;42852;1312;9247;43943;0;186;42607559;41429574;26133552;1974987;42525221;28330869;2173736;0;6858
FR;1;2022-06-15;1095;2013;8788;29413;1364;8476;29961;0;170;42608654;41431587;26142340;2004400;42526585;28339345;2203697;0;7028
FR;1;2022-06-16;959;1840;9405;38511;1061;8883;39418;0;188;42609613;41433427;26151745;2042911;42527646;28348228;2243115;0;7216
FR;1;2022-06-17;1229;2568;11916;44864;1483;11382;46004;0;224;42610842;41435995;26163661;2087775;42529129;28359610;2289119;0;7440
FR;1;2022-06-18;564;1277;4320;10544;717;4258;11087;0;62;42611406;41437272;26167981;2098319;42529846;28363868;2300206;0;7502
FR;1;2022-06-19;137;325;1003;1543;173;1082;1609;0;12;42611543;41437597;26168984;2099862;42530019;28364950;2301815;0;7514
FR;1;2022-06-20;861;1710;8493;25051;1009;8157;25912;0;146;42612404;41439307;26177477;2124913;42531028;28373107;2327727;0;7660
FR;1;2022-06-21;1104;2140;9765;47760;1255;8856;49105;0;241;42613508;41441447;26187242;2172673;42532283;28381963;2376832;0;7901
FR;1;2022-06-22;1046;2074;8442;37164;1302;7963;38024;0;231;42614554;41443521;26195684;2209837;42533585;28389926;2414856;0;8132
FR;1;2022-06-23;1054;2182;10125;52821;1211;9408;53830;0;290;42615608;41445703;26205809;2262658;42534796;28399334;2468686;0;8422
FR;1;2022-06-24;1256;2720;12917;65968;1487;11702;67640;0;367;42616864;41448423;26218726;2328626;42536283;28411036;2536326;0;8789
FR;1;2022-06-25;685;1506;5930;18924;792;5712;19723;0;163;42617549;41449929;26224656;2347550;42537075;28416748;2556049;0;8952
FR;1;2022-06-26;167;406;1817;3494;191;1713;3730;0;34;42617716;41450335;26226473;2351044;42537266;28418461;2559779;0;8986
FR;1;2022-06-27;945;1777;9901;45988;943;9127;47123;0;300;42618661;41452112;26236374;2397032;42538209;28427588;2606902;0;9286
FR;1;2022-06-28;1216;2576;13845;86603;1382;12408;88288;0;570;42619877;41454688;26250219;2483635;42539591;28439996;2695190;0;9856
FR;1;2022-06-29;1243;2297;11483;67405;1261;10550;68450;0;487;42621120;41456985;26261702;2551040;42540852;28450546;2763640;0;10343
FR;1;2022-06-30;1291;2487;13518;89968;1438;11829;91769;0;645;42622411;41459472;26275220;2641008;42542290;28462375;2855409;0;10988
FR;1;2022-07-01;1659;3483;20317;109201;1992;17974;111597;0;859;42624070;41462955;26295537;2750209;42544282;28480349;2967006;0;11847
FR;1;2022-07-02;770;1527;8025;33776;751;7254;34802;0;315;42624840;41464482;26303562;2783985;42545033;28487603;3001808;0;12162
FR;1;2022-07-03;230;480;1943;6119;258;1759;6445;0;71;42625070;41464962;26305505;2790104;42545291;28489362;3008253;0;12233
FR;1;2022-07-04;1682;3178;13933;75423;2064;12360;77312;0;589;42626752;41468140;26319438;2865527;42547355;28501722;3085565;0;12822
FR;1;2022-07-05;1507;2859;17696;126389;1513;15153;128502;0;1060;42628259;41470999;26337134;2991916;42548868;28516875;3214067;0;13882
FR;1;2022-07-06;1379;2410;14890;93749;1389;12914;95185;0;815;42629638;41473409;26352024;3085665;42550257;28529789;3309252;0;14697
FR;1;2022-07-07;1447;2538;16939;119494;1406;14009;121589;0;1074;42631085;41475947;26368963;3205159;42551663;28543798;3430841;0;15771
FR;1;2022-07-08;1534;2823;19612;130008;1541;15975;132812;0;1220;42632619;41478770;26388575;3335167;42553204;28559773;3563653;0;16991
FR;1;2022-07-09;663;1281;7311;36022;699;6354;36809;0;392;42633282;41480051;26395886;3371189;42553903;28566127;3600462;0;17383
FR;1;2022-07-10;245;657;2240;6689;412;2032;7068;0;89;42633527;41480708;26398126;3377878;42554315;28568159;3607530;0;17472
FR;1;2022-07-11;1242;2246;14320;84457;1181;11942;86567;0;734;42634769;41482954;26412446;3462335;42555496;28580101;3694097;0;18206
FR;1;2022-07-12;1605;2806;19465;137424;1441;15905;139914;0;1485;42636374;41485760;26431911;3599759;42556937;28596006;3834011;0;19691
FR;1;2022-07-13;1462;2442;14791;89837;1319;12644;91522;0;1002;42637836;41488202;26446702;3689596;42558256;28608650;3925533;0;20693
FR;1;2022-07-14;163;351;1866;5290;196;1775;5437;0;74;42637999;41488553;26448568;3694886;42558452;28610425;3930970;0;20767
FR;1;2022-07-15;1267;2319;14365;80599;1206;12008;82603;0;960;42639266;41490872;26462933;3775485;42559658;28622433;4013573;0;21727
FR;1;2022-07-16;514;1064;5640;23949;556;4893;24590;0;302;42639780;41491936;26468573;3799434;42560214;28627326;4038163;0;22029
FR;1;2022-07-17;163;369;1656;4464;193;1501;4727;0;60;42639943;41492305;26470229;3803898;42560407;28628827;4042890;0;22089
FR;1;2022-07-18;975;2037;11302;59282;1148;9572;61006;0;715;42640918;41494342;26481531;3863180;42561555;28638399;4103896;0;22804
FR;1;2022-07-19;1235;2132;14695;99429;1196;11727;101426;0;1386;42642153;41496474;26496226;3962609;42562751;28650126;4205322;0;24190
FR;1;2022-07-20;1186;2007;12376;74374;1173;10287;75859;0;964;42643339;41498481;26508602;4036983;42563924;28660413;4281181;0;25154
FR;1;2022-07-21;1138;1955;12418;84548;1189;9994;85913;0;1211;42644477;41500436;26521020;4121531;42565113;28670407;4367094;0;26365
FR;1;2022-07-22;1274;2246;14112;85965;1260;11434;87690;0;1264;42645751;41502682;26535132;4207496;42566373;28681841;4454784;0;27629
FR;1;2022-07-23;549;1093;5238;21296;634;4611;21842;0;373;42646300;41503775;26540370;4228792;42567007;28686452;4476626;0;28002
FR;1;2022-07-24;149;306;1328;3700;153;1169;3925;0;65;42646449;41504081;26541698;4232492;42567160;28687621;4480551;0;28067
FR;1;2022-07-25;891;1634;9076;46124;984;7526;47497;0;680;42647340;41505715;26550774;4278616;42568144;28695147;4528048;0;28747
FR;1;2022-07-26;1136;1965;12683;81969;1121;10337;83584;0;1198;42648476;41507680;26563457;4360585;42569265;28705484;4611632;0;29945
FR;1;2022-07-27;1021;1730;9760;58521;1047;8138;59702;0;874;42649497;41509410;26573217;4419106;42570312;28713622;4671334;0;30819
FR;1;2022-07-28;983;1706;9857;61925;1114;7856;63149;0;967;42650480;41511116;26583074;4481031;42571426;28721478;4734483;0;31786
FR;1;2022-07-29;1112;1845;10461;62992;1171;8385;64306;0;1066;42651592;41512961;26593535;4544023;42572597;28729863;4798789;0;32852
FR;1;2022-07-30;395;727;3349;14491;442;2850;14851;0;279;42651987;41513688;26596884;4558514;42573039;28732713;4813640;0;33131
FR;1;2022-07-31;141;264;900;2335;159;766;2477;0;47;42652128;41513952;26597784;4560849;42573198;28733479;4816117;0;33178
FR;1;2022-08-01;885;1474;7259;28968;1088;6121;29961;0;519;42653013;41515426;26605043;4589817;42574286;28739600;4846078;0;33697
FR;1;2022-08-02;931;1486;8239;54049;1001;6634;54688;0;1091;42653944;41516912;26613282;4643866;42575287;28746234;4900766;0;34788
FR;1;2022-08-03;738;1108;6157;37046;753;4939;37776;0;645;42654682;41518020;26619439;4680912;42576040;28751173;4938542;0;35433
FR;1;2022-08-04;651;1081;6264;41453;697;5058;42008;0;850;42655333;41519101;26625703;4722365;42576737;28756231;4980550;0;36283
FR;1;2022-08-05;747;1198;6766;43085;809;5436;43708;0;933;42656080;41520299;26632469;4765450;42577546;28761667;5024258;0;37216
FR;1;2022-08-06;277;466;1993;9000;306;1674;9192;0;218;42656357;41520765;26634462;4774450;42577852;28763341;5033450;0;37434
FR;1;2022-08-07;89;151;520;1558;107;436;1631;0;35;42656446;41520916;26634982;4776008;42577959;28763777;5035081;0;37469
FR;1;2022-08-08;605;1078;3807;21229;833;3141;21627;0;457;42657051;41521994;26638789;4797237;42578792;28766918;5056708;0;37926
FR;1;2022-08-09;669;1056;5683;38481;747;4558;38967;0;794;42657720;41523050;26644472;4835718;42579539;28771476;5095675;0;38720
FR;1;2022-08-10;572;1187;4435;26915;888;3636;27228;0;601;42658292;41524237;26648907;4862633;42580427;28775112;5122903;0;39321
FR;1;2022-08-11;566;920;4315;28212;634;3589;28540;0;634;42658858;41525157;26653222;4890845;42581061;28778701;5151443;0;39955
FR;1;2022-08-12;732;1044;4554;27171;720;3762;27583;0;668;42659590;41526201;26657776;4918016;42581781;28782463;5179026;0;40623
FR;1;2022-08-13;326;371;1248;5111;263;1066;5282;0;116;42659916;41526572;26659024;4923127;42582044;28783529;5184308;0;40739
FR;1;2022-08-14;67;115;277;871;96;236;941;0;24;42659983;41526687;26659301;4923998;42582140;28783765;5185249;0;40763
FR;1;2022-08-15;112;216;574;542;185;535;593;0;16;42660095;41526903;26659875;4924540;42582325;28784300;5185842;0;40779
FR;1;2022-08-16;551;953;3793;21491;712;3222;21692;0;582;42660646;41527856;26663668;4946031;42583037;28787522;5207534;0;41361
FR;1;2022-08-17;549;915;3769;22152;682;3195;22390;0;579;42661195;41528771;26667437;4968183;42583719;28790717;5229924;0;41940
FR;1;2022-08-18;562;899;3942;25455;700;3141;25677;0;630;42661757;41529670;26671379;4993638;42584419;28793858;5255601;0;42570
FR;1;2022-08-19;538;1050;4369;26547;749;3601;26855;0;732;42662295;41530720;26675748;5020185;42585168;28797459;5282456;0;43302
FR;1;2022-08-20;251;422;1290;5371;322;1107;5524;0;138;42662546;41531142;26677038;5025556;42585490;28798566;5287980;0;43440
FR;1;2022-08-21;84;112;287;990;77;253;1013;0;27;42662630;41531254;26677325;5026546;42585567;28798819;5288993;0;43467
FR;1;2022-08-22;511;900;3142;14956;673;2714;15232;0;411;42663141;41532154;26680467;5041502;42586240;28801533;5304225;0;43878
FR;1;2022-08-23;657;1064;4155;28323;748;3486;28405;0;830;42663798;41533218;26684622;5069825;42586988;28805019;5332630;0;44708
FR;1;2022-08-24;569;839;3405;19069;661;2774;19254;0;587;42664367;41534057;26688027;5088894;42587649;28807793;5351884;0;45295
FR;1;2022-08-25;565;937;3832;22919;654;3215;23148;0;655;42664932;41534994;26691859;5111813;42588303;28811008;5375032;0;45950
FR;1;2022-08-26;754;1137;4350;25157;810;3568;25532;0;745;42665686;41536131;26696209;5136970;42589113;28814576;5400564;0;46695
FR;1;2022-08-27;223;432;1324;5308;277;1191;5362;0;192;42665909;41536563;26697533;5142278;42589390;28815767;5405926;0;46887
FR;1;2022-08-28;113;147;298;900;106;280;949;0;33;42666022;41536710;26697831;5143178;42589496;28816047;5406875;0;46920
FR;1;2022-08-29;507;861;2979;14272;638;2519;14582;0;409;42666529;41537571;26700810;5157450;42590134;28818566;5421457;0;47329
FR;1;2022-08-30;746;1111;4626;27721;788;3776;28042;0;793;42667275;41538682;26705436;5185171;42590922;28822342;5449499;0;48122
FR;1;2022-08-31;587;835;3114;17243;614;2624;17505;0;483;42667862;41539517;26708550;5202414;42591536;28824966;5467004;0;48605
FR;1;2022-09-01;707;927;4333;21897;653;3693;22150;0;587;42668569;41540444;26712883;5224311;42592189;28828659;5489154;0;49192
FR;1;2022-09-02;901;1065;4887;27868;764;4084;28156;0;882;42669470;41541509;26717770;5252179;42592953;28832743;5517310;0;50074
FR;1;2022-09-03;323;511;1834;5876;349;1596;6105;0;174;42669793;41542020;26719604;5258055;42593302;28834339;5523415;0;50248
FR;1;2022-09-04;110;137;341;845;73;334;915;0;21;42669903;41542157;26719945;5258900;42593375;28834673;5524330;0;50269
FR;1;2022-09-05;731;873;3051;15698;697;2557;15982;0;499;42670634;41543030;26722996;5274598;42594072;28837230;5540312;0;50768
FR;1;2022-09-06;850;965;4572;31064;612;3712;31285;0;1002;42671484;41543995;26727568;5305662;42594684;28840942;5571597;0;51770
FR;1;2022-09-07;608;708;2921;16444;469;2426;16582;0;550;42672092;41544703;26730489;5322106;42595153;28843368;5588179;0;52320
FR;1;2022-09-08;585;796;3701;24224;543;3041;24305;0;796;42672677;41545499;26734190;5346330;42595696;28846409;5612484;0;53116
FR;1;2022-09-09;783;995;4307;26897;637;3597;27078;0;903;42673460;41546494;26738497;5373227;42596333;28850006;5639562;0;54019
FR;1;2022-09-10;351;579;1680;5590;410;1480;5782;0;203;42673811;41547073;26740177;5378817;42596743;28851486;5645344;0;54222
FR;1;2022-09-11;106;120;313;646;82;293;703;0;17;42673917;41547193;26740490;5379463;42596825;28851779;5646047;0;54239
FR;1;2022-09-12;485;605;2617;12955;426;2234;13235;0;462;42674402;41547798;26743107;5392418;42597251;28854013;5659282;0;54701
FR;1;2022-09-13;651;831;3873;25850;542;3386;25721;0;834;42675053;41548629;26746980;5418268;42597793;28857399;5685003;0;55535
FR;1;2022-09-14;626;725;2881;15702;509;2412;15938;0;537;42675679;41549354;26749861;5433970;42598302;28859811;5700941;0;56072
FR;1;2022-09-15;532;778;3345;23093;550;2851;23157;0;679;42676211;41550132;26753206;5457063;42598852;28862662;5724098;0;56751
FR;1;2022-09-16;726;947;4021;25351;630;3393;25550;0;891;42676937;41551079;26757227;5482414;42599482;28866055;5749648;0;57642
FR;1;2022-09-17;303;428;1397;5979;300;1222;6087;0;227;42677240;41551507;26758624;5488393;42599782;28867277;5755735;0;57869
FR;1;2022-09-18;99;126;311;924;103;279;980;0;34;42677339;41551633;26758935;5489317;42599885;28867556;5756715;0;57903
FR;1;2022-09-19;400;577;2142;12865;379;1837;13018;0;415;42677739;41552210;26761077;5502182;42600264;28869393;5769733;0;58318
FR;1;2022-09-20;564;841;3670;25830;589;3067;25870;0;854;42678303;41553051;26764747;5528012;42600853;28872460;5795603;0;59172
FR;1;2022-09-21;485;691;2628;15863;491;2256;15827;0;561;42678788;41553742;26767375;5543875;42601344;28874716;5811430;0;59733
FR;1;2022-09-22;549;779;3297;23009;517;2707;23187;0;745;42679337;41554521;26770672;5566884;42601861;28877423;5834617;0;60478
FR;1;2022-09-23;768;946;4353;28164;681;3634;28327;0;981;42680105;41555467;26775025;5595048;42602542;28881057;5862944;0;61459
FR;1;2022-09-24;357;540;1591;6706;379;1374;6880;0;300;42680462;41556007;26776616;5601754;42602921;28882431;5869824;0;61759
FR;1;2022-09-25;81;157;321;1072;111;293;1110;0;32;42680543;41556164;26776937;5602826;42603032;28882724;5870934;0;61791
FR;1;2022-09-26;382;654;2183;13078;432;1935;13172;0;412;42680925;41556818;26779120;5615904;42603464;28884659;5884106;0;62203
FR;1;2022-09-27;545;768;3458;25025;542;2794;25223;0;906;42681470;41557586;26782578;5640929;42604006;28887453;5909329;0;63109
FR;1;2022-09-28;525;720;2448;14971;507;2217;15060;0;597;42681995;41558306;26785026;5655900;42604513;28889670;5924389;0;63706
FR;1;2022-09-29;504;699;3003;20372;488;2527;20388;0;767;42682499;41559005;26788029;5676272;42605001;28892197;5944777;0;64473
FR;1;2022-09-30;694;996;3777;24429;705;3160;24678;0;970;42683193;41560001;26791806;5700701;42605706;28895357;5969455;0;65443
FR;1;2022-10-01;352;648;1905;5507;484;1659;5733;0;273;42683545;41560649;26793711;5706208;42606190;28897016;5975188;0;65716
FR;1;2022-10-02;56;120;204;568;82;204;589;0;29;42683601;41560769;26793915;5706776;42606272;28897220;5975777;0;65745
FR;1;2022-10-03;575;880;2226;10042;725;1986;10210;0;489;42684176;41561649;26796141;5716818;42606997;28899206;5985987;0;66234
FR;1;2022-10-04;683;740;2930;18922;508;2482;19010;0;1086;42684859;41562389;26799071;5735740;42607505;28901688;6004997;0;67320
FR;1;2022-10-05;489;727;2099;11114;501;1872;11243;0;723;42685348;41563116;26801170;5746854;42608006;28903560;6016240;0;68043
FR;1;2022-10-06;452;644;2498;15778;466;2063;15959;0;1063;42685800;41563760;26803668;5762632;42608472;28905623;6032199;0;69106
FR;1;2022-10-07;559;774;2694;16069;572;2311;16092;0;1164;42686359;41564534;26806362;5778701;42609044;28907934;6048291;0;70270
FR;1;2022-10-08;242;315;888;3171;248;776;3276;0;292;42686601;41564849;26807250;5781872;42609292;28908710;6051567;0;70562
FR;1;2022-10-09;76;93;151;461;83;135;487;0;51;42686677;41564942;26807401;5782333;42609375;28908845;6052054;0;70613
FR;1;2022-10-10;315;577;1324;4999;484;1240;5096;0;463;42686992;41565519;26808725;5787332;42609859;28910085;6057150;0;71076
FR;1;2022-10-11;339;457;1316;8087;343;1198;8188;0;758;42687331;41565976;26810041;5795419;42610202;28911283;6065338;0;71834
FR;1;2022-10-12;348;481;1078;5223;367;1076;5240;0;523;42687679;41566457;26811119;5800642;42610569;28912359;6070578;0;72357
FR;1;2022-10-13;338;450;1079;6099;360;936;6146;0;630;42688017;41566907;26812198;5806741;42610929;28913295;6076724;0;72987
FR;1;2022-10-14;413;554;1176;6712;468;1050;6781;0;676;42688430;41567461;26813374;5813453;42611397;28914345;6083505;0;73663
FR;1;2022-10-15;212;350;532;1860;302;515;1868;0;226;42688642;41567811;26813906;5815313;42611699;28914860;6085373;0;73889
FR;1;2022-10-16;47;68;111;296;49;118;315;0;48;42688689;41567879;26814017;5815609;42611748;28914978;6085688;0;73937
FR;1;2022-10-17;237;336;742;2653;268;698;2698;0;366;42688926;41568215;26814759;5818262;42612016;28915676;6088386;0;74303
FR;1;2022-10-18;266;319;956;4596;257;833;4700;0;866;42689192;41568534;26815715;5822858;42612273;28916509;6093086;0;75169
FR;1;2022-10-19;286;406;698;3187;339;667;3166;0;504;42689478;41568940;26816413;5826045;42612612;28917176;6096252;0;75673
FR;1;2022-10-20;289;357;904;4375;304;796;4410;0;771;42689767;41569297;26817317;5830420;42612916;28917972;6100662;0;76444
FR;1;2022-10-21;304;421;847;3807;372;743;3879;0;675;42690071;41569718;26818164;5834227;42613288;28918715;6104541;0;77119
FR;1;2022-10-22;135;184;307;1253;163;301;1218;0;210;42690206;41569902;26818471;5835480;42613451;28919016;6105759;0;77329
FR;1;2022-10-23;34;43;65;197;41;59;213;0;25;42690240;41569945;26818536;5835677;42613492;28919075;6105972;0;77354
FR;1;2022-10-24;273;238;479;1603;206;476;1660;0;306;42690513;41570183;26819015;5837280;42613698;28919551;6107632;0;77660
FR;1;2022-10-25;223;258;528;2651;227;449;2707;0;487;42690736;41570441;26819543;5839931;42613925;28920000;6110339;0;78147
FR;1;2022-10-26;236;251;394;1958;240;371;1965;0;439;42690972;41570692;26819937;5841889;42614165;28920371;6112304;0;78586
FR;1;2022-10-27;260;235;491;2169;207;510;2153;0;518;42691232;41570927;26820428;5844058;42614372;28920881;6114457;0;79104
FR;1;2022-10-28;313;336;534;2335;316;471;2402;0;478;42691545;41571263;26820962;5846393;42614688;28921352;6116859;0;79582
FR;1;2022-10-29;99;159;176;717;129;210;709;0;203;42691644;41571422;26821138;5847110;42614817;28921562;6117568;0;79785
FR;1;2022-10-30;38;52;62;184;44;56;189;0;38;42691682;41571474;26821200;5847294;42614861;28921618;6117757;0;79823
FR;1;2022-10-31;136;189;295;796;168;273;863;0;143;42691818;41571663;26821495;5848090;42615029;28921891;6118620;0;79966
FR;1;2022-11-01;77;135;768;115;117;768;134;0;19;42691895;41571798;26822263;5848205;42615146;28922659;6118754;0;79985
FR;1;2022-11-02;269;246;531;985;242;497;1048;0;356;42692164;41572044;26822794;5849190;42615388;28923156;6119802;0;80341
FR;1;2022-11-03;272;239;442;1380;224;404;1418;0;377;42692436;41572283;26823236;5850570;42615612;28923560;6121220;0;80718
FR;1;2022-11-04;233;262;424;1597;242;401;1637;0;438;42692669;41572545;26823660;5852167;42615854;28923961;6122857;0;81156
FR;1;2022-11-05;100;147;273;503;136;255;525;0;111;42692769;41572692;26823933;5852670;42615990;28924216;6123382;0;81267
FR;1;2022-11-06;36;49;32;131;48;35;129;0;33;42692805;41572741;26823965;5852801;42616038;28924251;6123511;0;81300
FR;1;2022-11-07;226;288;326;899;276;319;944;0;212;42693031;41573029;26824291;5853700;42616314;28924570;6124455;0;81512
FR;1;2022-11-08;240;268;472;1709;256;418;1738;0;524;42693271;41573297;26824763;5855409;42616570;28924988;6126193;0;82036
FR;1;2022-11-09;197;258;337;1104;248;303;1141;0;478;42693468;41573555;26825100;5856513;42616818;28925291;6127334;0;82514
FR;1;2022-11-10;216;394;437;1681;386;445;1670;0;605;42693684;41573949;26825537;5858194;42617204;28925736;6129004;0;83119
FR;1;2022-11-11;34;48;105;101;45;92;115;0;45;42693718;41573997;26825642;5858295;42617249;28925828;6129119;0;83164
FR;1;2022-11-12;95;152;257;375;138;257;390;0;101;42693813;41574149;26825899;5858670;42617387;28926085;6129509;0;83265
FR;1;2022-11-13;27;57;28;64;54;31;66;0;26;42693840;41574206;26825927;5858734;42617441;28926116;6129575;0;83291
FR;1;2022-11-14;175;184;271;770;172;275;840;0;235;42694015;41574390;26826198;5859504;42617613;28926391;6130415;0;83526
FR;1;2022-11-15;228;406;395;1300;405;373;1338;0;436;42694243;41574796;26826593;5860804;42618018;28926764;6131753;0;83962
FR;1;2022-11-16;197;273;336;983;267;350;1017;0;359;42694440;41575069;26826929;5861787;42618285;28927114;6132770;0;84321
FR;1;2022-11-17;171;213;297;1207;207;273;1211;0;388;42694611;41575282;26827226;5862994;42618492;28927387;6133981;0;84709
FR;1;2022-11-18;231;269;394;1315;261;383;1349;0;412;42694842;41575551;26827620;5864309;42618753;28927770;6135330;0;85121
FR;1;2022-11-19;120;115;249;441;114;214;474;0;102;42694962;41575666;26827869;5864750;42618867;28927984;6135804;0;85223
FR;1;2022-11-20;35;129;32;66;125;34;74;0;28;42694997;41575795;26827901;5864816;42618992;28928018;6135878;0;85251
FR;1;2022-11-21;174;173;271;641;146;288;678;0;211;42695171;41575968;26828172;5865457;42619138;28928306;6136556;0;85462
FR;1;2022-11-22;158;169;417;1160;152;398;1185;0;409;42695329;41576137;26828589;5866617;42619290;28928704;6137741;0;85871
FR;1;2022-11-23;180;186;246;763;171;247;786;0;241;42695509;41576323;26828835;5867380;42619461;28928951;6138527;0;86112
FR;1;2022-11-24;138;171;288;1214;151;301;1219;0;442;42695647;41576494;26829123;5868594;42619612;28929252;6139746;0;86554
FR;1;2022-11-25;210;249;429;1160;235;418;1194;0;392;42695857;41576743;26829552;5869754;42619847;28929670;6140940;0;86946
FR;1;2022-11-26;90;109;113;323;101;125;311;0;118;42695947;41576852;26829665;5870077;42619948;28929795;6141251;0;87064
FR;1;2022-11-27;18;38;22;72;25;34;78;0;49;42695965;41576890;26829687;5870149;42619973;28929829;6141329;0;87113
FR;1;2022-11-28;212;147;209;665;155;205;709;0;332;42696177;41577037;26829896;5870814;42620128;28930034;6142038;0;87445
FR;1;2022-11-29;172;145;269;1107;130;251;1119;0;458;42696349;41577182;26830165;5871921;42620258;28930285;6143157;0;87903
FR;1;2022-11-30;161;211;235;940;197;238;962;0;325;42696510;41577393;26830400;5872861;42620455;28930523;6144119;0;88228
FR;1;2022-12-01;199;162;717;1097;150;682;1146;0;379;42696709;41577555;26831117;5873958;42620605;28931205;6145265;0;88607
FR;1;2022-12-02;201;199;517;1187;194;513;1236;0;471;42696910;41577754;26831634;5875145;42620799;28931718;6146501;0;89078
FR;1;2022-12-03;102;112;263;532;100;240;530;0;180;42697012;41577866;26831897;5875677;42620899;28931958;6147031;0;89258
FR;1;2022-12-04;27;28;19;138;25;20;129;0;58;42697039;41577894;26831916;5875815;42620924;28931978;6147160;0;89316
FR;1;2022-12-05;148;171;308;868;167;303;902;0;318;42697187;41578065;26832224;5876683;42621091;28932281;6148062;0;89634
FR;1;2022-12-06;156;176;277;1449;162;282;1455;0;739;42697343;41578241;26832501;5878132;42621253;28932563;6149517;0;90373
FR;1;2022-12-07;155;173;256;1187;182;236;1203;0;576;42697498;41578414;26832757;5879319;42621435;28932799;6150720;0;90949
FR;1;2022-12-08;131;145;302;1757;137;259;1798;0;765;42697629;41578559;26833059;5881076;42621572;28933058;6152518;0;91714
FR;1;2022-12-09;202;197;357;1817;170;365;1838;0;721;42697831;41578756;26833416;5882893;42621742;28933423;6154356;0;92435
FR;1;2022-12-10;117;154;341;856;141;324;877;0;292;42697948;41578910;26833757;5883749;42621883;28933747;6155233;0;92727
FR;1;2022-12-11;32;30;32;219;27;30;201;0;62;42697980;41578940;26833789;5883968;42621910;28933777;6155434;0;92789
FR;1;2022-12-12;130;108;297;1101;105;284;1113;0;459;42698110;41579048;26834086;5885069;42622015;28934061;6156547;0;93248
FR;1;2022-12-13;126;134;293;1307;108;268;1321;0;618;42698236;41579182;26834379;5886376;42622123;28934329;6157868;0;93866
FR;1;2022-12-14;105;160;256;867;154;235;892;0;372;42698341;41579342;26834635;5887243;42622277;28934564;6158760;0;94238
FR;1;2022-12-15;141;183;457;1492;170;427;1518;0;691;42698482;41579525;26835092;5888735;42622447;28934991;6160278;0;94929
FR;1;2022-12-16;206;217;569;1344;220;553;1367;0;623;42698688;41579742;26835661;5890079;42622667;28935544;6161645;0;95552
FR;1;2022-12-17;88;93;224;468;82;219;476;0;204;42698776;41579835;26835885;5890547;42622749;28935763;6162121;0;95756
FR;1;2022-12-18;17;22;29;113;19;31;109;0;37;42698793;41579857;26835914;5890660;42622768;28935794;6162230;0;95793
FR;1;2022-12-19;151;133;251;791;141;221;835;0;382;42698944;41579990;26836165;5891451;42622909;28936015;6163065;0;96175
FR;1;2022-12-20;149;163;355;906;150;349;912;0;428;42699093;41580153;26836520;5892357;42623059;28936364;6163977;0;96603
FR;1;2022-12-21;139;112;218;638;122;183;647;0;388;42699232;41580265;26836738;5892995;42623181;28936547;6164624;0;96991
FR;1;2022-12-22;148;111;165;552;121;150;543;0;329;42699380;41580376;26836903;5893547;42623302;28936697;6165167;0;97320
FR;1;2022-12-23;130;157;459;419;142;449;426;0;182;42699510;41580533;26837362;5893966;42623444;28937146;6165593;0;97502
FR;1;2022-12-24;30;27;34;56;29;33;63;0;21;42699540;41580560;26837396;5894022;42623473;28937179;6165656;0;97523
FR;1;2022-12-25;4;11;20;12;12;14;15;0;11;42699544;41580571;26837416;5894034;42623485;28937193;6165671;0;97534
FR;1;2022-12-26;94;90;248;251;89;253;257;0;93;42699638;41580661;26837664;5894285;42623574;28937446;6165928;0;97627
FR;1;2022-12-27;117;160;311;387;151;317;402;0;180;42699755;41580821;26837975;5894672;42623725;28937763;6166330;0;97807
FR;1;2022-12-28;107;147;204;270;133;207;281;0;126;42699862;41580968;26838179;5894942;42623858;28937970;6166611;0;97933
FR;1;2022-12-29;105;112;154;282;112;153;303;0;114;42699967;41581080;26838333;5895224;42623970;28938123;6166914;0;98047
FR;1;2022-12-30;127;123;89;258;115;94;268;0;143;42700094;41581203;26838422;5895482;42624085;28938217;6167182;0;98190
FR;1;2022-12-31;38;35;28;79;40;25;79;0;25;42700132;41581238;26838450;5895561;42624125;28938242;6167261;0;98215
FR;1;2023-01-01;6;13;61;22;12;58;27;0;10;42700138;41581251;26838511;5895583;42624137;28938300;6167288;0;98225
FR;1;2023-01-02;615;158;679;170;166;658;196;0;64;42700753;41581409;26839190;5895753;42624303;28938958;6167484;0;98289
FR;1;2023-01-03;167;112;373;208;111;366;215;0;149;42700920;41581521;26839563;5895961;42624414;28939324;6167699;0;98438
FR;1;2023-01-04;96;101;250;198;102;251;208;0;194;42701016;41581622;26839813;5896159;42624516;28939575;6167907;0;98632
FR;1;2023-01-05;147;133;179;337;143;179;339;0;206;42701163;41581755;26839992;5896496;42624659;28939754;6168246;0;98838
FR;1;2023-01-06;200;144;226;325;147;212;350;0;230;42701363;41581899;26840218;5896821;42624806;28939966;6168596;0;99068
FR;1;2023-01-07;107;89;175;148;92;158;165;0;93;42701470;41581988;26840393;5896969;42624898;28940124;6168761;0;99161
FR;1;2023-01-08;27;19;31;59;18;26;64;0;24;42701497;41582007;26840424;5897028;42624916;28940150;6168825;0;99185
FR;1;2023-01-09;140;130;136;135;126;144;153;0;115;42701637;41582137;26840560;5897163;42625042;28940294;6168978;0;99300
FR;1;2023-01-10;119;145;285;277;142;292;278;0;192;42701756;41582282;26840845;5897440;42625184;28940586;6169256;0;99492
FR;1;2023-01-11;107;112;92;209;121;95;222;0;96;42701863;41582394;26840937;5897649;42625305;28940681;6169478;0;99588
FR;1;2023-01-12;137;123;215;243;118;215;268;0;166;42702000;41582517;26841152;5897892;42625423;28940896;6169746;0;99754
FR;1;2023-01-13;258;169;174;286;167;173;306;0;190;42702258;41582686;26841326;5898178;42625590;28941069;6170052;0;99944
FR;1;2023-01-14;89;64;162;104;66;172;103;0;62;42702347;41582750;26841488;5898282;42625656;28941241;6170155;0;100006
FR;1;2023-01-15;23;38;31;42;35;31;46;0;30;42702370;41582788;26841519;5898324;42625691;28941272;6170201;0;100036
FR;1;2023-01-16;113;107;310;155;102;314;133;0;101;42702483;41582895;26841829;5898479;42625793;28941586;6170334;0;100137
FR;1;2023-01-17;114;103;167;216;102;164;243;0;128;42702597;41582998;26841996;5898695;42625895;28941750;6170577;0;100265
FR;1;2023-01-18;99;90;97;143;89;92;184;0;122;42702696;41583088;26842093;5898838;42625984;28941842;6170761;0;100387
FR;1;2023-01-19;112;78;106;134;76;118;134;0;136;42702808;41583166;26842199;5898972;42626060;28941960;6170895;0;100523
FR;1;2023-01-20;170;150;168;280;151;196;269;0;210;42702978;41583316;26842367;5899252;42626211;28942156;6171164;0;100733
FR;1;2023-01-21;58;71;91;85;71;102;75;0;35;42703036;41583387;26842458;5899337;42626282;28942258;6171239;0;100768
FR;1;2023-01-22;10;9;14;21;7;9;26;0;14;42703046;41583396;26842472;5899358;42626289;28942267;6171265;0;100782
FR;1;2023-01-23;88;85;108;100;89;100;119;0;85;42703134;41583481;26842580;5899458;42626378;28942367;6171384;0;100867
FR;1;2023-01-24;123;76;73;122;89;70;131;0;183;42703257;41583557;26842653;5899580;42626467;28942437;6171515;0;101050
FR;1;2023-01-25;98;119;79;109;120;78;127;0;108;42703355;41583676;26842732;5899689;42626587;28942515;6171642;0;101158
FR;1;2023-01-26;104;105;63;152;94;68;173;0;108;42703459;41583781;26842795;5899841;42626681;28942583;6171815;0;101266
FR;1;2023-01-27;172;606;105;139;621;123;140;0;201;42703631;41584387;26842900;5899980;42627302;28942706;6171955;0;101467
FR;1;2023-01-28;73;74;56;45;76;53;53;0;39;42703704;41584461;26842956;5900025;42627378;28942759;6172008;0;101506
FR;1;2023-01-29;12;22;33;10;20;31;16;0;12;42703716;41584483;26842989;5900035;42627398;28942790;6172024;0;101518
FR;1;2023-01-30;144;109;64;75;114;70;84;0;55;42703860;41584592;26843053;5900110;42627512;28942860;6172108;0;101573
FR;1;2023-01-31;122;87;66;137;76;69;149;0;143;42703982;41584679;26843119;5900247;42627588;28942929;6172257;0;101716
FR;1;2023-02-01;122;149;345;106;148;338;134;0;77;42704104;41584828;26843464;5900353;42627736;28943267;6172391;0;101793
FR;1;2023-02-02;88;101;91;106;95;99;108;0;99;42704192;41584929;26843555;5900459;42627831;28943366;6172499;0;101892
FR;1;2023-02-03;156;148;133;98;148;139;104;0;97;42704348;41585077;26843688;5900557;42627979;28943505;6172603;0;101989
FR;1;2023-02-04;50;78;72;46;85;74;47;0;24;42704398;41585155;26843760;5900603;42628064;28943579;6172650;0;102013
FR;1;2023-02-05;6;8;19;6;7;22;7;0;8;42704404;41585163;26843779;5900609;42628071;28943601;6172657;0;102021
FR;1;2023-02-06;96;80;115;77;86;118;81;0;89;42704500;41585243;26843894;5900686;42628157;28943719;6172738;0;102110
FR;1;2023-02-07;92;78;97;77;79;91;97;0;115;42704592;41585321;26843991;5900763;42628236;28943810;6172835;0;102225
FR;1;2023-02-08;83;93;64;31;92;68;36;0;51;42704675;41585414;26844055;5900794;42628328;28943878;6172871;0;102276
FR;1;2023-02-09;65;65;83;59;75;82;67;0;79;42704740;41585479;26844138;5900853;42628403;28943960;6172938;0;102355
FR;1;2023-02-10;142;133;57;72;136;69;73;0;118;42704882;41585612;26844195;5900925;42628539;28944029;6173011;0;102473
FR;1;2023-02-11;45;53;78;25;50;87;27;0;11;42704927;41585665;26844273;5900950;42628589;28944116;6173038;0;102484
FR;1;2023-02-12;11;9;10;8;13;10;9;0;9;42704938;41585674;26844283;5900958;42628602;28944126;6173047;0;102493
FR;1;2023-02-13;97;119;47;42;120;54;34;0;31;42705035;41585793;26844330;5901000;42628722;28944180;6173081;0;102524
FR;1;2023-02-14;69;73;73;50;72;77;47;0;77;42705104;41585866;26844403;5901050;42628794;28944257;6173128;0;102601
FR;1;2023-02-15;76;103;77;52;111;83;60;0;81;42705180;41585969;26844480;5901102;42628905;28944340;6173188;0;102682
FR;1;2023-02-16;60;75;114;83;63;123;86;0;73;42705240;41586044;26844594;5901185;42628968;28944463;6173274;0;102755
FR;1;2023-02-17;105;125;172;61;130;176;70;0;47;42705345;41586169;26844766;5901246;42629098;28944639;6173344;0;102802
FR;1;2023-02-18;44;57;147;41;57;153;43;0;9;42705389;41586226;26844913;5901287;42629155;28944792;6173387;0;102811
FR;1;2023-02-19;14;0;6;4;2;5;4;0;5;42705403;41586226;26844919;5901291;42629157;28944797;6173391;0;102816
FR;1;2023-02-20;77;73;52;28;77;57;32;0;16;42705480;41586299;26844971;5901319;42629234;28944854;6173423;0;102832
FR;1;2023-02-21;62;74;54;49;78;57;47;0;38;42705542;41586373;26845025;5901368;42629312;28944911;6173470;0;102870
FR;1;2023-02-22;65;77;32;18;79;36;18;0;22;42705607;41586450;26845057;5901386;42629391;28944947;6173488;0;102892
FR;1;2023-02-23;52;79;48;36;77;58;31;0;54;42705659;41586529;26845105;5901422;42629468;28945005;6173519;0;102946
FR;1;2023-02-24;95;111;48;33;112;56;34;0;38;42705754;41586640;26845153;5901455;42629580;28945061;6173553;0;102984
FR;1;2023-02-25;42;49;69;22;56;69;24;0;26;42705796;41586689;26845222;5901477;42629636;28945130;6173577;0;103010
FR;1;2023-02-26;2;4;1;2;2;3;1;0;3;42705798;41586693;26845223;5901479;42629638;28945133;6173578;0;103013
FR;1;2023-02-27;91;77;62;35;77;70;32;0;21;42705889;41586770;26845285;5901514;42629715;28945203;6173610;0;103034
FR;1;2023-02-28;87;72;35;50;68;45;52;0;33;42705976;41586842;26845320;5901564;42629783;28945248;6173662;0;103067
FR;1;2023-03-01;73;90;242;52;88;234;69;0;42;42706049;41586932;26845562;5901616;42629871;28945482;6173731;0;103109
FR;1;2023-03-02;65;64;91;56;65;87;68;0;117;42706114;41586996;26845653;5901672;42629936;28945569;6173799;0;103226
FR;1;2023-03-03;107;108;72;53;107;70;57;0;47;42706221;41587104;26845725;5901725;42630043;28945639;6173856;0;103273
FR;1;2023-03-04;51;46;70;26;43;71;31;0;15;42706272;41587150;26845795;5901751;42630086;28945710;6173887;0;103288
FR;1;2023-03-05;4;2;5;0;3;5;1;0;0;42706276;41587152;26845800;5901751;42630089;28945715;6173888;0;103288
FR;1;2023-03-06;86;57;79;17;63;85;23;0;14;42706362;41587209;26845879;5901768;42630152;28945800;6173911;0;103302
FR;1;2023-03-07;53;71;47;40;68;45;50;0;71;42706415;41587280;26845926;5901808;42630220;28945845;6173961;0;103373
FR;1;2023-03-08;47;65;32;16;68;34;22;0;6;42706462;41587345;26845958;5901824;42630288;28945879;6173983;0;103379
FR;1;2023-03-09;38;55;45;22;49;50;31;0;30;42706500;41587400;26846003;5901846;42630337;28945929;6174014;0;103409
FR;1;2023-03-10;93;97;85;41;97;89;46;0;25;42706593;41587497;26846088;5901887;42630434;28946018;6174060;0;103434
FR;1;2023-03-11;47;39;51;9;33;57;13;0;6;42706640;41587536;26846139;5901896;42630467;28946075;6174073;0;103440
FR;1;2023-03-12;2;11;7;0;13;6;1;0;0;42706642;41587547;26846146;5901896;42630480;28946081;6174074;0;103440
FR;1;2023-03-13;50;73;40;15;68;48;14;0;19;42706692;41587620;26846186;5901911;42630548;28946129;6174088;0;103459
FR;1;2023-03-14;68;49;55;21;53;59;23;0;31;42706760;41587669;26846241;5901932;42630601;28946188;6174111;0;103490
FR;1;2023-03-15;41;70;81;95;69;78;68;0;47;42706801;41587739;26846322;5902027;42630670;28946266;6174179;0;103537
FR;1;2023-03-16;55;49;88;25;53;87;28;0;20;42706856;41587788;26846410;5902052;42630723;28946353;6174207;0;103557
FR;1;2023-03-17;109;89;101;37;103;104;41;0;35;42706965;41587877;26846511;5902089;42630826;28946457;6174248;0;103592
FR;1;2023-03-18;34;33;144;10;28;148;15;0;5;42706999;41587910;26846655;5902099;42630854;28946605;6174263;0;103597
FR;1;2023-03-19;11;5;2;2;6;2;3;0;0;42707010;41587915;26846657;5902101;42630860;28946607;6174266;0;103597
FR;1;2023-03-20;45;61;49;29;51;58;33;0;24;42707055;41587976;26846706;5902130;42630911;28946665;6174299;0;103621
FR;1;2023-03-21;74;62;42;11;67;45;16;0;26;42707129;41588038;26846748;5902141;42630978;28946710;6174315;0;103647
FR;1;2023-03-22;58;54;37;31;54;51;26;0;13;42707187;41588092;26846785;5902172;42631032;28946761;6174341;0;103660
FR;1;2023-03-23;59;47;37;23;48;41;25;0;47;42707246;41588139;26846822;5902195;42631080;28946802;6174366;0;103707
FR;1;2023-03-24;77;103;190;29;106;196;35;0;23;42707323;41588242;26847012;5902224;42631186;28946998;6174401;0;103730
FR;1;2023-03-25;47;51;48;11;48;52;15;0;6;42707370;41588293;26847060;5902235;42631234;28947050;6174416;0;103736
FR;1;2023-03-26;2;3;9;0;0;10;2;0;2;42707372;41588296;26847069;5902235;42631234;28947060;6174418;0;103738
FR;1;2023-03-27;104;58;68;11;61;71;15;0;22;42707476;41588354;26847137;5902246;42631295;28947131;6174433;0;103760
FR;1;2023-03-28;48;38;23;21;41;25;21;0;31;42707524;41588392;26847160;5902267;42631336;28947156;6174454;0;103791
FR;1;2023-03-29;55;46;31;28;45;38;25;0;14;42707579;41588438;26847191;5902295;42631381;28947194;6174479;0;103805
FR;1;2023-03-30;56;42;58;19;45;57;26;0;30;42707635;41588480;26847249;5902314;42631426;28947251;6174505;0;103835
FR;1;2023-03-31;66;84;28;16;82;34;13;0;35;42707701;41588564;26847277;5902330;42631508;28947285;6174518;0;103870
FR;1;2023-04-01;29;53;127;10;50;129;17;0;10;42707730;41588617;26847404;5902340;42631558;28947414;6174535;0;103880
FR;1;2023-04-02;1;1;8;0;1;7;1;0;0;42707731;41588618;26847412;5902340;42631559;28947421;6174536;0;103880
FR;1;2023-04-03;91;51;148;29;46;150;35;0;19;42707822;41588669;26847560;5902369;42631605;28947571;6174571;0;103899
FR;1;2023-04-04;40;52;40;11;44;47;12;0;25;42707862;41588721;26847600;5902380;42631649;28947618;6174583;0;103924
FR;1;2023-04-05;25;41;33;19;38;27;27;0;14;42707887;41588762;26847633;5902399;42631687;28947645;6174610;0;103938
FR;1;2023-04-06;43;45;33;11;42;35;16;0;15;42707930;41588807;26847666;5902410;42631729;28947680;6174626;0;103953
FR;1;2023-04-07;49;63;33;17;63;37;16;0;13;42707979;41588870;26847699;5902427;42631792;28947717;6174642;0;103966
FR;1;2023-04-08;25;32;11;13;25;18;13;0;13;42708004;41588902;26847710;5902440;42631817;28947735;6174655;0;103979
FR;1;2023-04-09;5;2;0;2;1;1;2;0;1;42708009;41588904;26847710;5902442;42631818;28947736;6174657;0;103980
FR;1;2023-04-10;5;15;22;1;15;24;1;0;1;42708014;41588919;26847732;5902443;42631833;28947760;6174658;0;103981
FR;1;2023-04-11;40;52;22;12;51;21;14;0;17;42708054;41588971;26847754;5902455;42631884;28947781;6174672;0;103998
FR;1;2023-04-12;36;35;36;19;33;41;22;0;24;42708090;41589006;26847790;5902474;42631917;28947822;6174694;0;104022
FR;1;2023-04-13;36;41;20;16;42;25;14;0;26;42708126;41589047;26847810;5902490;42631959;28947847;6174708;0;104048
FR;1;2023-04-14;59;69;132;15;78;126;22;0;17;42708185;41589116;26847942;5902505;42632037;28947973;6174730;0;104065
FR;1;2023-04-15;28;28;36;10;28;39;12;0;2;42708213;41589144;26847978;5902515;42632065;28948012;6174742;0;104067
FR;1;2023-04-16;3;2;0;0;2;0;0;0;0;42708216;41589146;26847978;5902515;42632067;28948012;6174742;0;104067
FR;1;2023-04-17;37;39;61;16;42;66;15;0;11;42708253;41589185;26848039;5902531;42632109;28948078;6174757;0;104078
FR;1;2023-04-18;37;40;27;7;35;41;12;0;24;42708290;41589225;26848066;5902538;42632144;28948119;6174769;0;104102
FR;1;2023-04-19;36;57;13;9;57;14;11;0;14;42708326;41589282;26848079;5902547;42632201;28948133;6174780;0;104116
FR;1;2023-04-20;27;40;39;16;41;40;17;0;15;42708353;41589322;26848118;5902563;42632242;28948173;6174797;0;104131
FR;1;2023-04-21;46;63;116;17;60;118;21;0;18;42708399;41589385;26848234;5902580;42632302;28948291;6174818;0;104149
FR;1;2023-04-22;19;23;34;9;20;39;9;0;4;42708418;41589408;26848268;5902589;42632322;28948330;6174827;0;104153
FR;1;2023-04-23;1;1;2;1;1;2;1;0;0;42708419;41589409;26848270;5902590;42632323;28948332;6174828;0;104153
FR;1;2023-04-24;58;39;29;5;38;33;6;0;9;42708477;41589448;26848299;5902595;42632361;28948365;6174834;0;104162
FR;1;2023-04-25;31;34;22;16;30;23;20;0;15;42708508;41589482;26848321;5902611;42632391;28948388;6174854;0;104177
FR;1;2023-04-26;31;24;9;6;24;14;8;0;8;42708539;41589506;26848330;5902617;42632415;28948402;6174862;0;104185
FR;1;2023-04-27;32;36;31;25;31;36;28;0;12;42708571;41589542;26848361;5902642;42632446;28948438;6174890;0;104197
FR;1;2023-04-28;70;53;22;14;47;28;20;0;11;42708641;41589595;26848383;5902656;42632493;28948466;6174910;0;104208
FR;1;2023-04-29;19;19;14;7;18;12;11;0;9;42708660;41589614;26848397;5902663;42632511;28948478;6174921;0;104217
FR;1;2023-04-30;6;0;0;1;0;0;1;0;0;42708666;41589614;26848397;5902664;42632511;28948478;6174922;0;104217
FR;1;2023-05-01;0;13;44;1;12;45;1;0;0;42708666;41589627;26848441;5902665;42632523;28948523;6174923;0;104217
FR;1;2023-05-02;94;54;132;12;58;127;24;0;19;42708760;41589681;26848573;5902677;42632581;28948650;6174947;0;104236
FR;1;2023-05-03;51;29;42;5;26;46;7;0;10;42708811;41589710;26848615;5902682;42632607;28948696;6174954;0;104246
FR;1;2023-05-04;19;33;64;26;33;83;35;0;18;42708830;41589743;26848679;5902708;42632640;28948779;6174989;0;104264
FR;1;2023-05-05;27;31;20;3;32;16;7;0;9;42708857;41589774;26848699;5902711;42632672;28948795;6174996;0;104273
FR;1;2023-05-06;11;7;7;3;8;8;4;0;7;42708868;41589781;26848706;5902714;42632680;28948803;6175000;0;104280
FR;1;2023-05-07;2;2;4;4;2;3;2;0;1;42708870;41589783;26848710;5902718;42632682;28948806;6175002;0;104281
FR;1;2023-05-08;7;4;5;1;3;6;1;0;0;42708877;41589787;26848715;5902719;42632685;28948812;6175003;0;104281
FR;1;2023-05-09;14;17;12;3;14;13;6;0;9;42708891;41589804;26848727;5902722;42632699;28948825;6175009;0;104290
FR;1;2023-05-10;19;18;7;11;18;9;8;0;1;42708910;41589822;26848734;5902733;42632717;28948834;6175017;0;104291
FR;1;2023-05-11;13;18;7;9;18;8;8;0;21;42708923;41589840;26848741;5902742;42632735;28948842;6175025;0;104312
FR;1;2023-05-12;16;42;26;15;39;31;18;0;11;42708939;41589882;26848767;5902757;42632774;28948873;6175043;0;104323
FR;1;2023-05-13;12;24;11;2;22;14;2;0;2;42708951;41589906;26848778;5902759;42632796;28948887;6175045;0;104325
FR;1;2023-05-14;12;1;1;0;1;1;0;0;0;42708963;41589907;26848779;5902759;42632797;28948888;6175045;0;104325
FR;1;2023-05-15;17;18;35;4;17;35;6;0;11;42708980;41589925;26848814;5902763;42632814;28948923;6175051;0;104336
FR;1;2023-05-16;17;25;17;30;22;17;35;0;49;42708997;41589950;26848831;5902793;42632836;28948940;6175086;0;104385
FR;1;2023-05-17;21;46;4;6;46;5;6;0;15;42709018;41589996;26848835;5902799;42632882;28948945;6175092;0;104400
FR;1;2023-05-18;0;3;1;0;3;1;0;0;1;42709018;41589999;26848836;5902799;42632885;28948946;6175092;0;104401
FR;1;2023-05-19;13;25;55;12;22;59;15;0;17;42709031;41590024;26848891;5902811;42632907;28949005;6175107;0;104418
FR;1;2023-05-20;6;7;11;6;6;10;9;0;6;42709037;41590031;26848902;5902817;42632913;28949015;6175116;0;104424
FR;1;2023-05-21;6;0;0;0;0;0;0;0;1;42709043;41590031;26848902;5902817;42632913;28949015;6175116;0;104425
FR;1;2023-05-22;41;17;30;6;17;30;7;0;7;42709084;41590048;26848932;5902823;42632930;28949045;6175123;0;104432
FR;1;2023-05-23;7;19;4;6;19;5;6;0;13;42709091;41590067;26848936;5902829;42632949;28949050;6175129;0;104445
FR;1;2023-05-24;14;20;13;16;20;13;18;0;29;42709105;41590087;26848949;5902845;42632969;28949063;6175147;0;104474
FR;1;2023-05-25;14;12;12;5;10;14;7;0;26;42709119;41590099;26848961;5902850;42632979;28949077;6175154;0;104500
FR;1;2023-05-26;25;22;26;8;20;28;10;0;10;42709144;41590121;26848987;5902858;42632999;28949105;6175164;0;104510
FR;1;2023-05-27;5;14;1;3;13;2;4;0;4;42709149;41590135;26848988;5902861;42633012;28949107;6175168;0;104514
FR;1;2023-05-28;1;2;1;0;2;1;0;0;0;42709150;41590137;26848989;5902861;42633014;28949108;6175168;0;104514
FR;1;2023-05-29;0;0;0;0;0;0;0;0;0;42709150;41590137;26848989;5902861;42633014;28949108;6175168;0;104514
FR;1;2023-05-30;40;16;14;25;18;16;28;0;32;42709190;41590153;26849003;5902886;42633032;28949124;6175196;0;104546
FR;1;2023-05-31;19;29;9;17;21;12;24;0;74;42709209;41590182;26849012;5902903;42633053;28949136;6175220;0;104620
FR;1;2023-06-01;10;23;29;12;17;33;12;0;19;42709219;41590205;26849041;5902915;42633070;28949169;6175232;0;104639
FR;1;2023-06-02;12;24;10;4;18;16;6;0;32;42709231;41590229;26849051;5902919;42633088;28949185;6175238;0;104671
FR;1;2023-06-03;4;7;1;2;7;2;2;0;0;42709235;41590236;26849052;5902921;42633095;28949187;6175240;0;104671
FR;1;2023-06-04;0;12;0;0;12;0;0;0;0;42709235;41590248;26849052;5902921;42633107;28949187;6175240;0;104671
FR;1;2023-06-05;50;18;7;6;16;8;9;0;8;42709285;41590266;26849059;5902927;42633123;28949195;6175249;0;104679
FR;1;2023-06-06;19;18;7;5;16;8;9;0;14;42709304;41590284;26849066;5902932;42633139;28949203;6175258;0;104693
FR;1;2023-06-07;14;10;3;3;9;3;4;0;5;42709318;41590294;26849069;5902935;42633148;28949206;6175262;0;104698
FR;1;2023-06-08;14;4;4;2;3;7;6;0;37;42709332;41590298;26849073;5902937;42633151;28949213;6175268;0;104735
FR;1;2023-06-09;17;34;8;13;32;9;13;0;32;42709349;41590332;26849081;5902950;42633183;28949222;6175281;0;104767
FR;1;2023-06-10;9;5;8;1;3;8;3;0;1;42709358;41590337;26849089;5902951;42633186;28949230;6175284;0;104768
FR;1;2023-06-11;0;0;0;0;0;0;0;0;0;42709358;41590337;26849089;5902951;42633186;28949230;6175284;0;104768
FR;1;2023-06-12;5;10;4;24;9;6;26;0;53;42709363;41590347;26849093;5902975;42633195;28949236;6175310;0;104821
FR;1;2023-06-13;10;7;4;4;6;5;6;0;3;42709373;41590354;26849097;5902979;42633201;28949241;6175316;0;104824
FR;1;2023-06-14;9;37;1;8;37;3;6;0;12;42709382;41590391;26849098;5902987;42633238;28949244;6175322;0;104836
FR;1;2023-06-15;5;15;5;20;11;10;19;0;46;42709387;41590406;26849103;5903007;42633249;28949254;6175341;0;104882
FR;1;2023-06-16;7;16;5;16;18;3;17;0;17;42709394;41590422;26849108;5903023;42633267;28949257;6175358;0;104899
FR;1;2023-06-17;5;14;3;1;13;3;1;0;5;42709399;41590436;26849111;5903024;42633280;28949260;6175359;0;104904
FR;1;2023-06-18;0;1;0;0;1;0;0;0;0;42709399;41590437;26849111;5903024;42633281;28949260;6175359;0;104904
FR;1;2023-06-19;12;8;3;3;9;1;6;0;6;42709411;41590445;26849114;5903027;42633290;28949261;6175365;0;104910
FR;1;2023-06-20;34;12;25;15;11;25;17;0;8;42709445;41590457;26849139;5903042;42633301;28949286;6175382;0;104918
FR;1;2023-06-21;9;12;4;33;11;11;33;0;17;42709454;41590469;26849143;5903075;42633312;28949297;6175415;0;104935
FR;1;2023-06-22;14;6;4;3;5;4;6;0;24;42709468;41590475;26849147;5903078;42633317;28949301;6175421;0;104959
FR;1;2023-06-23;10;12;3;4;12;4;5;0;6;42709478;41590487;26849150;5903082;42633329;28949305;6175426;0;104965
FR;1;2023-06-24;3;1;4;0;1;3;1;0;3;42709481;41590488;26849154;5903082;42633330;28949308;6175427;0;104968
FR;1;2023-06-25;0;0;0;0;0;0;0;0;0;42709481;41590488;26849154;5903082;42633330;28949308;6175427;0;104968
FR;1;2023-06-26;11;7;8;2;8;8;2;0;7;42709492;41590495;26849162;5903084;42633338;28949316;6175429;0;104975
FR;1;2023-06-27;12;7;5;1;7;3;4;0;3;42709504;41590502;26849167;5903085;42633345;28949319;6175433;0;104978
FR;1;2023-06-28;7;7;3;10;8;2;12;0;16;42709511;41590509;26849170;5903095;42633353;28949321;6175445;0;104994
FR;1;2023-06-29;3;5;3;10;5;1;12;0;49;42709514;41590514;26849173;5903105;42633358;28949322;6175457;0;105043
FR;1;2023-06-30;7;10;5;0;9;5;2;0;7;42709521;41590524;26849178;5903105;42633367;28949327;6175459;0;105050
FR;1;2023-07-01;5;4;0;1;6;1;1;0;1;42709526;41590528;26849178;5903106;42633373;28949328;6175460;0;105051
FR;1;2023-07-02;0;0;0;0;0;0;0;0;0;42709526;41590528;26849178;5903106;42633373;28949328;6175460;0;105051
FR;1;2023-07-03;24;1;9;1;1;6;5;0;2;42709550;41590529;26849187;5903107;42633374;28949334;6175465;0;105053
FR;1;2023-07-04;7;9;3;5;6;6;5;0;3;42709557;41590538;26849190;5903112;42633380;28949340;6175470;0;105056
FR;1;2023-07-05;6;3;0;0;3;0;0;0;2;42709563;41590541;26849190;5903112;42633383;28949340;6175470;0;105058
FR;1;2023-07-06;13;8;2;0;9;2;0;0;3;42709576;41590549;26849192;5903112;42633392;28949342;6175470;0;105061
FR;1;2023-07-07;7;2;1;1;2;1;1;0;7;42709583;41590551;26849193;5903113;42633394;28949343;6175471;0;105068
FR;1;2023-07-08;2;2;2;2;2;2;2;0;1;42709585;41590553;26849195;5903115;42633396;28949345;6175473;0;105069
FR;1;2023-07-09;1;1;0;0;1;0;0;0;0;42709586;41590554;26849195;5903115;42633397;28949345;6175473;0;105069
FR;1;2023-07-10;5;6;0;6;7;3;13;0;2;42709591;41590560;26849195;5903121;42633404;28949348;6175486;0;105071
FR;2;2020-12-27;0;0;0;0;0;0;0;0;0;0;0;0;0;0;0;0;0;0
FR;2;2020-12-28;0;0;0;0;0;0;0;0;0;0;0;0;0;0;0;0;0;0
FR;2;2020-12-29;0;0;0;0;0;0;0;0;0;0;0;0;0;0;0;0;0;0
FR;2;2020-12-30;0;0;0;0;0;0;0;0;0;0;0;0;0;0;0;0;0;0
FR;2;2020-12-31;0;0;0;0;0;0;0;0;0;0;0;0;0;0;0;0;0;0
FR;2;2021-01-01;0;0;0;0;0;0;0;0;0;0;0;0;0;0;0;0;0;0
FR;2;2021-01-02;0;0;0;0;0;0;0;0;0;0;0;0;0;0;0;0;0;0
FR;2;2021-01-03;0;0;0;0;0;0;0;0;0;0;0;0;0;0;0;0;0;0
FR;2;2021-01-04;0;0;0;0;0;0;0;0;0;0;0;0;0;0;0;0;0;0
FR;2;2021-01-05;0;0;0;0;0;0;0;0;0;0;0;0;0;0;0;0;0;0
FR;2;2021-01-06;0;0;0;0;0;0;0;0;0;0;0;0;0;0;0;0;0;0
FR;2;2021-01-07;0;0;0;0;0;0;0;0;0;0;0;0;0;0;0;0;0;0
FR;2;2021-01-08;0;0;0;0;0;0;0;0;0;0;0;0;0;0;0;0;0;0
FR;2;2021-01-09;0;0;0;0;0;0;0;0;0;0;0;0;0;0;0;0;0;0
FR;2;2021-01-10;0;0;0;0;0;0;0;0;0;0;0;0;0;0;0;0;0;0
FR;2;2021-01-11;0;0;0;0;0;0;0;0;0;0;0;0;0;0;0;0;0;0
FR;2;2021-01-12;0;0;0;0;0;0;0;0;0;0;0;0;0;0;0;0;0;0
FR;2;2021-01-13;0;0;0;0;0;0;0;0;0;0;0;0;0;0;0;0;0;0
FR;2;2021-01-14;1636;0;0;0;213;0;0;0;0;1636;0;0;0;213;0;0;0;0
FR;2;2021-01-15;398;0;0;0;28;0;0;0;0;2034;0;0;0;241;0;0;0;0
FR;2;2021-01-16;316;0;0;0;12;0;0;0;0;2350;0;0;0;253;0;0;0;0
FR;2;2021-01-17;84;0;0;0;7;0;0;0;0;2434;0;0;0;260;0;0;0;0
FR;2;2021-01-18;3075;3;0;0;27;0;0;0;0;5509;3;0;0;287;0;0;0;0
FR;2;2021-01-19;4681;2;0;0;31;0;0;0;0;10190;5;0;0;318;0;0;0;0
FR;2;2021-01-20;5138;6;0;0;58;0;0;0;0;15328;11;0;0;376;0;0;0;0
FR;2;2021-01-21;5346;9;0;0;55;0;0;0;0;20674;20;0;0;431;0;0;0;0
FR;2;2021-01-22;5119;19;0;0;70;0;0;0;0;25793;39;0;0;501;0;0;0;0
FR;2;2021-01-23;1875;2;0;0;16;0;0;0;0;27668;41;0;0;517;0;0;0;0
FR;2;2021-01-24;163;2;0;0;8;0;0;0;0;27831;43;0;0;525;0;0;0;0
FR;2;2021-01-25;3814;4;0;0;37;0;0;0;0;31645;47;0;0;562;0;0;0;0
FR;2;2021-01-26;3930;6;0;0;42;0;0;0;0;35575;53;0;0;604;0;0;0;0
FR;2;2021-01-27;3606;4;0;0;36;0;0;0;0;39181;57;0;0;640;0;0;0;0
FR;2;2021-01-28;3757;9;0;0;44;0;0;0;0;42938;66;0;0;684;0;0;0;0
FR;2;2021-01-29;3300;6;0;0;42;0;0;0;0;46238;72;0;0;726;0;0;0;0
FR;2;2021-01-30;1133;3;0;0;16;0;0;0;0;47371;75;0;0;742;0;0;0;0
FR;2;2021-01-31;47;2;0;0;9;0;0;0;0;47418;77;0;0;751;0;0;0;0
FR;2;2021-02-01;3408;13;0;0;44;0;0;0;0;50826;90;0;0;795;0;0;0;0
FR;2;2021-02-02;4498;19;0;0;53;0;0;0;0;55324;109;0;0;848;0;0;0;0
FR;2;2021-02-03;5223;12;0;0;83;0;0;0;0;60547;121;0;0;931;0;0;0;0
FR;2;2021-02-04;4941;11;0;0;36;0;0;0;0;65488;132;0;0;967;0;0;0;0
FR;2;2021-02-05;4817;17;0;0;50;0;0;0;0;70305;149;0;0;1017;0;0;0;0
FR;2;2021-02-06;2047;15;0;0;41;0;0;0;0;72352;164;0;0;1058;0;0;0;0
FR;2;2021-02-07;103;6;0;0;20;0;0;0;0;72455;170;0;0;1078;0;0;0;0
FR;2;2021-02-08;7559;27;0;0;86;0;0;0;0;80014;197;0;0;1164;0;0;0;0
FR;2;2021-02-09;8435;31;0;0;100;0;0;0;0;88449;228;0;0;1264;0;0;0;0
FR;2;2021-02-10;9349;63;0;0;183;0;0;0;0;97798;291;0;0;1447;0;0;0;0
FR;2;2021-02-11;10292;132;0;0;256;0;0;0;0;108090;423;0;0;1703;0;0;0;0
FR;2;2021-02-12;10059;276;0;0;430;0;0;0;0;118149;699;0;0;2133;0;0;0;0
FR;2;2021-02-13;3121;223;0;0;261;0;0;0;0;121270;922;0;0;2394;0;0;0;0
FR;2;2021-02-14;358;11;0;0;21;0;0;0;0;121628;933;0;0;2415;0;0;0;0
FR;2;2021-02-15;3460;3129;0;0;3176;0;0;0;0;125088;4062;0;0;5591;0;0;0;0
FR;2;2021-02-16;5076;4165;0;0;4238;0;0;0;0;130164;8227;0;0;9829;0;0;0;0
FR;2;2021-02-17;4259;4555;0;0;4632;0;0;0;0;134423;12782;0;0;14461;0;0;0;0
FR;2;2021-02-18;5406;5179;0;0;5249;0;0;0;0;139829;17961;0;0;19710;0;0;0;0
FR;2;2021-02-19;5329;4491;0;0;4592;0;0;0;0;145158;22452;0;0;24302;0;0;0;0
FR;2;2021-02-20;1872;1520;0;0;1537;0;0;0;0;147030;23972;0;0;25839;0;0;0;0
FR;2;2021-02-21;244;96;0;0;98;0;0;0;0;147274;24068;0;0;25937;0;0;0;0
FR;2;2021-02-22;3615;3783;0;0;3845;0;0;0;0;150889;27851;0;0;29782;0;0;0;0
FR;2;2021-02-23;4955;3741;0;0;3805;0;0;0;0;155844;31592;0;0;33587;0;0;0;0
FR;2;2021-02-24;5017;3559;0;0;3612;0;0;0;0;160861;35151;0;0;37199;0;0;0;0
FR;2;2021-02-25;5501;3495;0;0;3585;0;0;0;0;166362;38646;0;0;40784;0;0;0;0
FR;2;2021-02-26;4368;3179;0;0;3253;0;0;0;0;170730;41825;0;0;44037;0;0;0;0
FR;2;2021-02-27;1629;1067;0;0;1086;0;0;0;0;172359;42892;0;0;45123;0;0;0;0
FR;2;2021-02-28;179;17;0;0;28;0;0;0;0;172538;42909;0;0;45151;0;0;0;0
FR;2;2021-03-01;5193;3762;0;0;3851;0;0;0;0;177731;46671;0;0;49002;0;0;0;0
FR;2;2021-03-02;6542;4728;0;0;4829;0;0;0;0;184273;51399;0;0;53831;0;0;0;0
FR;2;2021-03-03;6544;4955;0;0;5096;0;0;0;0;190817;56354;0;0;58927;0;0;0;0
FR;2;2021-03-04;8412;4210;0;0;4396;0;0;0;0;199229;60564;0;0;63323;0;0;0;0
FR;2;2021-03-05;8037;4054;0;0;4237;0;0;0;0;207266;64618;0;0;67560;0;0;0;0
FR;2;2021-03-06;4791;1683;0;0;1783;0;0;0;0;212057;66301;0;0;69343;0;0;0;0
FR;2;2021-03-07;2373;32;0;0;76;0;0;0;0;214430;66333;0;0;69419;0;0;0;0
FR;2;2021-03-08;4166;8392;0;0;8549;0;0;0;0;218596;74725;0;0;77968;0;0;0;0
FR;2;2021-03-09;7494;8610;1;0;8869;0;0;0;0;226090;83335;1;0;86837;0;0;0;0
FR;2;2021-03-10;7108;9246;0;0;9473;0;0;0;0;233198;92581;1;0;96310;0;0;0;0
FR;2;2021-03-11;9379;9365;1;0;9686;0;0;0;0;242577;101946;2;0;105996;0;0;0;0
FR;2;2021-03-12;7989;8368;0;0;8671;0;0;0;0;250566;110314;2;0;114667;0;0;0;0
FR;2;2021-03-13;10058;2593;0;0;2914;0;0;0;0;260624;112907;2;0;117581;0;0;0;0
FR;2;2021-03-14;4841;380;0;0;539;0;0;0;0;265465;113287;2;0;118120;0;0;0;0
FR;2;2021-03-15;10919;3476;0;0;3765;0;0;0;0;276384;116763;2;0;121885;0;0;0;0
FR;2;2021-03-16;16770;4733;1;0;5283;0;0;0;0;293154;121496;3;0;127168;0;0;0;0
FR;2;2021-03-17;20242;4001;0;0;4675;0;0;0;0;313396;125497;3;0;131843;0;0;0;0
FR;2;2021-03-18;23375;5128;0;0;5957;0;0;0;0;336771;130625;3;0;137800;0;0;0;0
FR;2;2021-03-19;23316;4681;0;0;5444;0;0;0;0;360087;135306;3;0;143244;0;0;0;0
FR;2;2021-03-20;25451;1588;0;0;2345;0;0;0;0;385538;136894;3;0;145589;0;0;0;0
FR;2;2021-03-21;17675;153;0;0;731;0;0;0;0;403213;137047;3;0;146320;0;0;0;0
FR;2;2021-03-22;17791;3273;0;0;3942;0;0;0;0;421004;140320;3;0;150262;0;0;0;0
FR;2;2021-03-23;22707;4287;0;0;5142;0;0;0;0;443711;144607;3;0;155404;0;0;0;0
FR;2;2021-03-24;23966;5101;0;0;5938;0;0;0;0;467677;149708;3;0;161342;0;0;0;0
FR;2;2021-03-25;26762;5258;1;0;6455;0;0;0;0;494439;154966;4;0;167797;0;0;0;0
FR;2;2021-03-26;26992;4236;0;0;5382;0;0;0;0;521431;159202;4;0;173179;0;0;0;0
FR;2;2021-03-27;15923;1369;0;0;1899;0;0;0;0;537354;160571;4;0;175078;0;0;0;0
FR;2;2021-03-28;10563;135;0;0;427;0;0;0;0;547917;160706;4;0;175505;0;0;0;0
FR;2;2021-03-29;19004;4349;0;0;5049;0;0;0;0;566921;165055;4;0;180554;0;0;0;0
FR;2;2021-03-30;24597;6105;0;0;7045;0;0;0;0;591518;171160;4;0;187599;0;0;0;0
FR;2;2021-03-31;28562;5931;0;0;7224;0;0;0;0;620080;177091;4;0;194823;0;0;0;0
FR;2;2021-04-01;34560;8576;1;0;10269;0;0;0;0;654640;185667;5;0;205092;0;0;0;0
FR;2;2021-04-02;29992;7736;0;0;9165;0;0;0;0;684632;193403;5;0;214257;0;0;0;0
FR;2;2021-04-03;16959;4263;0;0;4945;0;0;0;0;701591;197666;5;0;219202;0;0;0;0
FR;2;2021-04-04;9309;1269;2;0;1677;0;0;0;0;710900;198935;7;0;220879;0;0;0;0
FR;2;2021-04-05;12448;797;0;0;1381;0;0;0;0;723348;199732;7;0;222260;0;0;0;0
FR;2;2021-04-06;27159;7362;0;0;8754;0;0;0;0;750507;207094;7;0;231014;0;0;0;0
FR;2;2021-04-07;30931;7067;1;0;8643;0;0;0;0;781438;214161;8;0;239657;0;0;0;0
FR;2;2021-04-08;36896;8592;1;0;10517;0;0;0;0;818334;222753;9;0;250174;0;0;0;0
FR;2;2021-04-09;33856;8391;28;0;10176;0;0;0;0;852190;231144;37;0;260350;0;0;0;0
FR;2;2021-04-10;19689;9270;1;0;10182;0;0;0;0;871879;240414;38;0;270532;0;0;0;0
FR;2;2021-04-11;7943;4240;1;0;4603;0;0;0;0;879822;244654;39;0;275135;0;0;0;0
FR;2;2021-04-12;17137;11028;0;0;11870;0;0;0;0;896959;255682;39;0;287005;0;0;0;0
FR;2;2021-04-13;19465;16034;1;0;17102;0;0;0;0;916424;271716;40;0;304107;0;0;0;0
FR;2;2021-04-14;18071;16446;7;0;17542;0;0;0;0;934495;288162;47;0;321649;0;0;0;0
FR;2;2021-04-15;22208;21893;27;0;23347;0;0;0;0;956703;310055;74;0;344996;0;0;0;0
FR;2;2021-04-16;20721;20640;45;0;21913;0;0;0;0;977424;330695;119;0;366909;0;0;0;0
FR;2;2021-04-17;13258;22494;5;0;23225;0;0;0;0;990682;353189;124;0;390134;0;0;0;0
FR;2;2021-04-18;5911;14396;6;0;14736;0;0;0;0;996593;367585;130;0;404870;0;0;0;0
FR;2;2021-04-19;16850;16395;24;0;17198;0;0;0;0;1013443;383980;154;0;422068;0;0;0;0
FR;2;2021-04-20;19329;21808;38;0;22870;0;0;0;0;1032772;405788;192;0;444938;0;0;0;0
FR;2;2021-04-21;20294;21902;76;0;23052;0;0;0;0;1053066;427690;268;0;467990;0;0;0;0
FR;2;2021-04-22;23824;24959;41;0;26372;0;0;0;0;1076890;452649;309;0;494362;0;0;0;0
FR;2;2021-04-23;24534;25502;76;0;27014;0;0;0;0;1101424;478151;385;0;521376;0;0;0;0
FR;2;2021-04-24;25305;15069;104;0;16507;0;0;0;0;1126729;493220;489;0;537883;0;0;0;0
FR;2;2021-04-25;9598;8623;5;0;9183;0;0;0;0;1136327;501843;494;0;547066;0;0;0;0
FR;2;2021-04-26;17169;17680;21;0;18566;0;0;0;0;1153496;519523;515;0;565632;0;0;0;0
FR;2;2021-04-27;19246;24100;40;0;25284;0;0;0;0;1172742;543623;555;0;590916;0;0;0;0
FR;2;2021-04-28;22343;26460;113;0;27861;0;0;0;0;1195085;570083;668;0;618777;0;0;0;0
FR;2;2021-04-29;25477;30499;70;0;32189;0;0;0;0;1220562;600582;738;0;650966;0;0;0;0
FR;2;2021-04-30;25542;27978;49;1;29628;0;0;0;0;1246104;628560;787;1;680594;0;0;0;0
FR;2;2021-05-01;14988;9855;6;0;10656;0;0;0;0;1261092;638415;793;1;691250;0;0;0;0
FR;2;2021-05-02;6642;9160;2;0;9506;0;0;0;0;1267734;647575;795;1;700756;0;0;0;0
FR;2;2021-05-03;20026;19127;40;0;20334;0;0;0;0;1287760;666702;835;1;721090;0;0;0;0
FR;2;2021-05-04;18288;29200;33;0;30346;0;0;0;0;1306048;695902;868;1;751436;0;0;0;0
FR;2;2021-05-05;18385;29524;48;0;30822;0;0;0;0;1324433;725426;916;1;782258;0;0;0;0
FR;2;2021-05-06;23553;35412;132;0;36985;0;0;0;0;1347986;760838;1048;1;819243;0;0;0;0
FR;2;2021-05-07;25349;33241;97;0;35100;0;0;0;0;1373335;794079;1145;1;854343;0;0;0;0
FR;2;2021-05-08;21343;10701;15;0;11788;0;0;0;0;1394678;804780;1160;1;866131;0;0;0;0
FR;2;2021-05-09;13170;7609;7;0;8284;0;0;0;0;1407848;812389;1167;1;874415;0;0;0;0
FR;2;2021-05-10;32949;21716;50;0;23573;0;0;0;0;1440797;834105;1217;1;897988;0;0;0;0
FR;2;2021-05-11;43616;20904;101;0;23529;0;0;0;0;1484413;855009;1318;1;921517;0;0;0;0
FR;2;2021-05-12;50070;19637;143;0;22519;0;0;0;0;1534483;874646;1461;1;944036;0;0;0;0
FR;2;2021-05-13;51301;5597;31;0;8465;0;0;0;0;1585784;880243;1492;1;952501;0;0;0;0
FR;2;2021-05-14;61361;12884;132;0;16538;0;0;0;0;1647145;893127;1624;1;969039;0;0;0;0
FR;2;2021-05-15;65938;7100;40;0;10650;0;0;0;0;1713083;900227;1664;1;979689;0;0;0;0
FR;2;2021-05-16;43588;2573;10;0;4944;0;0;0;0;1756671;902800;1674;1;984633;0;0;0;0
FR;2;2021-05-17;44756;12447;114;0;15354;0;0;0;0;1801427;915247;1788;1;999987;0;0;0;0
FR;2;2021-05-18;54650;12291;190;0;15974;0;0;0;0;1856077;927538;1978;1;1015961;0;0;0;0
FR;2;2021-05-19;57180;10459;281;0;14499;0;0;0;0;1913257;937997;2259;1;1030460;0;0;0;0
FR;2;2021-05-20;63452;10804;288;0;14899;0;0;0;0;1976709;948801;2547;1;1045359;0;0;0;0
FR;2;2021-05-21;64306;11602;230;0;16027;0;0;0;0;2041015;960403;2777;1;1061386;0;0;0;0
FR;2;2021-05-22;61488;4530;65;0;8500;0;0;0;0;2102503;964933;2842;1;1069886;0;0;0;0
FR;2;2021-05-23;37537;575;22;0;2912;0;0;0;0;2140040;965508;2864;1;1072798;0;0;0;0
FR;2;2021-05-24;17248;2052;35;0;3259;0;0;0;0;2157288;967560;2899;1;1076057;0;0;0;0
FR;2;2021-05-25;21121;12253;241;0;13854;0;0;0;0;2178409;979813;3140;1;1089911;0;0;0;0
FR;2;2021-05-26;19946;11539;230;0;13069;0;0;0;0;2198355;991352;3370;1;1102980;0;0;0;0
FR;2;2021-05-27;23001;12663;182;0;14399;0;0;0;0;2221356;1004015;3552;1;1117379;0;0;0;0
FR;2;2021-05-28;29398;15044;190;0;17224;0;0;0;0;2250754;1019059;3742;1;1134603;0;0;0;0
FR;2;2021-05-29;30425;8196;58;0;10104;0;0;0;0;2281179;1027255;3800;1;1144707;0;0;0;0
FR;2;2021-05-30;4648;1819;6;0;2154;0;0;0;0;2285827;1029074;3806;1;1146861;0;0;0;0
FR;2;2021-05-31;28590;18741;184;0;20820;0;0;0;0;2314417;1047815;3990;1;1167681;0;0;0;0
FR;2;2021-06-01;45745;19916;225;0;23152;0;0;0;0;2360162;1067731;4215;1;1190833;0;0;0;0
FR;2;2021-06-02;37483;19311;182;0;22317;0;0;0;0;2397645;1087042;4397;1;1213150;0;0;0;0
FR;2;2021-06-03;51284;23118;161;0;26972;0;0;0;0;2448929;1110160;4558;1;1240122;0;0;0;0
FR;2;2021-06-04;65519;24092;217;0;29057;0;0;0;0;2514448;1134252;4775;1;1269179;0;0;0;0
FR;2;2021-06-05;34607;24109;52;0;26964;0;0;0;0;2549055;1158361;4827;1;1296143;0;0;0;0
FR;2;2021-06-06;4958;6194;10;0;6613;0;0;0;0;2554013;1164555;4837;1;1302756;0;0;0;0
FR;2;2021-06-07;28177;23017;150;0;25433;0;0;0;0;2582190;1187572;4987;1;1328189;0;0;0;0
FR;2;2021-06-08;46379;22943;143;0;26909;0;0;0;0;2628569;1210515;5130;1;1355098;0;0;0;0
FR;2;2021-06-09;34298;20999;107;0;24131;0;0;0;0;2662867;1231514;5237;1;1379229;0;0;0;0
FR;2;2021-06-10;42644;19082;96;1;23004;0;0;0;0;2705511;1250596;5333;2;1402233;0;0;0;0
FR;2;2021-06-11;55306;25134;134;0;30233;0;0;0;0;2760817;1275730;5467;2;1432466;0;0;0;0
FR;2;2021-06-12;30567;19801;53;0;22655;0;0;0;0;2791384;1295531;5520;2;1455121;0;0;0;0
FR;2;2021-06-13;3333;9197;13;0;9586;0;0;0;0;2794717;1304728;5533;2;1464707;0;0;0;0
FR;2;2021-06-14;25304;24119;92;0;26699;0;0;0;0;2820021;1328847;5625;2;1491406;0;0;0;0
FR;2;2021-06-15;39049;22820;154;0;26568;0;0;0;0;2859070;1351667;5779;2;1517974;0;0;0;0
FR;2;2021-06-16;30169;21371;135;0;24524;0;0;0;0;2889239;1373038;5914;2;1542498;0;0;0;0
FR;2;2021-06-17;36913;25738;150;0;29600;0;0;0;0;2926152;1398776;6064;2;1572098;0;0;0;0
FR;2;2021-06-18;46860;28884;123;0;33587;0;0;0;0;2973012;1427660;6187;2;1605685;0;0;0;0
FR;2;2021-06-19;24527;24940;39;0;27714;0;0;0;0;2997539;1452600;6226;2;1633399;0;0;0;0
FR;2;2021-06-20;3745;10058;9;0;10557;0;0;0;0;3001284;1462658;6235;2;1643956;0;0;0;0
FR;2;2021-06-21;17538;42862;88;0;44874;0;0;0;0;3018822;1505520;6323;2;1688830;0;0;0;0
FR;2;2021-06-22;28367;49617;110;0;53046;0;0;0;0;3047189;1555137;6433;2;1741876;0;0;0;0
FR;2;2021-06-23;21790;49613;107;1;52462;1;0;0;0;3068979;1604750;6540;3;1794338;1;0;0;0
FR;2;2021-06-24;28381;50319;134;0;54050;0;0;0;0;3097360;1655069;6674;3;1848388;1;0;0;0
FR;2;2021-06-25;33402;60489;129;0;64878;0;0;0;0;3130762;1715558;6803;3;1913266;1;0;0;0
FR;2;2021-06-26;16396;59357;54;1;61749;0;0;0;0;3147158;1774915;6857;4;1975015;1;0;0;0
FR;2;2021-06-27;2566;29316;22;1;29898;0;0;0;0;3149724;1804231;6879;5;2004913;1;0;0;0
FR;2;2021-06-28;12641;54341;84;0;56317;0;0;0;0;3162365;1858572;6963;5;2061230;1;0;0;0
FR;2;2021-06-29;19857;60000;178;0;62943;0;0;0;0;3182222;1918572;7141;5;2124173;1;0;0;0
FR;2;2021-06-30;16337;58036;253;17;60720;0;0;0;0;3198559;1976608;7394;22;2184893;1;0;0;0
FR;2;2021-07-01;20497;59874;228;0;63201;0;0;0;0;3219056;2036482;7622;22;2248094;1;0;0;0
FR;2;2021-07-02;24083;62161;184;0;66375;0;0;0;0;3243139;2098643;7806;22;2314469;1;0;0;0
FR;2;2021-07-03;12123;57146;153;0;59485;0;0;0;0;3255262;2155789;7959;22;2373954;1;0;0;0
FR;2;2021-07-04;1961;23303;18;0;23870;0;0;0;0;3257223;2179092;7977;22;2397824;1;0;0;0
FR;2;2021-07-05;9179;29257;106;0;30893;0;0;0;0;3266402;2208349;8083;22;2428717;1;0;0;0
FR;2;2021-07-06;14584;36279;135;0;38958;0;0;0;0;3280986;2244628;8218;22;2467675;1;0;0;0
FR;2;2021-07-07;14421;33663;140;0;36416;0;0;0;0;3295407;2278291;8358;22;2504091;1;0;0;0
FR;2;2021-07-08;19723;40327;162;0;43984;0;0;0;0;3315130;2318618;8520;22;2548075;1;0;0;0
FR;2;2021-07-09;27105;54335;202;1;59486;0;0;0;0;3342235;2372953;8722;23;2607561;1;0;0;0
FR;2;2021-07-10;13389;33708;107;0;36392;0;0;0;0;3355624;2406661;8829;23;2643953;1;0;0;0
FR;2;2021-07-11;1811;4344;16;0;4771;0;0;0;0;3357435;2411005;8845;23;2648724;1;0;0;0
FR;2;2021-07-12;12971;37264;119;0;39919;0;0;0;0;3370406;2448269;8964;23;2688643;1;0;0;0
FR;2;2021-07-13;37120;53146;152;0;60280;0;0;0;0;3407526;2501415;9116;23;2748923;1;0;0;0
FR;2;2021-07-14;6628;3540;15;0;4887;0;0;0;0;3414154;2504955;9131;23;2753810;1;0;0;0
FR;2;2021-07-15;47244;47014;156;0;55210;0;0;0;0;3461398;2551969;9287;23;2809020;1;0;0;0
FR;2;2021-07-16;64320;55754;188;0;66736;0;0;0;0;3525718;2607723;9475;23;2875756;1;0;0;0
FR;2;2021-07-17;31603;23918;96;0;29375;0;0;0;0;3557321;2631641;9571;23;2905131;1;0;0;0
FR;2;2021-07-18;6090;4807;19;0;5952;0;0;0;0;3563411;2636448;9590;23;2911083;1;0;0;0
FR;2;2021-07-19;33007;28599;94;0;34212;0;0;0;0;3596418;2665047;9684;23;2945295;1;0;0;0
FR;2;2021-07-20;51999;44522;155;0;53157;0;0;0;0;3648417;2709569;9839;23;2998452;1;0;0;0
FR;2;2021-07-21;45256;34624;93;0;42126;0;0;0;0;3693673;2744193;9932;23;3040578;1;0;0;0
FR;2;2021-07-22;56280;41082;128;1;50355;0;0;0;0;3749953;2785275;10060;24;3090933;1;0;0;0
FR;2;2021-07-23;68305;48968;170;0;60256;0;0;0;0;3818258;2834243;10230;24;3151189;1;0;0;0
FR;2;2021-07-24;36178;21614;82;0;27471;0;0;0;0;3854436;2855857;10312;24;3178660;1;0;0;0
FR;2;2021-07-25;6751;2608;10;0;3866;0;0;0;0;3861187;2858465;10322;24;3182526;1;0;0;0
FR;2;2021-07-26;36320;22335;91;1;27838;0;0;0;0;3897507;2880800;10413;25;3210364;1;0;0;0
FR;2;2021-07-27;62392;34563;180;0;43711;0;0;0;0;3959899;2915363;10593;25;3254075;1;0;0;0
FR;2;2021-07-28;55327;26425;132;0;34511;0;0;0;0;4015226;2941788;10725;25;3288586;1;0;0;0
FR;2;2021-07-29;68481;32794;189;0;42475;0;0;0;0;4083707;2974582;10914;25;3331061;1;0;0;0
FR;2;2021-07-30;74468;37814;222;1;48604;0;0;0;0;4158175;3012396;11136;26;3379665;1;0;0;0
FR;2;2021-07-31;34778;16207;105;0;21406;0;0;0;0;4192953;3028603;11241;26;3401071;1;0;0;0
FR;2;2021-08-01;5416;2260;19;0;3123;0;0;0;0;4198369;3030863;11260;26;3404194;1;0;0;0
FR;2;2021-08-02;35899;16150;101;0;21053;0;0;0;0;4234268;3047013;11361;26;3425247;1;0;0;0
FR;2;2021-08-03;55988;28261;143;0;35464;0;0;0;0;4290256;3075274;11504;26;3460711;1;0;0;0
FR;2;2021-08-04;46638;20828;128;1;26936;0;0;0;0;4336894;3096102;11632;27;3487647;1;0;0;0
FR;2;2021-08-05;54642;31563;215;0;38739;0;0;0;0;4391536;3127665;11847;27;3526386;1;0;0;0
FR;2;2021-08-06;58099;42399;242;1;50227;0;0;0;0;4449635;3170064;12089;28;3576613;1;0;0;0
FR;2;2021-08-07;25152;17627;89;0;21317;0;0;0;0;4474787;3187691;12178;28;3597930;1;0;0;0
FR;2;2021-08-08;3840;3653;21;0;4311;0;0;0;0;4478627;3191344;12199;28;3602241;1;0;0;0
FR;2;2021-08-09;29308;21022;92;0;24848;0;0;0;0;4507935;3212366;12291;28;3627089;1;0;0;0
FR;2;2021-08-10;45014;33467;155;0;39228;0;0;0;0;4552949;3245833;12446;28;3666317;1;0;0;0
FR;2;2021-08-11;35277;25144;151;0;29743;0;0;0;0;4588226;3270977;12597;28;3696060;1;0;0;0
FR;2;2021-08-12;41905;35692;163;0;41228;0;0;0;0;4630131;3306669;12760;28;3737288;1;0;0;0
FR;2;2021-08-13;42608;37354;218;0;43041;0;0;0;0;4672739;3344023;12978;28;3780329;1;0;0;0
FR;2;2021-08-14;18524;22131;94;0;24762;0;0;0;0;4691263;3366154;13072;28;3805091;1;0;0;0
FR;2;2021-08-15;3865;3796;17;0;4382;0;0;0;0;4695128;3369950;13089;28;3809473;1;0;0;0
FR;2;2021-08-16;25095;27123;111;0;30446;0;0;0;0;4720223;3397073;13200;28;3839919;1;0;0;0
FR;2;2021-08-17;38270;43396;207;2;48380;0;0;0;0;4758493;3440469;13407;30;3888299;1;0;0;0
FR;2;2021-08-18;32254;36352;195;1;40693;0;0;0;0;4790747;3476821;13602;31;3928992;1;0;0;0
FR;2;2021-08-19;37436;46575;224;0;51775;0;0;0;0;4828183;3523396;13826;31;3980767;1;0;0;0
FR;2;2021-08-20;40568;55648;271;1;61573;0;0;0;0;4868751;3579044;14097;32;4042340;1;0;0;0
FR;2;2021-08-21;18122;24322;117;0;27114;0;0;0;0;4886873;3603366;14214;32;4069454;1;0;0;0
FR;2;2021-08-22;2909;4319;22;1;4851;1;0;0;0;4889782;3607685;14236;33;4074305;2;0;0;0
FR;2;2021-08-23;19250;35149;131;1;38039;0;0;0;0;4909032;3642834;14367;34;4112344;2;0;0;0
FR;2;2021-08-24;31952;56036;236;0;60693;0;0;0;0;4940984;3698870;14603;34;4173037;2;0;0;0
FR;2;2021-08-25;25934;43456;251;0;47405;0;0;0;0;4966918;3742326;14854;34;4220442;2;0;0;0
FR;2;2021-08-26;32362;55848;388;0;60586;0;0;0;0;4999280;3798174;15242;34;4281028;2;0;0;0
FR;2;2021-08-27;37003;65679;477;2;71403;0;0;0;0;5036283;3863853;15719;36;4352431;2;0;0;0
FR;2;2021-08-28;17819;28556;300;0;31616;0;0;0;0;5054102;3892409;16019;36;4384047;2;0;0;0
FR;2;2021-08-29;2656;5012;47;0;5623;0;0;0;0;5056758;3897421;16066;36;4389670;2;0;0;0
FR;2;2021-08-30;18418;37729;399;0;40148;756;0;0;0;5075176;3935150;16465;36;4429818;758;0;0;0
FR;2;2021-08-31;28077;57516;887;4;60947;1558;0;0;0;5103253;3992666;17352;40;4490765;2316;0;0;0
FR;2;2021-09-01;21595;39878;1309;0;42256;2129;0;0;0;5124848;4032544;18661;40;4533021;4445;0;0;0
FR;2;2021-09-02;25486;48669;1963;2;50944;3369;0;0;0;5150334;4081213;20624;42;4583965;7814;0;0;0
FR;2;2021-09-03;33414;64576;2988;3;67538;4886;1;0;0;5183748;4145789;23612;45;4651503;12700;1;0;0
FR;2;2021-09-04;16833;27763;1443;1;29553;2386;0;0;0;5200581;4173552;25055;46;4681056;15086;1;0;0
FR;2;2021-09-05;2265;3585;266;0;3941;412;0;0;0;5202846;4177137;25321;46;4684997;15498;1;0;0
FR;2;2021-09-06;14045;28693;1771;1;29758;2945;0;0;0;5216891;4205830;27092;47;4714755;18443;1;0;0
FR;2;2021-09-07;21111;41110;3022;13;42260;4945;0;0;0;5238002;4246940;30114;60;4757015;23388;1;0;0
FR;2;2021-09-08;17248;31922;2735;6;32738;4499;0;0;0;5255250;4278862;32849;66;4789753;27887;1;0;0
FR;2;2021-09-09;20982;40485;4437;3;41229;6842;0;0;0;5276232;4319347;37286;69;4830982;34729;1;0;0
FR;2;2021-09-10;28203;51318;5286;4;51885;8980;1;0;0;5304435;4370665;42572;73;4882867;43709;2;0;0
FR;2;2021-09-11;13655;22459;2405;5;23131;3990;0;0;0;5318090;4393124;44977;78;4905998;47699;2;0;0
FR;2;2021-09-12;1824;2771;292;0;2965;509;0;0;0;5319914;4395895;45269;78;4908963;48208;2;0;0
FR;2;2021-09-13;11659;21440;2474;4;21700;4052;0;0;0;5331573;4417335;47743;82;4930663;52260;2;0;0
FR;2;2021-09-14;18579;32719;5092;13;31679;9054;2;0;0;5350152;4450054;52835;95;4962342;61314;4;0;0
FR;2;2021-09-15;14917;28227;5168;3;26926;7749;9;0;0;5365069;4478281;58003;98;4989268;69063;13;0;0
FR;2;2021-09-16;16079;32800;6737;12;30181;10541;4;0;0;5381148;4511081;64740;110;5019449;79604;17;0;0
FR;2;2021-09-17;20916;47179;8782;10;42825;14631;6;0;0;5402064;4558260;73522;120;5062274;94235;23;0;0
FR;2;2021-09-18;9856;20959;3804;6;19595;6034;1;0;0;5411920;4579219;77326;126;5081869;100269;24;0;0
FR;2;2021-09-19;1166;2589;396;0;2532;631;0;0;0;5413086;4581808;77722;126;5084401;100900;24;0;0
FR;2;2021-09-20;7503;18702;3856;7;17025;6135;4;0;0;5420589;4600510;81578;133;5101426;107035;28;0;0
FR;2;2021-09-21;11215;29983;6495;5;26536;10744;3;0;0;5431804;4630493;88073;138;5127962;117779;31;0;0
FR;2;2021-09-22;9415;23545;5490;6;21193;8526;8;0;0;5441219;4654038;93563;144;5149155;126305;39;0;0
FR;2;2021-09-23;10730;28906;7881;10;24732;12647;10;0;0;5451949;4682944;101444;154;5173887;138952;49;0;0
FR;2;2021-09-24;15075;42947;10878;18;37281;17246;21;0;0;5467024;4725891;112322;172;5211168;156198;70;0;0
FR;2;2021-09-25;7258;18800;3965;9;17152;6121;3;0;0;5474282;4744691;116287;181;5228320;162319;73;0;0
FR;2;2021-09-26;1080;2543;495;0;2489;630;1;0;0;5475362;4747234;116782;181;5230809;162949;74;0;0
FR;2;2021-09-27;6312;16398;4287;8;14791;6532;2;0;0;5481674;4763632;121069;189;5245600;169481;76;0;0
FR;2;2021-09-28;9243;25573;7770;14;21719;12089;7;0;0;5490917;4789205;128839;203;5267319;181570;83;0;0
FR;2;2021-09-29;8081;20198;6067;25;17606;9259;8;0;0;5498998;4809403;134906;228;5284925;190829;91;0;0
FR;2;2021-09-30;9865;25839;9509;16;21640;14099;6;0;0;5508863;4835242;144415;244;5306565;204928;97;0;0
FR;2;2021-10-01;13979;35735;12921;25;30045;19328;9;0;0;5522842;4870977;157336;269;5336610;224256;106;0;0
FR;2;2021-10-02;6875;15934;4850;7;14226;7047;6;0;0;5529717;4886911;162186;276;5350836;231303;112;0;0
FR;2;2021-10-03;841;1907;492;1;1839;502;0;0;0;5530558;4888818;162678;277;5352675;231805;112;0;0
FR;2;2021-10-04;5826;13900;5516;5;12135;7854;6;0;0;5536384;4902718;168194;282;5364810;239659;118;0;0
FR;2;2021-10-05;9058;22573;11125;19;18533;15741;1;0;0;5545442;4925291;179319;301;5383343;255400;119;0;0
FR;2;2021-10-06;7785;17747;8243;11;15274;11090;4;0;0;5553227;4943038;187562;312;5398617;266490;123;0;0
FR;2;2021-10-07;9204;22215;12386;14;18008;16878;6;0;0;5562431;4965253;199948;326;5416625;283368;129;0;0
FR;2;2021-10-08;13432;32144;17348;28;26517;23609;11;0;0;5575863;4997397;217296;354;5443142;306977;140;0;0
FR;2;2021-10-09;6000;12847;6044;6;11381;7897;7;0;0;5581863;5010244;223340;360;5454523;314874;147;0;0
FR;2;2021-10-10;885;1592;436;2;1535;604;1;0;0;5582748;5011836;223776;362;5456058;315478;148;0;0
FR;2;2021-10-11;5607;11544;6455;17;9932;8829;3;0;0;5588355;5023380;230231;379;5465990;324307;151;0;0
FR;2;2021-10-12;8031;17790;12551;13;13921;16790;9;0;0;5596386;5041170;242782;392;5479911;341097;160;0;0
FR;2;2021-10-13;6947;14871;10256;12;11811;13663;7;0;0;5603333;5056041;253038;404;5491722;354760;167;0;0
FR;2;2021-10-14;8314;17941;14996;13;13556;19479;10;0;0;5611647;5073982;268034;417;5505278;374239;177;0;0
FR;2;2021-10-15;11856;26312;20902;26;19413;27982;4;0;0;5623503;5100294;288936;443;5524691;402221;181;0;0
FR;2;2021-10-16;5141;8728;1819;0;8172;3205;2;0;0;5628644;5109022;290755;443;5532863;405426;183;0;0
FR;2;2021-10-17;654;1150;185;0;1083;354;1;0;0;5629298;5110172;290940;443;5533946;405780;184;0;0
FR;2;2021-10-18;4564;7335;665;2;7242;1629;0;0;0;5633862;5117507;291605;445;5541188;407409;184;0;0
FR;2;2021-10-19;6239;9848;732;5;9653;2030;5;0;0;5640101;5127355;292337;450;5550841;409439;189;0;0
FR;2;2021-10-20;5170;8050;759;3;8173;1675;0;0;0;5645271;5135405;293096;453;5559014;411114;189;0;0
FR;2;2021-10-21;6090;9983;780;5;9841;2104;1;0;0;5651361;5145388;293876;458;5568855;413218;190;0;0
FR;2;2021-10-22;8452;14602;1151;4;14478;2891;2;0;0;5659813;5159990;295027;462;5583333;416109;192;0;0
FR;2;2021-10-23;3845;5993;587;0;6125;1235;3;0;0;5663658;5165983;295614;462;5589458;417344;195;0;0
FR;2;2021-10-24;494;882;101;0;900;204;0;0;0;5664152;5166865;295715;462;5590358;417548;195;0;0
FR;2;2021-10-25;3360;5343;307;1;5519;825;2;0;0;5667512;5172208;296022;463;5595877;418373;197;0;0
FR;2;2021-10-26;4177;7238;1134;4;7126;2024;5;0;0;5671689;5179446;297156;467;5603003;420397;202;0;0
FR;2;2021-10-27;3677;6586;1194;5;6448;1989;1;0;0;5675366;5186032;298350;472;5609451;422386;203;0;0
FR;2;2021-10-28;4597;7687;1737;3;7415;2746;1;0;0;5679963;5193719;300087;475;5616866;425132;204;0;0
FR;2;2021-10-29;5414;11082;2438;4;10692;3684;3;0;0;5685377;5204801;302525;479;5627558;428816;207;0;0
FR;2;2021-10-30;2749;4455;976;1;4450;1448;2;0;0;5688126;5209256;303501;480;5632008;430264;209;0;0
FR;2;2021-10-31;364;535;140;1;544;191;1;0;0;5688490;5209791;303641;481;5632552;430455;210;0;0
FR;2;2021-11-01;430;546;181;0;563;267;1;0;0;5688920;5210337;303822;481;5633115;430722;211;0;0
FR;2;2021-11-02;3294;6759;1184;0;6799;1771;5;0;0;5692214;5217096;305006;481;5639914;432493;216;0;0
FR;2;2021-11-03;3340;6227;1389;2;6311;1971;2;0;0;5695554;5223323;306395;483;5646225;434464;218;0;0
FR;2;2021-11-04;3987;7069;1769;4;7109;2495;3;0;0;5699541;5230392;308164;487;5653334;436959;221;0;0
FR;2;2021-11-05;5235;10502;2869;5;10215;3957;6;0;0;5704776;5240894;311033;492;5663549;440916;227;0;0
FR;2;2021-11-06;2597;4684;1407;0;4641;1824;2;0;0;5707373;5245578;312440;492;5668190;442740;229;0;0
FR;2;2021-11-07;506;862;221;0;869;291;2;0;0;5707879;5246440;312661;492;5669059;443031;231;0;0
FR;2;2021-11-08;2578;5348;1207;3;5268;1678;3;0;0;5710457;5251788;313868;495;5674327;444709;234;0;0
FR;2;2021-11-09;2749;6907;2402;5;6442;3181;2;0;0;5713206;5258695;316270;500;5680769;447890;236;0;0
FR;2;2021-11-10;2590;5668;5118;6;4761;6294;7;0;0;5715796;5264363;321388;506;5685530;454184;243;0;0
FR;2;2021-11-11;446;754;755;2;647;938;3;0;0;5716242;5265117;322143;508;5686177;455122;246;0;0
FR;2;2021-11-12;2953;8087;8982;8;6196;10932;9;0;0;5719195;5273204;331125;516;5692373;466054;255;0;0
FR;2;2021-11-13;1539;3372;3872;7;2720;4538;4;0;0;5720734;5276576;334997;523;5695093;470592;259;0;0
FR;2;2021-11-14;258;585;351;1;486;480;3;0;0;5720992;5277161;335348;524;5695579;471072;262;0;0
FR;2;2021-11-15;1621;3654;4449;8;2908;5329;16;0;0;5722613;5280815;339797;532;5698487;476401;278;0;0
FR;2;2021-11-16;2185;5875;8314;14;4152;10083;16;0;0;5724798;5286690;348111;546;5702639;486484;294;0;0
FR;2;2021-11-17;1740;4523;6634;8;3168;7852;5;0;0;5726538;5291213;354745;554;5705807;494336;299;0;0
FR;2;2021-11-18;2192;5920;9188;10;4018;11018;8;0;0;5728730;5297133;363933;564;5709825;505354;307;0;0
FR;2;2021-11-19;2701;7751;12981;19;4831;15480;12;0;0;5731431;5304884;376914;583;5714656;520834;319;0;0
FR;2;2021-11-20;1566;3333;5185;5;2351;6098;3;0;0;5732997;5308217;382099;588;5717007;526932;322;0;0
FR;2;2021-11-21;251;504;543;0;393;656;3;0;0;5733248;5308721;382642;588;5717400;527588;325;0;0
FR;2;2021-11-22;1278;2570;4485;5;1673;5397;9;0;0;5734526;5311291;387127;593;5719073;532985;334;0;0
FR;2;2021-11-23;1617;4277;8207;9;2536;9923;6;0;0;5736143;5315568;395334;602;5721609;542908;340;0;0
FR;2;2021-11-24;1421;3747;7486;14;2246;8736;9;0;0;5737564;5319315;402820;616;5723855;551644;349;0;0
FR;2;2021-11-25;1814;4863;11474;21;2682;13668;6;0;0;5739378;5324178;414294;637;5726537;565312;355;0;0
FR;2;2021-11-26;2541;7735;22676;31;3812;26091;14;0;0;5741919;5331913;436970;668;5730349;591403;369;0;0
FR;2;2021-11-27;1498;4144;12278;19;2126;14042;13;0;0;5743417;5336057;449248;687;5732475;605445;382;0;0
FR;2;2021-11-28;292;835;1976;3;478;2303;5;0;0;5743709;5336892;451224;690;5732953;607748;387;0;0
FR;2;2021-11-29;1449;4347;15099;23;2008;17269;25;0;0;5745158;5341239;466323;713;5734961;625017;412;0;0
FR;2;2021-11-30;1913;6658;26252;36;2640;30014;22;0;0;5747071;5347897;492575;749;5737601;655031;434;0;0
FR;2;2021-12-01;1918;6006;26211;31;2477;29519;20;0;0;5748989;5353903;518786;780;5740078;684550;454;0;0
FR;2;2021-12-02;1916;6780;37736;52;2112;41995;32;0;0;5750905;5360683;556522;832;5742190;726545;486;0;0
FR;2;2021-12-03;2558;10069;53644;111;3592;59391;31;0;0;5753463;5370752;610166;943;5745782;785936;517;0;0
FR;2;2021-12-04;1850;6275;37132;38;2185;40820;16;0;0;5755313;5377027;647298;981;5747967;826756;533;0;0
FR;2;2021-12-05;458;2242;14265;14;533;15990;7;0;0;5755771;5379269;661563;995;5748500;842746;540;0;0
FR;2;2021-12-06;2486;9844;77736;109;2697;84786;25;0;0;5758257;5389113;739299;1104;5751197;927532;565;0;0
FR;2;2021-12-07;3458;15288;122475;238;3743;133797;40;0;0;5761715;5404401;861774;1342;5754940;1061329;605;0;0
FR;2;2021-12-08;3725;15967;133225;330;3845;145413;54;0;0;5765440;5420368;994999;1672;5758785;1206742;659;0;0
FR;2;2021-12-09;4547;19627;170241;554;4167;185640;61;0;0;5769987;5439995;1165240;2226;5762952;1392382;720;0;0
FR;2;2021-12-10;4676;22806;188699;490;5010;206190;69;0;0;5774663;5462801;1353939;2716;5767962;1598572;789;0;0
FR;2;2021-12-11;3687;16620;132469;239;3664;144935;60;0;0;5778350;5479421;1486408;2955;5771626;1743507;849;0;0
FR;2;2021-12-12;1256;7119;59116;83;1016;65169;12;0;0;5779606;5486540;1545524;3038;5772642;1808676;861;0;0
FR;2;2021-12-13;5529;26811;220733;605;5223;243029;159;0;0;5785135;5513351;1766257;3643;5777865;2051705;1020;0;0
FR;2;2021-12-14;7019;37458;300806;909;6137;332277;190;0;0;5792154;5550809;2067063;4552;5784002;2383982;1210;0;0
FR;2;2021-12-15;6555;36215;285263;958;5866;315902;186;0;0;5798709;5587024;2352326;5510;5789868;2699884;1396;0;0
FR;2;2021-12-16;7764;37922;312181;982;6563;343824;186;0;0;5806473;5624946;2664507;6492;5796431;3043708;1582;0;0
FR;2;2021-12-17;8680;41187;327911;976;8020;360987;232;0;0;5815153;5666133;2992418;7468;5804451;3404695;1814;0;0
FR;2;2021-12-18;6515;26527;212374;448;4904;233673;120;0;0;5821668;5692660;3204792;7916;5809355;3638368;1934;0;0
FR;2;2021-12-19;2603;11403;90226;182;1655;100356;26;0;0;5824271;5704063;3295018;8098;5811010;3738724;1960;0;0
FR;2;2021-12-20;9548;33515;275258;707;6586;303403;209;0;0;5833819;5737578;3570276;8805;5817596;4042127;2169;0;0
FR;2;2021-12-21;11568;38274;309663;968;7368;341444;262;0;0;5845387;5775852;3879939;9773;5824964;4383571;2431;0;0
FR;2;2021-12-22;10461;32773;265149;952;6441;292503;316;0;1;5855848;5808625;4145088;10725;5831405;4676074;2747;0;1
FR;2;2021-12-23;9426;26620;199534;701;5875;221294;225;0;0;5865274;5835245;4344622;11426;5837280;4897368;2972;0;1
FR;2;2021-12-24;2783;7465;43866;140;2036;49560;78;0;0;5868057;5842710;4388488;11566;5839316;4946928;3050;0;1
FR;2;2021-12-25;201;669;2003;10;209;2476;15;0;0;5868258;5843379;4390491;11576;5839525;4949404;3065;0;1
FR;2;2021-12-26;1320;4215;25162;71;1052;28694;70;0;0;5869578;5847594;4415653;11647;5840577;4978098;3135;0;1
FR;2;2021-12-27;8076;29927;218439;659;6624;243388;294;0;0;5877654;5877521;4634092;12306;5847201;5221486;3429;0;1
FR;2;2021-12-28;9832;36287;272117;742;6982;302015;957;0;1;5887486;5913808;4906209;13048;5854183;5523501;4386;0;2
FR;2;2021-12-29;9498;32218;246151;765;6402;272696;1088;0;0;5896984;5946026;5152360;13813;5860585;5796197;5474;0;2
FR;2;2021-12-30;9464;28089;208839;663;5970;231478;1155;0;0;5906448;5974115;5361199;14476;5866555;6027675;6629;0;2
FR;2;2021-12-31;3011;8340;54991;176;2169;61233;392;0;0;5909459;5982455;5416190;14652;5868724;6088908;7021;0;2
FR;2;2022-01-01;231;693;2858;7;207;3353;29;0;0;5909690;5983148;5419048;14659;5868931;6092261;7050;0;2
FR;2;2022-01-02;1503;4860;29524;76;1167;33418;217;0;0;5911193;5988008;5448572;14735;5870098;6125679;7267;0;2
FR;2;2022-01-03;9606;35394;266545;806;8497;293921;1672;0;0;5920799;6023402;5715117;15541;5878595;6419600;8939;0;2
FR;2;2022-01-04;12857;45401;342102;1068;9970;377042;2458;0;1;5933656;6068803;6057219;16609;5888565;6796642;11397;0;3
FR;2;2022-01-05;11273;38626;294223;885;8634;323857;2155;0;2;5944929;6107429;6351442;17494;5897199;7120499;13552;0;5
FR;2;2022-01-06;13653;43485;331956;1298;9931;364766;2976;0;1;5958582;6150914;6683398;18792;5907130;7485265;16528;0;6
FR;2;2022-01-07;14225;47610;361123;1271;11232;396465;3159;0;0;5972807;6198524;7044521;20063;5918362;7881730;19687;0;6
FR;2;2022-01-08;7946;28137;201276;515;7209;221703;1531;0;2;5980753;6226661;7245797;20578;5925571;8103433;21218;0;8
FR;2;2022-01-09;2749;8945;62531;137;2068;69497;493;0;0;5983502;6235606;7308328;20715;5927639;8172930;21711;0;8
FR;2;2022-01-10;10100;31907;232509;859;8901;255085;2460;0;0;5993602;6267513;7540837;21574;5936540;8428015;24171;0;8
FR;2;2022-01-11;11466;36235;265948;1030;10055;290655;3378;0;1;6005068;6303748;7806785;22604;5946595;8718670;27549;0;9
FR;2;2022-01-12;8767;29784;206335;863;8717;226175;2798;0;5;6013835;6333532;8013120;23467;5955312;8944845;30347;0;14
FR;2;2022-01-13;9387;31335;224510;831;9037;244857;3463;0;4;6023222;6364867;8237630;24298;5964349;9189702;33810;0;18
FR;2;2022-01-14;9746;35573;254551;920;9840;277655;3979;0;1;6032968;6400440;8492181;25218;5974189;9467357;37789;0;19
FR;2;2022-01-15;5361;19443;140789;363;5322;153649;1929;0;0;6038329;6419883;8632970;25581;5979511;9621006;39718;0;19
FR;2;2022-01-16;1512;5457;35892;81;1619;39818;424;0;0;6039841;6425340;8668862;25662;5981130;9660824;40142;0;19
FR;2;2022-01-17;5546;19264;135421;601;6600;147263;2264;0;2;6045387;6444604;8804283;26263;5987730;9808087;42406;0;21
FR;2;2022-01-18;6422;21479;148647;648;7518;160471;3311;0;0;6051809;6466083;8952930;26911;5995248;9968558;45717;0;21
FR;2;2022-01-19;4398;16304;105112;552;6206;113701;2411;0;1;6056207;6482387;9058042;27463;6001454;10082259;48128;0;22
FR;2;2022-01-20;4873;17571;115304;603;7067;123694;3111;0;2;6061080;6499958;9173346;28066;6008521;10205953;51239;0;24
FR;2;2022-01-21;5197;20042;137358;679;7170;147777;3455;0;1;6066277;6520000;9310704;28745;6015691;10353730;54694;0;25
FR;2;2022-01-22;3033;10956;74265;260;3956;80339;1428;0;0;6069310;6530956;9384969;29005;6019647;10434069;56122;0;25
FR;2;2022-01-23;724;2707;15243;41;1055;16826;238;0;0;6070034;6533663;9400212;29046;6020702;10450895;56360;0;25
FR;2;2022-01-24;3292;12792;75084;431;5843;81018;1994;0;2;6073326;6546455;9475296;29477;6026545;10531913;58354;0;27
FR;2;2022-01-25;3575;14404;79638;496;6650;85463;2879;0;4;6076901;6560859;9554934;29973;6033195;10617376;61233;0;31
FR;2;2022-01-26;2515;10703;58987;363;5331;63037;1958;0;1;6079416;6571562;9613921;30336;6038526;10680413;63191;0;32
FR;2;2022-01-27;2684;11387;64185;391;5738;67973;2462;0;1;6082100;6582949;9678106;30727;6044264;10748386;65653;0;33
FR;2;2022-01-28;3551;18257;91730;430;8611;98907;3399;0;1;6085651;6601206;9769836;31157;6052875;10847293;69052;0;34
FR;2;2022-01-29;1896;9234;48856;164;4170;52929;1374;0;1;6087547;6610440;9818692;31321;6057045;10900222;70426;0;35
FR;2;2022-01-30;464;2206;9457;38;1049;10584;203;0;0;6088011;6612646;9828149;31359;6058094;10910806;70629;0;35
FR;2;2022-01-31;1891;9550;43834;209;4709;47321;1885;0;2;6089902;6622196;9871983;31568;6062803;10958127;72514;0;37
FR;2;2022-02-01;1917;10018;47030;279;4797;50077;2707;0;0;6091819;6632214;9919013;31847;6067600;11008204;75221;0;37
FR;2;2022-02-02;1614;8970;41124;250;4190;44147;2189;0;1;6093433;6641184;9960137;32097;6071790;11052351;77410;0;38
FR;2;2022-02-03;1732;8929;40526;205;4368;42912;2639;0;2;6095165;6650113;10000663;32302;6076158;11095263;80049;0;40
FR;2;2022-02-04;2151;15168;66648;299;7380;71317;3670;0;1;6097316;6665281;10067311;32601;6083538;11166580;83719;0;41
FR;2;2022-02-05;1360;8517;35948;132;4214;39220;1369;0;0;6098676;6673798;10103259;32733;6087752;11205800;85088;0;41
FR;2;2022-02-06;275;1761;6130;17;842;6899;218;0;0;6098951;6675559;10109389;32750;6088594;11212699;85306;0;41
FR;2;2022-02-07;1352;9543;37760;134;4535;41288;1888;0;2;6100303;6685102;10147149;32884;6093129;11253987;87194;0;43
FR;2;2022-02-08;1300;9834;40956;173;4647;43750;2741;0;1;6101603;6694936;10188105;33057;6097776;11297737;89935;0;44
FR;2;2022-02-09;1160;8841;37040;174;3804;40465;1901;0;2;6102763;6703777;10225145;33231;6101580;11338202;91836;0;46
FR;2;2022-02-10;1030;8001;33837;204;3605;36511;2051;0;1;6103793;6711778;10258982;33435;6105185;11374713;93887;0;47
FR;2;2022-02-11;1391;12088;53348;223;5283;57702;2888;0;0;6105184;6723866;10312330;33658;6110468;11432415;96775;0;47
FR;2;2022-02-12;753;6535;27989;86;2792;30808;1113;0;2;6105937;6730401;10340319;33744;6113260;11463223;97888;0;49
FR;2;2022-02-13;200;1340;4836;20;562;5577;141;0;0;6106137;6731741;10345155;33764;6113822;11468800;98029;0;49
FR;2;2022-02-14;836;6732;30274;92;2599;33233;1399;0;1;6106973;6738473;10375429;33856;6116421;11502033;99428;0;50
FR;2;2022-02-15;773;6473;28051;140;2801;29994;1965;0;2;6107746;6744946;10403480;33996;6119222;11532027;101393;0;52
FR;2;2022-02-16;657;5362;22069;124;2528;23634;1569;0;3;6108403;6750308;10425549;34120;6121750;11555661;102962;0;55
FR;2;2022-02-17;518;3786;14153;98;2131;14618;1406;0;2;6108921;6754094;10439702;34218;6123881;11570279;104368;0;57
FR;2;2022-02-18;723;5369;20443;134;3041;21130;1895;0;0;6109644;6759463;10460145;34352;6126922;11591409;106263;0;57
FR;2;2022-02-19;431;3061;10533;66;1699;11247;753;0;2;6110075;6762524;10470678;34418;6128621;11602656;107016;0;59
FR;2;2022-02-20;102;520;1463;3;314;1613;100;0;0;6110177;6763044;10472141;34421;6128935;11604269;107116;0;59
FR;2;2022-02-21;423;2685;9122;65;1569;9499;930;0;0;6110600;6765729;10481263;34486;6130504;11613768;108046;0;59
FR;2;2022-02-22;393;2568;8894;77;1622;8797;1180;0;0;6110993;6768297;10490157;34563;6132126;11622565;109226;0;59
FR;2;2022-02-23;432;2605;8992;82;1522;9269;1022;0;0;6111425;6770902;10499149;34645;6133648;11631834;110248;0;59
FR;2;2022-02-24;314;2039;6805;82;1251;6835;870;0;0;6111739;6772941;10505954;34727;6134899;11638669;111118;0;59
FR;2;2022-02-25;456;3210;11424;107;1979;11287;1560;0;3;6112195;6776151;10517378;34834;6136878;11649956;112678;0;62
FR;2;2022-02-26;297;1892;6038;49;1161;6345;587;0;1;6112492;6778043;10523416;34883;6138039;11656301;113265;0;63
FR;2;2022-02-27;76;313;908;5;214;951;98;0;0;6112568;6778356;10524324;34888;6138253;11657252;113363;0;63
FR;2;2022-02-28;332;1689;5525;53;1088;5531;733;0;0;6112900;6780045;10529849;34941;6139341;11662783;114096;0;63
FR;2;2022-03-01;279;1569;5484;46;952;5201;964;0;2;6113179;6781614;10535333;34987;6140293;11667984;115060;0;65
FR;2;2022-03-02;298;1446;5248;46;878;5092;816;0;1;6113477;6783060;10540581;35033;6141171;11673076;115876;0;66
FR;2;2022-03-03;226;1112;3709;42;721;3486;668;0;1;6113703;6784172;10544290;35075;6141892;11676562;116544;0;67
FR;2;2022-03-04;243;1469;4860;74;983;4506;950;0;1;6113946;6785641;10549150;35149;6142875;11681068;117494;0;68
FR;2;2022-03-05;174;906;2980;34;613;2724;561;0;0;6114120;6786547;10552130;35183;6143488;11683792;118055;0;68
FR;2;2022-03-06;42;190;280;5;110;322;52;0;0;6114162;6786737;10552410;35188;6143598;11684114;118107;0;68
FR;2;2022-03-07;157;659;1990;70;491;1780;472;0;0;6114319;6787396;10554400;35258;6144089;11685894;118579;0;68
FR;2;2022-03-08;143;670;2273;53;461;1908;619;0;0;6114462;6788066;10556673;35311;6144550;11687802;119198;0;68
FR;2;2022-03-09;156;709;2351;37;473;2052;617;0;0;6114618;6788775;10559024;35348;6145023;11689854;119815;0;68
FR;2;2022-03-10;123;603;1696;35;446;1471;456;0;1;6114741;6789378;10560720;35383;6145469;11691325;120271;0;69
FR;2;2022-03-11;172;757;2770;57;505;2369;737;0;1;6114913;6790135;10563490;35440;6145974;11693694;121008;0;70
FR;2;2022-03-12;149;485;1787;27;331;1557;450;0;0;6115062;6790620;10565277;35467;6146305;11695251;121458;0;70
FR;2;2022-03-13;25;75;203;30;45;204;69;0;0;6115087;6790695;10565480;35497;6146350;11695455;121527;0;70
FR;2;2022-03-14;129;470;1572;529;333;1301;951;0;0;6115216;6791165;10567052;36026;6146683;11696756;122478;0;70
FR;2;2022-03-15;139;441;1713;691;333;1333;1186;0;1;6115355;6791606;10568765;36717;6147016;11698089;123664;0;71
FR;2;2022-03-16;142;476;2013;1616;331;1593;2160;0;2;6115497;6792082;10570778;38333;6147347;11699682;125824;0;73
FR;2;2022-03-17;95;413;1412;1192;273;1148;1576;0;1;6115592;6792495;10572190;39525;6147620;11700830;127400;0;74
FR;2;2022-03-18;147;496;2026;1795;335;1669;2313;0;1;6115739;6792991;10574216;41320;6147955;11702499;129713;0;75
FR;2;2022-03-19;108;321;1210;941;219;1015;1259;0;0;6115847;6793312;10575426;42261;6148174;11703514;130972;0;75
FR;2;2022-03-20;13;77;191;59;39;168;115;0;0;6115860;6793389;10575617;42320;6148213;11703682;131087;0;75
FR;2;2022-03-21;98;307;1218;1483;181;1081;1760;0;1;6115958;6793696;10576835;43803;6148394;11704763;132847;0;76
FR;2;2022-03-22;118;391;1533;1831;244;1294;2220;0;0;6116076;6794087;10578368;45634;6148638;11706057;135067;0;76
FR;2;2022-03-23;137;362;1684;3032;232;1475;3374;0;6;6116213;6794449;10580052;48666;6148870;11707532;138441;0;82
FR;2;2022-03-24;117;293;1183;1548;186;1001;1814;0;8;6116330;6794742;10581235;50214;6149056;11708533;140255;0;90
FR;2;2022-03-25;119;361;1807;2451;238;1477;2837;0;8;6116449;6795103;10583042;52665;6149294;11710010;143092;0;98
FR;2;2022-03-26;79;247;1205;1222;138;953;1531;0;5;6116528;6795350;10584247;53887;6149432;11710963;144623;0;103
FR;2;2022-03-27;19;36;154;100;19;133;144;0;0;6116547;6795386;10584401;53987;6149451;11711096;144767;0;103
FR;2;2022-03-28;94;290;1140;1602;189;996;1835;0;6;6116641;6795676;10585541;55589;6149640;11712092;146602;0;109
FR;2;2022-03-29;108;258;1325;2467;167;1105;2760;0;4;6116749;6795934;10586866;58056;6149807;11713197;149362;0;113
FR;2;2022-03-30;91;313;1489;3187;164;1320;3424;0;2;6116840;6796247;10588355;61243;6149971;11714517;152786;0;115
FR;2;2022-03-31;104;284;1277;2332;171;1092;2616;0;3;6116944;6796531;10589632;63575;6150142;11715609;155402;0;118
FR;2;2022-04-01;123;324;1568;2349;164;1323;2667;0;7;6117067;6796855;10591200;65924;6150306;11716932;158069;0;125
FR;2;2022-04-02;81;161;845;891;83;737;1052;0;1;6117148;6797016;10592045;66815;6150389;11717669;159121;0;126
FR;2;2022-04-03;16;53;128;113;27;142;133;0;1;6117164;6797069;10592173;66928;6150416;11717811;159254;0;127
FR;2;2022-04-04;114;249;990;1447;151;799;1693;0;5;6117278;6797318;10593163;68375;6150567;11718610;160947;0;132
FR;2;2022-04-05;143;302;1322;2921;162;1150;3150;0;17;6117421;6797620;10594485;71296;6150729;11719760;164097;0;149
FR;2;2022-04-06;89;261;1308;2522;129;1131;2687;0;10;6117510;6797881;10595793;73818;6150858;11720891;166784;0;159
FR;2;2022-04-07;120;230;1303;2682;141;1042;2958;0;8;6117630;6798111;10597096;76500;6150999;11721933;169742;0;167
FR;2;2022-04-08;126;346;1636;3351;182;1328;3642;0;12;6117756;6798457;10598732;79851;6151181;11723261;173384;0;179
FR;2;2022-04-09;90;219;900;1046;144;732;1288;0;4;6117846;6798676;10599632;80897;6151325;11723993;174672;0;183
FR;2;2022-04-10;37;49;143;162;46;119;200;0;1;6117883;6798725;10599775;81059;6151371;11724112;174872;0;184
FR;2;2022-04-11;88;196;892;1560;122;782;1718;0;6;6117971;6798921;10600667;82619;6151493;11724894;176590;0;190
FR;2;2022-04-12;176;273;1183;2770;175;1062;2903;0;8;6118147;6799194;10601850;85389;6151668;11725956;179493;0;198
FR;2;2022-04-13;147;232;1125;2477;111;989;2671;0;11;6118294;6799426;10602975;87866;6151779;11726945;182164;0;209
FR;2;2022-04-14;116;227;1085;2677;114;919;2911;0;18;6118410;6799653;10604060;90543;6151893;11727864;185075;0;227
FR;2;2022-04-15;114;261;1221;2304;131;1078;2544;0;7;6118524;6799914;10605281;92847;6152024;11728942;187619;0;234
FR;2;2022-04-16;67;108;548;549;68;459;675;0;9;6118591;6800022;10605829;93396;6152092;11729401;188294;0;243
FR;2;2022-04-17;15;28;57;53;17;53;71;0;0;6118606;6800050;10605886;93449;6152109;11729454;188365;0;243
FR;2;2022-04-18;12;35;121;70;18;116;95;0;0;6118618;6800085;10606007;93519;6152127;11729570;188460;0;243
FR;2;2022-04-19;112;237;1120;1750;149;951;1934;0;9;6118730;6800322;10607127;95269;6152276;11730521;190394;0;252
FR;2;2022-04-20;95;243;1111;2172;127;935;2366;0;14;6118825;6800565;10608238;97441;6152403;11731456;192760;0;266
FR;2;2022-04-21;111;233;983;1912;125;838;2141;0;10;6118936;6800798;10609221;99353;6152528;11732294;194901;0;276
FR;2;2022-04-22;100;276;1243;2102;141;1024;2440;0;11;6119036;6801074;10610464;101455;6152669;11733318;197341;0;287
FR;2;2022-04-23;67;156;645;762;107;574;862;0;8;6119103;6801230;10611109;102217;6152776;11733892;198203;0;295
FR;2;2022-04-24;12;30;101;68;12;79;100;0;0;6119115;6801260;10611210;102285;6152788;11733971;198303;0;295
FR;2;2022-04-25;104;204;822;1329;103;711;1528;0;15;6119219;6801464;10612032;103614;6152891;11734682;199831;0;310
FR;2;2022-04-26;110;184;1041;2022;118;879;2219;0;18;6119329;6801648;10613073;105636;6153009;11735561;202050;0;328
FR;2;2022-04-27;98;181;860;1787;122;764;1809;0;7;6119427;6801829;10613933;107423;6153131;11736325;203859;0;335
FR;2;2022-04-28;93;214;949;1931;128;842;2087;0;12;6119520;6802043;10614882;109354;6153259;11737167;205946;0;347
FR;2;2022-04-29;81;282;1133;1697;131;1044;1876;0;11;6119601;6802325;10616015;111051;6153390;11738211;207822;0;358
FR;2;2022-04-30;66;127;471;540;80;430;628;0;9;6119667;6802452;10616486;111591;6153470;11738641;208450;0;367
FR;2;2022-05-01;24;24;84;49;20;85;61;0;1;6119691;6802476;10616570;111640;6153490;11738726;208511;0;368
FR;2;2022-05-02;115;232;764;1217;141;662;1375;0;5;6119806;6802708;10617334;112857;6153631;11739388;209886;0;373
FR;2;2022-05-03;153;233;999;1785;155;941;1896;0;14;6119959;6802941;10618333;114642;6153786;11740329;211782;0;387
FR;2;2022-05-04;90;226;926;1811;116;869;1822;0;13;6120049;6803167;10619259;116453;6153902;11741198;213604;0;400
FR;2;2022-05-05;127;198;857;1732;147;774;1848;0;10;6120176;6803365;10620116;118185;6154049;11741972;215452;0;410
FR;2;2022-05-06;133;246;1101;1859;139;1021;2052;0;16;6120309;6803611;10621217;120044;6154188;11742993;217504;0;426
FR;2;2022-05-07;40;99;470;504;61;406;593;0;4;6120349;6803710;10621687;120548;6154249;11743399;218097;0;430
FR;2;2022-05-08;48;54;107;71;41;102;101;0;0;6120397;6803764;10621794;120619;6154290;11743501;218198;0;430
FR;2;2022-05-09;101;174;654;986;103;604;1130;0;9;6120498;6803938;10622448;121605;6154393;11744105;219328;0;439
FR;2;2022-05-10;121;252;938;1841;155;893;1965;0;23;6120619;6804190;10623386;123446;6154548;11744998;221293;0;462
FR;2;2022-05-11;103;179;816;1879;117;795;1868;0;8;6120722;6804369;10624202;125325;6154665;11745793;223161;0;470
FR;2;2022-05-12;111;174;845;2096;116;803;2213;0;21;6120833;6804543;10625047;127421;6154781;11746596;225374;0;491
FR;2;2022-05-13;100;236;969;2097;122;900;2273;0;13;6120933;6804779;10626016;129518;6154903;11747496;227647;0;504
FR;2;2022-05-14;76;124;451;553;93;411;632;0;6;6121009;6804903;10626467;130071;6154996;11747907;228279;0;510
FR;2;2022-05-15;24;39;94;88;20;108;95;0;1;6121033;6804942;10626561;130159;6155016;11748015;228374;0;511
FR;2;2022-05-16;106;171;602;925;116;538;1037;0;11;6121139;6805113;10627163;131084;6155132;11748553;229411;0;522
FR;2;2022-05-17;95;184;690;1687;119;658;1739;0;8;6121234;6805297;10627853;132771;6155251;11749211;231150;0;530
FR;2;2022-05-18;80;181;643;1431;97;648;1486;0;10;6121314;6805478;10628496;134202;6155348;11749859;232636;0;540
FR;2;2022-05-19;73;161;710;1830;81;752;1816;0;12;6121387;6805639;10629206;136032;6155429;11750611;234452;0;552
FR;2;2022-05-20;107;181;874;1701;111;779;1849;0;17;6121494;6805820;10630080;137733;6155540;11751390;236301;0;569
FR;2;2022-05-21;48;96;398;517;71;339;581;0;8;6121542;6805916;10630478;138250;6155611;11751729;236882;0;577
FR;2;2022-05-22;8;23;69;37;18;57;56;0;0;6121550;6805939;10630547;138287;6155629;11751786;236938;0;577
FR;2;2022-05-23;86;133;498;931;100;469;967;0;7;6121636;6806072;10631045;139218;6155729;11752255;237905;0;584
FR;2;2022-05-24;87;164;627;1626;103;615;1680;0;17;6121723;6806236;10631672;140844;6155832;11752870;239585;0;601
FR;2;2022-05-25;72;146;539;1149;90;494;1260;0;5;6121795;6806382;10632211;141993;6155922;11753364;240845;0;606
FR;2;2022-05-26;12;31;77;45;13;85;56;0;1;6121807;6806413;10632288;142038;6155935;11753449;240901;0;607
FR;2;2022-05-27;44;124;456;818;68;438;893;0;9;6121851;6806537;10632744;142856;6156003;11753887;241794;0;616
FR;2;2022-05-28;28;60;221;244;29;221;266;0;1;6121879;6806597;10632965;143100;6156032;11754108;242060;0;617
FR;2;2022-05-29;13;34;43;25;22;51;28;0;0;6121892;6806631;10633008;143125;6156054;11754159;242088;0;617
FR;2;2022-05-30;65;109;425;755;60;410;806;0;6;6121957;6806740;10633433;143880;6156114;11754569;242894;0;623
FR;2;2022-05-31;76;135;564;1278;92;511;1304;0;12;6122033;6806875;10633997;145158;6156206;11755080;244198;0;635
FR;2;2022-06-01;59;160;564;1075;86;543;1170;0;6;6122092;6807035;10634561;146233;6156292;11755623;245368;0;641
FR;2;2022-06-02;92;178;627;1450;109;593;1557;0;12;6122184;6807213;10635188;147683;6156401;11756216;246925;0;653
FR;2;2022-06-03;71;157;668;1605;96;595;1694;0;19;6122255;6807370;10635856;149288;6156497;11756811;248619;0;672
FR;2;2022-06-04;69;93;283;434;66;269;476;0;11;6122324;6807463;10636139;149722;6156563;11757080;249095;0;683
FR;2;2022-06-05;12;17;63;58;16;47;75;0;1;6122336;6807480;10636202;149780;6156579;11757127;249170;0;684
FR;2;2022-06-06;12;41;93;76;30;92;81;0;4;6122348;6807521;10636295;149856;6156609;11757219;249251;0;688
FR;2;2022-06-07;99;222;667;1535;154;577;1661;0;10;6122447;6807743;10636962;151391;6156763;11757796;250912;0;698
FR;2;2022-06-08;70;119;477;1166;76;411;1262;0;5;6122517;6807862;10637439;152557;6156839;11758207;252174;0;703
FR;2;2022-06-09;93;167;613;1923;108;571;1927;0;18;6122610;6808029;10638052;154480;6156947;11758778;254101;0;721
FR;2;2022-06-10;93;168;651;1683;107;623;1774;0;23;6122703;6808197;10638703;156163;6157054;11759401;255875;0;744
FR;2;2022-06-11;44;85;287;529;42;258;583;0;5;6122747;6808282;10638990;156692;6157096;11759659;256458;0;749
FR;2;2022-06-12;18;38;58;78;27;60;78;0;0;6122765;6808320;10639048;156770;6157123;11759719;256536;0;749
FR;2;2022-06-13;39;121;395;953;63;379;1021;0;6;6122804;6808441;10639443;157723;6157186;11760098;257557;0;755
FR;2;2022-06-14;68;157;599;2088;101;537;2189;0;14;6122872;6808598;10640042;159811;6157287;11760635;259746;0;769
FR;2;2022-06-15;78;104;522;1504;84;444;1641;0;10;6122950;6808702;10640564;161315;6157371;11761079;261387;0;779
FR;2;2022-06-16;128;132;499;1411;128;426;1526;0;12;6123078;6808834;10641063;162726;6157499;11761505;262913;0;791
FR;2;2022-06-17;73;138;589;1817;88;516;1921;0;16;6123151;6808972;10641652;164543;6157587;11762021;264834;0;807
FR;2;2022-06-18;76;93;224;579;81;196;630;0;4;6123227;6809065;10641876;165122;6157668;11762217;265464;0;811
FR;2;2022-06-19;11;17;53;71;7;41;90;0;2;6123238;6809082;10641929;165193;6157675;11762258;265554;0;813
FR;2;2022-06-20;62;125;401;1028;72;392;1105;0;10;6123300;6809207;10642330;166221;6157747;11762650;266659;0;823
FR;2;2022-06-21;108;117;526;2127;105;456;2164;0;22;6123408;6809324;10642856;168348;6157852;11763106;268823;0;845
FR;2;2022-06-22;39;110;462;1889;57;415;1971;0;25;6123447;6809434;10643318;170237;6157909;11763521;270794;0;870
FR;2;2022-06-23;58;109;537;2282;68;452;2400;0;30;6123505;6809543;10643855;172519;6157977;11763973;273194;0;900
FR;2;2022-06-24;66;122;709;3199;65;571;3339;0;38;6123571;6809665;10644564;175718;6158042;11764544;276533;0;938
FR;2;2022-06-25;30;90;298;988;55;254;1041;0;13;6123601;6809755;10644862;176706;6158097;11764798;277574;0;951
FR;2;2022-06-26;30;27;131;194;29;97;236;0;5;6123631;6809782;10644993;176900;6158126;11764895;277810;0;956
FR;2;2022-06-27;79;137;582;2490;94;483;2623;0;39;6123710;6809919;10645575;179390;6158220;11765378;280433;0;995
FR;2;2022-06-28;110;140;812;4817;81;650;4894;0;54;6123820;6810059;10646387;184207;6158301;11766028;285327;0;1049
FR;2;2022-06-29;73;150;776;4436;80;637;4532;0;56;6123893;6810209;10647163;188643;6158381;11766665;289859;0;1105
FR;2;2022-06-30;72;133;834;5177;71;619;5398;0;79;6123965;6810342;10647997;193820;6158452;11767284;295257;0;1184
FR;2;2022-07-01;113;161;1152;6692;95;853;6944;0;92;6124078;6810503;10649149;200512;6158547;11768137;302201;0;1276
FR;2;2022-07-02;69;132;474;1977;82;392;2068;0;27;6124147;6810635;10649623;202489;6158629;11768529;304269;0;1303
FR;2;2022-07-03;23;30;147;334;21;131;357;0;8;6124170;6810665;10649770;202823;6158650;11768660;304626;0;1311
FR;2;2022-07-04;122;184;776;3785;113;612;3971;0;49;6124292;6810849;10650546;206608;6158763;11769272;308597;0;1360
FR;2;2022-07-05;119;188;1121;6818;121;829;6999;0;85;6124411;6811037;10651667;213426;6158884;11770101;315596;0;1445
FR;2;2022-07-06;93;152;951;5807;95;698;5933;0;84;6124504;6811189;10652618;219233;6158979;11770799;321529;0;1529
FR;2;2022-07-07;81;185;1021;6501;116;752;6732;0;101;6124585;6811374;10653639;225734;6159095;11771551;328261;0;1630
FR;2;2022-07-08;65;122;1095;7044;51;758;7235;0;123;6124650;6811496;10654734;232778;6159146;11772309;335496;0;1753
FR;2;2022-07-09;34;62;417;1869;31;299;1919;0;33;6124684;6811558;10655151;234647;6159177;11772608;337415;0;1786
FR;2;2022-07-10;7;17;97;315;8;83;327;0;5;6124691;6811575;10655248;234962;6159185;11772691;337742;0;1791
FR;2;2022-07-11;68;121;683;3826;76;541;3901;0;67;6124759;6811696;10655931;238788;6159261;11773232;341643;0;1858
FR;2;2022-07-12;102;180;1054;6517;107;809;6725;0;119;6124861;6811876;10656985;245305;6159368;11774041;348368;0;1977
FR;2;2022-07-13;65;128;879;4665;76;591;4831;0;78;6124926;6812004;10657864;249970;6159444;11774632;353199;0;2055
FR;2;2022-07-14;6;13;89;250;8;60;269;0;8;6124932;6812017;10657953;250220;6159452;11774692;353468;0;2063
FR;2;2022-07-15;61;129;739;3795;53;560;3961;0;75;6124993;6812146;10658692;254015;6159505;11775252;357429;0;2138
FR;2;2022-07-16;28;54;289;1031;30;242;1077;0;25;6125021;6812200;10658981;255046;6159535;11775494;358506;0;2163
FR;2;2022-07-17;5;12;78;201;6;67;207;0;6;6125026;6812212;10659059;255247;6159541;11775561;358713;0;2169
FR;2;2022-07-18;57;103;514;2510;61;385;2648;0;59;6125083;6812315;10659573;257757;6159602;11775946;361361;0;2228
FR;2;2022-07-19;66;133;770;4258;72;555;4447;0;72;6125149;6812448;10660343;262015;6159674;11776501;365808;0;2300
FR;2;2022-07-20;59;117;582;3179;68;430;3278;0;87;6125208;6812565;10660925;265194;6159742;11776931;369086;0;2387
FR;2;2022-07-21;60;110;673;3680;73;487;3797;0;105;6125268;6812675;10661598;268874;6159815;11777418;372883;0;2492
FR;2;2022-07-22;51;100;700;3550;48;507;3701;0;80;6125319;6812775;10662298;272424;6159863;11777925;376584;0;2572
FR;2;2022-07-23;38;97;290;1175;51;229;1228;0;37;6125357;6812872;10662588;273599;6159914;11778154;377812;0;2609
FR;2;2022-07-24;14;24;69;201;19;68;203;0;7;6125371;6812896;10662657;273800;6159933;11778222;378015;0;2616
FR;2;2022-07-25;50;71;405;1938;60;300;2000;0;56;6125421;6812967;10663062;275738;6159993;11778522;380015;0;2672
FR;2;2022-07-26;57;133;606;3423;67;476;3496;0;113;6125478;6813100;10663668;279161;6160060;11778998;383511;0;2785
FR;2;2022-07-27;42;81;457;2782;50;361;2801;0;89;6125520;6813181;10664125;281943;6160110;11779359;386312;0;2874
FR;2;2022-07-28;29;75;450;2487;37;356;2491;0;78;6125549;6813256;10664575;284430;6160147;11779715;388803;0;2952
FR;2;2022-07-29;68;88;535;2857;63;347;2978;0;73;6125617;6813344;10665110;287287;6160210;11780062;391781;0;3025
FR;2;2022-07-30;22;39;163;776;32;110;796;0;24;6125639;6813383;10665273;288063;6160242;11780172;392577;0;3049
FR;2;2022-07-31;6;13;27;104;12;21;110;0;2;6125645;6813396;10665300;288167;6160254;11780193;392687;0;3051
FR;2;2022-08-01;38;107;323;1262;74;260;1344;0;29;6125683;6813503;10665623;289429;6160328;11780453;394031;0;3080
FR;2;2022-08-02;49;75;325;2061;50;247;2097;0;78;6125732;6813578;10665948;291490;6160378;11780700;396128;0;3158
FR;2;2022-08-03;29;53;260;1611;25;188;1617;0;57;6125761;6813631;10666208;293101;6160403;11780888;397745;0;3215
FR;2;2022-08-04;40;65;306;1692;39;240;1701;0;66;6125801;6813696;10666514;294793;6160442;11781128;399446;0;3281
FR;2;2022-08-05;33;94;328;1881;67;236;1912;0;60;6125834;6813790;10666842;296674;6160509;11781364;401358;0;3341
FR;2;2022-08-06;22;41;106;365;29;82;372;0;10;6125856;6813831;10666948;297039;6160538;11781446;401730;0;3351
FR;2;2022-08-07;7;8;15;69;5;16;71;0;3;6125863;6813839;10666963;297108;6160543;11781462;401801;0;3354
FR;2;2022-08-08;19;35;220;877;22;148;915;0;33;6125882;6813874;10667183;297985;6160565;11781610;402716;0;3387
FR;2;2022-08-09;30;52;279;1474;42;238;1470;0;50;6125912;6813926;10667462;299459;6160607;11781848;404186;0;3437
FR;2;2022-08-10;17;22;213;1134;19;150;1155;0;46;6125929;6813948;10667675;300593;6160626;11781998;405341;0;3483
FR;2;2022-08-11;21;41;174;1038;26;117;1047;0;40;6125950;6813989;10667849;301631;6160652;11782115;406388;0;3523
FR;2;2022-08-12;36;51;184;1046;38;141;1069;0;35;6125986;6814040;10668033;302677;6160690;11782256;407457;0;3558
FR;2;2022-08-13;11;19;47;149;15;53;137;0;5;6125997;6814059;10668080;302826;6160705;11782309;407594;0;3563
FR;2;2022-08-14;1;2;12;52;1;11;54;0;1;6125998;6814061;10668092;302878;6160706;11782320;407648;0;3564
FR;2;2022-08-15;0;5;32;22;2;21;21;0;3;6125998;6814066;10668124;302900;6160708;11782341;407669;0;3567
FR;2;2022-08-16;27;33;144;681;34;120;678;0;33;6126025;6814099;10668268;303581;6160742;11782461;408347;0;3600
FR;2;2022-08-17;18;27;109;738;18;88;744;0;34;6126043;6814126;10668377;304319;6160760;11782549;409091;0;3634
FR;2;2022-08-18;14;30;160;836;14;107;852;0;42;6126057;6814156;10668537;305155;6160774;11782656;409943;0;3676
FR;2;2022-08-19;8;38;118;706;31;88;706;0;33;6126065;6814194;10668655;305861;6160805;11782744;410649;0;3709
FR;2;2022-08-20;6;26;61;197;16;52;201;0;8;6126071;6814220;10668716;306058;6160821;11782796;410850;0;3717
FR;2;2022-08-21;4;14;15;19;6;13;31;0;0;6126075;6814234;10668731;306077;6160827;11782809;410881;0;3717
FR;2;2022-08-22;11;25;116;395;17;73;451;0;13;6126086;6814259;10668847;306472;6160844;11782882;411332;0;3730
FR;2;2022-08-23;12;42;134;671;23;112;679;0;38;6126098;6814301;10668981;307143;6160867;11782994;412011;0;3768
FR;2;2022-08-24;11;28;87;466;21;80;472;0;18;6126109;6814329;10669068;307609;6160888;11783074;412483;0;3786
FR;2;2022-08-25;8;32;109;481;16;69;516;0;17;6126117;6814361;10669177;308090;6160904;11783143;412999;0;3803
FR;2;2022-08-26;16;46;117;720;36;91;713;0;32;6126133;6814407;10669294;308810;6160940;11783234;413712;0;3835
FR;2;2022-08-27;10;19;47;158;16;42;166;0;2;6126143;6814426;10669341;308968;6160956;11783276;413878;0;3837
FR;2;2022-08-28;1;5;5;15;1;7;16;0;1;6126144;6814431;10669346;308983;6160957;11783283;413894;0;3838
FR;2;2022-08-29;24;43;94;400;29;88;396;0;24;6126168;6814474;10669440;309383;6160986;11783371;414290;0;3862
FR;2;2022-08-30;31;54;154;791;34;119;798;0;29;6126199;6814528;10669594;310174;6161020;11783490;415088;0;3891
FR;2;2022-08-31;19;37;85;392;24;79;393;0;25;6126218;6814565;10669679;310566;6161044;11783569;415481;0;3916
FR;2;2022-09-01;19;43;139;600;25;122;609;0;36;6126237;6814608;10669818;311166;6161069;11783691;416090;0;3952
FR;2;2022-09-02;34;57;147;744;34;160;748;0;32;6126271;6814665;10669965;311910;6161103;11783851;416838;0;3984
FR;2;2022-09-03;17;20;83;205;11;67;213;0;7;6126288;6814685;10670048;312115;6161114;11783918;417051;0;3991
FR;2;2022-09-04;8;5;9;31;2;10;30;0;3;6126296;6814690;10670057;312146;6161116;11783928;417081;0;3994
FR;2;2022-09-05;29;32;126;367;24;98;397;0;24;6126325;6814722;10670183;312513;6161140;11784026;417478;0;4018
FR;2;2022-09-06;44;63;158;762;43;153;768;0;36;6126369;6814785;10670341;313275;6161183;11784179;418246;0;4054
FR;2;2022-09-07;21;22;76;375;18;51;387;0;23;6126390;6814807;10670417;313650;6161201;11784230;418633;0;4077
FR;2;2022-09-08;31;58;109;636;41;100;646;0;22;6126421;6814865;10670526;314286;6161242;11784330;419279;0;4099
FR;2;2022-09-09;18;24;126;754;21;74;747;0;48;6126439;6814889;10670652;315040;6161263;11784404;420026;0;4147
FR;2;2022-09-10;14;25;57;117;17;48;131;0;4;6126453;6814914;10670709;315157;6161280;11784452;420157;0;4151
FR;2;2022-09-11;12;5;11;11;3;13;13;0;0;6126465;6814919;10670720;315168;6161283;11784465;420170;0;4151
FR;2;2022-09-12;20;31;70;340;26;56;352;0;16;6126485;6814950;10670790;315508;6161309;11784521;420522;0;4167
FR;2;2022-09-13;15;34;125;670;13;99;674;0;40;6126500;6814984;10670915;316178;6161322;11784620;421196;0;4207
FR;2;2022-09-14;19;23;81;480;20;60;478;0;36;6126519;6815007;10670996;316658;6161342;11784680;421674;0;4243
FR;2;2022-09-15;23;45;126;486;27;102;493;0;47;6126542;6815052;10671122;317144;6161369;11784782;422167;0;4290
FR;2;2022-09-16;22;32;124;563;18;89;585;0;39;6126564;6815084;10671246;317707;6161387;11784871;422752;0;4329
FR;2;2022-09-17;6;20;56;160;15;52;147;0;14;6126570;6815104;10671302;317867;6161402;11784923;422899;0;4343
FR;2;2022-09-18;4;7;13;37;6;10;37;0;3;6126574;6815111;10671315;317904;6161408;11784933;422936;0;4346
FR;2;2022-09-19;26;24;114;353;16;87;381;0;22;6126600;6815135;10671429;318257;6161424;11785020;423317;0;4368
FR;2;2022-09-20;29;27;117;624;21;84;639;0;38;6126629;6815162;10671546;318881;6161445;11785104;423956;0;4406
FR;2;2022-09-21;15;30;100;393;15;78;418;0;23;6126644;6815192;10671646;319274;6161460;11785182;424374;0;4429
FR;2;2022-09-22;19;39;124;581;18;95;619;0;28;6126663;6815231;10671770;319855;6161478;11785277;424993;0;4457
FR;2;2022-09-23;21;38;135;556;22;111;571;0;40;6126684;6815269;10671905;320411;6161500;11785388;425564;0;4497
FR;2;2022-09-24;10;8;52;191;8;37;201;0;8;6126694;6815277;10671957;320602;6161508;11785425;425765;0;4505
FR;2;2022-09-25;9;11;15;29;11;12;33;0;5;6126703;6815288;10671972;320631;6161519;11785437;425798;0;4510
FR;2;2022-09-26;22;41;116;447;27;79;458;0;20;6126725;6815329;10672088;321078;6161546;11785516;426256;0;4530
FR;2;2022-09-27;30;46;162;906;35;108;861;0;52;6126755;6815375;10672250;321984;6161581;11785624;427117;0;4582
FR;2;2022-09-28;15;31;93;421;18;74;439;0;23;6126770;6815406;10672343;322405;6161599;11785698;427556;0;4605
FR;2;2022-09-29;26;48;115;618;23;110;630;0;33;6126796;6815454;10672458;323023;6161622;11785808;428186;0;4638
FR;2;2022-09-30;25;44;111;520;45;84;533;0;31;6126821;6815498;10672569;323543;6161667;11785892;428719;0;4669
FR;2;2022-10-01;11;20;51;128;20;36;129;0;8;6126832;6815518;10672620;323671;6161687;11785928;428848;0;4677
FR;2;2022-10-02;0;5;8;21;4;5;25;0;2;6126832;6815523;10672628;323692;6161691;11785933;428873;0;4679
FR;2;2022-10-03;22;35;85;291;30;69;306;0;22;6126854;6815558;10672713;323983;6161721;11786002;429179;0;4701
FR;2;2022-10-04;17;21;106;601;19;71;620;0;46;6126871;6815579;10672819;324584;6161740;11786073;429799;0;4747
FR;2;2022-10-05;20;31;75;491;26;67;488;0;54;6126891;6815610;10672894;325075;6161766;11786140;430287;0;4801
FR;2;2022-10-06;30;23;74;442;17;71;428;0;65;6126921;6815633;10672968;325517;6161783;11786211;430715;0;4866
FR;2;2022-10-07;21;30;86;499;27;66;503;0;42;6126942;6815663;10673054;326016;6161810;11786277;431218;0;4908
FR;2;2022-10-08;12;8;24;114;3;25;108;0;12;6126954;6815671;10673078;326130;6161813;11786302;431326;0;4920
FR;2;2022-10-09;1;8;15;17;6;11;22;0;5;6126955;6815679;10673093;326147;6161819;11786313;431348;0;4925
FR;2;2022-10-10;18;27;47;223;25;49;218;0;21;6126973;6815706;10673140;326370;6161844;11786362;431566;0;4946
FR;2;2022-10-11;16;15;48;253;11;39;241;0;52;6126989;6815721;10673188;326623;6161855;11786401;431807;0;4998
FR;2;2022-10-12;9;20;52;290;16;36;305;0;56;6126998;6815741;10673240;326913;6161871;11786437;432112;0;5054
FR;2;2022-10-13;11;14;48;271;9;48;261;0;26;6127009;6815755;10673288;327184;6161880;11786485;432373;0;5080
FR;2;2022-10-14;13;30;36;230;18;40;231;0;29;6127022;6815785;10673324;327414;6161898;11786525;432604;0;5109
FR;2;2022-10-15;4;13;22;111;7;17;113;0;15;6127026;6815798;10673346;327525;6161905;11786542;432717;0;5124
FR;2;2022-10-16;0;7;4;11;6;7;8;0;1;6127026;6815805;10673350;327536;6161911;11786549;432725;0;5125
FR;2;2022-10-17;15;19;31;121;18;26;131;0;29;6127041;6815824;10673381;327657;6161929;11786575;432856;0;5154
FR;2;2022-10-18;13;12;68;185;6;34;247;0;46;6127054;6815836;10673449;327842;6161935;11786609;433103;0;5200
FR;2;2022-10-19;8;17;39;184;12;31;223;0;52;6127062;6815853;10673488;328026;6161947;11786640;433326;0;5252
FR;2;2022-10-20;11;29;41;200;15;40;196;0;52;6127073;6815882;10673529;328226;6161962;11786680;433522;0;5304
FR;2;2022-10-21;6;16;60;233;7;53;222;0;31;6127079;6815898;10673589;328459;6161969;11786733;433744;0;5335
FR;2;2022-10-22;8;7;25;102;2;23;103;0;20;6127087;6815905;10673614;328561;6161971;11786756;433847;0;5355
FR;2;2022-10-23;0;3;1;5;3;0;6;0;2;6127087;6815908;10673615;328566;6161974;11786756;433853;0;5357
FR;2;2022-10-24;12;12;16;110;12;16;113;0;20;6127099;6815920;10673631;328676;6161986;11786772;433966;0;5377
FR;2;2022-10-25;12;7;23;138;6;15;145;0;51;6127111;6815927;10673654;328814;6161992;11786787;434111;0;5428
FR;2;2022-10-26;4;3;17;90;2;11;96;0;27;6127115;6815930;10673671;328904;6161994;11786798;434207;0;5455
FR;2;2022-10-27;7;10;18;88;10;20;71;0;27;6127122;6815940;10673689;328992;6162004;11786818;434278;0;5482
FR;2;2022-10-28;5;3;15;91;3;7;92;0;27;6127127;6815943;10673704;329083;6162007;11786825;434370;0;5509
FR;2;2022-10-29;7;8;18;33;6;14;37;0;8;6127134;6815951;10673722;329116;6162013;11786839;434407;0;5517
FR;2;2022-10-30;3;7;5;8;5;2;5;0;1;6127137;6815958;10673727;329124;6162018;11786841;434412;0;5518
FR;2;2022-10-31;2;8;6;49;6;10;48;0;11;6127139;6815966;10673733;329173;6162024;11786851;434460;0;5529
FR;2;2022-11-01;0;6;8;1;5;6;4;0;0;6127139;6815972;10673741;329174;6162029;11786857;434464;0;5529
FR;2;2022-11-02;6;5;12;44;5;12;45;0;11;6127145;6815977;10673753;329218;6162034;11786869;434509;0;5540
FR;2;2022-11-03;6;7;16;77;6;10;75;0;18;6127151;6815984;10673769;329295;6162040;11786879;434584;0;5558
FR;2;2022-11-04;7;12;15;85;10;14;93;0;10;6127158;6815996;10673784;329380;6162050;11786893;434677;0;5568
FR;2;2022-11-05;0;11;13;38;6;17;35;0;6;6127158;6816007;10673797;329418;6162056;11786910;434712;0;5574
FR;2;2022-11-06;0;2;2;1;0;4;0;0;2;6127158;6816009;10673799;329419;6162056;11786914;434712;0;5576
FR;2;2022-11-07;13;8;15;67;6;14;66;0;21;6127171;6816017;10673814;329486;6162062;11786928;434778;0;5597
FR;2;2022-11-08;14;8;18;58;6;14;65;0;27;6127185;6816025;10673832;329544;6162068;11786942;434843;0;5624
FR;2;2022-11-09;4;5;17;56;2;17;50;0;28;6127189;6816030;10673849;329600;6162070;11786959;434893;0;5652
FR;2;2022-11-10;7;10;17;74;7;14;76;0;14;6127196;6816040;10673866;329674;6162077;11786973;434969;0;5666
FR;2;2022-11-11;0;3;9;3;0;10;4;0;0;6127196;6816043;10673875;329677;6162077;11786983;434973;0;5666
FR;2;2022-11-12;2;5;7;19;4;7;19;0;4;6127198;6816048;10673882;329696;6162081;11786990;434992;0;5670
FR;2;2022-11-13;3;2;4;2;1;5;1;0;0;6127201;6816050;10673886;329698;6162082;11786995;434993;0;5670
FR;2;2022-11-14;7;6;13;29;3;10;33;0;7;6127208;6816056;10673899;329727;6162085;11787005;435026;0;5677
FR;2;2022-11-15;8;15;15;35;16;18;32;0;7;6127216;6816071;10673914;329762;6162101;11787023;435058;0;5684
FR;2;2022-11-16;3;6;4;45;6;4;46;0;18;6127219;6816077;10673918;329807;6162107;11787027;435104;0;5702
FR;2;2022-11-17;2;6;12;56;5;9;55;0;22;6127221;6816083;10673930;329863;6162112;11787036;435159;0;5724
FR;2;2022-11-18;3;4;7;41;4;6;44;0;10;6127224;6816087;10673937;329904;6162116;11787042;435203;0;5734
FR;2;2022-11-19;3;3;2;25;3;3;18;0;5;6127227;6816090;10673939;329929;6162119;11787045;435221;0;5739
FR;2;2022-11-20;0;2;6;9;2;6;10;0;26;6127227;6816092;10673945;329938;6162121;11787051;435231;0;5765
FR;2;2022-11-21;6;10;9;31;7;8;34;0;22;6127233;6816102;10673954;329969;6162128;11787059;435265;0;5787
FR;2;2022-11-22;8;8;20;65;6;21;70;0;71;6127241;6816110;10673974;330034;6162134;11787080;435335;0;5858
FR;2;2022-11-23;7;6;8;68;3;5;73;0;8;6127248;6816116;10673982;330102;6162137;11787085;435408;0;5866
FR;2;2022-11-24;2;2;11;51;2;7;58;0;10;6127250;6816118;10673993;330153;6162139;11787092;435466;0;5876
FR;2;2022-11-25;11;8;14;25;11;14;26;0;8;6127261;6816126;10674007;330178;6162150;11787106;435492;0;5884
FR;2;2022-11-26;1;5;4;8;4;7;6;0;0;6127262;6816131;10674011;330186;6162154;11787113;435498;0;5884
FR;2;2022-11-27;2;2;12;2;0;11;4;0;1;6127264;6816133;10674023;330188;6162154;11787124;435502;0;5885
FR;2;2022-11-28;0;2;8;35;1;6;37;0;5;6127264;6816135;10674031;330223;6162155;11787130;435539;0;5890
FR;2;2022-11-29;1;1;10;24;0;4;30;0;8;6127265;6816136;10674041;330247;6162155;11787134;435569;0;5898
FR;2;2022-11-30;2;2;10;47;1;11;44;0;21;6127267;6816138;10674051;330294;6162156;11787145;435613;0;5919
FR;2;2022-12-01;2;12;6;63;9;13;55;0;24;6127269;6816150;10674057;330357;6162165;11787158;435668;0;5943
FR;2;2022-12-02;1;2;12;51;2;10;51;0;27;6127270;6816152;10674069;330408;6162167;11787168;435719;0;5970
FR;2;2022-12-03;1;4;8;19;2;8;18;0;10;6127271;6816156;10674077;330427;6162169;11787176;435737;0;5980
FR;2;2022-12-04;0;0;0;4;0;0;4;0;2;6127271;6816156;10674077;330431;6162169;11787176;435741;0;5982
FR;2;2022-12-05;3;5;8;51;8;4;45;0;16;6127274;6816161;10674085;330482;6162177;11787180;435786;0;5998
FR;2;2022-12-06;3;5;14;45;4;6;48;0;17;6127277;6816166;10674099;330527;6162181;11787186;435834;0;6015
FR;2;2022-12-07;1;5;9;42;3;8;44;0;11;6127278;6816171;10674108;330569;6162184;11787194;435878;0;6026
FR;2;2022-12-08;0;2;11;44;0;6;49;0;16;6127278;6816173;10674119;330613;6162184;11787200;435927;0;6042
FR;2;2022-12-09;0;1;13;52;0;9;57;0;17;6127278;6816174;10674132;330665;6162184;11787209;435984;0;6059
FR;2;2022-12-10;0;3;15;50;1;6;52;0;9;6127278;6816177;10674147;330715;6162185;11787215;436036;0;6068
FR;2;2022-12-11;0;0;2;2;0;2;1;0;3;6127278;6816177;10674149;330717;6162185;11787217;436037;0;6071
FR;2;2022-12-12;1;0;6;37;0;6;36;0;11;6127279;6816177;10674155;330754;6162185;11787223;436073;0;6082
FR;2;2022-12-13;0;3;2;37;2;1;37;0;14;6127279;6816180;10674157;330791;6162187;11787224;436110;0;6096
FR;2;2022-12-14;0;5;8;26;5;3;31;0;14;6127279;6816185;10674165;330817;6162192;11787227;436141;0;6110
FR;2;2022-12-15;0;5;12;43;5;9;44;0;17;6127279;6816190;10674177;330860;6162197;11787236;436185;0;6127
FR;2;2022-12-16;2;4;27;56;3;20;62;0;16;6127281;6816194;10674204;330916;6162200;11787256;436247;0;6143
FR;2;2022-12-17;1;4;10;44;3;6;39;0;5;6127282;6816198;10674214;330960;6162203;11787262;436286;0;6148
FR;2;2022-12-18;1;0;0;0;0;0;0;0;1;6127283;6816198;10674214;330960;6162203;11787262;436286;0;6149
FR;2;2022-12-19;6;5;4;31;6;5;24;0;24;6127289;6816203;10674218;330991;6162209;11787267;436310;0;6173
FR;2;2022-12-20;0;4;6;37;2;7;38;0;24;6127289;6816207;10674224;331028;6162211;11787274;436348;0;6197
FR;2;2022-12-21;0;1;4;13;1;4;13;0;8;6127289;6816208;10674228;331041;6162212;11787278;436361;0;6205
FR;2;2022-12-22;0;5;17;32;2;6;45;0;10;6127289;6816213;10674245;331073;6162214;11787284;436406;0;6215
FR;2;2022-12-23;1;5;15;18;3;12;22;0;4;6127290;6816218;10674260;331091;6162217;11787296;436428;0;6219
FR;2;2022-12-24;0;0;1;1;0;1;1;0;0;6127290;6816218;10674261;331092;6162217;11787297;436429;0;6219
FR;2;2022-12-25;0;1;1;3;0;1;4;0;0;6127290;6816219;10674262;331095;6162217;11787298;436433;0;6219
FR;2;2022-12-26;0;0;7;11;0;5;11;0;3;6127290;6816219;10674269;331106;6162217;11787303;436444;0;6222
FR;2;2022-12-27;0;1;7;5;1;5;7;0;4;6127290;6816220;10674276;331111;6162218;11787308;436451;0;6226
FR;2;2022-12-28;0;2;4;13;2;3;14;0;5;6127290;6816222;10674280;331124;6162220;11787311;436465;0;6231
FR;2;2022-12-29;1;2;4;18;1;5;18;0;7;6127291;6816224;10674284;331142;6162221;11787316;436483;0;6238
FR;2;2022-12-30;1;0;2;8;0;2;7;0;1;6127292;6816224;10674286;331150;6162221;11787318;436490;0;6239
FR;2;2022-12-31;0;0;1;2;0;1;2;0;1;6127292;6816224;10674287;331152;6162221;11787319;436492;0;6240
FR;2;2023-01-01;0;0;0;0;0;0;0;0;0;6127292;6816224;10674287;331152;6162221;11787319;436492;0;6240
FR;2;2023-01-02;5;5;9;21;4;7;23;0;2;6127297;6816229;10674296;331173;6162225;11787326;436515;0;6242
FR;2;2023-01-03;1;0;6;13;0;7;11;0;6;6127298;6816229;10674302;331186;6162225;11787333;436526;0;6248
FR;2;2023-01-04;1;4;9;13;5;7;13;0;6;6127299;6816233;10674311;331199;6162230;11787340;436539;0;6254
FR;2;2023-01-05;0;2;7;6;2;4;7;0;3;6127299;6816235;10674318;331205;6162232;11787344;436546;0;6257
FR;2;2023-01-06;1;0;9;9;0;4;13;0;9;6127300;6816235;10674327;331214;6162232;11787348;436559;0;6266
FR;2;2023-01-07;0;0;4;10;0;4;8;0;5;6127300;6816235;10674331;331224;6162232;11787352;436567;0;6271
FR;2;2023-01-08;0;0;3;3;0;3;3;0;2;6127300;6816235;10674334;331227;6162232;11787355;436570;0;6273
FR;2;2023-01-09;0;2;8;9;2;3;13;0;5;6127300;6816237;10674342;331236;6162234;11787358;436583;0;6278
FR;2;2023-01-10;0;5;4;8;4;3;10;0;6;6127300;6816242;10674346;331244;6162238;11787361;436593;0;6284
FR;2;2023-01-11;3;0;4;7;0;3;9;0;3;6127303;6816242;10674350;331251;6162238;11787364;436602;0;6287
FR;2;2023-01-12;1;1;9;13;1;7;10;0;11;6127304;6816243;10674359;331264;6162239;11787371;436612;0;6298
FR;2;2023-01-13;0;1;5;7;1;3;10;0;3;6127304;6816244;10674364;331271;6162240;11787374;436622;0;6301
FR;2;2023-01-14;0;1;2;6;0;3;6;0;1;6127304;6816245;10674366;331277;6162240;11787377;436628;0;6302
FR;2;2023-01-15;0;0;0;0;0;0;0;0;0;6127304;6816245;10674366;331277;6162240;11787377;436628;0;6302
FR;2;2023-01-16;1;1;5;7;2;2;7;0;1;6127305;6816246;10674371;331284;6162242;11787379;436635;0;6303
FR;2;2023-01-17;1;0;5;4;0;5;3;0;0;6127306;6816246;10674376;331288;6162242;11787384;436638;0;6303
FR;2;2023-01-18;0;0;3;2;0;3;2;0;0;6127306;6816246;10674379;331290;6162242;11787387;436640;0;6303
FR;2;2023-01-19;0;0;1;6;0;1;6;0;6;6127306;6816246;10674380;331296;6162242;11787388;436646;0;6309
FR;2;2023-01-20;0;0;1;8;0;1;8;0;4;6127306;6816246;10674381;331304;6162242;11787389;436654;0;6313
FR;2;2023-01-21;0;0;0;3;0;0;0;0;0;6127306;6816246;10674381;331307;6162242;11787389;436654;0;6313
FR;2;2023-01-22;0;0;0;0;0;0;0;0;0;6127306;6816246;10674381;331307;6162242;11787389;436654;0;6313
FR;2;2023-01-23;0;0;3;3;0;2;3;0;1;6127306;6816246;10674384;331310;6162242;11787391;436657;0;6314
FR;2;2023-01-24;1;3;1;6;3;0;7;0;4;6127307;6816249;10674385;331316;6162245;11787391;436664;0;6318
FR;2;2023-01-25;1;0;0;6;0;0;6;0;0;6127308;6816249;10674385;331322;6162245;11787391;436670;0;6318
FR;2;2023-01-26;1;0;3;7;0;1;9;0;3;6127309;6816249;10674388;331329;6162245;11787392;436679;0;6321
FR;2;2023-01-27;0;2;3;3;1;2;3;0;2;6127309;6816251;10674391;331332;6162246;11787394;436682;0;6323
FR;2;2023-01-28;0;0;0;1;0;0;1;0;0;6127309;6816251;10674391;331333;6162246;11787394;436683;0;6323
FR;2;2023-01-29;0;0;1;0;0;0;1;0;0;6127309;6816251;10674392;331333;6162246;11787394;436684;0;6323
FR;2;2023-01-30;0;1;2;3;1;1;4;0;1;6127309;6816252;10674394;331336;6162247;11787395;436688;0;6324
FR;2;2023-01-31;1;0;3;2;0;2;3;0;0;6127310;6816252;10674397;331338;6162247;11787397;436691;0;6324
FR;2;2023-02-01;0;3;2;0;2;3;0;0;0;6127310;6816255;10674399;331338;6162249;11787400;436691;0;6324
FR;2;2023-02-02;0;2;3;4;1;4;6;0;4;6127310;6816257;10674402;331342;6162250;11787404;436697;0;6328
FR;2;2023-02-03;0;2;1;12;2;0;11;0;9;6127310;6816259;10674403;331354;6162252;11787404;436708;0;6337
FR;2;2023-02-04;0;1;1;0;0;2;0;0;0;6127310;6816260;10674404;331354;6162252;11787406;436708;0;6337
FR;2;2023-02-05;0;0;0;0;0;0;0;0;0;6127310;6816260;10674404;331354;6162252;11787406;436708;0;6337
FR;2;2023-02-06;0;4;2;2;3;3;2;0;0;6127310;6816264;10674406;331356;6162255;11787409;436710;0;6337
FR;2;2023-02-07;2;1;0;0;0;1;0;0;1;6127312;6816265;10674406;331356;6162255;11787410;436710;0;6338
FR;2;2023-02-08;0;0;3;2;0;2;4;0;1;6127312;6816265;10674409;331358;6162255;11787412;436714;0;6339
FR;2;2023-02-09;0;0;1;4;0;2;3;0;3;6127312;6816265;10674410;331362;6162255;11787414;436717;0;6342
FR;2;2023-02-10;0;0;1;3;0;1;2;0;6;6127312;6816265;10674411;331365;6162255;11787415;436719;0;6348
FR;2;2023-02-11;2;2;1;1;0;2;2;0;0;6127314;6816267;10674412;331366;6162255;11787417;436721;0;6348
FR;2;2023-02-12;0;0;0;0;0;0;0;0;0;6127314;6816267;10674412;331366;6162255;11787417;436721;0;6348
FR;2;2023-02-13;3;0;1;5;0;0;5;0;1;6127317;6816267;10674413;331371;6162255;11787417;436726;0;6349
FR;2;2023-02-14;1;2;1;1;2;0;2;0;0;6127318;6816269;10674414;331372;6162257;11787417;436728;0;6349
FR;2;2023-02-15;3;0;1;1;0;1;1;0;0;6127321;6816269;10674415;331373;6162257;11787418;436729;0;6349
FR;2;2023-02-16;3;1;1;1;1;1;1;0;2;6127324;6816270;10674416;331374;6162258;11787419;436730;0;6351
FR;2;2023-02-17;0;0;1;4;0;1;3;0;4;6127324;6816270;10674417;331378;6162258;11787420;436733;0;6355
FR;2;2023-02-18;0;0;5;1;0;5;0;0;1;6127324;6816270;10674422;331379;6162258;11787425;436733;0;6356
FR;2;2023-02-19;0;1;0;0;1;0;0;0;0;6127324;6816271;10674422;331379;6162259;11787425;436733;0;6356
FR;2;2023-02-20;1;0;0;1;0;0;1;0;2;6127325;6816271;10674422;331380;6162259;11787425;436734;0;6358
FR;2;2023-02-21;0;0;0;1;0;0;1;0;2;6127325;6816271;10674422;331381;6162259;11787425;436735;0;6360
FR;2;2023-02-22;1;0;0;3;0;0;3;0;0;6127326;6816271;10674422;331384;6162259;11787425;436738;0;6360
FR;2;2023-02-23;0;0;0;1;0;0;1;0;3;6127326;6816271;10674422;331385;6162259;11787425;436739;0;6363
FR;2;2023-02-24;1;0;1;2;0;0;3;0;0;6127327;6816271;10674423;331387;6162259;11787425;436742;0;6363
FR;2;2023-02-25;0;0;1;2;0;1;2;0;0;6127327;6816271;10674424;331389;6162259;11787426;436744;0;6363
FR;2;2023-02-26;0;0;0;0;0;0;0;0;0;6127327;6816271;10674424;331389;6162259;11787426;436744;0;6363
FR;2;2023-02-27;1;0;1;1;1;1;1;0;0;6127328;6816271;10674425;331390;6162260;11787427;436745;0;6363
FR;2;2023-02-28;1;0;0;0;0;0;0;0;2;6127329;6816271;10674425;331390;6162260;11787427;436745;0;6365
FR;2;2023-03-01;0;2;3;2;1;3;1;0;1;6127329;6816273;10674428;331392;6162261;11787430;436746;0;6366
FR;2;2023-03-02;0;2;2;1;2;1;1;0;1;6127329;6816275;10674430;331393;6162263;11787431;436747;0;6367
FR;2;2023-03-03;1;0;3;1;0;3;1;0;0;6127330;6816275;10674433;331394;6162263;11787434;436748;0;6367
FR;2;2023-03-04;0;0;1;0;0;1;0;0;0;6127330;6816275;10674434;331394;6162263;11787435;436748;0;6367
FR;2;2023-03-05;0;0;0;0;0;0;0;0;0;6127330;6816275;10674434;331394;6162263;11787435;436748;0;6367
FR;2;2023-03-06;0;0;2;1;0;1;2;0;2;6127330;6816275;10674436;331395;6162263;11787436;436750;0;6369
FR;2;2023-03-07;0;2;2;1;2;2;1;0;1;6127330;6816277;10674438;331396;6162265;11787438;436751;0;6370
FR;2;2023-03-08;0;0;0;0;0;0;0;0;2;6127330;6816277;10674438;331396;6162265;11787438;436751;0;6372
FR;2;2023-03-09;0;0;1;1;0;0;2;0;0;6127330;6816277;10674439;331397;6162265;11787438;436753;0;6372
FR;2;2023-03-10;0;0;1;0;0;1;0;0;0;6127330;6816277;10674440;331397;6162265;11787439;436753;0;6372
FR;2;2023-03-11;0;0;4;1;0;3;2;0;0;6127330;6816277;10674444;331398;6162265;11787442;436755;0;6372
FR;2;2023-03-12;0;0;0;0;0;0;0;0;0;6127330;6816277;10674444;331398;6162265;11787442;436755;0;6372
FR;2;2023-03-13;0;0;1;3;0;1;3;0;0;6127330;6816277;10674445;331401;6162265;11787443;436758;0;6372
FR;2;2023-03-14;1;0;0;0;0;0;0;0;0;6127331;6816277;10674445;331401;6162265;11787443;436758;0;6372
FR;2;2023-03-15;0;2;0;3;2;0;3;0;0;6127331;6816279;10674445;331404;6162267;11787443;436761;0;6372
FR;2;2023-03-16;0;2;0;0;1;1;1;0;0;6127331;6816281;10674445;331404;6162268;11787444;436762;0;6372
FR;2;2023-03-17;0;0;1;1;0;1;0;0;0;6127331;6816281;10674446;331405;6162268;11787445;436762;0;6372
FR;2;2023-03-18;0;0;7;0;0;7;0;0;1;6127331;6816281;10674453;331405;6162268;11787452;436762;0;6373
FR;2;2023-03-19;0;0;0;0;0;0;0;0;0;6127331;6816281;10674453;331405;6162268;11787452;436762;0;6373
FR;2;2023-03-20;0;0;1;0;0;1;0;0;0;6127331;6816281;10674454;331405;6162268;11787453;436762;0;6373
FR;2;2023-03-21;0;0;1;2;0;1;2;0;1;6127331;6816281;10674455;331407;6162268;11787454;436764;0;6374
FR;2;2023-03-22;0;0;0;0;0;0;0;0;1;6127331;6816281;10674455;331407;6162268;11787454;436764;0;6375
FR;2;2023-03-23;0;1;0;0;1;0;0;0;1;6127331;6816282;10674455;331407;6162269;11787454;436764;0;6376
FR;2;2023-03-24;0;1;0;2;1;0;2;0;2;6127331;6816283;10674455;331409;6162270;11787454;436766;0;6378
FR;2;2023-03-25;0;0;1;2;0;1;2;0;0;6127331;6816283;10674456;331411;6162270;11787455;436768;0;6378
FR;2;2023-03-26;0;2;1;0;2;1;0;0;0;6127331;6816285;10674457;331411;6162272;11787456;436768;0;6378
FR;2;2023-03-27;0;2;2;0;2;2;0;0;1;6127331;6816287;10674459;331411;6162274;11787458;436768;0;6379
FR;2;2023-03-28;0;0;0;0;0;0;0;0;1;6127331;6816287;10674459;331411;6162274;11787458;436768;0;6380
FR;2;2023-03-29;0;0;0;2;0;0;2;0;0;6127331;6816287;10674459;331413;6162274;11787458;436770;0;6380
FR;2;2023-03-30;0;0;0;0;0;0;0;0;0;6127331;6816287;10674459;331413;6162274;11787458;436770;0;6380
FR;2;2023-03-31;0;1;0;1;1;0;1;0;0;6127331;6816288;10674459;331414;6162275;11787458;436771;0;6380
FR;2;2023-04-01;0;0;1;0;0;0;1;0;0;6127331;6816288;10674460;331414;6162275;11787458;436772;0;6380
FR;2;2023-04-02;0;0;0;0;0;0;0;0;0;6127331;6816288;10674460;331414;6162275;11787458;436772;0;6380
FR;2;2023-04-03;0;1;2;2;1;2;2;0;1;6127331;6816289;10674462;331416;6162276;11787460;436774;0;6381
FR;2;2023-04-04;0;0;0;2;0;0;2;0;0;6127331;6816289;10674462;331418;6162276;11787460;436776;0;6381
FR;2;2023-04-05;0;0;1;0;0;1;0;0;0;6127331;6816289;10674463;331418;6162276;11787461;436776;0;6381
FR;2;2023-04-06;0;1;0;0;1;0;0;0;0;6127331;6816290;10674463;331418;6162277;11787461;436776;0;6381
FR;2;2023-04-07;0;0;0;1;0;0;1;0;0;6127331;6816290;10674463;331419;6162277;11787461;436777;0;6381
FR;2;2023-04-08;0;0;0;0;0;0;0;0;0;6127331;6816290;10674463;331419;6162277;11787461;436777;0;6381
FR;2;2023-04-09;0;0;1;0;0;1;0;0;0;6127331;6816290;10674464;331419;6162277;11787462;436777;0;6381
FR;2;2023-04-10;0;2;0;0;1;1;0;0;0;6127331;6816292;10674464;331419;6162278;11787463;436777;0;6381
FR;2;2023-04-11;0;0;0;0;0;0;0;0;1;6127331;6816292;10674464;331419;6162278;11787463;436777;0;6382
FR;2;2023-04-12;0;0;0;0;0;0;0;0;0;6127331;6816292;10674464;331419;6162278;11787463;436777;0;6382
FR;2;2023-04-13;0;0;2;1;0;2;0;0;0;6127331;6816292;10674466;331420;6162278;11787465;436777;0;6382
FR;2;2023-04-14;0;1;0;1;1;0;1;0;0;6127331;6816293;10674466;331421;6162279;11787465;436778;0;6382
FR;2;2023-04-15;0;0;0;0;0;0;0;0;0;6127331;6816293;10674466;331421;6162279;11787465;436778;0;6382
FR;2;2023-04-16;0;0;0;0;0;0;0;0;0;6127331;6816293;10674466;331421;6162279;11787465;436778;0;6382
FR;2;2023-04-17;1;1;0;0;2;0;0;0;0;6127332;6816294;10674466;331421;6162281;11787465;436778;0;6382
FR;2;2023-04-18;0;0;1;2;0;1;2;0;0;6127332;6816294;10674467;331423;6162281;11787466;436780;0;6382
FR;2;2023-04-19;0;0;0;0;0;0;2;0;0;6127332;6816294;10674467;331423;6162281;11787466;436782;0;6382
FR;2;2023-04-20;0;0;1;1;0;1;1;0;0;6127332;6816294;10674468;331424;6162281;11787467;436783;0;6382
FR;2;2023-04-21;0;0;1;0;0;1;0;0;0;6127332;6816294;10674469;331424;6162281;11787468;436783;0;6382
FR;2;2023-04-22;0;0;2;2;0;1;1;0;2;6127332;6816294;10674471;331426;6162281;11787469;436784;0;6384
FR;2;2023-04-23;0;0;0;0;0;0;0;0;0;6127332;6816294;10674471;331426;6162281;11787469;436784;0;6384
FR;2;2023-04-24;0;0;1;0;0;0;1;0;0;6127332;6816294;10674472;331426;6162281;11787469;436785;0;6384
FR;2;2023-04-25;0;0;0;0;0;0;0;0;0;6127332;6816294;10674472;331426;6162281;11787469;436785;0;6384
FR;2;2023-04-26;0;1;0;0;0;1;0;0;0;6127332;6816295;10674472;331426;6162281;11787470;436785;0;6384
FR;2;2023-04-27;0;0;0;0;0;0;0;0;1;6127332;6816295;10674472;331426;6162281;11787470;436785;0;6385
FR;2;2023-04-28;0;0;0;0;0;0;0;0;2;6127332;6816295;10674472;331426;6162281;11787470;436785;0;6387
FR;2;2023-04-29;0;0;0;1;0;0;1;0;0;6127332;6816295;10674472;331427;6162281;11787470;436786;0;6387
FR;2;2023-04-30;0;0;0;0;0;0;0;0;0;6127332;6816295;10674472;331427;6162281;11787470;436786;0;6387
FR;2;2023-05-01;0;1;0;0;1;0;0;0;0;6127332;6816296;10674472;331427;6162282;11787470;436786;0;6387
FR;2;2023-05-02;0;0;4;1;0;4;1;0;2;6127332;6816296;10674476;331428;6162282;11787474;436787;0;6389
FR;2;2023-05-03;0;1;0;0;0;1;0;0;0;6127332;6816297;10674476;331428;6162282;11787475;436787;0;6389
FR;2;2023-05-04;0;0;0;1;0;0;1;0;0;6127332;6816297;10674476;331429;6162282;11787475;436788;0;6389
FR;2;2023-05-05;0;1;1;1;1;1;1;0;0;6127332;6816298;10674477;331430;6162283;11787476;436789;0;6389
FR;2;2023-05-06;0;0;0;0;0;0;0;0;0;6127332;6816298;10674477;331430;6162283;11787476;436789;0;6389
FR;2;2023-05-07;0;0;0;0;0;0;0;0;0;6127332;6816298;10674477;331430;6162283;11787476;436789;0;6389
FR;2;2023-05-08;0;0;0;0;0;0;0;0;0;6127332;6816298;10674477;331430;6162283;11787476;436789;0;6389
FR;2;2023-05-09;0;1;0;0;0;1;0;0;0;6127332;6816299;10674477;331430;6162283;11787477;436789;0;6389
FR;2;2023-05-10;0;0;0;0;0;0;0;0;2;6127332;6816299;10674477;331430;6162283;11787477;436789;0;6391
FR;2;2023-05-11;0;0;0;0;0;0;0;0;1;6127332;6816299;10674477;331430;6162283;11787477;436789;0;6392
FR;2;2023-05-12;0;0;0;0;0;0;0;0;0;6127332;6816299;10674477;331430;6162283;11787477;436789;0;6392
FR;2;2023-05-13;0;1;0;0;0;1;0;0;0;6127332;6816300;10674477;331430;6162283;11787478;436789;0;6392
FR;2;2023-05-14;0;0;0;0;0;0;0;0;0;6127332;6816300;10674477;331430;6162283;11787478;436789;0;6392
FR;2;2023-05-15;0;0;1;0;0;1;0;0;0;6127332;6816300;10674478;331430;6162283;11787479;436789;0;6392
FR;2;2023-05-16;0;0;0;0;0;0;0;0;0;6127332;6816300;10674478;331430;6162283;11787479;436789;0;6392
FR;2;2023-05-17;0;0;0;0;0;0;0;0;0;6127332;6816300;10674478;331430;6162283;11787479;436789;0;6392
FR;2;2023-05-18;0;0;0;1;0;0;1;0;0;6127332;6816300;10674478;331431;6162283;11787479;436790;0;6392
FR;2;2023-05-19;0;0;0;0;0;0;0;0;0;6127332;6816300;10674478;331431;6162283;11787479;436790;0;6392
FR;2;2023-05-20;0;0;4;0;0;3;1;0;0;6127332;6816300;10674482;331431;6162283;11787482;436791;0;6392
FR;2;2023-05-21;0;0;0;0;0;0;0;0;0;6127332;6816300;10674482;331431;6162283;11787482;436791;0;6392
FR;2;2023-05-22;0;0;0;1;0;0;1;0;0;6127332;6816300;10674482;331432;6162283;11787482;436792;0;6392
FR;2;2023-05-23;0;0;0;0;0;0;0;0;1;6127332;6816300;10674482;331432;6162283;11787482;436792;0;6393
FR;2;2023-05-24;0;0;0;0;0;0;0;0;0;6127332;6816300;10674482;331432;6162283;11787482;436792;0;6393
FR;2;2023-05-25;0;0;0;0;0;0;1;0;0;6127332;6816300;10674482;331432;6162283;11787482;436793;0;6393
FR;2;2023-05-26;0;1;0;1;1;0;1;0;1;6127332;6816301;10674482;331433;6162284;11787482;436794;0;6394
FR;2;2023-05-27;0;0;2;0;0;2;0;0;0;6127332;6816301;10674484;331433;6162284;11787484;436794;0;6394
FR;2;2023-05-28;0;0;0;0;0;0;0;0;0;6127332;6816301;10674484;331433;6162284;11787484;436794;0;6394
FR;2;2023-05-29;0;0;0;0;0;0;0;0;0;6127332;6816301;10674484;331433;6162284;11787484;436794;0;6394
FR;2;2023-05-30;0;0;0;0;0;0;0;0;0;6127332;6816301;10674484;331433;6162284;11787484;436794;0;6394
FR;2;2023-05-31;0;0;0;0;0;0;0;0;0;6127332;6816301;10674484;331433;6162284;11787484;436794;0;6394
FR;2;2023-06-01;0;0;1;0;0;0;1;0;0;6127332;6816301;10674485;331433;6162284;11787484;436795;0;6394
FR;2;2023-06-02;0;0;0;0;0;0;2;0;0;6127332;6816301;10674485;331433;6162284;11787484;436797;0;6394
FR;2;2023-06-03;0;0;1;0;0;0;1;0;0;6127332;6816301;10674486;331433;6162284;11787484;436798;0;6394
FR;2;2023-06-04;0;0;0;0;0;0;0;0;0;6127332;6816301;10674486;331433;6162284;11787484;436798;0;6394
FR;2;2023-06-05;0;0;0;0;0;0;0;0;0;6127332;6816301;10674486;331433;6162284;11787484;436798;0;6394
FR;2;2023-06-06;0;0;1;0;0;0;0;0;0;6127332;6816301;10674487;331433;6162284;11787484;436798;0;6394
FR;2;2023-06-07;0;0;0;0;0;0;0;0;0;6127332;6816301;10674487;331433;6162284;11787484;436798;0;6394
FR;2;2023-06-08;0;0;0;0;0;0;0;0;0;6127332;6816301;10674487;331433;6162284;11787484;436798;0;6394
FR;2;2023-06-09;0;0;0;0;0;0;0;0;0;6127332;6816301;10674487;331433;6162284;11787484;436798;0;6394
FR;2;2023-06-10;0;0;0;0;0;0;0;0;0;6127332;6816301;10674487;331433;6162284;11787484;436798;0;6394
FR;2;2023-06-11;0;0;0;0;0;0;0;0;0;6127332;6816301;10674487;331433;6162284;11787484;436798;0;6394
FR;2;2023-06-12;0;0;1;0;0;1;0;0;0;6127332;6816301;10674488;331433;6162284;11787485;436798;0;6394
FR;2;2023-06-13;0;0;0;0;0;0;0;0;0;6127332;6816301;10674488;331433;6162284;11787485;436798;0;6394
FR;2;2023-06-14;0;0;0;0;0;0;0;0;0;6127332;6816301;10674488;331433;6162284;11787485;436798;0;6394
FR;2;2023-06-15;0;0;0;0;0;1;0;0;1;6127332;6816301;10674488;331433;6162284;11787486;436798;0;6395
FR;2;2023-06-16;0;0;0;0;0;0;0;0;0;6127332;6816301;10674488;331433;6162284;11787486;436798;0;6395
FR;2;2023-06-17;0;0;0;0;0;0;0;0;0;6127332;6816301;10674488;331433;6162284;11787486;436798;0;6395
FR;2;2023-06-18;0;0;0;0;0;0;0;0;0;6127332;6816301;10674488;331433;6162284;11787486;436798;0;6395
FR;2;2023-06-19;0;0;0;0;0;0;0;0;0;6127332;6816301;10674488;331433;6162284;11787486;436798;0;6395
FR;2;2023-06-20;0;0;0;0;0;0;0;0;0;6127332;6816301;10674488;331433;6162284;11787486;436798;0;6395
FR;2;2023-06-21;0;0;0;0;0;0;0;0;0;6127332;6816301;10674488;331433;6162284;11787486;436798;0;6395
FR;2;2023-06-22;0;0;0;0;0;0;1;0;1;6127332;6816301;10674488;331433;6162284;11787486;436799;0;6396
FR;2;2023-06-23;0;0;0;0;0;0;0;0;2;6127332;6816301;10674488;331433;6162284;11787486;436799;0;6398
FR;2;2023-06-24;0;0;0;1;0;0;1;0;1;6127332;6816301;10674488;331434;6162284;11787486;436800;0;6399
FR;2;2023-06-25;0;0;0;0;0;0;0;0;0;6127332;6816301;10674488;331434;6162284;11787486;436800;0;6399
FR;2;2023-06-26;0;0;0;0;0;0;0;0;0;6127332;6816301;10674488;331434;6162284;11787486;436800;0;6399
FR;2;2023-06-27;0;0;0;0;0;0;0;0;0;6127332;6816301;10674488;331434;6162284;11787486;436800;0;6399
FR;2;2023-06-28;0;0;0;0;0;0;0;0;0;6127332;6816301;10674488;331434;6162284;11787486;436800;0;6399
FR;2;2023-06-29;0;0;0;0;0;0;0;0;0;6127332;6816301;10674488;331434;6162284;11787486;436800;0;6399
FR;2;2023-06-30;0;0;0;0;0;0;0;0;0;6127332;6816301;10674488;331434;6162284;11787486;436800;0;6399
FR;2;2023-07-01;0;0;0;0;0;0;0;0;0;6127332;6816301;10674488;331434;6162284;11787486;436800;0;6399
FR;2;2023-07-02;0;0;0;0;0;0;0;0;0;6127332;6816301;10674488;331434;6162284;11787486;436800;0;6399
FR;2;2023-07-03;0;0;0;0;0;0;0;0;0;6127332;6816301;10674488;331434;6162284;11787486;436800;0;6399
FR;2;2023-07-04;0;0;0;0;0;0;0;0;0;6127332;6816301;10674488;331434;6162284;11787486;436800;0;6399
FR;2;2023-07-05;0;0;0;0;0;0;0;0;0;6127332;6816301;10674488;331434;6162284;11787486;436800;0;6399
FR;2;2023-07-06;0;0;0;0;0;0;0;0;0;6127332;6816301;10674488;331434;6162284;11787486;436800;0;6399
FR;2;2023-07-07;0;1;0;0;1;0;0;0;0;6127332;6816302;10674488;331434;6162285;11787486;436800;0;6399
FR;2;2023-07-08;0;0;0;0;0;0;0;0;0;6127332;6816302;10674488;331434;6162285;11787486;436800;0;6399
FR;2;2023-07-09;0;0;0;0;0;0;0;0;0;6127332;6816302;10674488;331434;6162285;11787486;436800;0;6399
FR;2;2023-07-10;0;0;0;0;0;0;0;0;0;6127332;6816302;10674488;331434;6162285;11787486;436800;0;6399
FR;3;2020-12-27;0;0;0;0;0;0;0;0;0;0;0;0;0;0;0;0;0;0
FR;3;2020-12-28;0;0;0;0;0;0;0;0;0;0;0;0;0;0;0;0;0;0
FR;3;2020-12-29;0;0;0;0;0;0;0;0;0;0;0;0;0;0;0;0;0;0
FR;3;2020-12-30;0;0;0;0;0;0;0;0;0;0;0;0;0;0;0;0;0;0
FR;3;2020-12-31;0;0;0;0;0;0;0;0;0;0;0;0;0;0;0;0;0;0
FR;3;2021-01-01;0;0;0;0;0;0;0;0;0;0;0;0;0;0;0;0;0;0
FR;3;2021-01-02;0;0;0;0;0;0;0;0;0;0;0;0;0;0;0;0;0;0
FR;3;2021-01-03;0;0;0;0;0;0;0;0;0;0;0;0;0;0;0;0;0;0
FR;3;2021-01-04;0;0;0;0;0;0;0;0;0;0;0;0;0;0;0;0;0;0
FR;3;2021-01-05;0;0;0;0;0;0;0;0;0;0;0;0;0;0;0;0;0;0
FR;3;2021-01-06;0;0;0;0;0;0;0;0;0;0;0;0;0;0;0;0;0;0
FR;3;2021-01-07;0;0;0;0;0;0;0;0;0;0;0;0;0;0;0;0;0;0
FR;3;2021-01-08;0;0;0;0;0;0;0;0;0;0;0;0;0;0;0;0;0;0
FR;3;2021-01-09;0;0;0;0;0;0;0;0;0;0;0;0;0;0;0;0;0;0
FR;3;2021-01-10;0;0;0;0;0;0;0;0;0;0;0;0;0;0;0;0;0;0
FR;3;2021-01-11;0;0;0;0;0;0;0;0;0;0;0;0;0;0;0;0;0;0
FR;3;2021-01-12;0;0;0;0;0;0;0;0;0;0;0;0;0;0;0;0;0;0
FR;3;2021-01-13;0;0;0;0;0;0;0;0;0;0;0;0;0;0;0;0;0;0
FR;3;2021-01-14;0;0;0;0;0;0;0;0;0;0;0;0;0;0;0;0;0;0
FR;3;2021-01-15;0;0;0;0;0;0;0;0;0;0;0;0;0;0;0;0;0;0
FR;3;2021-01-16;0;0;0;0;0;0;0;0;0;0;0;0;0;0;0;0;0;0
FR;3;2021-01-17;0;0;0;0;0;0;0;0;0;0;0;0;0;0;0;0;0;0
FR;3;2021-01-18;0;0;0;0;0;0;0;0;0;0;0;0;0;0;0;0;0;0
FR;3;2021-01-19;0;0;0;0;0;0;0;0;0;0;0;0;0;0;0;0;0;0
FR;3;2021-01-20;0;0;0;0;0;0;0;0;0;0;0;0;0;0;0;0;0;0
FR;3;2021-01-21;0;0;0;0;0;0;0;0;0;0;0;0;0;0;0;0;0;0
FR;3;2021-01-22;0;0;0;0;0;0;0;0;0;0;0;0;0;0;0;0;0;0
FR;3;2021-01-23;0;0;0;0;0;0;0;0;0;0;0;0;0;0;0;0;0;0
FR;3;2021-01-24;0;0;0;0;0;0;0;0;0;0;0;0;0;0;0;0;0;0
FR;3;2021-01-25;0;0;0;0;0;0;0;0;0;0;0;0;0;0;0;0;0;0
FR;3;2021-01-26;0;0;0;0;0;0;0;0;0;0;0;0;0;0;0;0;0;0
FR;3;2021-01-27;0;0;0;0;0;0;0;0;0;0;0;0;0;0;0;0;0;0
FR;3;2021-01-28;0;0;0;0;0;0;0;0;0;0;0;0;0;0;0;0;0;0
FR;3;2021-01-29;0;0;0;0;0;0;0;0;0;0;0;0;0;0;0;0;0;0
FR;3;2021-01-30;0;0;0;0;0;0;0;0;0;0;0;0;0;0;0;0;0;0
FR;3;2021-01-31;0;0;0;0;0;0;0;0;0;0;0;0;0;0;0;0;0;0
FR;3;2021-02-01;0;0;0;0;0;0;0;0;0;0;0;0;0;0;0;0;0;0
FR;3;2021-02-02;0;0;0;0;0;0;0;0;0;0;0;0;0;0;0;0;0;0
FR;3;2021-02-03;0;0;0;0;0;0;0;0;0;0;0;0;0;0;0;0;0;0
FR;3;2021-02-04;0;0;0;0;0;0;0;0;0;0;0;0;0;0;0;0;0;0
FR;3;2021-02-05;0;0;0;0;0;0;0;0;0;0;0;0;0;0;0;0;0;0
FR;3;2021-02-06;1473;0;0;0;105;0;0;0;0;1473;0;0;0;105;0;0;0;0
FR;3;2021-02-07;1423;2;0;0;87;0;0;0;0;2896;2;0;0;192;0;0;0;0
FR;3;2021-02-08;2790;1;0;0;177;0;0;0;0;5686;3;0;0;369;0;0;0;0
FR;3;2021-02-09;6786;0;0;0;502;0;0;0;0;12472;3;0;0;871;0;0;0;0
FR;3;2021-02-10;9612;0;0;0;695;0;0;0;0;22084;3;0;0;1566;0;0;0;0
FR;3;2021-02-11;13620;4;0;0;919;0;0;0;0;35704;7;0;0;2485;0;0;0;0
FR;3;2021-02-12;13410;0;0;0;907;0;0;0;0;49114;7;0;0;3392;0;0;0;0
FR;3;2021-02-13;3800;1;0;0;218;0;0;0;0;52914;8;0;0;3610;0;0;0;0
FR;3;2021-02-14;975;1;0;0;53;0;0;0;0;53889;9;0;0;3663;0;0;0;0
FR;3;2021-02-15;10497;2;0;0;719;0;0;0;0;64386;11;0;0;4382;0;0;0;0
FR;3;2021-02-16;12556;5;0;0;871;0;0;0;0;76942;16;0;0;5253;0;0;0;0
FR;3;2021-02-17;11159;1;0;0;717;0;0;0;0;88101;17;0;0;5970;0;0;0;0
FR;3;2021-02-18;14943;2;0;0;985;0;0;0;0;103044;19;0;0;6955;0;0;0;0
FR;3;2021-02-19;14364;1;0;0;846;0;0;0;0;117408;20;0;0;7801;0;0;0;0
FR;3;2021-02-20;3332;0;0;0;178;0;0;0;0;120740;20;0;0;7979;0;0;0;0
FR;3;2021-02-21;620;0;0;0;35;0;0;0;0;121360;20;0;0;8014;0;0;0;0
FR;3;2021-02-22;9171;1;0;0;654;0;0;0;0;130531;21;0;0;8668;0;0;0;0
FR;3;2021-02-23;11406;6;0;0;761;0;0;0;0;141937;27;0;0;9429;0;0;0;0
FR;3;2021-02-24;14305;1;0;0;829;0;0;0;0;156242;28;0;0;10258;0;0;0;0
FR;3;2021-02-25;44935;3;0;0;1814;0;0;0;0;201177;31;0;0;12072;0;0;0;0
FR;3;2021-02-26;61889;13;0;0;2201;0;0;0;0;263066;44;0;0;14273;0;0;0;0
FR;3;2021-02-27;34811;14;0;0;1028;0;0;0;0;297877;58;0;0;15301;0;0;0;0
FR;3;2021-02-28;2464;0;0;0;114;0;0;0;0;300341;58;0;0;15415;0;0;0;0
FR;3;2021-03-01;20521;21;0;0;1067;0;0;0;0;320862;79;0;0;16482;0;0;0;0
FR;3;2021-03-02;38878;25;0;0;1790;0;0;0;0;359740;104;0;0;18272;0;0;0;0
FR;3;2021-03-03;48750;18;0;0;2130;0;0;0;0;408490;122;0;0;20402;0;0;0;0
FR;3;2021-03-04;82229;25;0;0;3194;0;0;0;0;490719;147;0;0;23596;0;0;0;0
FR;3;2021-03-05;118138;43;0;0;4693;0;0;0;0;608857;190;0;0;28289;0;0;0;0
FR;3;2021-03-06;120727;65;1;0;3559;0;0;0;0;729584;255;1;0;31848;0;0;0;0
FR;3;2021-03-07;55186;23;0;0;1729;0;0;0;0;784770;278;1;0;33577;0;0;0;0
FR;3;2021-03-08;42814;29;0;0;2074;0;0;0;0;827584;307;1;0;35651;0;0;0;0
FR;3;2021-03-09;78979;51;0;0;3288;0;0;0;0;906563;358;1;0;38939;0;0;0;0
FR;3;2021-03-10;80985;67;0;0;3243;0;0;0;0;987548;425;1;0;42182;0;0;0;0
FR;3;2021-03-11;128447;66;0;0;4766;0;0;0;0;1115995;491;1;0;46948;0;0;0;0
FR;3;2021-03-12;182718;122;0;0;6279;0;0;0;0;1298713;613;1;0;53227;0;0;0;0
FR;3;2021-03-13;132160;91;0;0;3530;0;0;0;0;1430873;704;1;0;56757;0;0;0;0
FR;3;2021-03-14;14061;6;0;0;550;0;0;0;0;1444934;710;1;0;57307;0;0;0;0
FR;3;2021-03-15;52243;82;0;0;2097;0;0;0;0;1497177;792;1;0;59404;0;0;0;0
FR;3;2021-03-16;1221;51;0;0;105;0;0;0;0;1498398;843;1;0;59509;0;0;0;0
FR;3;2021-03-17;950;56;0;0;95;0;0;0;0;1499348;899;1;0;59604;0;0;0;0
FR;3;2021-03-18;1577;42;0;0;102;0;0;0;0;1500925;941;1;0;59706;0;0;0;0
FR;3;2021-03-19;70459;56;0;0;2060;0;0;0;0;1571384;997;1;0;61766;0;0;0;0
FR;3;2021-03-20;65242;51;0;0;1702;0;0;0;0;1636626;1048;1;0;63468;0;0;0;0
FR;3;2021-03-21;5762;8;0;0;199;0;0;0;0;1642388;1056;1;0;63667;0;0;0;0
FR;3;2021-03-22;37511;50;0;0;1053;0;0;0;0;1679899;1106;1;0;64720;0;0;0;0
FR;3;2021-03-23;84670;87;0;0;2288;0;0;0;0;1764569;1193;1;0;67008;0;0;0;0
FR;3;2021-03-24;90956;99;0;0;2491;0;0;0;0;1855525;1292;1;0;69499;0;0;0;0
FR;3;2021-03-25;150068;149;0;0;3792;0;0;0;0;2005593;1441;1;0;73291;0;0;0;0
FR;3;2021-03-26;165432;157;0;0;4148;0;0;0;0;2171025;1598;1;0;77439;0;0;0;0
FR;3;2021-03-27;68465;101;0;0;2004;0;0;0;0;2239490;1699;1;0;79443;0;0;0;0
FR;3;2021-03-28;6481;20;0;0;238;0;0;0;0;2245971;1719;1;0;79681;0;0;0;0
FR;3;2021-03-29;54171;83;0;0;1480;0;0;0;0;2300142;1802;1;0;81161;0;0;0;0
FR;3;2021-03-30;93185;103;0;0;2564;0;0;0;0;2393327;1905;1;0;83725;0;0;0;0
FR;3;2021-03-31;63547;110;0;0;1964;0;0;0;0;2456874;2015;1;0;85689;0;0;0;0
FR;3;2021-04-01;86136;116;0;0;2496;0;0;0;0;2543010;2131;1;0;88185;0;0;0;0
FR;3;2021-04-02;86916;186;0;0;2766;0;0;0;0;2629926;2317;1;0;90951;0;0;0;0
FR;3;2021-04-03;35876;133;0;0;1164;0;0;0;0;2665802;2450;1;0;92115;0;0;0;0
FR;3;2021-04-04;3577;19;0;0;164;0;0;0;0;2669379;2469;1;0;92279;0;0;0;0
FR;3;2021-04-05;4492;40;0;0;236;0;0;0;0;2673871;2509;1;0;92515;0;0;0;0
FR;3;2021-04-06;29763;105;0;0;1091;0;0;0;0;2703634;2614;1;0;93606;0;0;0;0
FR;3;2021-04-07;32350;113;0;0;1052;0;0;0;0;2735984;2727;1;0;94658;0;0;0;0
FR;3;2021-04-08;78825;274;0;0;2619;0;0;0;0;2814809;3001;1;0;97277;0;0;0;0
FR;3;2021-04-09;161764;454;0;0;5179;0;0;0;0;2976573;3455;1;0;102456;0;0;0;0
FR;3;2021-04-10;75765;365;0;0;2697;0;0;0;0;3052338;3820;1;0;105153;0;0;0;0
FR;3;2021-04-11;7316;47;0;0;306;0;0;0;0;3059654;3867;1;0;105459;0;0;0;0
FR;3;2021-04-12;51484;219;0;0;1738;0;0;0;0;3111138;4086;1;0;107197;0;0;0;0
FR;3;2021-04-13;86236;364;0;0;2911;0;0;0;0;3197374;4450;1;0;110108;0;0;0;0
FR;3;2021-04-14;67847;377;0;0;2429;0;0;0;0;3265221;4827;1;0;112537;0;0;0;0
FR;3;2021-04-15;93246;404;0;0;3442;0;0;0;0;3358467;5231;1;0;115979;0;0;0;0
FR;3;2021-04-16;112531;628;0;0;4343;0;0;0;0;3470998;5859;1;0;120322;0;0;0;0
FR;3;2021-04-17;53319;371;1;0;2277;0;0;0;0;3524317;6230;2;0;122599;0;0;0;0
FR;3;2021-04-18;9752;49;0;0;423;0;0;0;0;3534069;6279;2;0;123022;0;0;0;0
FR;3;2021-04-19;25117;287;0;0;1093;0;0;0;0;3559186;6566;2;0;124115;0;0;0;0
FR;3;2021-04-20;45676;438;0;0;1908;0;0;0;0;3604862;7004;2;0;126023;0;0;0;0
FR;3;2021-04-21;38988;553;0;0;1897;0;0;0;0;3643850;7557;2;0;127920;0;0;0;0
FR;3;2021-04-22;54723;875;0;0;2827;0;0;0;0;3698573;8432;2;0;130747;0;0;0;0
FR;3;2021-04-23;70493;1095;0;0;3697;0;0;0;0;3769066;9527;2;0;134444;0;0;0;0
FR;3;2021-04-24;37253;1101;0;0;2490;0;0;0;0;3806319;10628;2;0;136934;0;0;0;0
FR;3;2021-04-25;6213;158;0;0;446;0;0;0;0;3812532;10786;2;0;137380;0;0;0;0
FR;3;2021-04-26;19792;701;0;0;1436;0;0;0;0;3832324;11487;2;0;138816;0;0;0;0
FR;3;2021-04-27;34486;1336;0;0;2594;0;0;0;0;3866810;12823;2;0;141410;0;0;0;0
FR;3;2021-04-28;28971;2047;0;0;3164;0;0;0;0;3895781;14870;2;0;144574;0;0;0;0
FR;3;2021-04-29;45394;6127;0;0;7946;0;0;0;0;3941175;20997;2;0;152520;0;0;0;0
FR;3;2021-04-30;55465;9118;1;0;11513;0;0;0;0;3996640;30115;3;0;164033;0;0;0;0
FR;3;2021-05-01;9518;2064;0;0;2495;0;0;0;0;4006158;32179;3;0;166528;0;0;0;0
FR;3;2021-05-02;3081;466;0;0;611;0;0;0;0;4009239;32645;3;0;167139;0;0;0;0
FR;3;2021-05-03;13067;3940;0;0;4507;0;0;0;0;4022306;36585;3;0;171646;0;0;0;0
FR;3;2021-05-04;23123;8375;0;0;9442;0;0;0;0;4045429;44960;3;0;181088;0;0;0;0
FR;3;2021-05-05;18768;10833;0;0;11771;0;0;0;0;4064197;55793;3;0;192859;0;0;0;0
FR;3;2021-05-06;34632;21265;0;0;22815;0;0;0;0;4098829;77058;3;0;215674;0;0;0;0
FR;3;2021-05-07;44211;28904;0;0;31207;0;0;0;0;4143040;105962;3;0;246881;0;0;0;0
FR;3;2021-05-08;6786;9190;0;0;9556;0;0;0;0;4149826;115152;3;0;256437;0;0;0;0
FR;3;2021-05-09;1797;2667;0;0;2768;0;0;0;0;4151623;117819;3;0;259205;0;0;0;0
FR;3;2021-05-10;15001;12918;0;0;13611;0;0;0;0;4166624;130737;3;0;272816;0;0;0;0
FR;3;2021-05-11;27100;26272;0;0;27545;0;0;0;0;4193724;157009;3;0;300361;0;0;0;0
FR;3;2021-05-12;17273;28149;0;0;29087;0;0;0;0;4210997;185158;3;0;329448;0;0;0;0
FR;3;2021-05-13;2285;3510;0;0;3631;0;0;0;0;4213282;188668;3;0;333079;0;0;0;0
FR;3;2021-05-14;14521;26083;0;0;26864;0;0;0;0;4227803;214751;3;0;359943;0;0;0;0
FR;3;2021-05-15;7233;21086;0;0;21516;0;0;0;0;4235036;235837;3;0;381459;0;0;0;0
FR;3;2021-05-16;977;2649;0;0;2695;0;0;0;0;4236013;238486;3;0;384154;0;0;0;0
FR;3;2021-05-17;7967;20224;0;0;20668;0;0;0;0;4243980;258710;3;0;404822;0;0;0;0
FR;3;2021-05-18;13418;30158;0;0;30921;0;0;0;0;4257398;288868;3;0;435743;0;0;0;0
FR;3;2021-05-19;9277;30525;0;0;31119;0;0;0;0;4266675;319393;3;0;466862;0;0;0;0
FR;3;2021-05-20;12809;53834;3;0;54760;0;0;0;0;4279484;373227;6;0;521622;0;0;0;0
FR;3;2021-05-21;12771;66185;2;0;67116;0;0;0;0;4292255;439412;8;0;588738;0;0;0;0
FR;3;2021-05-22;4967;33781;1;0;34164;0;0;0;0;4297222;473193;9;0;622902;0;0;0;0
FR;3;2021-05-23;651;2663;0;0;2695;0;0;0;0;4297873;475856;9;0;625597;0;0;0;0
FR;3;2021-05-24;885;4784;0;0;4828;0;0;0;0;4298758;480640;9;0;630425;0;0;0;0
FR;3;2021-05-25;5316;46737;1;0;47145;0;0;0;0;4304074;527377;10;0;677570;0;0;0;0
FR;3;2021-05-26;4982;52193;1;0;52667;0;0;0;0;4309056;579570;11;0;730237;0;0;0;0
FR;3;2021-05-27;6338;79067;3;0;79679;0;0;0;0;4315394;658637;14;0;809916;0;0;0;0
FR;3;2021-05-28;7546;100338;2;0;101145;0;0;0;0;4322940;758975;16;0;911061;0;0;0;0
FR;3;2021-05-29;3350;61184;1;0;61567;0;0;0;0;4326290;820159;17;0;972628;0;0;0;0
FR;3;2021-05-30;551;8078;0;0;8127;0;0;0;0;4326841;828237;17;0;980755;0;0;0;0
FR;3;2021-05-31;2442;35484;3;0;35750;0;0;0;0;4329283;863721;20;0;1016505;0;0;0;0
FR;3;2021-06-01;3418;64904;10;0;65356;0;0;0;0;4332701;928625;30;0;1081861;0;0;0;0
FR;3;2021-06-02;2735;58933;6;0;59268;0;0;0;0;4335436;987558;36;0;1141129;0;0;0;0
FR;3;2021-06-03;3496;87204;10;0;87743;0;0;0;0;4338932;1074762;46;0;1228872;0;0;0;0
FR;3;2021-06-04;4125;105866;22;0;106532;0;0;0;0;4343057;1180628;68;0;1335404;0;0;0;0
FR;3;2021-06-05;1983;52608;4;0;52926;0;0;0;0;4345040;1233236;72;0;1388330;0;0;0;0
FR;3;2021-06-06;511;5269;1;0;5317;0;0;0;0;4345551;1238505;73;0;1393647;0;0;0;0
FR;3;2021-06-07;1488;30715;11;0;30896;0;0;0;0;4347039;1269220;84;0;1424543;0;0;0;0
FR;3;2021-06-08;2066;47427;18;0;47774;0;0;0;0;4349105;1316647;102;0;1472317;0;0;0;0
FR;3;2021-06-09;1796;41806;13;0;42111;0;0;0;0;4350901;1358453;115;0;1514428;0;0;0;0
FR;3;2021-06-10;2261;67665;17;0;68063;0;0;0;0;4353162;1426118;132;0;1582491;0;0;0;0
FR;3;2021-06-11;2494;96640;34;0;97116;0;0;0;0;4355656;1522758;166;0;1679607;0;0;0;0
FR;3;2021-06-12;1179;40557;6;0;40789;0;0;0;0;4356835;1563315;172;0;1720396;0;0;0;0
FR;3;2021-06-13;283;3606;3;0;3641;0;0;0;0;4357118;1566921;175;0;1724037;0;0;0;0
FR;3;2021-06-14;1051;42316;17;0;42486;0;0;0;0;4358169;1609237;192;0;1766523;0;0;0;0
FR;3;2021-06-15;1379;80353;20;0;80658;0;0;0;0;4359548;1689590;212;0;1847181;0;0;0;0
FR;3;2021-06-16;1263;65506;20;0;65779;0;0;0;0;4360811;1755096;232;0;1912960;0;0;0;0
FR;3;2021-06-17;1667;102294;41;0;102680;0;0;0;0;4362478;1857390;273;0;2015640;0;0;0;0
FR;3;2021-06-18;1873;118471;63;0;118941;0;0;0;0;4364351;1975861;336;0;2134581;0;0;0;0
FR;3;2021-06-19;804;39456;22;0;39651;0;0;0;0;4365155;2015317;358;0;2174232;0;0;0;0
FR;3;2021-06-20;162;3193;0;0;3222;0;0;0;0;4365317;2018510;358;0;2177454;0;0;0;0
FR;3;2021-06-21;775;39093;16;0;39251;0;0;0;0;4366092;2057603;374;0;2216705;0;0;0;0
FR;3;2021-06-22;1065;70092;52;0;70363;0;0;0;0;4367157;2127695;426;0;2287068;0;0;0;0
FR;3;2021-06-23;946;50834;39;0;51106;0;0;0;0;4368103;2178529;465;0;2338174;0;0;0;0
FR;3;2021-06-24;1314;77304;48;0;77677;0;0;0;0;4369417;2255833;513;0;2415851;0;0;0;0
FR;3;2021-06-25;1410;90856;73;0;91290;0;0;0;0;4370827;2346689;586;0;2507141;0;0;0;0
FR;3;2021-06-26;631;33107;29;0;33299;0;0;0;0;4371458;2379796;615;0;2540440;0;0;0;0
FR;3;2021-06-27;168;3776;1;0;3800;0;0;0;0;4371626;2383572;616;0;2544240;0;0;0;0
FR;3;2021-06-28;655;29927;27;0;30121;0;0;0;0;4372281;2413499;643;0;2574361;0;0;0;0
FR;3;2021-06-29;856;56649;95;0;56893;0;0;0;0;4373137;2470148;738;0;2631254;0;0;0;0
FR;3;2021-06-30;905;45217;93;0;45485;0;0;0;0;4374042;2515365;831;0;2676739;0;0;0;0
FR;3;2021-07-01;1164;66133;108;0;66482;0;0;0;0;4375206;2581498;939;0;2743221;0;0;0;0
FR;3;2021-07-02;1305;90524;170;0;91007;0;0;0;0;4376511;2672022;1109;0;2834228;0;0;0;0
FR;3;2021-07-03;602;31185;51;0;31386;0;0;0;0;4377113;2703207;1160;0;2865614;0;0;0;0
FR;3;2021-07-04;144;3968;3;0;3998;0;0;0;0;4377257;2707175;1163;0;2869612;0;0;0;0
FR;3;2021-07-05;613;33604;60;0;33805;0;0;0;0;4377870;2740779;1223;0;2903417;0;0;0;0
FR;3;2021-07-06;965;55938;88;0;56249;0;0;0;0;4378835;2796717;1311;0;2959666;0;0;0;0
FR;3;2021-07-07;874;42968;80;0;43266;0;0;0;0;4379709;2839685;1391;0;3002932;0;0;0;0
FR;3;2021-07-08;1127;60809;99;0;61219;0;0;0;0;4380836;2900494;1490;0;3064151;0;0;0;0
FR;3;2021-07-09;1261;68942;128;0;69407;0;0;0;0;4382097;2969436;1618;0;3133558;0;0;0;0
FR;3;2021-07-10;644;25018;59;0;25216;0;0;0;0;4382741;2994454;1677;0;3158774;0;0;0;0
FR;3;2021-07-11;132;3173;4;0;3198;0;0;0;0;4382873;2997627;1681;0;3161972;0;0;0;0
FR;3;2021-07-12;662;23600;59;0;23813;0;0;0;0;4383535;3021227;1740;0;3185785;0;0;0;0
FR;3;2021-07-13;1648;34429;90;0;34919;0;0;0;0;4385183;3055656;1830;0;3220704;0;0;0;0
FR;3;2021-07-14;272;2475;2;0;2532;0;0;0;0;4385455;3058131;1832;0;3223236;0;0;0;0
FR;3;2021-07-15;1941;30415;85;0;30990;0;0;0;0;4387396;3088546;1917;0;3254226;0;0;0;0
FR;3;2021-07-16;2520;38620;122;0;39354;0;0;0;0;4389916;3127166;2039;0;3293580;0;0;0;0
FR;3;2021-07-17;1051;13725;26;0;14033;0;0;0;0;4390967;3140891;2065;0;3307613;0;0;0;0
FR;3;2021-07-18;266;2547;3;0;2595;0;0;0;0;4391233;3143438;2068;0;3310208;0;0;0;0
FR;3;2021-07-19;1280;16883;38;0;17251;0;0;0;0;4392513;3160321;2106;0;3327459;0;0;0;0
FR;3;2021-07-20;1823;26931;98;0;27472;0;0;0;0;4394336;3187252;2204;0;3354931;0;0;0;0
FR;3;2021-07-21;1652;19471;44;0;19976;0;0;0;0;4395988;3206723;2248;0;3374907;0;0;0;0
FR;3;2021-07-22;1856;27647;83;0;28212;0;0;0;0;4397844;3234370;2331;0;3403119;0;0;0;0
FR;3;2021-07-23;2216;30212;117;0;30948;0;0;0;0;4400060;3264582;2448;0;3434067;0;0;0;0
FR;3;2021-07-24;828;6927;25;0;7150;0;0;0;0;4400888;3271509;2473;0;3441217;0;0;0;0
FR;3;2021-07-25;210;1287;1;0;1342;0;0;0;0;4401098;3272796;2474;0;3442559;0;0;0;0
FR;3;2021-07-26;933;10508;28;0;10816;0;0;0;0;4402031;3283304;2502;0;3453375;0;0;0;0
FR;3;2021-07-27;1171;16802;56;0;17165;0;0;0;0;4403202;3300106;2558;0;3470540;0;0;0;0
FR;3;2021-07-28;989;11999;40;0;12311;0;0;0;0;4404191;3312105;2598;0;3482851;0;0;0;0
FR;3;2021-07-29;1127;15676;63;0;16089;0;0;0;0;4405318;3327781;2661;0;3498940;0;0;0;0
FR;3;2021-07-30;1130;17992;79;0;18367;0;0;0;0;4406448;3345773;2740;0;3517307;0;0;0;0
FR;3;2021-07-31;407;3710;15;0;3836;0;0;0;0;4406855;3349483;2755;0;3521143;0;0;0;0
FR;3;2021-08-01;117;443;1;0;465;0;0;0;0;4406972;3349926;2756;0;3521608;0;0;0;0
FR;3;2021-08-02;424;5016;22;0;5136;0;0;0;0;4407396;3354942;2778;0;3526744;0;0;0;0
FR;3;2021-08-03;498;7466;27;0;7599;0;0;0;0;4407894;3362408;2805;0;3534343;0;0;0;0
FR;3;2021-08-04;441;4831;26;0;4977;0;0;0;0;4408335;3367239;2831;0;3539320;0;0;0;0
FR;3;2021-08-05;433;3655;13;0;3765;0;0;0;0;4408768;3370894;2844;0;3543085;0;0;0;0
FR;3;2021-08-06;456;4699;30;0;4800;0;0;0;0;4409224;3375593;2874;0;3547885;0;0;0;0
FR;3;2021-08-07;214;1900;11;0;1946;0;0;0;0;4409438;3377493;2885;0;3549831;0;0;0;0
FR;3;2021-08-08;251;423;2;0;456;0;0;0;0;4409689;3377916;2887;0;3550287;0;0;0;0
FR;3;2021-08-09;320;2374;11;0;2444;0;0;0;0;4410009;3380290;2898;0;3552731;0;0;0;0
FR;3;2021-08-10;369;3735;15;0;3823;0;0;0;0;4410378;3384025;2913;0;3556554;0;0;0;0
FR;3;2021-08-11;291;2639;15;0;2699;0;0;0;0;4410669;3386664;2928;0;3559253;0;0;0;0
FR;3;2021-08-12;279;2563;13;0;2651;0;0;0;0;4410948;3389227;2941;0;3561904;0;0;0;0
FR;3;2021-08-13;279;2255;16;0;2341;0;0;0;0;4411227;3391482;2957;0;3564245;0;0;0;0
FR;3;2021-08-14;172;873;1;0;904;0;0;0;0;4411399;3392355;2958;0;3565149;0;0;0;0
FR;3;2021-08-15;56;174;0;0;183;0;0;0;0;4411455;3392529;2958;0;3565332;0;0;0;0
FR;3;2021-08-16;126;1002;8;0;1041;0;0;0;0;4411581;3393531;2966;0;3566373;0;0;0;0
FR;3;2021-08-17;191;1430;8;0;1471;0;0;0;0;4411772;3394961;2974;0;3567844;0;0;0;0
FR;3;2021-08-18;205;1309;10;0;1351;0;0;0;0;4411977;3396270;2984;0;3569195;0;0;0;0
FR;3;2021-08-19;165;1373;10;0;1420;0;0;0;0;4412142;3397643;2994;0;3570615;0;0;0;0
FR;3;2021-08-20;167;1595;16;0;1657;0;0;0;0;4412309;3399238;3010;0;3572272;0;0;0;0
FR;3;2021-08-21;94;576;2;0;591;0;0;0;0;4412403;3399814;3012;0;3572863;0;0;0;0
FR;3;2021-08-22;42;194;1;0;197;0;0;0;0;4412445;3400008;3013;0;3573060;0;0;0;0
FR;3;2021-08-23;141;886;7;0;931;0;0;0;0;4412586;3400894;3020;0;3573991;0;0;0;0
FR;3;2021-08-24;125;920;10;0;952;0;0;0;0;4412711;3401814;3030;0;3574943;0;0;0;0
FR;3;2021-08-25;137;820;3;0;849;0;0;0;0;4412848;3402634;3033;0;3575792;0;0;0;0
FR;3;2021-08-26;172;823;9;0;871;0;0;0;0;4413020;3403457;3042;0;3576663;0;0;0;0
FR;3;2021-08-27;178;937;9;0;989;0;0;0;0;4413198;3404394;3051;0;3577652;0;0;0;0
FR;3;2021-08-28;101;373;4;0;390;0;0;0;0;4413299;3404767;3055;0;3578042;0;0;0;0
FR;3;2021-08-29;128;129;1;0;162;0;0;0;0;4413427;3404896;3056;0;3578204;0;0;0;0
FR;3;2021-08-30;100;560;0;0;469;108;0;0;0;4413527;3405456;3056;0;3578673;108;0;0;0
FR;3;2021-08-31;134;682;7;0;587;134;0;0;0;4413661;3406138;3063;0;3579260;242;0;0;0
FR;3;2021-09-01;122;460;5;0;383;105;0;0;0;4413783;3406598;3068;0;3579643;347;0;0;0
FR;3;2021-09-02;100;595;22;0;531;105;0;0;0;4413883;3407193;3090;0;3580174;452;0;0;0
FR;3;2021-09-03;116;552;17;0;477;116;0;0;0;4413999;3407745;3107;0;3580651;568;0;0;0
FR;3;2021-09-04;55;295;3;0;256;50;0;0;0;4414054;3408040;3110;0;3580907;618;0;0;0
FR;3;2021-09-05;52;65;5;0;55;25;0;0;0;4414106;3408105;3115;0;3580962;643;0;0;0
FR;3;2021-09-06;118;367;4;0;261;130;0;0;0;4414224;3408472;3119;0;3581223;773;0;0;0
FR;3;2021-09-07;125;431;14;0;347;116;0;0;0;4414349;3408903;3133;0;3581570;889;0;0;0
FR;3;2021-09-08;122;344;2;0;274;87;0;0;0;4414471;3409247;3135;0;3581844;976;0;0;0
FR;3;2021-09-09;94;379;8;0;299;103;0;0;0;4414565;3409626;3143;0;3582143;1079;0;0;0
FR;3;2021-09-10;101;402;3;0;332;93;0;0;0;4414666;3410028;3146;0;3582475;1172;0;0;0
FR;3;2021-09-11;79;233;4;0;178;65;0;0;0;4414745;3410261;3150;0;3582653;1237;0;0;0
FR;3;2021-09-12;37;49;1;0;38;16;0;0;0;4414782;3410310;3151;0;3582691;1253;0;0;0
FR;3;2021-09-13;78;298;7;0;215;102;1;0;0;4414860;3410608;3158;0;3582906;1355;1;0;0
FR;3;2021-09-14;75;271;6;0;191;94;0;0;0;4414935;3410879;3164;0;3583097;1449;1;0;0
FR;3;2021-09-15;64;252;3;0;257;6;0;0;0;4414999;3411131;3167;0;3583354;1455;1;0;0
FR;3;2021-09-16;65;320;6;0;331;6;0;0;0;4415064;3411451;3173;0;3583685;1461;1;0;0
FR;3;2021-09-17;52;327;3;0;339;6;0;0;0;4415116;3411778;3176;0;3584024;1467;1;0;0
FR;3;2021-09-18;37;172;1;0;176;1;0;0;0;4415153;3411950;3177;0;3584200;1468;1;0;0
FR;3;2021-09-19;29;31;2;0;34;1;0;0;0;4415182;3411981;3179;0;3584234;1469;1;0;0
FR;3;2021-09-20;82;188;0;0;196;1;0;0;0;4415264;3412169;3179;0;3584430;1470;1;0;0
FR;3;2021-09-21;60;273;7;0;277;8;0;0;0;4415324;3412442;3186;0;3584707;1478;1;0;0
FR;3;2021-09-22;67;229;6;0;242;7;0;0;0;4415391;3412671;3192;0;3584949;1485;1;0;0
FR;3;2021-09-23;37;256;11;0;260;7;0;0;0;4415428;3412927;3203;0;3585209;1492;1;0;0
FR;3;2021-09-24;29;315;12;0;313;18;0;0;0;4415457;3413242;3215;0;3585522;1510;1;0;0
FR;3;2021-09-25;31;144;3;0;150;3;0;0;0;4415488;3413386;3218;0;3585672;1513;1;0;0
FR;3;2021-09-26;16;57;1;0;59;1;0;0;0;4415504;3413443;3219;0;3585731;1514;1;0;0
FR;3;2021-09-27;49;282;3;0;285;5;0;0;0;4415553;3413725;3222;0;3586016;1519;1;0;0
FR;3;2021-09-28;49;245;6;0;253;8;0;0;0;4415602;3413970;3228;0;3586269;1527;1;0;0
FR;3;2021-09-29;40;218;10;0;222;15;0;0;0;4415642;3414188;3238;0;3586491;1542;1;0;0
FR;3;2021-09-30;40;200;8;0;204;11;0;0;0;4415682;3414388;3246;0;3586695;1553;1;0;0
FR;3;2021-10-01;23;159;6;0;161;8;0;0;0;4415705;3414547;3252;0;3586856;1561;1;0;0
FR;3;2021-10-02;17;88;0;0;89;0;0;0;0;4415722;3414635;3252;0;3586945;1561;1;0;0
FR;3;2021-10-03;19;19;1;0;19;2;0;0;0;4415741;3414654;3253;0;3586964;1563;1;0;0
FR;3;2021-10-04;33;157;4;0;162;4;0;0;0;4415774;3414811;3257;0;3587126;1567;1;0;0
FR;3;2021-10-05;17;148;10;0;153;12;0;0;0;4415791;3414959;3267;0;3587279;1579;1;0;0
FR;3;2021-10-06;34;145;9;0;153;10;0;0;0;4415825;3415104;3276;0;3587432;1589;1;0;0
FR;3;2021-10-07;20;132;6;0;130;6;0;0;0;4415845;3415236;3282;0;3587562;1595;1;0;0
FR;3;2021-10-08;25;136;10;0;141;9;0;0;0;4415870;3415372;3292;0;3587703;1604;1;0;0
FR;3;2021-10-09;17;72;1;0;73;1;0;0;0;4415887;3415444;3293;0;3587776;1605;1;0;0
FR;3;2021-10-10;13;17;2;0;16;3;0;0;0;4415900;3415461;3295;0;3587792;1608;1;0;0
FR;3;2021-10-11;17;117;4;0;122;5;0;0;0;4415917;3415578;3299;0;3587914;1613;1;0;0
FR;3;2021-10-12;22;99;6;0;99;6;0;0;0;4415939;3415677;3305;0;3588013;1619;1;0;0
FR;3;2021-10-13;25;114;9;0;121;7;0;0;0;4415964;3415791;3314;0;3588134;1626;1;0;0
FR;3;2021-10-14;19;138;3;0;139;4;0;0;0;4415983;3415929;3317;0;3588273;1630;1;0;0
FR;3;2021-10-15;24;139;8;0;138;13;0;0;0;4416007;3416068;3325;0;3588411;1643;1;0;0
FR;3;2021-10-16;13;66;6;0;65;8;0;0;0;4416020;3416134;3331;0;3588476;1651;1;0;0
FR;3;2021-10-17;13;24;0;0;26;0;0;0;0;4416033;3416158;3331;0;3588502;1651;1;0;0
FR;3;2021-10-18;18;112;2;0;117;2;0;0;0;4416051;3416270;3333;0;3588619;1653;1;0;0
FR;3;2021-10-19;18;112;19;0;113;21;0;0;0;4416069;3416382;3352;0;3588732;1674;1;0;0
FR;3;2021-10-20;27;124;6;0;126;7;0;0;0;4416096;3416506;3358;0;3588858;1681;1;0;0
FR;3;2021-10-21;28;120;17;0;120;13;0;0;0;4416124;3416626;3375;0;3588978;1694;1;0;0
FR;3;2021-10-22;25;103;18;0;102;21;0;0;0;4416149;3416729;3393;0;3589080;1715;1;0;0
FR;3;2021-10-23;17;53;3;0;53;2;0;0;0;4416166;3416782;3396;0;3589133;1717;1;0;0
FR;3;2021-10-24;7;36;0;0;34;0;0;0;0;4416173;3416818;3396;0;3589167;1717;1;0;0
FR;3;2021-10-25;27;141;7;0;145;7;0;0;0;4416200;3416959;3403;0;3589312;1724;1;0;0
FR;3;2021-10-26;25;96;22;0;93;19;0;0;0;4416225;3417055;3425;0;3589405;1743;1;0;0
FR;3;2021-10-27;19;91;9;0;93;9;0;0;0;4416244;3417146;3434;0;3589498;1752;1;0;0
FR;3;2021-10-28;23;114;33;0;111;36;0;0;0;4416267;3417260;3467;0;3589609;1788;1;0;0
FR;3;2021-10-29;12;97;64;0;91;54;0;0;0;4416279;3417357;3531;0;3589700;1842;1;0;0
FR;3;2021-10-30;11;62;11;1;62;10;0;0;0;4416290;3417419;3542;1;3589762;1852;1;0;0
FR;3;2021-10-31;8;25;1;0;25;1;0;0;0;4416298;3417444;3543;1;3589787;1853;1;0;0
FR;3;2021-11-01;11;22;2;0;23;1;0;0;0;4416309;3417466;3545;1;3589810;1854;1;0;0
FR;3;2021-11-02;11;100;10;0;100;12;0;0;0;4416320;3417566;3555;1;3589910;1866;1;0;0
FR;3;2021-11-03;22;105;10;0;113;10;0;0;0;4416342;3417671;3565;1;3590023;1876;1;0;0
FR;3;2021-11-04;20;88;6;0;93;5;0;0;0;4416362;3417759;3571;1;3590116;1881;1;0;0
FR;3;2021-11-05;19;119;9;1;125;6;1;0;0;4416381;3417878;3580;2;3590241;1887;2;0;0
FR;3;2021-11-06;11;54;3;0;56;3;0;0;0;4416392;3417932;3583;2;3590297;1890;2;0;0
FR;3;2021-11-07;6;23;1;0;24;1;0;0;0;4416398;3417955;3584;2;3590321;1891;2;0;0
FR;3;2021-11-08;12;124;7;0;129;5;0;0;0;4416410;3418079;3591;2;3590450;1896;2;0;0
FR;3;2021-11-09;15;123;6;0;125;6;0;0;0;4416425;3418202;3597;2;3590575;1902;2;0;0
FR;3;2021-11-10;15;130;15;0;128;16;0;0;0;4416440;3418332;3612;2;3590703;1918;2;0;0
FR;3;2021-11-11;12;49;3;0;51;3;0;0;0;4416452;3418381;3615;2;3590754;1921;2;0;0
FR;3;2021-11-12;15;126;6;0;128;5;0;0;0;4416467;3418507;3621;2;3590882;1926;2;0;0
FR;3;2021-11-13;7;66;9;0;61;10;0;0;0;4416474;3418573;3630;2;3590943;1936;2;0;0
FR;3;2021-11-14;3;24;1;0;24;1;0;0;0;4416477;3418597;3631;2;3590967;1937;2;0;0
FR;3;2021-11-15;7;161;11;0;158;12;0;0;0;4416484;3418758;3642;2;3591125;1949;2;0;0
FR;3;2021-11-16;9;125;11;0;120;10;0;0;0;4416493;3418883;3653;2;3591245;1959;2;0;0
FR;3;2021-11-17;8;134;11;0;135;8;0;0;0;4416501;3419017;3664;2;3591380;1967;2;0;0
FR;3;2021-11-18;16;131;10;0;132;11;0;0;0;4416517;3419148;3674;2;3591512;1978;2;0;0
FR;3;2021-11-19;12;178;23;0;173;28;0;0;0;4416529;3419326;3697;2;3591685;2006;2;0;0
FR;3;2021-11-20;6;101;6;0;102;6;0;0;0;4416535;3419427;3703;2;3591787;2012;2;0;0
FR;3;2021-11-21;3;24;4;0;23;4;0;0;0;4416538;3419451;3707;2;3591810;2016;2;0;0
FR;3;2021-11-22;11;185;11;0;185;11;0;0;0;4416549;3419636;3718;2;3591995;2027;2;0;0
FR;3;2021-11-23;10;180;16;0;178;15;0;0;0;4416559;3419816;3734;2;3592173;2042;2;0;0
FR;3;2021-11-24;11;180;9;0;172;17;0;0;0;4416570;3419996;3743;2;3592345;2059;2;0;0
FR;3;2021-11-25;12;196;11;0;195;11;0;0;0;4416582;3420192;3754;2;3592540;2070;2;0;0
FR;3;2021-11-26;10;251;35;0;250;33;1;0;0;4416592;3420443;3789;2;3592790;2103;3;0;0
FR;3;2021-11-27;8;122;20;0;122;21;0;0;0;4416600;3420565;3809;2;3592912;2124;3;0;0
FR;3;2021-11-28;3;56;7;0;57;7;0;0;0;4416603;3420621;3816;2;3592969;2131;3;0;0
FR;3;2021-11-29;5;214;22;0;209;23;1;0;0;4416608;3420835;3838;2;3593178;2154;4;0;0
FR;3;2021-11-30;9;281;31;0;280;33;1;0;0;4416617;3421116;3869;2;3593458;2187;5;0;0
FR;3;2021-12-01;30;314;39;0;312;41;2;0;0;4416647;3421430;3908;2;3593770;2228;7;0;0
FR;3;2021-12-02;9;337;33;0;333;36;0;0;0;4416656;3421767;3941;2;3594103;2264;7;0;0
FR;3;2021-12-03;6;364;37;0;360;38;0;0;0;4416662;3422131;3978;2;3594463;2302;7;0;0
FR;3;2021-12-04;3;201;26;0;197;28;0;0;0;4416665;3422332;4004;2;3594660;2330;7;0;0
FR;3;2021-12-05;1;61;5;0;61;5;0;0;0;4416666;3422393;4009;2;3594721;2335;7;0;0
FR;3;2021-12-06;7;347;14;0;346;15;0;0;0;4416673;3422740;4023;2;3595067;2350;7;0;0
FR;3;2021-12-07;6;409;20;0;403;24;1;0;0;4416679;3423149;4043;2;3595470;2374;8;0;0
FR;3;2021-12-08;9;373;29;0;365;30;1;0;0;4416688;3423522;4072;2;3595835;2404;9;0;0
FR;3;2021-12-09;3;423;17;0;410;22;1;0;0;4416691;3423945;4089;2;3596245;2426;10;0;0
FR;3;2021-12-10;10;443;29;0;440;25;0;0;0;4416701;3424388;4118;2;3596685;2451;10;0;0
FR;3;2021-12-11;4;299;10;0;296;9;2;0;0;4416705;3424687;4128;2;3596981;2460;12;0;0
FR;3;2021-12-12;1;96;3;0;96;3;0;0;0;4416706;3424783;4131;2;3597077;2463;12;0;0
FR;3;2021-12-13;2;432;19;0;426;21;0;0;0;4416708;3425215;4150;2;3597503;2484;12;0;0
FR;3;2021-12-14;8;550;18;0;538;21;1;0;0;4416716;3425765;4168;2;3598041;2505;13;0;0
FR;3;2021-12-15;10;521;17;0;508;21;0;0;0;4416726;3426286;4185;2;3598549;2526;13;0;0
FR;3;2021-12-16;10;525;19;0;519;18;3;0;0;4416736;3426811;4204;2;3599068;2544;16;0;0
FR;3;2021-12-17;5;592;18;0;588;19;0;0;0;4416741;3427403;4222;2;3599656;2563;16;0;0
FR;3;2021-12-18;5;343;4;0;337;5;1;0;0;4416746;3427746;4226;2;3599993;2568;17;0;0
FR;3;2021-12-19;3;176;2;0;174;2;0;0;0;4416749;3427922;4228;2;3600167;2570;17;0;0
FR;3;2021-12-20;10;566;23;0;560;28;0;0;0;4416759;3428488;4251;2;3600727;2598;17;0;0
FR;3;2021-12-21;5;660;10;0;652;13;2;0;0;4416764;3429148;4261;2;3601379;2611;19;0;0
FR;3;2021-12-22;10;612;9;0;606;10;1;0;0;4416774;3429760;4270;2;3601985;2621;20;0;0
FR;3;2021-12-23;4;534;8;0;532;8;0;0;0;4416778;3430294;4278;2;3602517;2629;20;0;0
FR;3;2021-12-24;2;233;3;0;228;6;0;0;0;4416780;3430527;4281;2;3602745;2635;20;0;0
FR;3;2021-12-25;0;24;0;0;24;0;0;0;0;4416780;3430551;4281;2;3602769;2635;20;0;0
FR;3;2021-12-26;0;87;1;0;87;1;0;0;0;4416780;3430638;4282;2;3602856;2636;20;0;0
FR;3;2021-12-27;7;454;17;0;451;20;1;0;0;4416787;3431092;4299;2;3603307;2656;21;0;0
FR;3;2021-12-28;3;570;6;0;569;5;0;0;0;4416790;3431662;4305;2;3603876;2661;21;0;0
FR;3;2021-12-29;5;487;14;0;482;16;0;0;0;4416795;3432149;4319;2;3604358;2677;21;0;0
FR;3;2021-12-30;3;517;7;0;510;10;2;0;0;4416798;3432666;4326;2;3604868;2687;23;0;0
FR;3;2021-12-31;0;182;5;0;178;7;0;0;0;4416798;3432848;4331;2;3605046;2694;23;0;0
FR;3;2022-01-01;0;26;0;0;24;2;0;0;0;4416798;3432874;4331;2;3605070;2696;23;0;0
FR;3;2022-01-02;0;76;0;0;76;0;0;0;0;4416798;3432950;4331;2;3605146;2696;23;0;0
FR;3;2022-01-03;5;489;17;0;479;21;3;0;0;4416803;3433439;4348;2;3605625;2717;26;0;0
FR;3;2022-01-04;7;533;9;0;532;8;0;0;0;4416810;3433972;4357;2;3606157;2725;26;0;0
FR;3;2022-01-05;5;487;10;0;479;14;1;0;0;4416815;3434459;4367;2;3606636;2739;27;0;0
FR;3;2022-01-06;6;464;9;0;459;10;1;0;0;4416821;3434923;4376;2;3607095;2749;28;0;0
FR;3;2022-01-07;2;489;11;0;483;13;1;0;1;4416823;3435412;4387;2;3607578;2762;29;0;1
FR;3;2022-01-08;6;250;4;0;247;5;0;0;0;4416829;3435662;4391;2;3607825;2767;29;0;1
FR;3;2022-01-09;0;115;0;0;115;0;0;0;0;4416829;3435777;4391;2;3607940;2767;29;0;1
FR;3;2022-01-10;2;420;12;0;418;12;0;0;0;4416831;3436197;4403;2;3608358;2779;29;0;1
FR;3;2022-01-11;3;455;1;0;454;1;0;0;0;4416834;3436652;4404;2;3608812;2780;29;0;1
FR;3;2022-01-12;4;393;9;0;390;10;2;0;0;4416838;3437045;4413;2;3609202;2790;31;0;1
FR;3;2022-01-13;3;380;11;0;378;12;1;0;0;4416841;3437425;4424;2;3609580;2802;32;0;1
FR;3;2022-01-14;4;419;10;0;413;13;1;0;0;4416845;3437844;4434;2;3609993;2815;33;0;1
FR;3;2022-01-15;0;275;2;0;271;3;0;0;0;4416845;3438119;4436;2;3610264;2818;33;0;1
FR;3;2022-01-16;1;108;1;0;106;1;1;0;0;4416846;3438227;4437;2;3610370;2819;34;0;1
FR;3;2022-01-17;2;318;8;0;315;9;1;0;0;4416848;3438545;4445;2;3610685;2828;35;0;1
FR;3;2022-01-18;2;358;1;0;354;2;1;0;0;4416850;3438903;4446;2;3611039;2830;36;0;1
FR;3;2022-01-19;2;322;5;0;316;10;0;0;0;4416852;3439225;4451;2;3611355;2840;36;0;1
FR;3;2022-01-20;1;351;5;0;350;3;2;0;0;4416853;3439576;4456;2;3611705;2843;38;0;1
FR;3;2022-01-21;4;337;5;0;331;7;2;0;0;4416857;3439913;4461;2;3612036;2850;40;0;1
FR;3;2022-01-22;2;218;1;0;214;2;3;0;0;4416859;3440131;4462;2;3612250;2852;43;0;1
FR;3;2022-01-23;0;77;0;0;75;1;1;0;0;4416859;3440208;4462;2;3612325;2853;44;0;1
FR;3;2022-01-24;3;316;1;0;308;6;2;0;0;4416862;3440524;4463;2;3612633;2859;46;0;1
FR;3;2022-01-25;0;171;0;0;168;0;1;0;0;4416862;3440695;4463;2;3612801;2859;47;0;1
FR;3;2022-01-26;0;77;0;0;77;0;0;0;0;4416862;3440772;4463;2;3612878;2859;47;0;1
FR;3;2022-01-27;0;52;0;0;52;0;0;0;0;4416862;3440824;4463;2;3612930;2859;47;0;1
FR;3;2022-01-28;0;115;0;0;114;0;0;0;0;4416862;3440939;4463;2;3613044;2859;47;0;1
FR;3;2022-01-29;0;97;0;0;97;0;0;0;0;4416862;3441036;4463;2;3613141;2859;47;0;1
FR;3;2022-01-30;0;50;0;0;50;0;0;0;0;4416862;3441086;4463;2;3613191;2859;47;0;1
FR;3;2022-01-31;0;90;0;0;90;0;0;0;0;4416862;3441176;4463;2;3613281;2859;47;0;1
FR;3;2022-02-01;0;98;0;0;96;1;0;0;0;4416862;3441274;4463;2;3613377;2860;47;0;1
FR;3;2022-02-02;0;85;0;0;83;0;0;0;0;4416862;3441359;4463;2;3613460;2860;47;0;1
FR;3;2022-02-03;0;91;0;0;89;0;0;0;0;4416862;3441450;4463;2;3613549;2860;47;0;1
FR;3;2022-02-04;0;113;0;0;110;0;1;0;0;4416862;3441563;4463;2;3613659;2860;48;0;1
FR;3;2022-02-05;0;68;0;0;68;0;0;0;0;4416862;3441631;4463;2;3613727;2860;48;0;1
FR;3;2022-02-06;0;10;0;0;10;0;0;0;0;4416862;3441641;4463;2;3613737;2860;48;0;1
FR;3;2022-02-07;0;75;0;0;75;0;0;0;0;4416862;3441716;4463;2;3613812;2860;48;0;1
FR;3;2022-02-08;0;0;0;0;0;0;0;0;0;4416862;3441716;4463;2;3613812;2860;48;0;1
FR;3;2022-02-09;0;0;0;0;0;0;0;0;0;4416862;3441716;4463;2;3613812;2860;48;0;1
FR;3;2022-02-10;0;0;0;0;0;0;0;0;0;4416862;3441716;4463;2;3613812;2860;48;0;1
FR;3;2022-02-11;0;0;0;0;0;0;0;0;0;4416862;3441716;4463;2;3613812;2860;48;0;1
FR;3;2022-02-12;0;0;0;0;0;0;0;0;0;4416862;3441716;4463;2;3613812;2860;48;0;1
FR;3;2022-02-13;0;0;0;0;0;0;0;0;0;4416862;3441716;4463;2;3613812;2860;48;0;1
FR;3;2022-02-14;0;0;0;0;0;0;0;0;0;4416862;3441716;4463;2;3613812;2860;48;0;1
FR;3;2022-02-15;0;0;0;0;0;0;0;0;0;4416862;3441716;4463;2;3613812;2860;48;0;1
FR;3;2022-02-16;0;0;0;0;0;0;0;0;0;4416862;3441716;4463;2;3613812;2860;48;0;1
FR;3;2022-02-17;0;0;0;0;0;0;0;0;0;4416862;3441716;4463;2;3613812;2860;48;0;1
FR;3;2022-02-18;0;0;0;0;0;0;0;0;0;4416862;3441716;4463;2;3613812;2860;48;0;1
FR;3;2022-02-19;0;0;0;0;0;0;0;0;0;4416862;3441716;4463;2;3613812;2860;48;0;1
FR;3;2022-02-20;0;0;0;0;0;0;0;0;0;4416862;3441716;4463;2;3613812;2860;48;0;1
FR;3;2022-02-21;2;0;0;0;0;0;0;0;0;4416864;3441716;4463;2;3613812;2860;48;0;1
FR;3;2022-02-22;0;0;0;0;0;0;0;0;0;4416864;3441716;4463;2;3613812;2860;48;0;1
FR;3;2022-02-23;0;0;0;0;0;0;0;0;0;4416864;3441716;4463;2;3613812;2860;48;0;1
FR;3;2022-02-24;0;0;0;0;0;0;0;0;0;4416864;3441716;4463;2;3613812;2860;48;0;1
FR;3;2022-02-25;0;0;0;0;0;0;0;0;0;4416864;3441716;4463;2;3613812;2860;48;0;1
FR;3;2022-02-26;0;0;0;0;0;0;0;0;0;4416864;3441716;4463;2;3613812;2860;48;0;1
FR;3;2022-02-27;0;0;0;0;0;0;0;0;0;4416864;3441716;4463;2;3613812;2860;48;0;1
FR;3;2022-02-28;1;0;0;0;0;0;0;0;0;4416865;3441716;4463;2;3613812;2860;48;0;1
FR;3;2022-03-01;1;0;0;0;0;0;0;0;0;4416866;3441716;4463;2;3613812;2860;48;0;1
FR;3;2022-03-02;0;0;0;0;0;0;0;0;0;4416866;3441716;4463;2;3613812;2860;48;0;1
FR;3;2022-03-03;0;0;0;0;0;0;0;0;0;4416866;3441716;4463;2;3613812;2860;48;0;1
FR;3;2022-03-04;0;0;0;0;0;0;0;0;0;4416866;3441716;4463;2;3613812;2860;48;0;1
FR;3;2022-03-05;0;0;0;0;0;0;0;0;0;4416866;3441716;4463;2;3613812;2860;48;0;1
FR;3;2022-03-06;1;0;0;0;0;0;0;0;0;4416867;3441716;4463;2;3613812;2860;48;0;1
FR;3;2022-03-07;0;0;0;0;0;0;0;0;0;4416867;3441716;4463;2;3613812;2860;48;0;1
FR;3;2022-03-08;1;0;0;0;0;0;0;0;0;4416868;3441716;4463;2;3613812;2860;48;0;1
FR;3;2022-03-09;0;0;0;0;0;0;0;0;0;4416868;3441716;4463;2;3613812;2860;48;0;1
FR;3;2022-03-10;0;0;0;0;0;0;0;0;0;4416868;3441716;4463;2;3613812;2860;48;0;1
FR;3;2022-03-11;0;0;0;0;0;0;0;0;0;4416868;3441716;4463;2;3613812;2860;48;0;1
FR;3;2022-03-12;0;0;0;0;0;0;0;0;0;4416868;3441716;4463;2;3613812;2860;48;0;1
FR;3;2022-03-13;0;0;0;0;0;0;0;0;0;4416868;3441716;4463;2;3613812;2860;48;0;1
FR;3;2022-03-14;0;0;0;0;0;0;0;0;0;4416868;3441716;4463;2;3613812;2860;48;0;1
FR;3;2022-03-15;0;0;0;0;0;0;0;0;0;4416868;3441716;4463;2;3613812;2860;48;0;1
FR;3;2022-03-16;0;0;0;0;0;0;0;0;0;4416868;3441716;4463;2;3613812;2860;48;0;1
FR;3;2022-03-17;0;0;0;0;0;0;0;0;0;4416868;3441716;4463;2;3613812;2860;48;0;1
FR;3;2022-03-18;0;0;0;0;0;0;0;0;0;4416868;3441716;4463;2;3613812;2860;48;0;1
FR;3;2022-03-19;0;0;0;0;0;0;0;0;0;4416868;3441716;4463;2;3613812;2860;48;0;1
FR;3;2022-03-20;1;0;0;0;0;0;0;0;0;4416869;3441716;4463;2;3613812;2860;48;0;1
FR;3;2022-03-21;0;0;0;0;0;0;0;0;0;4416869;3441716;4463;2;3613812;2860;48;0;1
FR;3;2022-03-22;0;0;0;0;0;0;0;0;0;4416869;3441716;4463;2;3613812;2860;48;0;1
FR;3;2022-03-23;1;0;0;0;0;0;0;0;0;4416870;3441716;4463;2;3613812;2860;48;0;1
FR;3;2022-03-24;0;0;0;0;0;0;0;0;0;4416870;3441716;4463;2;3613812;2860;48;0;1
FR;3;2022-03-25;1;0;0;0;0;0;0;0;0;4416871;3441716;4463;2;3613812;2860;48;0;1
FR;3;2022-03-26;0;0;0;0;0;0;0;0;0;4416871;3441716;4463;2;3613812;2860;48;0;1
FR;3;2022-03-27;0;0;0;0;0;0;0;0;0;4416871;3441716;4463;2;3613812;2860;48;0;1
FR;3;2022-03-28;0;0;0;0;0;0;0;0;0;4416871;3441716;4463;2;3613812;2860;48;0;1
FR;3;2022-03-29;0;0;0;0;0;0;0;0;0;4416871;3441716;4463;2;3613812;2860;48;0;1
FR;3;2022-03-30;0;0;0;0;0;0;0;0;0;4416871;3441716;4463;2;3613812;2860;48;0;1
FR;3;2022-03-31;0;0;0;0;0;0;0;0;0;4416871;3441716;4463;2;3613812;2860;48;0;1
FR;3;2022-04-01;0;0;0;0;0;0;0;0;0;4416871;3441716;4463;2;3613812;2860;48;0;1
FR;3;2022-04-02;0;0;0;0;0;0;0;0;0;4416871;3441716;4463;2;3613812;2860;48;0;1
FR;3;2022-04-03;0;0;0;0;0;0;0;0;0;4416871;3441716;4463;2;3613812;2860;48;0;1
FR;3;2022-04-04;0;0;0;0;0;0;0;0;0;4416871;3441716;4463;2;3613812;2860;48;0;1
FR;3;2022-04-05;0;0;0;0;0;0;0;0;0;4416871;3441716;4463;2;3613812;2860;48;0;1
FR;3;2022-04-06;0;0;0;0;0;0;0;0;0;4416871;3441716;4463;2;3613812;2860;48;0;1
FR;3;2022-04-07;0;0;0;0;0;0;0;0;0;4416871;3441716;4463;2;3613812;2860;48;0;1
FR;3;2022-04-08;0;0;0;0;0;0;0;0;0;4416871;3441716;4463;2;3613812;2860;48;0;1
FR;3;2022-04-09;0;0;0;0;0;0;0;0;0;4416871;3441716;4463;2;3613812;2860;48;0;1
FR;3;2022-04-10;0;0;0;0;0;0;0;0;0;4416871;3441716;4463;2;3613812;2860;48;0;1
FR;3;2022-04-11;0;0;0;0;0;0;0;0;0;4416871;3441716;4463;2;3613812;2860;48;0;1
FR;3;2022-04-12;0;0;0;0;0;0;0;0;0;4416871;3441716;4463;2;3613812;2860;48;0;1
FR;3;2022-04-13;0;0;0;0;0;0;0;0;0;4416871;3441716;4463;2;3613812;2860;48;0;1
FR;3;2022-04-14;0;0;0;0;0;0;0;0;0;4416871;3441716;4463;2;3613812;2860;48;0;1
FR;3;2022-04-15;1;0;0;0;0;0;0;0;0;4416872;3441716;4463;2;3613812;2860;48;0;1
FR;3;2022-04-16;0;0;0;0;0;0;0;0;0;4416872;3441716;4463;2;3613812;2860;48;0;1
FR;3;2022-04-17;0;0;0;0;0;0;0;0;0;4416872;3441716;4463;2;3613812;2860;48;0;1
FR;3;2022-04-18;0;0;0;0;0;0;0;0;0;4416872;3441716;4463;2;3613812;2860;48;0;1
FR;3;2022-04-19;0;0;0;0;0;0;0;0;0;4416872;3441716;4463;2;3613812;2860;48;0;1
FR;3;2022-04-20;0;0;0;0;0;0;0;0;0;4416872;3441716;4463;2;3613812;2860;48;0;1
FR;3;2022-04-21;0;0;0;0;0;0;0;0;0;4416872;3441716;4463;2;3613812;2860;48;0;1
FR;3;2022-04-22;0;0;0;0;0;0;0;0;0;4416872;3441716;4463;2;3613812;2860;48;0;1
FR;3;2022-04-23;0;0;0;0;0;0;0;0;0;4416872;3441716;4463;2;3613812;2860;48;0;1
FR;3;2022-04-24;0;0;0;0;0;0;0;0;0;4416872;3441716;4463;2;3613812;2860;48;0;1
FR;3;2022-04-25;0;0;0;0;0;0;0;0;0;4416872;3441716;4463;2;3613812;2860;48;0;1
FR;3;2022-04-26;0;0;0;0;0;0;0;0;0;4416872;3441716;4463;2;3613812;2860;48;0;1
FR;3;2022-04-27;0;0;0;0;0;0;0;0;0;4416872;3441716;4463;2;3613812;2860;48;0;1
FR;3;2022-04-28;0;0;0;0;0;0;0;0;0;4416872;3441716;4463;2;3613812;2860;48;0;1
FR;3;2022-04-29;0;0;0;0;0;0;0;0;0;4416872;3441716;4463;2;3613812;2860;48;0;1
FR;3;2022-04-30;0;0;0;0;0;0;0;0;0;4416872;3441716;4463;2;3613812;2860;48;0;1
FR;3;2022-05-01;0;0;0;0;0;0;0;0;0;4416872;3441716;4463;2;3613812;2860;48;0;1
FR;3;2022-05-02;0;0;0;0;0;0;0;0;0;4416872;3441716;4463;2;3613812;2860;48;0;1
FR;3;2022-05-03;0;0;0;0;0;0;0;0;0;4416872;3441716;4463;2;3613812;2860;48;0;1
FR;3;2022-05-04;0;0;0;0;0;0;0;0;0;4416872;3441716;4463;2;3613812;2860;48;0;1
FR;3;2022-05-05;0;0;0;0;0;0;0;0;0;4416872;3441716;4463;2;3613812;2860;48;0;1
FR;3;2022-05-06;0;0;0;0;0;0;0;0;0;4416872;3441716;4463;2;3613812;2860;48;0;1
FR;3;2022-05-07;0;0;0;0;0;0;0;0;0;4416872;3441716;4463;2;3613812;2860;48;0;1
FR;3;2022-05-08;0;0;0;0;0;0;0;0;0;4416872;3441716;4463;2;3613812;2860;48;0;1
FR;3;2022-05-09;0;0;0;0;0;0;0;0;0;4416872;3441716;4463;2;3613812;2860;48;0;1
FR;3;2022-05-10;0;0;0;0;0;0;0;0;0;4416872;3441716;4463;2;3613812;2860;48;0;1
FR;3;2022-05-11;0;0;0;0;0;0;0;0;0;4416872;3441716;4463;2;3613812;2860;48;0;1
FR;3;2022-05-12;0;0;0;0;0;0;0;0;0;4416872;3441716;4463;2;3613812;2860;48;0;1
FR;3;2022-05-13;0;0;0;0;0;0;0;0;0;4416872;3441716;4463;2;3613812;2860;48;0;1
FR;3;2022-05-14;1;0;0;0;0;0;0;0;0;4416873;3441716;4463;2;3613812;2860;48;0;1
FR;3;2022-05-15;0;0;0;0;0;0;0;0;0;4416873;3441716;4463;2;3613812;2860;48;0;1
FR;3;2022-05-16;0;0;0;0;0;0;0;0;0;4416873;3441716;4463;2;3613812;2860;48;0;1
FR;3;2022-05-17;0;0;0;0;0;0;0;0;0;4416873;3441716;4463;2;3613812;2860;48;0;1
FR;3;2022-05-18;0;0;0;0;0;0;0;0;0;4416873;3441716;4463;2;3613812;2860;48;0;1
FR;3;2022-05-19;0;0;0;0;0;0;0;0;0;4416873;3441716;4463;2;3613812;2860;48;0;1
FR;3;2022-05-20;0;0;0;0;0;0;0;0;0;4416873;3441716;4463;2;3613812;2860;48;0;1
FR;3;2022-05-21;0;0;0;0;0;0;0;0;0;4416873;3441716;4463;2;3613812;2860;48;0;1
FR;3;2022-05-22;0;0;0;0;0;0;0;0;0;4416873;3441716;4463;2;3613812;2860;48;0;1
FR;3;2022-05-23;0;0;0;0;0;0;0;0;0;4416873;3441716;4463;2;3613812;2860;48;0;1
FR;3;2022-05-24;0;0;0;0;0;0;0;0;0;4416873;3441716;4463;2;3613812;2860;48;0;1
FR;3;2022-05-25;0;0;0;0;0;0;0;0;0;4416873;3441716;4463;2;3613812;2860;48;0;1
FR;3;2022-05-26;0;0;0;0;0;0;0;0;0;4416873;3441716;4463;2;3613812;2860;48;0;1
FR;3;2022-05-27;0;0;0;0;0;0;0;0;0;4416873;3441716;4463;2;3613812;2860;48;0;1
FR;3;2022-05-28;0;0;0;0;0;0;0;0;0;4416873;3441716;4463;2;3613812;2860;48;0;1
FR;3;2022-05-29;0;0;0;0;0;0;0;0;0;4416873;3441716;4463;2;3613812;2860;48;0;1
FR;3;2022-05-30;0;0;0;0;0;0;0;0;0;4416873;3441716;4463;2;3613812;2860;48;0;1
FR;3;2022-05-31;0;0;0;0;0;0;0;0;0;4416873;3441716;4463;2;3613812;2860;48;0;1
FR;3;2022-06-01;0;0;0;0;0;0;0;0;0;4416873;3441716;4463;2;3613812;2860;48;0;1
FR;3;2022-06-02;0;0;0;0;0;0;0;0;0;4416873;3441716;4463;2;3613812;2860;48;0;1
FR;3;2022-06-03;0;0;0;0;0;0;0;0;0;4416873;3441716;4463;2;3613812;2860;48;0;1
FR;3;2022-06-04;0;0;0;0;0;0;0;0;0;4416873;3441716;4463;2;3613812;2860;48;0;1
FR;3;2022-06-05;0;0;0;0;0;0;0;0;0;4416873;3441716;4463;2;3613812;2860;48;0;1
FR;3;2022-06-06;0;0;0;0;0;0;0;0;0;4416873;3441716;4463;2;3613812;2860;48;0;1
FR;3;2022-06-07;0;0;0;0;0;0;0;0;0;4416873;3441716;4463;2;3613812;2860;48;0;1
FR;3;2022-06-08;0;0;0;0;0;0;0;0;0;4416873;3441716;4463;2;3613812;2860;48;0;1
FR;3;2022-06-09;0;0;0;0;0;0;0;0;0;4416873;3441716;4463;2;3613812;2860;48;0;1
FR;3;2022-06-10;0;0;0;0;0;0;0;0;0;4416873;3441716;4463;2;3613812;2860;48;0;1
FR;3;2022-06-11;0;0;0;0;0;0;0;0;0;4416873;3441716;4463;2;3613812;2860;48;0;1
FR;3;2022-06-12;0;0;0;0;0;0;0;0;0;4416873;3441716;4463;2;3613812;2860;48;0;1
FR;3;2022-06-13;1;0;0;0;0;0;0;0;0;4416874;3441716;4463;2;3613812;2860;48;0;1
FR;3;2022-06-14;0;0;0;0;0;0;0;0;0;4416874;3441716;4463;2;3613812;2860;48;0;1
FR;3;2022-06-15;0;0;0;0;0;0;0;0;0;4416874;3441716;4463;2;3613812;2860;48;0;1
FR;3;2022-06-16;0;0;0;0;0;0;0;0;0;4416874;3441716;4463;2;3613812;2860;48;0;1
FR;3;2022-06-17;0;0;0;0;0;0;0;0;0;4416874;3441716;4463;2;3613812;2860;48;0;1
FR;3;2022-06-18;0;0;0;0;0;0;0;0;0;4416874;3441716;4463;2;3613812;2860;48;0;1
FR;3;2022-06-19;0;0;0;0;0;0;0;0;0;4416874;3441716;4463;2;3613812;2860;48;0;1
FR;3;2022-06-20;0;0;0;0;0;0;0;0;0;4416874;3441716;4463;2;3613812;2860;48;0;1
FR;3;2022-06-21;0;0;0;0;0;0;0;0;0;4416874;3441716;4463;2;3613812;2860;48;0;1
FR;3;2022-06-22;0;0;0;0;0;0;0;0;0;4416874;3441716;4463;2;3613812;2860;48;0;1
FR;3;2022-06-23;0;0;0;0;0;0;0;0;0;4416874;3441716;4463;2;3613812;2860;48;0;1
FR;3;2022-06-24;0;0;0;0;0;0;0;0;0;4416874;3441716;4463;2;3613812;2860;48;0;1
FR;3;2022-06-25;0;0;0;0;0;0;0;0;0;4416874;3441716;4463;2;3613812;2860;48;0;1
FR;3;2022-06-26;0;0;0;0;0;0;0;0;0;4416874;3441716;4463;2;3613812;2860;48;0;1
FR;3;2022-06-27;0;0;0;0;0;0;0;0;0;4416874;3441716;4463;2;3613812;2860;48;0;1
FR;3;2022-06-28;0;0;0;0;0;0;0;0;0;4416874;3441716;4463;2;3613812;2860;48;0;1
FR;3;2022-06-29;1;0;0;0;0;0;0;0;0;4416875;3441716;4463;2;3613812;2860;48;0;1
FR;3;2022-06-30;0;0;0;0;0;0;0;0;0;4416875;3441716;4463;2;3613812;2860;48;0;1
FR;3;2022-07-01;0;0;0;0;0;0;0;0;0;4416875;3441716;4463;2;3613812;2860;48;0;1
FR;3;2022-07-02;0;0;0;0;0;0;0;0;0;4416875;3441716;4463;2;3613812;2860;48;0;1
FR;3;2022-07-03;0;0;0;0;0;0;0;0;0;4416875;3441716;4463;2;3613812;2860;48;0;1
FR;3;2022-07-04;0;0;0;0;0;0;0;0;0;4416875;3441716;4463;2;3613812;2860;48;0;1
FR;3;2022-07-05;0;0;0;0;0;0;0;0;0;4416875;3441716;4463;2;3613812;2860;48;0;1
FR;3;2022-07-06;0;0;0;0;0;0;0;0;0;4416875;3441716;4463;2;3613812;2860;48;0;1
FR;3;2022-07-07;0;0;0;0;0;0;0;0;0;4416875;3441716;4463;2;3613812;2860;48;0;1
FR;3;2022-07-08;0;0;0;0;0;0;0;0;0;4416875;3441716;4463;2;3613812;2860;48;0;1
FR;3;2022-07-09;0;0;0;0;0;0;0;0;0;4416875;3441716;4463;2;3613812;2860;48;0;1
FR;3;2022-07-10;0;0;0;0;0;0;0;0;0;4416875;3441716;4463;2;3613812;2860;48;0;1
FR;3;2022-07-11;0;0;0;0;0;0;0;0;0;4416875;3441716;4463;2;3613812;2860;48;0;1
FR;3;2022-07-12;0;0;0;0;0;0;0;0;0;4416875;3441716;4463;2;3613812;2860;48;0;1
FR;3;2022-07-13;0;0;0;0;0;0;0;0;0;4416875;3441716;4463;2;3613812;2860;48;0;1
FR;3;2022-07-14;0;0;0;0;0;0;0;0;0;4416875;3441716;4463;2;3613812;2860;48;0;1
FR;3;2022-07-15;0;0;0;0;0;0;0;0;0;4416875;3441716;4463;2;3613812;2860;48;0;1
FR;3;2022-07-16;0;0;0;0;0;0;0;0;0;4416875;3441716;4463;2;3613812;2860;48;0;1
FR;3;2022-07-17;0;0;0;0;0;0;0;0;0;4416875;3441716;4463;2;3613812;2860;48;0;1
FR;3;2022-07-18;0;0;0;0;0;0;0;0;0;4416875;3441716;4463;2;3613812;2860;48;0;1
FR;3;2022-07-19;0;0;0;0;0;0;0;0;0;4416875;3441716;4463;2;3613812;2860;48;0;1
FR;3;2022-07-20;0;0;0;0;0;0;0;0;0;4416875;3441716;4463;2;3613812;2860;48;0;1
FR;3;2022-07-21;0;0;0;0;0;0;0;0;0;4416875;3441716;4463;2;3613812;2860;48;0;1
FR;3;2022-07-22;0;0;0;0;0;0;0;0;0;4416875;3441716;4463;2;3613812;2860;48;0;1
FR;3;2022-07-23;0;0;0;0;0;0;0;0;0;4416875;3441716;4463;2;3613812;2860;48;0;1
FR;3;2022-07-24;0;0;0;0;0;0;0;0;0;4416875;3441716;4463;2;3613812;2860;48;0;1
FR;3;2022-07-25;0;0;0;0;0;0;0;0;0;4416875;3441716;4463;2;3613812;2860;48;0;1
FR;3;2022-07-26;0;0;0;0;0;0;0;0;0;4416875;3441716;4463;2;3613812;2860;48;0;1
FR;3;2022-07-27;0;0;0;0;0;0;0;0;0;4416875;3441716;4463;2;3613812;2860;48;0;1
FR;3;2022-07-28;0;0;0;0;0;0;0;0;0;4416875;3441716;4463;2;3613812;2860;48;0;1
FR;3;2022-07-29;0;0;0;0;0;0;0;0;0;4416875;3441716;4463;2;3613812;2860;48;0;1
FR;3;2022-07-30;0;0;0;0;0;0;0;0;0;4416875;3441716;4463;2;3613812;2860;48;0;1
FR;3;2022-07-31;0;0;0;0;0;0;0;0;0;4416875;3441716;4463;2;3613812;2860;48;0;1
FR;3;2022-08-01;0;0;0;0;0;0;0;0;0;4416875;3441716;4463;2;3613812;2860;48;0;1
FR;3;2022-08-02;0;0;0;0;0;0;0;0;0;4416875;3441716;4463;2;3613812;2860;48;0;1
FR;3;2022-08-03;0;0;0;0;0;0;0;0;0;4416875;3441716;4463;2;3613812;2860;48;0;1
FR;3;2022-08-04;0;0;0;0;0;0;0;0;0;4416875;3441716;4463;2;3613812;2860;48;0;1
FR;3;2022-08-05;0;0;0;0;0;0;0;0;0;4416875;3441716;4463;2;3613812;2860;48;0;1
FR;3;2022-08-06;0;0;0;0;0;0;0;0;0;4416875;3441716;4463;2;3613812;2860;48;0;1
FR;3;2022-08-07;0;0;0;0;0;0;0;0;0;4416875;3441716;4463;2;3613812;2860;48;0;1
FR;3;2022-08-08;0;0;0;0;0;0;0;0;0;4416875;3441716;4463;2;3613812;2860;48;0;1
FR;3;2022-08-09;0;0;0;0;0;0;0;0;0;4416875;3441716;4463;2;3613812;2860;48;0;1
FR;3;2022-08-10;0;0;0;0;0;0;0;0;0;4416875;3441716;4463;2;3613812;2860;48;0;1
FR;3;2022-08-11;0;0;0;0;0;0;0;0;0;4416875;3441716;4463;2;3613812;2860;48;0;1
FR;3;2022-08-12;0;0;0;0;0;0;0;0;0;4416875;3441716;4463;2;3613812;2860;48;0;1
FR;3;2022-08-13;0;0;0;0;0;0;0;0;0;4416875;3441716;4463;2;3613812;2860;48;0;1
FR;3;2022-08-14;0;0;0;0;0;0;0;0;0;4416875;3441716;4463;2;3613812;2860;48;0;1
FR;3;2022-08-15;0;0;0;0;0;0;0;0;0;4416875;3441716;4463;2;3613812;2860;48;0;1
FR;3;2022-08-16;0;0;0;0;0;0;0;0;0;4416875;3441716;4463;2;3613812;2860;48;0;1
FR;3;2022-08-17;0;0;0;0;0;0;0;0;0;4416875;3441716;4463;2;3613812;2860;48;0;1
FR;3;2022-08-18;0;0;0;0;0;0;0;0;0;4416875;3441716;4463;2;3613812;2860;48;0;1
FR;3;2022-08-19;0;0;0;0;0;0;0;0;0;4416875;3441716;4463;2;3613812;2860;48;0;1
FR;3;2022-08-20;0;0;0;0;0;0;0;0;0;4416875;3441716;4463;2;3613812;2860;48;0;1
FR;3;2022-08-21;0;0;0;0;0;0;0;0;0;4416875;3441716;4463;2;3613812;2860;48;0;1
FR;3;2022-08-22;0;0;0;0;0;0;0;0;0;4416875;3441716;4463;2;3613812;2860;48;0;1
FR;3;2022-08-23;0;0;0;0;0;0;0;0;0;4416875;3441716;4463;2;3613812;2860;48;0;1
FR;3;2022-08-24;0;0;0;0;0;0;0;0;0;4416875;3441716;4463;2;3613812;2860;48;0;1
FR;3;2022-08-25;0;0;0;0;0;0;0;0;0;4416875;3441716;4463;2;3613812;2860;48;0;1
FR;3;2022-08-26;0;0;0;0;0;0;0;0;0;4416875;3441716;4463;2;3613812;2860;48;0;1
FR;3;2022-08-27;0;0;0;0;0;0;0;0;0;4416875;3441716;4463;2;3613812;2860;48;0;1
FR;3;2022-08-28;0;0;0;0;0;0;0;0;0;4416875;3441716;4463;2;3613812;2860;48;0;1
FR;3;2022-08-29;0;0;0;0;0;0;0;0;0;4416875;3441716;4463;2;3613812;2860;48;0;1
FR;3;2022-08-30;0;0;0;0;0;0;0;0;0;4416875;3441716;4463;2;3613812;2860;48;0;1
FR;3;2022-08-31;0;0;0;0;0;0;0;0;0;4416875;3441716;4463;2;3613812;2860;48;0;1
FR;3;2022-09-01;0;0;0;0;0;0;0;0;0;4416875;3441716;4463;2;3613812;2860;48;0;1
FR;3;2022-09-02;0;0;0;0;0;0;0;0;0;4416875;3441716;4463;2;3613812;2860;48;0;1
FR;3;2022-09-03;0;0;0;0;0;0;0;0;0;4416875;3441716;4463;2;3613812;2860;48;0;1
FR;3;2022-09-04;0;0;0;0;0;0;0;0;0;4416875;3441716;4463;2;3613812;2860;48;0;1
FR;3;2022-09-05;0;0;0;0;0;0;0;0;0;4416875;3441716;4463;2;3613812;2860;48;0;1
FR;3;2022-09-06;0;0;0;0;0;0;0;0;0;4416875;3441716;4463;2;3613812;2860;48;0;1
FR;3;2022-09-07;0;0;0;0;0;0;0;0;0;4416875;3441716;4463;2;3613812;2860;48;0;1
FR;3;2022-09-08;0;0;0;0;0;0;0;0;0;4416875;3441716;4463;2;3613812;2860;48;0;1
FR;3;2022-09-09;0;0;0;0;0;0;0;0;0;4416875;3441716;4463;2;3613812;2860;48;0;1
FR;3;2022-09-10;0;0;0;0;0;0;0;0;0;4416875;3441716;4463;2;3613812;2860;48;0;1
FR;3;2022-09-11;0;0;0;0;0;0;0;0;0;4416875;3441716;4463;2;3613812;2860;48;0;1
FR;3;2022-09-12;0;0;0;0;0;0;0;0;0;4416875;3441716;4463;2;3613812;2860;48;0;1
FR;3;2022-09-13;0;0;0;0;0;0;0;0;0;4416875;3441716;4463;2;3613812;2860;48;0;1
FR;3;2022-09-14;0;0;0;0;0;0;0;0;0;4416875;3441716;4463;2;3613812;2860;48;0;1
FR;3;2022-09-15;0;0;0;0;0;0;0;0;0;4416875;3441716;4463;2;3613812;2860;48;0;1
FR;3;2022-09-16;0;0;0;0;0;0;0;0;0;4416875;3441716;4463;2;3613812;2860;48;0;1
FR;3;2022-09-17;0;0;0;0;0;0;0;0;0;4416875;3441716;4463;2;3613812;2860;48;0;1
FR;3;2022-09-18;0;0;0;0;0;0;0;0;0;4416875;3441716;4463;2;3613812;2860;48;0;1
FR;3;2022-09-19;0;0;0;0;0;0;0;0;0;4416875;3441716;4463;2;3613812;2860;48;0;1
FR;3;2022-09-20;0;0;0;0;0;0;0;0;0;4416875;3441716;4463;2;3613812;2860;48;0;1
FR;3;2022-09-21;0;0;0;0;0;0;0;0;0;4416875;3441716;4463;2;3613812;2860;48;0;1
FR;3;2022-09-22;0;0;0;0;0;0;0;0;0;4416875;3441716;4463;2;3613812;2860;48;0;1
FR;3;2022-09-23;0;0;0;0;0;0;0;0;0;4416875;3441716;4463;2;3613812;2860;48;0;1
FR;3;2022-09-24;0;0;0;0;0;0;0;0;0;4416875;3441716;4463;2;3613812;2860;48;0;1
FR;3;2022-09-25;0;0;0;0;0;0;0;0;0;4416875;3441716;4463;2;3613812;2860;48;0;1
FR;3;2022-09-26;0;0;0;0;0;0;0;0;0;4416875;3441716;4463;2;3613812;2860;48;0;1
FR;3;2022-09-27;0;0;0;0;0;0;0;0;0;4416875;3441716;4463;2;3613812;2860;48;0;1
FR;3;2022-09-28;0;0;0;0;0;0;0;0;0;4416875;3441716;4463;2;3613812;2860;48;0;1
FR;3;2022-09-29;0;0;0;0;0;0;0;0;0;4416875;3441716;4463;2;3613812;2860;48;0;1
FR;3;2022-09-30;0;0;0;0;0;0;0;0;0;4416875;3441716;4463;2;3613812;2860;48;0;1
FR;3;2022-10-01;0;0;0;0;0;0;0;0;0;4416875;3441716;4463;2;3613812;2860;48;0;1
FR;3;2022-10-02;0;0;0;0;0;0;0;0;0;4416875;3441716;4463;2;3613812;2860;48;0;1
FR;3;2022-10-03;0;0;0;0;0;0;0;0;0;4416875;3441716;4463;2;3613812;2860;48;0;1
FR;3;2022-10-04;0;0;0;0;0;0;0;0;0;4416875;3441716;4463;2;3613812;2860;48;0;1
FR;3;2022-10-05;0;0;0;0;0;0;0;0;0;4416875;3441716;4463;2;3613812;2860;48;0;1
FR;3;2022-10-06;0;0;0;0;0;0;0;0;0;4416875;3441716;4463;2;3613812;2860;48;0;1
FR;3;2022-10-07;0;0;0;0;0;0;0;0;0;4416875;3441716;4463;2;3613812;2860;48;0;1
FR;3;2022-10-08;0;0;0;0;0;0;0;0;0;4416875;3441716;4463;2;3613812;2860;48;0;1
FR;3;2022-10-09;0;0;0;0;0;0;0;0;0;4416875;3441716;4463;2;3613812;2860;48;0;1
FR;3;2022-10-10;0;0;0;0;0;0;0;0;0;4416875;3441716;4463;2;3613812;2860;48;0;1
FR;3;2022-10-11;0;0;0;0;0;0;0;0;0;4416875;3441716;4463;2;3613812;2860;48;0;1
FR;3;2022-10-12;0;0;0;0;0;0;0;0;0;4416875;3441716;4463;2;3613812;2860;48;0;1
FR;3;2022-10-13;0;0;0;0;0;0;0;0;0;4416875;3441716;4463;2;3613812;2860;48;0;1
FR;3;2022-10-14;0;0;0;0;0;0;0;0;0;4416875;3441716;4463;2;3613812;2860;48;0;1
FR;3;2022-10-15;0;0;0;0;0;0;0;0;0;4416875;3441716;4463;2;3613812;2860;48;0;1
FR;3;2022-10-16;0;0;0;0;0;0;0;0;0;4416875;3441716;4463;2;3613812;2860;48;0;1
FR;3;2022-10-17;0;0;0;0;0;0;0;0;0;4416875;3441716;4463;2;3613812;2860;48;0;1
FR;3;2022-10-18;0;0;0;0;0;0;0;0;0;4416875;3441716;4463;2;3613812;2860;48;0;1
FR;3;2022-10-19;0;0;0;0;0;0;0;0;0;4416875;3441716;4463;2;3613812;2860;48;0;1
FR;3;2022-10-20;0;0;0;0;0;0;0;0;0;4416875;3441716;4463;2;3613812;2860;48;0;1
FR;3;2022-10-21;0;0;0;0;0;0;0;0;0;4416875;3441716;4463;2;3613812;2860;48;0;1
FR;3;2022-10-22;0;0;0;0;0;0;0;0;0;4416875;3441716;4463;2;3613812;2860;48;0;1
FR;3;2022-10-23;0;0;0;0;0;0;0;0;0;4416875;3441716;4463;2;3613812;2860;48;0;1
FR;3;2022-10-24;0;0;0;0;0;0;0;0;0;4416875;3441716;4463;2;3613812;2860;48;0;1
FR;3;2022-10-25;0;0;0;0;0;0;0;0;0;4416875;3441716;4463;2;3613812;2860;48;0;1
FR;3;2022-10-26;0;0;0;0;0;0;0;0;0;4416875;3441716;4463;2;3613812;2860;48;0;1
FR;3;2022-10-27;0;0;0;0;0;0;0;0;0;4416875;3441716;4463;2;3613812;2860;48;0;1
FR;3;2022-10-28;0;0;0;0;0;0;0;0;0;4416875;3441716;4463;2;3613812;2860;48;0;1
FR;3;2022-10-29;0;0;0;0;0;0;0;0;0;4416875;3441716;4463;2;3613812;2860;48;0;1
FR;3;2022-10-30;0;0;0;0;0;0;0;0;0;4416875;3441716;4463;2;3613812;2860;48;0;1
FR;3;2022-10-31;0;0;0;0;0;0;0;0;0;4416875;3441716;4463;2;3613812;2860;48;0;1
FR;3;2022-11-01;0;0;0;0;0;0;0;0;0;4416875;3441716;4463;2;3613812;2860;48;0;1
FR;3;2022-11-02;0;0;0;0;0;0;0;0;0;4416875;3441716;4463;2;3613812;2860;48;0;1
FR;3;2022-11-03;0;0;0;0;0;0;0;0;0;4416875;3441716;4463;2;3613812;2860;48;0;1
FR;3;2022-11-04;0;0;0;0;0;0;0;0;0;4416875;3441716;4463;2;3613812;2860;48;0;1
FR;3;2022-11-05;0;0;0;0;0;0;0;0;0;4416875;3441716;4463;2;3613812;2860;48;0;1
FR;3;2022-11-06;0;0;0;0;0;0;0;0;0;4416875;3441716;4463;2;3613812;2860;48;0;1
FR;3;2022-11-07;0;0;0;0;0;0;0;0;0;4416875;3441716;4463;2;3613812;2860;48;0;1
FR;3;2022-11-08;1;0;0;0;0;0;0;0;0;4416876;3441716;4463;2;3613812;2860;48;0;1
FR;3;2022-11-09;0;0;0;0;0;0;0;0;0;4416876;3441716;4463;2;3613812;2860;48;0;1
FR;3;2022-11-10;0;0;0;0;0;0;0;0;0;4416876;3441716;4463;2;3613812;2860;48;0;1
FR;3;2022-11-11;0;0;0;0;0;0;0;0;0;4416876;3441716;4463;2;3613812;2860;48;0;1
FR;3;2022-11-12;0;0;0;0;0;0;0;0;0;4416876;3441716;4463;2;3613812;2860;48;0;1
FR;3;2022-11-13;0;0;0;0;0;0;0;0;0;4416876;3441716;4463;2;3613812;2860;48;0;1
FR;3;2022-11-14;0;0;0;0;0;0;0;0;0;4416876;3441716;4463;2;3613812;2860;48;0;1
FR;3;2022-11-15;0;0;0;0;0;0;0;0;0;4416876;3441716;4463;2;3613812;2860;48;0;1
FR;3;2022-11-16;0;0;0;0;0;0;0;0;0;4416876;3441716;4463;2;3613812;2860;48;0;1
FR;3;2022-11-17;0;0;0;0;0;0;0;0;0;4416876;3441716;4463;2;3613812;2860;48;0;1
FR;3;2022-11-18;0;0;0;0;0;0;0;0;0;4416876;3441716;4463;2;3613812;2860;48;0;1
FR;3;2022-11-19;0;0;0;0;0;0;0;0;0;4416876;3441716;4463;2;3613812;2860;48;0;1
FR;3;2022-11-20;0;0;0;0;0;0;0;0;0;4416876;3441716;4463;2;3613812;2860;48;0;1
FR;3;2022-11-21;0;0;0;0;0;0;0;0;0;4416876;3441716;4463;2;3613812;2860;48;0;1
FR;3;2022-11-22;0;0;0;0;0;0;0;0;0;4416876;3441716;4463;2;3613812;2860;48;0;1
FR;3;2022-11-23;0;0;0;0;0;0;0;0;0;4416876;3441716;4463;2;3613812;2860;48;0;1
FR;3;2022-11-24;0;0;0;0;0;0;0;0;0;4416876;3441716;4463;2;3613812;2860;48;0;1
FR;3;2022-11-25;0;0;0;0;0;0;0;0;0;4416876;3441716;4463;2;3613812;2860;48;0;1
FR;3;2022-11-26;0;0;0;0;0;0;0;0;0;4416876;3441716;4463;2;3613812;2860;48;0;1
FR;3;2022-11-27;0;0;0;0;0;0;0;0;0;4416876;3441716;4463;2;3613812;2860;48;0;1
FR;3;2022-11-28;0;0;0;0;0;0;0;0;0;4416876;3441716;4463;2;3613812;2860;48;0;1
FR;3;2022-11-29;0;0;0;0;0;0;0;0;0;4416876;3441716;4463;2;3613812;2860;48;0;1
FR;3;2022-11-30;0;0;0;0;0;0;0;0;0;4416876;3441716;4463;2;3613812;2860;48;0;1
FR;3;2022-12-01;0;0;0;0;0;0;0;0;0;4416876;3441716;4463;2;3613812;2860;48;0;1
FR;3;2022-12-02;0;0;0;0;0;0;0;0;0;4416876;3441716;4463;2;3613812;2860;48;0;1
FR;3;2022-12-03;0;0;0;0;0;0;0;0;0;4416876;3441716;4463;2;3613812;2860;48;0;1
FR;3;2022-12-04;0;0;0;0;0;0;0;0;0;4416876;3441716;4463;2;3613812;2860;48;0;1
FR;3;2022-12-05;0;0;0;0;0;0;0;0;0;4416876;3441716;4463;2;3613812;2860;48;0;1
FR;3;2022-12-06;0;0;0;0;0;0;0;0;0;4416876;3441716;4463;2;3613812;2860;48;0;1
FR;3;2022-12-07;0;0;0;0;0;0;0;0;0;4416876;3441716;4463;2;3613812;2860;48;0;1
FR;3;2022-12-08;0;0;0;0;0;0;0;0;0;4416876;3441716;4463;2;3613812;2860;48;0;1
FR;3;2022-12-09;0;0;0;0;0;0;0;0;0;4416876;3441716;4463;2;3613812;2860;48;0;1
FR;3;2022-12-10;0;0;0;0;0;0;0;0;0;4416876;3441716;4463;2;3613812;2860;48;0;1
FR;3;2022-12-11;0;0;0;0;0;0;0;0;0;4416876;3441716;4463;2;3613812;2860;48;0;1
FR;3;2022-12-12;0;0;0;0;0;0;0;0;0;4416876;3441716;4463;2;3613812;2860;48;0;1
FR;3;2022-12-13;0;0;0;0;0;0;0;0;0;4416876;3441716;4463;2;3613812;2860;48;0;1
FR;3;2022-12-14;0;0;0;0;0;0;0;0;0;4416876;3441716;4463;2;3613812;2860;48;0;1
FR;3;2022-12-15;0;0;0;0;0;0;0;0;0;4416876;3441716;4463;2;3613812;2860;48;0;1
FR;3;2022-12-16;0;0;0;0;0;0;0;0;0;4416876;3441716;4463;2;3613812;2860;48;0;1
FR;3;2022-12-17;0;0;0;0;0;0;0;0;0;4416876;3441716;4463;2;3613812;2860;48;0;1
FR;3;2022-12-18;0;0;0;0;0;0;0;0;0;4416876;3441716;4463;2;3613812;2860;48;0;1
FR;3;2022-12-19;0;0;0;0;0;0;0;0;0;4416876;3441716;4463;2;3613812;2860;48;0;1
FR;3;2022-12-20;0;0;0;0;0;0;0;0;0;4416876;3441716;4463;2;3613812;2860;48;0;1
FR;3;2022-12-21;0;0;0;0;0;0;0;0;0;4416876;3441716;4463;2;3613812;2860;48;0;1
FR;3;2022-12-22;0;0;0;0;0;0;0;0;0;4416876;3441716;4463;2;3613812;2860;48;0;1
FR;3;2022-12-23;0;0;0;0;0;0;0;0;0;4416876;3441716;4463;2;3613812;2860;48;0;1
FR;3;2022-12-24;0;0;0;0;0;0;0;0;0;4416876;3441716;4463;2;3613812;2860;48;0;1
FR;3;2022-12-25;0;0;0;0;0;0;0;0;0;4416876;3441716;4463;2;3613812;2860;48;0;1
FR;3;2022-12-26;0;0;0;0;0;0;0;0;0;4416876;3441716;4463;2;3613812;2860;48;0;1
FR;3;2022-12-27;0;0;0;0;0;0;0;0;0;4416876;3441716;4463;2;3613812;2860;48;0;1
FR;3;2022-12-28;0;0;0;0;0;0;0;0;0;4416876;3441716;4463;2;3613812;2860;48;0;1
FR;3;2022-12-29;0;0;0;0;0;0;0;0;0;4416876;3441716;4463;2;3613812;2860;48;0;1
FR;3;2022-12-30;0;0;0;0;0;0;0;0;0;4416876;3441716;4463;2;3613812;2860;48;0;1
FR;3;2022-12-31;0;0;0;0;0;0;0;0;0;4416876;3441716;4463;2;3613812;2860;48;0;1
FR;3;2023-01-01;0;0;0;0;0;0;0;0;0;4416876;3441716;4463;2;3613812;2860;48;0;1
FR;3;2023-01-02;0;0;0;0;0;0;0;0;0;4416876;3441716;4463;2;3613812;2860;48;0;1
FR;3;2023-01-03;0;0;0;0;0;0;0;0;0;4416876;3441716;4463;2;3613812;2860;48;0;1
FR;3;2023-01-04;0;0;0;0;0;0;0;0;0;4416876;3441716;4463;2;3613812;2860;48;0;1
FR;3;2023-01-05;0;0;0;0;0;0;0;0;0;4416876;3441716;4463;2;3613812;2860;48;0;1
FR;3;2023-01-06;0;0;0;0;0;0;0;0;0;4416876;3441716;4463;2;3613812;2860;48;0;1
FR;3;2023-01-07;0;0;0;0;0;0;0;0;0;4416876;3441716;4463;2;3613812;2860;48;0;1
FR;3;2023-01-08;0;0;0;0;0;0;0;0;0;4416876;3441716;4463;2;3613812;2860;48;0;1
FR;3;2023-01-09;0;0;0;0;0;0;0;0;0;4416876;3441716;4463;2;3613812;2860;48;0;1
FR;3;2023-01-10;0;0;0;0;0;0;0;0;0;4416876;3441716;4463;2;3613812;2860;48;0;1
FR;3;2023-01-11;0;0;0;0;0;0;0;0;0;4416876;3441716;4463;2;3613812;2860;48;0;1
FR;3;2023-01-12;0;0;0;0;0;0;0;0;0;4416876;3441716;4463;2;3613812;2860;48;0;1
FR;3;2023-01-13;0;0;0;0;0;0;0;0;0;4416876;3441716;4463;2;3613812;2860;48;0;1
FR;3;2023-01-14;0;0;0;0;0;0;0;0;0;4416876;3441716;4463;2;3613812;2860;48;0;1
FR;3;2023-01-15;0;0;0;0;0;0;0;0;0;4416876;3441716;4463;2;3613812;2860;48;0;1
FR;3;2023-01-16;0;0;0;0;0;0;0;0;0;4416876;3441716;4463;2;3613812;2860;48;0;1
FR;3;2023-01-17;0;0;0;0;0;0;0;0;0;4416876;3441716;4463;2;3613812;2860;48;0;1
FR;3;2023-01-18;0;0;0;0;0;0;0;0;0;4416876;3441716;4463;2;3613812;2860;48;0;1
FR;3;2023-01-19;0;0;0;0;0;0;0;0;0;4416876;3441716;4463;2;3613812;2860;48;0;1
FR;3;2023-01-20;0;0;0;0;0;0;0;0;0;4416876;3441716;4463;2;3613812;2860;48;0;1
FR;3;2023-01-21;0;0;0;0;0;0;0;0;0;4416876;3441716;4463;2;3613812;2860;48;0;1
FR;3;2023-01-22;0;0;0;0;0;0;0;0;0;4416876;3441716;4463;2;3613812;2860;48;0;1
FR;3;2023-01-23;0;0;0;0;0;0;0;0;0;4416876;3441716;4463;2;3613812;2860;48;0;1
FR;3;2023-01-24;0;0;0;0;0;0;0;0;0;4416876;3441716;4463;2;3613812;2860;48;0;1
FR;3;2023-01-25;1;0;0;0;0;0;0;0;0;4416877;3441716;4463;2;3613812;2860;48;0;1
FR;3;2023-01-26;0;0;0;0;0;0;0;0;0;4416877;3441716;4463;2;3613812;2860;48;0;1
FR;3;2023-01-27;0;0;0;0;0;0;0;0;0;4416877;3441716;4463;2;3613812;2860;48;0;1
FR;3;2023-01-28;0;0;0;0;0;0;0;0;0;4416877;3441716;4463;2;3613812;2860;48;0;1
FR;3;2023-01-29;0;0;0;0;0;0;0;0;0;4416877;3441716;4463;2;3613812;2860;48;0;1
FR;3;2023-01-30;0;0;0;0;0;0;0;0;0;4416877;3441716;4463;2;3613812;2860;48;0;1
FR;3;2023-01-31;0;0;0;0;0;0;0;0;0;4416877;3441716;4463;2;3613812;2860;48;0;1
FR;3;2023-02-01;0;0;0;0;0;0;0;0;0;4416877;3441716;4463;2;3613812;2860;48;0;1
FR;3;2023-02-02;0;0;0;0;0;0;0;0;0;4416877;3441716;4463;2;3613812;2860;48;0;1
FR;3;2023-02-03;0;0;0;0;0;0;0;0;0;4416877;3441716;4463;2;3613812;2860;48;0;1
FR;3;2023-02-04;0;0;0;0;0;0;0;0;0;4416877;3441716;4463;2;3613812;2860;48;0;1
FR;3;2023-02-05;0;0;0;0;0;0;0;0;0;4416877;3441716;4463;2;3613812;2860;48;0;1
FR;3;2023-02-06;0;0;0;0;0;0;0;0;0;4416877;3441716;4463;2;3613812;2860;48;0;1
FR;3;2023-02-07;0;0;0;0;0;0;0;0;0;4416877;3441716;4463;2;3613812;2860;48;0;1
FR;3;2023-02-08;0;0;0;0;0;0;0;0;0;4416877;3441716;4463;2;3613812;2860;48;0;1
FR;3;2023-02-09;0;0;0;0;0;0;0;0;0;4416877;3441716;4463;2;3613812;2860;48;0;1
FR;3;2023-02-10;0;0;0;0;0;0;0;0;0;4416877;3441716;4463;2;3613812;2860;48;0;1
FR;3;2023-02-11;0;0;0;0;0;0;0;0;0;4416877;3441716;4463;2;3613812;2860;48;0;1
FR;3;2023-02-12;0;0;0;0;0;0;0;0;0;4416877;3441716;4463;2;3613812;2860;48;0;1
FR;3;2023-02-13;0;0;0;0;0;0;0;0;0;4416877;3441716;4463;2;3613812;2860;48;0;1
FR;3;2023-02-14;0;0;0;0;0;0;0;0;0;4416877;3441716;4463;2;3613812;2860;48;0;1
FR;3;2023-02-15;0;0;0;0;0;0;0;0;0;4416877;3441716;4463;2;3613812;2860;48;0;1
FR;3;2023-02-16;0;0;0;0;0;0;0;0;0;4416877;3441716;4463;2;3613812;2860;48;0;1
FR;3;2023-02-17;0;0;0;0;0;0;0;0;0;4416877;3441716;4463;2;3613812;2860;48;0;1
FR;3;2023-02-18;0;0;0;0;0;0;0;0;0;4416877;3441716;4463;2;3613812;2860;48;0;1
FR;3;2023-02-19;0;0;0;0;0;0;0;0;0;4416877;3441716;4463;2;3613812;2860;48;0;1
FR;3;2023-02-20;0;0;0;0;0;0;0;0;0;4416877;3441716;4463;2;3613812;2860;48;0;1
FR;3;2023-02-21;0;0;0;0;0;0;0;0;0;4416877;3441716;4463;2;3613812;2860;48;0;1
FR;3;2023-02-22;0;0;0;0;0;0;0;0;0;4416877;3441716;4463;2;3613812;2860;48;0;1
FR;3;2023-02-23;0;0;0;0;0;0;0;0;0;4416877;3441716;4463;2;3613812;2860;48;0;1
FR;3;2023-02-24;0;0;0;0;0;0;0;0;0;4416877;3441716;4463;2;3613812;2860;48;0;1
FR;3;2023-02-25;0;0;0;0;0;0;0;0;0;4416877;3441716;4463;2;3613812;2860;48;0;1
FR;3;2023-02-26;0;0;0;0;0;0;0;0;0;4416877;3441716;4463;2;3613812;2860;48;0;1
FR;3;2023-02-27;0;0;0;0;0;0;0;0;0;4416877;3441716;4463;2;3613812;2860;48;0;1
FR;3;2023-02-28;0;0;0;0;0;0;0;0;0;4416877;3441716;4463;2;3613812;2860;48;0;1
FR;3;2023-03-01;0;0;0;0;0;0;0;0;0;4416877;3441716;4463;2;3613812;2860;48;0;1
FR;3;2023-03-02;0;0;0;0;0;0;0;0;0;4416877;3441716;4463;2;3613812;2860;48;0;1
FR;3;2023-03-03;0;0;0;0;0;0;0;0;0;4416877;3441716;4463;2;3613812;2860;48;0;1
FR;3;2023-03-04;0;0;0;0;0;0;0;0;0;4416877;3441716;4463;2;3613812;2860;48;0;1
FR;3;2023-03-05;0;0;0;0;0;0;0;0;0;4416877;3441716;4463;2;3613812;2860;48;0;1
FR;3;2023-03-06;0;0;0;0;0;0;0;0;0;4416877;3441716;4463;2;3613812;2860;48;0;1
FR;3;2023-03-07;0;0;0;0;0;0;0;0;0;4416877;3441716;4463;2;3613812;2860;48;0;1
FR;3;2023-03-08;0;0;0;0;0;0;0;0;0;4416877;3441716;4463;2;3613812;2860;48;0;1
FR;3;2023-03-09;0;0;0;0;0;0;0;0;0;4416877;3441716;4463;2;3613812;2860;48;0;1
FR;3;2023-03-10;0;0;0;0;0;0;0;0;0;4416877;3441716;4463;2;3613812;2860;48;0;1
FR;3;2023-03-11;0;0;0;0;0;0;0;0;0;4416877;3441716;4463;2;3613812;2860;48;0;1
FR;3;2023-03-12;0;0;0;0;0;0;0;0;0;4416877;3441716;4463;2;3613812;2860;48;0;1
FR;3;2023-03-13;0;0;0;0;0;0;0;0;0;4416877;3441716;4463;2;3613812;2860;48;0;1
FR;3;2023-03-14;0;0;0;0;0;0;0;0;0;4416877;3441716;4463;2;3613812;2860;48;0;1
FR;3;2023-03-15;0;0;0;0;0;0;0;0;0;4416877;3441716;4463;2;3613812;2860;48;0;1
FR;3;2023-03-16;0;0;0;0;0;0;0;0;0;4416877;3441716;4463;2;3613812;2860;48;0;1
FR;3;2023-03-17;0;0;0;0;0;0;0;0;0;4416877;3441716;4463;2;3613812;2860;48;0;1
FR;3;2023-03-18;0;0;0;0;0;0;0;0;0;4416877;3441716;4463;2;3613812;2860;48;0;1
FR;3;2023-03-19;0;0;0;0;0;0;0;0;0;4416877;3441716;4463;2;3613812;2860;48;0;1
FR;3;2023-03-20;0;0;0;0;0;0;0;0;0;4416877;3441716;4463;2;3613812;2860;48;0;1
FR;3;2023-03-21;0;0;0;0;0;0;0;0;0;4416877;3441716;4463;2;3613812;2860;48;0;1
FR;3;2023-03-22;0;0;0;0;0;0;0;0;0;4416877;3441716;4463;2;3613812;2860;48;0;1
FR;3;2023-03-23;0;0;0;0;0;0;0;0;0;4416877;3441716;4463;2;3613812;2860;48;0;1
FR;3;2023-03-24;0;0;0;0;0;0;0;0;0;4416877;3441716;4463;2;3613812;2860;48;0;1
FR;3;2023-03-25;0;0;0;0;0;0;0;0;0;4416877;3441716;4463;2;3613812;2860;48;0;1
FR;3;2023-03-26;0;0;0;0;0;0;0;0;0;4416877;3441716;4463;2;3613812;2860;48;0;1
FR;3;2023-03-27;0;0;0;0;0;0;0;0;0;4416877;3441716;4463;2;3613812;2860;48;0;1
FR;3;2023-03-28;0;0;0;0;0;0;0;0;0;4416877;3441716;4463;2;3613812;2860;48;0;1
FR;3;2023-03-29;0;0;0;0;0;0;0;0;0;4416877;3441716;4463;2;3613812;2860;48;0;1
FR;3;2023-03-30;0;0;0;0;0;0;0;0;0;4416877;3441716;4463;2;3613812;2860;48;0;1
FR;3;2023-03-31;0;0;0;0;0;0;0;0;0;4416877;3441716;4463;2;3613812;2860;48;0;1
FR;3;2023-04-01;0;0;0;0;0;0;0;0;0;4416877;3441716;4463;2;3613812;2860;48;0;1
FR;3;2023-04-02;0;0;0;0;0;0;0;0;0;4416877;3441716;4463;2;3613812;2860;48;0;1
FR;3;2023-04-03;0;0;0;0;0;0;0;0;0;4416877;3441716;4463;2;3613812;2860;48;0;1
FR;3;2023-04-04;0;0;0;0;0;0;0;0;0;4416877;3441716;4463;2;3613812;2860;48;0;1
FR;3;2023-04-05;0;0;0;0;0;0;0;0;0;4416877;3441716;4463;2;3613812;2860;48;0;1
FR;3;2023-04-06;0;0;0;0;0;0;0;0;0;4416877;3441716;4463;2;3613812;2860;48;0;1
FR;3;2023-04-07;0;0;0;0;0;0;0;0;0;4416877;3441716;4463;2;3613812;2860;48;0;1
FR;3;2023-04-08;0;0;0;0;0;0;0;0;0;4416877;3441716;4463;2;3613812;2860;48;0;1
FR;3;2023-04-09;0;0;0;0;0;0;0;0;0;4416877;3441716;4463;2;3613812;2860;48;0;1
FR;3;2023-04-10;0;0;0;0;0;0;0;0;0;4416877;3441716;4463;2;3613812;2860;48;0;1
FR;3;2023-04-11;0;0;0;0;0;0;0;0;0;4416877;3441716;4463;2;3613812;2860;48;0;1
FR;3;2023-04-12;0;0;0;0;0;0;0;0;0;4416877;3441716;4463;2;3613812;2860;48;0;1
FR;3;2023-04-13;0;0;0;0;0;0;0;0;0;4416877;3441716;4463;2;3613812;2860;48;0;1
FR;3;2023-04-14;0;0;0;0;0;0;0;0;0;4416877;3441716;4463;2;3613812;2860;48;0;1
FR;3;2023-04-15;0;0;0;0;0;0;0;0;0;4416877;3441716;4463;2;3613812;2860;48;0;1
FR;3;2023-04-16;0;0;0;0;0;0;0;0;0;4416877;3441716;4463;2;3613812;2860;48;0;1
FR;3;2023-04-17;0;0;0;0;0;0;0;0;0;4416877;3441716;4463;2;3613812;2860;48;0;1
FR;3;2023-04-18;0;0;0;0;0;0;0;0;0;4416877;3441716;4463;2;3613812;2860;48;0;1
FR;3;2023-04-19;0;0;0;0;0;0;0;0;0;4416877;3441716;4463;2;3613812;2860;48;0;1
FR;3;2023-04-20;0;0;0;0;0;0;0;0;0;4416877;3441716;4463;2;3613812;2860;48;0;1
FR;3;2023-04-21;0;0;0;0;0;0;0;0;0;4416877;3441716;4463;2;3613812;2860;48;0;1
FR;3;2023-04-22;0;0;0;0;0;0;0;0;0;4416877;3441716;4463;2;3613812;2860;48;0;1
FR;3;2023-04-23;0;0;0;0;0;0;0;0;0;4416877;3441716;4463;2;3613812;2860;48;0;1
FR;3;2023-04-24;0;0;0;0;0;0;0;0;0;4416877;3441716;4463;2;3613812;2860;48;0;1
FR;3;2023-04-25;0;0;0;0;0;0;0;0;0;4416877;3441716;4463;2;3613812;2860;48;0;1
FR;3;2023-04-26;0;0;0;0;0;0;0;0;0;4416877;3441716;4463;2;3613812;2860;48;0;1
FR;3;2023-04-27;0;0;0;0;0;0;0;0;0;4416877;3441716;4463;2;3613812;2860;48;0;1
FR;3;2023-04-28;0;0;0;0;0;0;0;0;0;4416877;3441716;4463;2;3613812;2860;48;0;1
FR;3;2023-04-29;0;0;0;0;0;0;0;0;0;4416877;3441716;4463;2;3613812;2860;48;0;1
FR;3;2023-04-30;0;0;0;0;0;0;0;0;0;4416877;3441716;4463;2;3613812;2860;48;0;1
FR;3;2023-05-01;0;0;0;0;0;0;0;0;0;4416877;3441716;4463;2;3613812;2860;48;0;1
FR;3;2023-05-02;0;0;0;0;0;0;0;0;0;4416877;3441716;4463;2;3613812;2860;48;0;1
FR;3;2023-05-03;0;0;0;0;0;0;0;0;0;4416877;3441716;4463;2;3613812;2860;48;0;1
FR;3;2023-05-04;0;0;0;0;0;0;0;0;0;4416877;3441716;4463;2;3613812;2860;48;0;1
FR;3;2023-05-05;0;0;0;0;0;0;0;0;0;4416877;3441716;4463;2;3613812;2860;48;0;1
FR;3;2023-05-06;0;0;0;0;0;0;0;0;0;4416877;3441716;4463;2;3613812;2860;48;0;1
FR;3;2023-05-07;0;0;0;0;0;0;0;0;0;4416877;3441716;4463;2;3613812;2860;48;0;1
FR;3;2023-05-08;0;0;0;0;0;0;0;0;0;4416877;3441716;4463;2;3613812;2860;48;0;1
FR;3;2023-05-09;0;0;0;0;0;0;0;0;0;4416877;3441716;4463;2;3613812;2860;48;0;1
FR;3;2023-05-10;0;0;0;0;0;0;0;0;0;4416877;3441716;4463;2;3613812;2860;48;0;1
FR;3;2023-05-11;0;0;0;0;0;0;0;0;0;4416877;3441716;4463;2;3613812;2860;48;0;1
FR;3;2023-05-12;0;0;0;0;0;0;0;0;0;4416877;3441716;4463;2;3613812;2860;48;0;1
FR;3;2023-05-13;0;0;0;0;0;0;0;0;0;4416877;3441716;4463;2;3613812;2860;48;0;1
FR;3;2023-05-14;0;0;0;0;0;0;0;0;0;4416877;3441716;4463;2;3613812;2860;48;0;1
FR;3;2023-05-15;0;0;0;0;0;0;0;0;0;4416877;3441716;4463;2;3613812;2860;48;0;1
FR;3;2023-05-16;0;0;0;0;0;0;0;0;0;4416877;3441716;4463;2;3613812;2860;48;0;1
FR;3;2023-05-17;0;0;0;0;0;0;0;0;0;4416877;3441716;4463;2;3613812;2860;48;0;1
FR;3;2023-05-18;0;0;0;0;0;0;0;0;0;4416877;3441716;4463;2;3613812;2860;48;0;1
FR;3;2023-05-19;0;0;0;0;0;0;0;0;0;4416877;3441716;4463;2;3613812;2860;48;0;1
FR;3;2023-05-20;0;0;0;0;0;0;0;0;0;4416877;3441716;4463;2;3613812;2860;48;0;1
FR;3;2023-05-21;0;0;0;0;0;0;0;0;0;4416877;3441716;4463;2;3613812;2860;48;0;1
FR;3;2023-05-22;0;0;0;0;0;0;0;0;0;4416877;3441716;4463;2;3613812;2860;48;0;1
FR;3;2023-05-23;0;0;0;0;0;0;0;0;0;4416877;3441716;4463;2;3613812;2860;48;0;1
FR;3;2023-05-24;0;0;0;0;0;0;0;0;0;4416877;3441716;4463;2;3613812;2860;48;0;1
FR;3;2023-05-25;0;0;0;0;0;0;0;0;0;4416877;3441716;4463;2;3613812;2860;48;0;1
FR;3;2023-05-26;0;0;0;0;0;0;0;0;0;4416877;3441716;4463;2;3613812;2860;48;0;1
FR;3;2023-05-27;0;0;0;0;0;0;0;0;0;4416877;3441716;4463;2;3613812;2860;48;0;1
FR;3;2023-05-28;0;0;0;0;0;0;0;0;0;4416877;3441716;4463;2;3613812;2860;48;0;1
FR;3;2023-05-29;0;0;0;0;0;0;0;0;0;4416877;3441716;4463;2;3613812;2860;48;0;1
FR;3;2023-05-30;0;0;0;0;0;0;0;0;0;4416877;3441716;4463;2;3613812;2860;48;0;1
FR;3;2023-05-31;0;0;0;0;0;0;0;0;0;4416877;3441716;4463;2;3613812;2860;48;0;1
FR;3;2023-06-01;0;0;0;0;0;0;0;0;0;4416877;3441716;4463;2;3613812;2860;48;0;1
FR;3;2023-06-02;0;0;0;0;0;0;0;0;0;4416877;3441716;4463;2;3613812;2860;48;0;1
FR;3;2023-06-03;0;0;0;0;0;0;0;0;0;4416877;3441716;4463;2;3613812;2860;48;0;1
FR;3;2023-06-04;0;0;0;0;0;0;0;0;0;4416877;3441716;4463;2;3613812;2860;48;0;1
FR;3;2023-06-05;0;0;0;0;0;0;0;0;0;4416877;3441716;4463;2;3613812;2860;48;0;1
FR;3;2023-06-06;0;0;0;0;0;0;0;0;0;4416877;3441716;4463;2;3613812;2860;48;0;1
FR;3;2023-06-07;0;0;0;0;0;0;0;0;0;4416877;3441716;4463;2;3613812;2860;48;0;1
FR;3;2023-06-08;0;0;0;0;0;0;0;0;0;4416877;3441716;4463;2;3613812;2860;48;0;1
FR;3;2023-06-09;0;0;0;0;0;0;0;0;0;4416877;3441716;4463;2;3613812;2860;48;0;1
FR;3;2023-06-10;0;0;0;0;0;0;0;0;0;4416877;3441716;4463;2;3613812;2860;48;0;1
FR;3;2023-06-11;0;0;0;0;0;0;0;0;0;4416877;3441716;4463;2;3613812;2860;48;0;1
FR;3;2023-06-12;0;0;0;0;0;0;0;0;0;4416877;3441716;4463;2;3613812;2860;48;0;1
FR;3;2023-06-13;0;0;0;0;0;0;0;0;0;4416877;3441716;4463;2;3613812;2860;48;0;1
FR;3;2023-06-14;0;0;0;0;0;0;0;0;0;4416877;3441716;4463;2;3613812;2860;48;0;1
FR;3;2023-06-15;0;0;0;0;0;0;0;0;0;4416877;3441716;4463;2;3613812;2860;48;0;1
FR;3;2023-06-16;0;0;0;0;0;0;0;0;0;4416877;3441716;4463;2;3613812;2860;48;0;1
FR;3;2023-06-17;0;0;0;0;0;0;0;0;0;4416877;3441716;4463;2;3613812;2860;48;0;1
FR;3;2023-06-18;0;0;0;0;0;0;0;0;0;4416877;3441716;4463;2;3613812;2860;48;0;1
FR;3;2023-06-19;0;0;0;0;0;0;0;0;0;4416877;3441716;4463;2;3613812;2860;48;0;1
FR;3;2023-06-20;0;0;0;0;0;0;0;0;0;4416877;3441716;4463;2;3613812;2860;48;0;1
FR;3;2023-06-21;0;0;0;0;0;0;0;0;0;4416877;3441716;4463;2;3613812;2860;48;0;1
FR;3;2023-06-22;0;0;0;0;0;0;0;0;0;4416877;3441716;4463;2;3613812;2860;48;0;1
FR;3;2023-06-23;0;0;0;0;0;0;0;0;0;4416877;3441716;4463;2;3613812;2860;48;0;1
FR;3;2023-06-24;0;0;0;0;0;0;0;0;0;4416877;3441716;4463;2;3613812;2860;48;0;1
FR;3;2023-06-25;0;0;0;0;0;0;0;0;0;4416877;3441716;4463;2;3613812;2860;48;0;1
FR;3;2023-06-26;0;0;0;0;0;0;0;0;0;4416877;3441716;4463;2;3613812;2860;48;0;1
FR;3;2023-06-27;0;0;0;0;0;0;0;0;0;4416877;3441716;4463;2;3613812;2860;48;0;1
FR;3;2023-06-28;0;0;0;0;0;0;0;0;0;4416877;3441716;4463;2;3613812;2860;48;0;1
FR;3;2023-06-29;0;0;0;0;0;0;0;0;0;4416877;3441716;4463;2;3613812;2860;48;0;1
FR;3;2023-06-30;0;0;0;0;0;0;0;0;0;4416877;3441716;4463;2;3613812;2860;48;0;1
FR;3;2023-07-01;0;0;0;0;0;0;0;0;0;4416877;3441716;4463;2;3613812;2860;48;0;1
FR;3;2023-07-02;0;0;0;0;0;0;0;0;0;4416877;3441716;4463;2;3613812;2860;48;0;1
FR;3;2023-07-03;0;0;0;0;0;0;0;0;0;4416877;3441716;4463;2;3613812;2860;48;0;1
FR;3;2023-07-04;0;0;0;0;0;0;0;0;0;4416877;3441716;4463;2;3613812;2860;48;0;1
FR;3;2023-07-05;0;0;0;0;0;0;0;0;0;4416877;3441716;4463;2;3613812;2860;48;0;1
FR;3;2023-07-06;0;0;0;0;0;0;0;0;0;4416877;3441716;4463;2;3613812;2860;48;0;1
FR;3;2023-07-07;0;0;0;0;0;0;0;0;0;4416877;3441716;4463;2;3613812;2860;48;0;1
FR;3;2023-07-08;0;0;0;0;0;0;0;0;0;4416877;3441716;4463;2;3613812;2860;48;0;1
FR;3;2023-07-09;0;0;0;0;0;0;0;0;0;4416877;3441716;4463;2;3613812;2860;48;0;1
FR;3;2023-07-10;0;0;0;0;0;0;0;0;0;4416877;3441716;4463;2;3613812;2860;48;0;1
FR;4;2020-12-27;0;0;0;0;0;0;0;0;0;0;0;0;0;0;0;0;0;0
FR;4;2020-12-28;0;0;0;0;0;0;0;0;0;0;0;0;0;0;0;0;0;0
FR;4;2020-12-29;0;0;0;0;0;0;0;0;0;0;0;0;0;0;0;0;0;0
FR;4;2020-12-30;0;0;0;0;0;0;0;0;0;0;0;0;0;0;0;0;0;0
FR;4;2020-12-31;0;0;0;0;0;0;0;0;0;0;0;0;0;0;0;0;0;0
FR;4;2021-01-01;0;0;0;0;0;0;0;0;0;0;0;0;0;0;0;0;0;0
FR;4;2021-01-02;0;0;0;0;0;0;0;0;0;0;0;0;0;0;0;0;0;0
FR;4;2021-01-03;0;0;0;0;0;0;0;0;0;0;0;0;0;0;0;0;0;0
FR;4;2021-01-04;0;0;0;0;0;0;0;0;0;0;0;0;0;0;0;0;0;0
FR;4;2021-01-05;0;0;0;0;0;0;0;0;0;0;0;0;0;0;0;0;0;0
FR;4;2021-01-06;0;0;0;0;0;0;0;0;0;0;0;0;0;0;0;0;0;0
FR;4;2021-01-07;0;0;0;0;0;0;0;0;0;0;0;0;0;0;0;0;0;0
FR;4;2021-01-08;0;0;0;0;0;0;0;0;0;0;0;0;0;0;0;0;0;0
FR;4;2021-01-09;0;0;0;0;0;0;0;0;0;0;0;0;0;0;0;0;0;0
FR;4;2021-01-10;0;0;0;0;0;0;0;0;0;0;0;0;0;0;0;0;0;0
FR;4;2021-01-11;0;0;0;0;0;0;0;0;0;0;0;0;0;0;0;0;0;0
FR;4;2021-01-12;0;0;0;0;0;0;0;0;0;0;0;0;0;0;0;0;0;0
FR;4;2021-01-13;0;0;0;0;0;0;0;0;0;0;0;0;0;0;0;0;0;0
FR;4;2021-01-14;0;0;0;0;0;0;0;0;0;0;0;0;0;0;0;0;0;0
FR;4;2021-01-15;0;0;0;0;0;0;0;0;0;0;0;0;0;0;0;0;0;0
FR;4;2021-01-16;0;0;0;0;0;0;0;0;0;0;0;0;0;0;0;0;0;0
FR;4;2021-01-17;0;0;0;0;0;0;0;0;0;0;0;0;0;0;0;0;0;0
FR;4;2021-01-18;0;0;0;0;0;0;0;0;0;0;0;0;0;0;0;0;0;0
FR;4;2021-01-19;0;0;0;0;0;0;0;0;0;0;0;0;0;0;0;0;0;0
FR;4;2021-01-20;0;0;0;0;0;0;0;0;0;0;0;0;0;0;0;0;0;0
FR;4;2021-01-21;0;0;0;0;0;0;0;0;0;0;0;0;0;0;0;0;0;0
FR;4;2021-01-22;0;0;0;0;0;0;0;0;0;0;0;0;0;0;0;0;0;0
FR;4;2021-01-23;0;0;0;0;0;0;0;0;0;0;0;0;0;0;0;0;0;0
FR;4;2021-01-24;0;0;0;0;0;0;0;0;0;0;0;0;0;0;0;0;0;0
FR;4;2021-01-25;0;0;0;0;0;0;0;0;0;0;0;0;0;0;0;0;0;0
FR;4;2021-01-26;0;0;0;0;0;0;0;0;0;0;0;0;0;0;0;0;0;0
FR;4;2021-01-27;0;0;0;0;0;0;0;0;0;0;0;0;0;0;0;0;0;0
FR;4;2021-01-28;0;0;0;0;0;0;0;0;0;0;0;0;0;0;0;0;0;0
FR;4;2021-01-29;0;0;0;0;0;0;0;0;0;0;0;0;0;0;0;0;0;0
FR;4;2021-01-30;0;0;0;0;0;0;0;0;0;0;0;0;0;0;0;0;0;0
FR;4;2021-01-31;0;0;0;0;0;0;0;0;0;0;0;0;0;0;0;0;0;0
FR;4;2021-02-01;0;0;0;0;0;0;0;0;0;0;0;0;0;0;0;0;0;0
FR;4;2021-02-02;0;0;0;0;0;0;0;0;0;0;0;0;0;0;0;0;0;0
FR;4;2021-02-03;0;0;0;0;0;0;0;0;0;0;0;0;0;0;0;0;0;0
FR;4;2021-02-04;0;0;0;0;0;0;0;0;0;0;0;0;0;0;0;0;0;0
FR;4;2021-02-05;0;0;0;0;0;0;0;0;0;0;0;0;0;0;0;0;0;0
FR;4;2021-02-06;0;0;0;0;0;0;0;0;0;0;0;0;0;0;0;0;0;0
FR;4;2021-02-07;0;0;0;0;0;0;0;0;0;0;0;0;0;0;0;0;0;0
FR;4;2021-02-08;0;0;0;0;0;0;0;0;0;0;0;0;0;0;0;0;0;0
FR;4;2021-02-09;0;0;0;0;0;0;0;0;0;0;0;0;0;0;0;0;0;0
FR;4;2021-02-10;0;0;0;0;0;0;0;0;0;0;0;0;0;0;0;0;0;0
FR;4;2021-02-11;0;0;0;0;0;0;0;0;0;0;0;0;0;0;0;0;0;0
FR;4;2021-02-12;0;0;0;0;0;0;0;0;0;0;0;0;0;0;0;0;0;0
FR;4;2021-02-13;0;0;0;0;0;0;0;0;0;0;0;0;0;0;0;0;0;0
FR;4;2021-02-14;0;0;0;0;0;0;0;0;0;0;0;0;0;0;0;0;0;0
FR;4;2021-02-15;0;0;0;0;0;0;0;0;0;0;0;0;0;0;0;0;0;0
FR;4;2021-02-16;0;0;0;0;0;0;0;0;0;0;0;0;0;0;0;0;0;0
FR;4;2021-02-17;0;0;0;0;0;0;0;0;0;0;0;0;0;0;0;0;0;0
FR;4;2021-02-18;0;0;0;0;0;0;0;0;0;0;0;0;0;0;0;0;0;0
FR;4;2021-02-19;0;0;0;0;0;0;0;0;0;0;0;0;0;0;0;0;0;0
FR;4;2021-02-20;0;0;0;0;0;0;0;0;0;0;0;0;0;0;0;0;0;0
FR;4;2021-02-21;0;0;0;0;0;0;0;0;0;0;0;0;0;0;0;0;0;0
FR;4;2021-02-22;0;0;0;0;0;0;0;0;0;0;0;0;0;0;0;0;0;0
FR;4;2021-02-23;0;0;0;0;0;0;0;0;0;0;0;0;0;0;0;0;0;0
FR;4;2021-02-24;0;0;0;0;0;0;0;0;0;0;0;0;0;0;0;0;0;0
FR;4;2021-02-25;0;0;0;0;0;0;0;0;0;0;0;0;0;0;0;0;0;0
FR;4;2021-02-26;0;0;0;0;0;0;0;0;0;0;0;0;0;0;0;0;0;0
FR;4;2021-02-27;0;0;0;0;0;0;0;0;0;0;0;0;0;0;0;0;0;0
FR;4;2021-02-28;0;0;0;0;0;0;0;0;0;0;0;0;0;0;0;0;0;0
FR;4;2021-03-01;0;0;0;0;0;0;0;0;0;0;0;0;0;0;0;0;0;0
FR;4;2021-03-02;0;0;0;0;0;0;0;0;0;0;0;0;0;0;0;0;0;0
FR;4;2021-03-03;0;0;0;0;0;0;0;0;0;0;0;0;0;0;0;0;0;0
FR;4;2021-03-04;0;0;0;0;0;0;0;0;0;0;0;0;0;0;0;0;0;0
FR;4;2021-03-05;0;0;0;0;0;0;0;0;0;0;0;0;0;0;0;0;0;0
FR;4;2021-03-06;0;0;0;0;0;0;0;0;0;0;0;0;0;0;0;0;0;0
FR;4;2021-03-07;0;0;0;0;0;0;0;0;0;0;0;0;0;0;0;0;0;0
FR;4;2021-03-08;0;0;0;0;0;0;0;0;0;0;0;0;0;0;0;0;0;0
FR;4;2021-03-09;0;0;0;0;0;0;0;0;0;0;0;0;0;0;0;0;0;0
FR;4;2021-03-10;0;0;0;0;0;0;0;0;0;0;0;0;0;0;0;0;0;0
FR;4;2021-03-11;0;0;0;0;0;0;0;0;0;0;0;0;0;0;0;0;0;0
FR;4;2021-03-12;0;0;0;0;0;0;0;0;0;0;0;0;0;0;0;0;0;0
FR;4;2021-03-13;0;0;0;0;0;0;0;0;0;0;0;0;0;0;0;0;0;0
FR;4;2021-03-14;0;0;0;0;0;0;0;0;0;0;0;0;0;0;0;0;0;0
FR;4;2021-03-15;0;0;0;0;0;0;0;0;0;0;0;0;0;0;0;0;0;0
FR;4;2021-03-16;0;0;0;0;0;0;0;0;0;0;0;0;0;0;0;0;0;0
FR;4;2021-03-17;0;0;0;0;0;0;0;0;0;0;0;0;0;0;0;0;0;0
FR;4;2021-03-18;0;0;0;0;0;0;0;0;0;0;0;0;0;0;0;0;0;0
FR;4;2021-03-19;0;0;0;0;0;0;0;0;0;0;0;0;0;0;0;0;0;0
FR;4;2021-03-20;0;0;0;0;0;0;0;0;0;0;0;0;0;0;0;0;0;0
FR;4;2021-03-21;0;0;0;0;0;0;0;0;0;0;0;0;0;0;0;0;0;0
FR;4;2021-03-22;0;0;0;0;0;0;0;0;0;0;0;0;0;0;0;0;0;0
FR;4;2021-03-23;0;0;0;0;0;0;0;0;0;0;0;0;0;0;0;0;0;0
FR;4;2021-03-24;0;0;0;0;0;0;0;0;0;0;0;0;0;0;0;0;0;0
FR;4;2021-03-25;0;0;0;0;0;0;0;0;0;0;0;0;0;0;0;0;0;0
FR;4;2021-03-26;0;0;0;0;0;0;0;0;0;0;0;0;0;0;0;0;0;0
FR;4;2021-03-27;0;0;0;0;0;0;0;0;0;0;0;0;0;0;0;0;0;0
FR;4;2021-03-28;0;0;0;0;0;0;0;0;0;0;0;0;0;0;0;0;0;0
FR;4;2021-03-29;0;0;0;0;0;0;0;0;0;0;0;0;0;0;0;0;0;0
FR;4;2021-03-30;0;0;0;0;0;0;0;0;0;0;0;0;0;0;0;0;0;0
FR;4;2021-03-31;0;0;0;0;0;0;0;0;0;0;0;0;0;0;0;0;0;0
FR;4;2021-04-01;0;0;0;0;0;0;0;0;0;0;0;0;0;0;0;0;0;0
FR;4;2021-04-02;0;0;0;0;0;0;0;0;0;0;0;0;0;0;0;0;0;0
FR;4;2021-04-03;0;0;0;0;0;0;0;0;0;0;0;0;0;0;0;0;0;0
FR;4;2021-04-04;0;0;0;0;0;0;0;0;0;0;0;0;0;0;0;0;0;0
FR;4;2021-04-05;0;0;0;0;0;0;0;0;0;0;0;0;0;0;0;0;0;0
FR;4;2021-04-06;0;0;0;0;0;0;0;0;0;0;0;0;0;0;0;0;0;0
FR;4;2021-04-07;0;0;0;0;0;0;0;0;0;0;0;0;0;0;0;0;0;0
FR;4;2021-04-08;0;0;0;0;0;0;0;0;0;0;0;0;0;0;0;0;0;0
FR;4;2021-04-09;0;0;0;0;0;0;0;0;0;0;0;0;0;0;0;0;0;0
FR;4;2021-04-10;0;0;0;0;0;0;0;0;0;0;0;0;0;0;0;0;0;0
FR;4;2021-04-11;0;0;0;0;0;0;0;0;0;0;0;0;0;0;0;0;0;0
FR;4;2021-04-12;0;0;0;0;0;0;0;0;0;0;0;0;0;0;0;0;0;0
FR;4;2021-04-13;0;0;0;0;0;0;0;0;0;0;0;0;0;0;0;0;0;0
FR;4;2021-04-14;0;0;0;0;0;0;0;0;0;0;0;0;0;0;0;0;0;0
FR;4;2021-04-15;0;0;0;0;0;0;0;0;0;0;0;0;0;0;0;0;0;0
FR;4;2021-04-16;0;0;0;0;0;0;0;0;0;0;0;0;0;0;0;0;0;0
FR;4;2021-04-17;0;0;0;0;0;0;0;0;0;0;0;0;0;0;0;0;0;0
FR;4;2021-04-18;0;0;0;0;0;0;0;0;0;0;0;0;0;0;0;0;0;0
FR;4;2021-04-19;0;0;0;0;0;0;0;0;0;0;0;0;0;0;0;0;0;0
FR;4;2021-04-20;0;0;0;0;0;0;0;0;0;0;0;0;0;0;0;0;0;0
FR;4;2021-04-21;0;0;0;0;0;0;0;0;0;0;0;0;0;0;0;0;0;0
FR;4;2021-04-22;0;0;0;0;0;0;0;0;0;0;0;0;0;0;0;0;0;0
FR;4;2021-04-23;3658;0;0;0;3620;0;0;0;0;3658;0;0;0;3620;0;0;0;0
FR;4;2021-04-24;1570;1;0;0;1559;0;0;0;0;5228;1;0;0;5179;0;0;0;0
FR;4;2021-04-25;125;0;0;0;125;0;0;0;0;5353;1;0;0;5304;0;0;0;0
FR;4;2021-04-26;2872;1;0;0;2862;0;0;0;0;8225;2;0;0;8166;0;0;0;0
FR;4;2021-04-27;9520;3;0;0;9501;0;0;0;0;17745;5;0;0;17667;0;0;0;0
FR;4;2021-04-28;9910;6;0;0;9885;0;0;0;0;27655;11;0;0;27552;0;0;0;0
FR;4;2021-04-29;15995;8;0;0;15979;0;0;0;0;43650;19;0;0;43531;0;0;0;0
FR;4;2021-04-30;19234;10;0;0;19205;0;0;0;0;62884;29;0;0;62736;0;0;0;0
FR;4;2021-05-01;1994;6;0;0;1992;0;0;0;0;64878;35;0;0;64728;0;0;0;0
FR;4;2021-05-02;484;0;0;0;482;0;0;0;0;65362;35;0;0;65210;0;0;0;0
FR;4;2021-05-03;5066;2;0;0;5059;0;0;0;0;70428;37;0;0;70269;0;0;0;0
FR;4;2021-05-04;8411;11;0;0;8400;0;0;0;0;78839;48;0;0;78669;0;0;0;0
FR;4;2021-05-05;6193;7;0;0;6188;0;0;0;0;85032;55;0;0;84857;0;0;0;0
FR;4;2021-05-06;11388;11;0;0;11385;0;0;0;0;96420;66;0;0;96242;0;0;0;0
FR;4;2021-05-07;19126;9;0;0;19087;0;0;0;0;115546;75;0;0;115329;0;0;0;0
FR;4;2021-05-08;2376;7;0;0;2380;0;0;0;0;117922;82;0;0;117709;0;0;0;0
FR;4;2021-05-09;692;3;0;0;693;0;0;0;0;118614;85;0;0;118402;0;0;0;0
FR;4;2021-05-10;7246;5;1;0;7243;0;0;0;0;125860;90;1;0;125645;0;0;0;0
FR;4;2021-05-11;14325;13;0;0;14305;0;0;0;0;140185;103;1;0;139950;0;0;0;0
FR;4;2021-05-12;10176;15;0;0;10179;0;0;0;0;150361;118;1;0;150129;0;0;0;0
FR;4;2021-05-13;1584;4;0;0;1585;0;0;0;0;151945;122;1;0;151714;0;0;0;0
FR;4;2021-05-14;7768;7;0;0;7763;0;0;0;0;159713;129;1;0;159477;0;0;0;0
FR;4;2021-05-15;3721;8;1;0;3720;0;0;0;0;163434;137;2;0;163197;0;0;0;0
FR;4;2021-05-16;417;1;0;0;417;0;0;0;0;163851;138;2;0;163614;0;0;0;0
FR;4;2021-05-17;4485;8;0;0;4484;0;0;0;0;168336;146;2;0;168098;0;0;0;0
FR;4;2021-05-18;8769;10;0;0;8769;0;0;0;0;177105;156;2;0;176867;0;0;0;0
FR;4;2021-05-19;5699;7;0;0;5701;0;0;0;0;182804;163;2;0;182568;0;0;0;0
FR;4;2021-05-20;9487;8;0;0;9479;0;0;0;0;192291;171;2;0;192047;0;0;0;0
FR;4;2021-05-21;12816;30;0;0;12823;0;0;0;0;205107;201;2;0;204870;0;0;0;0
FR;4;2021-05-22;5063;15;0;0;5070;0;0;0;0;210170;216;2;0;209940;0;0;0;0
FR;4;2021-05-23;498;4;0;0;501;0;0;0;0;210668;220;2;0;210441;0;0;0;0
FR;4;2021-05-24;1062;7;0;0;1066;0;0;0;0;211730;227;2;0;211507;0;0;0;0
FR;4;2021-05-25;7637;16;0;0;7643;0;0;0;0;219367;243;2;0;219150;0;0;0;0
FR;4;2021-05-26;7731;16;0;0;7739;0;0;0;0;227098;259;2;0;226889;0;0;0;0
FR;4;2021-05-27;14340;35;0;0;14349;0;0;0;0;241438;294;2;0;241238;0;0;0;0
FR;4;2021-05-28;26593;82;1;0;26634;0;0;0;0;268031;376;3;0;267872;0;0;0;0
FR;4;2021-05-29;11385;19;0;0;11385;0;0;0;0;279416;395;3;0;279257;0;0;0;0
FR;4;2021-05-30;974;7;0;0;973;0;0;0;0;280390;402;3;0;280230;0;0;0;0
FR;4;2021-05-31;12701;21;0;0;12701;0;0;0;0;293091;423;3;0;292931;0;0;0;0
FR;4;2021-06-01;20283;48;1;0;20301;0;0;0;0;313374;471;4;0;313232;0;0;0;0
FR;4;2021-06-02;14526;33;0;0;14538;0;0;0;0;327900;504;4;0;327770;0;0;0;0
FR;4;2021-06-03;19436;24;1;0;19434;0;0;0;0;347336;528;5;0;347204;0;0;0;0
FR;4;2021-06-04;22520;48;0;0;22538;0;0;0;0;369856;576;5;0;369742;0;0;0;0
FR;4;2021-06-05;9718;32;0;0;9722;0;0;0;0;379574;608;5;0;379464;0;0;0;0
FR;4;2021-06-06;1041;2;0;0;1037;0;0;0;0;380615;610;5;0;380501;0;0;0;0
FR;4;2021-06-07;9230;19;0;0;9238;0;0;0;0;389845;629;5;0;389739;0;0;0;0
FR;4;2021-06-08;14613;32;0;0;14625;0;0;0;0;404458;661;5;0;404364;0;0;0;0
FR;4;2021-06-09;12218;25;0;0;12226;0;0;0;0;416676;686;5;0;416590;0;0;0;0
FR;4;2021-06-10;15408;30;0;0;15416;0;0;0;0;432084;716;5;0;432006;0;0;0;0
FR;4;2021-06-11;16990;57;0;0;17017;0;0;0;0;449074;773;5;0;449023;0;0;0;0
FR;4;2021-06-12;7454;27;0;0;7479;0;0;0;0;456528;800;5;0;456502;0;0;0;0
FR;4;2021-06-13;908;3;0;0;910;0;0;0;0;457436;803;5;0;457412;0;0;0;0
FR;4;2021-06-14;6652;27;0;0;6662;0;0;0;0;464088;830;5;0;464074;0;0;0;0
FR;4;2021-06-15;10896;39;0;0;10913;0;0;0;0;474984;869;5;0;474987;0;0;0;0
FR;4;2021-06-16;8909;17;0;0;8917;0;0;0;0;483893;886;5;0;483904;0;0;0;0
FR;4;2021-06-17;10903;36;0;0;10915;0;0;0;0;494796;922;5;0;494819;0;0;0;0
FR;4;2021-06-18;12427;45;0;0;12454;0;0;0;0;507223;967;5;0;507273;0;0;0;0
FR;4;2021-06-19;5568;25;0;0;5588;0;0;0;0;512791;992;5;0;512861;0;0;0;0
FR;4;2021-06-20;828;5;0;0;832;0;0;0;0;513619;997;5;0;513693;0;0;0;0
FR;4;2021-06-21;5107;21;0;0;5107;0;0;0;0;518726;1018;5;0;518800;0;0;0;0
FR;4;2021-06-22;7916;29;2;0;7934;0;0;0;0;526642;1047;7;0;526734;0;0;0;0
FR;4;2021-06-23;7106;43;2;0;7133;0;0;0;0;533748;1090;9;0;533867;0;0;0;0
FR;4;2021-06-24;8657;46;1;0;8689;0;0;0;0;542405;1136;10;0;542556;0;0;0;0
FR;4;2021-06-25;10179;41;2;0;10211;0;0;0;0;552584;1177;12;0;552767;0;0;0;0
FR;4;2021-06-26;4854;23;0;0;4871;0;0;0;0;557438;1200;12;0;557638;0;0;0;0
FR;4;2021-06-27;769;4;0;0;771;0;0;0;0;558207;1204;12;0;558409;0;0;0;0
FR;4;2021-06-28;4835;16;1;0;4844;0;0;0;0;563042;1220;13;0;563253;0;0;0;0
FR;4;2021-06-29;7111;28;2;0;7120;0;0;0;0;570153;1248;15;0;570373;0;0;0;0
FR;4;2021-06-30;6728;41;2;0;6756;0;0;0;0;576881;1289;17;0;577129;0;0;0;0
FR;4;2021-07-01;8213;42;0;0;8235;0;0;0;0;585094;1331;17;0;585364;0;0;0;0
FR;4;2021-07-02;9430;53;1;0;9470;0;0;0;0;594524;1384;18;0;594834;0;0;0;0
FR;4;2021-07-03;4848;20;0;0;4863;0;0;0;0;599372;1404;18;0;599697;0;0;0;0
FR;4;2021-07-04;690;5;0;0;692;0;0;0;0;600062;1409;18;0;600389;0;0;0;0
FR;4;2021-07-05;4776;19;2;0;4787;0;0;0;0;604838;1428;20;0;605176;0;0;0;0
FR;4;2021-07-06;7729;29;4;0;7742;0;0;0;0;612567;1457;24;0;612918;0;0;0;0
FR;4;2021-07-07;7088;34;2;0;7100;0;0;0;0;619655;1491;26;0;620018;0;0;0;0
FR;4;2021-07-08;9235;40;2;0;9258;0;0;0;0;628890;1531;28;0;629276;0;0;0;0
FR;4;2021-07-09;10282;34;1;0;10305;0;0;0;0;639172;1565;29;0;639581;0;0;0;0
FR;4;2021-07-10;4639;14;2;0;4646;0;0;0;0;643811;1579;31;0;644227;0;0;0;0
FR;4;2021-07-11;586;4;1;0;584;0;0;0;0;644397;1583;32;0;644811;0;0;0;0
FR;4;2021-07-12;5879;29;0;0;5901;0;0;0;0;650276;1612;32;0;650712;0;0;0;0
FR;4;2021-07-13;14231;29;0;0;14249;0;0;0;0;664507;1641;32;0;664961;0;0;0;0
FR;4;2021-07-14;2291;15;0;0;2291;0;0;0;0;666798;1656;32;0;667252;0;0;0;0
FR;4;2021-07-15;18239;37;0;0;18256;0;0;0;0;685037;1693;32;0;685508;0;0;0;0
FR;4;2021-07-16;22838;71;2;0;22888;0;0;0;0;707875;1764;34;0;708396;0;0;0;0
FR;4;2021-07-17;9741;20;0;0;9749;0;0;0;0;717616;1784;34;0;718145;0;0;0;0
FR;4;2021-07-18;1359;5;0;0;1362;0;0;0;0;718975;1789;34;0;719507;0;0;0;0
FR;4;2021-07-19;12991;30;1;0;13016;0;0;0;0;731966;1819;35;0;732523;0;0;0;0
FR;4;2021-07-20;17345;26;1;0;17361;0;0;0;0;749311;1845;36;0;749884;0;0;0;0
FR;4;2021-07-21;15623;33;0;0;15643;0;0;0;0;764934;1878;36;0;765527;0;0;0;0
FR;4;2021-07-22;18247;45;2;0;18271;0;0;0;0;783181;1923;38;0;783798;0;0;0;0
FR;4;2021-07-23;20420;57;7;0;20453;0;0;0;0;803601;1980;45;0;804251;0;0;0;0
FR;4;2021-07-24;9290;34;0;0;9305;0;0;0;0;812891;2014;45;0;813556;0;0;0;0
FR;4;2021-07-25;1356;11;0;0;1358;0;0;0;0;814247;2025;45;0;814914;0;0;0;0
FR;4;2021-07-26;11050;23;0;0;11057;0;0;0;0;825297;2048;45;0;825971;0;0;0;0
FR;4;2021-07-27;14688;35;3;0;14708;0;0;0;0;839985;2083;48;0;840679;0;0;0;0
FR;4;2021-07-28;12938;26;2;0;12955;0;0;0;0;852923;2109;50;0;853634;0;0;0;0
FR;4;2021-07-29;14098;54;4;0;14140;0;0;0;0;867021;2163;54;0;867774;0;0;0;0
FR;4;2021-07-30;15503;46;2;0;15533;0;0;0;0;882524;2209;56;0;883307;0;0;0;0
FR;4;2021-07-31;6845;14;2;0;6855;0;0;0;0;889369;2223;58;0;890162;0;0;0;0
FR;4;2021-08-01;906;1;0;0;901;0;0;0;0;890275;2224;58;0;891063;0;0;0;0
FR;4;2021-08-02;7918;31;0;0;7919;0;0;0;0;898193;2255;58;0;898982;0;0;0;0
FR;4;2021-08-03;10805;31;2;0;10801;0;0;0;0;908998;2286;60;0;909783;0;0;0;0
FR;4;2021-08-04;9749;29;0;0;9748;0;0;0;0;918747;2315;60;0;919531;0;0;0;0
FR;4;2021-08-05;9831;42;0;0;9837;0;0;0;0;928578;2357;60;0;929368;0;0;0;0
FR;4;2021-08-06;10201;30;3;0;10198;0;0;0;0;938779;2387;63;0;939566;0;0;0;0
FR;4;2021-08-07;5100;30;1;0;5116;0;0;0;0;943879;2417;64;0;944682;0;0;0;0
FR;4;2021-08-08;1225;13;0;0;1228;0;0;0;0;945104;2430;64;0;945910;0;0;0;0
FR;4;2021-08-09;6350;31;0;0;6343;0;0;0;0;951454;2461;64;0;952253;0;0;0;0
FR;4;2021-08-10;8753;18;0;0;8724;0;0;0;0;960207;2479;64;0;960977;0;0;0;0
FR;4;2021-08-11;7945;34;4;0;7934;0;0;0;0;968152;2513;68;0;968911;0;0;0;0
FR;4;2021-08-12;8585;31;1;0;8573;0;0;0;0;976737;2544;69;0;977484;0;0;0;0
FR;4;2021-08-13;7561;25;0;1;7548;0;0;0;0;984298;2569;69;1;985032;0;0;0;0
FR;4;2021-08-14;3793;20;0;0;3777;0;0;0;0;988091;2589;69;1;988809;0;0;0;0
FR;4;2021-08-15;771;5;0;0;773;0;0;0;0;988862;2594;69;1;989582;0;0;0;0
FR;4;2021-08-16;4010;17;0;0;4005;0;0;0;0;992872;2611;69;1;993587;0;0;0;0
FR;4;2021-08-17;5634;17;1;0;5624;0;0;0;0;998506;2628;70;1;999211;0;0;0;0
FR;4;2021-08-18;5172;37;0;0;5189;0;0;0;0;1003678;2665;70;1;1004400;0;0;0;0
FR;4;2021-08-19;5489;34;3;0;5503;0;0;0;0;1009167;2699;73;1;1009903;0;0;0;0
FR;4;2021-08-20;5225;25;1;0;5235;0;0;0;0;1014392;2724;74;1;1015138;0;0;0;0
FR;4;2021-08-21;2311;23;1;0;2328;0;0;0;0;1016703;2747;75;1;1017466;0;0;0;0
FR;4;2021-08-22;414;2;0;0;415;0;0;0;0;1017117;2749;75;1;1017881;0;0;0;0
FR;4;2021-08-23;2938;21;1;0;2946;0;0;0;0;1020055;2770;76;1;1020827;0;0;0;0
FR;4;2021-08-24;3758;16;0;0;3761;0;0;0;0;1023813;2786;76;1;1024588;0;0;0;0
FR;4;2021-08-25;3546;25;1;0;3562;0;0;0;0;1027359;2811;77;1;1028150;0;0;0;0
FR;4;2021-08-26;3716;21;2;0;3728;0;0;0;0;1031075;2832;79;1;1031878;0;0;0;0
FR;4;2021-08-27;3618;31;2;0;3636;0;0;0;0;1034693;2863;81;1;1035514;0;0;0;0
FR;4;2021-08-28;1732;10;1;0;1737;0;0;0;0;1036425;2873;82;1;1037251;0;0;0;0
FR;4;2021-08-29;385;7;1;0;389;0;0;0;0;1036810;2880;83;1;1037640;0;0;0;0
FR;4;2021-08-30;2010;25;0;0;2018;16;0;0;0;1038820;2905;83;1;1039658;16;0;0;0
FR;4;2021-08-31;2487;21;0;0;2494;14;0;0;0;1041307;2926;83;1;1042152;30;0;0;0
FR;4;2021-09-01;2085;38;1;0;2096;22;0;0;0;1043392;2964;84;1;1044248;52;0;0;0
FR;4;2021-09-02;2309;31;4;0;2322;18;0;0;0;1045701;2995;88;1;1046570;70;0;0;0
FR;4;2021-09-03;2366;44;5;0;2375;36;0;0;0;1048067;3039;93;1;1048945;106;0;0;0
FR;4;2021-09-04;1374;18;0;0;1381;9;0;0;0;1049441;3057;93;1;1050326;115;0;0;0
FR;4;2021-09-05;434;2;0;0;434;2;0;0;0;1049875;3059;93;1;1050760;117;0;0;0
FR;4;2021-09-06;1713;62;0;0;1750;24;0;0;0;1051588;3121;93;1;1052510;141;0;0;0
FR;4;2021-09-07;1681;18;0;0;1690;8;0;0;0;1053269;3139;93;1;1054200;149;0;0;0
FR;4;2021-09-08;1286;26;3;0;1291;19;0;0;0;1054555;3165;96;1;1055491;168;0;0;0
FR;4;2021-09-09;1394;23;2;0;1404;9;0;0;0;1055949;3188;98;1;1056895;177;0;0;0
FR;4;2021-09-10;1522;31;2;0;1526;23;1;0;0;1057471;3219;100;1;1058421;200;1;0;0
FR;4;2021-09-11;746;11;0;0;749;3;0;0;0;1058217;3230;100;1;1059170;203;1;0;0
FR;4;2021-09-12;169;5;0;0;170;4;0;0;0;1058386;3235;100;1;1059340;207;1;0;0
FR;4;2021-09-13;1325;22;1;0;1328;16;0;0;0;1059711;3257;101;1;1060668;223;1;0;0
FR;4;2021-09-14;1507;9;2;0;1509;7;0;0;0;1061218;3266;103;1;1062177;230;1;0;0
FR;4;2021-09-15;1095;28;1;0;1098;25;0;0;0;1062313;3294;104;1;1063275;255;1;0;0
FR;4;2021-09-16;1108;22;2;0;1112;15;0;0;0;1063421;3316;106;1;1064387;270;1;0;0
FR;4;2021-09-17;898;21;1;0;905;12;0;0;0;1064319;3337;107;1;1065292;282;1;0;0
FR;4;2021-09-18;464;7;1;0;465;6;0;0;0;1064783;3344;108;1;1065757;288;1;0;0
FR;4;2021-09-19;182;3;0;0;183;2;0;0;0;1064965;3347;108;1;1065940;290;1;0;0
FR;4;2021-09-20;452;19;0;0;458;13;0;0;0;1065417;3366;108;1;1066398;303;1;0;0
FR;4;2021-09-21;434;11;0;0;436;7;0;0;0;1065851;3377;108;1;1066834;310;1;0;0
FR;4;2021-09-22;377;19;4;0;384;15;0;0;0;1066228;3396;112;1;1067218;325;1;0;0
FR;4;2021-09-23;488;15;1;0;489;14;0;0;0;1066716;3411;113;1;1067707;339;1;0;0
FR;4;2021-09-24;416;13;2;0;420;9;0;0;0;1067132;3424;115;1;1068127;348;1;0;0
FR;4;2021-09-25;281;10;1;0;282;5;0;0;0;1067413;3434;116;1;1068409;353;1;0;0
FR;4;2021-09-26;75;2;0;0;76;1;0;0;0;1067488;3436;116;1;1068485;354;1;0;0
FR;4;2021-09-27;270;10;1;0;271;8;0;0;0;1067758;3446;117;1;1068756;362;1;0;0
FR;4;2021-09-28;319;8;0;0;319;8;0;0;0;1068077;3454;117;1;1069075;370;1;0;0
FR;4;2021-09-29;378;19;1;0;380;13;0;0;0;1068455;3473;118;1;1069455;383;1;0;0
FR;4;2021-09-30;367;41;0;0;381;22;0;0;0;1068822;3514;118;1;1069836;405;1;0;0
FR;4;2021-10-01;411;56;0;0;413;50;0;0;0;1069233;3570;118;1;1070249;455;1;0;0
FR;4;2021-10-02;196;23;1;0;198;14;0;0;0;1069429;3593;119;1;1070447;469;1;0;0
FR;4;2021-10-03;86;1;0;0;87;0;0;0;0;1069515;3594;119;1;1070534;469;1;0;0
FR;4;2021-10-04;363;20;1;0;367;16;0;0;0;1069878;3614;120;1;1070901;485;1;0;0
FR;4;2021-10-05;286;19;2;0;288;15;0;0;0;1070164;3633;122;1;1071189;500;1;0;0
FR;4;2021-10-06;249;23;1;0;254;18;0;0;0;1070413;3656;123;1;1071443;518;1;0;0
FR;4;2021-10-07;268;25;2;0;273;13;0;0;0;1070681;3681;125;1;1071716;531;1;0;0
FR;4;2021-10-08;357;24;2;0;360;20;0;0;0;1071038;3705;127;1;1072076;551;1;0;0
FR;4;2021-10-09;194;6;6;0;195;7;0;0;0;1071232;3711;133;1;1072271;558;1;0;0
FR;4;2021-10-10;97;3;2;0;99;3;0;0;0;1071329;3714;135;1;1072370;561;1;0;0
FR;4;2021-10-11;252;15;1;0;253;14;0;0;0;1071581;3729;136;1;1072623;575;1;0;0
FR;4;2021-10-12;211;14;0;0;211;13;0;0;0;1071792;3743;136;1;1072834;588;1;0;0
FR;4;2021-10-13;221;28;1;0;224;25;0;0;0;1072013;3771;137;1;1073058;613;1;0;0
FR;4;2021-10-14;316;21;4;0;320;15;0;0;0;1072329;3792;141;1;1073378;628;1;0;0
FR;4;2021-10-15;324;24;5;0;325;25;0;0;0;1072653;3816;146;1;1073703;653;1;0;0
FR;4;2021-10-16;167;6;2;0;167;6;0;0;0;1072820;3822;148;1;1073870;659;1;0;0
FR;4;2021-10-17;70;2;0;0;71;1;0;0;0;1072890;3824;148;1;1073941;660;1;0;0
FR;4;2021-10-18;282;16;1;0;284;13;0;0;0;1073172;3840;149;1;1074225;673;1;0;0
FR;4;2021-10-19;215;15;2;0;215;16;0;0;0;1073387;3855;151;1;1074440;689;1;0;0
FR;4;2021-10-20;232;27;4;0;235;15;0;0;0;1073619;3882;155;1;1074675;704;1;0;0
FR;4;2021-10-21;244;18;0;0;246;14;0;0;0;1073863;3900;155;1;1074921;718;1;0;0
FR;4;2021-10-22;217;25;2;0;219;20;1;0;0;1074080;3925;157;1;1075140;738;2;0;0
FR;4;2021-10-23;117;16;1;0;118;15;0;0;0;1074197;3941;158;1;1075258;753;2;0;0
FR;4;2021-10-24;39;4;0;0;39;1;0;0;0;1074236;3945;158;1;1075297;754;2;0;0
FR;4;2021-10-25;218;7;2;0;218;9;0;0;0;1074454;3952;160;1;1075515;763;2;0;0
FR;4;2021-10-26;200;14;0;0;202;12;0;0;0;1074654;3966;160;1;1075717;775;2;0;0
FR;4;2021-10-27;196;12;4;0;196;12;2;0;0;1074850;3978;164;1;1075913;787;4;0;0
FR;4;2021-10-28;187;18;5;0;187;22;0;0;0;1075037;3996;169;1;1076100;809;4;0;0
FR;4;2021-10-29;227;18;2;0;228;16;0;0;0;1075264;4014;171;1;1076328;825;4;0;0
FR;4;2021-10-30;104;2;1;0;105;2;0;0;0;1075368;4016;172;1;1076433;827;4;0;0
FR;4;2021-10-31;59;3;2;0;60;3;0;0;0;1075427;4019;174;1;1076493;830;4;0;0
FR;4;2021-11-01;76;27;4;0;77;24;3;0;0;1075503;4046;178;1;1076570;854;7;0;0
FR;4;2021-11-02;164;21;2;0;165;21;0;0;0;1075667;4067;180;1;1076735;875;7;0;0
FR;4;2021-11-03;133;21;8;1;134;19;6;0;0;1075800;4088;188;2;1076869;894;13;0;0
FR;4;2021-11-04;187;15;1;0;188;12;1;0;0;1075987;4103;189;2;1077057;906;14;0;0
FR;4;2021-11-05;132;17;1;0;133;16;0;0;0;1076119;4120;190;2;1077190;922;14;0;0
FR;4;2021-11-06;82;6;1;0;82;6;0;0;0;1076201;4126;191;2;1077272;928;14;0;0
FR;4;2021-11-07;83;2;2;0;83;4;0;0;0;1076284;4128;193;2;1077355;932;14;0;0
FR;4;2021-11-08;162;20;1;0;163;20;0;0;0;1076446;4148;194;2;1077518;952;14;0;0
FR;4;2021-11-09;159;14;3;0;159;16;0;0;0;1076605;4162;197;2;1077677;968;14;0;0
FR;4;2021-11-10;121;30;7;0;121;33;2;0;0;1076726;4192;204;2;1077798;1001;16;0;0
FR;4;2021-11-11;100;10;1;0;100;11;0;0;0;1076826;4202;205;2;1077898;1012;16;0;0
FR;4;2021-11-12;107;19;2;0;108;18;1;0;0;1076933;4221;207;2;1078006;1030;17;0;0
FR;4;2021-11-13;75;15;2;0;76;14;0;0;0;1077008;4236;209;2;1078082;1044;17;0;0
FR;4;2021-11-14;55;5;4;0;56;8;0;0;0;1077063;4241;213;2;1078138;1052;17;0;0
FR;4;2021-11-15;99;26;2;0;101;24;2;0;0;1077162;4267;215;2;1078239;1076;19;0;0
FR;4;2021-11-16;112;14;3;0;112;17;0;0;0;1077274;4281;218;2;1078351;1093;19;0;0
FR;4;2021-11-17;122;30;4;0;122;30;1;0;0;1077396;4311;222;2;1078473;1123;20;0;0
FR;4;2021-11-18;103;34;14;0;105;43;1;0;0;1077499;4345;236;2;1078578;1166;21;0;0
FR;4;2021-11-19;89;21;3;0;89;22;1;0;0;1077588;4366;239;2;1078667;1188;22;0;0
FR;4;2021-11-20;78;8;1;0;78;8;0;0;0;1077666;4374;240;2;1078745;1196;22;0;0
FR;4;2021-11-21;70;7;2;0;70;9;0;0;0;1077736;4381;242;2;1078815;1205;22;0;0
FR;4;2021-11-22;109;28;9;0;110;33;2;0;0;1077845;4409;251;2;1078925;1238;24;0;0
FR;4;2021-11-23;78;31;6;0;79;29;2;0;0;1077923;4440;257;2;1079004;1267;26;0;0
FR;4;2021-11-24;93;23;12;0;95;25;4;0;0;1078016;4463;269;2;1079099;1292;30;0;0
FR;4;2021-11-25;96;28;19;0;97;35;5;0;0;1078112;4491;288;2;1079196;1327;35;0;0
FR;4;2021-11-26;86;43;12;0;90;45;3;0;0;1078198;4534;300;2;1079286;1372;38;0;0
FR;4;2021-11-27;42;22;15;0;42;25;10;0;0;1078240;4556;315;2;1079328;1397;48;0;0
FR;4;2021-11-28;53;8;0;0;54;7;0;0;0;1078293;4564;315;2;1079382;1404;48;0;0
FR;4;2021-11-29;90;31;16;0;90;40;2;0;0;1078383;4595;331;2;1079472;1444;50;0;0
FR;4;2021-11-30;77;37;13;0;77;42;2;0;0;1078460;4632;344;2;1079549;1486;52;0;0
FR;4;2021-12-01;88;60;19;0;88;67;11;0;0;1078548;4692;363;2;1079637;1553;63;0;0
FR;4;2021-12-02;114;48;21;0;118;56;3;0;0;1078662;4740;384;2;1079755;1609;66;0;0
FR;4;2021-12-03;106;36;15;0;106;44;4;0;0;1078768;4776;399;2;1079861;1653;70;0;0
FR;4;2021-12-04;73;31;18;0;75;44;1;0;0;1078841;4807;417;2;1079936;1697;71;0;0
FR;4;2021-12-05;64;7;1;0;65;7;0;0;0;1078905;4814;418;2;1080001;1704;71;0;0
FR;4;2021-12-06;112;46;20;0;112;60;3;0;0;1079017;4860;438;2;1080113;1764;74;0;0
FR;4;2021-12-07;85;37;9;0;88;36;3;0;0;1079102;4897;447;2;1080201;1800;77;0;0
FR;4;2021-12-08;74;31;17;0;76;38;7;0;0;1079176;4928;464;2;1080277;1838;84;0;0
FR;4;2021-12-09;65;32;10;1;65;39;3;0;0;1079241;4960;474;3;1080342;1877;87;0;0
FR;4;2021-12-10;64;64;20;0;65;68;10;0;0;1079305;5024;494;3;1080407;1945;97;0;0
FR;4;2021-12-11;30;34;7;0;30;34;3;0;0;1079335;5058;501;3;1080437;1979;100;0;0
FR;4;2021-12-12;30;12;3;0;30;15;0;0;0;1079365;5070;504;3;1080467;1994;100;0;0
FR;4;2021-12-13;79;40;14;0;81;49;2;0;0;1079444;5110;518;3;1080548;2043;102;0;0
FR;4;2021-12-14;61;43;18;0;62;55;2;0;0;1079505;5153;536;3;1080610;2098;104;0;0
FR;4;2021-12-15;68;65;29;0;68;86;6;0;0;1079573;5218;565;3;1080678;2184;110;0;0
FR;4;2021-12-16;35;45;18;0;36;58;3;0;0;1079608;5263;583;3;1080714;2242;113;0;0
FR;4;2021-12-17;39;55;11;0;39;59;6;0;0;1079647;5318;594;3;1080753;2301;119;0;0
FR;4;2021-12-18;49;31;3;0;50;33;0;0;0;1079696;5349;597;3;1080803;2334;119;0;0
FR;4;2021-12-19;17;4;1;0;18;4;0;0;0;1079713;5353;598;3;1080821;2338;119;0;0
FR;4;2021-12-20;45;38;10;0;46;41;6;0;0;1079758;5391;608;3;1080867;2379;125;0;0
FR;4;2021-12-21;32;32;17;0;34;39;5;0;0;1079790;5423;625;3;1080901;2418;130;0;0
FR;4;2021-12-22;37;39;10;0;38;39;7;0;0;1079827;5462;635;3;1080939;2457;137;0;0
FR;4;2021-12-23;41;45;8;0;41;49;2;0;0;1079868;5507;643;3;1080980;2506;139;0;0
FR;4;2021-12-24;25;28;10;0;27;31;4;0;0;1079893;5535;653;3;1081007;2537;143;0;0
FR;4;2021-12-25;8;3;3;0;8;4;2;0;0;1079901;5538;656;3;1081015;2541;145;0;0
FR;4;2021-12-26;5;3;1;0;6;2;0;0;0;1079906;5541;657;3;1081021;2543;145;0;0
FR;4;2021-12-27;31;41;9;0;32;43;4;0;0;1079937;5582;666;3;1081053;2586;149;0;0
FR;4;2021-12-28;28;28;7;0;30;29;4;0;0;1079965;5610;673;3;1081083;2615;153;0;0
FR;4;2021-12-29;56;25;11;0;57;30;5;0;0;1080021;5635;684;3;1081140;2645;158;0;0
FR;4;2021-12-30;48;19;12;0;51;22;5;0;0;1080069;5654;696;3;1081191;2667;163;0;0
FR;4;2021-12-31;20;7;8;0;21;12;2;0;0;1080089;5661;704;3;1081212;2679;165;0;0
FR;4;2022-01-01;7;4;5;0;7;7;1;0;0;1080096;5665;709;3;1081219;2686;166;0;0
FR;4;2022-01-02;43;5;16;0;43;20;1;0;0;1080139;5670;725;3;1081262;2706;167;0;0
FR;4;2022-01-03;45;55;25;1;47;65;10;0;0;1080184;5725;750;4;1081309;2771;177;0;0
FR;4;2022-01-04;44;28;16;0;45;33;8;0;0;1080228;5753;766;4;1081354;2804;185;0;0
FR;4;2022-01-05;52;24;19;0;58;27;9;0;0;1080280;5777;785;4;1081412;2831;194;0;0
FR;4;2022-01-06;52;24;24;0;52;40;8;0;0;1080332;5801;809;4;1081464;2871;202;0;0
FR;4;2022-01-07;31;20;16;0;33;21;12;0;0;1080363;5821;825;4;1081497;2892;214;0;0
FR;4;2022-01-08;13;6;10;0;14;12;3;0;0;1080376;5827;835;4;1081511;2904;217;0;0
FR;4;2022-01-09;20;2;3;0;21;4;0;0;0;1080396;5829;838;4;1081532;2908;217;0;0
FR;4;2022-01-10;53;22;19;0;53;36;4;0;0;1080449;5851;857;4;1081585;2944;221;0;0
FR;4;2022-01-11;30;31;12;0;34;35;1;0;0;1080479;5882;869;4;1081619;2979;222;0;0
FR;4;2022-01-12;35;21;13;0;37;23;9;0;0;1080514;5903;882;4;1081656;3002;231;0;0
FR;4;2022-01-13;55;20;27;0;56;38;8;0;0;1080569;5923;909;4;1081712;3040;239;0;0
FR;4;2022-01-14;25;32;13;0;26;35;7;0;0;1080594;5955;922;4;1081738;3075;246;0;0
FR;4;2022-01-15;15;6;8;0;16;12;1;0;0;1080609;5961;930;4;1081754;3087;247;0;0
FR;4;2022-01-16;13;9;14;0;13;22;1;0;0;1080622;5970;944;4;1081767;3109;248;0;0
FR;4;2022-01-17;27;20;15;0;27;29;5;0;0;1080649;5990;959;4;1081794;3138;253;0;0
FR;4;2022-01-18;17;14;10;0;17;21;3;0;0;1080666;6004;969;4;1081811;3159;256;0;0
FR;4;2022-01-19;33;23;13;0;33;34;1;0;0;1080699;6027;982;4;1081844;3193;257;0;0
FR;4;2022-01-20;34;34;13;0;36;39;5;0;0;1080733;6061;995;4;1081880;3232;262;0;0
FR;4;2022-01-21;13;12;20;1;13;17;15;0;1;1080746;6073;1015;5;1081893;3249;277;0;1
FR;4;2022-01-22;30;13;3;0;30;14;2;0;0;1080776;6086;1018;5;1081923;3263;279;0;1
FR;4;2022-01-23;8;2;7;0;8;9;0;0;0;1080784;6088;1025;5;1081931;3272;279;0;1
FR;4;2022-01-24;14;21;9;0;15;28;1;0;0;1080798;6109;1034;5;1081946;3300;280;0;1
FR;4;2022-01-25;22;32;10;1;23;38;3;0;0;1080820;6141;1044;6;1081969;3338;283;0;1
FR;4;2022-01-26;20;17;9;1;21;21;4;0;0;1080840;6158;1053;7;1081990;3359;287;0;1
FR;4;2022-01-27;22;19;8;0;23;25;1;0;0;1080862;6177;1061;7;1082013;3384;288;0;1
FR;4;2022-01-28;14;23;8;0;15;26;4;0;0;1080876;6200;1069;7;1082028;3410;292;0;1
FR;4;2022-01-29;17;6;5;0;17;10;0;0;0;1080893;6206;1074;7;1082045;3420;292;0;1
FR;4;2022-01-30;19;3;2;0;19;5;0;0;0;1080912;6209;1076;7;1082064;3425;292;0;1
FR;4;2022-01-31;22;28;8;0;22;32;2;0;0;1080934;6237;1084;7;1082086;3457;294;0;1
FR;4;2022-02-01;13;24;13;0;15;25;9;0;0;1080947;6261;1097;7;1082101;3482;303;0;1
FR;4;2022-02-02;19;12;14;2;20;20;7;0;0;1080966;6273;1111;9;1082121;3502;310;0;1
FR;4;2022-02-03;16;24;11;0;18;29;4;0;0;1080982;6297;1122;9;1082139;3531;314;0;1
FR;4;2022-02-04;7;5;7;0;7;9;3;0;0;1080989;6302;1129;9;1082146;3540;317;0;1
FR;4;2022-02-05;7;14;1;0;8;13;1;0;0;1080996;6316;1130;9;1082154;3553;318;0;1
FR;4;2022-02-06;8;4;4;0;8;7;1;0;0;1081004;6320;1134;9;1082162;3560;319;0;1
FR;4;2022-02-07;15;20;8;0;17;20;6;0;0;1081019;6340;1142;9;1082179;3580;325;0;1
FR;4;2022-02-08;20;21;13;1;22;22;10;0;0;1081039;6361;1155;10;1082201;3602;335;0;1
FR;4;2022-02-09;18;12;9;0;19;17;2;0;0;1081057;6373;1164;10;1082220;3619;337;0;1
FR;4;2022-02-10;23;23;10;0;24;25;7;0;0;1081080;6396;1174;10;1082244;3644;344;0;1
FR;4;2022-02-11;18;15;8;0;18;20;3;0;0;1081098;6411;1182;10;1082262;3664;347;0;1
FR;4;2022-02-12;24;6;3;0;26;7;0;0;0;1081122;6417;1185;10;1082288;3671;347;0;1
FR;4;2022-02-13;7;3;3;0;7;6;0;0;0;1081129;6420;1188;10;1082295;3677;347;0;1
FR;4;2022-02-14;22;10;10;0;22;16;4;0;0;1081151;6430;1198;10;1082317;3693;351;0;1
FR;4;2022-02-15;18;7;2;0;18;8;0;0;0;1081169;6437;1200;10;1082335;3701;351;0;1
FR;4;2022-02-16;17;11;11;0;17;18;3;0;0;1081186;6448;1211;10;1082352;3719;354;0;1
FR;4;2022-02-17;11;4;5;0;11;7;2;0;0;1081197;6452;1216;10;1082363;3726;356;0;1
FR;4;2022-02-18;16;15;8;0;16;21;2;0;0;1081213;6467;1224;10;1082379;3747;358;0;1
FR;4;2022-02-19;16;4;2;0;17;5;0;0;0;1081229;6471;1226;10;1082396;3752;358;0;1
FR;4;2022-02-20;9;4;0;0;10;3;0;0;0;1081238;6475;1226;10;1082406;3755;358;0;1
FR;4;2022-02-21;24;5;4;0;24;7;2;0;0;1081262;6480;1230;10;1082430;3762;360;0;1
FR;4;2022-02-22;9;5;10;0;10;10;4;0;0;1081271;6485;1240;10;1082440;3772;364;0;1
FR;4;2022-02-23;17;6;10;0;17;10;5;0;0;1081288;6491;1250;10;1082457;3782;369;0;1
FR;4;2022-02-24;11;5;4;0;11;7;2;0;0;1081299;6496;1254;10;1082468;3789;371;0;1
FR;4;2022-02-25;17;5;7;0;17;6;6;0;0;1081316;6501;1261;10;1082485;3795;377;0;1
FR;4;2022-02-26;27;3;1;0;27;4;0;0;0;1081343;6504;1262;10;1082512;3799;377;0;1
FR;4;2022-02-27;9;0;1;0;9;1;0;0;0;1081352;6504;1263;10;1082521;3800;377;0;1
FR;4;2022-02-28;18;3;2;0;19;3;1;0;0;1081370;6507;1265;10;1082540;3803;378;0;1
FR;4;2022-03-01;8;4;7;0;8;5;5;0;0;1081378;6511;1272;10;1082548;3808;383;0;1
FR;4;2022-03-02;16;3;6;0;17;7;1;0;0;1081394;6514;1278;10;1082565;3815;384;0;1
FR;4;2022-03-03;19;5;3;0;19;6;1;0;0;1081413;6519;1281;10;1082584;3821;385;0;1
FR;4;2022-03-04;7;8;2;1;7;6;3;0;0;1081420;6527;1283;11;1082591;3827;388;0;1
FR;4;2022-03-05;9;2;0;0;9;2;0;0;0;1081429;6529;1283;11;1082600;3829;388;0;1
FR;4;2022-03-06;4;0;1;0;4;1;0;0;0;1081433;6529;1284;11;1082604;3830;388;0;1
FR;4;2022-03-07;11;6;2;0;11;5;2;0;0;1081444;6535;1286;11;1082615;3835;390;0;1
FR;4;2022-03-08;15;3;0;0;15;3;0;0;0;1081459;6538;1286;11;1082630;3838;390;0;1
FR;4;2022-03-09;9;7;2;0;11;7;0;0;0;1081468;6545;1288;11;1082641;3845;390;0;1
FR;4;2022-03-10;6;1;6;0;6;3;4;0;0;1081474;6546;1294;11;1082647;3848;394;0;1
FR;4;2022-03-11;10;4;5;0;12;2;5;0;0;1081484;6550;1299;11;1082659;3850;399;0;1
FR;4;2022-03-12;10;2;0;0;11;0;0;0;0;1081494;6552;1299;11;1082670;3850;399;0;1
FR;4;2022-03-13;6;2;1;0;7;2;0;0;0;1081500;6554;1300;11;1082677;3852;399;0;1
FR;4;2022-03-14;4;3;1;0;5;3;0;0;0;1081504;6557;1301;11;1082682;3855;399;0;1
FR;4;2022-03-15;8;8;3;0;10;7;2;0;0;1081512;6565;1304;11;1082692;3862;401;0;1
FR;4;2022-03-16;7;3;4;0;7;4;3;0;0;1081519;6568;1308;11;1082699;3866;404;0;1
FR;4;2022-03-17;4;4;1;0;4;5;0;0;0;1081523;6572;1309;11;1082703;3871;404;0;1
FR;4;2022-03-18;9;3;0;0;9;3;0;0;0;1081532;6575;1309;11;1082712;3874;404;0;1
FR;4;2022-03-19;1;1;1;0;1;2;0;0;0;1081533;6576;1310;11;1082713;3876;404;0;1
FR;4;2022-03-20;3;1;2;0;3;2;1;0;0;1081536;6577;1312;11;1082716;3878;405;0;1
FR;4;2022-03-21;6;4;1;0;6;5;0;0;0;1081542;6581;1313;11;1082722;3883;405;0;1
FR;4;2022-03-22;4;2;2;0;4;3;1;0;0;1081546;6583;1315;11;1082726;3886;406;0;1
FR;4;2022-03-23;6;4;5;0;6;8;1;0;0;1081552;6587;1320;11;1082732;3894;407;0;1
FR;4;2022-03-24;2;5;3;1;2;7;2;0;0;1081554;6592;1323;12;1082734;3901;409;0;1
FR;4;2022-03-25;4;1;2;0;4;1;2;0;0;1081558;6593;1325;12;1082738;3902;411;0;1
FR;4;2022-03-26;5;5;0;0;5;5;0;0;0;1081563;6598;1325;12;1082743;3907;411;0;1
FR;4;2022-03-27;1;0;3;0;1;2;1;0;0;1081564;6598;1328;12;1082744;3909;412;0;1
FR;4;2022-03-28;6;1;3;0;7;3;0;0;0;1081570;6599;1331;12;1082751;3912;412;0;1
FR;4;2022-03-29;9;0;4;1;9;0;2;0;0;1081579;6599;1335;13;1082760;3912;414;0;1
FR;4;2022-03-30;3;4;0;0;3;4;0;0;0;1081582;6603;1335;13;1082763;3916;414;0;1
FR;4;2022-03-31;5;3;2;1;5;4;1;0;0;1081587;6606;1337;14;1082768;3920;415;0;1
FR;4;2022-04-01;15;3;5;0;15;6;2;0;0;1081602;6609;1342;14;1082783;3926;417;0;1
FR;4;2022-04-02;4;4;0;0;5;3;0;0;0;1081606;6613;1342;14;1082788;3929;417;0;1
FR;4;2022-04-03;0;1;0;0;0;1;0;0;0;1081606;6614;1342;14;1082788;3930;417;0;1
FR;4;2022-04-04;4;4;4;0;5;5;2;0;0;1081610;6618;1346;14;1082793;3935;419;0;1
FR;4;2022-04-05;4;3;3;1;5;3;3;0;0;1081614;6621;1349;15;1082798;3938;422;0;1
FR;4;2022-04-06;6;1;0;0;6;1;0;0;0;1081620;6622;1349;15;1082804;3939;422;0;1
FR;4;2022-04-07;3;2;3;2;3;5;0;0;0;1081623;6624;1352;17;1082807;3944;422;0;1
FR;4;2022-04-08;4;2;1;0;4;2;1;0;0;1081627;6626;1353;17;1082811;3946;423;0;1
FR;4;2022-04-09;0;0;1;1;0;1;1;0;0;1081627;6626;1354;18;1082811;3947;424;0;1
FR;4;2022-04-10;2;2;0;0;2;2;0;0;0;1081629;6628;1354;18;1082813;3949;424;0;1
FR;4;2022-04-11;4;3;4;0;4;5;2;0;0;1081633;6631;1358;18;1082817;3954;426;0;1
FR;4;2022-04-12;6;1;4;0;6;2;3;0;0;1081639;6632;1362;18;1082823;3956;429;0;1
FR;4;2022-04-13;5;8;2;1;5;10;1;0;0;1081644;6640;1364;19;1082828;3966;430;0;1
FR;4;2022-04-14;6;4;2;1;7;5;1;0;0;1081650;6644;1366;20;1082835;3971;431;0;1
FR;4;2022-04-15;7;9;1;0;7;10;0;0;0;1081657;6653;1367;20;1082842;3981;431;0;1
FR;4;2022-04-16;1;0;0;0;1;0;0;0;0;1081658;6653;1367;20;1082843;3981;431;0;1
FR;4;2022-04-17;3;2;1;0;3;3;0;0;0;1081661;6655;1368;20;1082846;3984;431;0;1
FR;4;2022-04-18;2;2;6;0;2;4;4;0;0;1081663;6657;1374;20;1082848;3988;435;0;1
FR;4;2022-04-19;3;1;1;0;3;1;1;0;0;1081666;6658;1375;20;1082851;3989;436;0;1
FR;4;2022-04-20;15;4;1;1;16;3;1;0;0;1081681;6662;1376;21;1082867;3992;437;0;1
FR;4;2022-04-21;7;1;0;0;7;1;0;0;0;1081688;6663;1376;21;1082874;3993;437;0;1
FR;4;2022-04-22;1;1;2;0;1;2;1;0;0;1081689;6664;1378;21;1082875;3995;438;0;1
FR;4;2022-04-23;2;3;3;0;2;6;0;0;0;1081691;6667;1381;21;1082877;4001;438;0;1
FR;4;2022-04-24;0;3;0;0;0;3;0;0;0;1081691;6670;1381;21;1082877;4004;438;0;1
FR;4;2022-04-25;3;5;3;0;3;8;0;0;0;1081694;6675;1384;21;1082880;4012;438;0;1
FR;4;2022-04-26;5;6;1;0;5;6;1;0;0;1081699;6681;1385;21;1082885;4018;439;0;1
FR;4;2022-04-27;4;1;1;2;5;1;2;0;0;1081703;6682;1386;23;1082890;4019;441;0;1
FR;4;2022-04-28;3;5;5;1;3;7;4;0;0;1081706;6687;1391;24;1082893;4026;445;0;1
FR;4;2022-04-29;6;3;0;0;6;2;0;0;0;1081712;6690;1391;24;1082899;4028;445;0;1
FR;4;2022-04-30;2;1;1;0;2;2;0;0;0;1081714;6691;1392;24;1082901;4030;445;0;1
FR;4;2022-05-01;0;0;0;0;0;0;0;0;0;1081714;6691;1392;24;1082901;4030;445;0;1
FR;4;2022-05-02;5;16;6;0;5;19;3;0;0;1081719;6707;1398;24;1082906;4049;448;0;1
FR;4;2022-05-03;2;6;2;0;2;7;1;0;0;1081721;6713;1400;24;1082908;4056;449;0;1
FR;4;2022-05-04;7;4;1;0;7;4;1;0;0;1081728;6717;1401;24;1082915;4060;450;0;1
FR;4;2022-05-05;5;2;1;1;6;1;2;0;0;1081733;6719;1402;25;1082921;4061;452;0;1
FR;4;2022-05-06;5;3;1;0;6;2;1;0;0;1081738;6722;1403;25;1082927;4063;453;0;1
FR;4;2022-05-07;0;1;0;0;0;1;0;0;0;1081738;6723;1403;25;1082927;4064;453;0;1
FR;4;2022-05-08;1;1;0;0;1;1;0;0;0;1081739;6724;1403;25;1082928;4065;453;0;1
FR;4;2022-05-09;5;1;0;1;5;1;1;0;0;1081744;6725;1403;26;1082933;4066;454;0;1
FR;4;2022-05-10;3;1;0;2;3;3;0;0;0;1081747;6726;1403;28;1082936;4069;454;0;1
FR;4;2022-05-11;4;2;4;0;4;5;1;0;0;1081751;6728;1407;28;1082940;4074;455;0;1
FR;4;2022-05-12;7;4;2;1;7;5;1;0;1;1081758;6732;1409;29;1082947;4079;456;0;2
FR;4;2022-05-13;1;0;2;0;1;2;0;0;0;1081759;6732;1411;29;1082948;4081;456;0;2
FR;4;2022-05-14;0;2;0;0;0;2;0;0;0;1081759;6734;1411;29;1082948;4083;456;0;2
FR;4;2022-05-15;2;2;0;0;4;0;0;0;0;1081761;6736;1411;29;1082952;4083;456;0;2
FR;4;2022-05-16;5;2;2;0;5;2;2;0;0;1081766;6738;1413;29;1082957;4085;458;0;2
FR;4;2022-05-17;5;1;2;0;5;3;0;0;0;1081771;6739;1415;29;1082962;4088;458;0;2
FR;4;2022-05-18;3;6;0;0;3;6;0;0;0;1081774;6745;1415;29;1082965;4094;458;0;2
FR;4;2022-05-19;2;3;3;0;2;5;1;0;0;1081776;6748;1418;29;1082967;4099;459;0;2
FR;4;2022-05-20;5;2;3;0;5;2;3;0;0;1081781;6750;1421;29;1082972;4101;462;0;2
FR;4;2022-05-21;2;0;1;0;2;1;0;0;0;1081783;6750;1422;29;1082974;4102;462;0;2
FR;4;2022-05-22;0;0;1;0;0;1;0;0;0;1081783;6750;1423;29;1082974;4103;462;0;2
FR;4;2022-05-23;0;0;2;0;0;0;2;0;0;1081783;6750;1425;29;1082974;4103;464;0;2
FR;4;2022-05-24;2;4;1;0;2;5;0;0;0;1081785;6754;1426;29;1082976;4108;464;0;2
FR;4;2022-05-25;1;4;1;0;3;3;0;0;0;1081786;6758;1427;29;1082979;4111;464;0;2
FR;4;2022-05-26;5;0;1;0;5;1;0;0;0;1081791;6758;1428;29;1082984;4112;464;0;2
FR;4;2022-05-27;0;2;1;1;0;3;1;0;0;1081791;6760;1429;30;1082984;4115;465;0;2
FR;4;2022-05-28;1;0;0;0;1;0;0;0;0;1081792;6760;1429;30;1082985;4115;465;0;2
FR;4;2022-05-29;1;0;1;0;1;1;0;0;0;1081793;6760;1430;30;1082986;4116;465;0;2
FR;4;2022-05-30;3;4;2;0;3;5;1;0;0;1081796;6764;1432;30;1082989;4121;466;0;2
FR;4;2022-05-31;2;1;0;0;2;1;0;0;0;1081798;6765;1432;30;1082991;4122;466;0;2
FR;4;2022-06-01;5;11;7;0;5;15;3;0;0;1081803;6776;1439;30;1082996;4137;469;0;2
FR;4;2022-06-02;6;7;3;0;6;7;2;0;0;1081809;6783;1442;30;1083002;4144;471;0;2
FR;4;2022-06-03;2;6;4;1;2;7;4;0;0;1081811;6789;1446;31;1083004;4151;475;0;2
FR;4;2022-06-04;0;1;1;1;0;1;2;0;0;1081811;6790;1447;32;1083004;4152;477;0;2
FR;4;2022-06-05;1;0;0;0;1;0;0;0;0;1081812;6790;1447;32;1083005;4152;477;0;2
FR;4;2022-06-06;8;0;3;0;8;2;1;0;0;1081820;6790;1450;32;1083013;4154;478;0;2
FR;4;2022-06-07;7;2;0;1;7;2;1;0;0;1081827;6792;1450;33;1083020;4156;479;0;2
FR;4;2022-06-08;0;5;3;0;1;7;0;0;0;1081827;6797;1453;33;1083021;4163;479;0;2
FR;4;2022-06-09;1;2;0;0;2;1;0;0;0;1081828;6799;1453;33;1083023;4164;479;0;2
FR;4;2022-06-10;4;0;3;0;4;1;2;0;0;1081832;6799;1456;33;1083027;4165;481;0;2
FR;4;2022-06-11;1;0;0;0;1;0;0;0;0;1081833;6799;1456;33;1083028;4165;481;0;2
FR;4;2022-06-12;4;1;1;0;4;2;0;0;0;1081837;6800;1457;33;1083032;4167;481;0;2
FR;4;2022-06-13;6;2;3;0;7;2;1;0;0;1081843;6802;1460;33;1083039;4169;482;0;2
FR;4;2022-06-14;4;3;0;0;5;2;0;0;0;1081847;6805;1460;33;1083044;4171;482;0;2
FR;4;2022-06-15;10;3;4;0;10;3;4;0;0;1081857;6808;1464;33;1083054;4174;486;0;2
FR;4;2022-06-16;2;3;1;1;3;2;1;0;1;1081859;6811;1465;34;1083057;4176;487;0;3
FR;4;2022-06-17;6;1;0;0;6;1;0;0;0;1081865;6812;1465;34;1083063;4177;487;0;3
FR;4;2022-06-18;0;0;0;0;0;0;0;0;0;1081865;6812;1465;34;1083063;4177;487;0;3
FR;4;2022-06-19;3;0;0;0;3;0;0;0;0;1081868;6812;1465;34;1083066;4177;487;0;3
FR;4;2022-06-20;6;2;2;1;6;3;2;0;0;1081874;6814;1467;35;1083072;4180;489;0;3
FR;4;2022-06-21;5;2;4;1;6;4;2;0;0;1081879;6816;1471;36;1083078;4184;491;0;3
FR;4;2022-06-22;3;2;1;3;4;2;1;0;0;1081882;6818;1472;39;1083082;4186;492;0;3
FR;4;2022-06-23;3;3;3;0;3;5;1;0;0;1081885;6821;1475;39;1083085;4191;493;0;3
FR;4;2022-06-24;3;0;2;0;3;0;2;0;0;1081888;6821;1477;39;1083088;4191;495;0;3
FR;4;2022-06-25;3;0;1;1;3;1;1;0;0;1081891;6821;1478;40;1083091;4192;496;0;3
FR;4;2022-06-26;0;0;2;0;0;2;0;0;0;1081891;6821;1480;40;1083091;4194;496;0;3
FR;4;2022-06-27;2;2;1;3;2;3;3;0;0;1081893;6823;1481;43;1083093;4197;499;0;3
FR;4;2022-06-28;0;4;2;1;0;5;2;0;0;1081893;6827;1483;44;1083093;4202;501;0;3
FR;4;2022-06-29;1;2;0;0;1;2;0;0;0;1081894;6829;1483;44;1083094;4204;501;0;3
FR;4;2022-06-30;2;0;0;0;2;0;0;0;0;1081896;6829;1483;44;1083096;4204;501;0;3
FR;4;2022-07-01;3;4;8;0;3;4;8;0;0;1081899;6833;1491;44;1083099;4208;509;0;3
FR;4;2022-07-02;0;1;0;0;1;0;0;0;0;1081899;6834;1491;44;1083100;4208;509;0;3
FR;4;2022-07-03;0;0;0;0;0;0;0;0;0;1081899;6834;1491;44;1083100;4208;509;0;3
FR;4;2022-07-04;4;1;0;0;4;1;0;0;0;1081903;6835;1491;44;1083104;4209;509;0;3
FR;4;2022-07-05;4;1;3;0;4;3;1;0;0;1081907;6836;1494;44;1083108;4212;510;0;3
FR;4;2022-07-06;5;0;1;1;5;0;1;0;1;1081912;6836;1495;45;1083113;4212;511;0;4
FR;4;2022-07-07;2;1;2;1;2;1;3;0;0;1081914;6837;1497;46;1083115;4213;514;0;4
FR;4;2022-07-08;4;1;0;0;4;1;0;0;0;1081918;6838;1497;46;1083119;4214;514;0;4
FR;4;2022-07-09;2;2;1;0;2;3;0;0;0;1081920;6840;1498;46;1083121;4217;514;0;4
FR;4;2022-07-10;2;0;1;0;2;0;0;0;0;1081922;6840;1499;46;1083123;4217;514;0;4
FR;4;2022-07-11;3;0;2;0;3;0;1;0;0;1081925;6840;1501;46;1083126;4217;515;0;4
FR;4;2022-07-12;0;0;2;0;0;2;0;0;0;1081925;6840;1503;46;1083126;4219;515;0;4
FR;4;2022-07-13;4;2;3;1;4;2;4;0;0;1081929;6842;1506;47;1083130;4221;519;0;4
FR;4;2022-07-14;6;0;1;0;6;0;1;0;0;1081935;6842;1507;47;1083136;4221;520;0;4
FR;4;2022-07-15;11;2;0;0;11;2;0;0;0;1081946;6844;1507;47;1083147;4223;520;0;4
FR;4;2022-07-16;5;0;0;2;5;0;2;0;0;1081951;6844;1507;49;1083152;4223;522;0;4
FR;4;2022-07-17;1;0;1;1;1;0;2;0;0;1081952;6844;1508;50;1083153;4223;524;0;4
FR;4;2022-07-18;3;3;2;0;3;3;2;0;0;1081955;6847;1510;50;1083156;4226;526;0;4
FR;4;2022-07-19;5;0;1;0;5;1;0;0;0;1081960;6847;1511;50;1083161;4227;526;0;4
FR;4;2022-07-20;12;2;1;0;13;2;0;0;0;1081972;6849;1512;50;1083174;4229;526;0;4
FR;4;2022-07-21;2;3;1;0;2;3;1;0;0;1081974;6852;1513;50;1083176;4232;527;0;4
FR;4;2022-07-22;5;1;3;0;5;2;2;0;0;1081979;6853;1516;50;1083181;4234;529;0;4
FR;4;2022-07-23;1;2;0;0;1;1;0;0;0;1081980;6855;1516;50;1083182;4235;529;0;4
FR;4;2022-07-24;1;0;0;0;1;0;0;0;0;1081981;6855;1516;50;1083183;4235;529;0;4
FR;4;2022-07-25;7;0;2;1;7;2;1;0;0;1081988;6855;1518;51;1083190;4237;530;0;4
FR;4;2022-07-26;3;0;0;0;3;0;0;0;0;1081991;6855;1518;51;1083193;4237;530;0;4
FR;4;2022-07-27;3;1;0;0;3;0;0;0;0;1081994;6856;1518;51;1083196;4237;530;0;4
FR;4;2022-07-28;13;0;0;0;13;0;0;0;0;1082007;6856;1518;51;1083209;4237;530;0;4
FR;4;2022-07-29;3;0;2;0;3;1;1;0;0;1082010;6856;1520;51;1083212;4238;531;0;4
FR;4;2022-07-30;5;0;2;0;5;0;2;0;0;1082015;6856;1522;51;1083217;4238;533;0;4
FR;4;2022-07-31;0;0;0;0;0;0;0;0;0;1082015;6856;1522;51;1083217;4238;533;0;4
FR;4;2022-08-01;4;0;3;0;4;2;1;0;0;1082019;6856;1525;51;1083221;4240;534;0;4
FR;4;2022-08-02;7;0;0;0;7;0;0;0;0;1082026;6856;1525;51;1083228;4240;534;0;4
FR;4;2022-08-03;2;2;1;0;2;2;1;0;0;1082028;6858;1526;51;1083230;4242;535;0;4
FR;4;2022-08-04;5;2;0;1;5;2;1;0;0;1082033;6860;1526;52;1083235;4244;536;0;4
FR;4;2022-08-05;3;1;1;0;3;1;1;0;0;1082036;6861;1527;52;1083238;4245;537;0;4
FR;4;2022-08-06;2;0;0;0;2;0;0;0;0;1082038;6861;1527;52;1083240;4245;537;0;4
FR;4;2022-08-07;5;0;0;0;5;0;0;0;0;1082043;6861;1527;52;1083245;4245;537;0;4
FR;4;2022-08-08;2;0;1;1;2;1;1;0;0;1082045;6861;1528;53;1083247;4246;538;0;4
FR;4;2022-08-09;1;1;2;2;1;2;3;0;0;1082046;6862;1530;55;1083248;4248;541;0;4
FR;4;2022-08-10;6;1;1;0;7;1;0;0;0;1082052;6863;1531;55;1083255;4249;541;0;4
FR;4;2022-08-11;2;0;1;0;2;1;0;0;0;1082054;6863;1532;55;1083257;4250;541;0;4
FR;4;2022-08-12;4;0;1;0;4;0;1;0;0;1082058;6863;1533;55;1083261;4250;542;0;4
FR;4;2022-08-13;1;0;0;0;1;0;0;0;0;1082059;6863;1533;55;1083262;4250;542;0;4
FR;4;2022-08-14;1;0;0;0;1;0;0;0;0;1082060;6863;1533;55;1083263;4250;542;0;4
FR;4;2022-08-15;1;2;3;0;1;2;3;0;0;1082061;6865;1536;55;1083264;4252;545;0;4
FR;4;2022-08-16;0;0;1;0;0;1;0;0;0;1082061;6865;1537;55;1083264;4253;545;0;4
FR;4;2022-08-17;3;0;0;0;3;0;0;0;0;1082064;6865;1537;55;1083267;4253;545;0;4
FR;4;2022-08-18;6;0;0;0;6;0;0;0;0;1082070;6865;1537;55;1083273;4253;545;0;4
FR;4;2022-08-19;5;0;0;0;5;0;0;0;0;1082075;6865;1537;55;1083278;4253;545;0;4
FR;4;2022-08-20;3;1;0;0;4;0;0;0;0;1082078;6866;1537;55;1083282;4253;545;0;4
FR;4;2022-08-21;1;0;0;0;1;0;0;0;0;1082079;6866;1537;55;1083283;4253;545;0;4
FR;4;2022-08-22;3;9;0;0;3;9;0;0;0;1082082;6875;1537;55;1083286;4262;545;0;4
FR;4;2022-08-23;3;3;3;0;3;4;2;0;0;1082085;6878;1540;55;1083289;4266;547;0;4
FR;4;2022-08-24;6;0;0;1;6;0;1;0;0;1082091;6878;1540;56;1083295;4266;548;0;4
FR;4;2022-08-25;1;3;2;0;1;4;1;0;0;1082092;6881;1542;56;1083296;4270;549;0;4
FR;4;2022-08-26;6;0;0;1;6;0;1;0;0;1082098;6881;1542;57;1083302;4270;550;0;4
FR;4;2022-08-27;1;0;0;0;1;0;0;0;0;1082099;6881;1542;57;1083303;4270;550;0;4
FR;4;2022-08-28;0;1;0;0;0;0;0;0;0;1082099;6882;1542;57;1083303;4270;550;0;4
FR;4;2022-08-29;8;0;0;0;8;0;0;0;0;1082107;6882;1542;57;1083311;4270;550;0;4
FR;4;2022-08-30;5;1;0;0;5;1;0;0;0;1082112;6883;1542;57;1083316;4271;550;0;4
FR;4;2022-08-31;3;1;0;0;3;1;0;0;0;1082115;6884;1542;57;1083319;4272;550;0;4
FR;4;2022-09-01;4;8;2;0;5;7;2;0;0;1082119;6892;1544;57;1083324;4279;552;0;4
FR;4;2022-09-02;2;2;1;0;3;2;0;0;0;1082121;6894;1545;57;1083327;4281;552;0;4
FR;4;2022-09-03;3;0;0;0;3;0;0;0;0;1082124;6894;1545;57;1083330;4281;552;0;4
FR;4;2022-09-04;1;0;0;0;1;0;0;0;0;1082125;6894;1545;57;1083331;4281;552;0;4
FR;4;2022-09-05;4;2;0;0;4;2;0;0;0;1082129;6896;1545;57;1083335;4283;552;0;4
FR;4;2022-09-06;1;0;0;0;1;0;0;0;0;1082130;6896;1545;57;1083336;4283;552;0;4
FR;4;2022-09-07;2;0;1;1;2;1;1;0;0;1082132;6896;1546;58;1083338;4284;553;0;4
FR;4;2022-09-08;3;0;0;0;3;0;0;0;0;1082135;6896;1546;58;1083341;4284;553;0;4
FR;4;2022-09-09;2;2;0;0;2;2;0;0;0;1082137;6898;1546;58;1083343;4286;553;0;4
FR;4;2022-09-10;0;1;0;3;0;2;2;0;0;1082137;6899;1546;61;1083343;4288;555;0;4
FR;4;2022-09-11;2;0;0;0;2;0;0;0;0;1082139;6899;1546;61;1083345;4288;555;0;4
FR;4;2022-09-12;1;1;1;0;1;1;1;0;0;1082140;6900;1547;61;1083346;4289;556;0;4
FR;4;2022-09-13;1;0;0;0;1;0;0;0;0;1082141;6900;1547;61;1083347;4289;556;0;4
FR;4;2022-09-14;4;0;0;0;4;0;0;0;0;1082145;6900;1547;61;1083351;4289;556;0;4
FR;4;2022-09-15;5;0;0;0;5;0;0;0;0;1082150;6900;1547;61;1083356;4289;556;0;4
FR;4;2022-09-16;1;0;0;0;1;0;0;0;0;1082151;6900;1547;61;1083357;4289;556;0;4
FR;4;2022-09-17;2;0;0;0;2;0;0;0;0;1082153;6900;1547;61;1083359;4289;556;0;4
FR;4;2022-09-18;0;1;0;0;0;1;0;0;0;1082153;6901;1547;61;1083359;4290;556;0;4
FR;4;2022-09-19;4;0;2;0;4;2;0;0;0;1082157;6901;1549;61;1083363;4292;556;0;4
FR;4;2022-09-20;4;0;0;0;4;0;0;0;0;1082161;6901;1549;61;1083367;4292;556;0;4
FR;4;2022-09-21;2;1;0;0;2;1;0;0;0;1082163;6902;1549;61;1083369;4293;556;0;4
FR;4;2022-09-22;2;1;0;0;2;1;0;0;0;1082165;6903;1549;61;1083371;4294;556;0;4
FR;4;2022-09-23;2;3;0;0;3;2;0;0;0;1082167;6906;1549;61;1083374;4296;556;0;4
FR;4;2022-09-24;1;0;0;0;1;0;0;0;0;1082168;6906;1549;61;1083375;4296;556;0;4
FR;4;2022-09-25;0;0;0;0;0;0;0;0;0;1082168;6906;1549;61;1083375;4296;556;0;4
FR;4;2022-09-26;2;0;1;0;2;0;1;0;0;1082170;6906;1550;61;1083377;4296;557;0;4
FR;4;2022-09-27;1;0;1;1;1;0;2;0;0;1082171;6906;1551;62;1083378;4296;559;0;4
FR;4;2022-09-28;3;0;2;0;3;2;0;0;0;1082174;6906;1553;62;1083381;4298;559;0;4
FR;4;2022-09-29;5;0;1;1;5;1;1;0;0;1082179;6906;1554;63;1083386;4299;560;0;4
FR;4;2022-09-30;1;1;0;0;1;1;0;0;0;1082180;6907;1554;63;1083387;4300;560;0;4
FR;4;2022-10-01;1;1;0;0;2;0;0;0;0;1082181;6908;1554;63;1083389;4300;560;0;4
FR;4;2022-10-02;0;1;0;0;0;1;0;0;0;1082181;6909;1554;63;1083389;4301;560;0;4
FR;4;2022-10-03;2;3;1;1;3;3;1;0;0;1082183;6912;1555;64;1083392;4304;561;0;4
FR;4;2022-10-04;3;0;0;0;3;0;0;0;0;1082186;6912;1555;64;1083395;4304;561;0;4
FR;4;2022-10-05;0;1;0;0;0;1;0;0;0;1082186;6913;1555;64;1083395;4305;561;0;4
FR;4;2022-10-06;2;0;0;0;2;0;0;0;0;1082188;6913;1555;64;1083397;4305;561;0;4
FR;4;2022-10-07;3;1;1;0;3;1;1;0;0;1082191;6914;1556;64;1083400;4306;562;0;4
FR;4;2022-10-08;4;1;0;0;4;0;0;0;0;1082195;6915;1556;64;1083404;4306;562;0;4
FR;4;2022-10-09;0;0;0;0;0;0;0;0;0;1082195;6915;1556;64;1083404;4306;562;0;4
FR;4;2022-10-10;5;0;2;3;5;2;1;0;2;1082200;6915;1558;67;1083409;4308;563;0;6
FR;4;2022-10-11;2;2;0;0;2;1;0;0;0;1082202;6917;1558;67;1083411;4309;563;0;6
FR;4;2022-10-12;1;0;0;0;1;0;0;0;0;1082203;6917;1558;67;1083412;4309;563;0;6
FR;4;2022-10-13;5;0;0;0;5;0;0;0;0;1082208;6917;1558;67;1083417;4309;563;0;6
FR;4;2022-10-14;1;1;0;0;1;1;0;0;0;1082209;6918;1558;67;1083418;4310;563;0;6
FR;4;2022-10-15;1;2;0;0;1;2;0;0;0;1082210;6920;1558;67;1083419;4312;563;0;6
FR;4;2022-10-16;0;0;0;0;0;0;0;0;0;1082210;6920;1558;67;1083419;4312;563;0;6
FR;4;2022-10-17;3;0;1;0;3;1;0;0;0;1082213;6920;1559;67;1083422;4313;563;0;6
FR;4;2022-10-18;1;0;0;1;1;0;1;0;0;1082214;6920;1559;68;1083423;4313;564;0;6
FR;4;2022-10-19;1;0;0;2;1;0;2;0;3;1082215;6920;1559;70;1083424;4313;566;0;9
FR;4;2022-10-20;4;1;0;0;4;1;0;0;0;1082219;6921;1559;70;1083428;4314;566;0;9
FR;4;2022-10-21;3;1;0;0;3;1;0;0;0;1082222;6922;1559;70;1083431;4315;566;0;9
FR;4;2022-10-22;1;0;0;0;1;0;0;0;0;1082223;6922;1559;70;1083432;4315;566;0;9
FR;4;2022-10-23;0;0;0;0;0;0;0;0;0;1082223;6922;1559;70;1083432;4315;566;0;9
FR;4;2022-10-24;3;0;0;0;3;0;0;0;0;1082226;6922;1559;70;1083435;4315;566;0;9
FR;4;2022-10-25;4;0;0;0;4;0;0;0;0;1082230;6922;1559;70;1083439;4315;566;0;9
FR;4;2022-10-26;2;1;0;0;2;1;0;0;0;1082232;6923;1559;70;1083441;4316;566;0;9
FR;4;2022-10-27;3;1;1;0;3;0;1;0;0;1082235;6924;1560;70;1083444;4316;567;0;9
FR;4;2022-10-28;0;0;0;0;0;0;0;0;0;1082235;6924;1560;70;1083444;4316;567;0;9
FR;4;2022-10-29;1;0;0;3;1;0;3;0;3;1082236;6924;1560;73;1083445;4316;570;0;12
FR;4;2022-10-30;1;0;0;0;1;0;0;0;0;1082237;6924;1560;73;1083446;4316;570;0;12
FR;4;2022-10-31;1;0;0;0;1;0;0;0;0;1082238;6924;1560;73;1083447;4316;570;0;12
FR;4;2022-11-01;1;6;0;0;1;6;0;0;0;1082239;6930;1560;73;1083448;4322;570;0;12
FR;4;2022-11-02;0;0;2;2;0;1;3;0;0;1082239;6930;1562;75;1083448;4323;573;0;12
FR;4;2022-11-03;1;0;0;0;1;0;0;0;0;1082240;6930;1562;75;1083449;4323;573;0;12
FR;4;2022-11-04;4;1;0;0;4;0;0;0;0;1082244;6931;1562;75;1083453;4323;573;0;12
FR;4;2022-11-05;0;0;0;0;0;0;0;0;0;1082244;6931;1562;75;1083453;4323;573;0;12
FR;4;2022-11-06;2;0;0;0;2;0;0;0;0;1082246;6931;1562;75;1083455;4323;573;0;12
FR;4;2022-11-07;2;0;0;0;2;0;0;0;0;1082248;6931;1562;75;1083457;4323;573;0;12
FR;4;2022-11-08;7;0;0;0;7;0;0;0;0;1082255;6931;1562;75;1083464;4323;573;0;12
FR;4;2022-11-09;0;0;0;0;0;0;0;0;0;1082255;6931;1562;75;1083464;4323;573;0;12
FR;4;2022-11-10;2;0;1;0;2;1;0;0;0;1082257;6931;1563;75;1083466;4324;573;0;12
FR;4;2022-11-11;1;0;0;0;1;0;0;0;0;1082258;6931;1563;75;1083467;4324;573;0;12
FR;4;2022-11-12;3;1;0;0;3;1;0;0;0;1082261;6932;1563;75;1083470;4325;573;0;12
FR;4;2022-11-13;2;0;0;0;2;0;0;0;0;1082263;6932;1563;75;1083472;4325;573;0;12
FR;4;2022-11-14;0;1;0;0;0;1;0;0;0;1082263;6933;1563;75;1083472;4326;573;0;12
FR;4;2022-11-15;3;1;0;0;3;1;0;0;0;1082266;6934;1563;75;1083475;4327;573;0;12
FR;4;2022-11-16;1;1;1;0;1;1;1;0;0;1082267;6935;1564;75;1083476;4328;574;0;12
FR;4;2022-11-17;0;2;0;0;0;2;0;0;0;1082267;6937;1564;75;1083476;4330;574;0;12
FR;4;2022-11-18;5;0;1;0;5;0;1;0;0;1082272;6937;1565;75;1083481;4330;575;0;12
FR;4;2022-11-19;0;0;0;0;0;0;0;0;0;1082272;6937;1565;75;1083481;4330;575;0;12
FR;4;2022-11-20;0;0;0;1;0;0;0;0;1;1082272;6937;1565;76;1083481;4330;575;0;13
FR;4;2022-11-21;0;0;0;0;0;0;0;0;0;1082272;6937;1565;76;1083481;4330;575;0;13
FR;4;2022-11-22;0;1;1;0;0;2;0;0;0;1082272;6938;1566;76;1083481;4332;575;0;13
FR;4;2022-11-23;1;0;0;0;1;0;0;0;1;1082273;6938;1566;76;1083482;4332;575;0;14
FR;4;2022-11-24;0;2;0;0;0;2;0;0;0;1082273;6940;1566;76;1083482;4334;575;0;14
FR;4;2022-11-25;3;4;0;0;3;4;0;0;0;1082276;6944;1566;76;1083485;4338;575;0;14
FR;4;2022-11-26;1;0;0;0;1;0;0;0;0;1082277;6944;1566;76;1083486;4338;575;0;14
FR;4;2022-11-27;0;0;0;0;0;0;0;0;0;1082277;6944;1566;76;1083486;4338;575;0;14
FR;4;2022-11-28;4;0;0;0;4;0;0;0;0;1082281;6944;1566;76;1083490;4338;575;0;14
FR;4;2022-11-29;3;0;0;0;3;0;0;0;0;1082284;6944;1566;76;1083493;4338;575;0;14
FR;4;2022-11-30;0;0;0;0;0;0;0;0;0;1082284;6944;1566;76;1083493;4338;575;0;14
FR;4;2022-12-01;1;2;2;0;2;2;1;0;0;1082285;6946;1568;76;1083495;4340;576;0;14
FR;4;2022-12-02;6;1;0;1;6;1;0;0;1;1082291;6947;1568;77;1083501;4341;576;0;15
FR;4;2022-12-03;1;0;0;0;1;0;0;0;0;1082292;6947;1568;77;1083502;4341;576;0;15
FR;4;2022-12-04;0;0;0;0;0;0;0;0;0;1082292;6947;1568;77;1083502;4341;576;0;15
FR;4;2022-12-05;3;1;0;0;3;1;0;0;0;1082295;6948;1568;77;1083505;4342;576;0;15
FR;4;2022-12-06;2;0;0;0;2;0;0;0;0;1082297;6948;1568;77;1083507;4342;576;0;15
FR;4;2022-12-07;2;3;1;0;2;4;0;0;0;1082299;6951;1569;77;1083509;4346;576;0;15
FR;4;2022-12-08;1;0;0;0;1;0;0;0;0;1082300;6951;1569;77;1083510;4346;576;0;15
FR;4;2022-12-09;2;0;1;0;2;0;1;0;0;1082302;6951;1570;77;1083512;4346;577;0;15
FR;4;2022-12-10;1;0;0;0;1;0;0;0;0;1082303;6951;1570;77;1083513;4346;577;0;15
FR;4;2022-12-11;0;0;0;0;0;0;0;0;0;1082303;6951;1570;77;1083513;4346;577;0;15
FR;4;2022-12-12;2;1;0;5;2;1;5;0;0;1082305;6952;1570;82;1083515;4347;582;0;15
FR;4;2022-12-13;2;0;0;0;2;0;0;0;0;1082307;6952;1570;82;1083517;4347;582;0;15
FR;4;2022-12-14;0;0;0;0;0;0;0;0;0;1082307;6952;1570;82;1083517;4347;582;0;15
FR;4;2022-12-15;1;1;0;0;1;1;0;0;0;1082308;6953;1570;82;1083518;4348;582;0;15
FR;4;2022-12-16;2;0;0;0;2;0;0;0;0;1082310;6953;1570;82;1083520;4348;582;0;15
FR;4;2022-12-17;0;0;1;0;0;0;1;0;0;1082310;6953;1571;82;1083520;4348;583;0;15
FR;4;2022-12-18;1;0;0;0;1;0;0;0;0;1082311;6953;1571;82;1083521;4348;583;0;15
FR;4;2022-12-19;1;0;0;0;1;0;0;0;0;1082312;6953;1571;82;1083522;4348;583;0;15
FR;4;2022-12-20;4;2;0;0;5;1;0;0;0;1082316;6955;1571;82;1083527;4349;583;0;15
FR;4;2022-12-21;6;0;0;0;6;0;0;0;0;1082322;6955;1571;82;1083533;4349;583;0;15
FR;4;2022-12-22;2;1;0;0;2;1;0;0;0;1082324;6956;1571;82;1083535;4350;583;0;15
FR;4;2022-12-23;3;0;0;0;3;0;0;0;0;1082327;6956;1571;82;1083538;4350;583;0;15
FR;4;2022-12-24;0;0;1;0;0;1;0;0;0;1082327;6956;1572;82;1083538;4351;583;0;15
FR;4;2022-12-25;0;0;0;0;0;0;0;0;0;1082327;6956;1572;82;1083538;4351;583;0;15
FR;4;2022-12-26;1;2;0;0;1;1;0;0;0;1082328;6958;1572;82;1083539;4352;583;0;15
FR;4;2022-12-27;1;1;0;0;1;1;0;0;0;1082329;6959;1572;82;1083540;4353;583;0;15
FR;4;2022-12-28;0;0;0;0;0;0;0;0;0;1082329;6959;1572;82;1083540;4353;583;0;15
FR;4;2022-12-29;0;1;0;0;1;0;0;0;0;1082329;6960;1572;82;1083541;4353;583;0;15
FR;4;2022-12-30;1;0;0;0;1;0;0;0;0;1082330;6960;1572;82;1083542;4353;583;0;15
FR;4;2022-12-31;0;0;0;0;0;0;0;0;0;1082330;6960;1572;82;1083542;4353;583;0;15
FR;4;2023-01-01;0;0;0;0;0;0;0;0;0;1082330;6960;1572;82;1083542;4353;583;0;15
FR;4;2023-01-02;2;0;2;0;2;1;1;0;0;1082332;6960;1574;82;1083544;4354;584;0;15
FR;4;2023-01-03;1;1;0;0;1;1;0;0;0;1082333;6961;1574;82;1083545;4355;584;0;15
FR;4;2023-01-04;0;0;0;0;0;0;0;0;0;1082333;6961;1574;82;1083545;4355;584;0;15
FR;4;2023-01-05;0;0;0;0;0;0;0;0;0;1082333;6961;1574;82;1083545;4355;584;0;15
FR;4;2023-01-06;1;1;3;0;1;4;0;0;0;1082334;6962;1577;82;1083546;4359;584;0;15
FR;4;2023-01-07;1;0;0;0;1;0;0;0;0;1082335;6962;1577;82;1083547;4359;584;0;15
FR;4;2023-01-08;1;0;0;0;1;0;0;0;0;1082336;6962;1577;82;1083548;4359;584;0;15
FR;4;2023-01-09;1;0;0;0;1;0;0;0;0;1082337;6962;1577;82;1083549;4359;584;0;15
FR;4;2023-01-10;2;1;0;0;2;1;0;0;0;1082339;6963;1577;82;1083551;4360;584;0;15
FR;4;2023-01-11;0;0;0;0;0;0;0;0;0;1082339;6963;1577;82;1083551;4360;584;0;15
FR;4;2023-01-12;3;2;0;0;3;2;0;0;0;1082342;6965;1577;82;1083554;4362;584;0;15
FR;4;2023-01-13;3;0;2;0;3;0;2;0;0;1082345;6965;1579;82;1083557;4362;586;0;15
FR;4;2023-01-14;0;0;1;0;0;0;1;0;0;1082345;6965;1580;82;1083557;4362;587;0;15
FR;4;2023-01-15;0;0;0;0;0;0;0;0;0;1082345;6965;1580;82;1083557;4362;587;0;15
FR;4;2023-01-16;3;0;0;0;3;0;0;0;0;1082348;6965;1580;82;1083560;4362;587;0;15
FR;4;2023-01-17;2;0;0;0;2;0;0;0;0;1082350;6965;1580;82;1083562;4362;587;0;15
FR;4;2023-01-18;3;0;0;0;3;0;0;0;0;1082353;6965;1580;82;1083565;4362;587;0;15
FR;4;2023-01-19;1;0;0;2;1;0;0;0;0;1082354;6965;1580;84;1083566;4362;587;0;15
FR;4;2023-01-20;0;0;0;0;0;0;0;0;0;1082354;6965;1580;84;1083566;4362;587;0;15
FR;4;2023-01-21;0;0;0;0;0;0;0;0;0;1082354;6965;1580;84;1083566;4362;587;0;15
FR;4;2023-01-22;0;0;0;0;0;0;0;0;0;1082354;6965;1580;84;1083566;4362;587;0;15
FR;4;2023-01-23;1;0;0;0;1;0;0;0;0;1082355;6965;1580;84;1083567;4362;587;0;15
FR;4;2023-01-24;3;1;0;0;3;1;0;0;0;1082358;6966;1580;84;1083570;4363;587;0;15
FR;4;2023-01-25;6;0;0;0;6;0;0;0;0;1082364;6966;1580;84;1083576;4363;587;0;15
FR;4;2023-01-26;1;0;1;0;1;1;0;0;0;1082365;6966;1581;84;1083577;4364;587;0;15
FR;4;2023-01-27;0;0;0;0;0;0;0;0;0;1082365;6966;1581;84;1083577;4364;587;0;15
FR;4;2023-01-28;0;0;0;0;0;0;0;0;0;1082365;6966;1581;84;1083577;4364;587;0;15
FR;4;2023-01-29;0;0;0;0;0;0;0;0;0;1082365;6966;1581;84;1083577;4364;587;0;15
FR;4;2023-01-30;0;0;0;0;0;0;0;0;0;1082365;6966;1581;84;1083577;4364;587;0;15
FR;4;2023-01-31;0;0;0;0;0;0;0;0;0;1082365;6966;1581;84;1083577;4364;587;0;15
FR;4;2023-02-01;0;0;0;0;0;0;0;0;0;1082365;6966;1581;84;1083577;4364;587;0;15
FR;4;2023-02-02;3;2;2;1;3;3;1;0;0;1082368;6968;1583;85;1083580;4367;588;0;15
FR;4;2023-02-03;0;0;0;0;0;0;0;0;0;1082368;6968;1583;85;1083580;4367;588;0;15
FR;4;2023-02-04;1;0;0;0;1;0;0;0;0;1082369;6968;1583;85;1083581;4367;588;0;15
FR;4;2023-02-05;0;0;0;0;0;0;0;0;0;1082369;6968;1583;85;1083581;4367;588;0;15
FR;4;2023-02-06;1;0;0;0;1;0;0;0;0;1082370;6968;1583;85;1083582;4367;588;0;15
FR;4;2023-02-07;2;0;0;0;2;0;0;0;0;1082372;6968;1583;85;1083584;4367;588;0;15
FR;4;2023-02-08;2;1;0;0;2;0;0;0;0;1082374;6969;1583;85;1083586;4367;588;0;15
FR;4;2023-02-09;1;1;0;0;1;1;0;0;0;1082375;6970;1583;85;1083587;4368;588;0;15
FR;4;2023-02-10;5;1;0;0;5;0;0;0;0;1082380;6971;1583;85;1083592;4368;588;0;15
FR;4;2023-02-11;4;0;0;0;4;0;0;0;0;1082384;6971;1583;85;1083596;4368;588;0;15
FR;4;2023-02-12;0;0;0;0;0;0;0;0;0;1082384;6971;1583;85;1083596;4368;588;0;15
FR;4;2023-02-13;3;0;0;0;3;0;0;0;0;1082387;6971;1583;85;1083599;4368;588;0;15
FR;4;2023-02-14;0;2;0;0;2;0;0;0;0;1082387;6973;1583;85;1083601;4368;588;0;15
FR;4;2023-02-15;2;0;0;0;2;0;0;0;0;1082389;6973;1583;85;1083603;4368;588;0;15
FR;4;2023-02-16;1;1;0;0;1;1;0;0;0;1082390;6974;1583;85;1083604;4369;588;0;15
FR;4;2023-02-17;1;0;0;0;1;0;0;0;0;1082391;6974;1583;85;1083605;4369;588;0;15
FR;4;2023-02-18;0;2;0;0;0;2;0;0;0;1082391;6976;1583;85;1083605;4371;588;0;15
FR;4;2023-02-19;0;0;0;0;0;0;0;0;0;1082391;6976;1583;85;1083605;4371;588;0;15
FR;4;2023-02-20;1;0;0;0;1;0;0;0;0;1082392;6976;1583;85;1083606;4371;588;0;15
FR;4;2023-02-21;2;0;0;0;2;0;0;0;0;1082394;6976;1583;85;1083608;4371;588;0;15
FR;4;2023-02-22;0;0;0;0;0;0;0;0;0;1082394;6976;1583;85;1083608;4371;588;0;15
FR;4;2023-02-23;0;0;0;0;0;0;0;0;0;1082394;6976;1583;85;1083608;4371;588;0;15
FR;4;2023-02-24;1;0;0;0;1;0;0;0;0;1082395;6976;1583;85;1083609;4371;588;0;15
FR;4;2023-02-25;2;1;0;0;2;1;0;0;0;1082397;6977;1583;85;1083611;4372;588;0;15
FR;4;2023-02-26;0;0;0;0;0;0;0;0;0;1082397;6977;1583;85;1083611;4372;588;0;15
FR;4;2023-02-27;1;0;0;0;1;0;0;0;0;1082398;6977;1583;85;1083612;4372;588;0;15
FR;4;2023-02-28;0;0;0;0;0;0;0;0;0;1082398;6977;1583;85;1083612;4372;588;0;15
FR;4;2023-03-01;1;0;0;0;1;0;0;0;0;1082399;6977;1583;85;1083613;4372;588;0;15
FR;4;2023-03-02;1;1;2;0;1;1;2;0;0;1082400;6978;1585;85;1083614;4373;590;0;15
FR;4;2023-03-03;1;0;0;0;1;0;0;0;0;1082401;6978;1585;85;1083615;4373;590;0;15
FR;4;2023-03-04;0;0;0;0;0;0;0;0;0;1082401;6978;1585;85;1083615;4373;590;0;15
FR;4;2023-03-05;0;0;0;0;0;0;0;0;0;1082401;6978;1585;85;1083615;4373;590;0;15
FR;4;2023-03-06;0;0;0;0;0;0;0;0;0;1082401;6978;1585;85;1083615;4373;590;0;15
FR;4;2023-03-07;0;0;0;0;0;0;0;0;0;1082401;6978;1585;85;1083615;4373;590;0;15
FR;4;2023-03-08;1;0;0;0;1;0;0;0;0;1082402;6978;1585;85;1083616;4373;590;0;15
FR;4;2023-03-09;0;0;0;0;0;0;0;0;0;1082402;6978;1585;85;1083616;4373;590;0;15
FR;4;2023-03-10;2;0;1;0;2;0;1;0;0;1082404;6978;1586;85;1083618;4373;591;0;15
FR;4;2023-03-11;0;0;0;0;0;0;0;0;0;1082404;6978;1586;85;1083618;4373;591;0;15
FR;4;2023-03-12;0;0;0;0;0;0;0;0;0;1082404;6978;1586;85;1083618;4373;591;0;15
FR;4;2023-03-13;0;0;0;0;0;0;0;0;0;1082404;6978;1586;85;1083618;4373;591;0;15
FR;4;2023-03-14;0;0;0;0;0;0;0;0;0;1082404;6978;1586;85;1083618;4373;591;0;15
FR;4;2023-03-15;1;0;0;1;1;0;0;0;1;1082405;6978;1586;86;1083619;4373;591;0;16
FR;4;2023-03-16;1;0;0;0;1;0;0;0;0;1082406;6978;1586;86;1083620;4373;591;0;16
FR;4;2023-03-17;1;0;0;0;1;0;0;0;0;1082407;6978;1586;86;1083621;4373;591;0;16
FR;4;2023-03-18;0;1;0;0;0;1;0;0;0;1082407;6979;1586;86;1083621;4374;591;0;16
FR;4;2023-03-19;0;0;0;0;0;0;0;0;0;1082407;6979;1586;86;1083621;4374;591;0;16
FR;4;2023-03-20;0;0;0;0;0;0;0;0;0;1082407;6979;1586;86;1083621;4374;591;0;16
FR;4;2023-03-21;2;0;0;0;2;0;0;0;0;1082409;6979;1586;86;1083623;4374;591;0;16
FR;4;2023-03-22;0;0;1;0;0;0;1;0;0;1082409;6979;1587;86;1083623;4374;592;0;16
FR;4;2023-03-23;1;0;0;0;1;0;0;0;0;1082410;6979;1587;86;1083624;4374;592;0;16
FR;4;2023-03-24;0;0;0;0;0;0;0;0;0;1082410;6979;1587;86;1083624;4374;592;0;16
FR;4;2023-03-25;0;0;0;0;0;0;0;0;0;1082410;6979;1587;86;1083624;4374;592;0;16
FR;4;2023-03-26;0;0;0;0;0;0;0;0;0;1082410;6979;1587;86;1083624;4374;592;0;16
FR;4;2023-03-27;1;0;0;0;1;0;0;0;0;1082411;6979;1587;86;1083625;4374;592;0;16
FR;4;2023-03-28;1;0;0;0;1;0;0;0;0;1082412;6979;1587;86;1083626;4374;592;0;16
FR;4;2023-03-29;2;0;0;0;2;0;0;0;0;1082414;6979;1587;86;1083628;4374;592;0;16
FR;4;2023-03-30;0;1;0;0;1;0;0;0;0;1082414;6980;1587;86;1083629;4374;592;0;16
FR;4;2023-03-31;3;0;0;1;3;0;0;0;4;1082417;6980;1587;87;1083632;4374;592;0;20
FR;4;2023-04-01;2;0;0;0;2;0;0;0;0;1082419;6980;1587;87;1083634;4374;592;0;20
FR;4;2023-04-02;0;0;0;0;0;0;0;0;0;1082419;6980;1587;87;1083634;4374;592;0;20
FR;4;2023-04-03;0;0;0;0;0;0;0;0;0;1082419;6980;1587;87;1083634;4374;592;0;20
FR;4;2023-04-04;0;0;0;0;0;0;0;0;0;1082419;6980;1587;87;1083634;4374;592;0;20
FR;4;2023-04-05;0;0;0;0;0;0;0;0;0;1082419;6980;1587;87;1083634;4374;592;0;20
FR;4;2023-04-06;0;0;0;0;0;0;0;0;0;1082419;6980;1587;87;1083634;4374;592;0;20
FR;4;2023-04-07;0;0;0;0;0;0;0;0;0;1082419;6980;1587;87;1083634;4374;592;0;20
FR;4;2023-04-08;0;0;0;0;0;0;0;0;0;1082419;6980;1587;87;1083634;4374;592;0;20
FR;4;2023-04-09;0;0;0;0;0;0;0;0;0;1082419;6980;1587;87;1083634;4374;592;0;20
FR;4;2023-04-10;1;0;0;0;1;0;0;0;0;1082420;6980;1587;87;1083635;4374;592;0;20
FR;4;2023-04-11;0;0;0;0;0;0;0;0;0;1082420;6980;1587;87;1083635;4374;592;0;20
FR;4;2023-04-12;1;0;0;0;1;0;0;0;0;1082421;6980;1587;87;1083636;4374;592;0;20
FR;4;2023-04-13;0;0;0;0;0;0;0;0;0;1082421;6980;1587;87;1083636;4374;592;0;20
FR;4;2023-04-14;0;0;0;0;0;0;0;0;0;1082421;6980;1587;87;1083636;4374;592;0;20
FR;4;2023-04-15;0;0;0;0;0;0;0;0;0;1082421;6980;1587;87;1083636;4374;592;0;20
FR;4;2023-04-16;0;0;0;0;0;0;0;0;0;1082421;6980;1587;87;1083636;4374;592;0;20
FR;4;2023-04-17;0;0;0;0;0;0;0;0;0;1082421;6980;1587;87;1083636;4374;592;0;20
FR;4;2023-04-18;0;0;0;0;0;0;0;0;0;1082421;6980;1587;87;1083636;4374;592;0;20
FR;4;2023-04-19;1;0;0;0;1;0;0;0;0;1082422;6980;1587;87;1083637;4374;592;0;20
FR;4;2023-04-20;0;0;0;0;0;0;0;0;0;1082422;6980;1587;87;1083637;4374;592;0;20
FR;4;2023-04-21;0;1;0;0;0;1;0;0;0;1082422;6981;1587;87;1083637;4375;592;0;20
FR;4;2023-04-22;0;0;0;0;0;0;0;0;0;1082422;6981;1587;87;1083637;4375;592;0;20
FR;4;2023-04-23;1;0;0;0;1;0;0;0;0;1082423;6981;1587;87;1083638;4375;592;0;20
FR;4;2023-04-24;1;0;0;0;1;0;0;0;0;1082424;6981;1587;87;1083639;4375;592;0;20
FR;4;2023-04-25;1;0;0;0;1;0;0;0;0;1082425;6981;1587;87;1083640;4375;592;0;20
FR;4;2023-04-26;0;0;0;0;0;0;0;0;0;1082425;6981;1587;87;1083640;4375;592;0;20
FR;4;2023-04-27;0;0;0;0;0;0;0;0;0;1082425;6981;1587;87;1083640;4375;592;0;20
FR;4;2023-04-28;0;0;0;0;0;0;0;0;0;1082425;6981;1587;87;1083640;4375;592;0;20
FR;4;2023-04-29;0;0;0;0;0;0;0;0;0;1082425;6981;1587;87;1083640;4375;592;0;20
FR;4;2023-04-30;0;0;0;0;0;0;0;0;0;1082425;6981;1587;87;1083640;4375;592;0;20
FR;4;2023-05-01;1;0;0;0;1;0;0;0;0;1082426;6981;1587;87;1083641;4375;592;0;20
FR;4;2023-05-02;0;0;0;0;0;0;0;0;0;1082426;6981;1587;87;1083641;4375;592;0;20
FR;4;2023-05-03;0;0;0;0;0;0;0;0;0;1082426;6981;1587;87;1083641;4375;592;0;20
FR;4;2023-05-04;0;0;0;0;0;0;0;0;0;1082426;6981;1587;87;1083641;4375;592;0;20
FR;4;2023-05-05;0;0;0;0;0;0;0;0;0;1082426;6981;1587;87;1083641;4375;592;0;20
FR;4;2023-05-06;0;0;0;0;0;0;0;0;0;1082426;6981;1587;87;1083641;4375;592;0;20
FR;4;2023-05-07;0;0;0;0;0;0;0;0;0;1082426;6981;1587;87;1083641;4375;592;0;20
FR;4;2023-05-08;0;0;0;0;0;0;0;0;0;1082426;6981;1587;87;1083641;4375;592;0;20
FR;4;2023-05-09;0;0;0;0;0;0;0;0;0;1082426;6981;1587;87;1083641;4375;592;0;20
FR;4;2023-05-10;0;0;0;0;0;0;0;0;0;1082426;6981;1587;87;1083641;4375;592;0;20
FR;4;2023-05-11;0;0;0;0;0;0;0;0;0;1082426;6981;1587;87;1083641;4375;592;0;20
FR;4;2023-05-12;0;0;0;0;0;0;0;0;0;1082426;6981;1587;87;1083641;4375;592;0;20
FR;4;2023-05-13;0;0;0;0;0;0;0;0;0;1082426;6981;1587;87;1083641;4375;592;0;20
FR;4;2023-05-14;0;0;0;0;0;0;0;0;0;1082426;6981;1587;87;1083641;4375;592;0;20
FR;4;2023-05-15;0;0;0;0;0;0;0;0;0;1082426;6981;1587;87;1083641;4375;592;0;20
FR;4;2023-05-16;0;0;0;0;0;0;0;0;0;1082426;6981;1587;87;1083641;4375;592;0;20
FR;4;2023-05-17;0;0;0;1;0;0;1;0;0;1082426;6981;1587;88;1083641;4375;593;0;20
FR;4;2023-05-18;0;0;0;0;0;0;0;0;0;1082426;6981;1587;88;1083641;4375;593;0;20
FR;4;2023-05-19;0;0;0;0;0;0;0;0;0;1082426;6981;1587;88;1083641;4375;593;0;20
FR;4;2023-05-20;0;0;0;0;0;0;0;0;0;1082426;6981;1587;88;1083641;4375;593;0;20
FR;4;2023-05-21;0;0;0;0;0;0;0;0;0;1082426;6981;1587;88;1083641;4375;593;0;20
FR;4;2023-05-22;0;0;0;0;0;0;0;0;0;1082426;6981;1587;88;1083641;4375;593;0;20
FR;4;2023-05-23;0;0;0;0;0;0;0;0;0;1082426;6981;1587;88;1083641;4375;593;0;20
FR;4;2023-05-24;0;0;0;0;0;0;0;0;0;1082426;6981;1587;88;1083641;4375;593;0;20
FR;4;2023-05-25;0;0;0;0;0;0;0;0;0;1082426;6981;1587;88;1083641;4375;593;0;20
FR;4;2023-05-26;0;0;0;0;0;0;0;0;0;1082426;6981;1587;88;1083641;4375;593;0;20
FR;4;2023-05-27;0;0;0;0;0;0;0;0;0;1082426;6981;1587;88;1083641;4375;593;0;20
FR;4;2023-05-28;0;0;0;0;0;0;0;0;0;1082426;6981;1587;88;1083641;4375;593;0;20
FR;4;2023-05-29;0;0;0;0;0;0;0;0;0;1082426;6981;1587;88;1083641;4375;593;0;20
FR;4;2023-05-30;0;0;0;0;0;0;0;0;0;1082426;6981;1587;88;1083641;4375;593;0;20
FR;4;2023-05-31;0;0;0;0;0;0;0;0;0;1082426;6981;1587;88;1083641;4375;593;0;20
FR;4;2023-06-01;2;0;0;0;2;0;0;0;0;1082428;6981;1587;88;1083643;4375;593;0;20
FR;4;2023-06-02;1;0;0;0;1;0;0;0;0;1082429;6981;1587;88;1083644;4375;593;0;20
FR;4;2023-06-03;0;0;0;0;0;0;0;0;0;1082429;6981;1587;88;1083644;4375;593;0;20
FR;4;2023-06-04;0;0;0;0;0;0;0;0;0;1082429;6981;1587;88;1083644;4375;593;0;20
FR;4;2023-06-05;0;0;0;0;0;0;0;0;0;1082429;6981;1587;88;1083644;4375;593;0;20
FR;4;2023-06-06;1;0;0;0;1;0;0;0;0;1082430;6981;1587;88;1083645;4375;593;0;20
FR;4;2023-06-07;0;0;0;0;0;0;0;0;0;1082430;6981;1587;88;1083645;4375;593;0;20
FR;4;2023-06-08;1;0;0;0;1;0;0;0;0;1082431;6981;1587;88;1083646;4375;593;0;20
FR;4;2023-06-09;1;0;0;0;1;0;0;0;0;1082432;6981;1587;88;1083647;4375;593;0;20
FR;4;2023-06-10;0;0;0;0;0;0;0;0;0;1082432;6981;1587;88;1083647;4375;593;0;20
FR;4;2023-06-11;0;0;0;0;0;0;0;0;0;1082432;6981;1587;88;1083647;4375;593;0;20
FR;4;2023-06-12;0;0;0;0;0;0;0;0;0;1082432;6981;1587;88;1083647;4375;593;0;20
FR;4;2023-06-13;0;0;0;0;0;0;0;0;0;1082432;6981;1587;88;1083647;4375;593;0;20
FR;4;2023-06-14;0;0;0;0;0;0;0;0;0;1082432;6981;1587;88;1083647;4375;593;0;20
FR;4;2023-06-15;0;0;0;0;0;0;0;0;0;1082432;6981;1587;88;1083647;4375;593;0;20
FR;4;2023-06-16;0;0;0;0;0;0;0;0;0;1082432;6981;1587;88;1083647;4375;593;0;20
FR;4;2023-06-17;0;0;0;0;0;0;0;0;0;1082432;6981;1587;88;1083647;4375;593;0;20
FR;4;2023-06-18;0;0;0;0;0;0;0;0;0;1082432;6981;1587;88;1083647;4375;593;0;20
FR;4;2023-06-19;0;0;0;0;0;0;0;0;0;1082432;6981;1587;88;1083647;4375;593;0;20
FR;4;2023-06-20;0;0;0;0;0;0;0;0;0;1082432;6981;1587;88;1083647;4375;593;0;20
FR;4;2023-06-21;0;0;0;0;0;0;0;0;0;1082432;6981;1587;88;1083647;4375;593;0;20
FR;4;2023-06-22;0;0;0;0;0;0;0;0;0;1082432;6981;1587;88;1083647;4375;593;0;20
FR;4;2023-06-23;0;0;0;0;0;0;0;0;0;1082432;6981;1587;88;1083647;4375;593;0;20
FR;4;2023-06-24;0;0;0;0;0;0;0;0;0;1082432;6981;1587;88;1083647;4375;593;0;20
FR;4;2023-06-25;0;0;0;0;0;0;0;0;0;1082432;6981;1587;88;1083647;4375;593;0;20
FR;4;2023-06-26;0;0;0;0;0;0;0;0;0;1082432;6981;1587;88;1083647;4375;593;0;20
FR;4;2023-06-27;0;0;0;0;0;0;0;0;0;1082432;6981;1587;88;1083647;4375;593;0;20
FR;4;2023-06-28;0;0;0;0;0;0;0;0;0;1082432;6981;1587;88;1083647;4375;593;0;20
FR;4;2023-06-29;0;0;0;0;0;0;0;0;0;1082432;6981;1587;88;1083647;4375;593;0;20
FR;4;2023-06-30;0;0;0;0;0;0;0;0;0;1082432;6981;1587;88;1083647;4375;593;0;20
FR;4;2023-07-01;0;0;0;0;0;0;0;0;0;1082432;6981;1587;88;1083647;4375;593;0;20
FR;4;2023-07-02;0;0;0;0;0;0;0;0;0;1082432;6981;1587;88;1083647;4375;593;0;20
FR;4;2023-07-03;0;0;0;0;0;0;0;0;0;1082432;6981;1587;88;1083647;4375;593;0;20
FR;4;2023-07-04;0;0;0;0;0;0;0;0;0;1082432;6981;1587;88;1083647;4375;593;0;20
FR;4;2023-07-05;0;0;0;0;0;0;0;0;0;1082432;6981;1587;88;1083647;4375;593;0;20
FR;4;2023-07-06;0;0;0;0;0;0;0;0;0;1082432;6981;1587;88;1083647;4375;593;0;20
FR;4;2023-07-07;0;0;0;0;0;0;0;0;0;1082432;6981;1587;88;1083647;4375;593;0;20
FR;4;2023-07-08;0;0;0;0;0;0;0;0;0;1082432;6981;1587;88;1083647;4375;593;0;20
FR;4;2023-07-09;0;0;0;0;0;0;0;0;0;1082432;6981;1587;88;1083647;4375;593;0;20
FR;4;2023-07-10;0;0;0;0;0;0;0;0;0;1082432;6981;1587;88;1083647;4375;593;0;20
FR;5;2020-12-27;0;0;0;0;0;0;0;0;0;0;0;0;0;0;0;0;0;0
FR;5;2020-12-28;0;0;0;0;0;0;0;0;0;0;0;0;0;0;0;0;0;0
FR;5;2020-12-29;0;0;0;0;0;0;0;0;0;0;0;0;0;0;0;0;0;0
FR;5;2020-12-30;0;0;0;0;0;0;0;0;0;0;0;0;0;0;0;0;0;0
FR;5;2020-12-31;0;0;0;0;0;0;0;0;0;0;0;0;0;0;0;0;0;0
FR;5;2021-01-01;0;0;0;0;0;0;0;0;0;0;0;0;0;0;0;0;0;0
FR;5;2021-01-02;0;0;0;0;0;0;0;0;0;0;0;0;0;0;0;0;0;0
FR;5;2021-01-03;0;0;0;0;0;0;0;0;0;0;0;0;0;0;0;0;0;0
FR;5;2021-01-04;0;0;0;0;0;0;0;0;0;0;0;0;0;0;0;0;0;0
FR;5;2021-01-05;0;0;0;0;0;0;0;0;0;0;0;0;0;0;0;0;0;0
FR;5;2021-01-06;0;0;0;0;0;0;0;0;0;0;0;0;0;0;0;0;0;0
FR;5;2021-01-07;0;0;0;0;0;0;0;0;0;0;0;0;0;0;0;0;0;0
FR;5;2021-01-08;0;0;0;0;0;0;0;0;0;0;0;0;0;0;0;0;0;0
FR;5;2021-01-09;0;0;0;0;0;0;0;0;0;0;0;0;0;0;0;0;0;0
FR;5;2021-01-10;0;0;0;0;0;0;0;0;0;0;0;0;0;0;0;0;0;0
FR;5;2021-01-11;0;0;0;0;0;0;0;0;0;0;0;0;0;0;0;0;0;0
FR;5;2021-01-12;0;0;0;0;0;0;0;0;0;0;0;0;0;0;0;0;0;0
FR;5;2021-01-13;0;0;0;0;0;0;0;0;0;0;0;0;0;0;0;0;0;0
FR;5;2021-01-14;0;0;0;0;0;0;0;0;0;0;0;0;0;0;0;0;0;0
FR;5;2021-01-15;0;0;0;0;0;0;0;0;0;0;0;0;0;0;0;0;0;0
FR;5;2021-01-16;0;0;0;0;0;0;0;0;0;0;0;0;0;0;0;0;0;0
FR;5;2021-01-17;0;0;0;0;0;0;0;0;0;0;0;0;0;0;0;0;0;0
FR;5;2021-01-18;0;0;0;0;0;0;0;0;0;0;0;0;0;0;0;0;0;0
FR;5;2021-01-19;0;0;0;0;0;0;0;0;0;0;0;0;0;0;0;0;0;0
FR;5;2021-01-20;0;0;0;0;0;0;0;0;0;0;0;0;0;0;0;0;0;0
FR;5;2021-01-21;0;0;0;0;0;0;0;0;0;0;0;0;0;0;0;0;0;0
FR;5;2021-01-22;0;0;0;0;0;0;0;0;0;0;0;0;0;0;0;0;0;0
FR;5;2021-01-23;0;0;0;0;0;0;0;0;0;0;0;0;0;0;0;0;0;0
FR;5;2021-01-24;0;0;0;0;0;0;0;0;0;0;0;0;0;0;0;0;0;0
FR;5;2021-01-25;0;0;0;0;0;0;0;0;0;0;0;0;0;0;0;0;0;0
FR;5;2021-01-26;0;0;0;0;0;0;0;0;0;0;0;0;0;0;0;0;0;0
FR;5;2021-01-27;0;0;0;0;0;0;0;0;0;0;0;0;0;0;0;0;0;0
FR;5;2021-01-28;0;0;0;0;0;0;0;0;0;0;0;0;0;0;0;0;0;0
FR;5;2021-01-29;0;0;0;0;0;0;0;0;0;0;0;0;0;0;0;0;0;0
FR;5;2021-01-30;0;0;0;0;0;0;0;0;0;0;0;0;0;0;0;0;0;0
FR;5;2021-01-31;0;0;0;0;0;0;0;0;0;0;0;0;0;0;0;0;0;0
FR;5;2021-02-01;0;0;0;0;0;0;0;0;0;0;0;0;0;0;0;0;0;0
FR;5;2021-02-02;0;0;0;0;0;0;0;0;0;0;0;0;0;0;0;0;0;0
FR;5;2021-02-03;0;0;0;0;0;0;0;0;0;0;0;0;0;0;0;0;0;0
FR;5;2021-02-04;0;0;0;0;0;0;0;0;0;0;0;0;0;0;0;0;0;0
FR;5;2021-02-05;0;0;0;0;0;0;0;0;0;0;0;0;0;0;0;0;0;0
FR;5;2021-02-06;0;0;0;0;0;0;0;0;0;0;0;0;0;0;0;0;0;0
FR;5;2021-02-07;0;0;0;0;0;0;0;0;0;0;0;0;0;0;0;0;0;0
FR;5;2021-02-08;0;0;0;0;0;0;0;0;0;0;0;0;0;0;0;0;0;0
FR;5;2021-02-09;0;0;0;0;0;0;0;0;0;0;0;0;0;0;0;0;0;0
FR;5;2021-02-10;0;0;0;0;0;0;0;0;0;0;0;0;0;0;0;0;0;0
FR;5;2021-02-11;0;0;0;0;0;0;0;0;0;0;0;0;0;0;0;0;0;0
FR;5;2021-02-12;0;0;0;0;0;0;0;0;0;0;0;0;0;0;0;0;0;0
FR;5;2021-02-13;0;0;0;0;0;0;0;0;0;0;0;0;0;0;0;0;0;0
FR;5;2021-02-14;0;0;0;0;0;0;0;0;0;0;0;0;0;0;0;0;0;0
FR;5;2021-02-15;0;0;0;0;0;0;0;0;0;0;0;0;0;0;0;0;0;0
FR;5;2021-02-16;0;0;0;0;0;0;0;0;0;0;0;0;0;0;0;0;0;0
FR;5;2021-02-17;0;0;0;0;0;0;0;0;0;0;0;0;0;0;0;0;0;0
FR;5;2021-02-18;0;0;0;0;0;0;0;0;0;0;0;0;0;0;0;0;0;0
FR;5;2021-02-19;0;0;0;0;0;0;0;0;0;0;0;0;0;0;0;0;0;0
FR;5;2021-02-20;0;0;0;0;0;0;0;0;0;0;0;0;0;0;0;0;0;0
FR;5;2021-02-21;0;0;0;0;0;0;0;0;0;0;0;0;0;0;0;0;0;0
FR;5;2021-02-22;0;0;0;0;0;0;0;0;0;0;0;0;0;0;0;0;0;0
FR;5;2021-02-23;0;0;0;0;0;0;0;0;0;0;0;0;0;0;0;0;0;0
FR;5;2021-02-24;0;0;0;0;0;0;0;0;0;0;0;0;0;0;0;0;0;0
FR;5;2021-02-25;0;0;0;0;0;0;0;0;0;0;0;0;0;0;0;0;0;0
FR;5;2021-02-26;0;0;0;0;0;0;0;0;0;0;0;0;0;0;0;0;0;0
FR;5;2021-02-27;0;0;0;0;0;0;0;0;0;0;0;0;0;0;0;0;0;0
FR;5;2021-02-28;0;0;0;0;0;0;0;0;0;0;0;0;0;0;0;0;0;0
FR;5;2021-03-01;0;0;0;0;0;0;0;0;0;0;0;0;0;0;0;0;0;0
FR;5;2021-03-02;0;0;0;0;0;0;0;0;0;0;0;0;0;0;0;0;0;0
FR;5;2021-03-03;0;0;0;0;0;0;0;0;0;0;0;0;0;0;0;0;0;0
FR;5;2021-03-04;0;0;0;0;0;0;0;0;0;0;0;0;0;0;0;0;0;0
FR;5;2021-03-05;0;0;0;0;0;0;0;0;0;0;0;0;0;0;0;0;0;0
FR;5;2021-03-06;0;0;0;0;0;0;0;0;0;0;0;0;0;0;0;0;0;0
FR;5;2021-03-07;0;0;0;0;0;0;0;0;0;0;0;0;0;0;0;0;0;0
FR;5;2021-03-08;0;0;0;0;0;0;0;0;0;0;0;0;0;0;0;0;0;0
FR;5;2021-03-09;0;0;0;0;0;0;0;0;0;0;0;0;0;0;0;0;0;0
FR;5;2021-03-10;0;0;0;0;0;0;0;0;0;0;0;0;0;0;0;0;0;0
FR;5;2021-03-11;0;0;0;0;0;0;0;0;0;0;0;0;0;0;0;0;0;0
FR;5;2021-03-12;0;0;0;0;0;0;0;0;0;0;0;0;0;0;0;0;0;0
FR;5;2021-03-13;0;0;0;0;0;0;0;0;0;0;0;0;0;0;0;0;0;0
FR;5;2021-03-14;0;0;0;0;0;0;0;0;0;0;0;0;0;0;0;0;0;0
FR;5;2021-03-15;0;0;0;0;0;0;0;0;0;0;0;0;0;0;0;0;0;0
FR;5;2021-03-16;0;0;0;0;0;0;0;0;0;0;0;0;0;0;0;0;0;0
FR;5;2021-03-17;0;0;0;0;0;0;0;0;0;0;0;0;0;0;0;0;0;0
FR;5;2021-03-18;0;0;0;0;0;0;0;0;0;0;0;0;0;0;0;0;0;0
FR;5;2021-03-19;0;0;0;0;0;0;0;0;0;0;0;0;0;0;0;0;0;0
FR;5;2021-03-20;0;0;0;0;0;0;0;0;0;0;0;0;0;0;0;0;0;0
FR;5;2021-03-21;0;0;0;0;0;0;0;0;0;0;0;0;0;0;0;0;0;0
FR;5;2021-03-22;0;0;0;0;0;0;0;0;0;0;0;0;0;0;0;0;0;0
FR;5;2021-03-23;0;0;0;0;0;0;0;0;0;0;0;0;0;0;0;0;0;0
FR;5;2021-03-24;0;0;0;0;0;0;0;0;0;0;0;0;0;0;0;0;0;0
FR;5;2021-03-25;0;0;0;0;0;0;0;0;0;0;0;0;0;0;0;0;0;0
FR;5;2021-03-26;0;0;0;0;0;0;0;0;0;0;0;0;0;0;0;0;0;0
FR;5;2021-03-27;0;0;0;0;0;0;0;0;0;0;0;0;0;0;0;0;0;0
FR;5;2021-03-28;0;0;0;0;0;0;0;0;0;0;0;0;0;0;0;0;0;0
FR;5;2021-03-29;0;0;0;0;0;0;0;0;0;0;0;0;0;0;0;0;0;0
FR;5;2021-03-30;0;0;0;0;0;0;0;0;0;0;0;0;0;0;0;0;0;0
FR;5;2021-03-31;0;0;0;0;0;0;0;0;0;0;0;0;0;0;0;0;0;0
FR;5;2021-04-01;0;0;0;0;0;0;0;0;0;0;0;0;0;0;0;0;0;0
FR;5;2021-04-02;0;0;0;0;0;0;0;0;0;0;0;0;0;0;0;0;0;0
FR;5;2021-04-03;0;0;0;0;0;0;0;0;0;0;0;0;0;0;0;0;0;0
FR;5;2021-04-04;0;0;0;0;0;0;0;0;0;0;0;0;0;0;0;0;0;0
FR;5;2021-04-05;0;0;0;0;0;0;0;0;0;0;0;0;0;0;0;0;0;0
FR;5;2021-04-06;0;0;0;0;0;0;0;0;0;0;0;0;0;0;0;0;0;0
FR;5;2021-04-07;0;0;0;0;0;0;0;0;0;0;0;0;0;0;0;0;0;0
FR;5;2021-04-08;0;0;0;0;0;0;0;0;0;0;0;0;0;0;0;0;0;0
FR;5;2021-04-09;0;0;0;0;0;0;0;0;0;0;0;0;0;0;0;0;0;0
FR;5;2021-04-10;0;0;0;0;0;0;0;0;0;0;0;0;0;0;0;0;0;0
FR;5;2021-04-11;0;0;0;0;0;0;0;0;0;0;0;0;0;0;0;0;0;0
FR;5;2021-04-12;0;0;0;0;0;0;0;0;0;0;0;0;0;0;0;0;0;0
FR;5;2021-04-13;0;0;0;0;0;0;0;0;0;0;0;0;0;0;0;0;0;0
FR;5;2021-04-14;0;0;0;0;0;0;0;0;0;0;0;0;0;0;0;0;0;0
FR;5;2021-04-15;0;0;0;0;0;0;0;0;0;0;0;0;0;0;0;0;0;0
FR;5;2021-04-16;0;0;0;0;0;0;0;0;0;0;0;0;0;0;0;0;0;0
FR;5;2021-04-17;0;0;0;0;0;0;0;0;0;0;0;0;0;0;0;0;0;0
FR;5;2021-04-18;0;0;0;0;0;0;0;0;0;0;0;0;0;0;0;0;0;0
FR;5;2021-04-19;0;0;0;0;0;0;0;0;0;0;0;0;0;0;0;0;0;0
FR;5;2021-04-20;0;0;0;0;0;0;0;0;0;0;0;0;0;0;0;0;0;0
FR;5;2021-04-21;0;0;0;0;0;0;0;0;0;0;0;0;0;0;0;0;0;0
FR;5;2021-04-22;0;0;0;0;0;0;0;0;0;0;0;0;0;0;0;0;0;0
FR;5;2021-04-23;0;0;0;0;0;0;0;0;0;0;0;0;0;0;0;0;0;0
FR;5;2021-04-24;0;0;0;0;0;0;0;0;0;0;0;0;0;0;0;0;0;0
FR;5;2021-04-25;0;0;0;0;0;0;0;0;0;0;0;0;0;0;0;0;0;0
FR;5;2021-04-26;0;0;0;0;0;0;0;0;0;0;0;0;0;0;0;0;0;0
FR;5;2021-04-27;0;0;0;0;0;0;0;0;0;0;0;0;0;0;0;0;0;0
FR;5;2021-04-28;0;0;0;0;0;0;0;0;0;0;0;0;0;0;0;0;0;0
FR;5;2021-04-29;0;0;0;0;0;0;0;0;0;0;0;0;0;0;0;0;0;0
FR;5;2021-04-30;0;0;0;0;0;0;0;0;0;0;0;0;0;0;0;0;0;0
FR;5;2021-05-01;0;0;0;0;0;0;0;0;0;0;0;0;0;0;0;0;0;0
FR;5;2021-05-02;0;0;0;0;0;0;0;0;0;0;0;0;0;0;0;0;0;0
FR;5;2021-05-03;0;0;0;0;0;0;0;0;0;0;0;0;0;0;0;0;0;0
FR;5;2021-05-04;0;0;0;0;0;0;0;0;0;0;0;0;0;0;0;0;0;0
FR;5;2021-05-05;0;0;0;0;0;0;0;0;0;0;0;0;0;0;0;0;0;0
FR;5;2021-05-06;0;0;0;0;0;0;0;0;0;0;0;0;0;0;0;0;0;0
FR;5;2021-05-07;0;0;0;0;0;0;0;0;0;0;0;0;0;0;0;0;0;0
FR;5;2021-05-08;0;0;0;0;0;0;0;0;0;0;0;0;0;0;0;0;0;0
FR;5;2021-05-09;0;0;0;0;0;0;0;0;0;0;0;0;0;0;0;0;0;0
FR;5;2021-05-10;0;0;0;0;0;0;0;0;0;0;0;0;0;0;0;0;0;0
FR;5;2021-05-11;0;0;0;0;0;0;0;0;0;0;0;0;0;0;0;0;0;0
FR;5;2021-05-12;0;0;0;0;0;0;0;0;0;0;0;0;0;0;0;0;0;0
FR;5;2021-05-13;0;0;0;0;0;0;0;0;0;0;0;0;0;0;0;0;0;0
FR;5;2021-05-14;0;0;0;0;0;0;0;0;0;0;0;0;0;0;0;0;0;0
FR;5;2021-05-15;0;0;0;0;0;0;0;0;0;0;0;0;0;0;0;0;0;0
FR;5;2021-05-16;0;0;0;0;0;0;0;0;0;0;0;0;0;0;0;0;0;0
FR;5;2021-05-17;0;0;0;0;0;0;0;0;0;0;0;0;0;0;0;0;0;0
FR;5;2021-05-18;0;0;0;0;0;0;0;0;0;0;0;0;0;0;0;0;0;0
FR;5;2021-05-19;0;0;0;0;0;0;0;0;0;0;0;0;0;0;0;0;0;0
FR;5;2021-05-20;0;0;0;0;0;0;0;0;0;0;0;0;0;0;0;0;0;0
FR;5;2021-05-21;0;0;0;0;0;0;0;0;0;0;0;0;0;0;0;0;0;0
FR;5;2021-05-22;0;0;0;0;0;0;0;0;0;0;0;0;0;0;0;0;0;0
FR;5;2021-05-23;0;0;0;0;0;0;0;0;0;0;0;0;0;0;0;0;0;0
FR;5;2021-05-24;0;0;0;0;0;0;0;0;0;0;0;0;0;0;0;0;0;0
FR;5;2021-05-25;0;0;0;0;0;0;0;0;0;0;0;0;0;0;0;0;0;0
FR;5;2021-05-26;0;0;0;0;0;0;0;0;0;0;0;0;0;0;0;0;0;0
FR;5;2021-05-27;0;0;0;0;0;0;0;0;0;0;0;0;0;0;0;0;0;0
FR;5;2021-05-28;0;0;0;0;0;0;0;0;0;0;0;0;0;0;0;0;0;0
FR;5;2021-05-29;0;0;0;0;0;0;0;0;0;0;0;0;0;0;0;0;0;0
FR;5;2021-05-30;0;0;0;0;0;0;0;0;0;0;0;0;0;0;0;0;0;0
FR;5;2021-05-31;0;0;0;0;0;0;0;0;0;0;0;0;0;0;0;0;0;0
FR;5;2021-06-01;0;0;0;0;0;0;0;0;0;0;0;0;0;0;0;0;0;0
FR;5;2021-06-02;0;0;0;0;0;0;0;0;0;0;0;0;0;0;0;0;0;0
FR;5;2021-06-03;0;0;0;0;0;0;0;0;0;0;0;0;0;0;0;0;0;0
FR;5;2021-06-04;0;0;0;0;0;0;0;0;0;0;0;0;0;0;0;0;0;0
FR;5;2021-06-05;0;0;0;0;0;0;0;0;0;0;0;0;0;0;0;0;0;0
FR;5;2021-06-06;0;0;0;0;0;0;0;0;0;0;0;0;0;0;0;0;0;0
FR;5;2021-06-07;0;0;0;0;0;0;0;0;0;0;0;0;0;0;0;0;0;0
FR;5;2021-06-08;0;0;0;0;0;0;0;0;0;0;0;0;0;0;0;0;0;0
FR;5;2021-06-09;0;0;0;0;0;0;0;0;0;0;0;0;0;0;0;0;0;0
FR;5;2021-06-10;0;0;0;0;0;0;0;0;0;0;0;0;0;0;0;0;0;0
FR;5;2021-06-11;0;0;0;0;0;0;0;0;0;0;0;0;0;0;0;0;0;0
FR;5;2021-06-12;0;0;0;0;0;0;0;0;0;0;0;0;0;0;0;0;0;0
FR;5;2021-06-13;0;0;0;0;0;0;0;0;0;0;0;0;0;0;0;0;0;0
FR;5;2021-06-14;0;0;0;0;0;0;0;0;0;0;0;0;0;0;0;0;0;0
FR;5;2021-06-15;0;0;0;0;0;0;0;0;0;0;0;0;0;0;0;0;0;0
FR;5;2021-06-16;0;0;0;0;0;0;0;0;0;0;0;0;0;0;0;0;0;0
FR;5;2021-06-17;0;0;0;0;0;0;0;0;0;0;0;0;0;0;0;0;0;0
FR;5;2021-06-18;0;0;0;0;0;0;0;0;0;0;0;0;0;0;0;0;0;0
FR;5;2021-06-19;0;0;0;0;0;0;0;0;0;0;0;0;0;0;0;0;0;0
FR;5;2021-06-20;0;0;0;0;0;0;0;0;0;0;0;0;0;0;0;0;0;0
FR;5;2021-06-21;0;0;0;0;0;0;0;0;0;0;0;0;0;0;0;0;0;0
FR;5;2021-06-22;0;0;0;0;0;0;0;0;0;0;0;0;0;0;0;0;0;0
FR;5;2021-06-23;0;0;0;0;0;0;0;0;0;0;0;0;0;0;0;0;0;0
FR;5;2021-06-24;0;0;0;0;0;0;0;0;0;0;0;0;0;0;0;0;0;0
FR;5;2021-06-25;0;0;0;0;0;0;0;0;0;0;0;0;0;0;0;0;0;0
FR;5;2021-06-26;0;0;0;0;0;0;0;0;0;0;0;0;0;0;0;0;0;0
FR;5;2021-06-27;0;0;0;0;0;0;0;0;0;0;0;0;0;0;0;0;0;0
FR;5;2021-06-28;0;0;0;0;0;0;0;0;0;0;0;0;0;0;0;0;0;0
FR;5;2021-06-29;0;0;0;0;0;0;0;0;0;0;0;0;0;0;0;0;0;0
FR;5;2021-06-30;0;0;0;0;0;0;0;0;0;0;0;0;0;0;0;0;0;0
FR;5;2021-07-01;0;0;0;0;0;0;0;0;0;0;0;0;0;0;0;0;0;0
FR;5;2021-07-02;0;0;0;0;0;0;0;0;0;0;0;0;0;0;0;0;0;0
FR;5;2021-07-03;0;0;0;0;0;0;0;0;0;0;0;0;0;0;0;0;0;0
FR;5;2021-07-04;0;0;0;0;0;0;0;0;0;0;0;0;0;0;0;0;0;0
FR;5;2021-07-05;0;0;0;0;0;0;0;0;0;0;0;0;0;0;0;0;0;0
FR;5;2021-07-06;0;0;0;0;0;0;0;0;0;0;0;0;0;0;0;0;0;0
FR;5;2021-07-07;0;0;0;0;0;0;0;0;0;0;0;0;0;0;0;0;0;0
FR;5;2021-07-08;0;0;0;0;0;0;0;0;0;0;0;0;0;0;0;0;0;0
FR;5;2021-07-09;0;0;0;0;0;0;0;0;0;0;0;0;0;0;0;0;0;0
FR;5;2021-07-10;0;0;0;0;0;0;0;0;0;0;0;0;0;0;0;0;0;0
FR;5;2021-07-11;0;0;0;0;0;0;0;0;0;0;0;0;0;0;0;0;0;0
FR;5;2021-07-12;0;0;0;0;0;0;0;0;0;0;0;0;0;0;0;0;0;0
FR;5;2021-07-13;0;0;0;0;0;0;0;0;0;0;0;0;0;0;0;0;0;0
FR;5;2021-07-14;0;0;0;0;0;0;0;0;0;0;0;0;0;0;0;0;0;0
FR;5;2021-07-15;0;0;0;0;0;0;0;0;0;0;0;0;0;0;0;0;0;0
FR;5;2021-07-16;0;0;0;0;0;0;0;0;0;0;0;0;0;0;0;0;0;0
FR;5;2021-07-17;0;0;0;0;0;0;0;0;0;0;0;0;0;0;0;0;0;0
FR;5;2021-07-18;0;0;0;0;0;0;0;0;0;0;0;0;0;0;0;0;0;0
FR;5;2021-07-19;0;0;0;0;0;0;0;0;0;0;0;0;0;0;0;0;0;0
FR;5;2021-07-20;0;0;0;0;0;0;0;0;0;0;0;0;0;0;0;0;0;0
FR;5;2021-07-21;0;0;0;0;0;0;0;0;0;0;0;0;0;0;0;0;0;0
FR;5;2021-07-22;0;0;0;0;0;0;0;0;0;0;0;0;0;0;0;0;0;0
FR;5;2021-07-23;0;0;0;0;0;0;0;0;0;0;0;0;0;0;0;0;0;0
FR;5;2021-07-24;0;0;0;0;0;0;0;0;0;0;0;0;0;0;0;0;0;0
FR;5;2021-07-25;0;0;0;0;0;0;0;0;0;0;0;0;0;0;0;0;0;0
FR;5;2021-07-26;0;0;0;0;0;0;0;0;0;0;0;0;0;0;0;0;0;0
FR;5;2021-07-27;0;0;0;0;0;0;0;0;0;0;0;0;0;0;0;0;0;0
FR;5;2021-07-28;0;0;0;0;0;0;0;0;0;0;0;0;0;0;0;0;0;0
FR;5;2021-07-29;0;0;0;0;0;0;0;0;0;0;0;0;0;0;0;0;0;0
FR;5;2021-07-30;0;0;0;0;0;0;0;0;0;0;0;0;0;0;0;0;0;0
FR;5;2021-07-31;0;0;0;0;0;0;0;0;0;0;0;0;0;0;0;0;0;0
FR;5;2021-08-01;0;0;0;0;0;0;0;0;0;0;0;0;0;0;0;0;0;0
FR;5;2021-08-02;0;0;0;0;0;0;0;0;0;0;0;0;0;0;0;0;0;0
FR;5;2021-08-03;0;0;0;0;0;0;0;0;0;0;0;0;0;0;0;0;0;0
FR;5;2021-08-04;0;0;0;0;0;0;0;0;0;0;0;0;0;0;0;0;0;0
FR;5;2021-08-05;0;0;0;0;0;0;0;0;0;0;0;0;0;0;0;0;0;0
FR;5;2021-08-06;0;0;0;0;0;0;0;0;0;0;0;0;0;0;0;0;0;0
FR;5;2021-08-07;0;0;0;0;0;0;0;0;0;0;0;0;0;0;0;0;0;0
FR;5;2021-08-08;0;0;0;0;0;0;0;0;0;0;0;0;0;0;0;0;0;0
FR;5;2021-08-09;0;0;0;0;0;0;0;0;0;0;0;0;0;0;0;0;0;0
FR;5;2021-08-10;0;0;0;0;0;0;0;0;0;0;0;0;0;0;0;0;0;0
FR;5;2021-08-11;0;0;0;0;0;0;0;0;0;0;0;0;0;0;0;0;0;0
FR;5;2021-08-12;0;0;0;0;0;0;0;0;0;0;0;0;0;0;0;0;0;0
FR;5;2021-08-13;0;0;0;0;0;0;0;0;0;0;0;0;0;0;0;0;0;0
FR;5;2021-08-14;0;0;0;0;0;0;0;0;0;0;0;0;0;0;0;0;0;0
FR;5;2021-08-15;0;0;0;0;0;0;0;0;0;0;0;0;0;0;0;0;0;0
FR;5;2021-08-16;0;0;0;0;0;0;0;0;0;0;0;0;0;0;0;0;0;0
FR;5;2021-08-17;0;0;0;0;0;0;0;0;0;0;0;0;0;0;0;0;0;0
FR;5;2021-08-18;0;0;0;0;0;0;0;0;0;0;0;0;0;0;0;0;0;0
FR;5;2021-08-19;0;0;0;0;0;0;0;0;0;0;0;0;0;0;0;0;0;0
FR;5;2021-08-20;0;0;0;0;0;0;0;0;0;0;0;0;0;0;0;0;0;0
FR;5;2021-08-21;0;0;0;0;0;0;0;0;0;0;0;0;0;0;0;0;0;0
FR;5;2021-08-22;0;0;0;0;0;0;0;0;0;0;0;0;0;0;0;0;0;0
FR;5;2021-08-23;0;0;0;0;0;0;0;0;0;0;0;0;0;0;0;0;0;0
FR;5;2021-08-24;0;0;0;0;0;0;0;0;0;0;0;0;0;0;0;0;0;0
FR;5;2021-08-25;0;0;0;0;0;0;0;0;0;0;0;0;0;0;0;0;0;0
FR;5;2021-08-26;0;0;0;0;0;0;0;0;0;0;0;0;0;0;0;0;0;0
FR;5;2021-08-27;0;0;0;0;0;0;0;0;0;0;0;0;0;0;0;0;0;0
FR;5;2021-08-28;0;0;0;0;0;0;0;0;0;0;0;0;0;0;0;0;0;0
FR;5;2021-08-29;0;0;0;0;0;0;0;0;0;0;0;0;0;0;0;0;0;0
FR;5;2021-08-30;0;0;0;0;0;0;0;0;0;0;0;0;0;0;0;0;0;0
FR;5;2021-08-31;0;0;0;0;0;0;0;0;0;0;0;0;0;0;0;0;0;0
FR;5;2021-09-01;0;0;0;0;0;0;0;0;0;0;0;0;0;0;0;0;0;0
FR;5;2021-09-02;0;0;0;0;0;0;0;0;0;0;0;0;0;0;0;0;0;0
FR;5;2021-09-03;0;0;0;0;0;0;0;0;0;0;0;0;0;0;0;0;0;0
FR;5;2021-09-04;0;0;0;0;0;0;0;0;0;0;0;0;0;0;0;0;0;0
FR;5;2021-09-05;0;0;0;0;0;0;0;0;0;0;0;0;0;0;0;0;0;0
FR;5;2021-09-06;0;0;0;0;0;0;0;0;0;0;0;0;0;0;0;0;0;0
FR;5;2021-09-07;0;0;0;0;0;0;0;0;0;0;0;0;0;0;0;0;0;0
FR;5;2021-09-08;0;0;0;0;0;0;0;0;0;0;0;0;0;0;0;0;0;0
FR;5;2021-09-09;0;0;0;0;0;0;0;0;0;0;0;0;0;0;0;0;0;0
FR;5;2021-09-10;0;0;0;0;0;0;0;0;0;0;0;0;0;0;0;0;0;0
FR;5;2021-09-11;0;0;0;0;0;0;0;0;0;0;0;0;0;0;0;0;0;0
FR;5;2021-09-12;0;0;0;0;0;0;0;0;0;0;0;0;0;0;0;0;0;0
FR;5;2021-09-13;0;0;0;0;0;0;0;0;0;0;0;0;0;0;0;0;0;0
FR;5;2021-09-14;0;0;0;0;0;0;0;0;0;0;0;0;0;0;0;0;0;0
FR;5;2021-09-15;0;0;0;0;0;0;0;0;0;0;0;0;0;0;0;0;0;0
FR;5;2021-09-16;0;0;0;0;0;0;0;0;0;0;0;0;0;0;0;0;0;0
FR;5;2021-09-17;0;0;0;0;0;0;0;0;0;0;0;0;0;0;0;0;0;0
FR;5;2021-09-18;0;0;0;0;0;0;0;0;0;0;0;0;0;0;0;0;0;0
FR;5;2021-09-19;0;0;0;0;0;0;0;0;0;0;0;0;0;0;0;0;0;0
FR;5;2021-09-20;0;0;0;0;0;0;0;0;0;0;0;0;0;0;0;0;0;0
FR;5;2021-09-21;0;0;0;0;0;0;0;0;0;0;0;0;0;0;0;0;0;0
FR;5;2021-09-22;0;0;0;0;0;0;0;0;0;0;0;0;0;0;0;0;0;0
FR;5;2021-09-23;0;0;0;0;0;0;0;0;0;0;0;0;0;0;0;0;0;0
FR;5;2021-09-24;0;0;0;0;0;0;0;0;0;0;0;0;0;0;0;0;0;0
FR;5;2021-09-25;0;0;0;0;0;0;0;0;0;0;0;0;0;0;0;0;0;0
FR;5;2021-09-26;0;0;0;0;0;0;0;0;0;0;0;0;0;0;0;0;0;0
FR;5;2021-09-27;0;0;0;0;0;0;0;0;0;0;0;0;0;0;0;0;0;0
FR;5;2021-09-28;0;0;0;0;0;0;0;0;0;0;0;0;0;0;0;0;0;0
FR;5;2021-09-29;0;0;0;0;0;0;0;0;0;0;0;0;0;0;0;0;0;0
FR;5;2021-09-30;0;0;0;0;0;0;0;0;0;0;0;0;0;0;0;0;0;0
FR;5;2021-10-01;0;0;0;0;0;0;0;0;0;0;0;0;0;0;0;0;0;0
FR;5;2021-10-02;0;0;0;0;0;0;0;0;0;0;0;0;0;0;0;0;0;0
FR;5;2021-10-03;0;0;0;0;0;0;0;0;0;0;0;0;0;0;0;0;0;0
FR;5;2021-10-04;0;0;0;0;0;0;0;0;0;0;0;0;0;0;0;0;0;0
FR;5;2021-10-05;0;0;0;0;0;0;0;0;0;0;0;0;0;0;0;0;0;0
FR;5;2021-10-06;0;0;0;0;0;0;0;0;0;0;0;0;0;0;0;0;0;0
FR;5;2021-10-07;0;0;0;0;0;0;0;0;0;0;0;0;0;0;0;0;0;0
FR;5;2021-10-08;0;0;0;0;0;0;0;0;0;0;0;0;0;0;0;0;0;0
FR;5;2021-10-09;0;0;0;0;0;0;0;0;0;0;0;0;0;0;0;0;0;0
FR;5;2021-10-10;0;0;0;0;0;0;0;0;0;0;0;0;0;0;0;0;0;0
FR;5;2021-10-11;0;0;0;0;0;0;0;0;0;0;0;0;0;0;0;0;0;0
FR;5;2021-10-12;0;0;0;0;0;0;0;0;0;0;0;0;0;0;0;0;0;0
FR;5;2021-10-13;0;0;0;0;0;0;0;0;0;0;0;0;0;0;0;0;0;0
FR;5;2021-10-14;0;0;0;0;0;0;0;0;0;0;0;0;0;0;0;0;0;0
FR;5;2021-10-15;0;0;0;0;0;0;0;0;0;0;0;0;0;0;0;0;0;0
FR;5;2021-10-16;0;0;0;0;0;0;0;0;0;0;0;0;0;0;0;0;0;0
FR;5;2021-10-17;0;0;0;0;0;0;0;0;0;0;0;0;0;0;0;0;0;0
FR;5;2021-10-18;0;0;0;0;0;0;0;0;0;0;0;0;0;0;0;0;0;0
FR;5;2021-10-19;0;0;0;0;0;0;0;0;0;0;0;0;0;0;0;0;0;0
FR;5;2021-10-20;0;0;0;0;0;0;0;0;0;0;0;0;0;0;0;0;0;0
FR;5;2021-10-21;0;0;0;0;0;0;0;0;0;0;0;0;0;0;0;0;0;0
FR;5;2021-10-22;0;0;0;0;0;0;0;0;0;0;0;0;0;0;0;0;0;0
FR;5;2021-10-23;0;0;0;0;0;0;0;0;0;0;0;0;0;0;0;0;0;0
FR;5;2021-10-24;0;0;0;0;0;0;0;0;0;0;0;0;0;0;0;0;0;0
FR;5;2021-10-25;0;0;0;0;0;0;0;0;0;0;0;0;0;0;0;0;0;0
FR;5;2021-10-26;0;0;0;0;0;0;0;0;0;0;0;0;0;0;0;0;0;0
FR;5;2021-10-27;0;0;0;0;0;0;0;0;0;0;0;0;0;0;0;0;0;0
FR;5;2021-10-28;0;0;0;0;0;0;0;0;0;0;0;0;0;0;0;0;0;0
FR;5;2021-10-29;0;0;0;0;0;0;0;0;0;0;0;0;0;0;0;0;0;0
FR;5;2021-10-30;0;0;0;0;0;0;0;0;0;0;0;0;0;0;0;0;0;0
FR;5;2021-10-31;0;0;0;0;0;0;0;0;0;0;0;0;0;0;0;0;0;0
FR;5;2021-11-01;0;0;0;0;0;0;0;0;0;0;0;0;0;0;0;0;0;0
FR;5;2021-11-02;0;0;0;0;0;0;0;0;0;0;0;0;0;0;0;0;0;0
FR;5;2021-11-03;0;0;0;0;0;0;0;0;0;0;0;0;0;0;0;0;0;0
FR;5;2021-11-04;0;0;0;0;0;0;0;0;0;0;0;0;0;0;0;0;0;0
FR;5;2021-11-05;0;0;0;0;0;0;0;0;0;0;0;0;0;0;0;0;0;0
FR;5;2021-11-06;0;0;0;0;0;0;0;0;0;0;0;0;0;0;0;0;0;0
FR;5;2021-11-07;0;0;0;0;0;0;0;0;0;0;0;0;0;0;0;0;0;0
FR;5;2021-11-08;0;0;0;0;0;0;0;0;0;0;0;0;0;0;0;0;0;0
FR;5;2021-11-09;0;0;0;0;0;0;0;0;0;0;0;0;0;0;0;0;0;0
FR;5;2021-11-10;0;0;0;0;0;0;0;0;0;0;0;0;0;0;0;0;0;0
FR;5;2021-11-11;0;0;0;0;0;0;0;0;0;0;0;0;0;0;0;0;0;0
FR;5;2021-11-12;0;0;0;0;0;0;0;0;0;0;0;0;0;0;0;0;0;0
FR;5;2021-11-13;0;0;0;0;0;0;0;0;0;0;0;0;0;0;0;0;0;0
FR;5;2021-11-14;0;0;0;0;0;0;0;0;0;0;0;0;0;0;0;0;0;0
FR;5;2021-11-15;0;0;0;0;0;0;0;0;0;0;0;0;0;0;0;0;0;0
FR;5;2021-11-16;0;0;0;0;0;0;0;0;0;0;0;0;0;0;0;0;0;0
FR;5;2021-11-17;0;0;0;0;0;0;0;0;0;0;0;0;0;0;0;0;0;0
FR;5;2021-11-18;0;0;0;0;0;0;0;0;0;0;0;0;0;0;0;0;0;0
FR;5;2021-11-19;0;0;0;0;0;0;0;0;0;0;0;0;0;0;0;0;0;0
FR;5;2021-11-20;0;0;0;0;0;0;0;0;0;0;0;0;0;0;0;0;0;0
FR;5;2021-11-21;0;0;0;0;0;0;0;0;0;0;0;0;0;0;0;0;0;0
FR;5;2021-11-22;0;0;0;0;0;0;0;0;0;0;0;0;0;0;0;0;0;0
FR;5;2021-11-23;0;0;0;0;0;0;0;0;0;0;0;0;0;0;0;0;0;0
FR;5;2021-11-24;0;0;0;0;0;0;0;0;0;0;0;0;0;0;0;0;0;0
FR;5;2021-11-25;0;0;0;0;0;0;0;0;0;0;0;0;0;0;0;0;0;0
FR;5;2021-11-26;0;0;0;0;0;0;0;0;0;0;0;0;0;0;0;0;0;0
FR;5;2021-11-27;0;0;0;0;0;0;0;0;0;0;0;0;0;0;0;0;0;0
FR;5;2021-11-28;0;0;0;0;0;0;0;0;0;0;0;0;0;0;0;0;0;0
FR;5;2021-11-29;0;0;0;0;0;0;0;0;0;0;0;0;0;0;0;0;0;0
FR;5;2021-11-30;0;0;0;0;0;0;0;0;0;0;0;0;0;0;0;0;0;0
FR;5;2021-12-01;0;0;0;0;0;0;0;0;0;0;0;0;0;0;0;0;0;0
FR;5;2021-12-02;0;0;0;0;0;0;0;0;0;0;0;0;0;0;0;0;0;0
FR;5;2021-12-03;0;0;0;0;0;0;0;0;0;0;0;0;0;0;0;0;0;0
FR;5;2021-12-04;0;0;0;0;0;0;0;0;0;0;0;0;0;0;0;0;0;0
FR;5;2021-12-05;0;0;0;0;0;0;0;0;0;0;0;0;0;0;0;0;0;0
FR;5;2021-12-06;0;0;0;0;0;0;0;0;0;0;0;0;0;0;0;0;0;0
FR;5;2021-12-07;0;0;0;0;0;0;0;0;0;0;0;0;0;0;0;0;0;0
FR;5;2021-12-08;0;0;0;0;0;0;0;0;0;0;0;0;0;0;0;0;0;0
FR;5;2021-12-09;0;0;0;0;0;0;0;0;0;0;0;0;0;0;0;0;0;0
FR;5;2021-12-10;0;0;0;0;0;0;0;0;0;0;0;0;0;0;0;0;0;0
FR;5;2021-12-11;0;0;0;0;0;0;0;0;0;0;0;0;0;0;0;0;0;0
FR;5;2021-12-12;0;0;0;0;0;0;0;0;0;0;0;0;0;0;0;0;0;0
FR;5;2021-12-13;0;0;0;0;0;0;0;0;0;0;0;0;0;0;0;0;0;0
FR;5;2021-12-14;33;45;77;0;27;88;1;0;0;33;45;77;0;27;88;1;0;0
FR;5;2021-12-15;196;44;37;0;42;49;0;0;0;229;89;114;0;69;137;1;0;0
FR;5;2021-12-16;181;21;44;0;38;48;0;0;0;410;110;158;0;107;185;1;0;0
FR;5;2021-12-17;313;16;72;0;34;74;2;0;0;723;126;230;0;141;259;3;0;0
FR;5;2021-12-18;766;24;22;0;67;29;0;0;0;1489;150;252;0;208;288;3;0;0
FR;5;2021-12-19;585;15;15;0;67;17;0;0;0;2074;165;267;0;275;305;3;0;0
FR;5;2021-12-20;1225;31;34;0;134;37;2;0;0;3299;196;301;0;409;342;5;0;0
FR;5;2021-12-21;1535;22;54;1;141;60;0;0;0;4834;218;355;1;550;402;5;0;0
FR;5;2021-12-22;4069;40;37;0;420;46;2;0;0;8903;258;392;1;970;448;7;0;0
FR;5;2021-12-23;3043;16;21;0;305;25;0;0;0;11946;274;413;1;1275;473;7;0;0
FR;5;2021-12-24;761;18;9;0;103;14;0;0;0;12707;292;422;1;1378;487;7;0;0
FR;5;2021-12-25;61;5;2;0;9;3;0;0;0;12768;297;424;1;1387;490;7;0;0
FR;5;2021-12-26;623;6;3;0;101;4;0;0;0;13391;303;427;1;1488;494;7;0;0
FR;5;2021-12-27;4085;25;21;0;460;23;1;0;0;17476;328;448;1;1948;517;8;0;0
FR;5;2021-12-28;5204;23;41;1;513;43;2;0;0;22680;351;489;2;2461;560;10;0;0
FR;5;2021-12-29;8105;34;66;1;888;69;0;0;0;30785;385;555;3;3349;629;10;0;0
FR;5;2021-12-30;5173;18;33;0;525;39;0;0;0;35958;403;588;3;3874;668;10;0;0
FR;5;2021-12-31;1554;8;10;0;182;11;0;0;0;37512;411;598;3;4056;679;10;0;0
FR;5;2022-01-01;186;2;2;0;24;3;0;0;0;37698;413;600;3;4080;682;10;0;0
FR;5;2022-01-02;1489;1;1;0;152;1;0;0;0;39187;414;601;3;4232;683;10;0;0
FR;5;2022-01-03;3069;36;34;0;323;33;1;0;0;42256;450;635;3;4555;716;11;0;0
FR;5;2022-01-04;3034;39;33;0;322;42;3;0;0;45290;489;668;3;4877;758;14;0;0
FR;5;2022-01-05;19324;203;97;1;2118;108;0;0;0;64614;692;765;4;6995;866;14;0;0
FR;5;2022-01-06;3748;134;122;0;507;142;2;0;0;68362;826;887;4;7502;1008;16;0;0
FR;5;2022-01-07;5006;202;48;2;705;56;1;0;0;73368;1028;935;6;8207;1064;17;0;0
FR;5;2022-01-08;13659;514;45;0;2003;52;0;0;0;87027;1542;980;6;10210;1116;17;0;0
FR;5;2022-01-09;5754;399;15;0;1112;20;1;0;0;92781;1941;995;6;11322;1136;18;0;0
FR;5;2022-01-10;3455;326;25;0;735;29;0;0;0;96236;2267;1020;6;12057;1165;18;0;0
FR;5;2022-01-11;3671;283;38;0;661;41;1;0;0;99907;2550;1058;6;12718;1206;19;0;0
FR;5;2022-01-12;22650;3005;89;0;5297;112;2;0;0;122557;5555;1147;6;18015;1318;21;0;0
FR;5;2022-01-13;4039;623;29;0;1052;31;2;0;0;126596;6178;1176;6;19067;1349;23;0;0
FR;5;2022-01-14;4843;583;45;0;1115;52;1;0;0;131439;6761;1221;6;20182;1401;24;0;0
FR;5;2022-01-15;14686;1747;38;3;3378;49;3;0;0;146125;8508;1259;9;23560;1450;27;0;0
FR;5;2022-01-16;4728;666;3;0;1261;5;0;0;0;150853;9174;1262;9;24821;1455;27;0;0
FR;5;2022-01-17;2297;718;26;0;986;29;0;0;0;153150;9892;1288;9;25807;1484;27;0;0
FR;5;2022-01-18;2431;870;30;0;1141;40;0;0;0;155581;10762;1318;9;26948;1524;27;0;0
FR;5;2022-01-19;18484;6423;74;2;8366;142;3;0;0;174065;17185;1392;11;35314;1666;30;0;0
FR;5;2022-01-20;1920;1067;25;0;1295;34;2;0;0;175985;18252;1417;11;36609;1700;32;0;0
FR;5;2022-01-21;3077;1372;47;1;1677;59;2;0;0;179062;19624;1464;12;38286;1759;34;0;0
FR;5;2022-01-22;10720;3454;33;1;4671;43;1;0;0;189782;23078;1497;13;42957;1802;35;0;0
FR;5;2022-01-23;2629;1415;6;0;1789;10;0;0;0;192411;24493;1503;13;44746;1812;35;0;0
FR;5;2022-01-24;1161;1341;19;0;1447;23;1;0;0;193572;25834;1522;13;46193;1835;36;0;0
FR;5;2022-01-25;1220;1550;20;2;1684;31;3;0;0;194792;27384;1542;15;47877;1866;39;0;0
FR;5;2022-01-26;10748;12032;50;1;13300;89;1;0;1;205540;39416;1592;16;61177;1955;40;0;1
FR;5;2022-01-27;1291;1693;10;0;1838;17;0;0;0;206831;41109;1602;16;63015;1972;40;0;1
FR;5;2022-01-28;1698;3346;16;0;3566;19;1;0;0;208529;44455;1618;16;66581;1991;41;0;1
FR;5;2022-01-29;6241;8041;68;0;8855;96;2;0;0;214770;52496;1686;16;75436;2087;43;0;1
FR;5;2022-01-30;1509;2950;5;0;3185;18;0;0;0;216279;55446;1691;16;78621;2105;43;0;1
FR;5;2022-01-31;589;1773;23;0;1837;24;3;0;0;216868;57219;1714;16;80458;2129;46;0;1
FR;5;2022-02-01;712;1706;10;0;1791;15;0;0;0;217580;58925;1724;16;82249;2144;46;0;1
FR;5;2022-02-02;6959;15655;52;0;16603;94;0;0;0;224539;74580;1776;16;98852;2238;46;0;1
FR;5;2022-02-03;492;1691;14;0;1748;13;5;0;0;225031;76271;1790;16;100600;2251;51;0;1
FR;5;2022-02-04;945;3002;19;0;3123;31;0;0;0;225976;79273;1809;16;103723;2282;51;0;1
FR;5;2022-02-05;3536;8919;23;0;9517;37;0;0;0;229512;88192;1832;16;113240;2319;51;0;1
FR;5;2022-02-06;737;2398;10;0;2556;19;0;0;0;230249;90590;1842;16;115796;2338;51;0;1
FR;5;2022-02-07;884;1596;23;0;1715;25;2;0;0;231133;92186;1865;16;117511;2363;53;0;1
FR;5;2022-02-08;725;1287;18;0;1407;20;2;0;0;231858;93473;1883;16;118918;2383;55;0;1
FR;5;2022-02-09;4544;12880;44;0;13608;76;1;0;0;236402;106353;1927;16;132526;2459;56;0;1
FR;5;2022-02-10;646;1059;14;0;1166;15;0;0;0;237048;107412;1941;16;133692;2474;56;0;1
FR;5;2022-02-11;793;2032;16;0;2163;21;1;0;0;237841;109444;1957;16;135855;2495;57;0;1
FR;5;2022-02-12;2286;6812;33;0;7279;53;0;0;0;240127;116256;1990;16;143134;2548;57;0;1
FR;5;2022-02-13;464;1541;8;0;1654;8;1;0;0;240591;117797;1998;16;144788;2556;58;0;1
FR;5;2022-02-14;678;1288;10;0;1407;13;1;0;0;241269;119085;2008;16;146195;2569;59;0;1
FR;5;2022-02-15;482;886;9;0;968;14;1;0;0;241751;119971;2017;16;147163;2583;60;0;1
FR;5;2022-02-16;2980;9124;41;1;9676;58;2;0;0;244731;129095;2058;17;156839;2641;62;0;1
FR;5;2022-02-17;436;809;6;0;876;7;1;0;0;245167;129904;2064;17;157715;2648;63;0;1
FR;5;2022-02-18;649;1408;13;0;1535;17;0;0;0;245816;131312;2077;17;159250;2665;63;0;1
FR;5;2022-02-19;1373;4315;16;0;4623;28;0;0;0;247189;135627;2093;17;163873;2693;63;0;1
FR;5;2022-02-20;247;879;6;0;941;8;0;0;0;247436;136506;2099;17;164814;2701;63;0;1
FR;5;2022-02-21;221;607;2;0;661;4;1;0;0;247657;137113;2101;17;165475;2705;64;0;1
FR;5;2022-02-22;262;545;17;0;591;17;1;0;0;247919;137658;2118;17;166066;2722;65;0;1
FR;5;2022-02-23;1909;6926;23;1;7346;43;0;0;0;249828;144584;2141;18;173412;2765;65;0;1
FR;5;2022-02-24;182;374;6;1;421;7;1;0;0;250010;144958;2147;19;173833;2772;66;0;1
FR;5;2022-02-25;336;951;13;0;1028;12;2;0;0;250346;145909;2160;19;174861;2784;68;0;1
FR;5;2022-02-26;972;3071;11;0;3333;15;2;0;0;251318;148980;2171;19;178194;2799;70;0;1
FR;5;2022-02-27;151;506;0;0;549;3;0;0;0;251469;149486;2171;19;178743;2802;70;0;1
FR;5;2022-02-28;162;369;1;0;408;1;0;0;0;251631;149855;2172;19;179151;2803;70;0;1
FR;5;2022-03-01;130;280;6;0;315;7;1;0;0;251761;150135;2178;19;179466;2810;71;0;1
FR;5;2022-03-02;1242;4156;28;2;4497;40;2;0;0;253003;154291;2206;21;183963;2850;73;0;1
FR;5;2022-03-03;121;251;5;0;271;10;1;0;0;253124;154542;2211;21;184234;2860;74;0;1
FR;5;2022-03-04;197;488;13;0;538;14;2;0;0;253321;155030;2224;21;184772;2874;76;0;1
FR;5;2022-03-05;677;1990;8;0;2243;16;2;0;0;253998;157020;2232;21;187015;2890;78;0;1
FR;5;2022-03-06;108;260;0;0;310;0;0;0;0;254106;157280;2232;21;187325;2890;78;0;1
FR;5;2022-03-07;71;228;5;0;254;3;2;0;0;254177;157508;2237;21;187579;2893;80;0;1
FR;5;2022-03-08;46;134;7;1;141;8;3;0;0;254223;157642;2244;22;187720;2901;83;0;1
FR;5;2022-03-09;911;3078;24;0;3407;36;0;0;0;255134;160720;2268;22;191127;2937;83;0;1
FR;5;2022-03-10;82;202;9;0;216;13;3;0;0;255216;160922;2277;22;191343;2950;86;0;1
FR;5;2022-03-11;148;369;13;1;426;15;0;0;0;255364;161291;2290;23;191769;2965;86;0;1
FR;5;2022-03-12;758;1613;13;1;1977;30;0;0;0;256122;162904;2303;24;193746;2995;86;0;1
FR;5;2022-03-13;78;102;0;0;135;0;0;0;0;256200;163006;2303;24;193881;2995;86;0;1
FR;5;2022-03-14;69;119;7;1;139;7;1;0;0;256269;163125;2310;25;194020;3002;87;0;1
FR;5;2022-03-15;83;99;4;0;119;7;1;0;0;256352;163224;2314;25;194139;3009;88;0;1
FR;5;2022-03-16;882;1827;15;3;2227;36;7;0;0;257234;165051;2329;28;196366;3045;95;0;1
FR;5;2022-03-17;68;123;8;4;151;10;4;0;0;257302;165174;2337;32;196517;3055;99;0;1
FR;5;2022-03-18;172;318;14;4;391;19;4;0;0;257474;165492;2351;36;196908;3074;103;0;1
FR;5;2022-03-19;752;1163;12;5;1555;33;8;0;0;258226;166655;2363;41;198463;3107;111;0;1
FR;5;2022-03-20;45;93;1;0;119;1;0;0;0;258271;166748;2364;41;198582;3108;111;0;1
FR;5;2022-03-21;71;120;10;6;136;15;8;0;0;258342;166868;2374;47;198718;3123;119;0;1
FR;5;2022-03-22;56;119;8;7;143;9;6;0;0;258398;166987;2382;54;198861;3132;125;0;1
FR;5;2022-03-23;805;1461;14;8;1878;36;9;0;0;259203;168448;2396;62;200739;3168;134;0;1
FR;5;2022-03-24;71;93;8;7;118;7;10;0;0;259274;168541;2404;69;200857;3175;144;0;1
FR;5;2022-03-25;222;293;14;8;388;18;9;0;0;259496;168834;2418;77;201245;3193;153;0;1
FR;5;2022-03-26;707;853;12;5;1273;26;6;0;1;260203;169687;2430;82;202518;3219;159;0;2
FR;5;2022-03-27;76;81;0;0;124;3;0;0;0;260279;169768;2430;82;202642;3222;159;0;2
FR;5;2022-03-28;81;93;1;2;132;3;2;0;0;260360;169861;2431;84;202774;3225;161;0;2
FR;5;2022-03-29;71;83;10;4;114;12;5;0;0;260431;169944;2441;88;202888;3237;166;0;2
FR;5;2022-03-30;823;1116;16;13;1604;29;14;0;0;261254;171060;2457;101;204492;3266;180;0;2
FR;5;2022-03-31;102;125;1;4;173;6;4;0;0;261356;171185;2458;105;204665;3272;184;0;2
FR;5;2022-04-01;114;86;7;12;135;11;12;0;1;261470;171271;2465;117;204800;3283;196;0;3
FR;5;2022-04-02;330;349;3;3;535;15;4;0;0;261800;171620;2468;120;205335;3298;200;0;3
FR;5;2022-04-03;54;59;1;0;88;1;0;0;0;261854;171679;2469;120;205423;3299;200;0;3
FR;5;2022-04-04;40;57;4;1;70;8;2;0;0;261894;171736;2473;121;205493;3307;202;0;3
FR;5;2022-04-05;53;60;6;6;75;9;5;0;0;261947;171796;2479;127;205568;3316;207;0;3
FR;5;2022-04-06;421;439;7;14;678;16;14;0;0;262368;172235;2486;141;206246;3332;221;0;3
FR;5;2022-04-07;45;69;5;7;89;7;10;0;0;262413;172304;2491;148;206335;3339;231;0;3
FR;5;2022-04-08;134;112;12;13;175;14;15;0;0;262547;172416;2503;161;206510;3353;246;0;3
FR;5;2022-04-09;311;324;2;5;511;17;5;0;0;262858;172740;2505;166;207021;3370;251;0;3
FR;5;2022-04-10;44;31;2;0;61;2;1;0;0;262902;172771;2507;166;207082;3372;252;0;3
FR;5;2022-04-11;50;60;3;2;78;4;3;0;0;262952;172831;2510;168;207160;3376;255;0;3
FR;5;2022-04-12;59;54;3;3;78;5;3;0;0;263011;172885;2513;171;207238;3381;258;0;3
FR;5;2022-04-13;382;413;3;8;606;16;8;0;0;263393;173298;2516;179;207844;3397;266;0;3
FR;5;2022-04-14;48;53;5;5;70;9;3;0;0;263441;173351;2521;184;207914;3406;269;0;3
FR;5;2022-04-15;91;111;4;4;152;5;6;0;0;263532;173462;2525;188;208066;3411;275;0;3
FR;5;2022-04-16;188;184;2;1;265;13;1;0;0;263720;173646;2527;189;208331;3424;276;0;3
FR;5;2022-04-17;12;11;1;0;17;1;0;0;0;263732;173657;2528;189;208348;3425;276;0;3
FR;5;2022-04-18;9;10;2;0;11;3;1;0;0;263741;173667;2530;189;208359;3428;277;0;3
FR;5;2022-04-19;75;71;6;1;96;6;4;0;0;263816;173738;2536;190;208455;3434;281;0;3
FR;5;2022-04-20;361;349;9;6;521;12;7;0;0;264177;174087;2545;196;208976;3446;288;0;3
FR;5;2022-04-21;42;64;9;10;71;12;14;0;0;264219;174151;2554;206;209047;3458;302;0;3
FR;5;2022-04-22;113;96;5;4;144;5;5;0;0;264332;174247;2559;210;209191;3463;307;0;3
FR;5;2022-04-23;209;193;4;2;284;11;3;0;0;264541;174440;2563;212;209475;3474;310;0;3
FR;5;2022-04-24;37;35;0;0;50;3;0;0;0;264578;174475;2563;212;209525;3477;310;0;3
FR;5;2022-04-25;69;65;1;1;102;4;1;0;0;264647;174540;2564;213;209627;3481;311;0;3
FR;5;2022-04-26;60;63;2;1;85;5;1;0;0;264707;174603;2566;214;209712;3486;312;0;3
FR;5;2022-04-27;335;316;3;7;463;14;8;0;0;265042;174919;2569;221;210175;3500;320;0;3
FR;5;2022-04-28;81;54;4;5;81;8;7;0;0;265123;174973;2573;226;210256;3508;327;0;3
FR;5;2022-04-29;117;84;5;19;118;12;17;0;0;265240;175057;2578;245;210374;3520;344;0;3
FR;5;2022-04-30;183;114;2;3;184;10;4;0;0;265423;175171;2580;248;210558;3530;348;0;3
FR;5;2022-05-01;11;7;0;0;11;0;0;0;0;265434;175178;2580;248;210569;3530;348;0;3
FR;5;2022-05-02;52;28;4;5;48;2;7;0;0;265486;175206;2584;253;210617;3532;355;0;3
FR;5;2022-05-03;87;57;2;4;84;11;4;0;0;265573;175263;2586;257;210701;3543;359;0;3
FR;5;2022-05-04;278;205;1;2;324;7;2;0;0;265851;175468;2587;259;211025;3550;361;0;3
FR;5;2022-05-05;62;32;3;4;46;5;4;0;0;265913;175500;2590;263;211071;3555;365;0;3
FR;5;2022-05-06;105;65;2;3;106;5;3;0;0;266018;175565;2592;266;211177;3560;368;0;3
FR;5;2022-05-07;171;117;2;10;180;13;7;0;0;266189;175682;2594;276;211357;3573;375;0;3
FR;5;2022-05-08;8;8;0;0;9;2;0;0;0;266197;175690;2594;276;211366;3575;375;0;3
FR;5;2022-05-09;44;34;15;3;51;16;4;0;0;266241;175724;2609;279;211417;3591;379;0;3
FR;5;2022-05-10;54;49;3;4;67;5;5;0;0;266295;175773;2612;283;211484;3596;384;0;3
FR;5;2022-05-11;327;237;12;7;344;21;11;0;0;266622;176010;2624;290;211828;3617;395;0;3
FR;5;2022-05-12;46;34;2;2;47;2;3;0;0;266668;176044;2626;292;211875;3619;398;0;3
FR;5;2022-05-13;109;83;3;8;120;8;7;0;0;266777;176127;2629;300;211995;3627;405;0;3
FR;5;2022-05-14;209;131;0;1;212;8;0;0;0;266986;176258;2629;301;212207;3635;405;0;3
FR;5;2022-05-15;22;9;2;0;18;1;1;0;0;267008;176267;2631;301;212225;3636;406;0;3
FR;5;2022-05-16;52;34;4;5;53;4;5;0;0;267060;176301;2635;306;212278;3640;411;0;3
FR;5;2022-05-17;72;40;5;0;68;2;3;0;0;267132;176341;2640;306;212346;3642;414;0;3
FR;5;2022-05-18;289;215;4;4;330;8;6;0;0;267421;176556;2644;310;212676;3650;420;0;3
FR;5;2022-05-19;45;35;5;3;42;3;4;0;0;267466;176591;2649;313;212718;3653;424;0;3
FR;5;2022-05-20;76;63;3;10;92;1;11;0;0;267542;176654;2652;323;212810;3654;435;0;3
FR;5;2022-05-21;242;166;2;3;268;17;1;0;0;267784;176820;2654;326;213078;3671;436;0;3
FR;5;2022-05-22;20;14;2;5;20;2;6;0;0;267804;176834;2656;331;213098;3673;442;0;3
FR;5;2022-05-23;42;31;4;3;42;6;3;0;0;267846;176865;2660;334;213140;3679;445;0;3
FR;5;2022-05-24;47;45;3;2;60;5;2;0;0;267893;176910;2663;336;213200;3684;447;0;3
FR;5;2022-05-25;329;258;4;1;386;16;1;0;0;268222;177168;2667;337;213586;3700;448;0;3
FR;5;2022-05-26;17;5;0;1;9;2;0;0;1;268239;177173;2667;338;213595;3702;448;0;4
FR;5;2022-05-27;99;54;4;4;89;9;3;0;0;268338;177227;2671;342;213684;3711;451;0;4
FR;5;2022-05-28;100;78;5;3;106;10;3;0;0;268438;177305;2676;345;213790;3721;454;0;4
FR;5;2022-05-29;14;14;1;0;18;2;0;0;0;268452;177319;2677;345;213808;3723;454;0;4
FR;5;2022-05-30;56;41;2;1;54;2;2;0;0;268508;177360;2679;346;213862;3725;456;0;4
FR;5;2022-05-31;57;43;1;8;62;1;8;0;0;268565;177403;2680;354;213924;3726;464;0;4
FR;5;2022-06-01;257;241;9;2;302;25;5;0;0;268822;177644;2689;356;214226;3751;469;0;4
FR;5;2022-06-02;63;61;5;0;73;9;1;0;0;268885;177705;2694;356;214299;3760;470;0;4
FR;5;2022-06-03;83;71;4;5;88;10;6;0;0;268968;177776;2698;361;214387;3770;476;0;4
FR;5;2022-06-04;157;109;2;1;187;9;1;0;0;269125;177885;2700;362;214574;3779;477;0;4
FR;5;2022-06-05;18;11;0;0;21;1;0;0;0;269143;177896;2700;362;214595;3780;477;0;4
FR;5;2022-06-06;16;12;0;1;15;0;1;0;0;269159;177908;2700;363;214610;3780;478;0;4
FR;5;2022-06-07;50;56;1;1;76;2;1;0;0;269209;177964;2701;364;214686;3782;479;0;4
FR;5;2022-06-08;283;225;3;4;332;17;2;0;0;269492;178189;2704;368;215018;3799;481;0;4
FR;5;2022-06-09;52;41;6;3;57;7;2;0;1;269544;178230;2710;371;215075;3806;483;0;5
FR;5;2022-06-10;81;72;1;1;105;6;1;0;0;269625;178302;2711;372;215180;3812;484;0;5
FR;5;2022-06-11;173;141;3;3;202;10;4;0;0;269798;178443;2714;375;215382;3822;488;0;5
FR;5;2022-06-12;17;16;0;0;19;2;0;0;0;269815;178459;2714;375;215401;3824;488;0;5
FR;5;2022-06-13;56;47;9;3;70;10;6;0;0;269871;178506;2723;378;215471;3834;494;0;5
FR;5;2022-06-14;59;56;1;4;64;6;4;0;0;269930;178562;2724;382;215535;3840;498;0;5
FR;5;2022-06-15;266;260;5;2;363;27;1;0;0;270196;178822;2729;384;215898;3867;499;0;5
FR;5;2022-06-16;47;30;5;2;44;5;2;0;0;270243;178852;2734;386;215942;3872;501;0;5
FR;5;2022-06-17;100;67;5;5;102;10;5;0;0;270343;178919;2739;391;216044;3882;506;0;5
FR;5;2022-06-18;146;95;10;2;152;26;2;0;1;270489;179014;2749;393;216196;3908;508;0;6
FR;5;2022-06-19;26;15;0;1;18;4;1;0;0;270515;179029;2749;394;216214;3912;509;0;6
FR;5;2022-06-20;56;50;8;0;62;11;2;0;0;270571;179079;2757;394;216276;3923;511;0;6
FR;5;2022-06-21;53;73;5;3;91;7;5;0;1;270624;179152;2762;397;216367;3930;516;0;7
FR;5;2022-06-22;224;248;7;9;348;33;10;0;0;270848;179400;2769;406;216715;3963;526;0;7
FR;5;2022-06-23;50;38;2;5;43;6;6;0;0;270898;179438;2771;411;216758;3969;532;0;7
FR;5;2022-06-24;91;70;12;5;101;16;8;0;0;270989;179508;2783;416;216859;3985;540;0;7
FR;5;2022-06-25;154;124;3;7;185;14;8;0;1;271143;179632;2786;423;217044;3999;548;0;8
FR;5;2022-06-26;26;19;2;0;29;5;0;0;0;271169;179651;2788;423;217073;4004;548;0;8
FR;5;2022-06-27;57;60;5;7;78;11;9;0;0;271226;179711;2793;430;217151;4015;557;0;8
FR;5;2022-06-28;70;49;8;2;69;14;5;0;0;271296;179760;2801;432;217220;4029;562;0;8
FR;5;2022-06-29;297;269;9;21;391;34;23;0;0;271593;180029;2810;453;217611;4063;585;0;8
FR;5;2022-06-30;89;57;10;12;89;17;11;0;0;271682;180086;2820;465;217700;4080;596;0;8
FR;5;2022-07-01;127;65;7;11;118;12;11;0;2;271809;180151;2827;476;217818;4092;607;0;10
FR;5;2022-07-02;191;132;4;0;210;22;0;0;0;272000;180283;2831;476;218028;4114;607;0;10
FR;5;2022-07-03;30;25;1;0;36;4;0;0;0;272030;180308;2832;476;218064;4118;607;0;10
FR;5;2022-07-04;103;65;2;5;102;7;5;0;1;272133;180373;2834;481;218166;4125;612;0;11
FR;5;2022-07-05;104;72;3;8;107;13;8;0;1;272237;180445;2837;489;218273;4138;620;0;12
FR;5;2022-07-06;278;168;9;36;289;27;36;0;0;272515;180613;2846;525;218562;4165;656;0;12
FR;5;2022-07-07;88;69;6;9;89;13;11;0;0;272603;180682;2852;534;218651;4178;667;0;12
FR;5;2022-07-08;152;120;7;14;146;25;13;0;1;272755;180802;2859;548;218797;4203;680;0;13
FR;5;2022-07-09;116;68;1;8;100;10;8;0;0;272871;180870;2860;556;218897;4213;688;0;13
FR;5;2022-07-10;15;6;0;0;10;1;0;0;0;272886;180876;2860;556;218907;4214;688;0;13
FR;5;2022-07-11;92;72;10;2;98;19;3;0;0;272978;180948;2870;558;219005;4233;691;0;13
FR;5;2022-07-12;67;63;5;10;81;7;12;0;0;273045;181011;2875;568;219086;4240;703;0;13
FR;5;2022-07-13;169;118;10;19;196;16;23;0;0;273214;181129;2885;587;219282;4256;726;0;13
FR;5;2022-07-14;8;4;0;0;7;0;0;0;0;273222;181133;2885;587;219289;4256;726;0;13
FR;5;2022-07-15;74;66;5;14;86;15;15;0;0;273296;181199;2890;601;219375;4271;741;0;13
FR;5;2022-07-16;54;44;3;0;71;3;2;0;0;273350;181243;2893;601;219446;4274;743;0;13
FR;5;2022-07-17;10;7;3;0;10;2;2;0;0;273360;181250;2896;601;219456;4276;745;0;13
FR;5;2022-07-18;60;47;0;4;70;4;3;0;0;273420;181297;2896;605;219526;4280;748;0;13
FR;5;2022-07-19;63;42;5;3;63;7;4;0;0;273483;181339;2901;608;219589;4287;752;0;13
FR;5;2022-07-20;120;106;4;11;141;14;9;0;0;273603;181445;2905;619;219730;4301;761;0;13
FR;5;2022-07-21;38;43;2;10;52;5;10;0;0;273641;181488;2907;629;219782;4306;771;0;13
FR;5;2022-07-22;48;69;11;13;75;23;11;0;1;273689;181557;2918;642;219857;4329;782;0;14
FR;5;2022-07-23;59;78;2;1;95;11;2;0;0;273748;181635;2920;643;219952;4340;784;0;14
FR;5;2022-07-24;11;9;3;1;12;3;1;0;0;273759;181644;2923;644;219964;4343;785;0;14
FR;5;2022-07-25;53;48;2;7;57;8;8;0;0;273812;181692;2925;651;220021;4351;793;0;14
FR;5;2022-07-26;58;52;5;41;70;6;44;0;0;273870;181744;2930;692;220091;4357;837;0;14
FR;5;2022-07-27;106;118;4;4;161;13;4;0;0;273976;181862;2934;696;220252;4370;841;0;14
FR;5;2022-07-28;39;35;2;2;47;6;1;0;0;274015;181897;2936;698;220299;4376;842;0;14
FR;5;2022-07-29;56;74;3;14;90;8;10;0;0;274071;181971;2939;712;220389;4384;852;0;14
FR;5;2022-07-30;55;53;5;1;76;7;2;0;0;274126;182024;2944;713;220465;4391;854;0;14
FR;5;2022-07-31;7;11;1;0;13;1;0;0;0;274133;182035;2945;713;220478;4392;854;0;14
FR;5;2022-08-01;39;53;1;2;64;6;2;0;0;274172;182088;2946;715;220542;4398;856;0;14
FR;5;2022-08-02;32;43;8;7;47;8;7;0;1;274204;182131;2954;722;220589;4406;863;0;15
FR;5;2022-08-03;54;51;4;10;70;9;8;0;0;274258;182182;2958;732;220659;4415;871;0;15
FR;5;2022-08-04;20;18;1;6;22;1;6;0;0;274278;182200;2959;738;220681;4416;877;0;15
FR;5;2022-08-05;35;26;3;3;39;3;3;0;0;274313;182226;2962;741;220720;4419;880;0;15
FR;5;2022-08-06;23;26;1;0;31;1;0;0;0;274336;182252;2963;741;220751;4420;880;0;15
FR;5;2022-08-07;2;2;1;0;1;1;1;0;0;274338;182254;2964;741;220752;4421;881;0;15
FR;5;2022-08-08;26;19;1;2;24;2;1;0;0;274364;182273;2965;743;220776;4423;882;0;15
FR;5;2022-08-09;26;28;3;3;35;3;3;0;0;274390;182301;2968;746;220811;4426;885;0;15
FR;5;2022-08-10;47;47;2;0;56;5;0;0;0;274437;182348;2970;746;220867;4431;885;0;15
FR;5;2022-08-11;19;36;2;2;42;5;2;0;0;274456;182384;2972;748;220909;4436;887;0;15
FR;5;2022-08-12;27;28;2;0;39;2;0;0;0;274483;182412;2974;748;220948;4438;887;0;15
FR;5;2022-08-13;16;18;0;0;24;0;0;0;0;274499;182430;2974;748;220972;4438;887;0;15
FR;5;2022-08-14;2;3;0;0;4;0;0;0;0;274501;182433;2974;748;220976;4438;887;0;15
FR;5;2022-08-15;2;6;0;0;6;0;0;0;0;274503;182439;2974;748;220982;4438;887;0;15
FR;5;2022-08-16;33;26;3;0;28;6;0;0;0;274536;182465;2977;748;221010;4444;887;0;15
FR;5;2022-08-17;52;55;2;1;72;1;1;0;0;274588;182520;2979;749;221082;4445;888;0;15
FR;5;2022-08-18;26;18;8;17;25;10;16;0;0;274614;182538;2987;766;221107;4455;904;0;15
FR;5;2022-08-19;26;34;1;2;43;2;2;0;0;274640;182572;2988;768;221150;4457;906;0;15
FR;5;2022-08-20;25;27;2;1;33;4;2;0;0;274665;182599;2990;769;221183;4461;908;0;15
FR;5;2022-08-21;7;4;1;0;7;1;0;0;0;274672;182603;2991;769;221190;4462;908;0;15
FR;5;2022-08-22;39;26;1;6;42;2;5;0;1;274711;182629;2992;775;221232;4464;913;0;16
FR;5;2022-08-23;27;26;1;1;32;2;1;0;0;274738;182655;2993;776;221264;4466;914;0;16
FR;5;2022-08-24;50;43;0;0;62;0;0;0;0;274788;182698;2993;776;221326;4466;914;0;16
FR;5;2022-08-25;27;26;3;1;31;2;0;0;1;274815;182724;2996;777;221357;4468;914;0;17
FR;5;2022-08-26;48;39;7;2;58;5;4;0;0;274863;182763;3003;779;221415;4473;918;0;17
FR;5;2022-08-27;46;28;1;0;46;3;1;0;0;274909;182791;3004;779;221461;4476;919;0;17
FR;5;2022-08-28;5;7;0;0;7;0;0;0;0;274914;182798;3004;779;221468;4476;919;0;17
FR;5;2022-08-29;58;44;1;1;66;4;1;0;0;274972;182842;3005;780;221534;4480;920;0;17
FR;5;2022-08-30;45;23;12;29;40;10;30;0;1;275017;182865;3017;809;221574;4490;950;0;18
FR;5;2022-08-31;53;47;6;1;58;11;1;0;0;275070;182912;3023;810;221632;4501;951;0;18
FR;5;2022-09-01;16;8;1;4;13;1;4;0;0;275086;182920;3024;814;221645;4502;955;0;18
FR;5;2022-09-02;42;23;8;2;35;9;3;0;0;275128;182943;3032;816;221680;4511;958;0;18
FR;5;2022-09-03;69;37;2;0;58;2;0;0;0;275197;182980;3034;816;221738;4513;958;0;18
FR;5;2022-09-04;12;7;1;0;8;3;0;0;0;275209;182987;3035;816;221746;4516;958;0;18
FR;5;2022-09-05;7;4;1;0;4;1;0;0;0;275216;182991;3036;816;221750;4517;958;0;18
FR;5;2022-09-06;23;14;3;15;17;2;14;0;2;275239;183005;3039;831;221767;4519;972;0;20
FR;5;2022-09-07;79;53;1;1;76;3;1;0;0;275318;183058;3040;832;221843;4522;973;0;20
FR;5;2022-09-08;10;4;0;4;7;0;4;0;0;275328;183062;3040;836;221850;4522;977;0;20
FR;5;2022-09-09;42;11;9;2;14;10;3;0;0;275370;183073;3049;838;221864;4532;980;0;20
FR;5;2022-09-10;40;45;1;1;50;8;1;0;0;275410;183118;3050;839;221914;4540;981;0;20
FR;5;2022-09-11;3;3;0;0;3;1;0;0;0;275413;183121;3050;839;221917;4541;981;0;20
FR;5;2022-09-12;7;5;2;2;7;2;2;0;0;275420;183126;3052;841;221924;4543;983;0;20
FR;5;2022-09-13;9;6;0;1;4;3;1;0;0;275429;183132;3052;842;221928;4546;984;0;20
FR;5;2022-09-14;52;47;4;6;55;9;5;0;0;275481;183179;3056;848;221983;4555;989;0;20
FR;5;2022-09-15;11;13;2;3;11;5;3;0;0;275492;183192;3058;851;221994;4560;992;0;20
FR;5;2022-09-16;25;33;1;4;38;3;3;0;0;275517;183225;3059;855;222032;4563;995;0;20
FR;5;2022-09-17;60;43;1;1;51;5;1;0;0;275577;183268;3060;856;222083;4568;996;0;20
FR;5;2022-09-18;9;6;0;1;10;1;0;0;0;275586;183274;3060;857;222093;4569;996;0;20
FR;5;2022-09-19;22;17;2;1;20;5;2;0;0;275608;183291;3062;858;222113;4574;998;0;20
FR;5;2022-09-20;15;11;3;3;15;1;4;0;0;275623;183302;3065;861;222128;4575;1002;0;20
FR;5;2022-09-21;68;45;9;0;65;13;0;0;0;275691;183347;3074;861;222193;4588;1002;0;20
FR;5;2022-09-22;12;6;4;24;6;4;23;0;1;275703;183353;3078;885;222199;4592;1025;0;21
FR;5;2022-09-23;20;25;2;3;23;8;3;0;0;275723;183378;3080;888;222222;4600;1028;0;21
FR;5;2022-09-24;44;51;1;8;65;5;8;0;0;275767;183429;3081;896;222287;4605;1036;0;21
FR;5;2022-09-25;6;12;0;0;13;1;0;0;0;275773;183441;3081;896;222300;4606;1036;0;21
FR;5;2022-09-26;15;7;0;2;12;0;1;0;1;275788;183448;3081;898;222312;4606;1037;0;22
FR;5;2022-09-27;7;12;4;9;14;4;9;0;1;275795;183460;3085;907;222326;4610;1046;0;23
FR;5;2022-09-28;65;67;5;0;91;7;0;0;0;275860;183527;3090;907;222417;4617;1046;0;23
FR;5;2022-09-29;17;9;1;0;15;1;1;0;1;275877;183536;3091;907;222432;4618;1047;0;24
FR;5;2022-09-30;28;47;2;2;54;4;3;0;0;275905;183583;3093;909;222486;4622;1050;0;24
FR;5;2022-10-01;40;35;5;5;48;8;7;0;0;275945;183618;3098;914;222534;4630;1057;0;24
FR;5;2022-10-02;1;9;1;0;10;1;0;0;0;275946;183627;3099;914;222544;4631;1057;0;24
FR;5;2022-10-03;7;6;3;0;5;4;0;0;0;275953;183633;3102;914;222549;4635;1057;0;24
FR;5;2022-10-04;11;8;1;3;11;2;3;0;0;275964;183641;3103;917;222560;4637;1060;0;24
FR;5;2022-10-05;57;62;2;2;79;13;2;0;0;276021;183703;3105;919;222639;4650;1062;0;24
FR;5;2022-10-06;12;10;1;4;15;2;4;0;0;276033;183713;3106;923;222654;4652;1066;0;24
FR;5;2022-10-07;21;31;1;0;34;5;0;0;0;276054;183744;3107;923;222688;4657;1066;0;24
FR;5;2022-10-08;33;51;1;0;54;7;0;0;0;276087;183795;3108;923;222742;4664;1066;0;24
FR;5;2022-10-09;7;10;0;0;11;1;0;0;0;276094;183805;3108;923;222753;4665;1066;0;24
FR;5;2022-10-10;14;6;0;1;8;1;1;0;0;276108;183811;3108;924;222761;4666;1067;0;24
FR;5;2022-10-11;6;13;2;1;14;2;2;0;0;276114;183824;3110;925;222775;4668;1069;0;24
FR;5;2022-10-12;40;57;3;2;69;8;2;0;0;276154;183881;3113;927;222844;4676;1071;0;24
FR;5;2022-10-13;11;16;2;0;18;4;0;0;0;276165;183897;3115;927;222862;4680;1071;0;24
FR;5;2022-10-14;21;21;1;0;20;5;0;0;0;276186;183918;3116;927;222882;4685;1071;0;24
FR;5;2022-10-15;19;26;10;0;25;11;2;0;0;276205;183944;3126;927;222907;4696;1073;0;24
FR;5;2022-10-16;3;1;0;0;1;1;0;0;0;276208;183945;3126;927;222908;4697;1073;0;24
FR;5;2022-10-17;8;8;2;1;8;3;1;0;2;276216;183953;3128;928;222916;4700;1074;0;26
FR;5;2022-10-18;6;7;0;2;8;0;2;0;0;276222;183960;3128;930;222924;4700;1076;0;26
FR;5;2022-10-19;38;44;8;0;53;11;0;0;1;276260;184004;3136;930;222977;4711;1076;0;27
FR;5;2022-10-20;18;15;2;1;16;3;1;0;0;276278;184019;3138;931;222993;4714;1077;0;27
FR;5;2022-10-21;22;15;6;0;19;8;1;0;2;276300;184034;3144;931;223012;4722;1078;0;29
FR;5;2022-10-22;35;29;2;12;32;5;12;0;0;276335;184063;3146;943;223044;4727;1090;0;29
FR;5;2022-10-23;9;3;0;0;4;0;0;0;0;276344;184066;3146;943;223048;4727;1090;0;29
FR;5;2022-10-24;14;7;6;7;9;9;8;0;0;276358;184073;3152;950;223057;4736;1098;0;29
FR;5;2022-10-25;13;9;6;3;9;8;3;0;2;276371;184082;3158;953;223066;4744;1101;0;31
FR;5;2022-10-26;34;22;6;0;29;10;0;0;0;276405;184104;3164;953;223095;4754;1101;0;31
FR;5;2022-10-27;16;4;4;0;11;4;0;0;0;276421;184108;3168;953;223106;4758;1101;0;31
FR;5;2022-10-28;19;13;5;3;14;6;4;0;0;276440;184121;3173;956;223120;4764;1105;0;31
FR;5;2022-10-29;21;13;0;0;17;3;0;0;0;276461;184134;3173;956;223137;4767;1105;0;31
FR;5;2022-10-30;1;4;2;0;4;3;0;0;0;276462;184138;3175;956;223141;4770;1105;0;31
FR;5;2022-10-31;14;11;2;1;12;3;1;0;0;276476;184149;3177;957;223153;4773;1106;0;31
FR;5;2022-11-01;3;3;0;1;3;0;1;0;0;276479;184152;3177;958;223156;4773;1107;0;31
FR;5;2022-11-02;23;17;5;4;23;5;5;0;0;276502;184169;3182;962;223179;4778;1112;0;31
FR;5;2022-11-03;22;4;1;1;11;1;1;0;0;276524;184173;3183;963;223190;4779;1113;0;31
FR;5;2022-11-04;19;18;1;0;18;2;0;0;0;276543;184191;3184;963;223208;4781;1113;0;31
FR;5;2022-11-05;25;16;1;0;21;1;0;0;0;276568;184207;3185;963;223229;4782;1113;0;31
FR;5;2022-11-06;1;7;0;0;7;0;0;0;0;276569;184214;3185;963;223236;4782;1113;0;31
FR;5;2022-11-07;10;3;3;0;3;3;0;0;0;276579;184217;3188;963;223239;4785;1113;0;31
FR;5;2022-11-08;12;7;1;2;8;1;1;0;0;276591;184224;3189;965;223247;4786;1114;0;31
FR;5;2022-11-09;30;29;6;1;32;6;1;0;0;276621;184253;3195;966;223279;4792;1115;0;31
FR;5;2022-11-10;11;16;1;0;17;1;0;0;0;276632;184269;3196;966;223296;4793;1115;0;31
FR;5;2022-11-11;2;4;0;1;6;0;1;0;0;276634;184273;3196;967;223302;4793;1116;0;31
FR;5;2022-11-12;19;10;5;9;18;6;9;0;2;276653;184283;3201;976;223320;4799;1125;0;33
FR;5;2022-11-13;2;2;0;1;2;0;1;0;0;276655;184285;3201;977;223322;4799;1126;0;33
FR;5;2022-11-14;8;11;0;1;10;3;0;0;0;276663;184296;3201;978;223332;4802;1126;0;33
FR;5;2022-11-15;8;6;4;3;6;4;3;0;0;276671;184302;3205;981;223338;4806;1129;0;33
FR;5;2022-11-16;29;28;2;1;33;5;0;0;0;276700;184330;3207;982;223371;4811;1129;0;33
FR;5;2022-11-17;6;16;4;0;16;5;0;0;0;276706;184346;3211;982;223387;4816;1129;0;33
FR;5;2022-11-18;17;17;7;0;19;9;0;0;0;276723;184363;3218;982;223406;4825;1129;0;33
FR;5;2022-11-19;18;27;2;0;28;6;0;0;0;276741;184390;3220;982;223434;4831;1129;0;33
FR;5;2022-11-20;6;3;0;0;5;0;0;0;0;276747;184393;3220;982;223439;4831;1129;0;33
FR;5;2022-11-21;8;5;0;2;4;2;1;0;0;276755;184398;3220;984;223443;4833;1130;0;33
FR;5;2022-11-22;9;3;0;1;4;0;1;0;0;276764;184401;3220;985;223447;4833;1131;0;33
FR;5;2022-11-23;34;25;6;1;27;13;0;0;0;276798;184426;3226;986;223474;4846;1131;0;33
FR;5;2022-11-24;3;7;2;0;8;1;1;0;0;276801;184433;3228;986;223482;4847;1132;0;33
FR;5;2022-11-25;15;20;2;0;25;3;0;0;1;276816;184453;3230;986;223507;4850;1132;0;34
FR;5;2022-11-26;22;19;4;0;20;8;0;0;0;276838;184472;3234;986;223527;4858;1132;0;34
FR;5;2022-11-27;7;0;1;0;3;1;0;0;0;276845;184472;3235;986;223530;4859;1132;0;34
FR;5;2022-11-28;7;15;3;0;15;5;0;0;0;276852;184487;3238;986;223545;4864;1132;0;34
FR;5;2022-11-29;10;9;1;0;11;3;0;0;1;276862;184496;3239;986;223556;4867;1132;0;35
FR;5;2022-11-30;35;48;12;0;56;17;1;0;0;276897;184544;3251;986;223612;4884;1133;0;35
FR;5;2022-12-01;5;10;2;0;10;3;0;0;0;276902;184554;3253;986;223622;4887;1133;0;35
FR;5;2022-12-02;1;5;2;1;4;3;1;0;0;276903;184559;3255;987;223626;4890;1134;0;35
FR;5;2022-12-03;3;3;8;1;5;8;1;0;0;276906;184562;3263;988;223631;4898;1135;0;35
FR;5;2022-12-04;3;2;1;0;2;2;0;0;0;276909;184564;3264;988;223633;4900;1135;0;35
FR;5;2022-12-05;1;2;0;0;1;1;0;0;0;276910;184566;3264;988;223634;4901;1135;0;35
FR;5;2022-12-06;5;1;0;0;1;0;0;0;1;276915;184567;3264;988;223635;4901;1135;0;36
FR;5;2022-12-07;5;8;1;0;8;1;0;0;0;276920;184575;3265;988;223643;4902;1135;0;36
FR;5;2022-12-08;2;2;0;0;2;0;0;0;0;276922;184577;3265;988;223645;4902;1135;0;36
FR;5;2022-12-09;5;8;0;0;6;2;0;0;0;276927;184585;3265;988;223651;4904;1135;0;36
FR;5;2022-12-10;4;7;2;1;8;2;1;0;0;276931;184592;3267;989;223659;4906;1136;0;36
FR;5;2022-12-11;2;0;0;0;0;0;0;0;0;276933;184592;3267;989;223659;4906;1136;0;36
FR;5;2022-12-12;0;0;0;0;0;0;0;0;0;276933;184592;3267;989;223659;4906;1136;0;36
FR;5;2022-12-13;2;3;0;0;4;1;0;0;0;276935;184595;3267;989;223663;4907;1136;0;36
FR;5;2022-12-14;2;3;0;9;3;1;8;0;3;276937;184598;3267;998;223666;4908;1144;0;39
FR;5;2022-12-15;0;2;0;0;2;0;0;0;0;276937;184600;3267;998;223668;4908;1144;0;39
FR;5;2022-12-16;3;3;2;0;4;3;0;0;0;276940;184603;3269;998;223672;4911;1144;0;39
FR;5;2022-12-17;3;3;3;0;3;2;1;0;0;276943;184606;3272;998;223675;4913;1145;0;39
FR;5;2022-12-18;3;0;0;1;0;0;1;0;1;276946;184606;3272;999;223675;4913;1146;0;40
FR;5;2022-12-19;1;0;0;2;0;0;2;0;0;276947;184606;3272;1001;223675;4913;1148;0;40
FR;5;2022-12-20;0;1;3;0;1;3;0;0;0;276947;184607;3275;1001;223676;4916;1148;0;40
FR;5;2022-12-21;2;4;0;0;4;0;0;0;0;276949;184611;3275;1001;223680;4916;1148;0;40
FR;5;2022-12-22;2;2;1;0;2;1;0;0;0;276951;184613;3276;1001;223682;4917;1148;0;40
FR;5;2022-12-23;3;1;1;0;1;1;0;0;0;276954;184614;3277;1001;223683;4918;1148;0;40
FR;5;2022-12-24;0;1;0;0;1;0;0;0;0;276954;184615;3277;1001;223684;4918;1148;0;40
FR;5;2022-12-25;0;1;2;0;0;3;0;0;0;276954;184616;3279;1001;223684;4921;1148;0;40
FR;5;2022-12-26;2;2;0;0;2;0;0;0;0;276956;184618;3279;1001;223686;4921;1148;0;40
FR;5;2022-12-27;0;3;0;0;3;0;0;0;0;276956;184621;3279;1001;223689;4921;1148;0;40
FR;5;2022-12-28;5;3;3;0;3;3;2;0;0;276961;184624;3282;1001;223692;4924;1150;0;40
FR;5;2022-12-29;3;2;2;0;3;2;0;0;0;276964;184626;3284;1001;223695;4926;1150;0;40
FR;5;2022-12-30;3;2;1;0;2;1;0;0;0;276967;184628;3285;1001;223697;4927;1150;0;40
FR;5;2022-12-31;0;0;0;0;0;0;0;0;0;276967;184628;3285;1001;223697;4927;1150;0;40
FR;5;2023-01-01;0;0;0;0;0;0;0;0;0;276967;184628;3285;1001;223697;4927;1150;0;40
FR;5;2023-01-02;1;1;1;0;1;1;0;0;0;276968;184629;3286;1001;223698;4928;1150;0;40
FR;5;2023-01-03;3;1;0;0;2;0;0;0;0;276971;184630;3286;1001;223700;4928;1150;0;40
FR;5;2023-01-04;6;1;1;0;2;1;0;0;0;276977;184631;3287;1001;223702;4929;1150;0;40
FR;5;2023-01-05;0;3;0;0;3;0;0;0;0;276977;184634;3287;1001;223705;4929;1150;0;40
FR;5;2023-01-06;2;1;1;0;1;1;0;0;0;276979;184635;3288;1001;223706;4930;1150;0;40
FR;5;2023-01-07;5;1;1;0;1;2;0;0;0;276984;184636;3289;1001;223707;4932;1150;0;40
FR;5;2023-01-08;2;2;0;0;2;0;0;0;0;276986;184638;3289;1001;223709;4932;1150;0;40
FR;5;2023-01-09;4;0;1;0;1;1;0;0;0;276990;184638;3290;1001;223710;4933;1150;0;40
FR;5;2023-01-10;3;1;0;0;2;0;0;0;0;276993;184639;3290;1001;223712;4933;1150;0;40
FR;5;2023-01-11;7;5;3;0;4;4;0;0;0;277000;184644;3293;1001;223716;4937;1150;0;40
FR;5;2023-01-12;14;6;4;0;6;6;0;0;0;277014;184650;3297;1001;223722;4943;1150;0;40
FR;5;2023-01-13;56;16;16;0;31;18;0;0;0;277070;184666;3313;1001;223753;4961;1150;0;40
FR;5;2023-01-14;56;34;13;1;34;20;2;0;0;277126;184700;3326;1002;223787;4981;1152;0;40
FR;5;2023-01-15;13;9;0;0;5;4;0;0;0;277139;184709;3326;1002;223792;4985;1152;0;40
FR;5;2023-01-16;13;8;3;0;8;3;0;0;0;277152;184717;3329;1002;223800;4988;1152;0;40
FR;5;2023-01-17;12;8;3;0;4;7;0;0;0;277164;184725;3332;1002;223804;4995;1152;0;40
FR;5;2023-01-18;72;35;21;2;46;25;2;0;0;277236;184760;3353;1004;223850;5020;1154;0;40
FR;5;2023-01-19;13;6;8;0;5;10;1;0;0;277249;184766;3361;1004;223855;5030;1155;0;40
FR;5;2023-01-20;27;17;13;0;17;18;0;0;2;277276;184783;3374;1004;223872;5048;1155;0;42
FR;5;2023-01-21;34;23;18;1;31;21;1;0;0;277310;184806;3392;1005;223903;5069;1156;0;42
FR;5;2023-01-22;6;4;2;0;4;3;0;0;0;277316;184810;3394;1005;223907;5072;1156;0;42
FR;5;2023-01-23;6;5;3;0;3;5;0;0;0;277322;184815;3397;1005;223910;5077;1156;0;42
FR;5;2023-01-24;16;3;3;0;6;4;0;0;0;277338;184818;3400;1005;223916;5081;1156;0;42
FR;5;2023-01-25;33;31;12;2;27;23;2;0;0;277371;184849;3412;1007;223943;5104;1158;0;42
FR;5;2023-01-26;6;5;4;0;6;4;0;0;0;277377;184854;3416;1007;223949;5108;1158;0;42
FR;5;2023-01-27;18;13;8;0;17;8;1;0;0;277395;184867;3424;1007;223966;5116;1159;0;42
FR;5;2023-01-28;21;8;4;3;11;6;3;0;0;277416;184875;3428;1010;223977;5122;1162;0;42
FR;5;2023-01-29;0;3;0;0;2;1;0;0;0;277416;184878;3428;1010;223979;5123;1162;0;42
FR;5;2023-01-30;7;5;3;0;4;6;0;0;0;277423;184883;3431;1010;223983;5129;1162;0;42
FR;5;2023-01-31;3;7;2;0;5;4;0;0;0;277426;184890;3433;1010;223988;5133;1162;0;42
FR;5;2023-02-01;18;18;7;1;19;8;1;0;0;277444;184908;3440;1011;224007;5141;1163;0;42
FR;5;2023-02-02;7;8;1;0;7;2;0;0;0;277451;184916;3441;1011;224014;5143;1163;0;42
FR;5;2023-02-03;15;26;6;0;27;9;0;0;0;277466;184942;3447;1011;224041;5152;1163;0;42
FR;5;2023-02-04;17;23;5;0;25;6;0;0;0;277483;184965;3452;1011;224066;5158;1163;0;42
FR;5;2023-02-05;1;2;0;1;2;1;0;0;0;277484;184967;3452;1012;224068;5159;1163;0;42
FR;5;2023-02-06;12;11;7;0;12;7;0;0;0;277496;184978;3459;1012;224080;5166;1163;0;42
FR;5;2023-02-07;6;11;2;0;10;4;0;0;0;277502;184989;3461;1012;224090;5170;1163;0;42
FR;5;2023-02-08;29;35;8;0;39;10;0;0;0;277531;185024;3469;1012;224129;5180;1163;0;42
FR;5;2023-02-09;15;7;5;0;8;5;0;0;0;277546;185031;3474;1012;224137;5185;1163;0;42
FR;5;2023-02-10;11;22;5;0;24;7;0;0;0;277557;185053;3479;1012;224161;5192;1163;0;42
FR;5;2023-02-11;12;11;3;1;15;4;0;0;0;277569;185064;3482;1013;224176;5196;1163;0;42
FR;5;2023-02-12;4;7;1;0;8;1;0;0;0;277573;185071;3483;1013;224184;5197;1163;0;42
FR;5;2023-02-13;4;6;6;0;5;7;0;0;0;277577;185077;3489;1013;224189;5204;1163;0;42
FR;5;2023-02-14;11;8;2;0;9;3;0;0;0;277588;185085;3491;1013;224198;5207;1163;0;42
FR;5;2023-02-15;27;25;4;0;27;5;0;0;0;277615;185110;3495;1013;224225;5212;1163;0;42
FR;5;2023-02-16;8;4;3;0;8;3;0;0;0;277623;185114;3498;1013;224233;5215;1163;0;42
FR;5;2023-02-17;9;5;9;0;6;9;0;0;0;277632;185119;3507;1013;224239;5224;1163;0;42
FR;5;2023-02-18;9;14;3;1;16;3;1;0;0;277641;185133;3510;1014;224255;5227;1164;0;42
FR;5;2023-02-19;0;1;0;0;1;0;0;0;0;277641;185134;3510;1014;224256;5227;1164;0;42
FR;5;2023-02-20;6;6;4;0;6;5;0;0;0;277647;185140;3514;1014;224262;5232;1164;0;42
FR;5;2023-02-21;4;6;5;0;7;5;0;0;0;277651;185146;3519;1014;224269;5237;1164;0;42
FR;5;2023-02-22;10;16;5;0;15;5;1;0;0;277661;185162;3524;1014;224284;5242;1165;0;42
FR;5;2023-02-23;5;5;2;0;5;2;0;0;0;277666;185167;3526;1014;224289;5244;1165;0;42
FR;5;2023-02-24;17;23;1;0;22;3;0;0;0;277683;185190;3527;1014;224311;5247;1165;0;42
FR;5;2023-02-25;11;9;0;0;10;0;0;0;0;277694;185199;3527;1014;224321;5247;1165;0;42
FR;5;2023-02-26;1;1;0;0;1;0;0;0;0;277695;185200;3527;1014;224322;5247;1165;0;42
FR;5;2023-02-27;7;5;2;0;5;2;0;0;0;277702;185205;3529;1014;224327;5249;1165;0;42
FR;5;2023-02-28;4;8;2;0;8;4;0;0;0;277706;185213;3531;1014;224335;5253;1165;0;42
FR;5;2023-03-01;12;25;1;0;23;3;1;0;0;277718;185238;3532;1014;224358;5256;1166;0;42
FR;5;2023-03-02;7;13;3;0;12;5;0;0;0;277725;185251;3535;1014;224370;5261;1166;0;42
FR;5;2023-03-03;11;4;3;0;8;3;1;0;0;277736;185255;3538;1014;224378;5264;1167;0;42
FR;5;2023-03-04;8;17;7;0;18;8;0;0;0;277744;185272;3545;1014;224396;5272;1167;0;42
FR;5;2023-03-05;3;3;0;0;3;0;0;0;0;277747;185275;3545;1014;224399;5272;1167;0;42
FR;5;2023-03-06;2;8;2;0;6;4;0;0;0;277749;185283;3547;1014;224405;5276;1167;0;42
FR;5;2023-03-07;2;9;4;0;9;4;0;0;0;277751;185292;3551;1014;224414;5280;1167;0;42
FR;5;2023-03-08;9;21;1;0;22;1;0;0;0;277760;185313;3552;1014;224436;5281;1167;0;42
FR;5;2023-03-09;1;6;0;0;5;1;0;0;0;277761;185319;3552;1014;224441;5282;1167;0;42
FR;5;2023-03-10;3;7;2;1;8;2;1;0;0;277764;185326;3554;1015;224449;5284;1168;0;42
FR;5;2023-03-11;5;4;0;0;6;0;0;0;0;277769;185330;3554;1015;224455;5284;1168;0;42
FR;5;2023-03-12;0;1;0;0;1;0;0;0;0;277769;185331;3554;1015;224456;5284;1168;0;42
FR;5;2023-03-13;2;2;0;0;4;0;0;0;0;277771;185333;3554;1015;224460;5284;1168;0;42
FR;5;2023-03-14;6;1;1;1;5;1;1;0;0;277777;185334;3555;1016;224465;5285;1169;0;42
FR;5;2023-03-15;7;8;2;0;12;3;0;0;0;277784;185342;3557;1016;224477;5288;1169;0;42
FR;5;2023-03-16;2;6;0;0;6;0;0;0;0;277786;185348;3557;1016;224483;5288;1169;0;42
FR;5;2023-03-17;14;15;3;0;13;4;1;0;0;277800;185363;3560;1016;224496;5292;1170;0;42
FR;5;2023-03-18;4;9;0;0;9;1;0;0;0;277804;185372;3560;1016;224505;5293;1170;0;42
FR;5;2023-03-19;0;0;0;0;0;0;0;0;0;277804;185372;3560;1016;224505;5293;1170;0;42
FR;5;2023-03-20;3;8;0;0;9;0;0;0;0;277807;185380;3560;1016;224514;5293;1170;0;42
FR;5;2023-03-21;3;8;2;2;8;2;2;0;0;277810;185388;3562;1018;224522;5295;1172;0;42
FR;5;2023-03-22;9;22;3;0;20;4;0;0;0;277819;185410;3565;1018;224542;5299;1172;0;42
FR;5;2023-03-23;2;5;1;0;5;1;0;0;0;277821;185415;3566;1018;224547;5300;1172;0;42
FR;5;2023-03-24;5;9;1;0;9;3;0;0;0;277826;185424;3567;1018;224556;5303;1172;0;42
FR;5;2023-03-25;3;8;2;0;8;2;0;0;0;277829;185432;3569;1018;224564;5305;1172;0;42
FR;5;2023-03-26;0;1;0;0;0;1;0;0;0;277829;185433;3569;1018;224564;5306;1172;0;42
FR;5;2023-03-27;3;0;1;0;1;1;0;0;0;277832;185433;3570;1018;224565;5307;1172;0;42
FR;5;2023-03-28;3;3;0;0;4;0;0;0;0;277835;185436;3570;1018;224569;5307;1172;0;42
FR;5;2023-03-29;7;16;4;0;16;6;0;0;0;277842;185452;3574;1018;224585;5313;1172;0;42
FR;5;2023-03-30;3;2;0;0;4;0;0;0;1;277845;185454;3574;1018;224589;5313;1172;0;43
FR;5;2023-03-31;3;7;2;1;7;2;1;0;0;277848;185461;3576;1019;224596;5315;1173;0;43
FR;5;2023-04-01;5;7;3;1;5;4;2;0;0;277853;185468;3579;1020;224601;5319;1175;0;43
FR;5;2023-04-02;0;1;0;0;1;0;0;0;0;277853;185469;3579;1020;224602;5319;1175;0;43
FR;5;2023-04-03;3;4;2;0;4;0;2;0;0;277856;185473;3581;1020;224606;5319;1177;0;43
FR;5;2023-04-04;1;3;0;0;3;0;0;0;0;277857;185476;3581;1020;224609;5319;1177;0;43
FR;5;2023-04-05;3;6;1;0;5;2;0;0;0;277860;185482;3582;1020;224614;5321;1177;0;43
FR;5;2023-04-06;3;3;0;0;3;0;0;0;0;277863;185485;3582;1020;224617;5321;1177;0;43
FR;5;2023-04-07;6;4;1;0;4;1;0;0;0;277869;185489;3583;1020;224621;5322;1177;0;43
FR;5;2023-04-08;6;10;1;0;10;1;0;0;0;277875;185499;3584;1020;224631;5323;1177;0;43
FR;5;2023-04-09;0;0;0;0;0;0;0;0;0;277875;185499;3584;1020;224631;5323;1177;0;43
FR;5;2023-04-10;0;0;0;0;0;0;0;0;0;277875;185499;3584;1020;224631;5323;1177;0;43
FR;5;2023-04-11;1;6;0;0;6;0;0;0;1;277876;185505;3584;1020;224637;5323;1177;0;44
FR;5;2023-04-12;4;9;1;0;9;1;0;0;0;277880;185514;3585;1020;224646;5324;1177;0;44
FR;5;2023-04-13;2;1;2;0;0;3;0;0;0;277882;185515;3587;1020;224646;5327;1177;0;44
FR;5;2023-04-14;5;5;2;0;8;2;0;0;0;277887;185520;3589;1020;224654;5329;1177;0;44
FR;5;2023-04-15;3;4;0;0;4;0;0;0;0;277890;185524;3589;1020;224658;5329;1177;0;44
FR;5;2023-04-16;1;0;0;0;0;0;0;0;0;277891;185524;3589;1020;224658;5329;1177;0;44
FR;5;2023-04-17;4;4;3;0;4;3;0;0;0;277895;185528;3592;1020;224662;5332;1177;0;44
FR;5;2023-04-18;3;2;0;0;2;0;0;0;0;277898;185530;3592;1020;224664;5332;1177;0;44
FR;5;2023-04-19;9;7;0;0;3;5;0;0;0;277907;185537;3592;1020;224667;5337;1177;0;44
FR;5;2023-04-20;5;2;0;0;2;0;0;0;0;277912;185539;3592;1020;224669;5337;1177;0;44
FR;5;2023-04-21;2;6;1;0;5;2;0;0;0;277914;185545;3593;1020;224674;5339;1177;0;44
FR;5;2023-04-22;4;6;1;0;6;1;0;0;0;277918;185551;3594;1020;224680;5340;1177;0;44
FR;5;2023-04-23;1;0;0;0;0;0;0;0;0;277919;185551;3594;1020;224680;5340;1177;0;44
FR;5;2023-04-24;3;5;2;0;5;2;0;0;0;277922;185556;3596;1020;224685;5342;1177;0;44
FR;5;2023-04-25;0;1;1;2;1;1;2;0;0;277922;185557;3597;1022;224686;5343;1179;0;44
FR;5;2023-04-26;1;3;0;0;3;0;0;0;0;277923;185560;3597;1022;224689;5343;1179;0;44
FR;5;2023-04-27;3;4;0;0;3;1;0;0;0;277926;185564;3597;1022;224692;5344;1179;0;44
FR;5;2023-04-28;2;3;0;0;2;1;0;0;0;277928;185567;3597;1022;224694;5345;1179;0;44
FR;5;2023-04-29;2;9;0;0;9;0;0;0;0;277930;185576;3597;1022;224703;5345;1179;0;44
FR;5;2023-04-30;0;0;0;0;0;0;0;0;0;277930;185576;3597;1022;224703;5345;1179;0;44
FR;5;2023-05-01;0;0;0;0;0;0;0;0;0;277930;185576;3597;1022;224703;5345;1179;0;44
FR;5;2023-05-02;2;2;1;0;3;1;0;0;0;277932;185578;3598;1022;224706;5346;1179;0;44
FR;5;2023-05-03;5;3;0;0;3;0;0;0;0;277937;185581;3598;1022;224709;5346;1179;0;44
FR;5;2023-05-04;1;3;0;0;3;0;0;0;0;277938;185584;3598;1022;224712;5346;1179;0;44
FR;5;2023-05-05;1;1;0;0;1;0;0;0;0;277939;185585;3598;1022;224713;5346;1179;0;44
FR;5;2023-05-06;2;1;0;0;1;0;0;0;0;277941;185586;3598;1022;224714;5346;1179;0;44
FR;5;2023-05-07;0;1;0;0;1;0;0;0;0;277941;185587;3598;1022;224715;5346;1179;0;44
FR;5;2023-05-08;1;1;0;0;1;0;0;0;0;277942;185588;3598;1022;224716;5346;1179;0;44
FR;5;2023-05-09;0;3;0;0;3;0;0;0;0;277942;185591;3598;1022;224719;5346;1179;0;44
FR;5;2023-05-10;2;8;0;0;8;0;0;0;0;277944;185599;3598;1022;224727;5346;1179;0;44
FR;5;2023-05-11;2;1;0;0;1;0;0;0;0;277946;185600;3598;1022;224728;5346;1179;0;44
FR;5;2023-05-12;2;3;0;0;3;0;0;0;0;277948;185603;3598;1022;224731;5346;1179;0;44
FR;5;2023-05-13;6;4;0;0;4;2;0;0;0;277954;185607;3598;1022;224735;5348;1179;0;44
FR;5;2023-05-14;0;0;0;0;0;0;0;0;0;277954;185607;3598;1022;224735;5348;1179;0;44
FR;5;2023-05-15;3;0;0;0;0;0;0;0;1;277957;185607;3598;1022;224735;5348;1179;0;45
FR;5;2023-05-16;0;1;0;0;1;0;0;0;0;277957;185608;3598;1022;224736;5348;1179;0;45
FR;5;2023-05-17;3;6;2;0;7;2;0;0;0;277960;185614;3600;1022;224743;5350;1179;0;45
FR;5;2023-05-18;0;1;0;0;1;0;0;0;0;277960;185615;3600;1022;224744;5350;1179;0;45
FR;5;2023-05-19;1;4;1;0;3;1;0;0;0;277961;185619;3601;1022;224747;5351;1179;0;45
FR;5;2023-05-20;5;0;0;0;0;0;0;0;0;277966;185619;3601;1022;224747;5351;1179;0;45
FR;5;2023-05-21;0;0;0;0;0;0;0;0;0;277966;185619;3601;1022;224747;5351;1179;0;45
FR;5;2023-05-22;0;3;0;0;3;0;0;0;0;277966;185622;3601;1022;224750;5351;1179;0;45
FR;5;2023-05-23;1;1;1;0;1;1;0;0;0;277967;185623;3602;1022;224751;5352;1179;0;45
FR;5;2023-05-24;6;5;0;0;5;0;0;0;0;277973;185628;3602;1022;224756;5352;1179;0;45
FR;5;2023-05-25;1;1;0;0;1;0;0;0;0;277974;185629;3602;1022;224757;5352;1179;0;45
FR;5;2023-05-26;2;5;0;0;5;0;0;0;0;277976;185634;3602;1022;224762;5352;1179;0;45
FR;5;2023-05-27;4;3;1;0;5;1;0;0;0;277980;185637;3603;1022;224767;5353;1179;0;45
FR;5;2023-05-28;0;1;0;0;1;0;0;0;0;277980;185638;3603;1022;224768;5353;1179;0;45
FR;5;2023-05-29;0;1;0;0;0;1;0;0;0;277980;185639;3603;1022;224768;5354;1179;0;45
FR;5;2023-05-30;0;1;0;0;1;0;0;0;0;277980;185640;3603;1022;224769;5354;1179;0;45
FR;5;2023-05-31;5;5;1;0;5;1;0;0;0;277985;185645;3604;1022;224774;5355;1179;0;45
FR;5;2023-06-01;2;0;0;0;0;0;0;0;0;277987;185645;3604;1022;224774;5355;1179;0;45
FR;5;2023-06-02;0;1;0;0;1;0;0;0;0;277987;185646;3604;1022;224775;5355;1179;0;45
FR;5;2023-06-03;3;4;4;0;4;4;1;0;0;277990;185650;3608;1022;224779;5359;1180;0;45
FR;5;2023-06-04;0;0;0;0;0;0;0;0;0;277990;185650;3608;1022;224779;5359;1180;0;45
FR;5;2023-06-05;3;1;0;0;1;0;0;0;0;277993;185651;3608;1022;224780;5359;1180;0;45
FR;5;2023-06-06;3;1;0;0;1;0;0;0;0;277996;185652;3608;1022;224781;5359;1180;0;45
FR;5;2023-06-07;6;1;4;0;0;5;0;0;0;278002;185653;3612;1022;224781;5364;1180;0;45
FR;5;2023-06-08;1;1;1;0;1;1;0;0;0;278003;185654;3613;1022;224782;5365;1180;0;45
FR;5;2023-06-09;1;1;1;0;1;1;0;0;0;278004;185655;3614;1022;224783;5366;1180;0;45
FR;5;2023-06-10;2;2;0;0;3;0;0;0;0;278006;185657;3614;1022;224786;5366;1180;0;45
FR;5;2023-06-11;0;0;1;0;0;1;0;0;0;278006;185657;3615;1022;224786;5367;1180;0;45
FR;5;2023-06-12;0;2;0;0;2;0;0;0;1;278006;185659;3615;1022;224788;5367;1180;0;46
FR;5;2023-06-13;0;0;0;0;0;0;0;0;0;278006;185659;3615;1022;224788;5367;1180;0;46
FR;5;2023-06-14;0;6;0;0;6;0;0;0;0;278006;185665;3615;1022;224794;5367;1180;0;46
FR;5;2023-06-15;1;1;0;1;2;0;0;0;0;278007;185666;3615;1023;224796;5367;1180;0;46
FR;5;2023-06-16;0;2;0;0;2;0;0;0;0;278007;185668;3615;1023;224798;5367;1180;0;46
FR;5;2023-06-17;3;3;0;0;3;1;0;0;0;278010;185671;3615;1023;224801;5368;1180;0;46
FR;5;2023-06-18;1;0;2;0;0;2;0;0;0;278011;185671;3617;1023;224801;5370;1180;0;46
FR;5;2023-06-19;3;0;0;0;0;0;0;0;0;278014;185671;3617;1023;224801;5370;1180;0;46
FR;5;2023-06-20;3;2;0;0;2;0;0;0;0;278017;185673;3617;1023;224803;5370;1180;0;46
FR;5;2023-06-21;0;6;0;0;6;0;0;0;0;278017;185679;3617;1023;224809;5370;1180;0;46
FR;5;2023-06-22;0;0;1;0;0;1;0;0;0;278017;185679;3618;1023;224809;5371;1180;0;46
FR;5;2023-06-23;2;0;0;1;0;0;1;0;0;278019;185679;3618;1024;224809;5371;1181;0;46
FR;5;2023-06-24;2;5;3;0;3;5;0;0;0;278021;185684;3621;1024;224812;5376;1181;0;46
FR;5;2023-06-25;2;0;2;0;0;2;0;0;0;278023;185684;3623;1024;224812;5378;1181;0;46
FR;5;2023-06-26;2;3;0;0;3;0;0;0;0;278025;185687;3623;1024;224815;5378;1181;0;46
FR;5;2023-06-27;4;0;0;0;0;0;0;0;0;278029;185687;3623;1024;224815;5378;1181;0;46
FR;5;2023-06-28;3;5;0;0;6;0;0;0;0;278032;185692;3623;1024;224821;5378;1181;0;46
FR;5;2023-06-29;0;0;0;0;0;0;0;0;0;278032;185692;3623;1024;224821;5378;1181;0;46
FR;5;2023-06-30;1;8;1;0;7;2;0;0;0;278033;185700;3624;1024;224828;5380;1181;0;46
FR;5;2023-07-01;6;2;0;0;2;0;0;0;0;278039;185702;3624;1024;224830;5380;1181;0;46
FR;5;2023-07-02;0;0;0;0;0;0;0;0;0;278039;185702;3624;1024;224830;5380;1181;0;46
FR;5;2023-07-03;1;0;0;0;0;0;0;0;0;278040;185702;3624;1024;224830;5380;1181;0;46
FR;5;2023-07-04;0;2;0;0;2;0;0;0;0;278040;185704;3624;1024;224832;5380;1181;0;46
FR;5;2023-07-05;0;0;0;0;0;0;0;0;0;278040;185704;3624;1024;224832;5380;1181;0;46
FR;5;2023-07-06;1;1;0;0;1;0;0;0;0;278041;185705;3624;1024;224833;5380;1181;0;46
FR;5;2023-07-07;0;2;0;0;2;0;0;0;0;278041;185707;3624;1024;224835;5380;1181;0;46
FR;5;2023-07-08;0;3;0;0;3;0;0;0;0;278041;185710;3624;1024;224838;5380;1181;0;46
FR;5;2023-07-09;0;1;0;0;1;0;0;0;0;278041;185711;3624;1024;224839;5380;1181;0;46
FR;5;2023-07-10;0;3;1;0;2;2;0;0;0;278041;185714;3625;1024;224841;5382;1181;0;46
FR;6;2020-12-27;0;0;0;0;0;0;0;0;0;0;0;0;0;0;0;0;0;0
FR;6;2020-12-28;0;0;0;0;0;0;0;0;0;0;0;0;0;0;0;0;0;0
FR;6;2020-12-29;0;0;0;0;0;0;0;0;0;0;0;0;0;0;0;0;0;0
FR;6;2020-12-30;0;0;0;0;0;0;0;0;0;0;0;0;0;0;0;0;0;0
FR;6;2020-12-31;0;0;0;0;0;0;0;0;0;0;0;0;0;0;0;0;0;0
FR;6;2021-01-01;0;0;0;0;0;0;0;0;0;0;0;0;0;0;0;0;0;0
FR;6;2021-01-02;0;0;0;0;0;0;0;0;0;0;0;0;0;0;0;0;0;0
FR;6;2021-01-03;0;0;0;0;0;0;0;0;0;0;0;0;0;0;0;0;0;0
FR;6;2021-01-04;0;0;0;0;0;0;0;0;0;0;0;0;0;0;0;0;0;0
FR;6;2021-01-05;0;0;0;0;0;0;0;0;0;0;0;0;0;0;0;0;0;0
FR;6;2021-01-06;0;0;0;0;0;0;0;0;0;0;0;0;0;0;0;0;0;0
FR;6;2021-01-07;0;0;0;0;0;0;0;0;0;0;0;0;0;0;0;0;0;0
FR;6;2021-01-08;0;0;0;0;0;0;0;0;0;0;0;0;0;0;0;0;0;0
FR;6;2021-01-09;0;0;0;0;0;0;0;0;0;0;0;0;0;0;0;0;0;0
FR;6;2021-01-10;0;0;0;0;0;0;0;0;0;0;0;0;0;0;0;0;0;0
FR;6;2021-01-11;0;0;0;0;0;0;0;0;0;0;0;0;0;0;0;0;0;0
FR;6;2021-01-12;0;0;0;0;0;0;0;0;0;0;0;0;0;0;0;0;0;0
FR;6;2021-01-13;0;0;0;0;0;0;0;0;0;0;0;0;0;0;0;0;0;0
FR;6;2021-01-14;0;0;0;0;0;0;0;0;0;0;0;0;0;0;0;0;0;0
FR;6;2021-01-15;0;0;0;0;0;0;0;0;0;0;0;0;0;0;0;0;0;0
FR;6;2021-01-16;0;0;0;0;0;0;0;0;0;0;0;0;0;0;0;0;0;0
FR;6;2021-01-17;0;0;0;0;0;0;0;0;0;0;0;0;0;0;0;0;0;0
FR;6;2021-01-18;0;0;0;0;0;0;0;0;0;0;0;0;0;0;0;0;0;0
FR;6;2021-01-19;0;0;0;0;0;0;0;0;0;0;0;0;0;0;0;0;0;0
FR;6;2021-01-20;0;0;0;0;0;0;0;0;0;0;0;0;0;0;0;0;0;0
FR;6;2021-01-21;0;0;0;0;0;0;0;0;0;0;0;0;0;0;0;0;0;0
FR;6;2021-01-22;0;0;0;0;0;0;0;0;0;0;0;0;0;0;0;0;0;0
FR;6;2021-01-23;0;0;0;0;0;0;0;0;0;0;0;0;0;0;0;0;0;0
FR;6;2021-01-24;0;0;0;0;0;0;0;0;0;0;0;0;0;0;0;0;0;0
FR;6;2021-01-25;0;0;0;0;0;0;0;0;0;0;0;0;0;0;0;0;0;0
FR;6;2021-01-26;0;0;0;0;0;0;0;0;0;0;0;0;0;0;0;0;0;0
FR;6;2021-01-27;0;0;0;0;0;0;0;0;0;0;0;0;0;0;0;0;0;0
FR;6;2021-01-28;0;0;0;0;0;0;0;0;0;0;0;0;0;0;0;0;0;0
FR;6;2021-01-29;0;0;0;0;0;0;0;0;0;0;0;0;0;0;0;0;0;0
FR;6;2021-01-30;0;0;0;0;0;0;0;0;0;0;0;0;0;0;0;0;0;0
FR;6;2021-01-31;0;0;0;0;0;0;0;0;0;0;0;0;0;0;0;0;0;0
FR;6;2021-02-01;0;0;0;0;0;0;0;0;0;0;0;0;0;0;0;0;0;0
FR;6;2021-02-02;0;0;0;0;0;0;0;0;0;0;0;0;0;0;0;0;0;0
FR;6;2021-02-03;0;0;0;0;0;0;0;0;0;0;0;0;0;0;0;0;0;0
FR;6;2021-02-04;0;0;0;0;0;0;0;0;0;0;0;0;0;0;0;0;0;0
FR;6;2021-02-05;0;0;0;0;0;0;0;0;0;0;0;0;0;0;0;0;0;0
FR;6;2021-02-06;0;0;0;0;0;0;0;0;0;0;0;0;0;0;0;0;0;0
FR;6;2021-02-07;0;0;0;0;0;0;0;0;0;0;0;0;0;0;0;0;0;0
FR;6;2021-02-08;0;0;0;0;0;0;0;0;0;0;0;0;0;0;0;0;0;0
FR;6;2021-02-09;0;0;0;0;0;0;0;0;0;0;0;0;0;0;0;0;0;0
FR;6;2021-02-10;0;0;0;0;0;0;0;0;0;0;0;0;0;0;0;0;0;0
FR;6;2021-02-11;0;0;0;0;0;0;0;0;0;0;0;0;0;0;0;0;0;0
FR;6;2021-02-12;0;0;0;0;0;0;0;0;0;0;0;0;0;0;0;0;0;0
FR;6;2021-02-13;0;0;0;0;0;0;0;0;0;0;0;0;0;0;0;0;0;0
FR;6;2021-02-14;0;0;0;0;0;0;0;0;0;0;0;0;0;0;0;0;0;0
FR;6;2021-02-15;0;0;0;0;0;0;0;0;0;0;0;0;0;0;0;0;0;0
FR;6;2021-02-16;0;0;0;0;0;0;0;0;0;0;0;0;0;0;0;0;0;0
FR;6;2021-02-17;0;0;0;0;0;0;0;0;0;0;0;0;0;0;0;0;0;0
FR;6;2021-02-18;0;0;0;0;0;0;0;0;0;0;0;0;0;0;0;0;0;0
FR;6;2021-02-19;0;0;0;0;0;0;0;0;0;0;0;0;0;0;0;0;0;0
FR;6;2021-02-20;0;0;0;0;0;0;0;0;0;0;0;0;0;0;0;0;0;0
FR;6;2021-02-21;0;0;0;0;0;0;0;0;0;0;0;0;0;0;0;0;0;0
FR;6;2021-02-22;0;0;0;0;0;0;0;0;0;0;0;0;0;0;0;0;0;0
FR;6;2021-02-23;0;0;0;0;0;0;0;0;0;0;0;0;0;0;0;0;0;0
FR;6;2021-02-24;0;0;0;0;0;0;0;0;0;0;0;0;0;0;0;0;0;0
FR;6;2021-02-25;0;0;0;0;0;0;0;0;0;0;0;0;0;0;0;0;0;0
FR;6;2021-02-26;0;0;0;0;0;0;0;0;0;0;0;0;0;0;0;0;0;0
FR;6;2021-02-27;0;0;0;0;0;0;0;0;0;0;0;0;0;0;0;0;0;0
FR;6;2021-02-28;0;0;0;0;0;0;0;0;0;0;0;0;0;0;0;0;0;0
FR;6;2021-03-01;0;0;0;0;0;0;0;0;0;0;0;0;0;0;0;0;0;0
FR;6;2021-03-02;0;0;0;0;0;0;0;0;0;0;0;0;0;0;0;0;0;0
FR;6;2021-03-03;0;0;0;0;0;0;0;0;0;0;0;0;0;0;0;0;0;0
FR;6;2021-03-04;0;0;0;0;0;0;0;0;0;0;0;0;0;0;0;0;0;0
FR;6;2021-03-05;0;0;0;0;0;0;0;0;0;0;0;0;0;0;0;0;0;0
FR;6;2021-03-06;0;0;0;0;0;0;0;0;0;0;0;0;0;0;0;0;0;0
FR;6;2021-03-07;0;0;0;0;0;0;0;0;0;0;0;0;0;0;0;0;0;0
FR;6;2021-03-08;0;0;0;0;0;0;0;0;0;0;0;0;0;0;0;0;0;0
FR;6;2021-03-09;0;0;0;0;0;0;0;0;0;0;0;0;0;0;0;0;0;0
FR;6;2021-03-10;0;0;0;0;0;0;0;0;0;0;0;0;0;0;0;0;0;0
FR;6;2021-03-11;0;0;0;0;0;0;0;0;0;0;0;0;0;0;0;0;0;0
FR;6;2021-03-12;0;0;0;0;0;0;0;0;0;0;0;0;0;0;0;0;0;0
FR;6;2021-03-13;0;0;0;0;0;0;0;0;0;0;0;0;0;0;0;0;0;0
FR;6;2021-03-14;0;0;0;0;0;0;0;0;0;0;0;0;0;0;0;0;0;0
FR;6;2021-03-15;0;0;0;0;0;0;0;0;0;0;0;0;0;0;0;0;0;0
FR;6;2021-03-16;0;0;0;0;0;0;0;0;0;0;0;0;0;0;0;0;0;0
FR;6;2021-03-17;0;0;0;0;0;0;0;0;0;0;0;0;0;0;0;0;0;0
FR;6;2021-03-18;0;0;0;0;0;0;0;0;0;0;0;0;0;0;0;0;0;0
FR;6;2021-03-19;0;0;0;0;0;0;0;0;0;0;0;0;0;0;0;0;0;0
FR;6;2021-03-20;0;0;0;0;0;0;0;0;0;0;0;0;0;0;0;0;0;0
FR;6;2021-03-21;0;0;0;0;0;0;0;0;0;0;0;0;0;0;0;0;0;0
FR;6;2021-03-22;0;0;0;0;0;0;0;0;0;0;0;0;0;0;0;0;0;0
FR;6;2021-03-23;0;0;0;0;0;0;0;0;0;0;0;0;0;0;0;0;0;0
FR;6;2021-03-24;0;0;0;0;0;0;0;0;0;0;0;0;0;0;0;0;0;0
FR;6;2021-03-25;0;0;0;0;0;0;0;0;0;0;0;0;0;0;0;0;0;0
FR;6;2021-03-26;0;0;0;0;0;0;0;0;0;0;0;0;0;0;0;0;0;0
FR;6;2021-03-27;0;0;0;0;0;0;0;0;0;0;0;0;0;0;0;0;0;0
FR;6;2021-03-28;0;0;0;0;0;0;0;0;0;0;0;0;0;0;0;0;0;0
FR;6;2021-03-29;0;0;0;0;0;0;0;0;0;0;0;0;0;0;0;0;0;0
FR;6;2021-03-30;0;0;0;0;0;0;0;0;0;0;0;0;0;0;0;0;0;0
FR;6;2021-03-31;0;0;0;0;0;0;0;0;0;0;0;0;0;0;0;0;0;0
FR;6;2021-04-01;0;0;0;0;0;0;0;0;0;0;0;0;0;0;0;0;0;0
FR;6;2021-04-02;0;0;0;0;0;0;0;0;0;0;0;0;0;0;0;0;0;0
FR;6;2021-04-03;0;0;0;0;0;0;0;0;0;0;0;0;0;0;0;0;0;0
FR;6;2021-04-04;0;0;0;0;0;0;0;0;0;0;0;0;0;0;0;0;0;0
FR;6;2021-04-05;0;0;0;0;0;0;0;0;0;0;0;0;0;0;0;0;0;0
FR;6;2021-04-06;0;0;0;0;0;0;0;0;0;0;0;0;0;0;0;0;0;0
FR;6;2021-04-07;0;0;0;0;0;0;0;0;0;0;0;0;0;0;0;0;0;0
FR;6;2021-04-08;0;0;0;0;0;0;0;0;0;0;0;0;0;0;0;0;0;0
FR;6;2021-04-09;0;0;0;0;0;0;0;0;0;0;0;0;0;0;0;0;0;0
FR;6;2021-04-10;0;0;0;0;0;0;0;0;0;0;0;0;0;0;0;0;0;0
FR;6;2021-04-11;0;0;0;0;0;0;0;0;0;0;0;0;0;0;0;0;0;0
FR;6;2021-04-12;0;0;0;0;0;0;0;0;0;0;0;0;0;0;0;0;0;0
FR;6;2021-04-13;0;0;0;0;0;0;0;0;0;0;0;0;0;0;0;0;0;0
FR;6;2021-04-14;0;0;0;0;0;0;0;0;0;0;0;0;0;0;0;0;0;0
FR;6;2021-04-15;0;0;0;0;0;0;0;0;0;0;0;0;0;0;0;0;0;0
FR;6;2021-04-16;0;0;0;0;0;0;0;0;0;0;0;0;0;0;0;0;0;0
FR;6;2021-04-17;0;0;0;0;0;0;0;0;0;0;0;0;0;0;0;0;0;0
FR;6;2021-04-18;0;0;0;0;0;0;0;0;0;0;0;0;0;0;0;0;0;0
FR;6;2021-04-19;0;0;0;0;0;0;0;0;0;0;0;0;0;0;0;0;0;0
FR;6;2021-04-20;0;0;0;0;0;0;0;0;0;0;0;0;0;0;0;0;0;0
FR;6;2021-04-21;0;0;0;0;0;0;0;0;0;0;0;0;0;0;0;0;0;0
FR;6;2021-04-22;0;0;0;0;0;0;0;0;0;0;0;0;0;0;0;0;0;0
FR;6;2021-04-23;0;0;0;0;0;0;0;0;0;0;0;0;0;0;0;0;0;0
FR;6;2021-04-24;0;0;0;0;0;0;0;0;0;0;0;0;0;0;0;0;0;0
FR;6;2021-04-25;0;0;0;0;0;0;0;0;0;0;0;0;0;0;0;0;0;0
FR;6;2021-04-26;0;0;0;0;0;0;0;0;0;0;0;0;0;0;0;0;0;0
FR;6;2021-04-27;0;0;0;0;0;0;0;0;0;0;0;0;0;0;0;0;0;0
FR;6;2021-04-28;0;0;0;0;0;0;0;0;0;0;0;0;0;0;0;0;0;0
FR;6;2021-04-29;0;0;0;0;0;0;0;0;0;0;0;0;0;0;0;0;0;0
FR;6;2021-04-30;0;0;0;0;0;0;0;0;0;0;0;0;0;0;0;0;0;0
FR;6;2021-05-01;0;0;0;0;0;0;0;0;0;0;0;0;0;0;0;0;0;0
FR;6;2021-05-02;0;0;0;0;0;0;0;0;0;0;0;0;0;0;0;0;0;0
FR;6;2021-05-03;0;0;0;0;0;0;0;0;0;0;0;0;0;0;0;0;0;0
FR;6;2021-05-04;0;0;0;0;0;0;0;0;0;0;0;0;0;0;0;0;0;0
FR;6;2021-05-05;0;0;0;0;0;0;0;0;0;0;0;0;0;0;0;0;0;0
FR;6;2021-05-06;0;0;0;0;0;0;0;0;0;0;0;0;0;0;0;0;0;0
FR;6;2021-05-07;0;0;0;0;0;0;0;0;0;0;0;0;0;0;0;0;0;0
FR;6;2021-05-08;0;0;0;0;0;0;0;0;0;0;0;0;0;0;0;0;0;0
FR;6;2021-05-09;0;0;0;0;0;0;0;0;0;0;0;0;0;0;0;0;0;0
FR;6;2021-05-10;0;0;0;0;0;0;0;0;0;0;0;0;0;0;0;0;0;0
FR;6;2021-05-11;0;0;0;0;0;0;0;0;0;0;0;0;0;0;0;0;0;0
FR;6;2021-05-12;0;0;0;0;0;0;0;0;0;0;0;0;0;0;0;0;0;0
FR;6;2021-05-13;0;0;0;0;0;0;0;0;0;0;0;0;0;0;0;0;0;0
FR;6;2021-05-14;0;0;0;0;0;0;0;0;0;0;0;0;0;0;0;0;0;0
FR;6;2021-05-15;0;0;0;0;0;0;0;0;0;0;0;0;0;0;0;0;0;0
FR;6;2021-05-16;0;0;0;0;0;0;0;0;0;0;0;0;0;0;0;0;0;0
FR;6;2021-05-17;0;0;0;0;0;0;0;0;0;0;0;0;0;0;0;0;0;0
FR;6;2021-05-18;0;0;0;0;0;0;0;0;0;0;0;0;0;0;0;0;0;0
FR;6;2021-05-19;0;0;0;0;0;0;0;0;0;0;0;0;0;0;0;0;0;0
FR;6;2021-05-20;0;0;0;0;0;0;0;0;0;0;0;0;0;0;0;0;0;0
FR;6;2021-05-21;0;0;0;0;0;0;0;0;0;0;0;0;0;0;0;0;0;0
FR;6;2021-05-22;0;0;0;0;0;0;0;0;0;0;0;0;0;0;0;0;0;0
FR;6;2021-05-23;0;0;0;0;0;0;0;0;0;0;0;0;0;0;0;0;0;0
FR;6;2021-05-24;0;0;0;0;0;0;0;0;0;0;0;0;0;0;0;0;0;0
FR;6;2021-05-25;0;0;0;0;0;0;0;0;0;0;0;0;0;0;0;0;0;0
FR;6;2021-05-26;0;0;0;0;0;0;0;0;0;0;0;0;0;0;0;0;0;0
FR;6;2021-05-27;0;0;0;0;0;0;0;0;0;0;0;0;0;0;0;0;0;0
FR;6;2021-05-28;0;0;0;0;0;0;0;0;0;0;0;0;0;0;0;0;0;0
FR;6;2021-05-29;0;0;0;0;0;0;0;0;0;0;0;0;0;0;0;0;0;0
FR;6;2021-05-30;0;0;0;0;0;0;0;0;0;0;0;0;0;0;0;0;0;0
FR;6;2021-05-31;0;0;0;0;0;0;0;0;0;0;0;0;0;0;0;0;0;0
FR;6;2021-06-01;0;0;0;0;0;0;0;0;0;0;0;0;0;0;0;0;0;0
FR;6;2021-06-02;0;0;0;0;0;0;0;0;0;0;0;0;0;0;0;0;0;0
FR;6;2021-06-03;0;0;0;0;0;0;0;0;0;0;0;0;0;0;0;0;0;0
FR;6;2021-06-04;0;0;0;0;0;0;0;0;0;0;0;0;0;0;0;0;0;0
FR;6;2021-06-05;0;0;0;0;0;0;0;0;0;0;0;0;0;0;0;0;0;0
FR;6;2021-06-06;0;0;0;0;0;0;0;0;0;0;0;0;0;0;0;0;0;0
FR;6;2021-06-07;0;0;0;0;0;0;0;0;0;0;0;0;0;0;0;0;0;0
FR;6;2021-06-08;0;0;0;0;0;0;0;0;0;0;0;0;0;0;0;0;0;0
FR;6;2021-06-09;0;0;0;0;0;0;0;0;0;0;0;0;0;0;0;0;0;0
FR;6;2021-06-10;0;0;0;0;0;0;0;0;0;0;0;0;0;0;0;0;0;0
FR;6;2021-06-11;0;0;0;0;0;0;0;0;0;0;0;0;0;0;0;0;0;0
FR;6;2021-06-12;0;0;0;0;0;0;0;0;0;0;0;0;0;0;0;0;0;0
FR;6;2021-06-13;0;0;0;0;0;0;0;0;0;0;0;0;0;0;0;0;0;0
FR;6;2021-06-14;0;0;0;0;0;0;0;0;0;0;0;0;0;0;0;0;0;0
FR;6;2021-06-15;0;0;0;0;0;0;0;0;0;0;0;0;0;0;0;0;0;0
FR;6;2021-06-16;0;0;0;0;0;0;0;0;0;0;0;0;0;0;0;0;0;0
FR;6;2021-06-17;0;0;0;0;0;0;0;0;0;0;0;0;0;0;0;0;0;0
FR;6;2021-06-18;0;0;0;0;0;0;0;0;0;0;0;0;0;0;0;0;0;0
FR;6;2021-06-19;0;0;0;0;0;0;0;0;0;0;0;0;0;0;0;0;0;0
FR;6;2021-06-20;0;0;0;0;0;0;0;0;0;0;0;0;0;0;0;0;0;0
FR;6;2021-06-21;0;0;0;0;0;0;0;0;0;0;0;0;0;0;0;0;0;0
FR;6;2021-06-22;0;0;0;0;0;0;0;0;0;0;0;0;0;0;0;0;0;0
FR;6;2021-06-23;0;0;0;0;0;0;0;0;0;0;0;0;0;0;0;0;0;0
FR;6;2021-06-24;0;0;0;0;0;0;0;0;0;0;0;0;0;0;0;0;0;0
FR;6;2021-06-25;0;0;0;0;0;0;0;0;0;0;0;0;0;0;0;0;0;0
FR;6;2021-06-26;0;0;0;0;0;0;0;0;0;0;0;0;0;0;0;0;0;0
FR;6;2021-06-27;0;0;0;0;0;0;0;0;0;0;0;0;0;0;0;0;0;0
FR;6;2021-06-28;0;0;0;0;0;0;0;0;0;0;0;0;0;0;0;0;0;0
FR;6;2021-06-29;0;0;0;0;0;0;0;0;0;0;0;0;0;0;0;0;0;0
FR;6;2021-06-30;0;0;0;0;0;0;0;0;0;0;0;0;0;0;0;0;0;0
FR;6;2021-07-01;0;0;0;0;0;0;0;0;0;0;0;0;0;0;0;0;0;0
FR;6;2021-07-02;0;0;0;0;0;0;0;0;0;0;0;0;0;0;0;0;0;0
FR;6;2021-07-03;0;0;0;0;0;0;0;0;0;0;0;0;0;0;0;0;0;0
FR;6;2021-07-04;0;0;0;0;0;0;0;0;0;0;0;0;0;0;0;0;0;0
FR;6;2021-07-05;0;0;0;0;0;0;0;0;0;0;0;0;0;0;0;0;0;0
FR;6;2021-07-06;0;0;0;0;0;0;0;0;0;0;0;0;0;0;0;0;0;0
FR;6;2021-07-07;0;0;0;0;0;0;0;0;0;0;0;0;0;0;0;0;0;0
FR;6;2021-07-08;0;0;0;0;0;0;0;0;0;0;0;0;0;0;0;0;0;0
FR;6;2021-07-09;0;0;0;0;0;0;0;0;0;0;0;0;0;0;0;0;0;0
FR;6;2021-07-10;0;0;0;0;0;0;0;0;0;0;0;0;0;0;0;0;0;0
FR;6;2021-07-11;0;0;0;0;0;0;0;0;0;0;0;0;0;0;0;0;0;0
FR;6;2021-07-12;0;0;0;0;0;0;0;0;0;0;0;0;0;0;0;0;0;0
FR;6;2021-07-13;0;0;0;0;0;0;0;0;0;0;0;0;0;0;0;0;0;0
FR;6;2021-07-14;0;0;0;0;0;0;0;0;0;0;0;0;0;0;0;0;0;0
FR;6;2021-07-15;0;0;0;0;0;0;0;0;0;0;0;0;0;0;0;0;0;0
FR;6;2021-07-16;0;0;0;0;0;0;0;0;0;0;0;0;0;0;0;0;0;0
FR;6;2021-07-17;0;0;0;0;0;0;0;0;0;0;0;0;0;0;0;0;0;0
FR;6;2021-07-18;0;0;0;0;0;0;0;0;0;0;0;0;0;0;0;0;0;0
FR;6;2021-07-19;0;0;0;0;0;0;0;0;0;0;0;0;0;0;0;0;0;0
FR;6;2021-07-20;0;0;0;0;0;0;0;0;0;0;0;0;0;0;0;0;0;0
FR;6;2021-07-21;0;0;0;0;0;0;0;0;0;0;0;0;0;0;0;0;0;0
FR;6;2021-07-22;0;0;0;0;0;0;0;0;0;0;0;0;0;0;0;0;0;0
FR;6;2021-07-23;0;0;0;0;0;0;0;0;0;0;0;0;0;0;0;0;0;0
FR;6;2021-07-24;0;0;0;0;0;0;0;0;0;0;0;0;0;0;0;0;0;0
FR;6;2021-07-25;0;0;0;0;0;0;0;0;0;0;0;0;0;0;0;0;0;0
FR;6;2021-07-26;0;0;0;0;0;0;0;0;0;0;0;0;0;0;0;0;0;0
FR;6;2021-07-27;0;0;0;0;0;0;0;0;0;0;0;0;0;0;0;0;0;0
FR;6;2021-07-28;0;0;0;0;0;0;0;0;0;0;0;0;0;0;0;0;0;0
FR;6;2021-07-29;0;0;0;0;0;0;0;0;0;0;0;0;0;0;0;0;0;0
FR;6;2021-07-30;0;0;0;0;0;0;0;0;0;0;0;0;0;0;0;0;0;0
FR;6;2021-07-31;0;0;0;0;0;0;0;0;0;0;0;0;0;0;0;0;0;0
FR;6;2021-08-01;0;0;0;0;0;0;0;0;0;0;0;0;0;0;0;0;0;0
FR;6;2021-08-02;0;0;0;0;0;0;0;0;0;0;0;0;0;0;0;0;0;0
FR;6;2021-08-03;0;0;0;0;0;0;0;0;0;0;0;0;0;0;0;0;0;0
FR;6;2021-08-04;0;0;0;0;0;0;0;0;0;0;0;0;0;0;0;0;0;0
FR;6;2021-08-05;0;0;0;0;0;0;0;0;0;0;0;0;0;0;0;0;0;0
FR;6;2021-08-06;0;0;0;0;0;0;0;0;0;0;0;0;0;0;0;0;0;0
FR;6;2021-08-07;0;0;0;0;0;0;0;0;0;0;0;0;0;0;0;0;0;0
FR;6;2021-08-08;0;0;0;0;0;0;0;0;0;0;0;0;0;0;0;0;0;0
FR;6;2021-08-09;0;0;0;0;0;0;0;0;0;0;0;0;0;0;0;0;0;0
FR;6;2021-08-10;0;0;0;0;0;0;0;0;0;0;0;0;0;0;0;0;0;0
FR;6;2021-08-11;0;0;0;0;0;0;0;0;0;0;0;0;0;0;0;0;0;0
FR;6;2021-08-12;0;0;0;0;0;0;0;0;0;0;0;0;0;0;0;0;0;0
FR;6;2021-08-13;0;0;0;0;0;0;0;0;0;0;0;0;0;0;0;0;0;0
FR;6;2021-08-14;0;0;0;0;0;0;0;0;0;0;0;0;0;0;0;0;0;0
FR;6;2021-08-15;0;0;0;0;0;0;0;0;0;0;0;0;0;0;0;0;0;0
FR;6;2021-08-16;0;0;0;0;0;0;0;0;0;0;0;0;0;0;0;0;0;0
FR;6;2021-08-17;0;0;0;0;0;0;0;0;0;0;0;0;0;0;0;0;0;0
FR;6;2021-08-18;0;0;0;0;0;0;0;0;0;0;0;0;0;0;0;0;0;0
FR;6;2021-08-19;0;0;0;0;0;0;0;0;0;0;0;0;0;0;0;0;0;0
FR;6;2021-08-20;0;0;0;0;0;0;0;0;0;0;0;0;0;0;0;0;0;0
FR;6;2021-08-21;0;0;0;0;0;0;0;0;0;0;0;0;0;0;0;0;0;0
FR;6;2021-08-22;0;0;0;0;0;0;0;0;0;0;0;0;0;0;0;0;0;0
FR;6;2021-08-23;0;0;0;0;0;0;0;0;0;0;0;0;0;0;0;0;0;0
FR;6;2021-08-24;0;0;0;0;0;0;0;0;0;0;0;0;0;0;0;0;0;0
FR;6;2021-08-25;0;0;0;0;0;0;0;0;0;0;0;0;0;0;0;0;0;0
FR;6;2021-08-26;0;0;0;0;0;0;0;0;0;0;0;0;0;0;0;0;0;0
FR;6;2021-08-27;0;0;0;0;0;0;0;0;0;0;0;0;0;0;0;0;0;0
FR;6;2021-08-28;0;0;0;0;0;0;0;0;0;0;0;0;0;0;0;0;0;0
FR;6;2021-08-29;0;0;0;0;0;0;0;0;0;0;0;0;0;0;0;0;0;0
FR;6;2021-08-30;0;0;0;0;0;0;0;0;0;0;0;0;0;0;0;0;0;0
FR;6;2021-08-31;0;0;0;0;0;0;0;0;0;0;0;0;0;0;0;0;0;0
FR;6;2021-09-01;0;0;0;0;0;0;0;0;0;0;0;0;0;0;0;0;0;0
FR;6;2021-09-02;0;0;0;0;0;0;0;0;0;0;0;0;0;0;0;0;0;0
FR;6;2021-09-03;0;0;0;0;0;0;0;0;0;0;0;0;0;0;0;0;0;0
FR;6;2021-09-04;0;0;0;0;0;0;0;0;0;0;0;0;0;0;0;0;0;0
FR;6;2021-09-05;0;0;0;0;0;0;0;0;0;0;0;0;0;0;0;0;0;0
FR;6;2021-09-06;0;0;0;0;0;0;0;0;0;0;0;0;0;0;0;0;0;0
FR;6;2021-09-07;0;0;0;0;0;0;0;0;0;0;0;0;0;0;0;0;0;0
FR;6;2021-09-08;0;0;0;0;0;0;0;0;0;0;0;0;0;0;0;0;0;0
FR;6;2021-09-09;0;0;0;0;0;0;0;0;0;0;0;0;0;0;0;0;0;0
FR;6;2021-09-10;0;0;0;0;0;0;0;0;0;0;0;0;0;0;0;0;0;0
FR;6;2021-09-11;0;0;0;0;0;0;0;0;0;0;0;0;0;0;0;0;0;0
FR;6;2021-09-12;0;0;0;0;0;0;0;0;0;0;0;0;0;0;0;0;0;0
FR;6;2021-09-13;0;0;0;0;0;0;0;0;0;0;0;0;0;0;0;0;0;0
FR;6;2021-09-14;0;0;0;0;0;0;0;0;0;0;0;0;0;0;0;0;0;0
FR;6;2021-09-15;0;0;0;0;0;0;0;0;0;0;0;0;0;0;0;0;0;0
FR;6;2021-09-16;0;0;0;0;0;0;0;0;0;0;0;0;0;0;0;0;0;0
FR;6;2021-09-17;0;0;0;0;0;0;0;0;0;0;0;0;0;0;0;0;0;0
FR;6;2021-09-18;0;0;0;0;0;0;0;0;0;0;0;0;0;0;0;0;0;0
FR;6;2021-09-19;0;0;0;0;0;0;0;0;0;0;0;0;0;0;0;0;0;0
FR;6;2021-09-20;0;0;0;0;0;0;0;0;0;0;0;0;0;0;0;0;0;0
FR;6;2021-09-21;0;0;0;0;0;0;0;0;0;0;0;0;0;0;0;0;0;0
FR;6;2021-09-22;0;0;0;0;0;0;0;0;0;0;0;0;0;0;0;0;0;0
FR;6;2021-09-23;0;0;0;0;0;0;0;0;0;0;0;0;0;0;0;0;0;0
FR;6;2021-09-24;0;0;0;0;0;0;0;0;0;0;0;0;0;0;0;0;0;0
FR;6;2021-09-25;0;0;0;0;0;0;0;0;0;0;0;0;0;0;0;0;0;0
FR;6;2021-09-26;0;0;0;0;0;0;0;0;0;0;0;0;0;0;0;0;0;0
FR;6;2021-09-27;0;0;0;0;0;0;0;0;0;0;0;0;0;0;0;0;0;0
FR;6;2021-09-28;0;0;0;0;0;0;0;0;0;0;0;0;0;0;0;0;0;0
FR;6;2021-09-29;0;0;0;0;0;0;0;0;0;0;0;0;0;0;0;0;0;0
FR;6;2021-09-30;0;0;0;0;0;0;0;0;0;0;0;0;0;0;0;0;0;0
FR;6;2021-10-01;0;0;0;0;0;0;0;0;0;0;0;0;0;0;0;0;0;0
FR;6;2021-10-02;0;0;0;0;0;0;0;0;0;0;0;0;0;0;0;0;0;0
FR;6;2021-10-03;0;0;0;0;0;0;0;0;0;0;0;0;0;0;0;0;0;0
FR;6;2021-10-04;0;0;0;0;0;0;0;0;0;0;0;0;0;0;0;0;0;0
FR;6;2021-10-05;0;0;0;0;0;0;0;0;0;0;0;0;0;0;0;0;0;0
FR;6;2021-10-06;0;0;0;0;0;0;0;0;0;0;0;0;0;0;0;0;0;0
FR;6;2021-10-07;0;0;0;0;0;0;0;0;0;0;0;0;0;0;0;0;0;0
FR;6;2021-10-08;0;0;0;0;0;0;0;0;0;0;0;0;0;0;0;0;0;0
FR;6;2021-10-09;0;0;0;0;0;0;0;0;0;0;0;0;0;0;0;0;0;0
FR;6;2021-10-10;0;0;0;0;0;0;0;0;0;0;0;0;0;0;0;0;0;0
FR;6;2021-10-11;0;0;0;0;0;0;0;0;0;0;0;0;0;0;0;0;0;0
FR;6;2021-10-12;0;0;0;0;0;0;0;0;0;0;0;0;0;0;0;0;0;0
FR;6;2021-10-13;0;0;0;0;0;0;0;0;0;0;0;0;0;0;0;0;0;0
FR;6;2021-10-14;0;0;0;0;0;0;0;0;0;0;0;0;0;0;0;0;0;0
FR;6;2021-10-15;0;0;0;0;0;0;0;0;0;0;0;0;0;0;0;0;0;0
FR;6;2021-10-16;0;0;0;0;0;0;0;0;0;0;0;0;0;0;0;0;0;0
FR;6;2021-10-17;0;0;0;0;0;0;0;0;0;0;0;0;0;0;0;0;0;0
FR;6;2021-10-18;0;0;0;0;0;0;0;0;0;0;0;0;0;0;0;0;0;0
FR;6;2021-10-19;0;0;0;0;0;0;0;0;0;0;0;0;0;0;0;0;0;0
FR;6;2021-10-20;0;0;0;0;0;0;0;0;0;0;0;0;0;0;0;0;0;0
FR;6;2021-10-21;0;0;0;0;0;0;0;0;0;0;0;0;0;0;0;0;0;0
FR;6;2021-10-22;0;0;0;0;0;0;0;0;0;0;0;0;0;0;0;0;0;0
FR;6;2021-10-23;0;0;0;0;0;0;0;0;0;0;0;0;0;0;0;0;0;0
FR;6;2021-10-24;0;0;0;0;0;0;0;0;0;0;0;0;0;0;0;0;0;0
FR;6;2021-10-25;0;0;0;0;0;0;0;0;0;0;0;0;0;0;0;0;0;0
FR;6;2021-10-26;0;0;0;0;0;0;0;0;0;0;0;0;0;0;0;0;0;0
FR;6;2021-10-27;0;0;0;0;0;0;0;0;0;0;0;0;0;0;0;0;0;0
FR;6;2021-10-28;0;0;0;0;0;0;0;0;0;0;0;0;0;0;0;0;0;0
FR;6;2021-10-29;0;0;0;0;0;0;0;0;0;0;0;0;0;0;0;0;0;0
FR;6;2021-10-30;0;0;0;0;0;0;0;0;0;0;0;0;0;0;0;0;0;0
FR;6;2021-10-31;0;0;0;0;0;0;0;0;0;0;0;0;0;0;0;0;0;0
FR;6;2021-11-01;0;0;0;0;0;0;0;0;0;0;0;0;0;0;0;0;0;0
FR;6;2021-11-02;0;0;0;0;0;0;0;0;0;0;0;0;0;0;0;0;0;0
FR;6;2021-11-03;0;0;0;0;0;0;0;0;0;0;0;0;0;0;0;0;0;0
FR;6;2021-11-04;0;0;0;0;0;0;0;0;0;0;0;0;0;0;0;0;0;0
FR;6;2021-11-05;0;0;0;0;0;0;0;0;0;0;0;0;0;0;0;0;0;0
FR;6;2021-11-06;0;0;0;0;0;0;0;0;0;0;0;0;0;0;0;0;0;0
FR;6;2021-11-07;0;0;0;0;0;0;0;0;0;0;0;0;0;0;0;0;0;0
FR;6;2021-11-08;0;0;0;0;0;0;0;0;0;0;0;0;0;0;0;0;0;0
FR;6;2021-11-09;0;0;0;0;0;0;0;0;0;0;0;0;0;0;0;0;0;0
FR;6;2021-11-10;0;0;0;0;0;0;0;0;0;0;0;0;0;0;0;0;0;0
FR;6;2021-11-11;0;0;0;0;0;0;0;0;0;0;0;0;0;0;0;0;0;0
FR;6;2021-11-12;0;0;0;0;0;0;0;0;0;0;0;0;0;0;0;0;0;0
FR;6;2021-11-13;0;0;0;0;0;0;0;0;0;0;0;0;0;0;0;0;0;0
FR;6;2021-11-14;0;0;0;0;0;0;0;0;0;0;0;0;0;0;0;0;0;0
FR;6;2021-11-15;0;0;0;0;0;0;0;0;0;0;0;0;0;0;0;0;0;0
FR;6;2021-11-16;0;0;0;0;0;0;0;0;0;0;0;0;0;0;0;0;0;0
FR;6;2021-11-17;0;0;0;0;0;0;0;0;0;0;0;0;0;0;0;0;0;0
FR;6;2021-11-18;0;0;0;0;0;0;0;0;0;0;0;0;0;0;0;0;0;0
FR;6;2021-11-19;0;0;0;0;0;0;0;0;0;0;0;0;0;0;0;0;0;0
FR;6;2021-11-20;0;0;0;0;0;0;0;0;0;0;0;0;0;0;0;0;0;0
FR;6;2021-11-21;0;0;0;0;0;0;0;0;0;0;0;0;0;0;0;0;0;0
FR;6;2021-11-22;0;0;0;0;0;0;0;0;0;0;0;0;0;0;0;0;0;0
FR;6;2021-11-23;0;0;0;0;0;0;0;0;0;0;0;0;0;0;0;0;0;0
FR;6;2021-11-24;0;0;0;0;0;0;0;0;0;0;0;0;0;0;0;0;0;0
FR;6;2021-11-25;0;0;0;0;0;0;0;0;0;0;0;0;0;0;0;0;0;0
FR;6;2021-11-26;0;0;0;0;0;0;0;0;0;0;0;0;0;0;0;0;0;0
FR;6;2021-11-27;0;0;0;0;0;0;0;0;0;0;0;0;0;0;0;0;0;0
FR;6;2021-11-28;0;0;0;0;0;0;0;0;0;0;0;0;0;0;0;0;0;0
FR;6;2021-11-29;0;0;0;0;0;0;0;0;0;0;0;0;0;0;0;0;0;0
FR;6;2021-11-30;0;0;0;0;0;0;0;0;0;0;0;0;0;0;0;0;0;0
FR;6;2021-12-01;0;0;0;0;0;0;0;0;0;0;0;0;0;0;0;0;0;0
FR;6;2021-12-02;0;0;0;0;0;0;0;0;0;0;0;0;0;0;0;0;0;0
FR;6;2021-12-03;0;0;0;0;0;0;0;0;0;0;0;0;0;0;0;0;0;0
FR;6;2021-12-04;0;0;0;0;0;0;0;0;0;0;0;0;0;0;0;0;0;0
FR;6;2021-12-05;0;0;0;0;0;0;0;0;0;0;0;0;0;0;0;0;0;0
FR;6;2021-12-06;0;0;0;0;0;0;0;0;0;0;0;0;0;0;0;0;0;0
FR;6;2021-12-07;0;0;0;0;0;0;0;0;0;0;0;0;0;0;0;0;0;0
FR;6;2021-12-08;0;0;0;0;0;0;0;0;0;0;0;0;0;0;0;0;0;0
FR;6;2021-12-09;0;0;0;0;0;0;0;0;0;0;0;0;0;0;0;0;0;0
FR;6;2021-12-10;0;0;0;0;0;0;0;0;0;0;0;0;0;0;0;0;0;0
FR;6;2021-12-11;0;0;0;0;0;0;0;0;0;0;0;0;0;0;0;0;0;0
FR;6;2021-12-12;0;0;0;0;0;0;0;0;0;0;0;0;0;0;0;0;0;0
FR;6;2021-12-13;0;0;0;0;0;0;0;0;0;0;0;0;0;0;0;0;0;0
FR;6;2021-12-14;0;0;0;0;0;0;0;0;0;0;0;0;0;0;0;0;0;0
FR;6;2021-12-15;0;0;0;0;0;0;0;0;0;0;0;0;0;0;0;0;0;0
FR;6;2021-12-16;0;0;0;0;0;0;0;0;0;0;0;0;0;0;0;0;0;0
FR;6;2021-12-17;0;0;0;0;0;0;0;0;0;0;0;0;0;0;0;0;0;0
FR;6;2021-12-18;0;0;0;0;0;0;0;0;0;0;0;0;0;0;0;0;0;0
FR;6;2021-12-19;0;0;0;0;0;0;0;0;0;0;0;0;0;0;0;0;0;0
FR;6;2021-12-20;0;0;0;0;0;0;0;0;0;0;0;0;0;0;0;0;0;0
FR;6;2021-12-21;0;0;0;0;0;0;0;0;0;0;0;0;0;0;0;0;0;0
FR;6;2021-12-22;0;0;0;0;0;0;0;0;0;0;0;0;0;0;0;0;0;0
FR;6;2021-12-23;0;0;0;0;0;0;0;0;0;0;0;0;0;0;0;0;0;0
FR;6;2021-12-24;0;0;0;0;0;0;0;0;0;0;0;0;0;0;0;0;0;0
FR;6;2021-12-25;0;0;0;0;0;0;0;0;0;0;0;0;0;0;0;0;0;0
FR;6;2021-12-26;0;0;0;0;0;0;0;0;0;0;0;0;0;0;0;0;0;0
FR;6;2021-12-27;0;0;0;0;0;0;0;0;0;0;0;0;0;0;0;0;0;0
FR;6;2021-12-28;0;0;0;0;0;0;0;0;0;0;0;0;0;0;0;0;0;0
FR;6;2021-12-29;0;0;0;0;0;0;0;0;0;0;0;0;0;0;0;0;0;0
FR;6;2021-12-30;0;0;0;0;0;0;0;0;0;0;0;0;0;0;0;0;0;0
FR;6;2021-12-31;0;0;0;0;0;0;0;0;0;0;0;0;0;0;0;0;0;0
FR;6;2022-01-01;0;0;0;0;0;0;0;0;0;0;0;0;0;0;0;0;0;0
FR;6;2022-01-02;0;0;0;0;0;0;0;0;0;0;0;0;0;0;0;0;0;0
FR;6;2022-01-03;0;0;0;0;0;0;0;0;0;0;0;0;0;0;0;0;0;0
FR;6;2022-01-04;0;0;0;0;0;0;0;0;0;0;0;0;0;0;0;0;0;0
FR;6;2022-01-05;0;0;0;0;0;0;0;0;0;0;0;0;0;0;0;0;0;0
FR;6;2022-01-06;0;0;0;0;0;0;0;0;0;0;0;0;0;0;0;0;0;0
FR;6;2022-01-07;0;0;0;0;0;0;0;0;0;0;0;0;0;0;0;0;0;0
FR;6;2022-01-08;0;0;0;0;0;0;0;0;0;0;0;0;0;0;0;0;0;0
FR;6;2022-01-09;0;0;0;0;0;0;0;0;0;0;0;0;0;0;0;0;0;0
FR;6;2022-01-10;0;0;0;0;0;0;0;0;0;0;0;0;0;0;0;0;0;0
FR;6;2022-01-11;0;0;0;0;0;0;0;0;0;0;0;0;0;0;0;0;0;0
FR;6;2022-01-12;0;0;0;0;0;0;0;0;0;0;0;0;0;0;0;0;0;0
FR;6;2022-01-13;0;0;0;0;0;0;0;0;0;0;0;0;0;0;0;0;0;0
FR;6;2022-01-14;0;0;0;0;0;0;0;0;0;0;0;0;0;0;0;0;0;0
FR;6;2022-01-15;0;0;0;0;0;0;0;0;0;0;0;0;0;0;0;0;0;0
FR;6;2022-01-16;0;0;0;0;0;0;0;0;0;0;0;0;0;0;0;0;0;0
FR;6;2022-01-17;0;0;0;0;0;0;0;0;0;0;0;0;0;0;0;0;0;0
FR;6;2022-01-18;0;0;0;0;0;0;0;0;0;0;0;0;0;0;0;0;0;0
FR;6;2022-01-19;0;0;0;0;0;0;0;0;0;0;0;0;0;0;0;0;0;0
FR;6;2022-01-20;0;0;0;0;0;0;0;0;0;0;0;0;0;0;0;0;0;0
FR;6;2022-01-21;0;0;0;0;0;0;0;0;0;0;0;0;0;0;0;0;0;0
FR;6;2022-01-22;0;0;0;0;0;0;0;0;0;0;0;0;0;0;0;0;0;0
FR;6;2022-01-23;0;0;0;0;0;0;0;0;0;0;0;0;0;0;0;0;0;0
FR;6;2022-01-24;0;0;0;0;0;0;0;0;0;0;0;0;0;0;0;0;0;0
FR;6;2022-01-25;0;0;0;0;0;0;0;0;0;0;0;0;0;0;0;0;0;0
FR;6;2022-01-26;0;0;0;0;0;0;0;0;0;0;0;0;0;0;0;0;0;0
FR;6;2022-01-27;0;0;0;0;0;0;0;0;0;0;0;0;0;0;0;0;0;0
FR;6;2022-01-28;0;0;0;0;0;0;0;0;0;0;0;0;0;0;0;0;0;0
FR;6;2022-01-29;0;0;0;0;0;0;0;0;0;0;0;0;0;0;0;0;0;0
FR;6;2022-01-30;0;0;0;0;0;0;0;0;0;0;0;0;0;0;0;0;0;0
FR;6;2022-01-31;0;0;0;0;0;0;0;0;0;0;0;0;0;0;0;0;0;0
FR;6;2022-02-01;0;0;0;0;0;0;0;0;0;0;0;0;0;0;0;0;0;0
FR;6;2022-02-02;0;0;0;0;0;0;0;0;0;0;0;0;0;0;0;0;0;0
FR;6;2022-02-03;0;0;0;0;0;0;0;0;0;0;0;0;0;0;0;0;0;0
FR;6;2022-02-04;0;0;0;0;0;0;0;0;0;0;0;0;0;0;0;0;0;0
FR;6;2022-02-05;0;0;0;0;0;0;0;0;0;0;0;0;0;0;0;0;0;0
FR;6;2022-02-06;0;0;0;0;0;0;0;0;0;0;0;0;0;0;0;0;0;0
FR;6;2022-02-07;0;0;0;0;0;0;0;0;0;0;0;0;0;0;0;0;0;0
FR;6;2022-02-08;0;0;0;0;0;0;0;0;0;0;0;0;0;0;0;0;0;0
FR;6;2022-02-09;0;0;0;0;0;0;0;0;0;0;0;0;0;0;0;0;0;0
FR;6;2022-02-10;0;0;0;0;0;0;0;0;0;0;0;0;0;0;0;0;0;0
FR;6;2022-02-11;0;0;0;0;0;0;0;0;0;0;0;0;0;0;0;0;0;0
FR;6;2022-02-12;0;0;0;0;0;0;0;0;0;0;0;0;0;0;0;0;0;0
FR;6;2022-02-13;0;0;0;0;0;0;0;0;0;0;0;0;0;0;0;0;0;0
FR;6;2022-02-14;0;0;0;0;0;0;0;0;0;0;0;0;0;0;0;0;0;0
FR;6;2022-02-15;0;0;0;0;0;0;0;0;0;0;0;0;0;0;0;0;0;0
FR;6;2022-02-16;0;0;0;0;0;0;0;0;0;0;0;0;0;0;0;0;0;0
FR;6;2022-02-17;0;0;0;0;0;0;0;0;0;0;0;0;0;0;0;0;0;0
FR;6;2022-02-18;0;0;0;0;0;0;0;0;0;0;0;0;0;0;0;0;0;0
FR;6;2022-02-19;0;0;0;0;0;0;0;0;0;0;0;0;0;0;0;0;0;0
FR;6;2022-02-20;0;0;0;0;0;0;0;0;0;0;0;0;0;0;0;0;0;0
FR;6;2022-02-21;0;0;0;0;0;0;0;0;0;0;0;0;0;0;0;0;0;0
FR;6;2022-02-22;0;0;0;0;0;0;0;0;0;0;0;0;0;0;0;0;0;0
FR;6;2022-02-23;0;0;0;0;0;0;0;0;0;0;0;0;0;0;0;0;0;0
FR;6;2022-02-24;0;0;0;0;0;0;0;0;0;0;0;0;0;0;0;0;0;0
FR;6;2022-02-25;0;0;0;0;0;0;0;0;0;0;0;0;0;0;0;0;0;0
FR;6;2022-02-26;1;0;0;0;0;0;0;0;0;1;0;0;0;0;0;0;0;0
FR;6;2022-02-27;1;0;0;0;1;0;0;0;0;2;0;0;0;1;0;0;0;0
FR;6;2022-02-28;0;0;0;0;0;0;0;0;0;2;0;0;0;1;0;0;0;0
FR;6;2022-03-01;3;0;0;0;0;0;0;0;0;5;0;0;0;1;0;0;0;0
FR;6;2022-03-02;97;9;2;0;15;7;0;0;0;102;9;2;0;16;7;0;0;0
FR;6;2022-03-03;0;0;0;0;0;0;0;0;0;102;9;2;0;16;7;0;0;0
FR;6;2022-03-04;92;4;0;0;8;4;0;0;0;194;13;2;0;24;11;0;0;0
FR;6;2022-03-05;391;23;2;0;60;14;0;0;0;585;36;4;0;84;25;0;0;0
FR;6;2022-03-06;7;1;0;0;2;0;0;0;0;592;37;4;0;86;25;0;0;0
FR;6;2022-03-07;337;19;0;0;51;13;0;0;0;929;56;4;0;137;38;0;0;0
FR;6;2022-03-08;230;14;0;0;47;5;0;0;0;1159;70;4;0;184;43;0;0;0
FR;6;2022-03-09;519;29;2;0;84;21;1;0;0;1678;99;6;0;268;64;1;0;0
FR;6;2022-03-10;206;19;0;1;54;12;1;0;0;1884;118;6;1;322;76;2;0;0
FR;6;2022-03-11;331;22;6;0;53;21;0;0;0;2215;140;12;1;375;97;2;0;0
FR;6;2022-03-12;518;25;1;0;83;20;0;0;0;2733;165;13;1;458;117;2;0;0
FR;6;2022-03-13;40;2;0;0;2;1;0;0;0;2773;167;13;1;460;118;2;0;0
FR;6;2022-03-14;201;4;2;0;39;3;1;0;0;2974;171;15;1;499;121;3;0;0
FR;6;2022-03-15;112;11;2;0;28;9;0;0;0;3086;182;17;1;527;130;3;0;0
FR;6;2022-03-16;310;17;2;1;49;15;1;0;0;3396;199;19;2;576;145;4;0;0
FR;6;2022-03-17;117;6;1;2;14;4;2;0;0;3513;205;20;4;590;149;6;0;0
FR;6;2022-03-18;215;10;0;0;40;6;0;0;0;3728;215;20;4;630;155;6;0;0
FR;6;2022-03-19;307;19;2;0;90;9;0;0;0;4035;234;22;4;720;164;6;0;0
FR;6;2022-03-20;15;5;0;0;5;1;0;0;0;4050;239;22;4;725;165;6;0;0
FR;6;2022-03-21;132;23;1;0;47;4;0;0;0;4182;262;23;4;772;169;6;0;0
FR;6;2022-03-22;97;15;0;0;34;4;0;0;0;4279;277;23;4;806;173;6;0;0
FR;6;2022-03-23;226;108;3;0;155;14;1;0;0;4505;385;26;4;961;187;7;0;0
FR;6;2022-03-24;100;15;1;3;32;4;3;0;0;4605;400;27;7;993;191;10;0;0
FR;6;2022-03-25;203;141;2;1;179;15;2;0;0;4808;541;29;8;1172;206;12;0;0
FR;6;2022-03-26;331;295;7;1;385;19;1;0;0;5139;836;36;9;1557;225;13;0;0
FR;6;2022-03-27;32;30;1;0;37;1;1;0;0;5171;866;37;9;1594;226;14;0;0
FR;6;2022-03-28;201;208;8;1;234;17;3;0;0;5372;1074;45;10;1828;243;17;0;0
FR;6;2022-03-29;124;189;12;2;206;12;9;0;0;5496;1263;57;12;2034;255;26;0;0
FR;6;2022-03-30;305;476;10;2;548;22;6;0;0;5801;1739;67;14;2582;277;32;0;0
FR;6;2022-03-31;123;140;10;0;160;14;5;0;0;5924;1879;77;14;2742;291;37;0;0
FR;6;2022-04-01;195;150;11;2;178;23;3;0;0;6119;2029;88;16;2920;314;40;0;0
FR;6;2022-04-02;206;241;9;1;280;13;8;0;0;6325;2270;97;17;3200;327;48;0;0
FR;6;2022-04-03;17;21;0;0;26;1;0;0;0;6342;2291;97;17;3226;328;48;0;0
FR;6;2022-04-04;137;114;6;1;131;9;5;0;0;6479;2405;103;18;3357;337;53;0;0
FR;6;2022-04-05;146;88;15;1;105;11;8;0;0;6625;2493;118;19;3462;348;61;0;0
FR;6;2022-04-06;204;245;22;26;291;27;33;0;0;6829;2738;140;45;3753;375;94;0;0
FR;6;2022-04-07;127;96;15;9;115;17;14;0;0;6956;2834;155;54;3868;392;108;0;0
FR;6;2022-04-08;199;171;16;3;214;17;9;0;1;7155;3005;171;57;4082;409;117;0;1
FR;6;2022-04-09;145;139;6;12;171;13;4;0;0;7300;3144;177;69;4253;422;121;0;1
FR;6;2022-04-10;11;20;3;0;26;1;3;0;0;7311;3164;180;69;4279;423;124;0;1
FR;6;2022-04-11;101;106;4;0;129;5;3;0;0;7412;3270;184;69;4408;428;127;0;1
FR;6;2022-04-12;136;75;5;8;114;10;10;0;0;7548;3345;189;77;4522;438;137;0;1
FR;6;2022-04-13;162;175;7;5;208;13;8;0;0;7710;3520;196;82;4730;451;145;0;1
FR;6;2022-04-14;100;103;5;10;121;8;10;0;0;7810;3623;201;92;4851;459;155;0;1
FR;6;2022-04-15;158;149;11;7;167;19;14;0;1;7968;3772;212;99;5018;478;169;0;2
FR;6;2022-04-16;127;132;5;0;162;14;2;0;0;8095;3904;217;99;5180;492;171;0;2
FR;6;2022-04-17;8;9;4;0;10;4;0;0;0;8103;3913;221;99;5190;496;171;0;2
FR;6;2022-04-18;8;15;3;0;14;4;0;0;0;8111;3928;224;99;5204;500;171;0;2
FR;6;2022-04-19;97;112;4;3;130;3;7;0;0;8208;4040;228;102;5334;503;178;0;2
FR;6;2022-04-20;177;227;8;7;269;15;3;0;0;8385;4267;236;109;5603;518;181;0;2
FR;6;2022-04-21;111;93;8;4;110;11;7;0;0;8496;4360;244;113;5713;529;188;0;2
FR;6;2022-04-22;139;160;13;12;189;13;13;0;0;8635;4520;257;125;5902;542;201;0;2
FR;6;2022-04-23;106;129;1;1;161;7;1;0;0;8741;4649;258;126;6063;549;202;0;2
FR;6;2022-04-24;5;21;1;0;22;0;1;0;0;8746;4670;259;126;6085;549;203;0;2
FR;6;2022-04-25;90;128;3;8;151;11;9;0;0;8836;4798;262;134;6236;560;212;0;2
FR;6;2022-04-26;101;128;19;2;151;17;13;0;0;8937;4926;281;136;6387;577;225;0;2
FR;6;2022-04-27;197;159;21;1;222;27;11;0;1;9134;5085;302;137;6609;604;236;0;3
FR;6;2022-04-28;109;87;7;1;123;8;7;0;0;9243;5172;309;138;6732;612;243;0;3
FR;6;2022-04-29;191;169;16;2;215;20;6;0;0;9434;5341;325;140;6947;632;249;0;3
FR;6;2022-04-30;133;125;7;1;168;24;2;0;0;9567;5466;332;141;7115;656;251;0;3
FR;6;2022-05-01;7;6;0;0;8;0;0;0;0;9574;5472;332;141;7123;656;251;0;3
FR;6;2022-05-02;94;65;3;4;88;3;4;0;0;9668;5537;335;145;7211;659;255;0;3
FR;6;2022-05-03;136;93;11;2;125;7;9;0;0;9804;5630;346;147;7336;666;264;0;3
FR;6;2022-05-04;167;118;25;12;161;29;12;0;1;9971;5748;371;159;7497;695;276;0;4
FR;6;2022-05-05;101;70;8;3;97;12;6;0;0;10072;5818;379;162;7594;707;282;0;4
FR;6;2022-05-06;152;110;10;9;155;16;11;0;0;10224;5928;389;171;7749;723;293;0;4
FR;6;2022-05-07;139;93;13;3;136;23;8;0;0;10363;6021;402;174;7885;746;301;0;4
FR;6;2022-05-08;20;8;6;5;16;7;5;0;0;10383;6029;408;179;7901;753;306;0;4
FR;6;2022-05-09;86;78;9;7;95;13;6;0;0;10469;6107;417;186;7996;766;312;0;4
FR;6;2022-05-10;112;80;15;7;110;12;13;0;0;10581;6187;432;193;8106;778;325;0;4
FR;6;2022-05-11;130;124;11;14;163;20;6;0;0;10711;6311;443;207;8269;798;331;0;4
FR;6;2022-05-12;105;76;7;5;96;15;6;0;1;10816;6387;450;212;8365;813;337;0;5
FR;6;2022-05-13;155;97;17;21;137;22;16;0;0;10971;6484;467;233;8502;835;353;0;5
FR;6;2022-05-14;81;60;6;7;84;15;2;0;0;11052;6544;473;240;8586;850;355;0;5
FR;6;2022-05-15;12;7;0;0;14;0;0;0;0;11064;6551;473;240;8600;850;355;0;5
FR;6;2022-05-16;65;54;6;2;69;12;3;0;0;11129;6605;479;242;8669;862;358;0;5
FR;6;2022-05-17;123;77;5;7;92;11;8;0;0;11252;6682;484;249;8761;873;366;0;5
FR;6;2022-05-18;131;116;5;1;158;14;3;0;0;11383;6798;489;250;8919;887;369;0;5
FR;6;2022-05-19;124;57;6;8;96;9;8;0;0;11507;6855;495;258;9015;896;377;0;5
FR;6;2022-05-20;125;115;13;3;151;18;10;0;0;11632;6970;508;261;9166;914;387;0;5
FR;6;2022-05-21;92;69;14;3;93;12;8;0;0;11724;7039;522;264;9259;926;395;0;5
FR;6;2022-05-22;19;12;5;0;21;4;1;0;0;11743;7051;527;264;9280;930;396;0;5
FR;6;2022-05-23;77;72;4;2;90;7;2;0;0;11820;7123;531;266;9370;937;398;0;5
FR;6;2022-05-24;117;98;8;2;131;16;4;0;0;11937;7221;539;268;9501;953;402;0;5
FR;6;2022-05-25;140;129;6;3;171;11;6;0;0;12077;7350;545;271;9672;964;408;0;5
FR;6;2022-05-26;7;9;3;0;5;9;0;0;0;12084;7359;548;271;9677;973;408;0;5
FR;6;2022-05-27;127;105;15;11;136;18;18;0;1;12211;7464;563;282;9813;991;426;0;6
FR;6;2022-05-28;54;75;1;5;89;8;5;0;0;12265;7539;564;287;9902;999;431;0;6
FR;6;2022-05-29;8;10;0;0;10;1;0;0;0;12273;7549;564;287;9912;1000;431;0;6
FR;6;2022-05-30;70;70;7;4;86;4;9;0;0;12343;7619;571;291;9998;1004;440;0;6
FR;6;2022-05-31;87;102;10;2;121;14;7;0;0;12430;7721;581;293;10119;1018;447;0;6
FR;6;2022-06-01;97;89;10;1;111;11;6;0;0;12527;7810;591;294;10230;1029;453;0;6
FR;6;2022-06-02;91;60;6;3;80;9;6;0;0;12618;7870;597;297;10310;1038;459;0;6
FR;6;2022-06-03;126;102;13;7;128;21;8;0;0;12744;7972;610;304;10438;1059;467;0;6
FR;6;2022-06-04;63;51;10;0;64;12;3;0;0;12807;8023;620;304;10502;1071;470;0;6
FR;6;2022-06-05;16;15;2;1;18;4;1;0;0;12823;8038;622;305;10520;1075;471;0;6
FR;6;2022-06-06;9;6;0;0;8;0;0;0;0;12832;8044;622;305;10528;1075;471;0;6
FR;6;2022-06-07;79;90;3;4;117;8;6;0;0;12911;8134;625;309;10645;1083;477;0;6
FR;6;2022-06-08;92;110;13;5;130;20;6;0;0;13003;8244;638;314;10775;1103;483;0;6
FR;6;2022-06-09;75;81;15;3;106;15;8;0;0;13078;8325;653;317;10881;1118;491;0;6
FR;6;2022-06-10;116;93;26;10;120;22;13;0;0;13194;8418;679;327;11001;1140;504;0;6
FR;6;2022-06-11;83;62;6;10;82;12;11;0;0;13277;8480;685;337;11083;1152;515;0;6
FR;6;2022-06-12;6;14;1;0;16;2;0;0;0;13283;8494;686;337;11099;1154;515;0;6
FR;6;2022-06-13;74;59;18;1;68;7;4;0;0;13357;8553;704;338;11167;1161;519;0;6
FR;6;2022-06-14;98;100;8;5;116;16;8;0;0;13455;8653;712;343;11283;1177;527;0;6
FR;6;2022-06-15;80;86;7;8;114;15;10;0;0;13535;8739;719;351;11397;1192;537;0;6
FR;6;2022-06-16;53;40;11;7;45;14;6;0;0;13588;8779;730;358;11442;1206;543;0;6
FR;6;2022-06-17;86;85;3;13;109;11;5;0;0;13674;8864;733;371;11551;1217;548;0;6
FR;6;2022-06-18;71;62;13;0;88;21;1;0;0;13745;8926;746;371;11639;1238;549;0;6
FR;6;2022-06-19;6;6;3;0;7;4;1;0;0;13751;8932;749;371;11646;1242;550;0;6
FR;6;2022-06-20;42;41;4;1;55;6;1;0;0;13793;8973;753;372;11701;1248;551;0;6
FR;6;2022-06-21;59;73;10;7;83;17;7;0;0;13852;9046;763;379;11784;1265;558;0;6
FR;6;2022-06-22;86;85;8;2;98;17;3;0;0;13938;9131;771;381;11882;1282;561;0;6
FR;6;2022-06-23;64;39;13;7;41;15;10;0;0;14002;9170;784;388;11923;1297;571;0;6
FR;6;2022-06-24;77;85;7;14;95;20;16;0;0;14079;9255;791;402;12018;1317;587;0;6
FR;6;2022-06-25;67;61;4;3;77;8;5;0;0;14146;9316;795;405;12095;1325;592;0;6
FR;6;2022-06-26;6;7;1;0;10;1;0;0;0;14152;9323;796;405;12105;1326;592;0;6
FR;6;2022-06-27;51;50;4;9;62;12;7;0;0;14203;9373;800;414;12167;1338;599;0;6
FR;6;2022-06-28;68;47;6;3;53;15;5;0;0;14271;9420;806;417;12220;1353;604;0;6
FR;6;2022-06-29;98;117;26;37;115;19;35;0;5;14369;9537;832;454;12335;1372;639;0;11
FR;6;2022-06-30;84;60;33;10;61;12;7;0;0;14453;9597;865;464;12396;1384;646;0;11
FR;6;2022-07-01;115;94;25;33;102;18;27;0;1;14568;9691;890;497;12498;1402;673;0;12
FR;6;2022-07-02;58;67;26;2;64;37;6;0;0;14626;9758;916;499;12562;1439;679;0;12
FR;6;2022-07-03;11;4;4;3;5;4;3;0;0;14637;9762;920;502;12567;1443;682;0;12
FR;6;2022-07-04;61;43;3;23;55;13;20;0;0;14698;9805;923;525;12622;1456;702;0;12
FR;6;2022-07-05;65;53;19;67;60;27;63;0;0;14763;9858;942;592;12682;1483;765;0;12
FR;6;2022-07-06;94;64;7;11;78;12;17;0;0;14857;9922;949;603;12760;1495;782;0;12
FR;6;2022-07-07;99;79;42;37;99;14;34;0;4;14956;10001;991;640;12859;1509;816;0;16
FR;6;2022-07-08;139;87;42;27;115;10;25;0;3;15095;10088;1033;667;12974;1519;841;0;19
FR;6;2022-07-09;53;51;16;29;51;27;33;0;1;15148;10139;1049;696;13025;1546;874;0;20
FR;6;2022-07-10;3;7;8;0;9;9;0;0;0;15151;10146;1057;696;13034;1555;874;0;20
FR;6;2022-07-11;54;44;5;4;47;12;4;0;0;15205;10190;1062;700;13081;1567;878;0;20
FR;6;2022-07-12;70;72;12;23;87;12;27;0;0;15275;10262;1074;723;13168;1579;905;0;20
FR;6;2022-07-13;84;65;14;21;71;25;22;0;0;15359;10327;1088;744;13239;1604;927;0;20
FR;6;2022-07-14;4;3;1;0;4;1;0;0;0;15363;10330;1089;744;13243;1605;927;0;20
FR;6;2022-07-15;74;59;9;57;85;16;45;0;0;15437;10389;1098;801;13328;1621;972;0;20
FR;6;2022-07-16;27;31;17;0;37;17;3;0;0;15464;10420;1115;801;13365;1638;975;0;20
FR;6;2022-07-17;3;7;0;0;8;0;0;0;0;15467;10427;1115;801;13373;1638;975;0;20
FR;6;2022-07-18;37;62;11;14;60;15;14;0;6;15504;10489;1126;815;13433;1653;989;0;26
FR;6;2022-07-19;54;48;4;19;60;6;21;0;1;15558;10537;1130;834;13493;1659;1010;0;27
FR;6;2022-07-20;53;70;7;22;75;11;27;0;0;15611;10607;1137;856;13568;1670;1037;0;27
FR;6;2022-07-21;51;61;4;7;56;11;9;0;0;15662;10668;1141;863;13624;1681;1046;0;27
FR;6;2022-07-22;55;74;7;26;82;8;16;0;2;15717;10742;1148;889;13706;1689;1062;0;29
FR;6;2022-07-23;38;40;6;10;40;6;9;0;1;15755;10782;1154;899;13746;1695;1071;0;30
FR;6;2022-07-24;11;14;1;3;19;3;3;0;0;15766;10796;1155;902;13765;1698;1074;0;30
FR;6;2022-07-25;60;44;8;12;41;9;13;0;1;15826;10840;1163;914;13806;1707;1087;0;31
FR;6;2022-07-26;47;64;14;6;62;10;13;0;0;15873;10904;1177;920;13868;1717;1100;0;31
FR;6;2022-07-27;54;78;15;11;80;18;15;0;8;15927;10982;1192;931;13948;1735;1115;0;39
FR;6;2022-07-28;30;48;4;6;50;8;7;0;1;15957;11030;1196;937;13998;1743;1122;0;40
FR;6;2022-07-29;43;71;10;38;60;24;36;0;1;16000;11101;1206;975;14058;1767;1158;0;41
FR;6;2022-07-30;26;48;4;15;49;7;15;0;0;16026;11149;1210;990;14107;1774;1173;0;41
FR;6;2022-07-31;0;1;1;0;1;0;1;0;0;16026;11150;1211;990;14108;1774;1174;0;41
FR;6;2022-08-01;39;36;14;8;32;10;6;0;1;16065;11186;1225;998;14140;1784;1180;0;42
FR;6;2022-08-02;37;46;10;14;52;6;16;0;0;16102;11232;1235;1012;14192;1790;1196;0;42
FR;6;2022-08-03;29;52;7;16;53;11;19;0;0;16131;11284;1242;1028;14245;1801;1215;0;42
FR;6;2022-08-04;25;21;4;9;20;6;10;0;1;16156;11305;1246;1037;14265;1807;1225;0;43
FR;6;2022-08-05;43;45;1;7;54;5;7;0;0;16199;11350;1247;1044;14319;1812;1232;0;43
FR;6;2022-08-06;17;27;1;3;33;2;4;0;0;16216;11377;1248;1047;14352;1814;1236;0;43
FR;6;2022-08-07;1;2;0;0;2;0;0;0;0;16217;11379;1248;1047;14354;1814;1236;0;43
FR;6;2022-08-08;24;33;1;0;40;1;0;0;0;16241;11412;1249;1047;14394;1815;1236;0;43
FR;6;2022-08-09;22;30;6;3;29;3;3;0;0;16263;11442;1255;1050;14423;1818;1239;0;43
FR;6;2022-08-10;32;36;5;9;38;5;9;0;5;16295;11478;1260;1059;14461;1823;1248;0;48
FR;6;2022-08-11;32;33;1;1;40;1;0;0;1;16327;11511;1261;1060;14501;1824;1248;0;49
FR;6;2022-08-12;50;44;6;2;50;15;3;0;1;16377;11555;1267;1062;14551;1839;1251;0;50
FR;6;2022-08-13;9;20;0;0;22;1;0;0;0;16386;11575;1267;1062;14573;1840;1251;0;50
FR;6;2022-08-14;3;1;0;0;2;0;0;0;0;16389;11576;1267;1062;14575;1840;1251;0;50
FR;6;2022-08-15;2;3;1;0;4;0;1;0;0;16391;11579;1268;1062;14579;1840;1252;0;50
FR;6;2022-08-16;35;66;21;7;66;7;2;0;0;16426;11645;1289;1069;14645;1847;1254;0;50
FR;6;2022-08-17;32;44;10;9;41;10;6;0;7;16458;11689;1299;1078;14686;1857;1260;0;57
FR;6;2022-08-18;29;55;14;4;61;4;0;0;1;16487;11744;1313;1082;14747;1861;1260;0;58
FR;6;2022-08-19;30;45;5;4;47;3;2;0;1;16517;11789;1318;1086;14794;1864;1262;0;59
FR;6;2022-08-20;26;28;3;0;27;8;1;0;0;16543;11817;1321;1086;14821;1872;1263;0;59
FR;6;2022-08-21;1;5;2;0;5;0;0;0;0;16544;11822;1323;1086;14826;1872;1263;0;59
FR;6;2022-08-22;20;42;15;1;45;0;0;0;0;16564;11864;1338;1087;14871;1872;1263;0;59
FR;6;2022-08-23;34;45;6;7;47;6;4;0;2;16598;11909;1344;1094;14918;1878;1267;0;61
FR;6;2022-08-24;34;30;6;3;36;6;2;0;3;16632;11939;1350;1097;14954;1884;1269;0;64
FR;6;2022-08-25;25;27;1;1;29;5;1;0;0;16657;11966;1351;1098;14983;1889;1270;0;64
FR;6;2022-08-26;38;44;4;4;51;7;7;0;0;16695;12010;1355;1102;15034;1896;1277;0;64
FR;6;2022-08-27;19;21;7;3;22;8;4;0;0;16714;12031;1362;1105;15056;1904;1281;0;64
FR;6;2022-08-28;6;3;0;6;3;1;1;0;4;16720;12034;1362;1111;15059;1905;1282;0;68
FR;6;2022-08-29;26;22;2;6;29;3;6;0;0;16746;12056;1364;1117;15088;1908;1288;0;68
FR;6;2022-08-30;28;35;4;12;33;8;13;0;0;16774;12091;1368;1129;15121;1916;1301;0;68
FR;6;2022-08-31;35;38;2;11;46;3;12;0;0;16809;12129;1370;1140;15167;1919;1313;0;68
FR;6;2022-09-01;17;11;5;1;13;4;3;0;0;16826;12140;1375;1141;15180;1923;1316;0;68
FR;6;2022-09-02;19;14;2;1;13;3;2;0;0;16845;12154;1377;1142;15193;1926;1318;0;68
FR;6;2022-09-03;10;3;1;5;4;2;5;0;0;16855;12157;1378;1147;15197;1928;1323;0;68
FR;6;2022-09-04;4;1;0;0;1;0;0;0;0;16859;12158;1378;1147;15198;1928;1323;0;68
FR;6;2022-09-05;8;7;0;0;10;0;0;0;0;16867;12165;1378;1147;15208;1928;1323;0;68
FR;6;2022-09-06;7;9;7;12;8;6;15;0;0;16874;12174;1385;1159;15216;1934;1338;0;68
FR;6;2022-09-07;3;8;1;0;8;1;0;0;0;16877;12182;1386;1159;15224;1935;1338;0;68
FR;6;2022-09-08;6;4;0;2;3;1;2;0;0;16883;12186;1386;1161;15227;1936;1340;0;68
FR;6;2022-09-09;7;9;2;7;9;3;8;0;0;16890;12195;1388;1168;15236;1939;1348;0;68
FR;6;2022-09-10;3;4;1;0;3;1;1;0;0;16893;12199;1389;1168;15239;1940;1349;0;68
FR;6;2022-09-11;1;3;0;0;3;0;0;0;0;16894;12202;1389;1168;15242;1940;1349;0;68
FR;6;2022-09-12;10;4;1;0;3;3;0;0;0;16904;12206;1390;1168;15245;1943;1349;0;68
FR;6;2022-09-13;7;2;3;0;2;2;2;0;0;16911;12208;1393;1168;15247;1945;1351;0;68
FR;6;2022-09-14;9;8;2;0;7;4;0;0;0;16920;12216;1395;1168;15254;1949;1351;0;68
FR;6;2022-09-15;8;13;5;5;9;9;3;0;2;16928;12229;1400;1173;15263;1958;1354;0;70
FR;6;2022-09-16;25;39;1;1;47;4;1;0;2;16953;12268;1401;1174;15310;1962;1355;0;72
FR;6;2022-09-17;24;22;0;6;24;5;3;0;2;16977;12290;1401;1180;15334;1967;1358;0;74
FR;6;2022-09-18;5;4;0;0;4;1;0;0;0;16982;12294;1401;1180;15338;1968;1358;0;74
FR;6;2022-09-19;30;30;2;1;32;5;1;0;0;17012;12324;1403;1181;15370;1973;1359;0;74
FR;6;2022-09-20;34;25;1;4;30;6;2;0;1;17046;12349;1404;1185;15400;1979;1361;0;75
FR;6;2022-09-21;21;9;3;3;7;7;5;0;3;17067;12358;1407;1188;15407;1986;1366;0;78
FR;6;2022-09-22;19;28;1;22;32;3;21;0;1;17086;12386;1408;1210;15439;1989;1387;0;79
FR;6;2022-09-23;28;41;5;9;47;9;2;0;0;17114;12427;1413;1219;15486;1998;1389;0;79
FR;6;2022-09-24;16;16;4;2;21;6;2;0;0;17130;12443;1417;1221;15507;2004;1391;0;79
FR;6;2022-09-25;3;14;0;0;14;1;0;0;0;17133;12457;1417;1221;15521;2005;1391;0;79
FR;6;2022-09-26;16;13;0;18;12;5;18;0;2;17149;12470;1417;1239;15533;2010;1409;0;81
FR;6;2022-09-27;32;19;2;3;23;4;4;0;0;17181;12489;1419;1242;15556;2014;1413;0;81
FR;6;2022-09-28;27;10;9;11;16;5;17;0;2;17208;12499;1428;1253;15572;2019;1430;0;83
FR;6;2022-09-29;13;13;10;34;16;6;33;0;7;17221;12512;1438;1287;15588;2025;1463;0;90
FR;6;2022-09-30;34;24;5;6;33;5;3;0;0;17255;12536;1443;1293;15621;2030;1466;0;90
FR;6;2022-10-01;17;12;5;8;9;8;8;0;2;17272;12548;1448;1301;15630;2038;1474;0;92
FR;6;2022-10-02;4;0;0;0;1;0;0;0;0;17276;12548;1448;1301;15631;2038;1474;0;92
FR;6;2022-10-03;11;10;3;5;11;4;6;0;0;17287;12558;1451;1306;15642;2042;1480;0;92
FR;6;2022-10-04;19;17;4;28;21;3;30;0;3;17306;12575;1455;1334;15663;2045;1510;0;95
FR;6;2022-10-05;11;12;3;2;9;7;4;0;0;17317;12587;1458;1336;15672;2052;1514;0;95
FR;6;2022-10-06;19;13;4;6;17;2;10;0;0;17336;12600;1462;1342;15689;2054;1524;0;95
FR;6;2022-10-07;27;26;5;24;24;11;16;0;5;17363;12626;1467;1366;15713;2065;1540;0;100
FR;6;2022-10-08;18;13;0;0;16;0;0;0;0;17381;12639;1467;1366;15729;2065;1540;0;100
FR;6;2022-10-09;7;3;4;27;3;4;30;0;6;17388;12642;1471;1393;15732;2069;1570;0;106
FR;6;2022-10-10;15;14;1;16;16;6;13;0;0;17403;12656;1472;1409;15748;2075;1583;0;106
FR;6;2022-10-11;21;23;3;11;22;8;13;0;3;17424;12679;1475;1420;15770;2083;1596;0;109
FR;6;2022-10-12;20;16;7;19;18;3;24;0;7;17444;12695;1482;1439;15788;2086;1620;0;116
FR;6;2022-10-13;28;15;2;36;23;0;38;0;6;17472;12710;1484;1475;15811;2086;1658;0;122
FR;6;2022-10-14;29;23;5;49;24;11;45;0;13;17501;12733;1489;1524;15835;2097;1703;0;135
FR;6;2022-10-15;13;9;0;22;8;4;21;0;6;17514;12742;1489;1546;15843;2101;1724;0;141
FR;6;2022-10-16;4;5;0;6;2;3;6;0;0;17518;12747;1489;1552;15845;2104;1730;0;141
FR;6;2022-10-17;14;14;2;10;14;1;12;0;2;17532;12761;1491;1562;15859;2105;1742;0;143
FR;6;2022-10-18;12;19;9;26;19;4;18;0;11;17544;12780;1500;1588;15878;2109;1760;0;154
FR;6;2022-10-19;10;20;6;16;20;5;19;0;5;17554;12800;1506;1604;15898;2114;1779;0;159
FR;6;2022-10-20;16;15;12;57;19;5;67;0;13;17570;12815;1518;1661;15917;2119;1846;0;172
FR;6;2022-10-21;16;21;9;34;22;11;37;0;10;17586;12836;1527;1695;15939;2130;1883;0;182
FR;6;2022-10-22;19;14;1;4;17;3;4;0;0;17605;12850;1528;1699;15956;2133;1887;0;182
FR;6;2022-10-23;3;3;1;0;4;0;1;0;0;17608;12853;1529;1699;15960;2133;1888;0;182
FR;6;2022-10-24;12;14;2;7;14;6;5;0;2;17620;12867;1531;1706;15974;2139;1893;0;184
FR;6;2022-10-25;20;13;6;17;16;7;19;0;4;17640;12880;1537;1723;15990;2146;1912;0;188
FR;6;2022-10-26;17;9;4;13;12;4;15;0;5;17657;12889;1541;1736;16002;2150;1927;0;193
FR;6;2022-10-27;20;7;8;37;10;6;36;0;14;17677;12896;1549;1773;16012;2156;1963;0;207
FR;6;2022-10-28;21;27;3;4;28;6;5;0;1;17698;12923;1552;1777;16040;2162;1968;0;208
FR;6;2022-10-29;7;11;5;11;10;6;14;0;12;17705;12934;1557;1788;16050;2168;1982;0;220
FR;6;2022-10-30;2;5;0;0;5;0;0;0;0;17707;12939;1557;1788;16055;2168;1982;0;220
FR;6;2022-10-31;20;14;2;13;17;4;12;0;3;17727;12953;1559;1801;16072;2172;1994;0;223
FR;6;2022-11-01;2;1;1;0;1;1;0;0;0;17729;12954;1560;1801;16073;2173;1994;0;223
FR;6;2022-11-02;15;25;9;21;26;11;19;0;12;17744;12979;1569;1822;16099;2184;2013;0;235
FR;6;2022-11-03;17;17;11;39;20;8;43;0;9;17761;12996;1580;1861;16119;2192;2056;0;244
FR;6;2022-11-04;19;22;9;16;27;5;16;0;10;17780;13018;1589;1877;16146;2197;2072;0;254
FR;6;2022-11-05;9;16;2;4;17;4;6;0;0;17789;13034;1591;1881;16163;2201;2078;0;254
FR;6;2022-11-06;5;1;0;0;1;0;0;0;0;17794;13035;1591;1881;16164;2201;2078;0;254
FR;6;2022-11-07;18;10;6;17;12;4;18;0;11;17812;13045;1597;1898;16176;2205;2096;0;265
FR;6;2022-11-08;18;10;2;3;8;5;5;0;4;17830;13055;1599;1901;16184;2210;2101;0;269
FR;6;2022-11-09;16;22;1;6;21;4;5;0;4;17846;13077;1600;1907;16205;2214;2106;0;273
FR;6;2022-11-10;10;10;4;12;8;5;11;0;10;17856;13087;1604;1919;16213;2219;2117;0;283
FR;6;2022-11-11;4;1;0;0;1;1;0;0;0;17860;13088;1604;1919;16214;2220;2117;0;283
FR;6;2022-11-12;4;11;1;7;11;2;5;0;9;17864;13099;1605;1926;16225;2222;2122;0;292
FR;6;2022-11-13;1;1;0;1;1;0;1;0;0;17865;13100;1605;1927;16226;2222;2123;0;292
FR;6;2022-11-14;13;10;7;32;14;8;33;0;14;17878;13110;1612;1959;16240;2230;2156;0;306
FR;6;2022-11-15;7;18;1;11;16;4;7;0;2;17885;13128;1613;1970;16256;2234;2163;0;308
FR;6;2022-11-16;16;15;9;32;16;3;42;0;9;17901;13143;1622;2002;16272;2237;2205;0;317
FR;6;2022-11-17;10;8;1;29;8;2;28;0;5;17911;13151;1623;2031;16280;2239;2233;0;322
FR;6;2022-11-18;19;12;5;23;17;4;25;0;7;17930;13163;1628;2054;16297;2243;2258;0;329
FR;6;2022-11-19;5;13;0;2;11;3;2;0;1;17935;13176;1628;2056;16308;2246;2260;0;330
FR;6;2022-11-20;2;1;2;0;1;2;0;0;0;17937;13177;1630;2056;16309;2248;2260;0;330
FR;6;2022-11-21;22;13;1;14;14;6;11;0;3;17959;13190;1631;2070;16323;2254;2271;0;333
FR;6;2022-11-22;14;9;0;4;11;1;3;0;1;17973;13199;1631;2074;16334;2255;2274;0;334
FR;6;2022-11-23;14;15;15;23;17;9;31;0;8;17987;13214;1646;2097;16351;2264;2305;0;342
FR;6;2022-11-24;14;17;1;13;19;5;12;0;7;18001;13231;1647;2110;16370;2269;2317;0;349
FR;6;2022-11-25;23;15;5;50;15;5;47;0;5;18024;13246;1652;2160;16385;2274;2364;0;354
FR;6;2022-11-26;9;5;2;4;3;2;5;0;1;18033;13251;1654;2164;16388;2276;2369;0;355
FR;6;2022-11-27;1;4;0;0;4;0;0;0;0;18034;13255;1654;2164;16392;2276;2369;0;355
FR;6;2022-11-28;9;11;6;22;11;3;24;0;11;18043;13266;1660;2186;16403;2279;2393;0;366
FR;6;2022-11-29;15;10;1;12;14;1;8;0;7;18058;13276;1661;2198;16417;2280;2401;0;373
FR;6;2022-11-30;18;20;8;23;19;12;22;0;8;18076;13296;1669;2221;16436;2292;2423;0;381
FR;6;2022-12-01;12;9;7;20;11;4;24;0;9;18088;13305;1676;2241;16447;2296;2447;0;390
FR;6;2022-12-02;17;9;12;36;12;8;42;0;1;18105;13314;1688;2277;16459;2304;2489;0;391
FR;6;2022-12-03;13;3;13;20;6;5;28;0;13;18118;13317;1701;2297;16465;2309;2517;0;404
FR;6;2022-12-04;3;1;0;2;1;0;2;0;0;18121;13318;1701;2299;16466;2309;2519;0;404
FR;6;2022-12-05;11;10;7;16;10;4;19;0;8;18132;13328;1708;2315;16476;2313;2538;0;412
FR;6;2022-12-06;10;19;3;30;12;11;28;0;3;18142;13347;1711;2345;16488;2324;2566;0;415
FR;6;2022-12-07;17;8;10;56;10;8;57;0;30;18159;13355;1721;2401;16498;2332;2623;0;445
FR;6;2022-12-08;9;13;8;19;11;7;21;0;13;18168;13368;1729;2420;16509;2339;2644;0;458
FR;6;2022-12-09;15;9;5;29;12;4;30;0;6;18183;13377;1734;2449;16521;2343;2674;0;464
FR;6;2022-12-10;12;9;6;9;7;4;14;0;7;18195;13386;1740;2458;16528;2347;2688;0;471
FR;6;2022-12-11;4;2;1;0;2;1;0;0;0;18199;13388;1741;2458;16530;2348;2688;0;471
FR;6;2022-12-12;17;10;8;36;14;9;33;0;17;18216;13398;1749;2494;16544;2357;2721;0;488
FR;6;2022-12-13;17;21;12;66;16;18;65;0;14;18233;13419;1761;2560;16560;2375;2786;0;502
FR;6;2022-12-14;14;13;8;53;11;12;53;0;14;18247;13432;1769;2613;16571;2387;2839;0;516
FR;6;2022-12-15;12;15;14;38;13;9;44;0;9;18259;13447;1783;2651;16584;2396;2883;0;525
FR;6;2022-12-16;18;14;15;39;15;14;39;0;13;18277;13461;1798;2690;16599;2410;2922;0;538
FR;6;2022-12-17;11;10;15;28;9;15;29;0;8;18288;13471;1813;2718;16608;2425;2951;0;546
FR;6;2022-12-18;7;4;0;2;5;0;2;0;0;18295;13475;1813;2720;16613;2425;2953;0;546
FR;6;2022-12-19;12;8;9;29;8;12;29;0;15;18307;13483;1822;2749;16621;2437;2982;0;561
FR;6;2022-12-20;17;23;11;23;17;19;22;0;21;18324;13506;1833;2772;16638;2456;3004;0;582
FR;6;2022-12-21;23;16;9;19;13;13;17;0;5;18347;13522;1842;2791;16651;2469;3021;0;587
FR;6;2022-12-22;13;14;9;21;15;13;18;0;11;18360;13536;1851;2812;16666;2482;3039;0;598
FR;6;2022-12-23;10;19;12;7;14;18;7;0;3;18370;13555;1863;2819;16680;2500;3046;0;601
FR;6;2022-12-24;4;5;3;1;5;2;2;0;1;18374;13560;1866;2820;16685;2502;3048;0;602
FR;6;2022-12-25;0;0;0;0;0;0;0;0;0;18374;13560;1866;2820;16685;2502;3048;0;602
FR;6;2022-12-26;8;12;12;11;10;18;11;0;3;18382;13572;1878;2831;16695;2520;3059;0;605
FR;6;2022-12-27;16;13;15;8;11;19;8;0;0;18398;13585;1893;2839;16706;2539;3067;0;605
FR;6;2022-12-28;15;19;6;8;19;9;9;0;4;18413;13604;1899;2847;16725;2548;3076;0;609
FR;6;2022-12-29;15;12;7;8;10;9;9;0;7;18428;13616;1906;2855;16735;2557;3085;0;616
FR;6;2022-12-30;20;19;13;8;20;13;11;0;4;18448;13635;1919;2863;16755;2570;3096;0;620
FR;6;2022-12-31;5;2;6;1;4;7;1;0;1;18453;13637;1925;2864;16759;2577;3097;0;621
FR;6;2023-01-01;2;1;0;3;0;3;0;0;1;18455;13638;1925;2867;16759;2580;3097;0;622
FR;6;2023-01-02;9;14;2;3;10;7;3;0;0;18464;13652;1927;2870;16769;2587;3100;0;622
FR;6;2023-01-03;8;17;9;21;17;9;21;0;7;18472;13669;1936;2891;16786;2596;3121;0;629
FR;6;2023-01-04;9;10;4;10;9;8;6;0;14;18481;13679;1940;2901;16795;2604;3127;0;643
FR;6;2023-01-05;11;11;6;23;10;3;26;0;8;18492;13690;1946;2924;16805;2607;3153;0;651
FR;6;2023-01-06;16;24;15;30;21;17;29;0;15;18508;13714;1961;2954;16826;2624;3182;0;666
FR;6;2023-01-07;9;19;4;1;10;13;3;0;1;18517;13733;1965;2955;16836;2637;3185;0;667
FR;6;2023-01-08;2;7;4;11;6;4;11;0;3;18519;13740;1969;2966;16842;2641;3196;0;670
FR;6;2023-01-09;16;10;5;35;9;8;34;0;17;18535;13750;1974;3001;16851;2649;3230;0;687
FR;6;2023-01-10;13;15;13;23;13;10;26;0;9;18548;13765;1987;3024;16864;2659;3256;0;696
FR;6;2023-01-11;15;14;5;16;18;6;14;0;12;18563;13779;1992;3040;16882;2665;3270;0;708
FR;6;2023-01-12;7;13;2;5;10;3;5;0;12;18570;13792;1994;3045;16892;2668;3275;0;720
FR;6;2023-01-13;20;14;18;43;15;20;43;0;31;18590;13806;2012;3088;16907;2688;3318;0;751
FR;6;2023-01-14;20;8;6;2;9;9;2;0;0;18610;13814;2018;3090;16916;2697;3320;0;751
FR;6;2023-01-15;0;0;1;3;0;1;3;0;0;18610;13814;2019;3093;16916;2698;3323;0;751
FR;6;2023-01-16;22;12;2;1;10;6;3;0;2;18632;13826;2021;3094;16926;2704;3326;0;753
FR;6;2023-01-17;8;17;12;8;17;11;14;0;5;18640;13843;2033;3102;16943;2715;3340;0;758
FR;6;2023-01-18;22;15;9;7;17;10;8;0;1;18662;13858;2042;3109;16960;2725;3348;0;759
FR;6;2023-01-19;9;9;14;9;11;12;13;0;7;18671;13867;2056;3118;16971;2737;3361;0;766
FR;6;2023-01-20;17;13;9;32;15;7;34;0;27;18688;13880;2065;3150;16986;2744;3395;0;793
FR;6;2023-01-21;12;7;5;2;6;8;3;0;1;18700;13887;2070;3152;16992;2752;3398;0;794
FR;6;2023-01-22;0;0;1;1;0;1;1;0;0;18700;13887;2071;3153;16992;2753;3399;0;794
FR;6;2023-01-23;9;9;5;11;8;5;11;0;3;18709;13896;2076;3164;17000;2758;3410;0;797
FR;6;2023-01-24;14;15;15;13;15;14;18;0;6;18723;13911;2091;3177;17015;2772;3428;0;803
FR;6;2023-01-25;15;7;5;3;6;6;4;0;4;18738;13918;2096;3180;17021;2778;3432;0;807
FR;6;2023-01-26;13;15;3;11;12;8;13;0;9;18751;13933;2099;3191;17033;2786;3445;0;816
FR;6;2023-01-27;21;17;7;34;22;7;29;0;29;18772;13950;2106;3225;17055;2793;3474;0;845
FR;6;2023-01-28;15;15;7;4;17;6;5;0;1;18787;13965;2113;3229;17072;2799;3479;0;846
FR;6;2023-01-29;1;4;0;0;3;1;0;0;0;18788;13969;2113;3229;17075;2800;3479;0;846
FR;6;2023-01-30;2;15;8;4;15;8;3;0;8;18790;13984;2121;3233;17090;2808;3482;0;854
FR;6;2023-01-31;9;8;5;8;8;5;8;0;5;18799;13992;2126;3241;17098;2813;3490;0;859
FR;6;2023-02-01;20;18;4;4;17;4;8;0;4;18819;14010;2130;3245;17115;2817;3498;0;863
FR;6;2023-02-02;8;10;9;1;10;10;1;0;1;18827;14020;2139;3246;17125;2827;3499;0;864
FR;6;2023-02-03;16;15;11;18;15;11;19;0;13;18843;14035;2150;3264;17140;2838;3518;0;877
FR;6;2023-02-04;6;9;9;7;11;9;8;0;2;18849;14044;2159;3271;17151;2847;3526;0;879
FR;6;2023-02-05;0;0;0;4;0;0;4;0;0;18849;14044;2159;3275;17151;2847;3530;0;879
FR;6;2023-02-06;10;16;1;4;15;5;4;0;0;18859;14060;2160;3279;17166;2852;3534;0;879
FR;6;2023-02-07;8;9;4;8;9;7;7;0;3;18867;14069;2164;3287;17175;2859;3541;0;882
FR;6;2023-02-08;7;3;3;2;2;6;1;0;1;18874;14072;2167;3289;17177;2865;3542;0;883
FR;6;2023-02-09;6;11;1;6;8;8;2;0;2;18880;14083;2168;3295;17185;2873;3544;0;885
FR;6;2023-02-10;13;21;6;12;15;15;11;0;2;18893;14104;2174;3307;17200;2888;3555;0;887
FR;6;2023-02-11;12;8;7;4;9;3;9;0;5;18905;14112;2181;3311;17209;2891;3564;0;892
FR;6;2023-02-12;0;1;0;0;1;0;0;0;0;18905;14113;2181;3311;17210;2891;3564;0;892
FR;6;2023-02-13;5;6;0;0;6;1;0;0;0;18910;14119;2181;3311;17216;2892;3564;0;892
FR;6;2023-02-14;12;13;3;15;15;4;14;0;0;18922;14132;2184;3326;17231;2896;3578;0;892
FR;6;2023-02-15;8;11;3;2;11;2;2;0;4;18930;14143;2187;3328;17242;2898;3580;0;896
FR;6;2023-02-16;17;8;1;3;18;1;3;0;4;18947;14151;2188;3331;17260;2899;3583;0;900
FR;6;2023-02-17;9;15;3;9;12;8;9;0;5;18956;14166;2191;3340;17272;2907;3592;0;905
FR;6;2023-02-18;10;6;1;1;7;1;1;0;0;18966;14172;2192;3341;17279;2908;3593;0;905
FR;6;2023-02-19;0;0;0;0;0;0;0;0;0;18966;14172;2192;3341;17279;2908;3593;0;905
FR;6;2023-02-20;10;8;3;2;9;5;1;0;0;18976;14180;2195;3343;17288;2913;3594;0;905
FR;6;2023-02-21;9;8;8;5;6;7;8;0;1;18985;14188;2203;3348;17294;2920;3602;0;906
FR;6;2023-02-22;4;13;1;3;13;3;3;0;5;18989;14201;2204;3351;17307;2923;3605;0;911
FR;6;2023-02-23;7;11;6;2;10;6;4;0;1;18996;14212;2210;3353;17317;2929;3609;0;912
FR;6;2023-02-24;9;13;5;21;15;4;19;0;15;19005;14225;2215;3374;17332;2933;3628;0;927
FR;6;2023-02-25;4;5;1;1;6;1;1;0;0;19009;14230;2216;3375;17338;2934;3629;0;927
FR;6;2023-02-26;0;1;0;0;0;1;0;0;0;19009;14231;2216;3375;17338;2935;3629;0;927
FR;6;2023-02-27;10;8;3;1;3;9;0;0;2;19019;14239;2219;3376;17341;2944;3629;0;929
FR;6;2023-02-28;3;8;4;4;9;3;6;0;0;19022;14247;2223;3380;17350;2947;3635;0;929
FR;6;2023-03-01;6;10;3;2;10;4;2;0;0;19028;14257;2226;3382;17360;2951;3637;0;929
FR;6;2023-03-02;8;7;1;3;7;3;2;0;5;19036;14264;2227;3385;17367;2954;3639;0;934
FR;6;2023-03-03;14;12;5;7;11;9;6;0;7;19050;14276;2232;3392;17378;2963;3645;0;941
FR;6;2023-03-04;8;14;1;0;13;3;0;0;0;19058;14290;2233;3392;17391;2966;3645;0;941
FR;6;2023-03-05;4;0;0;0;0;0;0;0;0;19062;14290;2233;3392;17391;2966;3645;0;941
FR;6;2023-03-06;8;12;0;1;11;2;0;0;1;19070;14302;2233;3393;17402;2968;3645;0;942
FR;6;2023-03-07;4;6;0;1;4;3;0;0;5;19074;14308;2233;3394;17406;2971;3645;0;947
FR;6;2023-03-08;3;7;2;0;7;2;0;0;0;19077;14315;2235;3394;17413;2973;3645;0;947
FR;6;2023-03-09;7;6;0;1;6;2;1;0;0;19084;14321;2235;3395;17419;2975;3646;0;947
FR;6;2023-03-10;9;9;2;9;9;2;9;0;9;19093;14330;2237;3404;17428;2977;3655;0;956
FR;6;2023-03-11;13;12;2;0;12;2;2;0;0;19106;14342;2239;3404;17440;2979;3657;0;956
FR;6;2023-03-12;2;0;0;0;1;0;0;0;0;19108;14342;2239;3404;17441;2979;3657;0;956
FR;6;2023-03-13;7;12;4;1;13;2;1;0;2;19115;14354;2243;3405;17454;2981;3658;0;958
FR;6;2023-03-14;5;12;2;0;8;6;0;0;0;19120;14366;2245;3405;17462;2987;3658;0;958
FR;6;2023-03-15;6;4;2;3;5;3;3;0;1;19126;14370;2247;3408;17467;2990;3661;0;959
FR;6;2023-03-16;9;5;2;0;5;3;0;0;0;19135;14375;2249;3408;17472;2993;3661;0;959
FR;6;2023-03-17;10;12;5;5;8;8;5;0;3;19145;14387;2254;3413;17480;3001;3666;0;962
FR;6;2023-03-18;6;2;2;0;3;2;0;0;0;19151;14389;2256;3413;17483;3003;3666;0;962
FR;6;2023-03-19;0;0;1;0;0;0;0;0;0;19151;14389;2257;3413;17483;3003;3666;0;962
FR;6;2023-03-20;2;6;3;7;5;4;5;0;4;19153;14395;2260;3420;17488;3007;3671;0;966
FR;6;2023-03-21;2;1;5;2;1;3;4;0;0;19155;14396;2265;3422;17489;3010;3675;0;966
FR;6;2023-03-22;1;4;3;0;4;3;0;0;3;19156;14400;2268;3422;17493;3013;3675;0;969
FR;6;2023-03-23;3;4;3;2;4;3;2;0;0;19159;14404;2271;3424;17497;3016;3677;0;969
FR;6;2023-03-24;3;9;6;0;9;7;0;0;0;19162;14413;2277;3424;17506;3023;3677;0;969
FR;6;2023-03-25;10;7;0;0;9;0;0;0;0;19172;14420;2277;3424;17515;3023;3677;0;969
FR;6;2023-03-26;1;0;0;0;0;0;0;0;0;19173;14420;2277;3424;17515;3023;3677;0;969
FR;6;2023-03-27;6;9;2;2;8;4;1;0;0;19179;14429;2279;3426;17523;3027;3678;0;969
FR;6;2023-03-28;8;4;2;2;6;2;2;0;2;19187;14433;2281;3428;17529;3029;3680;0;971
FR;6;2023-03-29;4;1;2;0;1;2;0;0;0;19191;14434;2283;3428;17530;3031;3680;0;971
FR;6;2023-03-30;4;7;1;0;5;3;0;0;0;19195;14441;2284;3428;17535;3034;3680;0;971
FR;6;2023-03-31;1;3;3;3;3;3;1;0;7;19196;14444;2287;3431;17538;3037;3681;0;978
FR;6;2023-04-01;5;11;0;0;11;1;0;0;3;19201;14455;2287;3431;17549;3038;3681;0;981
FR;6;2023-04-02;0;0;0;0;0;0;0;0;0;19201;14455;2287;3431;17549;3038;3681;0;981
FR;6;2023-04-03;5;10;0;1;10;2;1;0;2;19206;14465;2287;3432;17559;3040;3682;0;983
FR;6;2023-04-04;5;10;2;4;8;3;5;0;7;19211;14475;2289;3436;17567;3043;3687;0;990
FR;6;2023-04-05;0;7;3;0;7;3;0;0;3;19211;14482;2292;3436;17574;3046;3687;0;993
FR;6;2023-04-06;3;6;4;1;3;7;1;0;2;19214;14488;2296;3437;17577;3053;3688;0;995
FR;6;2023-04-07;11;8;2;0;9;4;0;0;0;19225;14496;2298;3437;17586;3057;3688;0;995
FR;6;2023-04-08;2;1;3;0;1;3;0;0;0;19227;14497;2301;3437;17587;3060;3688;0;995
FR;6;2023-04-09;0;0;0;0;0;0;0;0;0;19227;14497;2301;3437;17587;3060;3688;0;995
FR;6;2023-04-10;0;0;0;0;0;0;0;0;0;19227;14497;2301;3437;17587;3060;3688;0;995
FR;6;2023-04-11;3;8;1;0;6;3;0;0;0;19230;14505;2302;3437;17593;3063;3688;0;995
FR;6;2023-04-12;3;4;2;0;5;2;0;0;4;19233;14509;2304;3437;17598;3065;3688;0;999
FR;6;2023-04-13;1;4;0;0;3;1;0;0;2;19234;14513;2304;3437;17601;3066;3688;0;1001
FR;6;2023-04-14;4;5;0;0;5;0;0;0;1;19238;14518;2304;3437;17606;3066;3688;0;1002
FR;6;2023-04-15;7;2;1;1;4;1;1;0;0;19245;14520;2305;3438;17610;3067;3689;0;1002
FR;6;2023-04-16;0;2;0;0;1;1;0;0;0;19245;14522;2305;3438;17611;3068;3689;0;1002
FR;6;2023-04-17;4;8;2;0;8;2;0;0;0;19249;14530;2307;3438;17619;3070;3689;0;1002
FR;6;2023-04-18;3;2;1;0;2;1;0;0;1;19252;14532;2308;3438;17621;3071;3689;0;1003
FR;6;2023-04-19;1;3;0;0;2;1;0;0;0;19253;14535;2308;3438;17623;3072;3689;0;1003
FR;6;2023-04-20;5;4;0;0;3;2;0;0;0;19258;14539;2308;3438;17626;3074;3689;0;1003
FR;6;2023-04-21;7;3;2;3;1;5;3;0;1;19265;14542;2310;3441;17627;3079;3692;0;1004
FR;6;2023-04-22;3;3;3;0;1;5;0;0;0;19268;14545;2313;3441;17628;3084;3692;0;1004
FR;6;2023-04-23;0;2;0;0;1;1;0;0;0;19268;14547;2313;3441;17629;3085;3692;0;1004
FR;6;2023-04-24;2;8;0;1;5;3;1;0;0;19270;14555;2313;3442;17634;3088;3693;0;1004
FR;6;2023-04-25;5;2;0;1;2;0;1;0;1;19275;14557;2313;3443;17636;3088;3694;0;1005
FR;6;2023-04-26;7;5;1;0;4;2;0;0;2;19282;14562;2314;3443;17640;3090;3694;0;1007
FR;6;2023-04-27;8;9;2;0;9;3;1;0;3;19290;14571;2316;3443;17649;3093;3695;0;1010
FR;6;2023-04-28;5;4;0;1;4;0;1;0;2;19295;14575;2316;3444;17653;3093;3696;0;1012
FR;6;2023-04-29;7;3;2;0;4;2;1;0;0;19302;14578;2318;3444;17657;3095;3697;0;1012
FR;6;2023-04-30;0;0;0;0;0;0;0;0;0;19302;14578;2318;3444;17657;3095;3697;0;1012
FR;6;2023-05-01;0;0;0;0;0;0;0;0;0;19302;14578;2318;3444;17657;3095;3697;0;1012
FR;6;2023-05-02;3;4;3;0;3;3;1;0;0;19305;14582;2321;3444;17660;3098;3698;0;1012
FR;6;2023-05-03;1;3;0;0;2;1;0;0;2;19306;14585;2321;3444;17662;3099;3698;0;1014
FR;6;2023-05-04;3;4;7;0;5;6;3;0;1;19309;14589;2328;3444;17667;3105;3701;0;1015
FR;6;2023-05-05;3;2;0;0;3;0;0;0;0;19312;14591;2328;3444;17670;3105;3701;0;1015
FR;6;2023-05-06;0;2;1;1;1;2;1;0;0;19312;14593;2329;3445;17671;3107;3702;0;1015
FR;6;2023-05-07;1;0;0;0;0;0;0;0;0;19313;14593;2329;3445;17671;3107;3702;0;1015
FR;6;2023-05-08;0;0;7;0;0;3;4;0;0;19313;14593;2336;3445;17671;3110;3706;0;1015
FR;6;2023-05-09;5;4;2;1;6;2;1;0;0;19318;14597;2338;3446;17677;3112;3707;0;1015
FR;6;2023-05-10;5;2;2;0;3;1;1;0;0;19323;14599;2340;3446;17680;3113;3708;0;1015
FR;6;2023-05-11;2;3;3;1;3;4;2;0;2;19325;14602;2343;3447;17683;3117;3710;0;1017
FR;6;2023-05-12;1;2;0;0;3;0;0;0;1;19326;14604;2343;3447;17686;3117;3710;0;1018
FR;6;2023-05-13;0;3;2;0;1;2;2;0;2;19326;14607;2345;3447;17687;3119;3712;0;1020
FR;6;2023-05-14;0;0;0;0;0;0;0;0;0;19326;14607;2345;3447;17687;3119;3712;0;1020
FR;6;2023-05-15;2;3;2;0;2;3;0;0;0;19328;14610;2347;3447;17689;3122;3712;0;1020
FR;6;2023-05-16;2;5;1;0;5;1;0;0;1;19330;14615;2348;3447;17694;3123;3712;0;1021
FR;6;2023-05-17;7;5;2;0;5;2;1;0;2;19337;14620;2350;3447;17699;3125;3713;0;1023
FR;6;2023-05-18;0;0;0;0;0;0;0;0;0;19337;14620;2350;3447;17699;3125;3713;0;1023
FR;6;2023-05-19;2;2;1;0;2;1;0;0;0;19339;14622;2351;3447;17701;3126;3713;0;1023
FR;6;2023-05-20;1;4;1;0;3;2;0;0;0;19340;14626;2352;3447;17704;3128;3713;0;1023
FR;6;2023-05-21;0;0;0;0;0;0;0;0;0;19340;14626;2352;3447;17704;3128;3713;0;1023
FR;6;2023-05-22;2;1;1;0;1;0;1;0;0;19342;14627;2353;3447;17705;3128;3714;0;1023
FR;6;2023-05-23;1;2;2;2;2;1;3;0;0;19343;14629;2355;3449;17707;3129;3717;0;1023
FR;6;2023-05-24;1;2;3;2;2;2;3;0;1;19344;14631;2358;3451;17709;3131;3720;0;1024
FR;6;2023-05-25;1;3;0;1;1;2;0;0;4;19345;14634;2358;3452;17710;3133;3720;0;1028
FR;6;2023-05-26;3;2;0;4;3;0;4;0;3;19348;14636;2358;3456;17713;3133;3724;0;1031
FR;6;2023-05-27;2;3;0;0;3;0;0;0;1;19350;14639;2358;3456;17716;3133;3724;0;1032
FR;6;2023-05-28;0;1;0;0;1;0;0;0;0;19350;14640;2358;3456;17717;3133;3724;0;1032
FR;6;2023-05-29;0;0;0;0;0;0;0;0;0;19350;14640;2358;3456;17717;3133;3724;0;1032
FR;6;2023-05-30;5;5;4;1;2;6;2;0;0;19355;14645;2362;3457;17719;3139;3726;0;1032
FR;6;2023-05-31;2;4;0;0;3;1;0;0;2;19357;14649;2362;3457;17722;3140;3726;0;1034
FR;6;2023-06-01;0;1;4;0;1;4;0;0;2;19357;14650;2366;3457;17723;3144;3726;0;1036
FR;6;2023-06-02;0;3;1;0;3;1;0;0;0;19357;14653;2367;3457;17726;3145;3726;0;1036
FR;6;2023-06-03;0;1;0;0;1;0;0;0;0;19357;14654;2367;3457;17727;3145;3726;0;1036
FR;6;2023-06-04;0;0;0;0;0;0;0;0;0;19357;14654;2367;3457;17727;3145;3726;0;1036
FR;6;2023-06-05;4;1;2;0;2;2;0;0;2;19361;14655;2369;3457;17729;3147;3726;0;1038
FR;6;2023-06-06;2;2;2;0;2;2;0;0;1;19363;14657;2371;3457;17731;3149;3726;0;1039
FR;6;2023-06-07;0;2;0;0;2;0;0;0;0;19363;14659;2371;3457;17733;3149;3726;0;1039
FR;6;2023-06-08;0;2;0;0;2;0;0;0;0;19363;14661;2371;3457;17735;3149;3726;0;1039
FR;6;2023-06-09;2;2;0;3;2;0;3;0;2;19365;14663;2371;3460;17737;3149;3729;0;1041
FR;6;2023-06-10;1;1;2;1;2;0;4;0;0;19366;14664;2373;3461;17739;3149;3733;0;1041
FR;6;2023-06-11;0;0;0;0;0;0;0;0;0;19366;14664;2373;3461;17739;3149;3733;0;1041
FR;6;2023-06-12;0;1;1;0;1;0;1;0;0;19366;14665;2374;3461;17740;3149;3734;0;1041
FR;6;2023-06-13;1;2;1;2;2;2;1;0;1;19367;14667;2375;3463;17742;3151;3735;0;1042
FR;6;2023-06-14;1;2;1;2;2;1;2;0;2;19368;14669;2376;3465;17744;3152;3737;0;1044
FR;6;2023-06-15;0;0;0;0;0;0;0;0;1;19368;14669;2376;3465;17744;3152;3737;0;1045
FR;6;2023-06-16;0;2;1;0;2;1;0;0;0;19368;14671;2377;3465;17746;3153;3737;0;1045
FR;6;2023-06-17;0;1;0;0;1;0;0;0;0;19368;14672;2377;3465;17747;3153;3737;0;1045
FR;6;2023-06-18;0;0;0;0;0;0;0;0;0;19368;14672;2377;3465;17747;3153;3737;0;1045
FR;6;2023-06-19;0;1;1;0;1;0;1;0;0;19368;14673;2378;3465;17748;3153;3738;0;1045
FR;6;2023-06-20;2;3;0;2;4;0;2;0;0;19370;14676;2378;3467;17752;3153;3740;0;1045
FR;6;2023-06-21;0;1;1;2;1;1;3;0;0;19370;14677;2379;3469;17753;3154;3743;0;1045
FR;6;2023-06-22;0;1;1;1;1;1;1;0;0;19370;14678;2380;3470;17754;3155;3744;0;1045
FR;6;2023-06-23;4;2;0;3;2;0;3;0;8;19374;14680;2380;3473;17756;3155;3747;0;1053
FR;6;2023-06-24;2;0;1;1;0;1;0;0;2;19376;14680;2381;3474;17756;3156;3747;0;1055
FR;6;2023-06-25;0;0;0;0;0;0;0;0;0;19376;14680;2381;3474;17756;3156;3747;0;1055
FR;6;2023-06-26;1;0;0;1;0;0;1;0;0;19377;14680;2381;3475;17756;3156;3748;0;1055
FR;6;2023-06-27;0;3;0;2;2;1;2;0;0;19377;14683;2381;3477;17758;3157;3750;0;1055
FR;6;2023-06-28;2;0;0;1;0;0;1;0;0;19379;14683;2381;3478;17758;3157;3751;0;1055
FR;6;2023-06-29;1;0;1;0;0;1;0;0;1;19380;14683;2382;3478;17758;3158;3751;0;1056
FR;6;2023-06-30;2;1;3;0;1;3;0;0;0;19382;14684;2385;3478;17759;3161;3751;0;1056
FR;6;2023-07-01;4;0;0;0;4;0;0;0;1;19386;14684;2385;3478;17763;3161;3751;0;1057
FR;6;2023-07-02;0;0;0;0;0;0;0;0;0;19386;14684;2385;3478;17763;3161;3751;0;1057
FR;6;2023-07-03;0;1;0;0;1;0;0;0;0;19386;14685;2385;3478;17764;3161;3751;0;1057
FR;6;2023-07-04;1;2;0;0;2;0;0;0;0;19387;14687;2385;3478;17766;3161;3751;0;1057
FR;6;2023-07-05;1;0;1;3;0;1;3;0;3;19388;14687;2386;3481;17766;3162;3754;0;1060
FR;6;2023-07-06;2;1;0;0;2;0;0;0;1;19390;14688;2386;3481;17768;3162;3754;0;1061
FR;6;2023-07-07;2;0;1;0;0;1;0;0;0;19392;14688;2387;3481;17768;3163;3754;0;1061
FR;6;2023-07-08;1;1;0;0;1;0;0;0;0;19393;14689;2387;3481;17769;3163;3754;0;1061
FR;6;2023-07-09;0;0;0;0;0;0;0;0;0;19393;14689;2387;3481;17769;3163;3754;0;1061
FR;6;2023-07-10;0;0;0;0;0;0;0;0;1;19393;14689;2387;3481;17769;3163;3754;0;1062
FR;8;2020-12-27;0;0;0;0;0;0;0;0;0;0;0;0;0;0;0;0;0;0
FR;8;2020-12-28;0;0;0;0;0;0;0;0;0;0;0;0;0;0;0;0;0;0
FR;8;2020-12-29;0;0;0;0;0;0;0;0;0;0;0;0;0;0;0;0;0;0
FR;8;2020-12-30;0;0;0;0;0;0;0;0;0;0;0;0;0;0;0;0;0;0
FR;8;2020-12-31;0;0;0;0;0;0;0;0;0;0;0;0;0;0;0;0;0;0
FR;8;2021-01-01;0;0;0;0;0;0;0;0;0;0;0;0;0;0;0;0;0;0
FR;8;2021-01-02;0;0;0;0;0;0;0;0;0;0;0;0;0;0;0;0;0;0
FR;8;2021-01-03;0;0;0;0;0;0;0;0;0;0;0;0;0;0;0;0;0;0
FR;8;2021-01-04;0;0;0;0;0;0;0;0;0;0;0;0;0;0;0;0;0;0
FR;8;2021-01-05;0;0;0;0;0;0;0;0;0;0;0;0;0;0;0;0;0;0
FR;8;2021-01-06;0;0;0;0;0;0;0;0;0;0;0;0;0;0;0;0;0;0
FR;8;2021-01-07;0;0;0;0;0;0;0;0;0;0;0;0;0;0;0;0;0;0
FR;8;2021-01-08;0;0;0;0;0;0;0;0;0;0;0;0;0;0;0;0;0;0
FR;8;2021-01-09;0;0;0;0;0;0;0;0;0;0;0;0;0;0;0;0;0;0
FR;8;2021-01-10;0;0;0;0;0;0;0;0;0;0;0;0;0;0;0;0;0;0
FR;8;2021-01-11;0;0;0;0;0;0;0;0;0;0;0;0;0;0;0;0;0;0
FR;8;2021-01-12;0;0;0;0;0;0;0;0;0;0;0;0;0;0;0;0;0;0
FR;8;2021-01-13;0;0;0;0;0;0;0;0;0;0;0;0;0;0;0;0;0;0
FR;8;2021-01-14;0;0;0;0;0;0;0;0;0;0;0;0;0;0;0;0;0;0
FR;8;2021-01-15;0;0;0;0;0;0;0;0;0;0;0;0;0;0;0;0;0;0
FR;8;2021-01-16;0;0;0;0;0;0;0;0;0;0;0;0;0;0;0;0;0;0
FR;8;2021-01-17;0;0;0;0;0;0;0;0;0;0;0;0;0;0;0;0;0;0
FR;8;2021-01-18;0;0;0;0;0;0;0;0;0;0;0;0;0;0;0;0;0;0
FR;8;2021-01-19;0;0;0;0;0;0;0;0;0;0;0;0;0;0;0;0;0;0
FR;8;2021-01-20;0;0;0;0;0;0;0;0;0;0;0;0;0;0;0;0;0;0
FR;8;2021-01-21;0;0;0;0;0;0;0;0;0;0;0;0;0;0;0;0;0;0
FR;8;2021-01-22;0;0;0;0;0;0;0;0;0;0;0;0;0;0;0;0;0;0
FR;8;2021-01-23;0;0;0;0;0;0;0;0;0;0;0;0;0;0;0;0;0;0
FR;8;2021-01-24;0;0;0;0;0;0;0;0;0;0;0;0;0;0;0;0;0;0
FR;8;2021-01-25;0;0;0;0;0;0;0;0;0;0;0;0;0;0;0;0;0;0
FR;8;2021-01-26;0;0;0;0;0;0;0;0;0;0;0;0;0;0;0;0;0;0
FR;8;2021-01-27;0;0;0;0;0;0;0;0;0;0;0;0;0;0;0;0;0;0
FR;8;2021-01-28;0;0;0;0;0;0;0;0;0;0;0;0;0;0;0;0;0;0
FR;8;2021-01-29;0;0;0;0;0;0;0;0;0;0;0;0;0;0;0;0;0;0
FR;8;2021-01-30;0;0;0;0;0;0;0;0;0;0;0;0;0;0;0;0;0;0
FR;8;2021-01-31;0;0;0;0;0;0;0;0;0;0;0;0;0;0;0;0;0;0
FR;8;2021-02-01;0;0;0;0;0;0;0;0;0;0;0;0;0;0;0;0;0;0
FR;8;2021-02-02;0;0;0;0;0;0;0;0;0;0;0;0;0;0;0;0;0;0
FR;8;2021-02-03;0;0;0;0;0;0;0;0;0;0;0;0;0;0;0;0;0;0
FR;8;2021-02-04;0;0;0;0;0;0;0;0;0;0;0;0;0;0;0;0;0;0
FR;8;2021-02-05;0;0;0;0;0;0;0;0;0;0;0;0;0;0;0;0;0;0
FR;8;2021-02-06;0;0;0;0;0;0;0;0;0;0;0;0;0;0;0;0;0;0
FR;8;2021-02-07;0;0;0;0;0;0;0;0;0;0;0;0;0;0;0;0;0;0
FR;8;2021-02-08;0;0;0;0;0;0;0;0;0;0;0;0;0;0;0;0;0;0
FR;8;2021-02-09;0;0;0;0;0;0;0;0;0;0;0;0;0;0;0;0;0;0
FR;8;2021-02-10;0;0;0;0;0;0;0;0;0;0;0;0;0;0;0;0;0;0
FR;8;2021-02-11;0;0;0;0;0;0;0;0;0;0;0;0;0;0;0;0;0;0
FR;8;2021-02-12;0;0;0;0;0;0;0;0;0;0;0;0;0;0;0;0;0;0
FR;8;2021-02-13;0;0;0;0;0;0;0;0;0;0;0;0;0;0;0;0;0;0
FR;8;2021-02-14;0;0;0;0;0;0;0;0;0;0;0;0;0;0;0;0;0;0
FR;8;2021-02-15;0;0;0;0;0;0;0;0;0;0;0;0;0;0;0;0;0;0
FR;8;2021-02-16;0;0;0;0;0;0;0;0;0;0;0;0;0;0;0;0;0;0
FR;8;2021-02-17;0;0;0;0;0;0;0;0;0;0;0;0;0;0;0;0;0;0
FR;8;2021-02-18;0;0;0;0;0;0;0;0;0;0;0;0;0;0;0;0;0;0
FR;8;2021-02-19;0;0;0;0;0;0;0;0;0;0;0;0;0;0;0;0;0;0
FR;8;2021-02-20;0;0;0;0;0;0;0;0;0;0;0;0;0;0;0;0;0;0
FR;8;2021-02-21;0;0;0;0;0;0;0;0;0;0;0;0;0;0;0;0;0;0
FR;8;2021-02-22;0;0;0;0;0;0;0;0;0;0;0;0;0;0;0;0;0;0
FR;8;2021-02-23;0;0;0;0;0;0;0;0;0;0;0;0;0;0;0;0;0;0
FR;8;2021-02-24;0;0;0;0;0;0;0;0;0;0;0;0;0;0;0;0;0;0
FR;8;2021-02-25;0;0;0;0;0;0;0;0;0;0;0;0;0;0;0;0;0;0
FR;8;2021-02-26;0;0;0;0;0;0;0;0;0;0;0;0;0;0;0;0;0;0
FR;8;2021-02-27;0;0;0;0;0;0;0;0;0;0;0;0;0;0;0;0;0;0
FR;8;2021-02-28;0;0;0;0;0;0;0;0;0;0;0;0;0;0;0;0;0;0
FR;8;2021-03-01;0;0;0;0;0;0;0;0;0;0;0;0;0;0;0;0;0;0
FR;8;2021-03-02;0;0;0;0;0;0;0;0;0;0;0;0;0;0;0;0;0;0
FR;8;2021-03-03;0;0;0;0;0;0;0;0;0;0;0;0;0;0;0;0;0;0
FR;8;2021-03-04;0;0;0;0;0;0;0;0;0;0;0;0;0;0;0;0;0;0
FR;8;2021-03-05;0;0;0;0;0;0;0;0;0;0;0;0;0;0;0;0;0;0
FR;8;2021-03-06;0;0;0;0;0;0;0;0;0;0;0;0;0;0;0;0;0;0
FR;8;2021-03-07;0;0;0;0;0;0;0;0;0;0;0;0;0;0;0;0;0;0
FR;8;2021-03-08;0;0;0;0;0;0;0;0;0;0;0;0;0;0;0;0;0;0
FR;8;2021-03-09;0;0;0;0;0;0;0;0;0;0;0;0;0;0;0;0;0;0
FR;8;2021-03-10;0;0;0;0;0;0;0;0;0;0;0;0;0;0;0;0;0;0
FR;8;2021-03-11;0;0;0;0;0;0;0;0;0;0;0;0;0;0;0;0;0;0
FR;8;2021-03-12;0;0;0;0;0;0;0;0;0;0;0;0;0;0;0;0;0;0
FR;8;2021-03-13;0;0;0;0;0;0;0;0;0;0;0;0;0;0;0;0;0;0
FR;8;2021-03-14;0;0;0;0;0;0;0;0;0;0;0;0;0;0;0;0;0;0
FR;8;2021-03-15;0;0;0;0;0;0;0;0;0;0;0;0;0;0;0;0;0;0
FR;8;2021-03-16;0;0;0;0;0;0;0;0;0;0;0;0;0;0;0;0;0;0
FR;8;2021-03-17;0;0;0;0;0;0;0;0;0;0;0;0;0;0;0;0;0;0
FR;8;2021-03-18;0;0;0;0;0;0;0;0;0;0;0;0;0;0;0;0;0;0
FR;8;2021-03-19;0;0;0;0;0;0;0;0;0;0;0;0;0;0;0;0;0;0
FR;8;2021-03-20;0;0;0;0;0;0;0;0;0;0;0;0;0;0;0;0;0;0
FR;8;2021-03-21;0;0;0;0;0;0;0;0;0;0;0;0;0;0;0;0;0;0
FR;8;2021-03-22;0;0;0;0;0;0;0;0;0;0;0;0;0;0;0;0;0;0
FR;8;2021-03-23;0;0;0;0;0;0;0;0;0;0;0;0;0;0;0;0;0;0
FR;8;2021-03-24;0;0;0;0;0;0;0;0;0;0;0;0;0;0;0;0;0;0
FR;8;2021-03-25;0;0;0;0;0;0;0;0;0;0;0;0;0;0;0;0;0;0
FR;8;2021-03-26;0;0;0;0;0;0;0;0;0;0;0;0;0;0;0;0;0;0
FR;8;2021-03-27;0;0;0;0;0;0;0;0;0;0;0;0;0;0;0;0;0;0
FR;8;2021-03-28;0;0;0;0;0;0;0;0;0;0;0;0;0;0;0;0;0;0
FR;8;2021-03-29;0;0;0;0;0;0;0;0;0;0;0;0;0;0;0;0;0;0
FR;8;2021-03-30;0;0;0;0;0;0;0;0;0;0;0;0;0;0;0;0;0;0
FR;8;2021-03-31;0;0;0;0;0;0;0;0;0;0;0;0;0;0;0;0;0;0
FR;8;2021-04-01;0;0;0;0;0;0;0;0;0;0;0;0;0;0;0;0;0;0
FR;8;2021-04-02;0;0;0;0;0;0;0;0;0;0;0;0;0;0;0;0;0;0
FR;8;2021-04-03;0;0;0;0;0;0;0;0;0;0;0;0;0;0;0;0;0;0
FR;8;2021-04-04;0;0;0;0;0;0;0;0;0;0;0;0;0;0;0;0;0;0
FR;8;2021-04-05;0;0;0;0;0;0;0;0;0;0;0;0;0;0;0;0;0;0
FR;8;2021-04-06;0;0;0;0;0;0;0;0;0;0;0;0;0;0;0;0;0;0
FR;8;2021-04-07;0;0;0;0;0;0;0;0;0;0;0;0;0;0;0;0;0;0
FR;8;2021-04-08;0;0;0;0;0;0;0;0;0;0;0;0;0;0;0;0;0;0
FR;8;2021-04-09;0;0;0;0;0;0;0;0;0;0;0;0;0;0;0;0;0;0
FR;8;2021-04-10;0;0;0;0;0;0;0;0;0;0;0;0;0;0;0;0;0;0
FR;8;2021-04-11;0;0;0;0;0;0;0;0;0;0;0;0;0;0;0;0;0;0
FR;8;2021-04-12;0;0;0;0;0;0;0;0;0;0;0;0;0;0;0;0;0;0
FR;8;2021-04-13;0;0;0;0;0;0;0;0;0;0;0;0;0;0;0;0;0;0
FR;8;2021-04-14;0;0;0;0;0;0;0;0;0;0;0;0;0;0;0;0;0;0
FR;8;2021-04-15;0;0;0;0;0;0;0;0;0;0;0;0;0;0;0;0;0;0
FR;8;2021-04-16;0;0;0;0;0;0;0;0;0;0;0;0;0;0;0;0;0;0
FR;8;2021-04-17;0;0;0;0;0;0;0;0;0;0;0;0;0;0;0;0;0;0
FR;8;2021-04-18;0;0;0;0;0;0;0;0;0;0;0;0;0;0;0;0;0;0
FR;8;2021-04-19;0;0;0;0;0;0;0;0;0;0;0;0;0;0;0;0;0;0
FR;8;2021-04-20;0;0;0;0;0;0;0;0;0;0;0;0;0;0;0;0;0;0
FR;8;2021-04-21;0;0;0;0;0;0;0;0;0;0;0;0;0;0;0;0;0;0
FR;8;2021-04-22;0;0;0;0;0;0;0;0;0;0;0;0;0;0;0;0;0;0
FR;8;2021-04-23;0;0;0;0;0;0;0;0;0;0;0;0;0;0;0;0;0;0
FR;8;2021-04-24;0;0;0;0;0;0;0;0;0;0;0;0;0;0;0;0;0;0
FR;8;2021-04-25;0;0;0;0;0;0;0;0;0;0;0;0;0;0;0;0;0;0
FR;8;2021-04-26;0;0;0;0;0;0;0;0;0;0;0;0;0;0;0;0;0;0
FR;8;2021-04-27;0;0;0;0;0;0;0;0;0;0;0;0;0;0;0;0;0;0
FR;8;2021-04-28;0;0;0;0;0;0;0;0;0;0;0;0;0;0;0;0;0;0
FR;8;2021-04-29;0;0;0;0;0;0;0;0;0;0;0;0;0;0;0;0;0;0
FR;8;2021-04-30;0;0;0;0;0;0;0;0;0;0;0;0;0;0;0;0;0;0
FR;8;2021-05-01;0;0;0;0;0;0;0;0;0;0;0;0;0;0;0;0;0;0
FR;8;2021-05-02;0;0;0;0;0;0;0;0;0;0;0;0;0;0;0;0;0;0
FR;8;2021-05-03;0;0;0;0;0;0;0;0;0;0;0;0;0;0;0;0;0;0
FR;8;2021-05-04;0;0;0;0;0;0;0;0;0;0;0;0;0;0;0;0;0;0
FR;8;2021-05-05;0;0;0;0;0;0;0;0;0;0;0;0;0;0;0;0;0;0
FR;8;2021-05-06;0;0;0;0;0;0;0;0;0;0;0;0;0;0;0;0;0;0
FR;8;2021-05-07;0;0;0;0;0;0;0;0;0;0;0;0;0;0;0;0;0;0
FR;8;2021-05-08;0;0;0;0;0;0;0;0;0;0;0;0;0;0;0;0;0;0
FR;8;2021-05-09;0;0;0;0;0;0;0;0;0;0;0;0;0;0;0;0;0;0
FR;8;2021-05-10;0;0;0;0;0;0;0;0;0;0;0;0;0;0;0;0;0;0
FR;8;2021-05-11;0;0;0;0;0;0;0;0;0;0;0;0;0;0;0;0;0;0
FR;8;2021-05-12;0;0;0;0;0;0;0;0;0;0;0;0;0;0;0;0;0;0
FR;8;2021-05-13;0;0;0;0;0;0;0;0;0;0;0;0;0;0;0;0;0;0
FR;8;2021-05-14;0;0;0;0;0;0;0;0;0;0;0;0;0;0;0;0;0;0
FR;8;2021-05-15;0;0;0;0;0;0;0;0;0;0;0;0;0;0;0;0;0;0
FR;8;2021-05-16;0;0;0;0;0;0;0;0;0;0;0;0;0;0;0;0;0;0
FR;8;2021-05-17;0;0;0;0;0;0;0;0;0;0;0;0;0;0;0;0;0;0
FR;8;2021-05-18;0;0;0;0;0;0;0;0;0;0;0;0;0;0;0;0;0;0
FR;8;2021-05-19;0;0;0;0;0;0;0;0;0;0;0;0;0;0;0;0;0;0
FR;8;2021-05-20;0;0;0;0;0;0;0;0;0;0;0;0;0;0;0;0;0;0
FR;8;2021-05-21;0;0;0;0;0;0;0;0;0;0;0;0;0;0;0;0;0;0
FR;8;2021-05-22;0;0;0;0;0;0;0;0;0;0;0;0;0;0;0;0;0;0
FR;8;2021-05-23;0;0;0;0;0;0;0;0;0;0;0;0;0;0;0;0;0;0
FR;8;2021-05-24;0;0;0;0;0;0;0;0;0;0;0;0;0;0;0;0;0;0
FR;8;2021-05-25;0;0;0;0;0;0;0;0;0;0;0;0;0;0;0;0;0;0
FR;8;2021-05-26;0;0;0;0;0;0;0;0;0;0;0;0;0;0;0;0;0;0
FR;8;2021-05-27;0;0;0;0;0;0;0;0;0;0;0;0;0;0;0;0;0;0
FR;8;2021-05-28;0;0;0;0;0;0;0;0;0;0;0;0;0;0;0;0;0;0
FR;8;2021-05-29;0;0;0;0;0;0;0;0;0;0;0;0;0;0;0;0;0;0
FR;8;2021-05-30;0;0;0;0;0;0;0;0;0;0;0;0;0;0;0;0;0;0
FR;8;2021-05-31;0;0;0;0;0;0;0;0;0;0;0;0;0;0;0;0;0;0
FR;8;2021-06-01;0;0;0;0;0;0;0;0;0;0;0;0;0;0;0;0;0;0
FR;8;2021-06-02;0;0;0;0;0;0;0;0;0;0;0;0;0;0;0;0;0;0
FR;8;2021-06-03;0;0;0;0;0;0;0;0;0;0;0;0;0;0;0;0;0;0
FR;8;2021-06-04;0;0;0;0;0;0;0;0;0;0;0;0;0;0;0;0;0;0
FR;8;2021-06-05;0;0;0;0;0;0;0;0;0;0;0;0;0;0;0;0;0;0
FR;8;2021-06-06;0;0;0;0;0;0;0;0;0;0;0;0;0;0;0;0;0;0
FR;8;2021-06-07;0;0;0;0;0;0;0;0;0;0;0;0;0;0;0;0;0;0
FR;8;2021-06-08;0;0;0;0;0;0;0;0;0;0;0;0;0;0;0;0;0;0
FR;8;2021-06-09;0;0;0;0;0;0;0;0;0;0;0;0;0;0;0;0;0;0
FR;8;2021-06-10;0;0;0;0;0;0;0;0;0;0;0;0;0;0;0;0;0;0
FR;8;2021-06-11;0;0;0;0;0;0;0;0;0;0;0;0;0;0;0;0;0;0
FR;8;2021-06-12;0;0;0;0;0;0;0;0;0;0;0;0;0;0;0;0;0;0
FR;8;2021-06-13;0;0;0;0;0;0;0;0;0;0;0;0;0;0;0;0;0;0
FR;8;2021-06-14;0;0;0;0;0;0;0;0;0;0;0;0;0;0;0;0;0;0
FR;8;2021-06-15;0;0;0;0;0;0;0;0;0;0;0;0;0;0;0;0;0;0
FR;8;2021-06-16;0;0;0;0;0;0;0;0;0;0;0;0;0;0;0;0;0;0
FR;8;2021-06-17;0;0;0;0;0;0;0;0;0;0;0;0;0;0;0;0;0;0
FR;8;2021-06-18;0;0;0;0;0;0;0;0;0;0;0;0;0;0;0;0;0;0
FR;8;2021-06-19;0;0;0;0;0;0;0;0;0;0;0;0;0;0;0;0;0;0
FR;8;2021-06-20;0;0;0;0;0;0;0;0;0;0;0;0;0;0;0;0;0;0
FR;8;2021-06-21;0;0;0;0;0;0;0;0;0;0;0;0;0;0;0;0;0;0
FR;8;2021-06-22;0;0;0;0;0;0;0;0;0;0;0;0;0;0;0;0;0;0
FR;8;2021-06-23;0;0;0;0;0;0;0;0;0;0;0;0;0;0;0;0;0;0
FR;8;2021-06-24;0;0;0;0;0;0;0;0;0;0;0;0;0;0;0;0;0;0
FR;8;2021-06-25;0;0;0;0;0;0;0;0;0;0;0;0;0;0;0;0;0;0
FR;8;2021-06-26;0;0;0;0;0;0;0;0;0;0;0;0;0;0;0;0;0;0
FR;8;2021-06-27;0;0;0;0;0;0;0;0;0;0;0;0;0;0;0;0;0;0
FR;8;2021-06-28;0;0;0;0;0;0;0;0;0;0;0;0;0;0;0;0;0;0
FR;8;2021-06-29;0;0;0;0;0;0;0;0;0;0;0;0;0;0;0;0;0;0
FR;8;2021-06-30;0;0;0;0;0;0;0;0;0;0;0;0;0;0;0;0;0;0
FR;8;2021-07-01;0;0;0;0;0;0;0;0;0;0;0;0;0;0;0;0;0;0
FR;8;2021-07-02;0;0;0;0;0;0;0;0;0;0;0;0;0;0;0;0;0;0
FR;8;2021-07-03;0;0;0;0;0;0;0;0;0;0;0;0;0;0;0;0;0;0
FR;8;2021-07-04;0;0;0;0;0;0;0;0;0;0;0;0;0;0;0;0;0;0
FR;8;2021-07-05;0;0;0;0;0;0;0;0;0;0;0;0;0;0;0;0;0;0
FR;8;2021-07-06;0;0;0;0;0;0;0;0;0;0;0;0;0;0;0;0;0;0
FR;8;2021-07-07;0;0;0;0;0;0;0;0;0;0;0;0;0;0;0;0;0;0
FR;8;2021-07-08;0;0;0;0;0;0;0;0;0;0;0;0;0;0;0;0;0;0
FR;8;2021-07-09;0;0;0;0;0;0;0;0;0;0;0;0;0;0;0;0;0;0
FR;8;2021-07-10;0;0;0;0;0;0;0;0;0;0;0;0;0;0;0;0;0;0
FR;8;2021-07-11;0;0;0;0;0;0;0;0;0;0;0;0;0;0;0;0;0;0
FR;8;2021-07-12;0;0;0;0;0;0;0;0;0;0;0;0;0;0;0;0;0;0
FR;8;2021-07-13;0;0;0;0;0;0;0;0;0;0;0;0;0;0;0;0;0;0
FR;8;2021-07-14;0;0;0;0;0;0;0;0;0;0;0;0;0;0;0;0;0;0
FR;8;2021-07-15;0;0;0;0;0;0;0;0;0;0;0;0;0;0;0;0;0;0
FR;8;2021-07-16;0;0;0;0;0;0;0;0;0;0;0;0;0;0;0;0;0;0
FR;8;2021-07-17;0;0;0;0;0;0;0;0;0;0;0;0;0;0;0;0;0;0
FR;8;2021-07-18;0;0;0;0;0;0;0;0;0;0;0;0;0;0;0;0;0;0
FR;8;2021-07-19;0;0;0;0;0;0;0;0;0;0;0;0;0;0;0;0;0;0
FR;8;2021-07-20;0;0;0;0;0;0;0;0;0;0;0;0;0;0;0;0;0;0
FR;8;2021-07-21;0;0;0;0;0;0;0;0;0;0;0;0;0;0;0;0;0;0
FR;8;2021-07-22;0;0;0;0;0;0;0;0;0;0;0;0;0;0;0;0;0;0
FR;8;2021-07-23;0;0;0;0;0;0;0;0;0;0;0;0;0;0;0;0;0;0
FR;8;2021-07-24;0;0;0;0;0;0;0;0;0;0;0;0;0;0;0;0;0;0
FR;8;2021-07-25;0;0;0;0;0;0;0;0;0;0;0;0;0;0;0;0;0;0
FR;8;2021-07-26;0;0;0;0;0;0;0;0;0;0;0;0;0;0;0;0;0;0
FR;8;2021-07-27;0;0;0;0;0;0;0;0;0;0;0;0;0;0;0;0;0;0
FR;8;2021-07-28;0;0;0;0;0;0;0;0;0;0;0;0;0;0;0;0;0;0
FR;8;2021-07-29;0;0;0;0;0;0;0;0;0;0;0;0;0;0;0;0;0;0
FR;8;2021-07-30;0;0;0;0;0;0;0;0;0;0;0;0;0;0;0;0;0;0
FR;8;2021-07-31;0;0;0;0;0;0;0;0;0;0;0;0;0;0;0;0;0;0
FR;8;2021-08-01;0;0;0;0;0;0;0;0;0;0;0;0;0;0;0;0;0;0
FR;8;2021-08-02;0;0;0;0;0;0;0;0;0;0;0;0;0;0;0;0;0;0
FR;8;2021-08-03;0;0;0;0;0;0;0;0;0;0;0;0;0;0;0;0;0;0
FR;8;2021-08-04;0;0;0;0;0;0;0;0;0;0;0;0;0;0;0;0;0;0
FR;8;2021-08-05;0;0;0;0;0;0;0;0;0;0;0;0;0;0;0;0;0;0
FR;8;2021-08-06;0;0;0;0;0;0;0;0;0;0;0;0;0;0;0;0;0;0
FR;8;2021-08-07;0;0;0;0;0;0;0;0;0;0;0;0;0;0;0;0;0;0
FR;8;2021-08-08;0;0;0;0;0;0;0;0;0;0;0;0;0;0;0;0;0;0
FR;8;2021-08-09;0;0;0;0;0;0;0;0;0;0;0;0;0;0;0;0;0;0
FR;8;2021-08-10;0;0;0;0;0;0;0;0;0;0;0;0;0;0;0;0;0;0
FR;8;2021-08-11;0;0;0;0;0;0;0;0;0;0;0;0;0;0;0;0;0;0
FR;8;2021-08-12;0;0;0;0;0;0;0;0;0;0;0;0;0;0;0;0;0;0
FR;8;2021-08-13;0;0;0;0;0;0;0;0;0;0;0;0;0;0;0;0;0;0
FR;8;2021-08-14;0;0;0;0;0;0;0;0;0;0;0;0;0;0;0;0;0;0
FR;8;2021-08-15;0;0;0;0;0;0;0;0;0;0;0;0;0;0;0;0;0;0
FR;8;2021-08-16;0;0;0;0;0;0;0;0;0;0;0;0;0;0;0;0;0;0
FR;8;2021-08-17;0;0;0;0;0;0;0;0;0;0;0;0;0;0;0;0;0;0
FR;8;2021-08-18;0;0;0;0;0;0;0;0;0;0;0;0;0;0;0;0;0;0
FR;8;2021-08-19;0;0;0;0;0;0;0;0;0;0;0;0;0;0;0;0;0;0
FR;8;2021-08-20;0;0;0;0;0;0;0;0;0;0;0;0;0;0;0;0;0;0
FR;8;2021-08-21;0;0;0;0;0;0;0;0;0;0;0;0;0;0;0;0;0;0
FR;8;2021-08-22;0;0;0;0;0;0;0;0;0;0;0;0;0;0;0;0;0;0
FR;8;2021-08-23;0;0;0;0;0;0;0;0;0;0;0;0;0;0;0;0;0;0
FR;8;2021-08-24;0;0;0;0;0;0;0;0;0;0;0;0;0;0;0;0;0;0
FR;8;2021-08-25;0;0;0;0;0;0;0;0;0;0;0;0;0;0;0;0;0;0
FR;8;2021-08-26;0;0;0;0;0;0;0;0;0;0;0;0;0;0;0;0;0;0
FR;8;2021-08-27;0;0;0;0;0;0;0;0;0;0;0;0;0;0;0;0;0;0
FR;8;2021-08-28;0;0;0;0;0;0;0;0;0;0;0;0;0;0;0;0;0;0
FR;8;2021-08-29;0;0;0;0;0;0;0;0;0;0;0;0;0;0;0;0;0;0
FR;8;2021-08-30;0;0;0;0;0;0;0;0;0;0;0;0;0;0;0;0;0;0
FR;8;2021-08-31;0;0;0;0;0;0;0;0;0;0;0;0;0;0;0;0;0;0
FR;8;2021-09-01;0;0;0;0;0;0;0;0;0;0;0;0;0;0;0;0;0;0
FR;8;2021-09-02;0;0;0;0;0;0;0;0;0;0;0;0;0;0;0;0;0;0
FR;8;2021-09-03;0;0;0;0;0;0;0;0;0;0;0;0;0;0;0;0;0;0
FR;8;2021-09-04;0;0;0;0;0;0;0;0;0;0;0;0;0;0;0;0;0;0
FR;8;2021-09-05;0;0;0;0;0;0;0;0;0;0;0;0;0;0;0;0;0;0
FR;8;2021-09-06;0;0;0;0;0;0;0;0;0;0;0;0;0;0;0;0;0;0
FR;8;2021-09-07;0;0;0;0;0;0;0;0;0;0;0;0;0;0;0;0;0;0
FR;8;2021-09-08;0;0;0;0;0;0;0;0;0;0;0;0;0;0;0;0;0;0
FR;8;2021-09-09;0;0;0;0;0;0;0;0;0;0;0;0;0;0;0;0;0;0
FR;8;2021-09-10;0;0;0;0;0;0;0;0;0;0;0;0;0;0;0;0;0;0
FR;8;2021-09-11;0;0;0;0;0;0;0;0;0;0;0;0;0;0;0;0;0;0
FR;8;2021-09-12;0;0;0;0;0;0;0;0;0;0;0;0;0;0;0;0;0;0
FR;8;2021-09-13;0;0;0;0;0;0;0;0;0;0;0;0;0;0;0;0;0;0
FR;8;2021-09-14;0;0;0;0;0;0;0;0;0;0;0;0;0;0;0;0;0;0
FR;8;2021-09-15;0;0;0;0;0;0;0;0;0;0;0;0;0;0;0;0;0;0
FR;8;2021-09-16;0;0;0;0;0;0;0;0;0;0;0;0;0;0;0;0;0;0
FR;8;2021-09-17;0;0;0;0;0;0;0;0;0;0;0;0;0;0;0;0;0;0
FR;8;2021-09-18;0;0;0;0;0;0;0;0;0;0;0;0;0;0;0;0;0;0
FR;8;2021-09-19;0;0;0;0;0;0;0;0;0;0;0;0;0;0;0;0;0;0
FR;8;2021-09-20;0;0;0;0;0;0;0;0;0;0;0;0;0;0;0;0;0;0
FR;8;2021-09-21;0;0;0;0;0;0;0;0;0;0;0;0;0;0;0;0;0;0
FR;8;2021-09-22;0;0;0;0;0;0;0;0;0;0;0;0;0;0;0;0;0;0
FR;8;2021-09-23;0;0;0;0;0;0;0;0;0;0;0;0;0;0;0;0;0;0
FR;8;2021-09-24;0;0;0;0;0;0;0;0;0;0;0;0;0;0;0;0;0;0
FR;8;2021-09-25;0;0;0;0;0;0;0;0;0;0;0;0;0;0;0;0;0;0
FR;8;2021-09-26;0;0;0;0;0;0;0;0;0;0;0;0;0;0;0;0;0;0
FR;8;2021-09-27;0;0;0;0;0;0;0;0;0;0;0;0;0;0;0;0;0;0
FR;8;2021-09-28;0;0;0;0;0;0;0;0;0;0;0;0;0;0;0;0;0;0
FR;8;2021-09-29;0;0;0;0;0;0;0;0;0;0;0;0;0;0;0;0;0;0
FR;8;2021-09-30;0;0;0;0;0;0;0;0;0;0;0;0;0;0;0;0;0;0
FR;8;2021-10-01;0;0;0;0;0;0;0;0;0;0;0;0;0;0;0;0;0;0
FR;8;2021-10-02;0;0;0;0;0;0;0;0;0;0;0;0;0;0;0;0;0;0
FR;8;2021-10-03;0;0;0;0;0;0;0;0;0;0;0;0;0;0;0;0;0;0
FR;8;2021-10-04;0;0;0;0;0;0;0;0;0;0;0;0;0;0;0;0;0;0
FR;8;2021-10-05;0;0;0;0;0;0;0;0;0;0;0;0;0;0;0;0;0;0
FR;8;2021-10-06;0;0;0;0;0;0;0;0;0;0;0;0;0;0;0;0;0;0
FR;8;2021-10-07;0;0;0;0;0;0;0;0;0;0;0;0;0;0;0;0;0;0
FR;8;2021-10-08;0;0;0;0;0;0;0;0;0;0;0;0;0;0;0;0;0;0
FR;8;2021-10-09;0;0;0;0;0;0;0;0;0;0;0;0;0;0;0;0;0;0
FR;8;2021-10-10;0;0;0;0;0;0;0;0;0;0;0;0;0;0;0;0;0;0
FR;8;2021-10-11;0;0;0;0;0;0;0;0;0;0;0;0;0;0;0;0;0;0
FR;8;2021-10-12;0;0;0;0;0;0;0;0;0;0;0;0;0;0;0;0;0;0
FR;8;2021-10-13;0;0;0;0;0;0;0;0;0;0;0;0;0;0;0;0;0;0
FR;8;2021-10-14;0;0;0;0;0;0;0;0;0;0;0;0;0;0;0;0;0;0
FR;8;2021-10-15;0;0;0;0;0;0;0;0;0;0;0;0;0;0;0;0;0;0
FR;8;2021-10-16;0;0;0;0;0;0;0;0;0;0;0;0;0;0;0;0;0;0
FR;8;2021-10-17;0;0;0;0;0;0;0;0;0;0;0;0;0;0;0;0;0;0
FR;8;2021-10-18;0;0;0;0;0;0;0;0;0;0;0;0;0;0;0;0;0;0
FR;8;2021-10-19;0;0;0;0;0;0;0;0;0;0;0;0;0;0;0;0;0;0
FR;8;2021-10-20;0;0;0;0;0;0;0;0;0;0;0;0;0;0;0;0;0;0
FR;8;2021-10-21;0;0;0;0;0;0;0;0;0;0;0;0;0;0;0;0;0;0
FR;8;2021-10-22;0;0;0;0;0;0;0;0;0;0;0;0;0;0;0;0;0;0
FR;8;2021-10-23;0;0;0;0;0;0;0;0;0;0;0;0;0;0;0;0;0;0
FR;8;2021-10-24;0;0;0;0;0;0;0;0;0;0;0;0;0;0;0;0;0;0
FR;8;2021-10-25;0;0;0;0;0;0;0;0;0;0;0;0;0;0;0;0;0;0
FR;8;2021-10-26;0;0;0;0;0;0;0;0;0;0;0;0;0;0;0;0;0;0
FR;8;2021-10-27;0;0;0;0;0;0;0;0;0;0;0;0;0;0;0;0;0;0
FR;8;2021-10-28;0;0;0;0;0;0;0;0;0;0;0;0;0;0;0;0;0;0
FR;8;2021-10-29;0;0;0;0;0;0;0;0;0;0;0;0;0;0;0;0;0;0
FR;8;2021-10-30;0;0;0;0;0;0;0;0;0;0;0;0;0;0;0;0;0;0
FR;8;2021-10-31;0;0;0;0;0;0;0;0;0;0;0;0;0;0;0;0;0;0
FR;8;2021-11-01;0;0;0;0;0;0;0;0;0;0;0;0;0;0;0;0;0;0
FR;8;2021-11-02;0;0;0;0;0;0;0;0;0;0;0;0;0;0;0;0;0;0
FR;8;2021-11-03;0;0;0;0;0;0;0;0;0;0;0;0;0;0;0;0;0;0
FR;8;2021-11-04;0;0;0;0;0;0;0;0;0;0;0;0;0;0;0;0;0;0
FR;8;2021-11-05;0;0;0;0;0;0;0;0;0;0;0;0;0;0;0;0;0;0
FR;8;2021-11-06;0;0;0;0;0;0;0;0;0;0;0;0;0;0;0;0;0;0
FR;8;2021-11-07;0;0;0;0;0;0;0;0;0;0;0;0;0;0;0;0;0;0
FR;8;2021-11-08;0;0;0;0;0;0;0;0;0;0;0;0;0;0;0;0;0;0
FR;8;2021-11-09;0;0;0;0;0;0;0;0;0;0;0;0;0;0;0;0;0;0
FR;8;2021-11-10;0;0;0;0;0;0;0;0;0;0;0;0;0;0;0;0;0;0
FR;8;2021-11-11;0;0;0;0;0;0;0;0;0;0;0;0;0;0;0;0;0;0
FR;8;2021-11-12;0;0;0;0;0;0;0;0;0;0;0;0;0;0;0;0;0;0
FR;8;2021-11-13;0;0;0;0;0;0;0;0;0;0;0;0;0;0;0;0;0;0
FR;8;2021-11-14;0;0;0;0;0;0;0;0;0;0;0;0;0;0;0;0;0;0
FR;8;2021-11-15;0;0;0;0;0;0;0;0;0;0;0;0;0;0;0;0;0;0
FR;8;2021-11-16;0;0;0;0;0;0;0;0;0;0;0;0;0;0;0;0;0;0
FR;8;2021-11-17;0;0;0;0;0;0;0;0;0;0;0;0;0;0;0;0;0;0
FR;8;2021-11-18;0;0;0;0;0;0;0;0;0;0;0;0;0;0;0;0;0;0
FR;8;2021-11-19;0;0;0;0;0;0;0;0;0;0;0;0;0;0;0;0;0;0
FR;8;2021-11-20;0;0;0;0;0;0;0;0;0;0;0;0;0;0;0;0;0;0
FR;8;2021-11-21;0;0;0;0;0;0;0;0;0;0;0;0;0;0;0;0;0;0
FR;8;2021-11-22;0;0;0;0;0;0;0;0;0;0;0;0;0;0;0;0;0;0
FR;8;2021-11-23;0;0;0;0;0;0;0;0;0;0;0;0;0;0;0;0;0;0
FR;8;2021-11-24;0;0;0;0;0;0;0;0;0;0;0;0;0;0;0;0;0;0
FR;8;2021-11-25;0;0;0;0;0;0;0;0;0;0;0;0;0;0;0;0;0;0
FR;8;2021-11-26;0;0;0;0;0;0;0;0;0;0;0;0;0;0;0;0;0;0
FR;8;2021-11-27;0;0;0;0;0;0;0;0;0;0;0;0;0;0;0;0;0;0
FR;8;2021-11-28;0;0;0;0;0;0;0;0;0;0;0;0;0;0;0;0;0;0
FR;8;2021-11-29;0;0;0;0;0;0;0;0;0;0;0;0;0;0;0;0;0;0
FR;8;2021-11-30;0;0;0;0;0;0;0;0;0;0;0;0;0;0;0;0;0;0
FR;8;2021-12-01;0;0;0;0;0;0;0;0;0;0;0;0;0;0;0;0;0;0
FR;8;2021-12-02;0;0;0;0;0;0;0;0;0;0;0;0;0;0;0;0;0;0
FR;8;2021-12-03;0;0;0;0;0;0;0;0;0;0;0;0;0;0;0;0;0;0
FR;8;2021-12-04;0;0;0;0;0;0;0;0;0;0;0;0;0;0;0;0;0;0
FR;8;2021-12-05;0;0;0;0;0;0;0;0;0;0;0;0;0;0;0;0;0;0
FR;8;2021-12-06;0;0;0;0;0;0;0;0;0;0;0;0;0;0;0;0;0;0
FR;8;2021-12-07;0;0;0;0;0;0;0;0;0;0;0;0;0;0;0;0;0;0
FR;8;2021-12-08;0;0;0;0;0;0;0;0;0;0;0;0;0;0;0;0;0;0
FR;8;2021-12-09;0;0;0;0;0;0;0;0;0;0;0;0;0;0;0;0;0;0
FR;8;2021-12-10;0;0;0;0;0;0;0;0;0;0;0;0;0;0;0;0;0;0
FR;8;2021-12-11;0;0;0;0;0;0;0;0;0;0;0;0;0;0;0;0;0;0
FR;8;2021-12-12;0;0;0;0;0;0;0;0;0;0;0;0;0;0;0;0;0;0
FR;8;2021-12-13;0;0;0;0;0;0;0;0;0;0;0;0;0;0;0;0;0;0
FR;8;2021-12-14;0;0;0;0;0;0;0;0;0;0;0;0;0;0;0;0;0;0
FR;8;2021-12-15;0;0;0;0;0;0;0;0;0;0;0;0;0;0;0;0;0;0
FR;8;2021-12-16;0;0;0;0;0;0;0;0;0;0;0;0;0;0;0;0;0;0
FR;8;2021-12-17;0;0;0;0;0;0;0;0;0;0;0;0;0;0;0;0;0;0
FR;8;2021-12-18;0;0;0;0;0;0;0;0;0;0;0;0;0;0;0;0;0;0
FR;8;2021-12-19;0;0;0;0;0;0;0;0;0;0;0;0;0;0;0;0;0;0
FR;8;2021-12-20;0;0;0;0;0;0;0;0;0;0;0;0;0;0;0;0;0;0
FR;8;2021-12-21;0;0;0;0;0;0;0;0;0;0;0;0;0;0;0;0;0;0
FR;8;2021-12-22;0;0;0;0;0;0;0;0;0;0;0;0;0;0;0;0;0;0
FR;8;2021-12-23;0;0;0;0;0;0;0;0;0;0;0;0;0;0;0;0;0;0
FR;8;2021-12-24;0;0;0;0;0;0;0;0;0;0;0;0;0;0;0;0;0;0
FR;8;2021-12-25;0;0;0;0;0;0;0;0;0;0;0;0;0;0;0;0;0;0
FR;8;2021-12-26;0;0;0;0;0;0;0;0;0;0;0;0;0;0;0;0;0;0
FR;8;2021-12-27;0;0;0;0;0;0;0;0;0;0;0;0;0;0;0;0;0;0
FR;8;2021-12-28;0;0;0;0;0;0;0;0;0;0;0;0;0;0;0;0;0;0
FR;8;2021-12-29;0;0;0;0;0;0;0;0;0;0;0;0;0;0;0;0;0;0
FR;8;2021-12-30;0;0;0;0;0;0;0;0;0;0;0;0;0;0;0;0;0;0
FR;8;2021-12-31;0;0;0;0;0;0;0;0;0;0;0;0;0;0;0;0;0;0
FR;8;2022-01-01;0;0;0;0;0;0;0;0;0;0;0;0;0;0;0;0;0;0
FR;8;2022-01-02;0;0;0;0;0;0;0;0;0;0;0;0;0;0;0;0;0;0
FR;8;2022-01-03;0;0;0;0;0;0;0;0;0;0;0;0;0;0;0;0;0;0
FR;8;2022-01-04;0;0;0;0;0;0;0;0;0;0;0;0;0;0;0;0;0;0
FR;8;2022-01-05;0;0;0;0;0;0;0;0;0;0;0;0;0;0;0;0;0;0
FR;8;2022-01-06;0;0;0;0;0;0;0;0;0;0;0;0;0;0;0;0;0;0
FR;8;2022-01-07;0;0;0;0;0;0;0;0;0;0;0;0;0;0;0;0;0;0
FR;8;2022-01-08;0;0;0;0;0;0;0;0;0;0;0;0;0;0;0;0;0;0
FR;8;2022-01-09;0;0;0;0;0;0;0;0;0;0;0;0;0;0;0;0;0;0
FR;8;2022-01-10;0;0;0;0;0;0;0;0;0;0;0;0;0;0;0;0;0;0
FR;8;2022-01-11;0;0;0;0;0;0;0;0;0;0;0;0;0;0;0;0;0;0
FR;8;2022-01-12;0;0;0;0;0;0;0;0;0;0;0;0;0;0;0;0;0;0
FR;8;2022-01-13;0;0;0;0;0;0;0;0;0;0;0;0;0;0;0;0;0;0
FR;8;2022-01-14;0;0;0;0;0;0;0;0;0;0;0;0;0;0;0;0;0;0
FR;8;2022-01-15;0;0;0;0;0;0;0;0;0;0;0;0;0;0;0;0;0;0
FR;8;2022-01-16;0;0;0;0;0;0;0;0;0;0;0;0;0;0;0;0;0;0
FR;8;2022-01-17;0;0;0;0;0;0;0;0;0;0;0;0;0;0;0;0;0;0
FR;8;2022-01-18;0;0;0;0;0;0;0;0;0;0;0;0;0;0;0;0;0;0
FR;8;2022-01-19;0;0;0;0;0;0;0;0;0;0;0;0;0;0;0;0;0;0
FR;8;2022-01-20;0;0;0;0;0;0;0;0;0;0;0;0;0;0;0;0;0;0
FR;8;2022-01-21;0;0;0;0;0;0;0;0;0;0;0;0;0;0;0;0;0;0
FR;8;2022-01-22;0;0;0;0;0;0;0;0;0;0;0;0;0;0;0;0;0;0
FR;8;2022-01-23;0;0;0;0;0;0;0;0;0;0;0;0;0;0;0;0;0;0
FR;8;2022-01-24;0;0;0;0;0;0;0;0;0;0;0;0;0;0;0;0;0;0
FR;8;2022-01-25;0;0;0;0;0;0;0;0;0;0;0;0;0;0;0;0;0;0
FR;8;2022-01-26;0;0;0;0;0;0;0;0;0;0;0;0;0;0;0;0;0;0
FR;8;2022-01-27;0;0;0;0;0;0;0;0;0;0;0;0;0;0;0;0;0;0
FR;8;2022-01-28;0;0;0;0;0;0;0;0;0;0;0;0;0;0;0;0;0;0
FR;8;2022-01-29;0;0;0;0;0;0;0;0;0;0;0;0;0;0;0;0;0;0
FR;8;2022-01-30;0;0;0;0;0;0;0;0;0;0;0;0;0;0;0;0;0;0
FR;8;2022-01-31;0;0;0;0;0;0;0;0;0;0;0;0;0;0;0;0;0;0
FR;8;2022-02-01;0;0;0;0;0;0;0;0;0;0;0;0;0;0;0;0;0;0
FR;8;2022-02-02;0;0;0;0;0;0;0;0;0;0;0;0;0;0;0;0;0;0
FR;8;2022-02-03;0;0;0;0;0;0;0;0;0;0;0;0;0;0;0;0;0;0
FR;8;2022-02-04;0;0;0;0;0;0;0;0;0;0;0;0;0;0;0;0;0;0
FR;8;2022-02-05;0;0;0;0;0;0;0;0;0;0;0;0;0;0;0;0;0;0
FR;8;2022-02-06;0;0;0;0;0;0;0;0;0;0;0;0;0;0;0;0;0;0
FR;8;2022-02-07;0;0;0;0;0;0;0;0;0;0;0;0;0;0;0;0;0;0
FR;8;2022-02-08;0;0;0;0;0;0;0;0;0;0;0;0;0;0;0;0;0;0
FR;8;2022-02-09;0;0;0;0;0;0;0;0;0;0;0;0;0;0;0;0;0;0
FR;8;2022-02-10;0;0;0;0;0;0;0;0;0;0;0;0;0;0;0;0;0;0
FR;8;2022-02-11;0;0;0;0;0;0;0;0;0;0;0;0;0;0;0;0;0;0
FR;8;2022-02-12;0;0;0;0;0;0;0;0;0;0;0;0;0;0;0;0;0;0
FR;8;2022-02-13;0;0;0;0;0;0;0;0;0;0;0;0;0;0;0;0;0;0
FR;8;2022-02-14;0;0;0;0;0;0;0;0;0;0;0;0;0;0;0;0;0;0
FR;8;2022-02-15;0;0;0;0;0;0;0;0;0;0;0;0;0;0;0;0;0;0
FR;8;2022-02-16;0;0;0;0;0;0;0;0;0;0;0;0;0;0;0;0;0;0
FR;8;2022-02-17;0;0;0;0;0;0;0;0;0;0;0;0;0;0;0;0;0;0
FR;8;2022-02-18;0;0;0;0;0;0;0;0;0;0;0;0;0;0;0;0;0;0
FR;8;2022-02-19;0;0;0;0;0;0;0;0;0;0;0;0;0;0;0;0;0;0
FR;8;2022-02-20;0;0;0;0;0;0;0;0;0;0;0;0;0;0;0;0;0;0
FR;8;2022-02-21;0;0;0;0;0;0;0;0;0;0;0;0;0;0;0;0;0;0
FR;8;2022-02-22;0;0;0;0;0;0;0;0;0;0;0;0;0;0;0;0;0;0
FR;8;2022-02-23;0;0;0;0;0;0;0;0;0;0;0;0;0;0;0;0;0;0
FR;8;2022-02-24;0;0;0;0;0;0;0;0;0;0;0;0;0;0;0;0;0;0
FR;8;2022-02-25;0;0;0;0;0;0;0;0;0;0;0;0;0;0;0;0;0;0
FR;8;2022-02-26;0;0;0;0;0;0;0;0;0;0;0;0;0;0;0;0;0;0
FR;8;2022-02-27;0;0;0;0;0;0;0;0;0;0;0;0;0;0;0;0;0;0
FR;8;2022-02-28;0;0;0;0;0;0;0;0;0;0;0;0;0;0;0;0;0;0
FR;8;2022-03-01;0;0;0;0;0;0;0;0;0;0;0;0;0;0;0;0;0;0
FR;8;2022-03-02;0;0;0;0;0;0;0;0;0;0;0;0;0;0;0;0;0;0
FR;8;2022-03-03;0;0;0;0;0;0;0;0;0;0;0;0;0;0;0;0;0;0
FR;8;2022-03-04;0;0;0;0;0;0;0;0;0;0;0;0;0;0;0;0;0;0
FR;8;2022-03-05;0;0;0;0;0;0;0;0;0;0;0;0;0;0;0;0;0;0
FR;8;2022-03-06;0;0;0;0;0;0;0;0;0;0;0;0;0;0;0;0;0;0
FR;8;2022-03-07;0;0;0;0;0;0;0;0;0;0;0;0;0;0;0;0;0;0
FR;8;2022-03-08;0;0;0;0;0;0;0;0;0;0;0;0;0;0;0;0;0;0
FR;8;2022-03-09;0;0;0;0;0;0;0;0;0;0;0;0;0;0;0;0;0;0
FR;8;2022-03-10;0;0;0;0;0;0;0;0;0;0;0;0;0;0;0;0;0;0
FR;8;2022-03-11;0;0;0;0;0;0;0;0;0;0;0;0;0;0;0;0;0;0
FR;8;2022-03-12;0;0;0;0;0;0;0;0;0;0;0;0;0;0;0;0;0;0
FR;8;2022-03-13;0;0;0;0;0;0;0;0;0;0;0;0;0;0;0;0;0;0
FR;8;2022-03-14;0;0;0;0;0;0;0;0;0;0;0;0;0;0;0;0;0;0
FR;8;2022-03-15;0;0;0;0;0;0;0;0;0;0;0;0;0;0;0;0;0;0
FR;8;2022-03-16;0;0;0;0;0;0;0;0;0;0;0;0;0;0;0;0;0;0
FR;8;2022-03-17;0;0;0;0;0;0;0;0;0;0;0;0;0;0;0;0;0;0
FR;8;2022-03-18;0;0;0;0;0;0;0;0;0;0;0;0;0;0;0;0;0;0
FR;8;2022-03-19;0;0;0;0;0;0;0;0;0;0;0;0;0;0;0;0;0;0
FR;8;2022-03-20;0;0;0;0;0;0;0;0;0;0;0;0;0;0;0;0;0;0
FR;8;2022-03-21;0;0;0;0;0;0;0;0;0;0;0;0;0;0;0;0;0;0
FR;8;2022-03-22;0;0;0;0;0;0;0;0;0;0;0;0;0;0;0;0;0;0
FR;8;2022-03-23;0;0;0;0;0;0;0;0;0;0;0;0;0;0;0;0;0;0
FR;8;2022-03-24;0;0;0;0;0;0;0;0;0;0;0;0;0;0;0;0;0;0
FR;8;2022-03-25;0;0;0;0;0;0;0;0;0;0;0;0;0;0;0;0;0;0
FR;8;2022-03-26;0;0;0;0;0;0;0;0;0;0;0;0;0;0;0;0;0;0
FR;8;2022-03-27;0;0;0;0;0;0;0;0;0;0;0;0;0;0;0;0;0;0
FR;8;2022-03-28;0;0;0;0;0;0;0;0;0;0;0;0;0;0;0;0;0;0
FR;8;2022-03-29;0;0;0;0;0;0;0;0;0;0;0;0;0;0;0;0;0;0
FR;8;2022-03-30;0;0;0;0;0;0;0;0;0;0;0;0;0;0;0;0;0;0
FR;8;2022-03-31;0;0;0;0;0;0;0;0;0;0;0;0;0;0;0;0;0;0
FR;8;2022-04-01;0;0;0;0;0;0;0;0;0;0;0;0;0;0;0;0;0;0
FR;8;2022-04-02;0;0;0;0;0;0;0;0;0;0;0;0;0;0;0;0;0;0
FR;8;2022-04-03;0;0;0;0;0;0;0;0;0;0;0;0;0;0;0;0;0;0
FR;8;2022-04-04;0;0;0;0;0;0;0;0;0;0;0;0;0;0;0;0;0;0
FR;8;2022-04-05;0;0;0;0;0;0;0;0;0;0;0;0;0;0;0;0;0;0
FR;8;2022-04-06;0;0;0;0;0;0;0;0;0;0;0;0;0;0;0;0;0;0
FR;8;2022-04-07;0;0;0;0;0;0;0;0;0;0;0;0;0;0;0;0;0;0
FR;8;2022-04-08;0;0;0;0;0;0;0;0;0;0;0;0;0;0;0;0;0;0
FR;8;2022-04-09;0;0;0;0;0;0;0;0;0;0;0;0;0;0;0;0;0;0
FR;8;2022-04-10;0;0;0;0;0;0;0;0;0;0;0;0;0;0;0;0;0;0
FR;8;2022-04-11;0;0;0;0;0;0;0;0;0;0;0;0;0;0;0;0;0;0
FR;8;2022-04-12;0;0;0;0;0;0;0;0;0;0;0;0;0;0;0;0;0;0
FR;8;2022-04-13;0;0;0;0;0;0;0;0;0;0;0;0;0;0;0;0;0;0
FR;8;2022-04-14;0;0;0;0;0;0;0;0;0;0;0;0;0;0;0;0;0;0
FR;8;2022-04-15;0;0;0;0;0;0;0;0;0;0;0;0;0;0;0;0;0;0
FR;8;2022-04-16;0;0;0;0;0;0;0;0;0;0;0;0;0;0;0;0;0;0
FR;8;2022-04-17;0;0;0;0;0;0;0;0;0;0;0;0;0;0;0;0;0;0
FR;8;2022-04-18;0;0;0;0;0;0;0;0;0;0;0;0;0;0;0;0;0;0
FR;8;2022-04-19;0;0;0;0;0;0;0;0;0;0;0;0;0;0;0;0;0;0
FR;8;2022-04-20;0;0;0;0;0;0;0;0;0;0;0;0;0;0;0;0;0;0
FR;8;2022-04-21;0;0;0;0;0;0;0;0;0;0;0;0;0;0;0;0;0;0
FR;8;2022-04-22;0;0;0;0;0;0;0;0;0;0;0;0;0;0;0;0;0;0
FR;8;2022-04-23;0;0;0;0;0;0;0;0;0;0;0;0;0;0;0;0;0;0
FR;8;2022-04-24;0;0;0;0;0;0;0;0;0;0;0;0;0;0;0;0;0;0
FR;8;2022-04-25;0;0;0;0;0;0;0;0;0;0;0;0;0;0;0;0;0;0
FR;8;2022-04-26;0;0;0;0;0;0;0;0;0;0;0;0;0;0;0;0;0;0
FR;8;2022-04-27;0;0;0;0;0;0;0;0;0;0;0;0;0;0;0;0;0;0
FR;8;2022-04-28;0;0;0;0;0;0;0;0;0;0;0;0;0;0;0;0;0;0
FR;8;2022-04-29;0;0;0;0;0;0;0;0;0;0;0;0;0;0;0;0;0;0
FR;8;2022-04-30;0;0;0;0;0;0;0;0;0;0;0;0;0;0;0;0;0;0
FR;8;2022-05-01;0;0;0;0;0;0;0;0;0;0;0;0;0;0;0;0;0;0
FR;8;2022-05-02;0;0;0;0;0;0;0;0;0;0;0;0;0;0;0;0;0;0
FR;8;2022-05-03;0;0;0;0;0;0;0;0;0;0;0;0;0;0;0;0;0;0
FR;8;2022-05-04;0;0;0;0;0;0;0;0;0;0;0;0;0;0;0;0;0;0
FR;8;2022-05-05;0;0;0;0;0;0;0;0;0;0;0;0;0;0;0;0;0;0
FR;8;2022-05-06;0;0;0;0;0;0;0;0;0;0;0;0;0;0;0;0;0;0
FR;8;2022-05-07;0;0;0;0;0;0;0;0;0;0;0;0;0;0;0;0;0;0
FR;8;2022-05-08;0;0;0;0;0;0;0;0;0;0;0;0;0;0;0;0;0;0
FR;8;2022-05-09;0;0;0;0;0;0;0;0;0;0;0;0;0;0;0;0;0;0
FR;8;2022-05-10;0;0;0;0;0;0;0;0;0;0;0;0;0;0;0;0;0;0
FR;8;2022-05-11;0;0;0;0;0;0;0;0;0;0;0;0;0;0;0;0;0;0
FR;8;2022-05-12;0;0;0;0;0;0;0;0;0;0;0;0;0;0;0;0;0;0
FR;8;2022-05-13;0;0;0;0;0;0;0;0;0;0;0;0;0;0;0;0;0;0
FR;8;2022-05-14;0;0;0;0;0;0;0;0;0;0;0;0;0;0;0;0;0;0
FR;8;2022-05-15;0;0;0;0;0;0;0;0;0;0;0;0;0;0;0;0;0;0
FR;8;2022-05-16;0;0;0;0;0;0;0;0;0;0;0;0;0;0;0;0;0;0
FR;8;2022-05-17;0;0;0;0;0;0;0;0;0;0;0;0;0;0;0;0;0;0
FR;8;2022-05-18;0;0;0;0;0;0;0;0;0;0;0;0;0;0;0;0;0;0
FR;8;2022-05-19;0;0;0;0;0;0;0;0;0;0;0;0;0;0;0;0;0;0
FR;8;2022-05-20;0;0;0;0;0;0;0;0;0;0;0;0;0;0;0;0;0;0
FR;8;2022-05-21;0;0;0;0;0;0;0;0;0;0;0;0;0;0;0;0;0;0
FR;8;2022-05-22;0;0;0;0;0;0;0;0;0;0;0;0;0;0;0;0;0;0
FR;8;2022-05-23;0;0;0;0;0;0;0;0;0;0;0;0;0;0;0;0;0;0
FR;8;2022-05-24;0;0;0;0;0;0;0;0;0;0;0;0;0;0;0;0;0;0
FR;8;2022-05-25;0;0;0;0;0;0;0;0;0;0;0;0;0;0;0;0;0;0
FR;8;2022-05-26;0;0;0;0;0;0;0;0;0;0;0;0;0;0;0;0;0;0
FR;8;2022-05-27;0;0;0;0;0;0;0;0;0;0;0;0;0;0;0;0;0;0
FR;8;2022-05-28;0;0;0;0;0;0;0;0;0;0;0;0;0;0;0;0;0;0
FR;8;2022-05-29;0;0;0;0;0;0;0;0;0;0;0;0;0;0;0;0;0;0
FR;8;2022-05-30;0;0;0;0;0;0;0;0;0;0;0;0;0;0;0;0;0;0
FR;8;2022-05-31;0;0;0;0;0;0;0;0;0;0;0;0;0;0;0;0;0;0
FR;8;2022-06-01;0;0;0;0;0;0;0;0;0;0;0;0;0;0;0;0;0;0
FR;8;2022-06-02;0;0;0;0;0;0;0;0;0;0;0;0;0;0;0;0;0;0
FR;8;2022-06-03;0;0;0;0;0;0;0;0;0;0;0;0;0;0;0;0;0;0
FR;8;2022-06-04;0;0;0;0;0;0;0;0;0;0;0;0;0;0;0;0;0;0
FR;8;2022-06-05;0;0;0;0;0;0;0;0;0;0;0;0;0;0;0;0;0;0
FR;8;2022-06-06;0;0;0;0;0;0;0;0;0;0;0;0;0;0;0;0;0;0
FR;8;2022-06-07;0;0;0;0;0;0;0;0;0;0;0;0;0;0;0;0;0;0
FR;8;2022-06-08;0;0;0;0;0;0;0;0;0;0;0;0;0;0;0;0;0;0
FR;8;2022-06-09;0;0;0;0;0;0;0;0;0;0;0;0;0;0;0;0;0;0
FR;8;2022-06-10;0;0;0;0;0;0;0;0;0;0;0;0;0;0;0;0;0;0
FR;8;2022-06-11;0;0;0;0;0;0;0;0;0;0;0;0;0;0;0;0;0;0
FR;8;2022-06-12;0;0;0;0;0;0;0;0;0;0;0;0;0;0;0;0;0;0
FR;8;2022-06-13;0;0;0;0;0;0;0;0;0;0;0;0;0;0;0;0;0;0
FR;8;2022-06-14;0;0;0;0;0;0;0;0;0;0;0;0;0;0;0;0;0;0
FR;8;2022-06-15;0;0;0;0;0;0;0;0;0;0;0;0;0;0;0;0;0;0
FR;8;2022-06-16;0;0;0;0;0;0;0;0;0;0;0;0;0;0;0;0;0;0
FR;8;2022-06-17;0;0;0;0;0;0;0;0;0;0;0;0;0;0;0;0;0;0
FR;8;2022-06-18;0;0;0;0;0;0;0;0;0;0;0;0;0;0;0;0;0;0
FR;8;2022-06-19;0;0;0;0;0;0;0;0;0;0;0;0;0;0;0;0;0;0
FR;8;2022-06-20;0;0;0;0;0;0;0;0;0;0;0;0;0;0;0;0;0;0
FR;8;2022-06-21;0;0;0;0;0;0;0;0;0;0;0;0;0;0;0;0;0;0
FR;8;2022-06-22;0;0;0;0;0;0;0;0;0;0;0;0;0;0;0;0;0;0
FR;8;2022-06-23;0;0;0;0;0;0;0;0;0;0;0;0;0;0;0;0;0;0
FR;8;2022-06-24;0;0;0;0;0;0;0;0;0;0;0;0;0;0;0;0;0;0
FR;8;2022-06-25;0;0;0;0;0;0;0;0;0;0;0;0;0;0;0;0;0;0
FR;8;2022-06-26;0;0;0;0;0;0;0;0;0;0;0;0;0;0;0;0;0;0
FR;8;2022-06-27;0;0;0;0;0;0;0;0;0;0;0;0;0;0;0;0;0;0
FR;8;2022-06-28;0;0;0;0;0;0;0;0;0;0;0;0;0;0;0;0;0;0
FR;8;2022-06-29;0;0;0;0;0;0;0;0;0;0;0;0;0;0;0;0;0;0
FR;8;2022-06-30;0;0;0;0;0;0;0;0;0;0;0;0;0;0;0;0;0;0
FR;8;2022-07-01;0;0;0;0;0;0;0;0;0;0;0;0;0;0;0;0;0;0
FR;8;2022-07-02;0;0;0;0;0;0;0;0;0;0;0;0;0;0;0;0;0;0
FR;8;2022-07-03;0;0;0;0;0;0;0;0;0;0;0;0;0;0;0;0;0;0
FR;8;2022-07-04;0;0;0;0;0;0;0;0;0;0;0;0;0;0;0;0;0;0
FR;8;2022-07-05;0;0;0;0;0;0;0;0;0;0;0;0;0;0;0;0;0;0
FR;8;2022-07-06;0;0;0;0;0;0;0;0;0;0;0;0;0;0;0;0;0;0
FR;8;2022-07-07;0;0;0;0;0;0;0;0;0;0;0;0;0;0;0;0;0;0
FR;8;2022-07-08;0;0;0;0;0;0;0;0;0;0;0;0;0;0;0;0;0;0
FR;8;2022-07-09;0;0;0;0;0;0;0;0;0;0;0;0;0;0;0;0;0;0
FR;8;2022-07-10;0;0;0;0;0;0;0;0;0;0;0;0;0;0;0;0;0;0
FR;8;2022-07-11;0;0;0;0;0;0;0;0;0;0;0;0;0;0;0;0;0;0
FR;8;2022-07-12;0;0;0;0;0;0;0;0;0;0;0;0;0;0;0;0;0;0
FR;8;2022-07-13;0;0;0;0;0;0;0;0;0;0;0;0;0;0;0;0;0;0
FR;8;2022-07-14;0;0;0;0;0;0;0;0;0;0;0;0;0;0;0;0;0;0
FR;8;2022-07-15;0;0;0;0;0;0;0;0;0;0;0;0;0;0;0;0;0;0
FR;8;2022-07-16;0;0;0;0;0;0;0;0;0;0;0;0;0;0;0;0;0;0
FR;8;2022-07-17;0;0;0;0;0;0;0;0;0;0;0;0;0;0;0;0;0;0
FR;8;2022-07-18;0;0;0;0;0;0;0;0;0;0;0;0;0;0;0;0;0;0
FR;8;2022-07-19;0;0;0;0;0;0;0;0;0;0;0;0;0;0;0;0;0;0
FR;8;2022-07-20;0;0;0;0;0;0;0;0;0;0;0;0;0;0;0;0;0;0
FR;8;2022-07-21;0;0;0;0;0;0;0;0;0;0;0;0;0;0;0;0;0;0
FR;8;2022-07-22;0;0;0;0;0;0;0;0;0;0;0;0;0;0;0;0;0;0
FR;8;2022-07-23;0;0;0;0;0;0;0;0;0;0;0;0;0;0;0;0;0;0
FR;8;2022-07-24;0;0;0;0;0;0;0;0;0;0;0;0;0;0;0;0;0;0
FR;8;2022-07-25;0;0;0;0;0;0;0;0;0;0;0;0;0;0;0;0;0;0
FR;8;2022-07-26;0;0;0;0;0;0;0;0;0;0;0;0;0;0;0;0;0;0
FR;8;2022-07-27;0;0;0;0;0;0;0;0;0;0;0;0;0;0;0;0;0;0
FR;8;2022-07-28;0;0;0;0;0;0;0;0;0;0;0;0;0;0;0;0;0;0
FR;8;2022-07-29;0;0;0;0;0;0;0;0;0;0;0;0;0;0;0;0;0;0
FR;8;2022-07-30;0;0;0;0;0;0;0;0;0;0;0;0;0;0;0;0;0;0
FR;8;2022-07-31;0;0;0;0;0;0;0;0;0;0;0;0;0;0;0;0;0;0
FR;8;2022-08-01;0;0;0;0;0;0;0;0;0;0;0;0;0;0;0;0;0;0
FR;8;2022-08-02;0;0;0;0;0;0;0;0;0;0;0;0;0;0;0;0;0;0
FR;8;2022-08-03;0;0;0;0;0;0;0;0;0;0;0;0;0;0;0;0;0;0
FR;8;2022-08-04;0;0;0;0;0;0;0;0;0;0;0;0;0;0;0;0;0;0
FR;8;2022-08-05;0;0;0;0;0;0;0;0;0;0;0;0;0;0;0;0;0;0
FR;8;2022-08-06;0;0;0;0;0;0;0;0;0;0;0;0;0;0;0;0;0;0
FR;8;2022-08-07;0;0;0;0;0;0;0;0;0;0;0;0;0;0;0;0;0;0
FR;8;2022-08-08;0;0;0;0;0;0;0;0;0;0;0;0;0;0;0;0;0;0
FR;8;2022-08-09;0;0;0;0;0;0;0;0;0;0;0;0;0;0;0;0;0;0
FR;8;2022-08-10;0;0;0;0;0;0;0;0;0;0;0;0;0;0;0;0;0;0
FR;8;2022-08-11;0;0;0;0;0;0;0;0;0;0;0;0;0;0;0;0;0;0
FR;8;2022-08-12;0;0;0;0;0;0;0;0;0;0;0;0;0;0;0;0;0;0
FR;8;2022-08-13;0;0;0;0;0;0;0;0;0;0;0;0;0;0;0;0;0;0
FR;8;2022-08-14;0;0;0;0;0;0;0;0;0;0;0;0;0;0;0;0;0;0
FR;8;2022-08-15;0;0;0;0;0;0;0;0;0;0;0;0;0;0;0;0;0;0
FR;8;2022-08-16;0;0;0;0;0;0;0;0;0;0;0;0;0;0;0;0;0;0
FR;8;2022-08-17;0;0;0;0;0;0;0;0;0;0;0;0;0;0;0;0;0;0
FR;8;2022-08-18;0;0;0;0;0;0;0;0;0;0;0;0;0;0;0;0;0;0
FR;8;2022-08-19;0;0;0;0;0;0;0;0;0;0;0;0;0;0;0;0;0;0
FR;8;2022-08-20;0;0;0;0;0;0;0;0;0;0;0;0;0;0;0;0;0;0
FR;8;2022-08-21;0;0;0;0;0;0;0;0;0;0;0;0;0;0;0;0;0;0
FR;8;2022-08-22;0;0;0;0;0;0;0;0;0;0;0;0;0;0;0;0;0;0
FR;8;2022-08-23;0;0;0;0;0;0;0;0;0;0;0;0;0;0;0;0;0;0
FR;8;2022-08-24;0;0;0;0;0;0;0;0;0;0;0;0;0;0;0;0;0;0
FR;8;2022-08-25;0;0;0;0;0;0;0;0;0;0;0;0;0;0;0;0;0;0
FR;8;2022-08-26;0;0;0;0;0;0;0;0;0;0;0;0;0;0;0;0;0;0
FR;8;2022-08-27;0;0;0;0;0;0;0;0;0;0;0;0;0;0;0;0;0;0
FR;8;2022-08-28;0;0;0;0;0;0;0;0;0;0;0;0;0;0;0;0;0;0
FR;8;2022-08-29;0;0;0;0;0;0;0;0;0;0;0;0;0;0;0;0;0;0
FR;8;2022-08-30;0;0;0;0;0;0;0;0;0;0;0;0;0;0;0;0;0;0
FR;8;2022-08-31;0;0;0;0;0;0;0;0;0;0;0;0;0;0;0;0;0;0
FR;8;2022-09-01;0;0;0;0;0;0;0;0;0;0;0;0;0;0;0;0;0;0
FR;8;2022-09-02;0;0;0;0;0;0;0;0;0;0;0;0;0;0;0;0;0;0
FR;8;2022-09-03;0;0;0;0;0;0;0;0;0;0;0;0;0;0;0;0;0;0
FR;8;2022-09-04;0;0;0;0;0;0;0;0;0;0;0;0;0;0;0;0;0;0
FR;8;2022-09-05;0;0;0;0;0;0;0;0;0;0;0;0;0;0;0;0;0;0
FR;8;2022-09-06;0;0;0;0;0;0;0;0;0;0;0;0;0;0;0;0;0;0
FR;8;2022-09-07;0;0;0;0;0;0;0;0;0;0;0;0;0;0;0;0;0;0
FR;8;2022-09-08;0;0;0;0;0;0;0;0;0;0;0;0;0;0;0;0;0;0
FR;8;2022-09-09;0;0;0;0;0;0;0;0;0;0;0;0;0;0;0;0;0;0
FR;8;2022-09-10;0;0;0;0;0;0;0;0;0;0;0;0;0;0;0;0;0;0
FR;8;2022-09-11;0;0;0;0;0;0;0;0;0;0;0;0;0;0;0;0;0;0
FR;8;2022-09-12;0;0;0;0;0;0;0;0;0;0;0;0;0;0;0;0;0;0
FR;8;2022-09-13;0;0;0;0;0;0;0;0;0;0;0;0;0;0;0;0;0;0
FR;8;2022-09-14;0;0;0;0;0;0;0;0;0;0;0;0;0;0;0;0;0;0
FR;8;2022-09-15;0;0;0;0;0;0;0;0;0;0;0;0;0;0;0;0;0;0
FR;8;2022-09-16;0;0;0;0;0;0;0;0;0;0;0;0;0;0;0;0;0;0
FR;8;2022-09-17;0;0;0;0;0;0;0;0;0;0;0;0;0;0;0;0;0;0
FR;8;2022-09-18;0;0;0;0;0;0;0;0;0;0;0;0;0;0;0;0;0;0
FR;8;2022-09-19;0;0;0;0;0;0;0;0;0;0;0;0;0;0;0;0;0;0
FR;8;2022-09-20;0;0;0;0;0;0;0;0;0;0;0;0;0;0;0;0;0;0
FR;8;2022-09-21;0;0;0;0;0;0;0;0;0;0;0;0;0;0;0;0;0;0
FR;8;2022-09-22;0;0;0;0;0;0;0;0;0;0;0;0;0;0;0;0;0;0
FR;8;2022-09-23;0;0;0;0;0;0;0;0;0;0;0;0;0;0;0;0;0;0
FR;8;2022-09-24;0;0;0;0;0;0;0;0;0;0;0;0;0;0;0;0;0;0
FR;8;2022-09-25;0;0;0;0;0;0;0;0;0;0;0;0;0;0;0;0;0;0
FR;8;2022-09-26;0;0;0;0;0;0;0;0;0;0;0;0;0;0;0;0;0;0
FR;8;2022-09-27;0;0;0;0;0;0;0;0;0;0;0;0;0;0;0;0;0;0
FR;8;2022-09-28;0;0;0;0;0;0;0;0;0;0;0;0;0;0;0;0;0;0
FR;8;2022-09-29;0;0;0;0;0;0;0;0;0;0;0;0;0;0;0;0;0;0
FR;8;2022-09-30;0;0;0;0;0;0;0;0;0;0;0;0;0;0;0;0;0;0
FR;8;2022-10-01;0;0;0;0;0;0;0;0;0;0;0;0;0;0;0;0;0;0
FR;8;2022-10-02;0;0;0;0;0;0;0;0;0;0;0;0;0;0;0;0;0;0
FR;8;2022-10-03;0;0;0;0;0;0;0;0;0;0;0;0;0;0;0;0;0;0
FR;8;2022-10-04;0;0;0;0;0;0;0;0;0;0;0;0;0;0;0;0;0;0
FR;8;2022-10-05;0;0;0;0;0;0;0;0;0;0;0;0;0;0;0;0;0;0
FR;8;2022-10-06;14;17;113;861;8;83;866;1059;110;14;17;113;861;8;83;866;1059;110
FR;8;2022-10-07;75;103;843;8012;63;700;8066;9846;1073;89;120;956;8873;71;783;8932;10905;1183
FR;8;2022-10-08;37;115;610;4057;50;516;4109;5310;676;126;235;1566;12930;121;1299;13041;16215;1859
FR;8;2022-10-09;17;22;145;885;13;132;913;1234;185;143;257;1711;13815;134;1431;13954;17449;2044
FR;8;2022-10-10;131;192;1351;12751;106;1044;12982;16301;2253;274;449;3062;26566;240;2475;26936;33750;4297
FR;8;2022-10-11;205;264;2477;26947;136;2013;27217;33995;4727;479;713;5539;53513;376;4488;54153;67745;9024
FR;8;2022-10-12;165;258;1831;18238;152;1441;18474;23477;3538;644;971;7370;71751;528;5929;72627;91222;12562
FR;8;2022-10-13;209;281;2512;28079;178;1905;28443;35582;5206;853;1252;9882;99830;706;7834;101070;126804;17768
FR;8;2022-10-14;257;419;3272;36247;241;2557;36672;45579;6308;1110;1671;13154;136077;947;10391;137742;172383;24076
FR;8;2022-10-15;105;182;1203;8806;79;1002;8932;11783;1829;1215;1853;14357;144883;1026;11393;146674;184166;25905
FR;8;2022-10-16;36;54;248;1522;26;215;1557;2179;402;1251;1907;14605;146405;1052;11608;148231;186345;26307
FR;8;2022-10-17;159;313;2101;21806;175;1631;22113;28301;4535;1410;2220;16706;168211;1227;13239;170344;214646;30842
FR;8;2022-10-18;276;350;3356;37862;227;2654;38245;50787;9815;1686;2570;20062;206073;1454;15893;208589;265433;40657
FR;8;2022-10-19;205;314;2632;28301;183;2188;28629;38749;7871;1891;2884;22694;234374;1637;18081;237218;304182;48528
FR;8;2022-10-20;257;368;3577;41214;229;2653;41819;55725;11168;2148;3252;26271;275588;1866;20734;279037;359907;59696
FR;8;2022-10-21;325;490;4461;49421;277;3475;50020;66311;12717;2473;3742;30732;325009;2143;24209;329057;426218;72413
FR;8;2022-10-22;127;168;1230;10665;112;927;10851;14746;2949;2600;3910;31962;335674;2255;25136;339908;440964;75362
FR;8;2022-10-23;50;53;266;1762;48;197;1841;2610;571;2650;3963;32228;337436;2303;25333;341749;443574;75933
FR;8;2022-10-24;231;312;2475;24047;175;2074;24345;33555;7085;2881;4275;34703;361483;2478;27407;366094;477129;83018
FR;8;2022-10-25;307;417;4082;43467;257;3138;44066;61318;14011;3188;4692;38785;404950;2735;30545;410160;538447;97029
FR;8;2022-10-26;228;343;2886;28762;187;2381;29042;41474;9963;3416;5035;41671;433712;2922;32926;439202;579921;106992
FR;8;2022-10-27;277;415;3330;36200;243;2636;36676;51267;11890;3693;5450;45001;469912;3165;35562;475878;631188;118882
FR;8;2022-10-28;330;466;3829;39480;260;2864;40203;55137;12001;4023;5916;48830;509392;3425;38426;516081;686325;130883
FR;8;2022-10-29;113;165;1074;8230;94;803;8374;11861;2667;4136;6081;49904;517622;3519;39229;524455;698186;133550
FR;8;2022-10-30;40;53;210;1348;38;180;1394;2063;485;4176;6134;50114;518970;3557;39409;525849;700249;134035
FR;8;2022-10-31;196;260;1665;14543;145;1277;14808;21211;5108;4372;6394;51779;533513;3702;40686;540657;721460;139143
FR;8;2022-11-01;52;43;137;963;25;171;978;1626;474;4424;6437;51916;534476;3727;40857;541635;723086;139617
FR;8;2022-11-02;207;371;2377;23320;206;1982;23716;35077;9312;4631;6808;54293;557796;3933;42839;565351;758163;148929
FR;8;2022-11-03;310;419;3487;36970;260;2604;37615;54695;14377;4941;7227;57780;594766;4193;45443;602966;812858;163306
FR;8;2022-11-04;357;497;3785;40214;262;2977;40743;58032;14201;5298;7724;61565;634980;4455;48420;643709;870890;177507
FR;8;2022-11-05;113;189;1103;8770;123;850;8937;12893;3071;5411;7913;62668;643750;4578;49270;652646;883783;180578
FR;8;2022-11-06;45;56;224;1410;38;205;1443;2252;594;5456;7969;62892;645160;4616;49475;654089;886035;181172
FR;8;2022-11-07;278;282;2324;24845;211;1799;25433;37636;10336;5734;8251;65216;670005;4827;51274;679522;923671;191508
FR;8;2022-11-08;385;508;4340;48424;308;3274;49408;71674;18830;6119;8759;69556;718429;5135;54548;728930;995345;210338
FR;8;2022-11-09;271;370;2879;29184;212;2263;29870;44496;12279;6390;9129;72435;747613;5347;56811;758800;1039841;222617
FR;8;2022-11-10;373;549;3959;40306;317;3036;41217;60608;16215;6763;9678;76394;787919;5664;59847;800017;1100449;238832
FR;8;2022-11-11;40;67;243;1480;38;204;1526;2676;933;6803;9745;76637;789399;5702;60051;801543;1103125;239765
FR;8;2022-11-12;84;166;881;6433;80;687;6636;9894;2552;6887;9911;77518;795832;5782;60738;808179;1113019;242317
FR;8;2022-11-13;36;56;213;1110;37;173;1162;1927;586;6923;9967;77731;796942;5819;60911;809341;1114946;242903
FR;8;2022-11-14;238;308;2245;22501;169;1729;23035;35208;10369;7161;10275;79976;819443;5988;62640;832376;1150154;253272
FR;8;2022-11-15;354;432;3766;42380;267;2876;43289;64857;18558;7515;10707;83742;861823;6255;65516;875665;1215011;271830
FR;8;2022-11-16;316;353;2623;26561;222;2159;27039;41800;12517;7831;11060;86365;888384;6477;67675;902704;1256811;284347
FR;8;2022-11-17;376;431;3390;36899;293;2622;37480;56723;16522;8207;11491;89755;925283;6770;70297;940184;1313534;300869
FR;8;2022-11-18;346;468;4075;42329;290;2978;43184;63705;17439;8553;11959;93830;967612;7060;73275;983368;1377239;318308
FR;8;2022-11-19;121;183;1198;8976;122;844;9159;13843;3802;8674;12142;95028;976588;7182;74119;992527;1391082;322110
FR;8;2022-11-20;35;55;260;1588;39;217;1656;2667;789;8709;12197;95288;978176;7221;74336;994183;1393749;322899
FR;8;2022-11-21;218;303;2078;20128;178;1601;20660;32200;9872;8927;12500;97366;998304;7399;75937;1014843;1425949;332771
FR;8;2022-11-22;338;409;3477;37575;252;2675;38095;58253;17372;9265;12909;100843;1035879;7651;78612;1052938;1484202;350143
FR;8;2022-11-23;234;327;2415;24443;192;2018;24873;39258;12285;9499;13236;103258;1060322;7843;80630;1077811;1523460;362428
FR;8;2022-11-24;352;391;3373;34938;238;2581;35625;55424;17119;9851;13627;106631;1095260;8081;83211;1113436;1578884;379547
FR;8;2022-11-25;311;428;3634;37745;291;2626;38547;57871;16574;10162;14055;110265;1133005;8372;85837;1151983;1636755;396121
FR;8;2022-11-26;172;195;1177;8823;127;898;8989;13703;3785;10334;14250;111442;1141828;8499;86735;1160972;1650458;399906
FR;8;2022-11-27;45;43;227;1550;38;180;1572;2486;724;10379;14293;111669;1143378;8537;86915;1162544;1652944;400630
FR;8;2022-11-28;184;301;2309;23397;172;1704;24060;37357;11519;10563;14594;113978;1166775;8709;88619;1186604;1690301;412149
FR;8;2022-11-29;293;430;3980;44109;218;2945;44796;69214;21350;10856;15024;117958;1210884;8927;91564;1231400;1759515;433499
FR;8;2022-11-30;284;415;3377;34890;232;2545;35654;54730;16413;11140;15439;121335;1245774;9159;94109;1267054;1814245;449912
FR;8;2022-12-01;334;476;4479;49383;274;3132;50163;77767;24309;11474;15915;125814;1295157;9433;97241;1317217;1892012;474221
FR;8;2022-12-02;410;522;5439;58460;308;3743;59637;89853;26283;11884;16437;131253;1353617;9741;100984;1376854;1981865;500504
FR;8;2022-12-03;178;223;1918;16861;113;1328;17273;25844;7207;12062;16660;133171;1370478;9854;102312;1394127;2007709;507711
FR;8;2022-12-04;54;90;489;4056;59;404;4116;6288;1756;12116;16750;133660;1374534;9913;102716;1398243;2013997;509467
FR;8;2022-12-05;306;407;3852;42398;250;2517;43323;66979;20990;12422;17157;137512;1416932;10163;105233;1441566;2080976;530457
FR;8;2022-12-06;439;555;6301;74329;315;4215;75753;117967;37753;12861;17712;143813;1491261;10478;109448;1517319;2198943;568210
FR;8;2022-12-07;367;438;4909;55038;266;3244;56129;87719;28151;13228;18150;148722;1546299;10744;112692;1573448;2286662;596361
FR;8;2022-12-08;454;541;6448;75456;299;4197;77040;120499;39001;13682;18691;155170;1621755;11043;116889;1650488;2407161;635362
FR;8;2022-12-09;546;609;8021;90911;361;5216;92680;143050;44884;14228;19300;163191;1712666;11404;122105;1743168;2550211;680246
FR;8;2022-12-10;264;376;3341;31718;243;2089;32564;48738;13994;14492;19676;166532;1744384;11647;124194;1775732;2598949;694240
FR;8;2022-12-11;90;109;938;7866;70;645;8085;11895;3145;14582;19785;167470;1752250;11717;124839;1783817;2610844;697385
FR;8;2022-12-12;356;465;5859;64351;256;3730;65866;103413;33619;14938;20250;173329;1816601;11973;128569;1849683;2714257;731004
FR;8;2022-12-13;542;611;8431;99145;362;5208;101583;160271;53145;15480;20861;181760;1915746;12335;133777;1951266;2874528;784149
FR;8;2022-12-14;460;535;6364;70058;308;4214;71642;113506;37380;15940;21396;188124;1985804;12643;137991;2022908;2988034;821529
FR;8;2022-12-15;494;664;8163;91749;379;5142;93962;149266;49821;16434;22060;196287;2077553;13022;143133;2116870;3137300;871350
FR;8;2022-12-16;582;715;8880;100372;391;5712;102502;162077;53488;17016;22775;205167;2177925;13413;148845;2219372;3299377;924838
FR;8;2022-12-17;235;309;3145;30075;192;2004;30844;46784;13831;17251;23084;208312;2208000;13605;150849;2250216;3346161;938669
FR;8;2022-12-18;63;94;732;5975;50;499;6124;9309;2657;17314;23178;209044;2213975;13655;151348;2256340;3355470;941326
FR;8;2022-12-19;402;453;5344;53775;265;3368;55338;87781;28893;17716;23631;214388;2267750;13920;154716;2311678;3443251;970219
FR;8;2022-12-20;556;585;7347;76592;352;4755;78689;127126;43354;18272;24216;221735;2344342;14272;159471;2390367;3570377;1013573
FR;8;2022-12-21;429;483;4970;48810;289;3325;50102;81792;28167;18701;24699;226705;2393152;14561;162796;2440469;3652169;1041740
FR;8;2022-12-22;465;526;4589;44285;317;3188;45505;74799;25951;19166;25225;231294;2437437;14878;165984;2485974;3726968;1067691
FR;8;2022-12-23;322;391;2887;25049;254;2102;25697;42335;14418;19488;25616;234181;2462486;15132;168086;2511671;3769303;1082109
FR;8;2022-12-24;70;70;395;2552;41;295;2666;4152;1174;19558;25686;234576;2465038;15173;168381;2514337;3773455;1083283
FR;8;2022-12-25;29;30;106;546;22;84;567;914;260;19587;25716;234682;2465584;15195;168465;2514904;3774369;1083543
FR;8;2022-12-26;245;278;2158;16092;180;1508;16705;26817;8508;19832;25994;236840;2481676;15375;169973;2531609;3801186;1092051
FR;8;2022-12-27;393;453;3776;32422;265;2534;33517;55333;19135;20225;26447;240616;2514098;15640;172507;2565126;3856519;1111186
FR;8;2022-12-28;345;343;2942;24668;192;2056;25256;41769;14337;20570;26790;243558;2538766;15832;174563;2590382;3898288;1125523
FR;8;2022-12-29;298;409;3159;25516;227;2187;26468;43980;15195;20868;27199;246717;2564282;16059;176750;2616850;3942268;1140718
FR;8;2022-12-30;300;346;2445;18677;219;1703;19319;31742;10612;21168;27545;249162;2582959;16278;178453;2636169;3974010;1151330
FR;8;2022-12-31;92;117;453;2965;75;364;3108;4764;1272;21260;27662;249615;2585924;16353;178817;2639277;3978774;1152602
FR;8;2023-01-01;17;30;112;661;14;85;684;995;225;21277;27692;249727;2586585;16367;178902;2639961;3979769;1152827
FR;8;2023-01-02;283;414;2268;18228;245;1615;18690;32086;11696;21560;28106;251995;2604813;16612;180517;2658651;4011855;1164523
FR;8;2023-01-03;476;547;4251;42812;327;2915;43728;80865;33899;22036;28653;256246;2647625;16939;183432;2702379;4092720;1198422
FR;8;2023-01-04;415;482;3495;29987;299;2426;30742;58284;24929;22451;29135;259741;2677612;17238;185858;2733121;4151004;1223351
FR;8;2023-01-05;505;599;4370;41821;400;2934;42712;82017;36051;22956;29734;264111;2719433;17638;188792;2775833;4233021;1259402
FR;8;2023-01-06;518;671;5108;46739;406;3346;47751;89700;38272;23474;30405;269219;2766172;18044;192138;2823584;4322721;1297674
FR;8;2023-01-07;219;290;1704;12304;183;1199;12617;22352;8436;23693;30695;270923;2778476;18227;193337;2836201;4345073;1306110
FR;8;2023-01-08;69;105;443;2744;64;312;2839;5095;1927;23762;30800;271366;2781220;18291;193649;2839040;4350168;1308037
FR;8;2023-01-09;405;482;2622;21497;315;1856;22057;44599;20466;24167;31282;273988;2802717;18606;195505;2861097;4394767;1328503
FR;8;2023-01-10;464;644;4349;40194;404;3069;40959;85068;40656;24631;31926;278337;2842911;19010;198574;2902056;4479835;1369159
FR;8;2023-01-11;350;461;2950;24116;287;2117;24627;51494;24458;24981;32387;281287;2867027;19297;200691;2926683;4531329;1393617
FR;8;2023-01-12;413;544;3658;33170;334;2576;33792;70833;34095;25394;32931;284945;2900197;19631;203267;2960475;4602162;1427712
FR;8;2023-01-13;449;590;4050;34895;340;2866;35507;72891;34139;25843;33521;288995;2935092;19971;206133;2995982;4675053;1461851
FR;8;2023-01-14;178;229;1343;8862;123;959;9045;17190;7106;26021;33750;290338;2943954;20094;207092;3005027;4692243;1468957
FR;8;2023-01-15;63;89;329;1481;54;245;1587;3198;1354;26084;33839;290667;2945435;20148;207337;3006614;4695441;1470311
FR;8;2023-01-16;267;340;1997;15752;199;1433;16011;35209;17562;26351;34179;292664;2961187;20347;208770;3022625;4730650;1487873
FR;8;2023-01-17;360;455;3248;28164;283;2321;28672;64507;33107;26711;34634;295912;2989351;20630;211091;3051297;4795157;1520980
FR;8;2023-01-18;266;407;2193;16822;247;1669;17067;38335;19344;26977;35041;298105;3006173;20877;212760;3068364;4833492;1540324
FR;8;2023-01-19;355;415;2667;22306;253;1950;22654;51226;26250;27332;35456;300772;3028479;21130;214710;3091018;4884718;1566574
FR;8;2023-01-20;406;509;3175;24804;310;2340;25286;56596;28589;27738;35965;303947;3053283;21440;217050;3116304;4941314;1595163
FR;8;2023-01-21;147;189;1004;6114;102;732;6241;12899;5829;27885;36154;304951;3059397;21542;217782;3122545;4954213;1600992
FR;8;2023-01-22;31;52;156;833;23;138;878;1880;844;27916;36206;305107;3060230;21565;217920;3123423;4956093;1601836
FR;8;2023-01-23;215;299;1588;10614;163;1162;10834;26665;14421;28131;36505;306695;3070844;21728;219082;3134257;4982758;1616257
FR;8;2023-01-24;305;419;2409;20006;250;1796;20267;49922;27441;28436;36924;309104;3090850;21978;220878;3154524;5032680;1643698
FR;8;2023-01-25;241;378;1800;12091;230;1324;12493;29961;15878;28677;37302;310904;3102941;22208;222202;3167017;5062641;1659576
FR;8;2023-01-26;299;386;2225;16494;265;1642;16771;41558;22754;28976;37688;313129;3119435;22473;223844;3183788;5104199;1682330
FR;8;2023-01-27;312;493;2459;17869;298;1841;18105;44184;23814;29288;38181;315588;3137304;22771;225685;3201893;5148383;1706144
FR;8;2023-01-28;125;187;767;4327;124;600;4442;9722;4591;29413;38368;316355;3141631;22895;226285;3206335;5158105;1710735
FR;8;2023-01-29;26;43;86;438;28;67;470;1059;514;29439;38411;316441;3142069;22923;226352;3206805;5159164;1711249
FR;8;2023-01-30;208;316;1230;7977;187;1017;8140;20474;11068;29647;38727;317671;3150046;23110;227369;3214945;5179638;1722317
FR;8;2023-01-31;272;382;1917;13605;235;1420;13840;36258;20707;29919;39109;319588;3163651;23345;228789;3228785;5215896;1743024
FR;8;2023-02-01;247;347;1334;8020;226;1090;8141;21715;12205;30166;39456;320922;3171671;23571;229879;3236926;5237611;1755229
FR;8;2023-02-02;257;385;1573;11467;234;1282;11689;31062;17729;30423;39841;322495;3183138;23805;231161;3248615;5268673;1772958
FR;8;2023-02-03;280;448;1847;12109;286;1437;12291;32953;18844;30703;40289;324342;3195247;24091;232598;3260906;5301626;1791802
FR;8;2023-02-04;118;159;568;2956;110;461;2998;7188;3658;30821;40448;324910;3198203;24201;233059;3263904;5308814;1795460
FR;8;2023-02-05;10;53;66;224;31;61;239;572;264;30831;40501;324976;3198427;24232;233120;3264143;5309386;1795724
FR;8;2023-02-06;187;243;944;5180;171;704;5365;15027;8725;31018;40744;325920;3203607;24403;233824;3269508;5324413;1804449
FR;8;2023-02-07;234;395;1458;9434;269;1184;9589;27600;16418;31252;41139;327378;3213041;24672;235008;3279097;5352013;1820867
FR;8;2023-02-08;173;250;1019;5851;171;808;5993;16567;9485;31425;41389;328397;3218892;24843;235816;3285090;5368580;1830352
FR;8;2023-02-09;235;385;1177;7556;246;985;7737;22242;13192;31660;41774;329574;3226448;25089;236801;3292827;5390822;1843544
FR;8;2023-02-10;277;365;1400;7960;247;1159;8092;23134;13501;31937;42139;330974;3234408;25336;237960;3300919;5413956;1857045
FR;8;2023-02-11;88;145;470;2015;100;402;2092;5228;2665;32025;42284;331444;3236423;25436;238362;3303011;5419184;1859710
FR;8;2023-02-12;27;31;51;166;25;45;187;428;189;32052;42315;331495;3236589;25461;238407;3303198;5419612;1859899
FR;8;2023-02-13;131;206;671;3168;129;607;3263;9302;5295;32183;42521;332166;3239757;25590;239014;3306461;5428914;1865194
FR;8;2023-02-14;192;264;1062;5707;160;891;5854;17116;10073;32375;42785;333228;3245464;25750;239905;3312315;5446030;1875267
FR;8;2023-02-15;164;255;847;3876;146;726;4048;11822;6846;32539;43040;334075;3249340;25896;240631;3316363;5457852;1882113
FR;8;2023-02-16;168;308;1001;4918;175;855;5061;14622;8456;32707;43348;335076;3254258;26071;241486;3321424;5472474;1890569
FR;8;2023-02-17;227;318;1101;5203;224;941;5426;15939;9313;32934;43666;336177;3259461;26295;242427;3326850;5488413;1899882
FR;8;2023-02-18;95;130;395;1492;86;312;1566;3913;1979;33029;43796;336572;3260953;26381;242739;3328416;5492326;1901861
FR;8;2023-02-19;22;36;43;132;31;35;135;333;159;33051;43832;336615;3261085;26412;242774;3328551;5492659;1902020
FR;8;2023-02-20;140;257;639;2680;161;593;2795;8202;4667;33191;44089;337254;3263765;26573;243367;3331346;5500861;1906687
FR;8;2023-02-21;178;307;966;4294;163;840;4497;13574;7960;33369;44396;338220;3268059;26736;244207;3335843;5514435;1914647
FR;8;2023-02-22;157;258;666;2775;174;624;2817;8660;5051;33526;44654;338886;3270834;26910;244831;3338660;5523095;1919698
FR;8;2023-02-23;151;262;826;3787;154;739;3966;11872;6888;33677;44916;339712;3274621;27064;245570;3342626;5534967;1926586
FR;8;2023-02-24;158;311;953;4116;191;829;4305;12438;7065;33835;45227;340665;3278737;27255;246399;3346931;5547405;1933651
FR;8;2023-02-25;58;102;346;1059;69;276;1114;2946;1498;33893;45329;341011;3279796;27324;246675;3348045;5550351;1935149
FR;8;2023-02-26;14;21;31;95;22;28;108;251;108;33907;45350;341042;3279891;27346;246703;3348153;5550602;1935257
FR;8;2023-02-27;92;223;506;1829;154;481;1900;6244;3726;33999;45573;341548;3281720;27500;247184;3350053;5556846;1938983
FR;8;2023-02-28;158;258;759;3348;154;717;3481;11648;7145;34157;45831;342307;3285068;27654;247901;3353534;5568494;1946128
FR;8;2023-03-01;130;195;523;1831;145;460;1984;6239;3648;34287;46026;342830;3286899;27799;248361;3355518;5574733;1949776
FR;8;2023-03-02;131;220;715;2764;135;607;2956;9696;5903;34418;46246;343545;3289663;27934;248968;3358474;5584429;1955679
FR;8;2023-03-03;182;331;897;3417;220;794;3546;11313;6659;34600;46577;344442;3293080;28154;249762;3362020;5595742;1962338
FR;8;2023-03-04;58;137;311;975;83;295;981;2632;1296;34658;46714;344753;3294055;28237;250057;3363001;5598374;1963634
FR;8;2023-03-05;12;20;22;49;16;26;49;185;99;34670;46734;344775;3294104;28253;250083;3363050;5598559;1963733
FR;8;2023-03-06;120;178;414;1309;103;394;1370;4426;2524;34790;46912;345189;3295413;28356;250477;3364420;5602985;1966257
FR;8;2023-03-07;122;212;570;2160;128;525;2238;7558;4576;34912;47124;345759;3297573;28484;251002;3366658;5610543;1970833
FR;8;2023-03-08;93;182;450;1344;114;401;1432;4735;2749;35005;47306;346209;3298917;28598;251403;3368090;5615278;1973582
FR;8;2023-03-09;121;202;559;1876;123;525;1939;6840;4203;35126;47508;346768;3300793;28721;251928;3370029;5622118;1977785
FR;8;2023-03-10;202;336;773;2426;215;699;2566;8579;5074;35328;47844;347541;3303219;28936;252627;3372595;5630697;1982859
FR;8;2023-03-11;54;115;271;734;79;236;768;2152;1096;35382;47959;347812;3303953;29015;252863;3373363;5632849;1983955
FR;8;2023-03-12;6;10;23;60;8;22;61;172;85;35388;47969;347835;3304013;29023;252885;3373424;5633021;1984040
FR;8;2023-03-13;81;138;385;991;89;344;1068;3432;1930;35469;48107;348220;3305004;29112;253229;3374492;5636453;1985970
FR;8;2023-03-14;110;212;561;1741;126;544;1816;6400;3833;35579;48319;348781;3306745;29238;253773;3376308;5642853;1989803
FR;8;2023-03-15;105;166;408;1101;117;371;1175;4069;2375;35684;48485;349189;3307846;29355;254144;3377483;5646922;1992178
FR;8;2023-03-16;99;192;505;1498;124;462;1583;5579;3339;35783;48677;349694;3309344;29479;254606;3379066;5652501;1995517
FR;8;2023-03-17;141;222;646;1837;136;563;1984;6838;4046;35924;48899;350340;3311181;29615;255169;3381050;5659339;1999563
FR;8;2023-03-18;75;111;272;528;70;258;587;1850;944;35999;49010;350612;3311709;29685;255427;3381637;5661189;2000507
FR;8;2023-03-19;3;15;24;45;15;12;52;116;49;36002;49025;350636;3311754;29700;255439;3381689;5661305;2000556
FR;8;2023-03-20;85;171;405;923;95;402;1005;3514;1976;36087;49196;351041;3312677;29795;255841;3382694;5664819;2002532
FR;8;2023-03-21;126;202;570;1510;119;547;1681;6109;3635;36213;49398;351611;3314187;29914;256388;3384375;5670928;2006167
FR;8;2023-03-22;119;158;396;936;106;370;1050;3636;2090;36332;49556;352007;3315123;30020;256758;3385425;5674564;2008257
FR;8;2023-03-23;89;161;515;1284;90;458;1371;4885;2847;36421;49717;352522;3316407;30110;257216;3386796;5679449;2011104
FR;8;2023-03-24;145;265;696;1618;158;635;1789;6233;3553;36566;49982;353218;3318025;30268;257851;3388585;5685682;2014657
FR;8;2023-03-25;60;94;274;491;71;240;545;1616;760;36626;50076;353492;3318516;30339;258091;3389130;5687298;2015417
FR;8;2023-03-26;6;9;16;30;8;13;30;83;38;36632;50085;353508;3318546;30347;258104;3389160;5687381;2015455
FR;8;2023-03-27;111;171;407;789;125;386;877;3126;1741;36743;50256;353915;3319335;30472;258490;3390037;5690507;2017196
FR;8;2023-03-28;110;179;529;1454;96;487;1587;5803;3446;36853;50435;354444;3320789;30568;258977;3391624;5696310;2020642
FR;8;2023-03-29;90;168;371;891;87;363;1028;3547;1968;36943;50603;354815;3321680;30655;259340;3392652;5699857;2022610
FR;8;2023-03-30;102;172;486;1254;88;480;1398;5069;2893;37045;50775;355301;3322934;30743;259820;3394050;5704926;2025503
FR;8;2023-03-31;129;248;641;1623;166;559;1764;6387;3699;37174;51023;355942;3324557;30909;260379;3395814;5711313;2029202
FR;8;2023-04-01;58;106;283;537;52;242;625;1831;870;37232;51129;356225;3325094;30961;260621;3396439;5713144;2030072
FR;8;2023-04-02;5;21;20;35;12;26;36;106;44;37237;51150;356245;3325129;30973;260647;3396475;5713250;2030116
FR;8;2023-04-03;77;141;362;738;92;333;834;2947;1611;37314;51291;356607;3325867;31065;260980;3397309;5716197;2031727
FR;8;2023-04-04;77;180;465;1110;119;392;1263;4926;2905;37391;51471;357072;3326977;31184;261372;3398572;5721123;2034632
FR;8;2023-04-05;69;134;347;734;85;333;822;3171;1807;37460;51605;357419;3327711;31269;261705;3399394;5724294;2036439
FR;8;2023-04-06;92;119;368;955;75;334;1063;3944;2248;37552;51724;357787;3328666;31344;262039;3400457;5728238;2038687
FR;8;2023-04-07;120;215;490;1163;131;452;1284;4646;2588;37672;51939;358277;3329829;31475;262491;3401741;5732884;2041275
FR;8;2023-04-08;33;93;211;347;57;206;382;1217;538;37705;52032;358488;3330176;31532;262697;3402123;5734101;2041813
FR;8;2023-04-09;4;16;16;12;9;19;16;55;15;37709;52048;358504;3330188;31541;262716;3402139;5734156;2041828
FR;8;2023-04-10;6;13;26;27;6;26;36;91;25;37715;52061;358530;3330215;31547;262742;3402175;5734247;2041853
FR;8;2023-04-11;73;174;463;886;91;457;987;4031;2217;37788;52235;358993;3331101;31638;263199;3403162;5738278;2044070
FR;8;2023-04-12;80;144;319;664;98;311;725;2989;1671;37868;52379;359312;3331765;31736;263510;3403887;5741267;2045741
FR;8;2023-04-13;67;166;360;870;100;350;955;3986;2287;37935;52545;359672;3332635;31836;263860;3404842;5745253;2048028
FR;8;2023-04-14;120;193;471;1116;129;423;1190;4839;2791;38055;52738;360143;3333751;31965;264283;3406032;5750092;2050819
FR;8;2023-04-15;36;81;197;367;42;196;394;1369;628;38091;52819;360340;3334118;32007;264479;3406426;5751461;2051447
FR;8;2023-04-16;14;14;12;34;11;16;30;107;46;38105;52833;360352;3334152;32018;264495;3406456;5751568;2051493
FR;8;2023-04-17;59;136;290;608;72;302;706;2837;1500;38164;52969;360642;3334760;32090;264797;3407162;5754405;2052993
FR;8;2023-04-18;96;136;353;799;85;357;892;3879;2194;38260;53105;360995;3335559;32175;265154;3408054;5758284;2055187
FR;8;2023-04-19;59;93;264;552;61;240;644;2604;1369;38319;53198;361259;3336111;32236;265394;3408698;5760888;2056556
FR;8;2023-04-20;66;138;292;735;86;285;786;3226;1755;38385;53336;361551;3336846;32322;265679;3409484;5764114;2058311
FR;8;2023-04-21;85;178;390;898;97;389;1015;4021;2123;38470;53514;361941;3337744;32419;266068;3410499;5768135;2060434
FR;8;2023-04-22;27;69;135;234;42;146;257;1017;496;38497;53583;362076;3337978;32461;266214;3410756;5769152;2060930
FR;8;2023-04-23;2;5;12;18;4;12;21;71;30;38499;53588;362088;3337996;32465;266226;3410777;5769223;2060960
FR;8;2023-04-24;70;115;247;489;68;231;568;2227;1127;38569;53703;362335;3338485;32533;266457;3411345;5771450;2062087
FR;8;2023-04-25;81;133;323;749;84;334;798;3765;2034;38650;53836;362658;3339234;32617;266791;3412143;5775215;2064121
FR;8;2023-04-26;56;98;246;452;76;238;516;2369;1215;38706;53934;362904;3339686;32693;267029;3412659;5777584;2065336
FR;8;2023-04-27;88;117;287;710;70;294;803;3455;1826;38794;54051;363191;3340396;32763;267323;3413462;5781039;2067162
FR;8;2023-04-28;110;195;363;769;101;382;878;3965;1993;38904;54246;363554;3341165;32864;267705;3414340;5785004;2069155
FR;8;2023-04-29;51;59;127;237;42;118;276;1003;459;38955;54305;363681;3341402;32906;267823;3414616;5786007;2069614
FR;8;2023-04-30;1;7;10;10;3;9;11;63;34;38956;54312;363691;3341412;32909;267832;3414627;5786070;2069648
FR;8;2023-05-01;15;6;13;10;4;13;13;62;21;38971;54318;363704;3341422;32913;267845;3414640;5786132;2069669
FR;8;2023-05-02;92;148;313;578;91;307;682;3258;1669;39063;54466;364017;3342000;33004;268152;3415322;5789390;2071338
FR;8;2023-05-03;77;94;218;429;66;217;475;2522;1272;39140;54560;364235;3342429;33070;268369;3415797;5791912;2072610
FR;8;2023-05-04;67;121;264;674;82;320;703;3770;1929;39207;54681;364499;3343103;33152;268689;3416500;5795682;2074539
FR;8;2023-05-05;91;156;306;723;89;348;803;4144;2169;39298;54837;364805;3343826;33241;269037;3417303;5799826;2076708
FR;8;2023-05-06;53;56;108;227;39;122;238;1063;493;39351;54893;364913;3344053;33280;269159;3417541;5800889;2077201
FR;8;2023-05-07;4;5;7;17;3;7;19;84;31;39355;54898;364920;3344070;33283;269166;3417560;5800973;2077232
FR;8;2023-05-08;12;9;15;17;7;17;36;123;61;39367;54907;364935;3344087;33290;269183;3417596;5801096;2077293
FR;8;2023-05-09;66;94;205;496;68;216;551;3212;1600;39433;55001;365140;3344583;33358;269399;3418147;5804308;2078893
FR;8;2023-05-10;65;91;179;473;66;218;513;3075;1449;39498;55092;365319;3345056;33424;269617;3418660;5807383;2080342
FR;8;2023-05-11;63;80;205;606;59;193;682;3763;1842;39561;55172;365524;3345662;33483;269810;3419342;5811146;2082184
FR;8;2023-05-12;72;94;235;698;64;240;734;4176;1965;39633;55266;365759;3346360;33547;270050;3420076;5815322;2084149
FR;8;2023-05-13;29;46;100;190;29;108;208;935;384;39662;55312;365859;3346550;33576;270158;3420284;5816257;2084533
FR;8;2023-05-14;3;12;7;14;7;11;15;82;29;39665;55324;365866;3346564;33583;270169;3420299;5816339;2084562
FR;8;2023-05-15;41;66;157;440;40;147;482;3143;1484;39706;55390;366023;3347004;33623;270316;3420781;5819482;2086046
FR;8;2023-05-16;65;117;203;795;79;218;937;5745;2691;39771;55507;366226;3347799;33702;270534;3421718;5825227;2088737
FR;8;2023-05-17;64;78;189;472;44;189;536;3088;1356;39835;55585;366415;3348271;33746;270723;3422254;5828315;2090093
FR;8;2023-05-18;3;5;9;26;3;11;32;168;65;39838;55590;366424;3348297;33749;270734;3422286;5828483;2090158
FR;8;2023-05-19;56;99;175;451;64;171;506;2752;1178;39894;55689;366599;3348748;33813;270905;3422792;5831235;2091336
FR;8;2023-05-20;32;31;92;115;21;85;128;787;303;39926;55720;366691;3348863;33834;270990;3422920;5832022;2091639
FR;8;2023-05-21;5;6;5;14;7;5;15;142;43;39931;55726;366696;3348877;33841;270995;3422935;5832164;2091682
FR;8;2023-05-22;44;42;135;446;34;134;502;3083;1379;39975;55768;366831;3349323;33875;271129;3423437;5835247;2093061
FR;8;2023-05-23;34;58;169;595;42;156;731;4606;2099;40009;55826;367000;3349918;33917;271285;3424168;5839853;2095160
FR;8;2023-05-24;43;53;162;487;37;157;563;3227;1435;40052;55879;367162;3350405;33954;271442;3424731;5843080;2096595
FR;8;2023-05-25;56;68;160;550;52;152;628;4527;2011;40108;55947;367322;3350955;34006;271594;3425359;5847607;2098606
FR;8;2023-05-26;58;100;185;608;67;189;665;4540;2079;40166;56047;367507;3351563;34073;271783;3426024;5852147;2100685
FR;8;2023-05-27;20;44;66;128;25;70;151;815;380;40186;56091;367573;3351691;34098;271853;3426175;5852962;2101065
FR;8;2023-05-28;2;1;3;8;2;2;14;70;34;40188;56092;367576;3351699;34100;271855;3426189;5853032;2101099
FR;8;2023-05-29;5;3;7;33;2;8;44;308;122;40193;56095;367583;3351732;34102;271863;3426233;5853340;2101221
FR;8;2023-05-30;46;74;135;594;47;151;744;4547;1869;40239;56169;367718;3352326;34149;272014;3426977;5857887;2103090
FR;8;2023-05-31;42;75;112;476;48;125;550;3422;1532;40281;56244;367830;3352802;34197;272139;3427527;5861309;2104622
FR;8;2023-06-01;62;71;149;550;49;161;646;4575;1860;40343;56315;367979;3353352;34246;272300;3428173;5865884;2106482
FR;8;2023-06-02;54;93;181;594;57;197;698;4974;2201;40397;56408;368160;3353946;34303;272497;3428871;5870858;2108683
FR;8;2023-06-03;17;38;64;143;20;69;158;974;383;40414;56446;368224;3354089;34323;272566;3429029;5871832;2109066
FR;8;2023-06-04;2;5;5;11;2;8;14;110;30;40416;56451;368229;3354100;34325;272574;3429043;5871942;2109096
FR;8;2023-06-05;51;73;150;531;53;179;618;4166;1687;40467;56524;368379;3354631;34378;272753;3429661;5876108;2110783
FR;8;2023-06-06;69;98;216;778;78;250;882;7025;2949;40536;56622;368595;3355409;34456;273003;3430543;5883133;2113732
FR;8;2023-06-07;43;72;139;544;49;129;587;3969;1667;40579;56694;368734;3355953;34505;273132;3431130;5887102;2115399
FR;8;2023-06-08;52;72;181;735;55;190;835;6191;2573;40631;56766;368915;3356688;34560;273322;3431965;5893293;2117972
FR;8;2023-06-09;48;96;178;572;75;179;625;4988;2064;40679;56862;369093;3357260;34635;273501;3432590;5898281;2120036
FR;8;2023-06-10;18;31;53;129;22;52;150;907;344;40697;56893;369146;3357389;34657;273553;3432740;5899188;2120380
FR;8;2023-06-11;1;7;4;15;6;6;18;143;59;40698;56900;369150;3357404;34663;273559;3432758;5899331;2120439
FR;8;2023-06-12;34;86;161;581;67;160;635;4860;2016;40732;56986;369311;3357985;34730;273719;3433393;5904191;2122455
FR;8;2023-06-13;54;58;224;816;47;195;934;6989;2934;40786;57044;369535;3358801;34777;273914;3434327;5911180;2125389
FR;8;2023-06-14;39;75;129;544;58;146;607;4565;2012;40825;57119;369664;3359345;34835;274060;3434934;5915745;2127401
FR;8;2023-06-15;49;58;182;737;44;188;843;6314;2778;40874;57177;369846;3360082;34879;274248;3435777;5922059;2130179
FR;8;2023-06-16;58;72;178;753;58;150;766;5824;2496;40932;57249;370024;3360835;34937;274398;3436543;5927883;2132675
FR;8;2023-06-17;12;27;43;91;18;50;111;834;305;40944;57276;370067;3360926;34955;274448;3436654;5928717;2132980
FR;8;2023-06-18;2;6;6;29;6;8;27;217;95;40946;57282;370073;3360955;34961;274456;3436681;5928934;2133075
FR;8;2023-06-19;40;45;145;476;31;153;587;4189;1651;40986;57327;370218;3361431;34992;274609;3437268;5933123;2134726
FR;8;2023-06-20;64;44;179;699;37;200;724;6116;2671;41050;57371;370397;3362130;35029;274809;3437992;5939239;2137397
FR;8;2023-06-21;30;44;133;582;37;188;712;4292;1737;41080;57415;370530;3362712;35066;274997;3438704;5943531;2139134
FR;8;2023-06-22;40;44;159;631;31;193;728;4761;1839;41120;57459;370689;3363343;35097;275190;3439432;5948292;2140973
FR;8;2023-06-23;62;73;140;606;52;141;730;4945;1853;41182;57532;370829;3363949;35149;275331;3440162;5953237;2142826
FR;8;2023-06-24;5;14;43;86;8;45;103;753;243;41187;57546;370872;3364035;35157;275376;3440265;5953990;2143069
FR;8;2023-06-25;2;5;9;12;3;8;13;99;41;41189;57551;370881;3364047;35160;275384;3440278;5954089;2143110
FR;8;2023-06-26;31;38;145;330;28;141;390;2733;1065;41220;57589;371026;3364377;35188;275525;3440668;5956822;2144175
FR;8;2023-06-27;54;47;154;594;34;145;622;4503;1741;41274;57636;371180;3364971;35222;275670;3441290;5961325;2145916
FR;8;2023-06-28;33;35;126;426;28;104;449;2963;1263;41307;57671;371306;3365397;35250;275774;3441739;5964288;2147179
FR;8;2023-06-29;26;48;111;393;32;122;428;3704;1481;41333;57719;371417;3365790;35282;275896;3442167;5967992;2148660
FR;8;2023-06-30;30;49;112;430;31;125;437;3825;1395;41363;57768;371529;3366220;35313;276021;3442604;5971817;2150055
FR;8;2023-07-01;19;24;41;80;20;38;105;793;306;41382;57792;371570;3366300;35333;276059;3442709;5972610;2150361
FR;8;2023-07-02;0;0;1;8;0;2;7;45;24;41382;57792;371571;3366308;35333;276061;3442716;5972655;2150385
FR;8;2023-07-03;33;34;124;222;33;123;230;1926;671;41415;57826;371695;3366530;35366;276184;3442946;5974581;2151056
FR;8;2023-07-04;34;42;107;358;34;120;371;2891;1125;41449;57868;371802;3366888;35400;276304;3443317;5977472;2152181
FR;8;2023-07-05;37;33;95;311;29;93;379;2377;943;41486;57901;371897;3367199;35429;276397;3443696;5979849;2153124
FR;8;2023-07-06;33;31;103;402;22;127;482;2740;997;41519;57932;372000;3367601;35451;276524;3444178;5982589;2154121
FR;8;2023-07-07;44;51;120;325;42;123;365;2656;921;41563;57983;372120;3367926;35493;276647;3444543;5985245;2155042
FR;8;2023-07-08;11;20;46;67;12;47;80;491;158;41574;58003;372166;3367993;35505;276694;3444623;5985736;2155200
FR;8;2023-07-09;0;3;2;6;2;1;7;40;17;41574;58006;372168;3367999;35507;276695;3444630;5985776;2155217
FR;8;2023-07-10;14;16;73;136;11;78;155;1314;431;41588;58022;372241;3368135;35518;276773;3444785;5987090;2155648
FR;9;2020-12-27;0;0;0;0;0;0;0;0;0;0;0;0;0;0;0;0;0;0
FR;9;2020-12-28;0;0;0;0;0;0;0;0;0;0;0;0;0;0;0;0;0;0
FR;9;2020-12-29;0;0;0;0;0;0;0;0;0;0;0;0;0;0;0;0;0;0
FR;9;2020-12-30;0;0;0;0;0;0;0;0;0;0;0;0;0;0;0;0;0;0
FR;9;2020-12-31;0;0;0;0;0;0;0;0;0;0;0;0;0;0;0;0;0;0
FR;9;2021-01-01;0;0;0;0;0;0;0;0;0;0;0;0;0;0;0;0;0;0
FR;9;2021-01-02;0;0;0;0;0;0;0;0;0;0;0;0;0;0;0;0;0;0
FR;9;2021-01-03;0;0;0;0;0;0;0;0;0;0;0;0;0;0;0;0;0;0
FR;9;2021-01-04;0;0;0;0;0;0;0;0;0;0;0;0;0;0;0;0;0;0
FR;9;2021-01-05;0;0;0;0;0;0;0;0;0;0;0;0;0;0;0;0;0;0
FR;9;2021-01-06;0;0;0;0;0;0;0;0;0;0;0;0;0;0;0;0;0;0
FR;9;2021-01-07;0;0;0;0;0;0;0;0;0;0;0;0;0;0;0;0;0;0
FR;9;2021-01-08;0;0;0;0;0;0;0;0;0;0;0;0;0;0;0;0;0;0
FR;9;2021-01-09;0;0;0;0;0;0;0;0;0;0;0;0;0;0;0;0;0;0
FR;9;2021-01-10;0;0;0;0;0;0;0;0;0;0;0;0;0;0;0;0;0;0
FR;9;2021-01-11;0;0;0;0;0;0;0;0;0;0;0;0;0;0;0;0;0;0
FR;9;2021-01-12;0;0;0;0;0;0;0;0;0;0;0;0;0;0;0;0;0;0
FR;9;2021-01-13;0;0;0;0;0;0;0;0;0;0;0;0;0;0;0;0;0;0
FR;9;2021-01-14;0;0;0;0;0;0;0;0;0;0;0;0;0;0;0;0;0;0
FR;9;2021-01-15;0;0;0;0;0;0;0;0;0;0;0;0;0;0;0;0;0;0
FR;9;2021-01-16;0;0;0;0;0;0;0;0;0;0;0;0;0;0;0;0;0;0
FR;9;2021-01-17;0;0;0;0;0;0;0;0;0;0;0;0;0;0;0;0;0;0
FR;9;2021-01-18;0;0;0;0;0;0;0;0;0;0;0;0;0;0;0;0;0;0
FR;9;2021-01-19;0;0;0;0;0;0;0;0;0;0;0;0;0;0;0;0;0;0
FR;9;2021-01-20;0;0;0;0;0;0;0;0;0;0;0;0;0;0;0;0;0;0
FR;9;2021-01-21;0;0;0;0;0;0;0;0;0;0;0;0;0;0;0;0;0;0
FR;9;2021-01-22;0;0;0;0;0;0;0;0;0;0;0;0;0;0;0;0;0;0
FR;9;2021-01-23;0;0;0;0;0;0;0;0;0;0;0;0;0;0;0;0;0;0
FR;9;2021-01-24;0;0;0;0;0;0;0;0;0;0;0;0;0;0;0;0;0;0
FR;9;2021-01-25;0;0;0;0;0;0;0;0;0;0;0;0;0;0;0;0;0;0
FR;9;2021-01-26;0;0;0;0;0;0;0;0;0;0;0;0;0;0;0;0;0;0
FR;9;2021-01-27;0;0;0;0;0;0;0;0;0;0;0;0;0;0;0;0;0;0
FR;9;2021-01-28;0;0;0;0;0;0;0;0;0;0;0;0;0;0;0;0;0;0
FR;9;2021-01-29;0;0;0;0;0;0;0;0;0;0;0;0;0;0;0;0;0;0
FR;9;2021-01-30;0;0;0;0;0;0;0;0;0;0;0;0;0;0;0;0;0;0
FR;9;2021-01-31;0;0;0;0;0;0;0;0;0;0;0;0;0;0;0;0;0;0
FR;9;2021-02-01;0;0;0;0;0;0;0;0;0;0;0;0;0;0;0;0;0;0
FR;9;2021-02-02;0;0;0;0;0;0;0;0;0;0;0;0;0;0;0;0;0;0
FR;9;2021-02-03;0;0;0;0;0;0;0;0;0;0;0;0;0;0;0;0;0;0
FR;9;2021-02-04;0;0;0;0;0;0;0;0;0;0;0;0;0;0;0;0;0;0
FR;9;2021-02-05;0;0;0;0;0;0;0;0;0;0;0;0;0;0;0;0;0;0
FR;9;2021-02-06;0;0;0;0;0;0;0;0;0;0;0;0;0;0;0;0;0;0
FR;9;2021-02-07;0;0;0;0;0;0;0;0;0;0;0;0;0;0;0;0;0;0
FR;9;2021-02-08;0;0;0;0;0;0;0;0;0;0;0;0;0;0;0;0;0;0
FR;9;2021-02-09;0;0;0;0;0;0;0;0;0;0;0;0;0;0;0;0;0;0
FR;9;2021-02-10;0;0;0;0;0;0;0;0;0;0;0;0;0;0;0;0;0;0
FR;9;2021-02-11;0;0;0;0;0;0;0;0;0;0;0;0;0;0;0;0;0;0
FR;9;2021-02-12;0;0;0;0;0;0;0;0;0;0;0;0;0;0;0;0;0;0
FR;9;2021-02-13;0;0;0;0;0;0;0;0;0;0;0;0;0;0;0;0;0;0
FR;9;2021-02-14;0;0;0;0;0;0;0;0;0;0;0;0;0;0;0;0;0;0
FR;9;2021-02-15;0;0;0;0;0;0;0;0;0;0;0;0;0;0;0;0;0;0
FR;9;2021-02-16;0;0;0;0;0;0;0;0;0;0;0;0;0;0;0;0;0;0
FR;9;2021-02-17;0;0;0;0;0;0;0;0;0;0;0;0;0;0;0;0;0;0
FR;9;2021-02-18;0;0;0;0;0;0;0;0;0;0;0;0;0;0;0;0;0;0
FR;9;2021-02-19;0;0;0;0;0;0;0;0;0;0;0;0;0;0;0;0;0;0
FR;9;2021-02-20;0;0;0;0;0;0;0;0;0;0;0;0;0;0;0;0;0;0
FR;9;2021-02-21;0;0;0;0;0;0;0;0;0;0;0;0;0;0;0;0;0;0
FR;9;2021-02-22;0;0;0;0;0;0;0;0;0;0;0;0;0;0;0;0;0;0
FR;9;2021-02-23;0;0;0;0;0;0;0;0;0;0;0;0;0;0;0;0;0;0
FR;9;2021-02-24;0;0;0;0;0;0;0;0;0;0;0;0;0;0;0;0;0;0
FR;9;2021-02-25;0;0;0;0;0;0;0;0;0;0;0;0;0;0;0;0;0;0
FR;9;2021-02-26;0;0;0;0;0;0;0;0;0;0;0;0;0;0;0;0;0;0
FR;9;2021-02-27;0;0;0;0;0;0;0;0;0;0;0;0;0;0;0;0;0;0
FR;9;2021-02-28;0;0;0;0;0;0;0;0;0;0;0;0;0;0;0;0;0;0
FR;9;2021-03-01;0;0;0;0;0;0;0;0;0;0;0;0;0;0;0;0;0;0
FR;9;2021-03-02;0;0;0;0;0;0;0;0;0;0;0;0;0;0;0;0;0;0
FR;9;2021-03-03;0;0;0;0;0;0;0;0;0;0;0;0;0;0;0;0;0;0
FR;9;2021-03-04;0;0;0;0;0;0;0;0;0;0;0;0;0;0;0;0;0;0
FR;9;2021-03-05;0;0;0;0;0;0;0;0;0;0;0;0;0;0;0;0;0;0
FR;9;2021-03-06;0;0;0;0;0;0;0;0;0;0;0;0;0;0;0;0;0;0
FR;9;2021-03-07;0;0;0;0;0;0;0;0;0;0;0;0;0;0;0;0;0;0
FR;9;2021-03-08;0;0;0;0;0;0;0;0;0;0;0;0;0;0;0;0;0;0
FR;9;2021-03-09;0;0;0;0;0;0;0;0;0;0;0;0;0;0;0;0;0;0
FR;9;2021-03-10;0;0;0;0;0;0;0;0;0;0;0;0;0;0;0;0;0;0
FR;9;2021-03-11;0;0;0;0;0;0;0;0;0;0;0;0;0;0;0;0;0;0
FR;9;2021-03-12;0;0;0;0;0;0;0;0;0;0;0;0;0;0;0;0;0;0
FR;9;2021-03-13;0;0;0;0;0;0;0;0;0;0;0;0;0;0;0;0;0;0
FR;9;2021-03-14;0;0;0;0;0;0;0;0;0;0;0;0;0;0;0;0;0;0
FR;9;2021-03-15;0;0;0;0;0;0;0;0;0;0;0;0;0;0;0;0;0;0
FR;9;2021-03-16;0;0;0;0;0;0;0;0;0;0;0;0;0;0;0;0;0;0
FR;9;2021-03-17;0;0;0;0;0;0;0;0;0;0;0;0;0;0;0;0;0;0
FR;9;2021-03-18;0;0;0;0;0;0;0;0;0;0;0;0;0;0;0;0;0;0
FR;9;2021-03-19;0;0;0;0;0;0;0;0;0;0;0;0;0;0;0;0;0;0
FR;9;2021-03-20;0;0;0;0;0;0;0;0;0;0;0;0;0;0;0;0;0;0
FR;9;2021-03-21;0;0;0;0;0;0;0;0;0;0;0;0;0;0;0;0;0;0
FR;9;2021-03-22;0;0;0;0;0;0;0;0;0;0;0;0;0;0;0;0;0;0
FR;9;2021-03-23;0;0;0;0;0;0;0;0;0;0;0;0;0;0;0;0;0;0
FR;9;2021-03-24;0;0;0;0;0;0;0;0;0;0;0;0;0;0;0;0;0;0
FR;9;2021-03-25;0;0;0;0;0;0;0;0;0;0;0;0;0;0;0;0;0;0
FR;9;2021-03-26;0;0;0;0;0;0;0;0;0;0;0;0;0;0;0;0;0;0
FR;9;2021-03-27;0;0;0;0;0;0;0;0;0;0;0;0;0;0;0;0;0;0
FR;9;2021-03-28;0;0;0;0;0;0;0;0;0;0;0;0;0;0;0;0;0;0
FR;9;2021-03-29;0;0;0;0;0;0;0;0;0;0;0;0;0;0;0;0;0;0
FR;9;2021-03-30;0;0;0;0;0;0;0;0;0;0;0;0;0;0;0;0;0;0
FR;9;2021-03-31;0;0;0;0;0;0;0;0;0;0;0;0;0;0;0;0;0;0
FR;9;2021-04-01;0;0;0;0;0;0;0;0;0;0;0;0;0;0;0;0;0;0
FR;9;2021-04-02;0;0;0;0;0;0;0;0;0;0;0;0;0;0;0;0;0;0
FR;9;2021-04-03;0;0;0;0;0;0;0;0;0;0;0;0;0;0;0;0;0;0
FR;9;2021-04-04;0;0;0;0;0;0;0;0;0;0;0;0;0;0;0;0;0;0
FR;9;2021-04-05;0;0;0;0;0;0;0;0;0;0;0;0;0;0;0;0;0;0
FR;9;2021-04-06;0;0;0;0;0;0;0;0;0;0;0;0;0;0;0;0;0;0
FR;9;2021-04-07;0;0;0;0;0;0;0;0;0;0;0;0;0;0;0;0;0;0
FR;9;2021-04-08;0;0;0;0;0;0;0;0;0;0;0;0;0;0;0;0;0;0
FR;9;2021-04-09;0;0;0;0;0;0;0;0;0;0;0;0;0;0;0;0;0;0
FR;9;2021-04-10;0;0;0;0;0;0;0;0;0;0;0;0;0;0;0;0;0;0
FR;9;2021-04-11;0;0;0;0;0;0;0;0;0;0;0;0;0;0;0;0;0;0
FR;9;2021-04-12;0;0;0;0;0;0;0;0;0;0;0;0;0;0;0;0;0;0
FR;9;2021-04-13;0;0;0;0;0;0;0;0;0;0;0;0;0;0;0;0;0;0
FR;9;2021-04-14;0;0;0;0;0;0;0;0;0;0;0;0;0;0;0;0;0;0
FR;9;2021-04-15;0;0;0;0;0;0;0;0;0;0;0;0;0;0;0;0;0;0
FR;9;2021-04-16;0;0;0;0;0;0;0;0;0;0;0;0;0;0;0;0;0;0
FR;9;2021-04-17;0;0;0;0;0;0;0;0;0;0;0;0;0;0;0;0;0;0
FR;9;2021-04-18;0;0;0;0;0;0;0;0;0;0;0;0;0;0;0;0;0;0
FR;9;2021-04-19;0;0;0;0;0;0;0;0;0;0;0;0;0;0;0;0;0;0
FR;9;2021-04-20;0;0;0;0;0;0;0;0;0;0;0;0;0;0;0;0;0;0
FR;9;2021-04-21;0;0;0;0;0;0;0;0;0;0;0;0;0;0;0;0;0;0
FR;9;2021-04-22;0;0;0;0;0;0;0;0;0;0;0;0;0;0;0;0;0;0
FR;9;2021-04-23;0;0;0;0;0;0;0;0;0;0;0;0;0;0;0;0;0;0
FR;9;2021-04-24;0;0;0;0;0;0;0;0;0;0;0;0;0;0;0;0;0;0
FR;9;2021-04-25;0;0;0;0;0;0;0;0;0;0;0;0;0;0;0;0;0;0
FR;9;2021-04-26;0;0;0;0;0;0;0;0;0;0;0;0;0;0;0;0;0;0
FR;9;2021-04-27;0;0;0;0;0;0;0;0;0;0;0;0;0;0;0;0;0;0
FR;9;2021-04-28;0;0;0;0;0;0;0;0;0;0;0;0;0;0;0;0;0;0
FR;9;2021-04-29;0;0;0;0;0;0;0;0;0;0;0;0;0;0;0;0;0;0
FR;9;2021-04-30;0;0;0;0;0;0;0;0;0;0;0;0;0;0;0;0;0;0
FR;9;2021-05-01;0;0;0;0;0;0;0;0;0;0;0;0;0;0;0;0;0;0
FR;9;2021-05-02;0;0;0;0;0;0;0;0;0;0;0;0;0;0;0;0;0;0
FR;9;2021-05-03;0;0;0;0;0;0;0;0;0;0;0;0;0;0;0;0;0;0
FR;9;2021-05-04;0;0;0;0;0;0;0;0;0;0;0;0;0;0;0;0;0;0
FR;9;2021-05-05;0;0;0;0;0;0;0;0;0;0;0;0;0;0;0;0;0;0
FR;9;2021-05-06;0;0;0;0;0;0;0;0;0;0;0;0;0;0;0;0;0;0
FR;9;2021-05-07;0;0;0;0;0;0;0;0;0;0;0;0;0;0;0;0;0;0
FR;9;2021-05-08;0;0;0;0;0;0;0;0;0;0;0;0;0;0;0;0;0;0
FR;9;2021-05-09;0;0;0;0;0;0;0;0;0;0;0;0;0;0;0;0;0;0
FR;9;2021-05-10;0;0;0;0;0;0;0;0;0;0;0;0;0;0;0;0;0;0
FR;9;2021-05-11;0;0;0;0;0;0;0;0;0;0;0;0;0;0;0;0;0;0
FR;9;2021-05-12;0;0;0;0;0;0;0;0;0;0;0;0;0;0;0;0;0;0
FR;9;2021-05-13;0;0;0;0;0;0;0;0;0;0;0;0;0;0;0;0;0;0
FR;9;2021-05-14;0;0;0;0;0;0;0;0;0;0;0;0;0;0;0;0;0;0
FR;9;2021-05-15;0;0;0;0;0;0;0;0;0;0;0;0;0;0;0;0;0;0
FR;9;2021-05-16;0;0;0;0;0;0;0;0;0;0;0;0;0;0;0;0;0;0
FR;9;2021-05-17;0;0;0;0;0;0;0;0;0;0;0;0;0;0;0;0;0;0
FR;9;2021-05-18;0;0;0;0;0;0;0;0;0;0;0;0;0;0;0;0;0;0
FR;9;2021-05-19;0;0;0;0;0;0;0;0;0;0;0;0;0;0;0;0;0;0
FR;9;2021-05-20;0;0;0;0;0;0;0;0;0;0;0;0;0;0;0;0;0;0
FR;9;2021-05-21;0;0;0;0;0;0;0;0;0;0;0;0;0;0;0;0;0;0
FR;9;2021-05-22;0;0;0;0;0;0;0;0;0;0;0;0;0;0;0;0;0;0
FR;9;2021-05-23;0;0;0;0;0;0;0;0;0;0;0;0;0;0;0;0;0;0
FR;9;2021-05-24;0;0;0;0;0;0;0;0;0;0;0;0;0;0;0;0;0;0
FR;9;2021-05-25;0;0;0;0;0;0;0;0;0;0;0;0;0;0;0;0;0;0
FR;9;2021-05-26;0;0;0;0;0;0;0;0;0;0;0;0;0;0;0;0;0;0
FR;9;2021-05-27;0;0;0;0;0;0;0;0;0;0;0;0;0;0;0;0;0;0
FR;9;2021-05-28;0;0;0;0;0;0;0;0;0;0;0;0;0;0;0;0;0;0
FR;9;2021-05-29;0;0;0;0;0;0;0;0;0;0;0;0;0;0;0;0;0;0
FR;9;2021-05-30;0;0;0;0;0;0;0;0;0;0;0;0;0;0;0;0;0;0
FR;9;2021-05-31;0;0;0;0;0;0;0;0;0;0;0;0;0;0;0;0;0;0
FR;9;2021-06-01;0;0;0;0;0;0;0;0;0;0;0;0;0;0;0;0;0;0
FR;9;2021-06-02;0;0;0;0;0;0;0;0;0;0;0;0;0;0;0;0;0;0
FR;9;2021-06-03;0;0;0;0;0;0;0;0;0;0;0;0;0;0;0;0;0;0
FR;9;2021-06-04;0;0;0;0;0;0;0;0;0;0;0;0;0;0;0;0;0;0
FR;9;2021-06-05;0;0;0;0;0;0;0;0;0;0;0;0;0;0;0;0;0;0
FR;9;2021-06-06;0;0;0;0;0;0;0;0;0;0;0;0;0;0;0;0;0;0
FR;9;2021-06-07;0;0;0;0;0;0;0;0;0;0;0;0;0;0;0;0;0;0
FR;9;2021-06-08;0;0;0;0;0;0;0;0;0;0;0;0;0;0;0;0;0;0
FR;9;2021-06-09;0;0;0;0;0;0;0;0;0;0;0;0;0;0;0;0;0;0
FR;9;2021-06-10;0;0;0;0;0;0;0;0;0;0;0;0;0;0;0;0;0;0
FR;9;2021-06-11;0;0;0;0;0;0;0;0;0;0;0;0;0;0;0;0;0;0
FR;9;2021-06-12;0;0;0;0;0;0;0;0;0;0;0;0;0;0;0;0;0;0
FR;9;2021-06-13;0;0;0;0;0;0;0;0;0;0;0;0;0;0;0;0;0;0
FR;9;2021-06-14;0;0;0;0;0;0;0;0;0;0;0;0;0;0;0;0;0;0
FR;9;2021-06-15;0;0;0;0;0;0;0;0;0;0;0;0;0;0;0;0;0;0
FR;9;2021-06-16;0;0;0;0;0;0;0;0;0;0;0;0;0;0;0;0;0;0
FR;9;2021-06-17;0;0;0;0;0;0;0;0;0;0;0;0;0;0;0;0;0;0
FR;9;2021-06-18;0;0;0;0;0;0;0;0;0;0;0;0;0;0;0;0;0;0
FR;9;2021-06-19;0;0;0;0;0;0;0;0;0;0;0;0;0;0;0;0;0;0
FR;9;2021-06-20;0;0;0;0;0;0;0;0;0;0;0;0;0;0;0;0;0;0
FR;9;2021-06-21;0;0;0;0;0;0;0;0;0;0;0;0;0;0;0;0;0;0
FR;9;2021-06-22;0;0;0;0;0;0;0;0;0;0;0;0;0;0;0;0;0;0
FR;9;2021-06-23;0;0;0;0;0;0;0;0;0;0;0;0;0;0;0;0;0;0
FR;9;2021-06-24;0;0;0;0;0;0;0;0;0;0;0;0;0;0;0;0;0;0
FR;9;2021-06-25;0;0;0;0;0;0;0;0;0;0;0;0;0;0;0;0;0;0
FR;9;2021-06-26;0;0;0;0;0;0;0;0;0;0;0;0;0;0;0;0;0;0
FR;9;2021-06-27;0;0;0;0;0;0;0;0;0;0;0;0;0;0;0;0;0;0
FR;9;2021-06-28;0;0;0;0;0;0;0;0;0;0;0;0;0;0;0;0;0;0
FR;9;2021-06-29;0;0;0;0;0;0;0;0;0;0;0;0;0;0;0;0;0;0
FR;9;2021-06-30;0;0;0;0;0;0;0;0;0;0;0;0;0;0;0;0;0;0
FR;9;2021-07-01;0;0;0;0;0;0;0;0;0;0;0;0;0;0;0;0;0;0
FR;9;2021-07-02;0;0;0;0;0;0;0;0;0;0;0;0;0;0;0;0;0;0
FR;9;2021-07-03;0;0;0;0;0;0;0;0;0;0;0;0;0;0;0;0;0;0
FR;9;2021-07-04;0;0;0;0;0;0;0;0;0;0;0;0;0;0;0;0;0;0
FR;9;2021-07-05;0;0;0;0;0;0;0;0;0;0;0;0;0;0;0;0;0;0
FR;9;2021-07-06;0;0;0;0;0;0;0;0;0;0;0;0;0;0;0;0;0;0
FR;9;2021-07-07;0;0;0;0;0;0;0;0;0;0;0;0;0;0;0;0;0;0
FR;9;2021-07-08;0;0;0;0;0;0;0;0;0;0;0;0;0;0;0;0;0;0
FR;9;2021-07-09;0;0;0;0;0;0;0;0;0;0;0;0;0;0;0;0;0;0
FR;9;2021-07-10;0;0;0;0;0;0;0;0;0;0;0;0;0;0;0;0;0;0
FR;9;2021-07-11;0;0;0;0;0;0;0;0;0;0;0;0;0;0;0;0;0;0
FR;9;2021-07-12;0;0;0;0;0;0;0;0;0;0;0;0;0;0;0;0;0;0
FR;9;2021-07-13;0;0;0;0;0;0;0;0;0;0;0;0;0;0;0;0;0;0
FR;9;2021-07-14;0;0;0;0;0;0;0;0;0;0;0;0;0;0;0;0;0;0
FR;9;2021-07-15;0;0;0;0;0;0;0;0;0;0;0;0;0;0;0;0;0;0
FR;9;2021-07-16;0;0;0;0;0;0;0;0;0;0;0;0;0;0;0;0;0;0
FR;9;2021-07-17;0;0;0;0;0;0;0;0;0;0;0;0;0;0;0;0;0;0
FR;9;2021-07-18;0;0;0;0;0;0;0;0;0;0;0;0;0;0;0;0;0;0
FR;9;2021-07-19;0;0;0;0;0;0;0;0;0;0;0;0;0;0;0;0;0;0
FR;9;2021-07-20;0;0;0;0;0;0;0;0;0;0;0;0;0;0;0;0;0;0
FR;9;2021-07-21;0;0;0;0;0;0;0;0;0;0;0;0;0;0;0;0;0;0
FR;9;2021-07-22;0;0;0;0;0;0;0;0;0;0;0;0;0;0;0;0;0;0
FR;9;2021-07-23;0;0;0;0;0;0;0;0;0;0;0;0;0;0;0;0;0;0
FR;9;2021-07-24;0;0;0;0;0;0;0;0;0;0;0;0;0;0;0;0;0;0
FR;9;2021-07-25;0;0;0;0;0;0;0;0;0;0;0;0;0;0;0;0;0;0
FR;9;2021-07-26;0;0;0;0;0;0;0;0;0;0;0;0;0;0;0;0;0;0
FR;9;2021-07-27;0;0;0;0;0;0;0;0;0;0;0;0;0;0;0;0;0;0
FR;9;2021-07-28;0;0;0;0;0;0;0;0;0;0;0;0;0;0;0;0;0;0
FR;9;2021-07-29;0;0;0;0;0;0;0;0;0;0;0;0;0;0;0;0;0;0
FR;9;2021-07-30;0;0;0;0;0;0;0;0;0;0;0;0;0;0;0;0;0;0
FR;9;2021-07-31;0;0;0;0;0;0;0;0;0;0;0;0;0;0;0;0;0;0
FR;9;2021-08-01;0;0;0;0;0;0;0;0;0;0;0;0;0;0;0;0;0;0
FR;9;2021-08-02;0;0;0;0;0;0;0;0;0;0;0;0;0;0;0;0;0;0
FR;9;2021-08-03;0;0;0;0;0;0;0;0;0;0;0;0;0;0;0;0;0;0
FR;9;2021-08-04;0;0;0;0;0;0;0;0;0;0;0;0;0;0;0;0;0;0
FR;9;2021-08-05;0;0;0;0;0;0;0;0;0;0;0;0;0;0;0;0;0;0
FR;9;2021-08-06;0;0;0;0;0;0;0;0;0;0;0;0;0;0;0;0;0;0
FR;9;2021-08-07;0;0;0;0;0;0;0;0;0;0;0;0;0;0;0;0;0;0
FR;9;2021-08-08;0;0;0;0;0;0;0;0;0;0;0;0;0;0;0;0;0;0
FR;9;2021-08-09;0;0;0;0;0;0;0;0;0;0;0;0;0;0;0;0;0;0
FR;9;2021-08-10;0;0;0;0;0;0;0;0;0;0;0;0;0;0;0;0;0;0
FR;9;2021-08-11;0;0;0;0;0;0;0;0;0;0;0;0;0;0;0;0;0;0
FR;9;2021-08-12;0;0;0;0;0;0;0;0;0;0;0;0;0;0;0;0;0;0
FR;9;2021-08-13;0;0;0;0;0;0;0;0;0;0;0;0;0;0;0;0;0;0
FR;9;2021-08-14;0;0;0;0;0;0;0;0;0;0;0;0;0;0;0;0;0;0
FR;9;2021-08-15;0;0;0;0;0;0;0;0;0;0;0;0;0;0;0;0;0;0
FR;9;2021-08-16;0;0;0;0;0;0;0;0;0;0;0;0;0;0;0;0;0;0
FR;9;2021-08-17;0;0;0;0;0;0;0;0;0;0;0;0;0;0;0;0;0;0
FR;9;2021-08-18;0;0;0;0;0;0;0;0;0;0;0;0;0;0;0;0;0;0
FR;9;2021-08-19;0;0;0;0;0;0;0;0;0;0;0;0;0;0;0;0;0;0
FR;9;2021-08-20;0;0;0;0;0;0;0;0;0;0;0;0;0;0;0;0;0;0
FR;9;2021-08-21;0;0;0;0;0;0;0;0;0;0;0;0;0;0;0;0;0;0
FR;9;2021-08-22;0;0;0;0;0;0;0;0;0;0;0;0;0;0;0;0;0;0
FR;9;2021-08-23;0;0;0;0;0;0;0;0;0;0;0;0;0;0;0;0;0;0
FR;9;2021-08-24;0;0;0;0;0;0;0;0;0;0;0;0;0;0;0;0;0;0
FR;9;2021-08-25;0;0;0;0;0;0;0;0;0;0;0;0;0;0;0;0;0;0
FR;9;2021-08-26;0;0;0;0;0;0;0;0;0;0;0;0;0;0;0;0;0;0
FR;9;2021-08-27;0;0;0;0;0;0;0;0;0;0;0;0;0;0;0;0;0;0
FR;9;2021-08-28;0;0;0;0;0;0;0;0;0;0;0;0;0;0;0;0;0;0
FR;9;2021-08-29;0;0;0;0;0;0;0;0;0;0;0;0;0;0;0;0;0;0
FR;9;2021-08-30;0;0;0;0;0;0;0;0;0;0;0;0;0;0;0;0;0;0
FR;9;2021-08-31;0;0;0;0;0;0;0;0;0;0;0;0;0;0;0;0;0;0
FR;9;2021-09-01;0;0;0;0;0;0;0;0;0;0;0;0;0;0;0;0;0;0
FR;9;2021-09-02;0;0;0;0;0;0;0;0;0;0;0;0;0;0;0;0;0;0
FR;9;2021-09-03;0;0;0;0;0;0;0;0;0;0;0;0;0;0;0;0;0;0
FR;9;2021-09-04;0;0;0;0;0;0;0;0;0;0;0;0;0;0;0;0;0;0
FR;9;2021-09-05;0;0;0;0;0;0;0;0;0;0;0;0;0;0;0;0;0;0
FR;9;2021-09-06;0;0;0;0;0;0;0;0;0;0;0;0;0;0;0;0;0;0
FR;9;2021-09-07;0;0;0;0;0;0;0;0;0;0;0;0;0;0;0;0;0;0
FR;9;2021-09-08;0;0;0;0;0;0;0;0;0;0;0;0;0;0;0;0;0;0
FR;9;2021-09-09;0;0;0;0;0;0;0;0;0;0;0;0;0;0;0;0;0;0
FR;9;2021-09-10;0;0;0;0;0;0;0;0;0;0;0;0;0;0;0;0;0;0
FR;9;2021-09-11;0;0;0;0;0;0;0;0;0;0;0;0;0;0;0;0;0;0
FR;9;2021-09-12;0;0;0;0;0;0;0;0;0;0;0;0;0;0;0;0;0;0
FR;9;2021-09-13;0;0;0;0;0;0;0;0;0;0;0;0;0;0;0;0;0;0
FR;9;2021-09-14;0;0;0;0;0;0;0;0;0;0;0;0;0;0;0;0;0;0
FR;9;2021-09-15;0;0;0;0;0;0;0;0;0;0;0;0;0;0;0;0;0;0
FR;9;2021-09-16;0;0;0;0;0;0;0;0;0;0;0;0;0;0;0;0;0;0
FR;9;2021-09-17;0;0;0;0;0;0;0;0;0;0;0;0;0;0;0;0;0;0
FR;9;2021-09-18;0;0;0;0;0;0;0;0;0;0;0;0;0;0;0;0;0;0
FR;9;2021-09-19;0;0;0;0;0;0;0;0;0;0;0;0;0;0;0;0;0;0
FR;9;2021-09-20;0;0;0;0;0;0;0;0;0;0;0;0;0;0;0;0;0;0
FR;9;2021-09-21;0;0;0;0;0;0;0;0;0;0;0;0;0;0;0;0;0;0
FR;9;2021-09-22;0;0;0;0;0;0;0;0;0;0;0;0;0;0;0;0;0;0
FR;9;2021-09-23;0;0;0;0;0;0;0;0;0;0;0;0;0;0;0;0;0;0
FR;9;2021-09-24;0;0;0;0;0;0;0;0;0;0;0;0;0;0;0;0;0;0
FR;9;2021-09-25;0;0;0;0;0;0;0;0;0;0;0;0;0;0;0;0;0;0
FR;9;2021-09-26;0;0;0;0;0;0;0;0;0;0;0;0;0;0;0;0;0;0
FR;9;2021-09-27;0;0;0;0;0;0;0;0;0;0;0;0;0;0;0;0;0;0
FR;9;2021-09-28;0;0;0;0;0;0;0;0;0;0;0;0;0;0;0;0;0;0
FR;9;2021-09-29;0;0;0;0;0;0;0;0;0;0;0;0;0;0;0;0;0;0
FR;9;2021-09-30;0;0;0;0;0;0;0;0;0;0;0;0;0;0;0;0;0;0
FR;9;2021-10-01;0;0;0;0;0;0;0;0;0;0;0;0;0;0;0;0;0;0
FR;9;2021-10-02;0;0;0;0;0;0;0;0;0;0;0;0;0;0;0;0;0;0
FR;9;2021-10-03;0;0;0;0;0;0;0;0;0;0;0;0;0;0;0;0;0;0
FR;9;2021-10-04;0;0;0;0;0;0;0;0;0;0;0;0;0;0;0;0;0;0
FR;9;2021-10-05;0;0;0;0;0;0;0;0;0;0;0;0;0;0;0;0;0;0
FR;9;2021-10-06;0;0;0;0;0;0;0;0;0;0;0;0;0;0;0;0;0;0
FR;9;2021-10-07;0;0;0;0;0;0;0;0;0;0;0;0;0;0;0;0;0;0
FR;9;2021-10-08;0;0;0;0;0;0;0;0;0;0;0;0;0;0;0;0;0;0
FR;9;2021-10-09;0;0;0;0;0;0;0;0;0;0;0;0;0;0;0;0;0;0
FR;9;2021-10-10;0;0;0;0;0;0;0;0;0;0;0;0;0;0;0;0;0;0
FR;9;2021-10-11;0;0;0;0;0;0;0;0;0;0;0;0;0;0;0;0;0;0
FR;9;2021-10-12;0;0;0;0;0;0;0;0;0;0;0;0;0;0;0;0;0;0
FR;9;2021-10-13;0;0;0;0;0;0;0;0;0;0;0;0;0;0;0;0;0;0
FR;9;2021-10-14;0;0;0;0;0;0;0;0;0;0;0;0;0;0;0;0;0;0
FR;9;2021-10-15;0;0;0;0;0;0;0;0;0;0;0;0;0;0;0;0;0;0
FR;9;2021-10-16;0;0;0;0;0;0;0;0;0;0;0;0;0;0;0;0;0;0
FR;9;2021-10-17;0;0;0;0;0;0;0;0;0;0;0;0;0;0;0;0;0;0
FR;9;2021-10-18;0;0;0;0;0;0;0;0;0;0;0;0;0;0;0;0;0;0
FR;9;2021-10-19;0;0;0;0;0;0;0;0;0;0;0;0;0;0;0;0;0;0
FR;9;2021-10-20;0;0;0;0;0;0;0;0;0;0;0;0;0;0;0;0;0;0
FR;9;2021-10-21;0;0;0;0;0;0;0;0;0;0;0;0;0;0;0;0;0;0
FR;9;2021-10-22;0;0;0;0;0;0;0;0;0;0;0;0;0;0;0;0;0;0
FR;9;2021-10-23;0;0;0;0;0;0;0;0;0;0;0;0;0;0;0;0;0;0
FR;9;2021-10-24;0;0;0;0;0;0;0;0;0;0;0;0;0;0;0;0;0;0
FR;9;2021-10-25;0;0;0;0;0;0;0;0;0;0;0;0;0;0;0;0;0;0
FR;9;2021-10-26;0;0;0;0;0;0;0;0;0;0;0;0;0;0;0;0;0;0
FR;9;2021-10-27;0;0;0;0;0;0;0;0;0;0;0;0;0;0;0;0;0;0
FR;9;2021-10-28;0;0;0;0;0;0;0;0;0;0;0;0;0;0;0;0;0;0
FR;9;2021-10-29;0;0;0;0;0;0;0;0;0;0;0;0;0;0;0;0;0;0
FR;9;2021-10-30;0;0;0;0;0;0;0;0;0;0;0;0;0;0;0;0;0;0
FR;9;2021-10-31;0;0;0;0;0;0;0;0;0;0;0;0;0;0;0;0;0;0
FR;9;2021-11-01;0;0;0;0;0;0;0;0;0;0;0;0;0;0;0;0;0;0
FR;9;2021-11-02;0;0;0;0;0;0;0;0;0;0;0;0;0;0;0;0;0;0
FR;9;2021-11-03;0;0;0;0;0;0;0;0;0;0;0;0;0;0;0;0;0;0
FR;9;2021-11-04;0;0;0;0;0;0;0;0;0;0;0;0;0;0;0;0;0;0
FR;9;2021-11-05;0;0;0;0;0;0;0;0;0;0;0;0;0;0;0;0;0;0
FR;9;2021-11-06;0;0;0;0;0;0;0;0;0;0;0;0;0;0;0;0;0;0
FR;9;2021-11-07;0;0;0;0;0;0;0;0;0;0;0;0;0;0;0;0;0;0
FR;9;2021-11-08;0;0;0;0;0;0;0;0;0;0;0;0;0;0;0;0;0;0
FR;9;2021-11-09;0;0;0;0;0;0;0;0;0;0;0;0;0;0;0;0;0;0
FR;9;2021-11-10;0;0;0;0;0;0;0;0;0;0;0;0;0;0;0;0;0;0
FR;9;2021-11-11;0;0;0;0;0;0;0;0;0;0;0;0;0;0;0;0;0;0
FR;9;2021-11-12;0;0;0;0;0;0;0;0;0;0;0;0;0;0;0;0;0;0
FR;9;2021-11-13;0;0;0;0;0;0;0;0;0;0;0;0;0;0;0;0;0;0
FR;9;2021-11-14;0;0;0;0;0;0;0;0;0;0;0;0;0;0;0;0;0;0
FR;9;2021-11-15;0;0;0;0;0;0;0;0;0;0;0;0;0;0;0;0;0;0
FR;9;2021-11-16;0;0;0;0;0;0;0;0;0;0;0;0;0;0;0;0;0;0
FR;9;2021-11-17;0;0;0;0;0;0;0;0;0;0;0;0;0;0;0;0;0;0
FR;9;2021-11-18;0;0;0;0;0;0;0;0;0;0;0;0;0;0;0;0;0;0
FR;9;2021-11-19;0;0;0;0;0;0;0;0;0;0;0;0;0;0;0;0;0;0
FR;9;2021-11-20;0;0;0;0;0;0;0;0;0;0;0;0;0;0;0;0;0;0
FR;9;2021-11-21;0;0;0;0;0;0;0;0;0;0;0;0;0;0;0;0;0;0
FR;9;2021-11-22;0;0;0;0;0;0;0;0;0;0;0;0;0;0;0;0;0;0
FR;9;2021-11-23;0;0;0;0;0;0;0;0;0;0;0;0;0;0;0;0;0;0
FR;9;2021-11-24;0;0;0;0;0;0;0;0;0;0;0;0;0;0;0;0;0;0
FR;9;2021-11-25;0;0;0;0;0;0;0;0;0;0;0;0;0;0;0;0;0;0
FR;9;2021-11-26;0;0;0;0;0;0;0;0;0;0;0;0;0;0;0;0;0;0
FR;9;2021-11-27;0;0;0;0;0;0;0;0;0;0;0;0;0;0;0;0;0;0
FR;9;2021-11-28;0;0;0;0;0;0;0;0;0;0;0;0;0;0;0;0;0;0
FR;9;2021-11-29;0;0;0;0;0;0;0;0;0;0;0;0;0;0;0;0;0;0
FR;9;2021-11-30;0;0;0;0;0;0;0;0;0;0;0;0;0;0;0;0;0;0
FR;9;2021-12-01;0;0;0;0;0;0;0;0;0;0;0;0;0;0;0;0;0;0
FR;9;2021-12-02;0;0;0;0;0;0;0;0;0;0;0;0;0;0;0;0;0;0
FR;9;2021-12-03;0;0;0;0;0;0;0;0;0;0;0;0;0;0;0;0;0;0
FR;9;2021-12-04;0;0;0;0;0;0;0;0;0;0;0;0;0;0;0;0;0;0
FR;9;2021-12-05;0;0;0;0;0;0;0;0;0;0;0;0;0;0;0;0;0;0
FR;9;2021-12-06;0;0;0;0;0;0;0;0;0;0;0;0;0;0;0;0;0;0
FR;9;2021-12-07;0;0;0;0;0;0;0;0;0;0;0;0;0;0;0;0;0;0
FR;9;2021-12-08;0;0;0;0;0;0;0;0;0;0;0;0;0;0;0;0;0;0
FR;9;2021-12-09;0;0;0;0;0;0;0;0;0;0;0;0;0;0;0;0;0;0
FR;9;2021-12-10;0;0;0;0;0;0;0;0;0;0;0;0;0;0;0;0;0;0
FR;9;2021-12-11;0;0;0;0;0;0;0;0;0;0;0;0;0;0;0;0;0;0
FR;9;2021-12-12;0;0;0;0;0;0;0;0;0;0;0;0;0;0;0;0;0;0
FR;9;2021-12-13;0;0;0;0;0;0;0;0;0;0;0;0;0;0;0;0;0;0
FR;9;2021-12-14;0;0;0;0;0;0;0;0;0;0;0;0;0;0;0;0;0;0
FR;9;2021-12-15;0;0;0;0;0;0;0;0;0;0;0;0;0;0;0;0;0;0
FR;9;2021-12-16;0;0;0;0;0;0;0;0;0;0;0;0;0;0;0;0;0;0
FR;9;2021-12-17;0;0;0;0;0;0;0;0;0;0;0;0;0;0;0;0;0;0
FR;9;2021-12-18;0;0;0;0;0;0;0;0;0;0;0;0;0;0;0;0;0;0
FR;9;2021-12-19;0;0;0;0;0;0;0;0;0;0;0;0;0;0;0;0;0;0
FR;9;2021-12-20;0;0;0;0;0;0;0;0;0;0;0;0;0;0;0;0;0;0
FR;9;2021-12-21;0;0;0;0;0;0;0;0;0;0;0;0;0;0;0;0;0;0
FR;9;2021-12-22;0;0;0;0;0;0;0;0;0;0;0;0;0;0;0;0;0;0
FR;9;2021-12-23;0;0;0;0;0;0;0;0;0;0;0;0;0;0;0;0;0;0
FR;9;2021-12-24;0;0;0;0;0;0;0;0;0;0;0;0;0;0;0;0;0;0
FR;9;2021-12-25;0;0;0;0;0;0;0;0;0;0;0;0;0;0;0;0;0;0
FR;9;2021-12-26;0;0;0;0;0;0;0;0;0;0;0;0;0;0;0;0;0;0
FR;9;2021-12-27;0;0;0;0;0;0;0;0;0;0;0;0;0;0;0;0;0;0
FR;9;2021-12-28;0;0;0;0;0;0;0;0;0;0;0;0;0;0;0;0;0;0
FR;9;2021-12-29;0;0;0;0;0;0;0;0;0;0;0;0;0;0;0;0;0;0
FR;9;2021-12-30;0;0;0;0;0;0;0;0;0;0;0;0;0;0;0;0;0;0
FR;9;2021-12-31;0;0;0;0;0;0;0;0;0;0;0;0;0;0;0;0;0;0
FR;9;2022-01-01;0;0;0;0;0;0;0;0;0;0;0;0;0;0;0;0;0;0
FR;9;2022-01-02;0;0;0;0;0;0;0;0;0;0;0;0;0;0;0;0;0;0
FR;9;2022-01-03;0;0;0;0;0;0;0;0;0;0;0;0;0;0;0;0;0;0
FR;9;2022-01-04;0;0;0;0;0;0;0;0;0;0;0;0;0;0;0;0;0;0
FR;9;2022-01-05;0;0;0;0;0;0;0;0;0;0;0;0;0;0;0;0;0;0
FR;9;2022-01-06;0;0;0;0;0;0;0;0;0;0;0;0;0;0;0;0;0;0
FR;9;2022-01-07;0;0;0;0;0;0;0;0;0;0;0;0;0;0;0;0;0;0
FR;9;2022-01-08;0;0;0;0;0;0;0;0;0;0;0;0;0;0;0;0;0;0
FR;9;2022-01-09;0;0;0;0;0;0;0;0;0;0;0;0;0;0;0;0;0;0
FR;9;2022-01-10;0;0;0;0;0;0;0;0;0;0;0;0;0;0;0;0;0;0
FR;9;2022-01-11;0;0;0;0;0;0;0;0;0;0;0;0;0;0;0;0;0;0
FR;9;2022-01-12;0;0;0;0;0;0;0;0;0;0;0;0;0;0;0;0;0;0
FR;9;2022-01-13;0;0;0;0;0;0;0;0;0;0;0;0;0;0;0;0;0;0
FR;9;2022-01-14;0;0;0;0;0;0;0;0;0;0;0;0;0;0;0;0;0;0
FR;9;2022-01-15;0;0;0;0;0;0;0;0;0;0;0;0;0;0;0;0;0;0
FR;9;2022-01-16;0;0;0;0;0;0;0;0;0;0;0;0;0;0;0;0;0;0
FR;9;2022-01-17;0;0;0;0;0;0;0;0;0;0;0;0;0;0;0;0;0;0
FR;9;2022-01-18;0;0;0;0;0;0;0;0;0;0;0;0;0;0;0;0;0;0
FR;9;2022-01-19;0;0;0;0;0;0;0;0;0;0;0;0;0;0;0;0;0;0
FR;9;2022-01-20;0;0;0;0;0;0;0;0;0;0;0;0;0;0;0;0;0;0
FR;9;2022-01-21;0;0;0;0;0;0;0;0;0;0;0;0;0;0;0;0;0;0
FR;9;2022-01-22;0;0;0;0;0;0;0;0;0;0;0;0;0;0;0;0;0;0
FR;9;2022-01-23;0;0;0;0;0;0;0;0;0;0;0;0;0;0;0;0;0;0
FR;9;2022-01-24;0;0;0;0;0;0;0;0;0;0;0;0;0;0;0;0;0;0
FR;9;2022-01-25;0;0;0;0;0;0;0;0;0;0;0;0;0;0;0;0;0;0
FR;9;2022-01-26;0;0;0;0;0;0;0;0;0;0;0;0;0;0;0;0;0;0
FR;9;2022-01-27;0;0;0;0;0;0;0;0;0;0;0;0;0;0;0;0;0;0
FR;9;2022-01-28;0;0;0;0;0;0;0;0;0;0;0;0;0;0;0;0;0;0
FR;9;2022-01-29;0;0;0;0;0;0;0;0;0;0;0;0;0;0;0;0;0;0
FR;9;2022-01-30;0;0;0;0;0;0;0;0;0;0;0;0;0;0;0;0;0;0
FR;9;2022-01-31;0;0;0;0;0;0;0;0;0;0;0;0;0;0;0;0;0;0
FR;9;2022-02-01;0;0;0;0;0;0;0;0;0;0;0;0;0;0;0;0;0;0
FR;9;2022-02-02;0;0;0;0;0;0;0;0;0;0;0;0;0;0;0;0;0;0
FR;9;2022-02-03;0;0;0;0;0;0;0;0;0;0;0;0;0;0;0;0;0;0
FR;9;2022-02-04;0;0;0;0;0;0;0;0;0;0;0;0;0;0;0;0;0;0
FR;9;2022-02-05;0;0;0;0;0;0;0;0;0;0;0;0;0;0;0;0;0;0
FR;9;2022-02-06;0;0;0;0;0;0;0;0;0;0;0;0;0;0;0;0;0;0
FR;9;2022-02-07;0;0;0;0;0;0;0;0;0;0;0;0;0;0;0;0;0;0
FR;9;2022-02-08;0;0;0;0;0;0;0;0;0;0;0;0;0;0;0;0;0;0
FR;9;2022-02-09;0;0;0;0;0;0;0;0;0;0;0;0;0;0;0;0;0;0
FR;9;2022-02-10;0;0;0;0;0;0;0;0;0;0;0;0;0;0;0;0;0;0
FR;9;2022-02-11;0;0;0;0;0;0;0;0;0;0;0;0;0;0;0;0;0;0
FR;9;2022-02-12;0;0;0;0;0;0;0;0;0;0;0;0;0;0;0;0;0;0
FR;9;2022-02-13;0;0;0;0;0;0;0;0;0;0;0;0;0;0;0;0;0;0
FR;9;2022-02-14;0;0;0;0;0;0;0;0;0;0;0;0;0;0;0;0;0;0
FR;9;2022-02-15;0;0;0;0;0;0;0;0;0;0;0;0;0;0;0;0;0;0
FR;9;2022-02-16;0;0;0;0;0;0;0;0;0;0;0;0;0;0;0;0;0;0
FR;9;2022-02-17;0;0;0;0;0;0;0;0;0;0;0;0;0;0;0;0;0;0
FR;9;2022-02-18;0;0;0;0;0;0;0;0;0;0;0;0;0;0;0;0;0;0
FR;9;2022-02-19;0;0;0;0;0;0;0;0;0;0;0;0;0;0;0;0;0;0
FR;9;2022-02-20;0;0;0;0;0;0;0;0;0;0;0;0;0;0;0;0;0;0
FR;9;2022-02-21;0;0;0;0;0;0;0;0;0;0;0;0;0;0;0;0;0;0
FR;9;2022-02-22;0;0;0;0;0;0;0;0;0;0;0;0;0;0;0;0;0;0
FR;9;2022-02-23;0;0;0;0;0;0;0;0;0;0;0;0;0;0;0;0;0;0
FR;9;2022-02-24;0;0;0;0;0;0;0;0;0;0;0;0;0;0;0;0;0;0
FR;9;2022-02-25;0;0;0;0;0;0;0;0;0;0;0;0;0;0;0;0;0;0
FR;9;2022-02-26;0;0;0;0;0;0;0;0;0;0;0;0;0;0;0;0;0;0
FR;9;2022-02-27;0;0;0;0;0;0;0;0;0;0;0;0;0;0;0;0;0;0
FR;9;2022-02-28;0;0;0;0;0;0;0;0;0;0;0;0;0;0;0;0;0;0
FR;9;2022-03-01;0;0;0;0;0;0;0;0;0;0;0;0;0;0;0;0;0;0
FR;9;2022-03-02;0;0;0;0;0;0;0;0;0;0;0;0;0;0;0;0;0;0
FR;9;2022-03-03;0;0;0;0;0;0;0;0;0;0;0;0;0;0;0;0;0;0
FR;9;2022-03-04;0;0;0;0;0;0;0;0;0;0;0;0;0;0;0;0;0;0
FR;9;2022-03-05;0;0;0;0;0;0;0;0;0;0;0;0;0;0;0;0;0;0
FR;9;2022-03-06;0;0;0;0;0;0;0;0;0;0;0;0;0;0;0;0;0;0
FR;9;2022-03-07;0;0;0;0;0;0;0;0;0;0;0;0;0;0;0;0;0;0
FR;9;2022-03-08;0;0;0;0;0;0;0;0;0;0;0;0;0;0;0;0;0;0
FR;9;2022-03-09;0;0;0;0;0;0;0;0;0;0;0;0;0;0;0;0;0;0
FR;9;2022-03-10;0;0;0;0;0;0;0;0;0;0;0;0;0;0;0;0;0;0
FR;9;2022-03-11;0;0;0;0;0;0;0;0;0;0;0;0;0;0;0;0;0;0
FR;9;2022-03-12;0;0;0;0;0;0;0;0;0;0;0;0;0;0;0;0;0;0
FR;9;2022-03-13;0;0;0;0;0;0;0;0;0;0;0;0;0;0;0;0;0;0
FR;9;2022-03-14;0;0;0;0;0;0;0;0;0;0;0;0;0;0;0;0;0;0
FR;9;2022-03-15;0;0;0;0;0;0;0;0;0;0;0;0;0;0;0;0;0;0
FR;9;2022-03-16;0;0;0;0;0;0;0;0;0;0;0;0;0;0;0;0;0;0
FR;9;2022-03-17;0;0;0;0;0;0;0;0;0;0;0;0;0;0;0;0;0;0
FR;9;2022-03-18;0;0;0;0;0;0;0;0;0;0;0;0;0;0;0;0;0;0
FR;9;2022-03-19;0;0;0;0;0;0;0;0;0;0;0;0;0;0;0;0;0;0
FR;9;2022-03-20;0;0;0;0;0;0;0;0;0;0;0;0;0;0;0;0;0;0
FR;9;2022-03-21;0;0;0;0;0;0;0;0;0;0;0;0;0;0;0;0;0;0
FR;9;2022-03-22;0;0;0;0;0;0;0;0;0;0;0;0;0;0;0;0;0;0
FR;9;2022-03-23;0;0;0;0;0;0;0;0;0;0;0;0;0;0;0;0;0;0
FR;9;2022-03-24;0;0;0;0;0;0;0;0;0;0;0;0;0;0;0;0;0;0
FR;9;2022-03-25;0;0;0;0;0;0;0;0;0;0;0;0;0;0;0;0;0;0
FR;9;2022-03-26;0;0;0;0;0;0;0;0;0;0;0;0;0;0;0;0;0;0
FR;9;2022-03-27;0;0;0;0;0;0;0;0;0;0;0;0;0;0;0;0;0;0
FR;9;2022-03-28;0;0;0;0;0;0;0;0;0;0;0;0;0;0;0;0;0;0
FR;9;2022-03-29;0;0;0;0;0;0;0;0;0;0;0;0;0;0;0;0;0;0
FR;9;2022-03-30;0;0;0;0;0;0;0;0;0;0;0;0;0;0;0;0;0;0
FR;9;2022-03-31;0;0;0;0;0;0;0;0;0;0;0;0;0;0;0;0;0;0
FR;9;2022-04-01;0;0;0;0;0;0;0;0;0;0;0;0;0;0;0;0;0;0
FR;9;2022-04-02;0;0;0;0;0;0;0;0;0;0;0;0;0;0;0;0;0;0
FR;9;2022-04-03;0;0;0;0;0;0;0;0;0;0;0;0;0;0;0;0;0;0
FR;9;2022-04-04;0;0;0;0;0;0;0;0;0;0;0;0;0;0;0;0;0;0
FR;9;2022-04-05;0;0;0;0;0;0;0;0;0;0;0;0;0;0;0;0;0;0
FR;9;2022-04-06;0;0;0;0;0;0;0;0;0;0;0;0;0;0;0;0;0;0
FR;9;2022-04-07;0;0;0;0;0;0;0;0;0;0;0;0;0;0;0;0;0;0
FR;9;2022-04-08;0;0;0;0;0;0;0;0;0;0;0;0;0;0;0;0;0;0
FR;9;2022-04-09;0;0;0;0;0;0;0;0;0;0;0;0;0;0;0;0;0;0
FR;9;2022-04-10;0;0;0;0;0;0;0;0;0;0;0;0;0;0;0;0;0;0
FR;9;2022-04-11;0;0;0;0;0;0;0;0;0;0;0;0;0;0;0;0;0;0
FR;9;2022-04-12;0;0;0;0;0;0;0;0;0;0;0;0;0;0;0;0;0;0
FR;9;2022-04-13;0;0;0;0;0;0;0;0;0;0;0;0;0;0;0;0;0;0
FR;9;2022-04-14;0;0;0;0;0;0;0;0;0;0;0;0;0;0;0;0;0;0
FR;9;2022-04-15;0;0;0;0;0;0;0;0;0;0;0;0;0;0;0;0;0;0
FR;9;2022-04-16;0;0;0;0;0;0;0;0;0;0;0;0;0;0;0;0;0;0
FR;9;2022-04-17;0;0;0;0;0;0;0;0;0;0;0;0;0;0;0;0;0;0
FR;9;2022-04-18;0;0;0;0;0;0;0;0;0;0;0;0;0;0;0;0;0;0
FR;9;2022-04-19;0;0;0;0;0;0;0;0;0;0;0;0;0;0;0;0;0;0
FR;9;2022-04-20;0;0;0;0;0;0;0;0;0;0;0;0;0;0;0;0;0;0
FR;9;2022-04-21;0;0;0;0;0;0;0;0;0;0;0;0;0;0;0;0;0;0
FR;9;2022-04-22;0;0;0;0;0;0;0;0;0;0;0;0;0;0;0;0;0;0
FR;9;2022-04-23;0;0;0;0;0;0;0;0;0;0;0;0;0;0;0;0;0;0
FR;9;2022-04-24;0;0;0;0;0;0;0;0;0;0;0;0;0;0;0;0;0;0
FR;9;2022-04-25;0;0;0;0;0;0;0;0;0;0;0;0;0;0;0;0;0;0
FR;9;2022-04-26;0;0;0;0;0;0;0;0;0;0;0;0;0;0;0;0;0;0
FR;9;2022-04-27;0;0;0;0;0;0;0;0;0;0;0;0;0;0;0;0;0;0
FR;9;2022-04-28;0;0;0;0;0;0;0;0;0;0;0;0;0;0;0;0;0;0
FR;9;2022-04-29;0;0;0;0;0;0;0;0;0;0;0;0;0;0;0;0;0;0
FR;9;2022-04-30;0;0;0;0;0;0;0;0;0;0;0;0;0;0;0;0;0;0
FR;9;2022-05-01;0;0;0;0;0;0;0;0;0;0;0;0;0;0;0;0;0;0
FR;9;2022-05-02;0;0;0;0;0;0;0;0;0;0;0;0;0;0;0;0;0;0
FR;9;2022-05-03;0;0;0;0;0;0;0;0;0;0;0;0;0;0;0;0;0;0
FR;9;2022-05-04;0;0;0;0;0;0;0;0;0;0;0;0;0;0;0;0;0;0
FR;9;2022-05-05;0;0;0;0;0;0;0;0;0;0;0;0;0;0;0;0;0;0
FR;9;2022-05-06;0;0;0;0;0;0;0;0;0;0;0;0;0;0;0;0;0;0
FR;9;2022-05-07;0;0;0;0;0;0;0;0;0;0;0;0;0;0;0;0;0;0
FR;9;2022-05-08;0;0;0;0;0;0;0;0;0;0;0;0;0;0;0;0;0;0
FR;9;2022-05-09;0;0;0;0;0;0;0;0;0;0;0;0;0;0;0;0;0;0
FR;9;2022-05-10;0;0;0;0;0;0;0;0;0;0;0;0;0;0;0;0;0;0
FR;9;2022-05-11;0;0;0;0;0;0;0;0;0;0;0;0;0;0;0;0;0;0
FR;9;2022-05-12;0;0;0;0;0;0;0;0;0;0;0;0;0;0;0;0;0;0
FR;9;2022-05-13;0;0;0;0;0;0;0;0;0;0;0;0;0;0;0;0;0;0
FR;9;2022-05-14;0;0;0;0;0;0;0;0;0;0;0;0;0;0;0;0;0;0
FR;9;2022-05-15;0;0;0;0;0;0;0;0;0;0;0;0;0;0;0;0;0;0
FR;9;2022-05-16;0;0;0;0;0;0;0;0;0;0;0;0;0;0;0;0;0;0
FR;9;2022-05-17;0;0;0;0;0;0;0;0;0;0;0;0;0;0;0;0;0;0
FR;9;2022-05-18;0;0;0;0;0;0;0;0;0;0;0;0;0;0;0;0;0;0
FR;9;2022-05-19;0;0;0;0;0;0;0;0;0;0;0;0;0;0;0;0;0;0
FR;9;2022-05-20;0;0;0;0;0;0;0;0;0;0;0;0;0;0;0;0;0;0
FR;9;2022-05-21;0;0;0;0;0;0;0;0;0;0;0;0;0;0;0;0;0;0
FR;9;2022-05-22;0;0;0;0;0;0;0;0;0;0;0;0;0;0;0;0;0;0
FR;9;2022-05-23;0;0;0;0;0;0;0;0;0;0;0;0;0;0;0;0;0;0
FR;9;2022-05-24;0;0;0;0;0;0;0;0;0;0;0;0;0;0;0;0;0;0
FR;9;2022-05-25;0;0;0;0;0;0;0;0;0;0;0;0;0;0;0;0;0;0
FR;9;2022-05-26;0;0;0;0;0;0;0;0;0;0;0;0;0;0;0;0;0;0
FR;9;2022-05-27;0;0;0;0;0;0;0;0;0;0;0;0;0;0;0;0;0;0
FR;9;2022-05-28;0;0;0;0;0;0;0;0;0;0;0;0;0;0;0;0;0;0
FR;9;2022-05-29;0;0;0;0;0;0;0;0;0;0;0;0;0;0;0;0;0;0
FR;9;2022-05-30;0;0;0;0;0;0;0;0;0;0;0;0;0;0;0;0;0;0
FR;9;2022-05-31;0;0;0;0;0;0;0;0;0;0;0;0;0;0;0;0;0;0
FR;9;2022-06-01;0;0;0;0;0;0;0;0;0;0;0;0;0;0;0;0;0;0
FR;9;2022-06-02;0;0;0;0;0;0;0;0;0;0;0;0;0;0;0;0;0;0
FR;9;2022-06-03;0;0;0;0;0;0;0;0;0;0;0;0;0;0;0;0;0;0
FR;9;2022-06-04;0;0;0;0;0;0;0;0;0;0;0;0;0;0;0;0;0;0
FR;9;2022-06-05;0;0;0;0;0;0;0;0;0;0;0;0;0;0;0;0;0;0
FR;9;2022-06-06;0;0;0;0;0;0;0;0;0;0;0;0;0;0;0;0;0;0
FR;9;2022-06-07;0;0;0;0;0;0;0;0;0;0;0;0;0;0;0;0;0;0
FR;9;2022-06-08;0;0;0;0;0;0;0;0;0;0;0;0;0;0;0;0;0;0
FR;9;2022-06-09;0;0;0;0;0;0;0;0;0;0;0;0;0;0;0;0;0;0
FR;9;2022-06-10;0;0;0;0;0;0;0;0;0;0;0;0;0;0;0;0;0;0
FR;9;2022-06-11;0;0;0;0;0;0;0;0;0;0;0;0;0;0;0;0;0;0
FR;9;2022-06-12;0;0;0;0;0;0;0;0;0;0;0;0;0;0;0;0;0;0
FR;9;2022-06-13;0;0;0;0;0;0;0;0;0;0;0;0;0;0;0;0;0;0
FR;9;2022-06-14;0;0;0;0;0;0;0;0;0;0;0;0;0;0;0;0;0;0
FR;9;2022-06-15;0;0;0;0;0;0;0;0;0;0;0;0;0;0;0;0;0;0
FR;9;2022-06-16;0;0;0;0;0;0;0;0;0;0;0;0;0;0;0;0;0;0
FR;9;2022-06-17;0;0;0;0;0;0;0;0;0;0;0;0;0;0;0;0;0;0
FR;9;2022-06-18;0;0;0;0;0;0;0;0;0;0;0;0;0;0;0;0;0;0
FR;9;2022-06-19;0;0;0;0;0;0;0;0;0;0;0;0;0;0;0;0;0;0
FR;9;2022-06-20;0;0;0;0;0;0;0;0;0;0;0;0;0;0;0;0;0;0
FR;9;2022-06-21;0;0;0;0;0;0;0;0;0;0;0;0;0;0;0;0;0;0
FR;9;2022-06-22;0;0;0;0;0;0;0;0;0;0;0;0;0;0;0;0;0;0
FR;9;2022-06-23;0;0;0;0;0;0;0;0;0;0;0;0;0;0;0;0;0;0
FR;9;2022-06-24;0;0;0;0;0;0;0;0;0;0;0;0;0;0;0;0;0;0
FR;9;2022-06-25;0;0;0;0;0;0;0;0;0;0;0;0;0;0;0;0;0;0
FR;9;2022-06-26;0;0;0;0;0;0;0;0;0;0;0;0;0;0;0;0;0;0
FR;9;2022-06-27;0;0;0;0;0;0;0;0;0;0;0;0;0;0;0;0;0;0
FR;9;2022-06-28;0;0;0;0;0;0;0;0;0;0;0;0;0;0;0;0;0;0
FR;9;2022-06-29;0;0;0;0;0;0;0;0;0;0;0;0;0;0;0;0;0;0
FR;9;2022-06-30;0;0;0;0;0;0;0;0;0;0;0;0;0;0;0;0;0;0
FR;9;2022-07-01;0;0;0;0;0;0;0;0;0;0;0;0;0;0;0;0;0;0
FR;9;2022-07-02;0;0;0;0;0;0;0;0;0;0;0;0;0;0;0;0;0;0
FR;9;2022-07-03;0;0;0;0;0;0;0;0;0;0;0;0;0;0;0;0;0;0
FR;9;2022-07-04;0;0;0;0;0;0;0;0;0;0;0;0;0;0;0;0;0;0
FR;9;2022-07-05;0;0;0;0;0;0;0;0;0;0;0;0;0;0;0;0;0;0
FR;9;2022-07-06;0;0;0;0;0;0;0;0;0;0;0;0;0;0;0;0;0;0
FR;9;2022-07-07;0;0;0;0;0;0;0;0;0;0;0;0;0;0;0;0;0;0
FR;9;2022-07-08;0;0;0;0;0;0;0;0;0;0;0;0;0;0;0;0;0;0
FR;9;2022-07-09;0;0;0;0;0;0;0;0;0;0;0;0;0;0;0;0;0;0
FR;9;2022-07-10;0;0;0;0;0;0;0;0;0;0;0;0;0;0;0;0;0;0
FR;9;2022-07-11;0;0;0;0;0;0;0;0;0;0;0;0;0;0;0;0;0;0
FR;9;2022-07-12;0;0;0;0;0;0;0;0;0;0;0;0;0;0;0;0;0;0
FR;9;2022-07-13;0;0;0;0;0;0;0;0;0;0;0;0;0;0;0;0;0;0
FR;9;2022-07-14;0;0;0;0;0;0;0;0;0;0;0;0;0;0;0;0;0;0
FR;9;2022-07-15;0;0;0;0;0;0;0;0;0;0;0;0;0;0;0;0;0;0
FR;9;2022-07-16;0;0;0;0;0;0;0;0;0;0;0;0;0;0;0;0;0;0
FR;9;2022-07-17;0;0;0;0;0;0;0;0;0;0;0;0;0;0;0;0;0;0
FR;9;2022-07-18;0;0;0;0;0;0;0;0;0;0;0;0;0;0;0;0;0;0
FR;9;2022-07-19;0;0;0;0;0;0;0;0;0;0;0;0;0;0;0;0;0;0
FR;9;2022-07-20;0;0;0;0;0;0;0;0;0;0;0;0;0;0;0;0;0;0
FR;9;2022-07-21;0;0;0;0;0;0;0;0;0;0;0;0;0;0;0;0;0;0
FR;9;2022-07-22;0;0;0;0;0;0;0;0;0;0;0;0;0;0;0;0;0;0
FR;9;2022-07-23;0;0;0;0;0;0;0;0;0;0;0;0;0;0;0;0;0;0
FR;9;2022-07-24;0;0;0;0;0;0;0;0;0;0;0;0;0;0;0;0;0;0
FR;9;2022-07-25;0;0;0;0;0;0;0;0;0;0;0;0;0;0;0;0;0;0
FR;9;2022-07-26;0;0;0;0;0;0;0;0;0;0;0;0;0;0;0;0;0;0
FR;9;2022-07-27;0;0;0;0;0;0;0;0;0;0;0;0;0;0;0;0;0;0
FR;9;2022-07-28;0;0;0;0;0;0;0;0;0;0;0;0;0;0;0;0;0;0
FR;9;2022-07-29;0;0;0;0;0;0;0;0;0;0;0;0;0;0;0;0;0;0
FR;9;2022-07-30;0;0;0;0;0;0;0;0;0;0;0;0;0;0;0;0;0;0
FR;9;2022-07-31;0;0;0;0;0;0;0;0;0;0;0;0;0;0;0;0;0;0
FR;9;2022-08-01;0;0;0;0;0;0;0;0;0;0;0;0;0;0;0;0;0;0
FR;9;2022-08-02;0;0;0;0;0;0;0;0;0;0;0;0;0;0;0;0;0;0
FR;9;2022-08-03;0;0;0;0;0;0;0;0;0;0;0;0;0;0;0;0;0;0
FR;9;2022-08-04;0;0;0;0;0;0;0;0;0;0;0;0;0;0;0;0;0;0
FR;9;2022-08-05;0;0;0;0;0;0;0;0;0;0;0;0;0;0;0;0;0;0
FR;9;2022-08-06;0;0;0;0;0;0;0;0;0;0;0;0;0;0;0;0;0;0
FR;9;2022-08-07;0;0;0;0;0;0;0;0;0;0;0;0;0;0;0;0;0;0
FR;9;2022-08-08;0;0;0;0;0;0;0;0;0;0;0;0;0;0;0;0;0;0
FR;9;2022-08-09;0;0;0;0;0;0;0;0;0;0;0;0;0;0;0;0;0;0
FR;9;2022-08-10;0;0;0;0;0;0;0;0;0;0;0;0;0;0;0;0;0;0
FR;9;2022-08-11;0;0;0;0;0;0;0;0;0;0;0;0;0;0;0;0;0;0
FR;9;2022-08-12;0;0;0;0;0;0;0;0;0;0;0;0;0;0;0;0;0;0
FR;9;2022-08-13;0;0;0;0;0;0;0;0;0;0;0;0;0;0;0;0;0;0
FR;9;2022-08-14;0;0;0;0;0;0;0;0;0;0;0;0;0;0;0;0;0;0
FR;9;2022-08-15;0;0;0;0;0;0;0;0;0;0;0;0;0;0;0;0;0;0
FR;9;2022-08-16;0;0;0;0;0;0;0;0;0;0;0;0;0;0;0;0;0;0
FR;9;2022-08-17;0;0;0;0;0;0;0;0;0;0;0;0;0;0;0;0;0;0
FR;9;2022-08-18;0;0;0;0;0;0;0;0;0;0;0;0;0;0;0;0;0;0
FR;9;2022-08-19;0;0;0;0;0;0;0;0;0;0;0;0;0;0;0;0;0;0
FR;9;2022-08-20;0;0;0;0;0;0;0;0;0;0;0;0;0;0;0;0;0;0
FR;9;2022-08-21;0;0;0;0;0;0;0;0;0;0;0;0;0;0;0;0;0;0
FR;9;2022-08-22;0;0;0;0;0;0;0;0;0;0;0;0;0;0;0;0;0;0
FR;9;2022-08-23;0;0;0;0;0;0;0;0;0;0;0;0;0;0;0;0;0;0
FR;9;2022-08-24;0;0;0;0;0;0;0;0;0;0;0;0;0;0;0;0;0;0
FR;9;2022-08-25;0;0;0;0;0;0;0;0;0;0;0;0;0;0;0;0;0;0
FR;9;2022-08-26;0;0;0;0;0;0;0;0;0;0;0;0;0;0;0;0;0;0
FR;9;2022-08-27;0;0;0;0;0;0;0;0;0;0;0;0;0;0;0;0;0;0
FR;9;2022-08-28;0;0;0;0;0;0;0;0;0;0;0;0;0;0;0;0;0;0
FR;9;2022-08-29;0;0;0;0;0;0;0;0;0;0;0;0;0;0;0;0;0;0
FR;9;2022-08-30;0;0;0;0;0;0;0;0;0;0;0;0;0;0;0;0;0;0
FR;9;2022-08-31;0;0;0;0;0;0;0;0;0;0;0;0;0;0;0;0;0;0
FR;9;2022-09-01;0;0;0;0;0;0;0;0;0;0;0;0;0;0;0;0;0;0
FR;9;2022-09-02;0;0;0;0;0;0;0;0;0;0;0;0;0;0;0;0;0;0
FR;9;2022-09-03;0;0;0;0;0;0;0;0;0;0;0;0;0;0;0;0;0;0
FR;9;2022-09-04;0;0;0;0;0;0;0;0;0;0;0;0;0;0;0;0;0;0
FR;9;2022-09-05;0;0;0;0;0;0;0;0;0;0;0;0;0;0;0;0;0;0
FR;9;2022-09-06;0;0;0;0;0;0;0;0;0;0;0;0;0;0;0;0;0;0
FR;9;2022-09-07;0;0;0;0;0;0;0;0;0;0;0;0;0;0;0;0;0;0
FR;9;2022-09-08;0;0;0;0;0;0;0;0;0;0;0;0;0;0;0;0;0;0
FR;9;2022-09-09;0;0;0;0;0;0;0;0;0;0;0;0;0;0;0;0;0;0
FR;9;2022-09-10;0;0;0;0;0;0;0;0;0;0;0;0;0;0;0;0;0;0
FR;9;2022-09-11;0;0;0;0;0;0;0;0;0;0;0;0;0;0;0;0;0;0
FR;9;2022-09-12;0;0;0;0;0;0;0;0;0;0;0;0;0;0;0;0;0;0
FR;9;2022-09-13;0;0;0;0;0;0;0;0;0;0;0;0;0;0;0;0;0;0
FR;9;2022-09-14;0;0;0;0;0;0;0;0;0;0;0;0;0;0;0;0;0;0
FR;9;2022-09-15;0;0;0;0;0;0;0;0;0;0;0;0;0;0;0;0;0;0
FR;9;2022-09-16;0;0;0;0;0;0;0;0;0;0;0;0;0;0;0;0;0;0
FR;9;2022-09-17;0;0;0;0;0;0;0;0;0;0;0;0;0;0;0;0;0;0
FR;9;2022-09-18;0;0;0;0;0;0;0;0;0;0;0;0;0;0;0;0;0;0
FR;9;2022-09-19;0;0;0;0;0;0;0;0;0;0;0;0;0;0;0;0;0;0
FR;9;2022-09-20;0;0;0;0;0;0;0;0;0;0;0;0;0;0;0;0;0;0
FR;9;2022-09-21;0;0;0;0;0;0;0;0;0;0;0;0;0;0;0;0;0;0
FR;9;2022-09-22;0;0;0;0;0;0;0;0;0;0;0;0;0;0;0;0;0;0
FR;9;2022-09-23;0;0;0;0;0;0;0;0;0;0;0;0;0;0;0;0;0;0
FR;9;2022-09-24;0;0;0;0;0;0;0;0;0;0;0;0;0;0;0;0;0;0
FR;9;2022-09-25;0;0;0;0;0;0;0;0;0;0;0;0;0;0;0;0;0;0
FR;9;2022-09-26;0;0;0;0;0;0;0;0;0;0;0;0;0;0;0;0;0;0
FR;9;2022-09-27;0;0;0;0;0;0;0;0;0;0;0;0;0;0;0;0;0;0
FR;9;2022-09-28;0;0;0;0;0;0;0;0;0;0;0;0;0;0;0;0;0;0
FR;9;2022-09-29;1;1;8;33;0;6;35;43;2;1;1;8;33;0;6;35;43;2
FR;9;2022-09-30;5;13;62;606;7;48;614;715;51;6;14;70;639;7;54;649;758;53
FR;9;2022-10-01;10;2;43;327;3;26;335;396;35;16;16;113;966;10;80;984;1154;88
FR;9;2022-10-02;2;1;5;50;0;4;51;66;11;18;17;118;1016;10;84;1035;1220;99
FR;9;2022-10-03;15;17;151;1714;11;129;1708;2074;234;33;34;269;2730;21;213;2743;3294;333
FR;9;2022-10-04;23;48;353;3954;18;228;4022;4704;450;56;82;622;6684;39;441;6765;7998;783
FR;9;2022-10-05;30;21;269;3000;18;203;3013;3658;433;86;103;891;9684;57;644;9778;11656;1216
FR;9;2022-10-06;23;35;400;4598;18;301;4631;5609;672;109;138;1291;14282;75;945;14409;17265;1888
FR;9;2022-10-07;29;50;499;5706;19;384;5720;7029;923;138;188;1790;19988;94;1329;20129;24294;2811
FR;9;2022-10-08;10;18;128;1090;8;86;1108;1389;191;148;206;1918;21078;102;1415;21237;25683;3002
FR;9;2022-10-09;1;7;22;197;1;29;198;277;50;149;213;1940;21275;103;1444;21435;25960;3052
FR;9;2022-10-10;11;26;207;2572;14;181;2576;3296;533;160;239;2147;23847;117;1625;24011;29256;3585
FR;9;2022-10-11;31;40;424;5043;27;312;5024;6198;851;191;279;2571;28890;144;1937;29035;35454;4436
FR;9;2022-10-12;22;26;297;2987;16;212;3044;3830;572;213;305;2868;31877;160;2149;32079;39284;5008
FR;9;2022-10-13;25;42;374;3980;16;245;4036;5027;740;238;347;3242;35857;176;2394;36115;44311;5748
FR;9;2022-10-14;27;26;383;4430;12;295;4414;5558;838;265;373;3625;40287;188;2689;40529;49869;6586
FR;9;2022-10-15;14;8;101;1052;7;79;1029;1308;198;279;381;3726;41339;195;2768;41558;51177;6784
FR;9;2022-10-16;4;1;9;132;2;12;126;168;28;283;382;3735;41471;197;2780;41684;51345;6812
FR;9;2022-10-17;4;22;165;1875;11;127;1883;2492;475;287;404;3900;43346;208;2907;43567;53837;7287
FR;9;2022-10-18;36;29;317;3430;17;237;3454;4663;963;323;433;4217;46776;225;3144;47021;58500;8250
FR;9;2022-10-19;22;19;262;2688;17;174;2717;3733;827;345;452;4479;49464;242;3318;49738;62233;9077
FR;9;2022-10-20;22;22;308;3628;8;233;3639;4813;933;367;474;4787;53092;250;3551;53377;67046;10010
FR;9;2022-10-21;14;32;327;3550;11;228;3556;4656;864;381;506;5114;56642;261;3779;56933;71702;10874
FR;9;2022-10-22;10;11;90;914;8;62;919;1193;207;391;517;5204;57556;269;3841;57852;72895;11081
FR;9;2022-10-23;2;2;17;100;2;10;105;148;33;393;519;5221;57656;271;3851;57957;73043;11114
FR;9;2022-10-24;7;17;159;1363;6;106;1434;1942;397;400;536;5380;59019;277;3957;59391;74985;11511
FR;9;2022-10-25;19;22;228;2841;16;188;2851;3938;896;419;558;5608;61860;293;4145;62242;78923;12407
FR;9;2022-10-26;14;16;169;1800;13;123;1812;2527;590;433;574;5777;63660;306;4268;64054;81450;12997
FR;9;2022-10-27;9;26;230;2303;15;173;2337;3210;689;442;600;6007;65963;321;4441;66391;84660;13686
FR;9;2022-10-28;18;27;224;2277;17;151;2303;3143;682;460;627;6231;68240;338;4592;68694;87803;14368
FR;9;2022-10-29;12;8;55;505;5;46;496;662;119;472;635;6286;68745;343;4638;69190;88465;14487
FR;9;2022-10-30;2;1;8;58;1;8;58;82;16;474;636;6294;68803;344;4646;69248;88547;14503
FR;9;2022-10-31;13;7;105;660;9;59;695;996;240;487;643;6399;69463;353;4705;69943;89543;14743
FR;9;2022-11-01;1;2;15;43;1;11;49;71;11;488;645;6414;69506;354;4716;69992;89614;14754
FR;9;2022-11-02;7;12;102;1027;4;76;1045;1577;452;495;657;6516;70533;358;4792;71037;91191;15206
FR;9;2022-11-03;17;18;157;1599;16;92;1647;2348;599;512;675;6673;72132;374;4884;72684;93539;15805
FR;9;2022-11-04;21;19;193;1751;15;120;1800;2536;611;533;694;6866;73883;389;5004;74484;96075;16416
FR;9;2022-11-05;8;10;58;403;9;39;424;573;107;541;704;6924;74286;398;5043;74908;96648;16523
FR;9;2022-11-06;5;4;5;62;6;2;61;88;25;546;708;6929;74348;404;5045;74969;96736;16548
FR;9;2022-11-07;17;19;89;942;16;110;941;1489;432;563;727;7018;75290;420;5155;75910;98225;16980
FR;9;2022-11-08;11;19;171;1827;13;137;1815;2660;703;574;746;7189;77117;433;5292;77725;100885;17683
FR;9;2022-11-09;16;16;123;1261;9;98;1322;1878;453;590;762;7312;78378;442;5390;79047;102763;18136
FR;9;2022-11-10;13;22;162;1623;14;137;1621;2281;519;603;784;7474;80001;456;5527;80668;105044;18655
FR;9;2022-11-11;1;1;13;81;1;6;83;124;35;604;785;7487;80082;457;5533;80751;105168;18690
FR;9;2022-11-12;5;8;44;259;7;19;278;395;97;609;793;7531;80341;464;5552;81029;105563;18787
FR;9;2022-11-13;2;0;4;30;0;4;31;51;16;611;793;7535;80371;464;5556;81060;105614;18803
FR;9;2022-11-14;11;12;56;713;11;44;722;1108;339;622;805;7591;81084;475;5600;81782;106722;19142
FR;9;2022-11-15;18;17;151;1346;8;104;1356;2104;638;640;822;7742;82430;483;5704;83138;108826;19780
FR;9;2022-11-16;10;5;99;979;8;58;997;1490;431;650;827;7841;83409;491;5762;84135;110316;20211
FR;9;2022-11-17;10;17;126;1089;11;78;1113;1698;502;660;844;7967;84498;502;5840;85248;112014;20713
FR;9;2022-11-18;7;16;120;1440;5;78;1455;2027;492;667;860;8087;85938;507;5918;86703;114041;21205
FR;9;2022-11-19;3;5;51;364;1;28;351;490;106;670;865;8138;86302;508;5946;87054;114531;21311
FR;9;2022-11-20;1;0;5;37;0;3;35;54;16;671;865;8143;86339;508;5949;87089;114585;21327
FR;9;2022-11-21;9;12;66;636;5;51;639;960;263;680;877;8209;86975;513;6000;87728;115545;21590
FR;9;2022-11-22;15;12;121;1037;13;74;1067;1592;449;695;889;8330;88012;526;6074;88795;117137;22039
FR;9;2022-11-23;7;10;69;735;5;33;762;1172;372;702;899;8399;88747;531;6107;89557;118309;22411
FR;9;2022-11-24;8;19;93;979;14;68;992;1472;406;710;918;8492;89726;545;6175;90549;119781;22817
FR;9;2022-11-25;8;11;107;1180;9;82;1195;1781;503;718;929;8599;90906;554;6257;91744;121562;23320
FR;9;2022-11-26;6;6;35;217;7;24;214;310;68;724;935;8634;91123;561;6281;91958;121872;23388
FR;9;2022-11-27;1;1;6;42;0;2;46;82;34;725;936;8640;91165;561;6283;92004;121954;23422
FR;9;2022-11-28;5;7;103;698;7;60;726;1135;344;730;943;8743;91863;568;6343;92730;123089;23766
FR;9;2022-11-29;6;18;142;1299;6;89;1327;1942;521;736;961;8885;93162;574;6432;94057;125031;24287
FR;9;2022-11-30;9;12;99;1032;5;76;1055;1606;470;745;973;8984;94194;579;6508;95112;126637;24757
FR;9;2022-12-01;16;14;112;1345;8;80;1331;1970;554;761;987;9096;95539;587;6588;96443;128607;25311
FR;9;2022-12-02;10;13;193;1817;10;107;1818;2631;700;771;1000;9289;97356;597;6695;98261;131238;26011
FR;9;2022-12-03;7;9;79;619;5;41;632;887;208;778;1009;9368;97975;602;6736;98893;132125;26219
FR;9;2022-12-04;11;4;15;105;5;8;105;153;40;789;1013;9383;98080;607;6744;98998;132278;26259
FR;9;2022-12-05;21;24;144;1406;18;98;1421;2110;584;810;1037;9527;99486;625;6842;100419;134388;26843
FR;9;2022-12-06;30;21;264;2453;21;148;2548;3812;1097;840;1058;9791;101939;646;6990;102967;138200;27940
FR;9;2022-12-07;15;22;181;1848;20;112;1890;2826;814;855;1080;9972;103787;666;7102;104857;141026;28754
FR;9;2022-12-08;14;22;222;2404;15;125;2467;3701;1092;869;1102;10194;106191;681;7227;107324;144727;29846
FR;9;2022-12-09;14;25;287;2888;10;143;2986;4337;1200;883;1127;10481;109079;691;7370;110310;149064;31046
FR;9;2022-12-10;12;13;122;1324;5;56;1347;1819;410;895;1140;10603;110403;696;7426;111657;150883;31456
FR;9;2022-12-11;5;5;21;277;6;10;283;363;66;900;1145;10624;110680;702;7436;111940;151246;31522
FR;9;2022-12-12;17;14;215;1958;12;109;2032;2892;746;917;1159;10839;112638;714;7545;113972;154138;32268
FR;9;2022-12-13;28;23;317;3085;15;151;3221;4720;1337;945;1182;11156;115723;729;7696;117193;158858;33605
FR;9;2022-12-14;15;10;191;2335;8;94;2405;3505;989;960;1192;11347;118058;737;7790;119598;162363;34594
FR;9;2022-12-15;17;24;257;2611;13;138;2682;4069;1238;977;1216;11604;120669;750;7928;122280;166432;35832
FR;9;2022-12-16;15;29;294;3072;21;165;3155;4603;1274;992;1245;11898;123741;771;8093;125435;171035;37106
FR;9;2022-12-17;8;11;106;1193;6;50;1208;1664;402;1000;1256;12004;124934;777;8143;126643;172699;37508
FR;9;2022-12-18;1;7;30;245;6;14;251;333;67;1001;1263;12034;125179;783;8157;126894;173032;37575
FR;9;2022-12-19;20;22;149;1599;16;78;1631;2507;789;1021;1285;12183;126778;799;8235;128525;175539;38364
FR;9;2022-12-20;21;19;232;2306;6;115;2349;3708;1233;1042;1304;12415;129084;805;8350;130874;179247;39597
FR;9;2022-12-21;6;14;139;1501;7;66;1554;2402;775;1048;1318;12554;130585;812;8416;132428;181649;40372
FR;9;2022-12-22;19;9;136;1402;9;78;1418;2119;615;1067;1327;12690;131987;821;8494;133846;183768;40987
FR;9;2022-12-23;11;15;77;728;9;51;730;1092;305;1078;1342;12767;132715;830;8545;134576;184860;41292
FR;9;2022-12-24;1;5;13;96;4;6;98;138;34;1079;1347;12780;132811;834;8551;134674;184998;41326
FR;9;2022-12-25;1;0;5;5;0;4;6;12;2;1080;1347;12785;132816;834;8555;134680;185010;41328
FR;9;2022-12-26;17;8;64;547;11;37;554;829;235;1097;1355;12849;133363;845;8592;135234;185839;41563
FR;9;2022-12-27;12;30;97;882;14;69;917;1422;430;1109;1385;12946;134245;859;8661;136151;187261;41993
FR;9;2022-12-28;8;9;82;749;8;40;768;1185;372;1117;1394;13028;134994;867;8701;136919;188446;42365
FR;9;2022-12-29;9;14;92;720;10;51;753;1135;324;1126;1408;13120;135714;877;8752;137672;189581;42689
FR;9;2022-12-30;12;17;77;592;9;47;612;899;237;1138;1425;13197;136306;886;8799;138284;190480;42926
FR;9;2022-12-31;2;3;17;136;2;12;139;190;38;1140;1428;13214;136442;888;8811;138423;190670;42964
FR;9;2023-01-01;0;2;3;19;1;4;19;31;8;1140;1430;13217;136461;889;8815;138442;190701;42972
FR;9;2023-01-02;11;11;56;592;4;40;585;949;320;1151;1441;13273;137053;893;8855;139027;191650;43292
FR;9;2023-01-03;19;20;122;1079;20;75;1101;1940;749;1170;1461;13395;138132;913;8930;140128;193590;44041
FR;9;2023-01-04;21;19;113;846;9;73;898;1609;633;1191;1480;13508;138978;922;9003;141026;195199;44674
FR;9;2023-01-05;5;20;115;1059;11;65;1091;2048;882;1196;1500;13623;140037;933;9068;142117;197247;45556
FR;9;2023-01-06;13;17;152;1370;4;73;1388;2410;938;1209;1517;13775;141407;937;9141;143505;199657;46494
FR;9;2023-01-07;6;13;58;436;14;36;427;687;220;1215;1530;13833;141843;951;9177;143932;200344;46714
FR;9;2023-01-08;4;11;15;92;9;12;91;137;32;1219;1541;13848;141935;960;9189;144023;200481;46746
FR;9;2023-01-09;16;15;87;623;9;62;615;1276;586;1235;1556;13935;142558;969;9251;144638;201757;47332
FR;9;2023-01-10;13;12;154;979;11;74;1033;1990;871;1248;1568;14089;143537;980;9325;145671;203747;48203
FR;9;2023-01-11;19;9;74;680;10;49;689;1387;643;1267;1577;14163;144217;990;9374;146360;205134;48846
FR;9;2023-01-12;21;9;92;845;3;77;823;1688;775;1288;1586;14255;145062;993;9451;147183;206822;49621
FR;9;2023-01-13;15;19;106;888;12;73;910;1784;785;1303;1605;14361;145950;1005;9524;148093;208606;50406
FR;9;2023-01-14;9;9;55;294;5;33;299;585;247;1312;1614;14416;146244;1010;9557;148392;209191;50653
FR;9;2023-01-15;1;3;15;37;0;9;41;82;32;1313;1617;14431;146281;1010;9566;148433;209273;50685
FR;9;2023-01-16;6;15;54;366;13;24;383;785;371;1319;1632;14485;146647;1023;9590;148816;210058;51056
FR;9;2023-01-17;7;9;83;563;4;49;577;1244;609;1326;1641;14568;147210;1027;9639;149393;211302;51665
FR;9;2023-01-18;8;14;37;380;6;32;397;841;405;1334;1655;14605;147590;1033;9671;149790;212143;52070
FR;9;2023-01-19;10;9;58;477;8;30;478;1088;569;1344;1664;14663;148067;1041;9701;150268;213231;52639
FR;9;2023-01-20;15;19;96;578;16;57;595;1190;534;1359;1683;14759;148645;1057;9758;150863;214421;53173
FR;9;2023-01-21;8;15;20;192;11;13;190;347;140;1367;1698;14779;148837;1068;9771;151053;214768;53313
FR;9;2023-01-22;0;0;8;20;0;5;21;42;16;1367;1698;14787;148857;1068;9776;151074;214810;53329
FR;9;2023-01-23;4;15;27;253;9;25;242;563;287;1371;1713;14814;149110;1077;9801;151316;215373;53616
FR;9;2023-01-24;11;10;70;461;9;42;484;1162;633;1382;1723;14884;149571;1086;9843;151800;216535;54249
FR;9;2023-01-25;11;20;50;325;9;47;336;798;410;1393;1743;14934;149896;1095;9890;152136;217333;54659
FR;9;2023-01-26;7;17;64;391;8;50;390;967;515;1400;1760;14998;150287;1103;9940;152526;218300;55174
FR;9;2023-01-27;4;7;59;381;3;31;397;906;462;1404;1767;15057;150668;1106;9971;152923;219206;55636
FR;9;2023-01-28;3;6;31;128;5;27;120;265;116;1407;1773;15088;150796;1111;9998;153043;219471;55752
FR;9;2023-01-29;3;0;3;18;2;1;17;40;22;1410;1773;15091;150814;1113;9999;153060;219511;55774
FR;9;2023-01-30;4;6;31;192;5;11;211;501;272;1414;1779;15122;151006;1118;10010;153271;220012;56046
FR;9;2023-01-31;14;7;38;260;8;18;264;649;359;1428;1786;15160;151266;1126;10028;153535;220661;56405
FR;9;2023-02-01;5;7;26;173;4;20;179;519;309;1433;1793;15186;151439;1130;10048;153714;221180;56714
FR;9;2023-02-02;4;6;31;252;6;23;233;666;395;1437;1799;15217;151691;1136;10071;153947;221846;57109
FR;9;2023-02-03;8;13;42;289;10;37;275;677;355;1445;1812;15259;151980;1146;10108;154222;222523;57464
FR;9;2023-02-04;6;5;10;70;7;8;68;160;84;1451;1817;15269;152050;1153;10116;154290;222683;57548
FR;9;2023-02-05;1;1;4;7;0;4;7;17;6;1452;1818;15273;152057;1153;10120;154297;222700;57554
FR;9;2023-02-06;3;5;17;81;4;15;78;229;134;1455;1823;15290;152138;1157;10135;154375;222929;57688
FR;9;2023-02-07;3;5;30;145;3;21;138;451;285;1458;1828;15320;152283;1160;10156;154513;223380;57973
FR;9;2023-02-08;4;6;25;116;3;13;125;301;160;1462;1834;15345;152399;1163;10169;154638;223681;58133
FR;9;2023-02-09;8;3;20;138;4;14;123;343;202;1470;1837;15365;152537;1167;10183;154761;224024;58335
FR;9;2023-02-10;8;8;19;149;10;11;145;315;153;1478;1845;15384;152686;1177;10194;154906;224339;58488
FR;9;2023-02-11;5;4;14;42;3;9;47;84;28;1483;1849;15398;152728;1180;10203;154953;224423;58516
FR;9;2023-02-12;0;0;0;1;0;0;1;8;7;1483;1849;15398;152729;1180;10203;154954;224431;58523
FR;9;2023-02-13;3;8;5;50;8;4;45;107;55;1486;1857;15403;152779;1188;10207;154999;224538;58578
FR;9;2023-02-14;10;10;16;66;10;13;63;225;146;1496;1867;15419;152845;1198;10220;155062;224763;58724
FR;9;2023-02-15;1;5;17;52;3;13;50;163;99;1497;1872;15436;152897;1201;10233;155112;224926;58823
FR;9;2023-02-16;4;6;19;77;1;17;78;197;93;1501;1878;15455;152974;1202;10250;155190;225123;58916
FR;9;2023-02-17;6;4;15;62;5;11;64;178;99;1507;1882;15470;153036;1207;10261;155254;225301;59015
FR;9;2023-02-18;1;5;1;30;5;3;25;58;29;1508;1887;15471;153066;1212;10264;155279;225359;59044
FR;9;2023-02-19;1;0;0;1;0;0;1;3;2;1509;1887;15471;153067;1212;10264;155280;225362;59046
FR;9;2023-02-20;2;3;9;60;2;6;60;123;55;1511;1890;15480;153127;1214;10270;155340;225485;59101
FR;9;2023-02-21;6;9;11;65;7;10;65;160;83;1517;1899;15491;153192;1221;10280;155405;225645;59184
FR;9;2023-02-22;2;4;18;70;3;13;72;210;118;1519;1903;15509;153262;1224;10293;155477;225855;59302
FR;9;2023-02-23;5;3;17;63;1;12;69;146;61;1524;1906;15526;153325;1225;10305;155546;226001;59363
FR;9;2023-02-24;6;5;13;80;6;8;83;211;114;1530;1911;15539;153405;1231;10313;155629;226212;59477
FR;9;2023-02-25;2;2;10;14;4;4;23;43;16;1532;1913;15549;153419;1235;10317;155652;226255;59493
FR;9;2023-02-26;3;1;0;4;3;1;4;5;0;1535;1914;15549;153423;1238;10318;155656;226260;59493
FR;9;2023-02-27;2;3;5;17;3;2;19;49;26;1537;1917;15554;153440;1241;10320;155675;226309;59519
FR;9;2023-02-28;7;13;18;55;11;16;58;155;76;1544;1930;15572;153495;1252;10336;155733;226464;59595
FR;9;2023-03-01;0;9;6;20;7;7;20;78;48;1544;1939;15578;153515;1259;10343;155753;226542;59643
FR;9;2023-03-02;0;1;7;31;1;2;36;80;41;1544;1940;15585;153546;1260;10345;155789;226622;59684
FR;9;2023-03-03;1;4;9;47;3;7;48;122;67;1545;1944;15594;153593;1263;10352;155837;226744;59751
FR;9;2023-03-04;1;2;7;19;1;4;25;41;10;1546;1946;15601;153612;1264;10356;155862;226785;59761
FR;9;2023-03-05;0;1;1;0;1;0;1;8;7;1546;1947;15602;153612;1265;10356;155863;226793;59768
FR;9;2023-03-06;1;6;6;8;3;6;9;35;19;1547;1953;15608;153620;1268;10362;155872;226828;59787
FR;9;2023-03-07;2;4;8;20;0;9;24;69;34;1549;1957;15616;153640;1268;10371;155896;226897;59821
FR;9;2023-03-08;2;4;10;6;4;4;13;39;20;1551;1961;15626;153646;1272;10375;155909;226936;59841
FR;9;2023-03-09;1;3;9;12;2;6;17;65;42;1552;1964;15635;153658;1274;10381;155926;227001;59883
FR;9;2023-03-10;3;3;6;23;3;4;20;73;47;1555;1967;15641;153681;1277;10385;155946;227074;59930
FR;9;2023-03-11;2;3;4;8;2;1;11;15;3;1557;1970;15645;153689;1279;10386;155957;227089;59933
FR;9;2023-03-12;0;1;0;0;1;0;0;0;0;1557;1971;15645;153689;1280;10386;155957;227089;59933
FR;9;2023-03-13;3;6;9;34;4;4;14;49;29;1560;1977;15654;153723;1284;10390;155971;227138;59962
FR;9;2023-03-14;3;3;7;27;1;6;29;79;41;1563;1980;15661;153750;1285;10396;156000;227217;60003
FR;9;2023-03-15;0;6;4;15;4;4;17;48;25;1563;1986;15665;153765;1289;10400;156017;227265;60028
FR;9;2023-03-16;0;9;7;15;5;8;15;77;52;1563;1995;15672;153780;1294;10408;156032;227342;60080
FR;9;2023-03-17;0;7;6;40;3;8;27;113;71;1563;2002;15678;153820;1297;10416;156059;227455;60151
FR;9;2023-03-18;2;2;5;13;1;4;16;48;26;1565;2004;15683;153833;1298;10420;156075;227503;60177
FR;9;2023-03-19;0;1;0;0;1;0;0;0;0;1565;2005;15683;153833;1299;10420;156075;227503;60177
FR;9;2023-03-20;3;7;1;25;6;1;13;54;40;1568;2012;15684;153858;1305;10421;156088;227557;60217
FR;9;2023-03-21;1;1;6;16;1;1;21;69;47;1569;2013;15690;153874;1306;10422;156109;227626;60264
FR;9;2023-03-22;1;2;4;19;2;2;22;78;49;1570;2015;15694;153893;1308;10424;156131;227704;60313
FR;9;2023-03-23;0;6;7;22;4;7;21;56;25;1570;2021;15701;153915;1312;10431;156152;227760;60338
FR;9;2023-03-24;2;2;5;25;2;5;26;53;19;1572;2023;15706;153940;1314;10436;156178;227813;60357
FR;9;2023-03-25;0;0;4;6;0;3;8;16;5;1572;2023;15710;153946;1314;10439;156186;227829;60362
FR;9;2023-03-26;0;1;0;0;0;1;0;2;1;1572;2024;15710;153946;1314;10440;156186;227831;60363
FR;9;2023-03-27;0;3;4;8;2;2;12;32;15;1572;2027;15714;153954;1316;10442;156198;227863;60378
FR;9;2023-03-28;5;13;6;17;12;7;16;49;22;1577;2040;15720;153971;1328;10449;156214;227912;60400
FR;9;2023-03-29;3;6;8;5;2;8;8;28;12;1580;2046;15728;153976;1330;10457;156222;227940;60412
FR;9;2023-03-30;2;2;2;17;2;3;17;43;20;1582;2048;15730;153993;1332;10460;156239;227983;60432
FR;9;2023-03-31;1;3;2;18;1;6;15;45;22;1583;2051;15732;154011;1333;10466;156254;228028;60454
FR;9;2023-04-01;0;1;5;2;0;4;5;12;3;1583;2052;15737;154013;1333;10470;156259;228040;60457
FR;9;2023-04-02;3;1;1;0;0;2;0;4;2;1586;2053;15738;154013;1333;10472;156259;228044;60459
FR;9;2023-04-03;0;1;3;13;0;4;10;53;34;1586;2054;15741;154026;1333;10476;156269;228097;60493
FR;9;2023-04-04;4;4;11;18;2;7;22;61;29;1590;2058;15752;154044;1335;10483;156291;228158;60522
FR;9;2023-04-05;0;2;5;27;1;3;32;78;39;1590;2060;15757;154071;1336;10486;156323;228236;60561
FR;9;2023-04-06;0;0;4;13;0;2;16;42;23;1590;2060;15761;154084;1336;10488;156339;228278;60584
FR;9;2023-04-07;1;6;1;7;2;4;7;34;19;1591;2066;15762;154091;1338;10492;156346;228312;60603
FR;9;2023-04-08;0;1;2;1;0;1;3;7;2;1591;2067;15764;154092;1338;10493;156349;228319;60605
FR;9;2023-04-09;0;1;0;0;1;0;0;2;1;1591;2068;15764;154092;1339;10493;156349;228321;60606
FR;9;2023-04-10;0;1;1;5;1;1;5;6;0;1591;2069;15765;154097;1340;10494;156354;228327;60606
FR;9;2023-04-11;2;5;4;9;4;3;8;22;8;1593;2074;15769;154106;1344;10497;156362;228349;60614
FR;9;2023-04-12;1;2;6;8;2;4;10;41;24;1594;2076;15775;154114;1346;10501;156372;228390;60638
FR;9;2023-04-13;0;0;2;4;0;2;4;15;9;1594;2076;15777;154118;1346;10503;156376;228405;60647
FR;9;2023-04-14;1;4;7;10;1;6;12;38;13;1595;2080;15784;154128;1347;10509;156388;228443;60660
FR;9;2023-04-15;0;1;2;2;1;1;2;7;4;1595;2081;15786;154130;1348;10510;156390;228450;60664
FR;9;2023-04-16;0;1;0;0;1;0;0;0;0;1595;2082;15786;154130;1349;10510;156390;228450;60664
FR;9;2023-04-17;1;2;7;11;2;3;14;45;21;1596;2084;15793;154141;1351;10513;156404;228495;60685
FR;9;2023-04-18;2;1;3;8;1;2;9;34;21;1598;2085;15796;154149;1352;10515;156413;228529;60706
FR;9;2023-04-19;1;0;2;4;0;2;4;28;16;1599;2085;15798;154153;1352;10517;156417;228557;60722
FR;9;2023-04-20;1;0;2;6;0;2;6;24;13;1600;2085;15800;154159;1352;10519;156423;228581;60735
FR;9;2023-04-21;0;2;2;5;1;3;8;31;15;1600;2087;15802;154164;1353;10522;156431;228612;60750
FR;9;2023-04-22;0;1;0;2;1;0;2;3;1;1600;2088;15802;154166;1354;10522;156433;228615;60751
FR;9;2023-04-23;0;0;0;0;0;0;0;1;0;1600;2088;15802;154166;1354;10522;156433;228616;60751
FR;9;2023-04-24;1;3;3;13;3;3;11;26;9;1601;2091;15805;154179;1357;10525;156444;228642;60760
FR;9;2023-04-25;1;2;5;11;2;1;16;87;43;1602;2093;15810;154190;1359;10526;156460;228729;60803
FR;9;2023-04-26;5;0;4;9;0;5;4;13;3;1607;2093;15814;154199;1359;10531;156464;228742;60806
FR;9;2023-04-27;0;2;4;2;2;4;1;9;3;1607;2095;15818;154201;1361;10535;156465;228751;60809
FR;9;2023-04-28;0;0;0;0;0;0;0;4;4;1607;2095;15818;154201;1361;10535;156465;228755;60813
FR;9;2023-04-29;1;2;2;0;1;1;3;8;3;1608;2097;15820;154201;1362;10536;156468;228763;60816
FR;9;2023-04-30;0;1;0;0;1;0;0;0;0;1608;2098;15820;154201;1363;10536;156468;228763;60816
FR;9;2023-05-01;0;0;0;0;0;0;0;0;0;1608;2098;15820;154201;1363;10536;156468;228763;60816
FR;9;2023-05-02;1;1;3;2;0;3;3;18;7;1609;2099;15823;154203;1363;10539;156471;228781;60823
FR;9;2023-05-03;2;2;2;2;1;3;2;9;3;1611;2101;15825;154205;1364;10542;156473;228790;60826
FR;9;2023-05-04;0;1;2;2;1;2;3;9;2;1611;2102;15827;154207;1365;10544;156476;228799;60828
FR;9;2023-05-05;0;1;2;1;1;0;3;19;11;1611;2103;15829;154208;1366;10544;156479;228818;60839
FR;9;2023-05-06;0;1;0;0;1;0;0;3;2;1611;2104;15829;154208;1367;10544;156479;228821;60841
FR;9;2023-05-07;0;1;0;0;0;1;0;1;0;1611;2105;15829;154208;1367;10545;156479;228822;60841
FR;9;2023-05-08;0;0;0;0;0;0;0;0;0;1611;2105;15829;154208;1367;10545;156479;228822;60841
FR;9;2023-05-09;0;1;3;16;1;3;14;45;28;1611;2106;15832;154224;1368;10548;156493;228867;60869
FR;9;2023-05-10;1;0;0;0;0;1;0;9;3;1612;2106;15832;154224;1368;10549;156493;228876;60872
FR;9;2023-05-11;0;0;1;0;0;1;0;7;5;1612;2106;15833;154224;1368;10550;156493;228883;60877
FR;9;2023-05-12;1;1;4;1;0;3;3;14;7;1613;2107;15837;154225;1368;10553;156496;228897;60884
FR;9;2023-05-13;0;0;0;0;0;0;0;2;1;1613;2107;15837;154225;1368;10553;156496;228899;60885
FR;9;2023-05-14;0;0;0;0;0;0;0;0;0;1613;2107;15837;154225;1368;10553;156496;228899;60885
FR;9;2023-05-15;0;0;0;1;0;0;1;9;2;1613;2107;15837;154226;1368;10553;156497;228908;60887
FR;9;2023-05-16;0;1;0;3;1;0;3;11;4;1613;2108;15837;154229;1369;10553;156500;228919;60891
FR;9;2023-05-17;0;0;1;4;0;1;3;7;0;1613;2108;15838;154233;1369;10554;156503;228926;60891
FR;9;2023-05-18;0;0;0;0;0;0;0;0;0;1613;2108;15838;154233;1369;10554;156503;228926;60891
FR;9;2023-05-19;0;1;1;1;1;0;2;6;4;1613;2109;15839;154234;1370;10554;156505;228932;60895
FR;9;2023-05-20;0;0;0;0;0;0;0;2;0;1613;2109;15839;154234;1370;10554;156505;228934;60895
FR;9;2023-05-21;0;0;0;0;0;0;0;0;0;1613;2109;15839;154234;1370;10554;156505;228934;60895
FR;9;2023-05-22;0;1;0;0;1;0;0;4;4;1613;2110;15839;154234;1371;10554;156505;228938;60899
FR;9;2023-05-23;1;1;0;1;0;1;1;10;3;1614;2111;15839;154235;1371;10555;156506;228948;60902
FR;9;2023-05-24;0;1;0;2;1;0;2;4;0;1614;2112;15839;154237;1372;10555;156508;228952;60902
FR;9;2023-05-25;0;0;0;0;0;0;0;3;0;1614;2112;15839;154237;1372;10555;156508;228955;60902
FR;9;2023-05-26;0;0;2;4;0;3;2;14;8;1614;2112;15841;154241;1372;10558;156510;228969;60910
FR;9;2023-05-27;0;0;0;0;0;0;0;0;0;1614;2112;15841;154241;1372;10558;156510;228969;60910
FR;9;2023-05-28;0;0;0;0;0;0;0;0;0;1614;2112;15841;154241;1372;10558;156510;228969;60910
FR;9;2023-05-29;0;0;0;0;0;0;0;0;0;1614;2112;15841;154241;1372;10558;156510;228969;60910
FR;9;2023-05-30;0;0;1;1;0;0;1;15;9;1614;2112;15842;154242;1372;10558;156511;228984;60919
FR;9;2023-05-31;0;0;2;1;0;1;0;5;1;1614;2112;15844;154243;1372;10559;156511;228989;60920
FR;9;2023-06-01;0;0;0;1;0;0;1;8;5;1614;2112;15844;154244;1372;10559;156512;228997;60925
FR;9;2023-06-02;0;0;1;2;0;1;2;15;6;1614;2112;15845;154246;1372;10560;156514;229012;60931
FR;9;2023-06-03;0;0;1;2;0;0;6;9;3;1614;2112;15846;154248;1372;10560;156520;229021;60934
FR;9;2023-06-04;0;0;0;0;0;0;0;0;0;1614;2112;15846;154248;1372;10560;156520;229021;60934
FR;9;2023-06-05;0;0;0;0;0;0;0;1;0;1614;2112;15846;154248;1372;10560;156520;229022;60934
FR;9;2023-06-06;0;0;0;0;0;0;0;9;3;1614;2112;15846;154248;1372;10560;156520;229031;60937
FR;9;2023-06-07;0;0;0;2;0;0;2;8;3;1614;2112;15846;154250;1372;10560;156522;229039;60940
FR;9;2023-06-08;0;0;1;1;0;1;1;7;4;1614;2112;15847;154251;1372;10561;156523;229046;60944
FR;9;2023-06-09;0;0;0;0;0;0;1;10;1;1614;2112;15847;154251;1372;10561;156524;229056;60945
FR;9;2023-06-10;0;1;1;1;0;1;2;8;1;1614;2113;15848;154252;1372;10562;156526;229064;60946
FR;9;2023-06-11;0;0;0;0;0;0;0;0;0;1614;2113;15848;154252;1372;10562;156526;229064;60946
FR;9;2023-06-12;0;0;0;0;0;0;0;4;3;1614;2113;15848;154252;1372;10562;156526;229068;60949
FR;9;2023-06-13;0;0;0;0;0;0;0;4;3;1614;2113;15848;154252;1372;10562;156526;229072;60952
FR;9;2023-06-14;0;0;0;0;0;0;0;2;1;1614;2113;15848;154252;1372;10562;156526;229074;60953
FR;9;2023-06-15;0;0;0;2;0;0;2;9;2;1614;2113;15848;154254;1372;10562;156528;229083;60955
FR;9;2023-06-16;0;1;0;1;1;0;1;12;10;1614;2114;15848;154255;1373;10562;156529;229095;60965
FR;9;2023-06-17;0;0;0;0;0;0;0;4;1;1614;2114;15848;154255;1373;10562;156529;229099;60966
FR;9;2023-06-18;0;0;0;0;0;0;0;0;0;1614;2114;15848;154255;1373;10562;156529;229099;60966
FR;9;2023-06-19;0;0;0;0;0;0;0;9;2;1614;2114;15848;154255;1373;10562;156529;229108;60968
FR;9;2023-06-20;0;0;0;1;0;0;2;9;4;1614;2114;15848;154256;1373;10562;156531;229117;60972
FR;9;2023-06-21;0;0;1;2;0;1;2;8;2;1614;2114;15849;154258;1373;10563;156533;229125;60974
FR;9;2023-06-22;0;0;0;2;0;0;1;9;3;1614;2114;15849;154260;1373;10563;156534;229134;60977
FR;9;2023-06-23;0;0;0;1;0;0;1;6;0;1614;2114;15849;154261;1373;10563;156535;229140;60977
FR;9;2023-06-24;0;0;0;1;0;1;3;6;2;1614;2114;15849;154262;1373;10564;156538;229146;60979
FR;9;2023-06-25;0;0;0;0;0;0;0;0;0;1614;2114;15849;154262;1373;10564;156538;229146;60979
FR;9;2023-06-26;0;0;0;0;0;0;0;3;0;1614;2114;15849;154262;1373;10564;156538;229149;60979
FR;9;2023-06-27;0;0;0;0;0;0;0;2;1;1614;2114;15849;154262;1373;10564;156538;229151;60980
FR;9;2023-06-28;0;0;0;0;0;1;0;5;2;1614;2114;15849;154262;1373;10565;156538;229156;60982
FR;9;2023-06-29;0;0;0;0;0;0;0;3;1;1614;2114;15849;154262;1373;10565;156538;229159;60983
FR;9;2023-06-30;0;0;0;0;0;0;0;7;3;1614;2114;15849;154262;1373;10565;156538;229166;60986
FR;9;2023-07-01;0;0;0;0;0;0;0;3;1;1614;2114;15849;154262;1373;10565;156538;229169;60987
FR;9;2023-07-02;0;0;0;0;0;0;0;0;0;1614;2114;15849;154262;1373;10565;156538;229169;60987
FR;9;2023-07-03;0;0;0;0;0;0;0;3;3;1614;2114;15849;154262;1373;10565;156538;229172;60990
FR;9;2023-07-04;0;0;0;0;0;0;2;3;0;1614;2114;15849;154262;1373;10565;156540;229175;60990
FR;9;2023-07-05;0;0;1;0;0;1;0;6;3;1614;2114;15850;154262;1373;10566;156540;229181;60993
FR;9;2023-07-06;0;0;0;1;0;0;0;4;1;1614;2114;15850;154263;1373;10566;156540;229185;60994
FR;9;2023-07-07;0;0;0;0;0;0;0;6;3;1614;2114;15850;154263;1373;10566;156540;229191;60997
FR;9;2023-07-08;0;0;0;0;0;0;0;2;0;1614;2114;15850;154263;1373;10566;156540;229193;60997
FR;9;2023-07-09;0;0;0;0;0;0;0;0;0;1614;2114;15850;154263;1373;10566;156540;229193;60997
FR;9;2023-07-10;0;0;0;1;0;0;1;1;0;1614;2114;15850;154264;1373;10566;156541;229194;60997
FR;10;2020-12-27;0;0;0;0;0;0;0;0;0;0;0;0;0;0;0;0;0;0
FR;10;2020-12-28;0;0;0;0;0;0;0;0;0;0;0;0;0;0;0;0;0;0
FR;10;2020-12-29;0;0;0;0;0;0;0;0;0;0;0;0;0;0;0;0;0;0
FR;10;2020-12-30;0;0;0;0;0;0;0;0;0;0;0;0;0;0;0;0;0;0
FR;10;2020-12-31;0;0;0;0;0;0;0;0;0;0;0;0;0;0;0;0;0;0
FR;10;2021-01-01;0;0;0;0;0;0;0;0;0;0;0;0;0;0;0;0;0;0
FR;10;2021-01-02;0;0;0;0;0;0;0;0;0;0;0;0;0;0;0;0;0;0
FR;10;2021-01-03;0;0;0;0;0;0;0;0;0;0;0;0;0;0;0;0;0;0
FR;10;2021-01-04;0;0;0;0;0;0;0;0;0;0;0;0;0;0;0;0;0;0
FR;10;2021-01-05;0;0;0;0;0;0;0;0;0;0;0;0;0;0;0;0;0;0
FR;10;2021-01-06;0;0;0;0;0;0;0;0;0;0;0;0;0;0;0;0;0;0
FR;10;2021-01-07;0;0;0;0;0;0;0;0;0;0;0;0;0;0;0;0;0;0
FR;10;2021-01-08;0;0;0;0;0;0;0;0;0;0;0;0;0;0;0;0;0;0
FR;10;2021-01-09;0;0;0;0;0;0;0;0;0;0;0;0;0;0;0;0;0;0
FR;10;2021-01-10;0;0;0;0;0;0;0;0;0;0;0;0;0;0;0;0;0;0
FR;10;2021-01-11;0;0;0;0;0;0;0;0;0;0;0;0;0;0;0;0;0;0
FR;10;2021-01-12;0;0;0;0;0;0;0;0;0;0;0;0;0;0;0;0;0;0
FR;10;2021-01-13;0;0;0;0;0;0;0;0;0;0;0;0;0;0;0;0;0;0
FR;10;2021-01-14;0;0;0;0;0;0;0;0;0;0;0;0;0;0;0;0;0;0
FR;10;2021-01-15;0;0;0;0;0;0;0;0;0;0;0;0;0;0;0;0;0;0
FR;10;2021-01-16;0;0;0;0;0;0;0;0;0;0;0;0;0;0;0;0;0;0
FR;10;2021-01-17;0;0;0;0;0;0;0;0;0;0;0;0;0;0;0;0;0;0
FR;10;2021-01-18;0;0;0;0;0;0;0;0;0;0;0;0;0;0;0;0;0;0
FR;10;2021-01-19;0;0;0;0;0;0;0;0;0;0;0;0;0;0;0;0;0;0
FR;10;2021-01-20;0;0;0;0;0;0;0;0;0;0;0;0;0;0;0;0;0;0
FR;10;2021-01-21;0;0;0;0;0;0;0;0;0;0;0;0;0;0;0;0;0;0
FR;10;2021-01-22;0;0;0;0;0;0;0;0;0;0;0;0;0;0;0;0;0;0
FR;10;2021-01-23;0;0;0;0;0;0;0;0;0;0;0;0;0;0;0;0;0;0
FR;10;2021-01-24;0;0;0;0;0;0;0;0;0;0;0;0;0;0;0;0;0;0
FR;10;2021-01-25;0;0;0;0;0;0;0;0;0;0;0;0;0;0;0;0;0;0
FR;10;2021-01-26;0;0;0;0;0;0;0;0;0;0;0;0;0;0;0;0;0;0
FR;10;2021-01-27;0;0;0;0;0;0;0;0;0;0;0;0;0;0;0;0;0;0
FR;10;2021-01-28;0;0;0;0;0;0;0;0;0;0;0;0;0;0;0;0;0;0
FR;10;2021-01-29;0;0;0;0;0;0;0;0;0;0;0;0;0;0;0;0;0;0
FR;10;2021-01-30;0;0;0;0;0;0;0;0;0;0;0;0;0;0;0;0;0;0
FR;10;2021-01-31;0;0;0;0;0;0;0;0;0;0;0;0;0;0;0;0;0;0
FR;10;2021-02-01;0;0;0;0;0;0;0;0;0;0;0;0;0;0;0;0;0;0
FR;10;2021-02-02;0;0;0;0;0;0;0;0;0;0;0;0;0;0;0;0;0;0
FR;10;2021-02-03;0;0;0;0;0;0;0;0;0;0;0;0;0;0;0;0;0;0
FR;10;2021-02-04;0;0;0;0;0;0;0;0;0;0;0;0;0;0;0;0;0;0
FR;10;2021-02-05;0;0;0;0;0;0;0;0;0;0;0;0;0;0;0;0;0;0
FR;10;2021-02-06;0;0;0;0;0;0;0;0;0;0;0;0;0;0;0;0;0;0
FR;10;2021-02-07;0;0;0;0;0;0;0;0;0;0;0;0;0;0;0;0;0;0
FR;10;2021-02-08;0;0;0;0;0;0;0;0;0;0;0;0;0;0;0;0;0;0
FR;10;2021-02-09;0;0;0;0;0;0;0;0;0;0;0;0;0;0;0;0;0;0
FR;10;2021-02-10;0;0;0;0;0;0;0;0;0;0;0;0;0;0;0;0;0;0
FR;10;2021-02-11;0;0;0;0;0;0;0;0;0;0;0;0;0;0;0;0;0;0
FR;10;2021-02-12;0;0;0;0;0;0;0;0;0;0;0;0;0;0;0;0;0;0
FR;10;2021-02-13;0;0;0;0;0;0;0;0;0;0;0;0;0;0;0;0;0;0
FR;10;2021-02-14;0;0;0;0;0;0;0;0;0;0;0;0;0;0;0;0;0;0
FR;10;2021-02-15;0;0;0;0;0;0;0;0;0;0;0;0;0;0;0;0;0;0
FR;10;2021-02-16;0;0;0;0;0;0;0;0;0;0;0;0;0;0;0;0;0;0
FR;10;2021-02-17;0;0;0;0;0;0;0;0;0;0;0;0;0;0;0;0;0;0
FR;10;2021-02-18;0;0;0;0;0;0;0;0;0;0;0;0;0;0;0;0;0;0
FR;10;2021-02-19;0;0;0;0;0;0;0;0;0;0;0;0;0;0;0;0;0;0
FR;10;2021-02-20;0;0;0;0;0;0;0;0;0;0;0;0;0;0;0;0;0;0
FR;10;2021-02-21;0;0;0;0;0;0;0;0;0;0;0;0;0;0;0;0;0;0
FR;10;2021-02-22;0;0;0;0;0;0;0;0;0;0;0;0;0;0;0;0;0;0
FR;10;2021-02-23;0;0;0;0;0;0;0;0;0;0;0;0;0;0;0;0;0;0
FR;10;2021-02-24;0;0;0;0;0;0;0;0;0;0;0;0;0;0;0;0;0;0
FR;10;2021-02-25;0;0;0;0;0;0;0;0;0;0;0;0;0;0;0;0;0;0
FR;10;2021-02-26;0;0;0;0;0;0;0;0;0;0;0;0;0;0;0;0;0;0
FR;10;2021-02-27;0;0;0;0;0;0;0;0;0;0;0;0;0;0;0;0;0;0
FR;10;2021-02-28;0;0;0;0;0;0;0;0;0;0;0;0;0;0;0;0;0;0
FR;10;2021-03-01;0;0;0;0;0;0;0;0;0;0;0;0;0;0;0;0;0;0
FR;10;2021-03-02;0;0;0;0;0;0;0;0;0;0;0;0;0;0;0;0;0;0
FR;10;2021-03-03;0;0;0;0;0;0;0;0;0;0;0;0;0;0;0;0;0;0
FR;10;2021-03-04;0;0;0;0;0;0;0;0;0;0;0;0;0;0;0;0;0;0
FR;10;2021-03-05;0;0;0;0;0;0;0;0;0;0;0;0;0;0;0;0;0;0
FR;10;2021-03-06;0;0;0;0;0;0;0;0;0;0;0;0;0;0;0;0;0;0
FR;10;2021-03-07;0;0;0;0;0;0;0;0;0;0;0;0;0;0;0;0;0;0
FR;10;2021-03-08;0;0;0;0;0;0;0;0;0;0;0;0;0;0;0;0;0;0
FR;10;2021-03-09;0;0;0;0;0;0;0;0;0;0;0;0;0;0;0;0;0;0
FR;10;2021-03-10;0;0;0;0;0;0;0;0;0;0;0;0;0;0;0;0;0;0
FR;10;2021-03-11;0;0;0;0;0;0;0;0;0;0;0;0;0;0;0;0;0;0
FR;10;2021-03-12;0;0;0;0;0;0;0;0;0;0;0;0;0;0;0;0;0;0
FR;10;2021-03-13;0;0;0;0;0;0;0;0;0;0;0;0;0;0;0;0;0;0
FR;10;2021-03-14;0;0;0;0;0;0;0;0;0;0;0;0;0;0;0;0;0;0
FR;10;2021-03-15;0;0;0;0;0;0;0;0;0;0;0;0;0;0;0;0;0;0
FR;10;2021-03-16;0;0;0;0;0;0;0;0;0;0;0;0;0;0;0;0;0;0
FR;10;2021-03-17;0;0;0;0;0;0;0;0;0;0;0;0;0;0;0;0;0;0
FR;10;2021-03-18;0;0;0;0;0;0;0;0;0;0;0;0;0;0;0;0;0;0
FR;10;2021-03-19;0;0;0;0;0;0;0;0;0;0;0;0;0;0;0;0;0;0
FR;10;2021-03-20;0;0;0;0;0;0;0;0;0;0;0;0;0;0;0;0;0;0
FR;10;2021-03-21;0;0;0;0;0;0;0;0;0;0;0;0;0;0;0;0;0;0
FR;10;2021-03-22;0;0;0;0;0;0;0;0;0;0;0;0;0;0;0;0;0;0
FR;10;2021-03-23;0;0;0;0;0;0;0;0;0;0;0;0;0;0;0;0;0;0
FR;10;2021-03-24;0;0;0;0;0;0;0;0;0;0;0;0;0;0;0;0;0;0
FR;10;2021-03-25;0;0;0;0;0;0;0;0;0;0;0;0;0;0;0;0;0;0
FR;10;2021-03-26;0;0;0;0;0;0;0;0;0;0;0;0;0;0;0;0;0;0
FR;10;2021-03-27;0;0;0;0;0;0;0;0;0;0;0;0;0;0;0;0;0;0
FR;10;2021-03-28;0;0;0;0;0;0;0;0;0;0;0;0;0;0;0;0;0;0
FR;10;2021-03-29;0;0;0;0;0;0;0;0;0;0;0;0;0;0;0;0;0;0
FR;10;2021-03-30;0;0;0;0;0;0;0;0;0;0;0;0;0;0;0;0;0;0
FR;10;2021-03-31;0;0;0;0;0;0;0;0;0;0;0;0;0;0;0;0;0;0
FR;10;2021-04-01;0;0;0;0;0;0;0;0;0;0;0;0;0;0;0;0;0;0
FR;10;2021-04-02;0;0;0;0;0;0;0;0;0;0;0;0;0;0;0;0;0;0
FR;10;2021-04-03;0;0;0;0;0;0;0;0;0;0;0;0;0;0;0;0;0;0
FR;10;2021-04-04;0;0;0;0;0;0;0;0;0;0;0;0;0;0;0;0;0;0
FR;10;2021-04-05;0;0;0;0;0;0;0;0;0;0;0;0;0;0;0;0;0;0
FR;10;2021-04-06;0;0;0;0;0;0;0;0;0;0;0;0;0;0;0;0;0;0
FR;10;2021-04-07;0;0;0;0;0;0;0;0;0;0;0;0;0;0;0;0;0;0
FR;10;2021-04-08;0;0;0;0;0;0;0;0;0;0;0;0;0;0;0;0;0;0
FR;10;2021-04-09;0;0;0;0;0;0;0;0;0;0;0;0;0;0;0;0;0;0
FR;10;2021-04-10;0;0;0;0;0;0;0;0;0;0;0;0;0;0;0;0;0;0
FR;10;2021-04-11;0;0;0;0;0;0;0;0;0;0;0;0;0;0;0;0;0;0
FR;10;2021-04-12;0;0;0;0;0;0;0;0;0;0;0;0;0;0;0;0;0;0
FR;10;2021-04-13;0;0;0;0;0;0;0;0;0;0;0;0;0;0;0;0;0;0
FR;10;2021-04-14;0;0;0;0;0;0;0;0;0;0;0;0;0;0;0;0;0;0
FR;10;2021-04-15;0;0;0;0;0;0;0;0;0;0;0;0;0;0;0;0;0;0
FR;10;2021-04-16;0;0;0;0;0;0;0;0;0;0;0;0;0;0;0;0;0;0
FR;10;2021-04-17;0;0;0;0;0;0;0;0;0;0;0;0;0;0;0;0;0;0
FR;10;2021-04-18;0;0;0;0;0;0;0;0;0;0;0;0;0;0;0;0;0;0
FR;10;2021-04-19;0;0;0;0;0;0;0;0;0;0;0;0;0;0;0;0;0;0
FR;10;2021-04-20;0;0;0;0;0;0;0;0;0;0;0;0;0;0;0;0;0;0
FR;10;2021-04-21;0;0;0;0;0;0;0;0;0;0;0;0;0;0;0;0;0;0
FR;10;2021-04-22;0;0;0;0;0;0;0;0;0;0;0;0;0;0;0;0;0;0
FR;10;2021-04-23;0;0;0;0;0;0;0;0;0;0;0;0;0;0;0;0;0;0
FR;10;2021-04-24;0;0;0;0;0;0;0;0;0;0;0;0;0;0;0;0;0;0
FR;10;2021-04-25;0;0;0;0;0;0;0;0;0;0;0;0;0;0;0;0;0;0
FR;10;2021-04-26;0;0;0;0;0;0;0;0;0;0;0;0;0;0;0;0;0;0
FR;10;2021-04-27;0;0;0;0;0;0;0;0;0;0;0;0;0;0;0;0;0;0
FR;10;2021-04-28;0;0;0;0;0;0;0;0;0;0;0;0;0;0;0;0;0;0
FR;10;2021-04-29;0;0;0;0;0;0;0;0;0;0;0;0;0;0;0;0;0;0
FR;10;2021-04-30;0;0;0;0;0;0;0;0;0;0;0;0;0;0;0;0;0;0
FR;10;2021-05-01;0;0;0;0;0;0;0;0;0;0;0;0;0;0;0;0;0;0
FR;10;2021-05-02;0;0;0;0;0;0;0;0;0;0;0;0;0;0;0;0;0;0
FR;10;2021-05-03;0;0;0;0;0;0;0;0;0;0;0;0;0;0;0;0;0;0
FR;10;2021-05-04;0;0;0;0;0;0;0;0;0;0;0;0;0;0;0;0;0;0
FR;10;2021-05-05;0;0;0;0;0;0;0;0;0;0;0;0;0;0;0;0;0;0
FR;10;2021-05-06;0;0;0;0;0;0;0;0;0;0;0;0;0;0;0;0;0;0
FR;10;2021-05-07;0;0;0;0;0;0;0;0;0;0;0;0;0;0;0;0;0;0
FR;10;2021-05-08;0;0;0;0;0;0;0;0;0;0;0;0;0;0;0;0;0;0
FR;10;2021-05-09;0;0;0;0;0;0;0;0;0;0;0;0;0;0;0;0;0;0
FR;10;2021-05-10;0;0;0;0;0;0;0;0;0;0;0;0;0;0;0;0;0;0
FR;10;2021-05-11;0;0;0;0;0;0;0;0;0;0;0;0;0;0;0;0;0;0
FR;10;2021-05-12;0;0;0;0;0;0;0;0;0;0;0;0;0;0;0;0;0;0
FR;10;2021-05-13;0;0;0;0;0;0;0;0;0;0;0;0;0;0;0;0;0;0
FR;10;2021-05-14;0;0;0;0;0;0;0;0;0;0;0;0;0;0;0;0;0;0
FR;10;2021-05-15;0;0;0;0;0;0;0;0;0;0;0;0;0;0;0;0;0;0
FR;10;2021-05-16;0;0;0;0;0;0;0;0;0;0;0;0;0;0;0;0;0;0
FR;10;2021-05-17;0;0;0;0;0;0;0;0;0;0;0;0;0;0;0;0;0;0
FR;10;2021-05-18;0;0;0;0;0;0;0;0;0;0;0;0;0;0;0;0;0;0
FR;10;2021-05-19;0;0;0;0;0;0;0;0;0;0;0;0;0;0;0;0;0;0
FR;10;2021-05-20;0;0;0;0;0;0;0;0;0;0;0;0;0;0;0;0;0;0
FR;10;2021-05-21;0;0;0;0;0;0;0;0;0;0;0;0;0;0;0;0;0;0
FR;10;2021-05-22;0;0;0;0;0;0;0;0;0;0;0;0;0;0;0;0;0;0
FR;10;2021-05-23;0;0;0;0;0;0;0;0;0;0;0;0;0;0;0;0;0;0
FR;10;2021-05-24;0;0;0;0;0;0;0;0;0;0;0;0;0;0;0;0;0;0
FR;10;2021-05-25;0;0;0;0;0;0;0;0;0;0;0;0;0;0;0;0;0;0
FR;10;2021-05-26;0;0;0;0;0;0;0;0;0;0;0;0;0;0;0;0;0;0
FR;10;2021-05-27;0;0;0;0;0;0;0;0;0;0;0;0;0;0;0;0;0;0
FR;10;2021-05-28;0;0;0;0;0;0;0;0;0;0;0;0;0;0;0;0;0;0
FR;10;2021-05-29;0;0;0;0;0;0;0;0;0;0;0;0;0;0;0;0;0;0
FR;10;2021-05-30;0;0;0;0;0;0;0;0;0;0;0;0;0;0;0;0;0;0
FR;10;2021-05-31;0;0;0;0;0;0;0;0;0;0;0;0;0;0;0;0;0;0
FR;10;2021-06-01;0;0;0;0;0;0;0;0;0;0;0;0;0;0;0;0;0;0
FR;10;2021-06-02;0;0;0;0;0;0;0;0;0;0;0;0;0;0;0;0;0;0
FR;10;2021-06-03;0;0;0;0;0;0;0;0;0;0;0;0;0;0;0;0;0;0
FR;10;2021-06-04;0;0;0;0;0;0;0;0;0;0;0;0;0;0;0;0;0;0
FR;10;2021-06-05;0;0;0;0;0;0;0;0;0;0;0;0;0;0;0;0;0;0
FR;10;2021-06-06;0;0;0;0;0;0;0;0;0;0;0;0;0;0;0;0;0;0
FR;10;2021-06-07;0;0;0;0;0;0;0;0;0;0;0;0;0;0;0;0;0;0
FR;10;2021-06-08;0;0;0;0;0;0;0;0;0;0;0;0;0;0;0;0;0;0
FR;10;2021-06-09;0;0;0;0;0;0;0;0;0;0;0;0;0;0;0;0;0;0
FR;10;2021-06-10;0;0;0;0;0;0;0;0;0;0;0;0;0;0;0;0;0;0
FR;10;2021-06-11;0;0;0;0;0;0;0;0;0;0;0;0;0;0;0;0;0;0
FR;10;2021-06-12;0;0;0;0;0;0;0;0;0;0;0;0;0;0;0;0;0;0
FR;10;2021-06-13;0;0;0;0;0;0;0;0;0;0;0;0;0;0;0;0;0;0
FR;10;2021-06-14;0;0;0;0;0;0;0;0;0;0;0;0;0;0;0;0;0;0
FR;10;2021-06-15;0;0;0;0;0;0;0;0;0;0;0;0;0;0;0;0;0;0
FR;10;2021-06-16;0;0;0;0;0;0;0;0;0;0;0;0;0;0;0;0;0;0
FR;10;2021-06-17;0;0;0;0;0;0;0;0;0;0;0;0;0;0;0;0;0;0
FR;10;2021-06-18;0;0;0;0;0;0;0;0;0;0;0;0;0;0;0;0;0;0
FR;10;2021-06-19;0;0;0;0;0;0;0;0;0;0;0;0;0;0;0;0;0;0
FR;10;2021-06-20;0;0;0;0;0;0;0;0;0;0;0;0;0;0;0;0;0;0
FR;10;2021-06-21;0;0;0;0;0;0;0;0;0;0;0;0;0;0;0;0;0;0
FR;10;2021-06-22;0;0;0;0;0;0;0;0;0;0;0;0;0;0;0;0;0;0
FR;10;2021-06-23;0;0;0;0;0;0;0;0;0;0;0;0;0;0;0;0;0;0
FR;10;2021-06-24;0;0;0;0;0;0;0;0;0;0;0;0;0;0;0;0;0;0
FR;10;2021-06-25;0;0;0;0;0;0;0;0;0;0;0;0;0;0;0;0;0;0
FR;10;2021-06-26;0;0;0;0;0;0;0;0;0;0;0;0;0;0;0;0;0;0
FR;10;2021-06-27;0;0;0;0;0;0;0;0;0;0;0;0;0;0;0;0;0;0
FR;10;2021-06-28;0;0;0;0;0;0;0;0;0;0;0;0;0;0;0;0;0;0
FR;10;2021-06-29;0;0;0;0;0;0;0;0;0;0;0;0;0;0;0;0;0;0
FR;10;2021-06-30;0;0;0;0;0;0;0;0;0;0;0;0;0;0;0;0;0;0
FR;10;2021-07-01;0;0;0;0;0;0;0;0;0;0;0;0;0;0;0;0;0;0
FR;10;2021-07-02;0;0;0;0;0;0;0;0;0;0;0;0;0;0;0;0;0;0
FR;10;2021-07-03;0;0;0;0;0;0;0;0;0;0;0;0;0;0;0;0;0;0
FR;10;2021-07-04;0;0;0;0;0;0;0;0;0;0;0;0;0;0;0;0;0;0
FR;10;2021-07-05;0;0;0;0;0;0;0;0;0;0;0;0;0;0;0;0;0;0
FR;10;2021-07-06;0;0;0;0;0;0;0;0;0;0;0;0;0;0;0;0;0;0
FR;10;2021-07-07;0;0;0;0;0;0;0;0;0;0;0;0;0;0;0;0;0;0
FR;10;2021-07-08;0;0;0;0;0;0;0;0;0;0;0;0;0;0;0;0;0;0
FR;10;2021-07-09;0;0;0;0;0;0;0;0;0;0;0;0;0;0;0;0;0;0
FR;10;2021-07-10;0;0;0;0;0;0;0;0;0;0;0;0;0;0;0;0;0;0
FR;10;2021-07-11;0;0;0;0;0;0;0;0;0;0;0;0;0;0;0;0;0;0
FR;10;2021-07-12;0;0;0;0;0;0;0;0;0;0;0;0;0;0;0;0;0;0
FR;10;2021-07-13;0;0;0;0;0;0;0;0;0;0;0;0;0;0;0;0;0;0
FR;10;2021-07-14;0;0;0;0;0;0;0;0;0;0;0;0;0;0;0;0;0;0
FR;10;2021-07-15;0;0;0;0;0;0;0;0;0;0;0;0;0;0;0;0;0;0
FR;10;2021-07-16;0;0;0;0;0;0;0;0;0;0;0;0;0;0;0;0;0;0
FR;10;2021-07-17;0;0;0;0;0;0;0;0;0;0;0;0;0;0;0;0;0;0
FR;10;2021-07-18;0;0;0;0;0;0;0;0;0;0;0;0;0;0;0;0;0;0
FR;10;2021-07-19;0;0;0;0;0;0;0;0;0;0;0;0;0;0;0;0;0;0
FR;10;2021-07-20;0;0;0;0;0;0;0;0;0;0;0;0;0;0;0;0;0;0
FR;10;2021-07-21;0;0;0;0;0;0;0;0;0;0;0;0;0;0;0;0;0;0
FR;10;2021-07-22;0;0;0;0;0;0;0;0;0;0;0;0;0;0;0;0;0;0
FR;10;2021-07-23;0;0;0;0;0;0;0;0;0;0;0;0;0;0;0;0;0;0
FR;10;2021-07-24;0;0;0;0;0;0;0;0;0;0;0;0;0;0;0;0;0;0
FR;10;2021-07-25;0;0;0;0;0;0;0;0;0;0;0;0;0;0;0;0;0;0
FR;10;2021-07-26;0;0;0;0;0;0;0;0;0;0;0;0;0;0;0;0;0;0
FR;10;2021-07-27;0;0;0;0;0;0;0;0;0;0;0;0;0;0;0;0;0;0
FR;10;2021-07-28;0;0;0;0;0;0;0;0;0;0;0;0;0;0;0;0;0;0
FR;10;2021-07-29;0;0;0;0;0;0;0;0;0;0;0;0;0;0;0;0;0;0
FR;10;2021-07-30;0;0;0;0;0;0;0;0;0;0;0;0;0;0;0;0;0;0
FR;10;2021-07-31;0;0;0;0;0;0;0;0;0;0;0;0;0;0;0;0;0;0
FR;10;2021-08-01;0;0;0;0;0;0;0;0;0;0;0;0;0;0;0;0;0;0
FR;10;2021-08-02;0;0;0;0;0;0;0;0;0;0;0;0;0;0;0;0;0;0
FR;10;2021-08-03;0;0;0;0;0;0;0;0;0;0;0;0;0;0;0;0;0;0
FR;10;2021-08-04;0;0;0;0;0;0;0;0;0;0;0;0;0;0;0;0;0;0
FR;10;2021-08-05;0;0;0;0;0;0;0;0;0;0;0;0;0;0;0;0;0;0
FR;10;2021-08-06;0;0;0;0;0;0;0;0;0;0;0;0;0;0;0;0;0;0
FR;10;2021-08-07;0;0;0;0;0;0;0;0;0;0;0;0;0;0;0;0;0;0
FR;10;2021-08-08;0;0;0;0;0;0;0;0;0;0;0;0;0;0;0;0;0;0
FR;10;2021-08-09;0;0;0;0;0;0;0;0;0;0;0;0;0;0;0;0;0;0
FR;10;2021-08-10;0;0;0;0;0;0;0;0;0;0;0;0;0;0;0;0;0;0
FR;10;2021-08-11;0;0;0;0;0;0;0;0;0;0;0;0;0;0;0;0;0;0
FR;10;2021-08-12;0;0;0;0;0;0;0;0;0;0;0;0;0;0;0;0;0;0
FR;10;2021-08-13;0;0;0;0;0;0;0;0;0;0;0;0;0;0;0;0;0;0
FR;10;2021-08-14;0;0;0;0;0;0;0;0;0;0;0;0;0;0;0;0;0;0
FR;10;2021-08-15;0;0;0;0;0;0;0;0;0;0;0;0;0;0;0;0;0;0
FR;10;2021-08-16;0;0;0;0;0;0;0;0;0;0;0;0;0;0;0;0;0;0
FR;10;2021-08-17;0;0;0;0;0;0;0;0;0;0;0;0;0;0;0;0;0;0
FR;10;2021-08-18;0;0;0;0;0;0;0;0;0;0;0;0;0;0;0;0;0;0
FR;10;2021-08-19;0;0;0;0;0;0;0;0;0;0;0;0;0;0;0;0;0;0
FR;10;2021-08-20;0;0;0;0;0;0;0;0;0;0;0;0;0;0;0;0;0;0
FR;10;2021-08-21;0;0;0;0;0;0;0;0;0;0;0;0;0;0;0;0;0;0
FR;10;2021-08-22;0;0;0;0;0;0;0;0;0;0;0;0;0;0;0;0;0;0
FR;10;2021-08-23;0;0;0;0;0;0;0;0;0;0;0;0;0;0;0;0;0;0
FR;10;2021-08-24;0;0;0;0;0;0;0;0;0;0;0;0;0;0;0;0;0;0
FR;10;2021-08-25;0;0;0;0;0;0;0;0;0;0;0;0;0;0;0;0;0;0
FR;10;2021-08-26;0;0;0;0;0;0;0;0;0;0;0;0;0;0;0;0;0;0
FR;10;2021-08-27;0;0;0;0;0;0;0;0;0;0;0;0;0;0;0;0;0;0
FR;10;2021-08-28;0;0;0;0;0;0;0;0;0;0;0;0;0;0;0;0;0;0
FR;10;2021-08-29;0;0;0;0;0;0;0;0;0;0;0;0;0;0;0;0;0;0
FR;10;2021-08-30;0;0;0;0;0;0;0;0;0;0;0;0;0;0;0;0;0;0
FR;10;2021-08-31;0;0;0;0;0;0;0;0;0;0;0;0;0;0;0;0;0;0
FR;10;2021-09-01;0;0;0;0;0;0;0;0;0;0;0;0;0;0;0;0;0;0
FR;10;2021-09-02;0;0;0;0;0;0;0;0;0;0;0;0;0;0;0;0;0;0
FR;10;2021-09-03;0;0;0;0;0;0;0;0;0;0;0;0;0;0;0;0;0;0
FR;10;2021-09-04;0;0;0;0;0;0;0;0;0;0;0;0;0;0;0;0;0;0
FR;10;2021-09-05;0;0;0;0;0;0;0;0;0;0;0;0;0;0;0;0;0;0
FR;10;2021-09-06;0;0;0;0;0;0;0;0;0;0;0;0;0;0;0;0;0;0
FR;10;2021-09-07;0;0;0;0;0;0;0;0;0;0;0;0;0;0;0;0;0;0
FR;10;2021-09-08;0;0;0;0;0;0;0;0;0;0;0;0;0;0;0;0;0;0
FR;10;2021-09-09;0;0;0;0;0;0;0;0;0;0;0;0;0;0;0;0;0;0
FR;10;2021-09-10;0;0;0;0;0;0;0;0;0;0;0;0;0;0;0;0;0;0
FR;10;2021-09-11;0;0;0;0;0;0;0;0;0;0;0;0;0;0;0;0;0;0
FR;10;2021-09-12;0;0;0;0;0;0;0;0;0;0;0;0;0;0;0;0;0;0
FR;10;2021-09-13;0;0;0;0;0;0;0;0;0;0;0;0;0;0;0;0;0;0
FR;10;2021-09-14;0;0;0;0;0;0;0;0;0;0;0;0;0;0;0;0;0;0
FR;10;2021-09-15;0;0;0;0;0;0;0;0;0;0;0;0;0;0;0;0;0;0
FR;10;2021-09-16;0;0;0;0;0;0;0;0;0;0;0;0;0;0;0;0;0;0
FR;10;2021-09-17;0;0;0;0;0;0;0;0;0;0;0;0;0;0;0;0;0;0
FR;10;2021-09-18;0;0;0;0;0;0;0;0;0;0;0;0;0;0;0;0;0;0
FR;10;2021-09-19;0;0;0;0;0;0;0;0;0;0;0;0;0;0;0;0;0;0
FR;10;2021-09-20;0;0;0;0;0;0;0;0;0;0;0;0;0;0;0;0;0;0
FR;10;2021-09-21;0;0;0;0;0;0;0;0;0;0;0;0;0;0;0;0;0;0
FR;10;2021-09-22;0;0;0;0;0;0;0;0;0;0;0;0;0;0;0;0;0;0
FR;10;2021-09-23;0;0;0;0;0;0;0;0;0;0;0;0;0;0;0;0;0;0
FR;10;2021-09-24;0;0;0;0;0;0;0;0;0;0;0;0;0;0;0;0;0;0
FR;10;2021-09-25;0;0;0;0;0;0;0;0;0;0;0;0;0;0;0;0;0;0
FR;10;2021-09-26;0;0;0;0;0;0;0;0;0;0;0;0;0;0;0;0;0;0
FR;10;2021-09-27;0;0;0;0;0;0;0;0;0;0;0;0;0;0;0;0;0;0
FR;10;2021-09-28;0;0;0;0;0;0;0;0;0;0;0;0;0;0;0;0;0;0
FR;10;2021-09-29;0;0;0;0;0;0;0;0;0;0;0;0;0;0;0;0;0;0
FR;10;2021-09-30;0;0;0;0;0;0;0;0;0;0;0;0;0;0;0;0;0;0
FR;10;2021-10-01;0;0;0;0;0;0;0;0;0;0;0;0;0;0;0;0;0;0
FR;10;2021-10-02;0;0;0;0;0;0;0;0;0;0;0;0;0;0;0;0;0;0
FR;10;2021-10-03;0;0;0;0;0;0;0;0;0;0;0;0;0;0;0;0;0;0
FR;10;2021-10-04;0;0;0;0;0;0;0;0;0;0;0;0;0;0;0;0;0;0
FR;10;2021-10-05;0;0;0;0;0;0;0;0;0;0;0;0;0;0;0;0;0;0
FR;10;2021-10-06;0;0;0;0;0;0;0;0;0;0;0;0;0;0;0;0;0;0
FR;10;2021-10-07;0;0;0;0;0;0;0;0;0;0;0;0;0;0;0;0;0;0
FR;10;2021-10-08;0;0;0;0;0;0;0;0;0;0;0;0;0;0;0;0;0;0
FR;10;2021-10-09;0;0;0;0;0;0;0;0;0;0;0;0;0;0;0;0;0;0
FR;10;2021-10-10;0;0;0;0;0;0;0;0;0;0;0;0;0;0;0;0;0;0
FR;10;2021-10-11;0;0;0;0;0;0;0;0;0;0;0;0;0;0;0;0;0;0
FR;10;2021-10-12;0;0;0;0;0;0;0;0;0;0;0;0;0;0;0;0;0;0
FR;10;2021-10-13;0;0;0;0;0;0;0;0;0;0;0;0;0;0;0;0;0;0
FR;10;2021-10-14;0;0;0;0;0;0;0;0;0;0;0;0;0;0;0;0;0;0
FR;10;2021-10-15;0;0;0;0;0;0;0;0;0;0;0;0;0;0;0;0;0;0
FR;10;2021-10-16;0;0;0;0;0;0;0;0;0;0;0;0;0;0;0;0;0;0
FR;10;2021-10-17;0;0;0;0;0;0;0;0;0;0;0;0;0;0;0;0;0;0
FR;10;2021-10-18;0;0;0;0;0;0;0;0;0;0;0;0;0;0;0;0;0;0
FR;10;2021-10-19;0;0;0;0;0;0;0;0;0;0;0;0;0;0;0;0;0;0
FR;10;2021-10-20;0;0;0;0;0;0;0;0;0;0;0;0;0;0;0;0;0;0
FR;10;2021-10-21;0;0;0;0;0;0;0;0;0;0;0;0;0;0;0;0;0;0
FR;10;2021-10-22;0;0;0;0;0;0;0;0;0;0;0;0;0;0;0;0;0;0
FR;10;2021-10-23;0;0;0;0;0;0;0;0;0;0;0;0;0;0;0;0;0;0
FR;10;2021-10-24;0;0;0;0;0;0;0;0;0;0;0;0;0;0;0;0;0;0
FR;10;2021-10-25;0;0;0;0;0;0;0;0;0;0;0;0;0;0;0;0;0;0
FR;10;2021-10-26;0;0;0;0;0;0;0;0;0;0;0;0;0;0;0;0;0;0
FR;10;2021-10-27;0;0;0;0;0;0;0;0;0;0;0;0;0;0;0;0;0;0
FR;10;2021-10-28;0;0;0;0;0;0;0;0;0;0;0;0;0;0;0;0;0;0
FR;10;2021-10-29;0;0;0;0;0;0;0;0;0;0;0;0;0;0;0;0;0;0
FR;10;2021-10-30;0;0;0;0;0;0;0;0;0;0;0;0;0;0;0;0;0;0
FR;10;2021-10-31;0;0;0;0;0;0;0;0;0;0;0;0;0;0;0;0;0;0
FR;10;2021-11-01;0;0;0;0;0;0;0;0;0;0;0;0;0;0;0;0;0;0
FR;10;2021-11-02;0;0;0;0;0;0;0;0;0;0;0;0;0;0;0;0;0;0
FR;10;2021-11-03;0;0;0;0;0;0;0;0;0;0;0;0;0;0;0;0;0;0
FR;10;2021-11-04;0;0;0;0;0;0;0;0;0;0;0;0;0;0;0;0;0;0
FR;10;2021-11-05;0;0;0;0;0;0;0;0;0;0;0;0;0;0;0;0;0;0
FR;10;2021-11-06;0;0;0;0;0;0;0;0;0;0;0;0;0;0;0;0;0;0
FR;10;2021-11-07;0;0;0;0;0;0;0;0;0;0;0;0;0;0;0;0;0;0
FR;10;2021-11-08;0;0;0;0;0;0;0;0;0;0;0;0;0;0;0;0;0;0
FR;10;2021-11-09;0;0;0;0;0;0;0;0;0;0;0;0;0;0;0;0;0;0
FR;10;2021-11-10;0;0;0;0;0;0;0;0;0;0;0;0;0;0;0;0;0;0
FR;10;2021-11-11;0;0;0;0;0;0;0;0;0;0;0;0;0;0;0;0;0;0
FR;10;2021-11-12;0;0;0;0;0;0;0;0;0;0;0;0;0;0;0;0;0;0
FR;10;2021-11-13;0;0;0;0;0;0;0;0;0;0;0;0;0;0;0;0;0;0
FR;10;2021-11-14;0;0;0;0;0;0;0;0;0;0;0;0;0;0;0;0;0;0
FR;10;2021-11-15;0;0;0;0;0;0;0;0;0;0;0;0;0;0;0;0;0;0
FR;10;2021-11-16;0;0;0;0;0;0;0;0;0;0;0;0;0;0;0;0;0;0
FR;10;2021-11-17;0;0;0;0;0;0;0;0;0;0;0;0;0;0;0;0;0;0
FR;10;2021-11-18;0;0;0;0;0;0;0;0;0;0;0;0;0;0;0;0;0;0
FR;10;2021-11-19;0;0;0;0;0;0;0;0;0;0;0;0;0;0;0;0;0;0
FR;10;2021-11-20;0;0;0;0;0;0;0;0;0;0;0;0;0;0;0;0;0;0
FR;10;2021-11-21;0;0;0;0;0;0;0;0;0;0;0;0;0;0;0;0;0;0
FR;10;2021-11-22;0;0;0;0;0;0;0;0;0;0;0;0;0;0;0;0;0;0
FR;10;2021-11-23;0;0;0;0;0;0;0;0;0;0;0;0;0;0;0;0;0;0
FR;10;2021-11-24;0;0;0;0;0;0;0;0;0;0;0;0;0;0;0;0;0;0
FR;10;2021-11-25;0;0;0;0;0;0;0;0;0;0;0;0;0;0;0;0;0;0
FR;10;2021-11-26;0;0;0;0;0;0;0;0;0;0;0;0;0;0;0;0;0;0
FR;10;2021-11-27;0;0;0;0;0;0;0;0;0;0;0;0;0;0;0;0;0;0
FR;10;2021-11-28;0;0;0;0;0;0;0;0;0;0;0;0;0;0;0;0;0;0
FR;10;2021-11-29;0;0;0;0;0;0;0;0;0;0;0;0;0;0;0;0;0;0
FR;10;2021-11-30;0;0;0;0;0;0;0;0;0;0;0;0;0;0;0;0;0;0
FR;10;2021-12-01;0;0;0;0;0;0;0;0;0;0;0;0;0;0;0;0;0;0
FR;10;2021-12-02;0;0;0;0;0;0;0;0;0;0;0;0;0;0;0;0;0;0
FR;10;2021-12-03;0;0;0;0;0;0;0;0;0;0;0;0;0;0;0;0;0;0
FR;10;2021-12-04;0;0;0;0;0;0;0;0;0;0;0;0;0;0;0;0;0;0
FR;10;2021-12-05;0;0;0;0;0;0;0;0;0;0;0;0;0;0;0;0;0;0
FR;10;2021-12-06;0;0;0;0;0;0;0;0;0;0;0;0;0;0;0;0;0;0
FR;10;2021-12-07;0;0;0;0;0;0;0;0;0;0;0;0;0;0;0;0;0;0
FR;10;2021-12-08;0;0;0;0;0;0;0;0;0;0;0;0;0;0;0;0;0;0
FR;10;2021-12-09;0;0;0;0;0;0;0;0;0;0;0;0;0;0;0;0;0;0
FR;10;2021-12-10;0;0;0;0;0;0;0;0;0;0;0;0;0;0;0;0;0;0
FR;10;2021-12-11;0;0;0;0;0;0;0;0;0;0;0;0;0;0;0;0;0;0
FR;10;2021-12-12;0;0;0;0;0;0;0;0;0;0;0;0;0;0;0;0;0;0
FR;10;2021-12-13;0;0;0;0;0;0;0;0;0;0;0;0;0;0;0;0;0;0
FR;10;2021-12-14;0;0;0;0;0;0;0;0;0;0;0;0;0;0;0;0;0;0
FR;10;2021-12-15;0;0;0;0;0;0;0;0;0;0;0;0;0;0;0;0;0;0
FR;10;2021-12-16;0;0;0;0;0;0;0;0;0;0;0;0;0;0;0;0;0;0
FR;10;2021-12-17;0;0;0;0;0;0;0;0;0;0;0;0;0;0;0;0;0;0
FR;10;2021-12-18;0;0;0;0;0;0;0;0;0;0;0;0;0;0;0;0;0;0
FR;10;2021-12-19;0;0;0;0;0;0;0;0;0;0;0;0;0;0;0;0;0;0
FR;10;2021-12-20;0;0;0;0;0;0;0;0;0;0;0;0;0;0;0;0;0;0
FR;10;2021-12-21;0;0;0;0;0;0;0;0;0;0;0;0;0;0;0;0;0;0
FR;10;2021-12-22;0;0;0;0;0;0;0;0;0;0;0;0;0;0;0;0;0;0
FR;10;2021-12-23;0;0;0;0;0;0;0;0;0;0;0;0;0;0;0;0;0;0
FR;10;2021-12-24;0;0;0;0;0;0;0;0;0;0;0;0;0;0;0;0;0;0
FR;10;2021-12-25;0;0;0;0;0;0;0;0;0;0;0;0;0;0;0;0;0;0
FR;10;2021-12-26;0;0;0;0;0;0;0;0;0;0;0;0;0;0;0;0;0;0
FR;10;2021-12-27;0;0;0;0;0;0;0;0;0;0;0;0;0;0;0;0;0;0
FR;10;2021-12-28;0;0;0;0;0;0;0;0;0;0;0;0;0;0;0;0;0;0
FR;10;2021-12-29;0;0;0;0;0;0;0;0;0;0;0;0;0;0;0;0;0;0
FR;10;2021-12-30;0;0;0;0;0;0;0;0;0;0;0;0;0;0;0;0;0;0
FR;10;2021-12-31;0;0;0;0;0;0;0;0;0;0;0;0;0;0;0;0;0;0
FR;10;2022-01-01;0;0;0;0;0;0;0;0;0;0;0;0;0;0;0;0;0;0
FR;10;2022-01-02;0;0;0;0;0;0;0;0;0;0;0;0;0;0;0;0;0;0
FR;10;2022-01-03;0;0;0;0;0;0;0;0;0;0;0;0;0;0;0;0;0;0
FR;10;2022-01-04;0;0;0;0;0;0;0;0;0;0;0;0;0;0;0;0;0;0
FR;10;2022-01-05;0;0;0;0;0;0;0;0;0;0;0;0;0;0;0;0;0;0
FR;10;2022-01-06;0;0;0;0;0;0;0;0;0;0;0;0;0;0;0;0;0;0
FR;10;2022-01-07;0;0;0;0;0;0;0;0;0;0;0;0;0;0;0;0;0;0
FR;10;2022-01-08;0;0;0;0;0;0;0;0;0;0;0;0;0;0;0;0;0;0
FR;10;2022-01-09;0;0;0;0;0;0;0;0;0;0;0;0;0;0;0;0;0;0
FR;10;2022-01-10;0;0;0;0;0;0;0;0;0;0;0;0;0;0;0;0;0;0
FR;10;2022-01-11;0;0;0;0;0;0;0;0;0;0;0;0;0;0;0;0;0;0
FR;10;2022-01-12;0;0;0;0;0;0;0;0;0;0;0;0;0;0;0;0;0;0
FR;10;2022-01-13;0;0;0;0;0;0;0;0;0;0;0;0;0;0;0;0;0;0
FR;10;2022-01-14;0;0;0;0;0;0;0;0;0;0;0;0;0;0;0;0;0;0
FR;10;2022-01-15;0;0;0;0;0;0;0;0;0;0;0;0;0;0;0;0;0;0
FR;10;2022-01-16;0;0;0;0;0;0;0;0;0;0;0;0;0;0;0;0;0;0
FR;10;2022-01-17;0;0;0;0;0;0;0;0;0;0;0;0;0;0;0;0;0;0
FR;10;2022-01-18;0;0;0;0;0;0;0;0;0;0;0;0;0;0;0;0;0;0
FR;10;2022-01-19;0;0;0;0;0;0;0;0;0;0;0;0;0;0;0;0;0;0
FR;10;2022-01-20;0;0;0;0;0;0;0;0;0;0;0;0;0;0;0;0;0;0
FR;10;2022-01-21;0;0;0;0;0;0;0;0;0;0;0;0;0;0;0;0;0;0
FR;10;2022-01-22;0;0;0;0;0;0;0;0;0;0;0;0;0;0;0;0;0;0
FR;10;2022-01-23;0;0;0;0;0;0;0;0;0;0;0;0;0;0;0;0;0;0
FR;10;2022-01-24;0;0;0;0;0;0;0;0;0;0;0;0;0;0;0;0;0;0
FR;10;2022-01-25;0;0;0;0;0;0;0;0;0;0;0;0;0;0;0;0;0;0
FR;10;2022-01-26;0;0;0;0;0;0;0;0;0;0;0;0;0;0;0;0;0;0
FR;10;2022-01-27;0;0;0;0;0;0;0;0;0;0;0;0;0;0;0;0;0;0
FR;10;2022-01-28;0;0;0;0;0;0;0;0;0;0;0;0;0;0;0;0;0;0
FR;10;2022-01-29;0;0;0;0;0;0;0;0;0;0;0;0;0;0;0;0;0;0
FR;10;2022-01-30;0;0;0;0;0;0;0;0;0;0;0;0;0;0;0;0;0;0
FR;10;2022-01-31;0;0;0;0;0;0;0;0;0;0;0;0;0;0;0;0;0;0
FR;10;2022-02-01;0;0;0;0;0;0;0;0;0;0;0;0;0;0;0;0;0;0
FR;10;2022-02-02;0;0;0;0;0;0;0;0;0;0;0;0;0;0;0;0;0;0
FR;10;2022-02-03;0;0;0;0;0;0;0;0;0;0;0;0;0;0;0;0;0;0
FR;10;2022-02-04;0;0;0;0;0;0;0;0;0;0;0;0;0;0;0;0;0;0
FR;10;2022-02-05;0;0;0;0;0;0;0;0;0;0;0;0;0;0;0;0;0;0
FR;10;2022-02-06;0;0;0;0;0;0;0;0;0;0;0;0;0;0;0;0;0;0
FR;10;2022-02-07;0;0;0;0;0;0;0;0;0;0;0;0;0;0;0;0;0;0
FR;10;2022-02-08;0;0;0;0;0;0;0;0;0;0;0;0;0;0;0;0;0;0
FR;10;2022-02-09;0;0;0;0;0;0;0;0;0;0;0;0;0;0;0;0;0;0
FR;10;2022-02-10;0;0;0;0;0;0;0;0;0;0;0;0;0;0;0;0;0;0
FR;10;2022-02-11;0;0;0;0;0;0;0;0;0;0;0;0;0;0;0;0;0;0
FR;10;2022-02-12;0;0;0;0;0;0;0;0;0;0;0;0;0;0;0;0;0;0
FR;10;2022-02-13;0;0;0;0;0;0;0;0;0;0;0;0;0;0;0;0;0;0
FR;10;2022-02-14;0;0;0;0;0;0;0;0;0;0;0;0;0;0;0;0;0;0
FR;10;2022-02-15;0;0;0;0;0;0;0;0;0;0;0;0;0;0;0;0;0;0
FR;10;2022-02-16;0;0;0;0;0;0;0;0;0;0;0;0;0;0;0;0;0;0
FR;10;2022-02-17;0;0;0;0;0;0;0;0;0;0;0;0;0;0;0;0;0;0
FR;10;2022-02-18;0;0;0;0;0;0;0;0;0;0;0;0;0;0;0;0;0;0
FR;10;2022-02-19;0;0;0;0;0;0;0;0;0;0;0;0;0;0;0;0;0;0
FR;10;2022-02-20;0;0;0;0;0;0;0;0;0;0;0;0;0;0;0;0;0;0
FR;10;2022-02-21;0;0;0;0;0;0;0;0;0;0;0;0;0;0;0;0;0;0
FR;10;2022-02-22;0;0;0;0;0;0;0;0;0;0;0;0;0;0;0;0;0;0
FR;10;2022-02-23;0;0;0;0;0;0;0;0;0;0;0;0;0;0;0;0;0;0
FR;10;2022-02-24;0;0;0;0;0;0;0;0;0;0;0;0;0;0;0;0;0;0
FR;10;2022-02-25;0;0;0;0;0;0;0;0;0;0;0;0;0;0;0;0;0;0
FR;10;2022-02-26;0;0;0;0;0;0;0;0;0;0;0;0;0;0;0;0;0;0
FR;10;2022-02-27;0;0;0;0;0;0;0;0;0;0;0;0;0;0;0;0;0;0
FR;10;2022-02-28;0;0;0;0;0;0;0;0;0;0;0;0;0;0;0;0;0;0
FR;10;2022-03-01;0;0;0;0;0;0;0;0;0;0;0;0;0;0;0;0;0;0
FR;10;2022-03-02;0;0;0;0;0;0;0;0;0;0;0;0;0;0;0;0;0;0
FR;10;2022-03-03;0;0;0;0;0;0;0;0;0;0;0;0;0;0;0;0;0;0
FR;10;2022-03-04;0;0;0;0;0;0;0;0;0;0;0;0;0;0;0;0;0;0
FR;10;2022-03-05;0;0;0;0;0;0;0;0;0;0;0;0;0;0;0;0;0;0
FR;10;2022-03-06;0;0;0;0;0;0;0;0;0;0;0;0;0;0;0;0;0;0
FR;10;2022-03-07;0;0;0;0;0;0;0;0;0;0;0;0;0;0;0;0;0;0
FR;10;2022-03-08;0;0;0;0;0;0;0;0;0;0;0;0;0;0;0;0;0;0
FR;10;2022-03-09;0;0;0;0;0;0;0;0;0;0;0;0;0;0;0;0;0;0
FR;10;2022-03-10;0;0;0;0;0;0;0;0;0;0;0;0;0;0;0;0;0;0
FR;10;2022-03-11;0;0;0;0;0;0;0;0;0;0;0;0;0;0;0;0;0;0
FR;10;2022-03-12;0;0;0;0;0;0;0;0;0;0;0;0;0;0;0;0;0;0
FR;10;2022-03-13;0;0;0;0;0;0;0;0;0;0;0;0;0;0;0;0;0;0
FR;10;2022-03-14;0;0;0;0;0;0;0;0;0;0;0;0;0;0;0;0;0;0
FR;10;2022-03-15;0;0;0;0;0;0;0;0;0;0;0;0;0;0;0;0;0;0
FR;10;2022-03-16;0;0;0;0;0;0;0;0;0;0;0;0;0;0;0;0;0;0
FR;10;2022-03-17;0;0;0;0;0;0;0;0;0;0;0;0;0;0;0;0;0;0
FR;10;2022-03-18;0;0;0;0;0;0;0;0;0;0;0;0;0;0;0;0;0;0
FR;10;2022-03-19;0;0;0;0;0;0;0;0;0;0;0;0;0;0;0;0;0;0
FR;10;2022-03-20;0;0;0;0;0;0;0;0;0;0;0;0;0;0;0;0;0;0
FR;10;2022-03-21;0;0;0;0;0;0;0;0;0;0;0;0;0;0;0;0;0;0
FR;10;2022-03-22;0;0;0;0;0;0;0;0;0;0;0;0;0;0;0;0;0;0
FR;10;2022-03-23;0;0;0;0;0;0;0;0;0;0;0;0;0;0;0;0;0;0
FR;10;2022-03-24;0;0;0;0;0;0;0;0;0;0;0;0;0;0;0;0;0;0
FR;10;2022-03-25;0;0;0;0;0;0;0;0;0;0;0;0;0;0;0;0;0;0
FR;10;2022-03-26;0;0;0;0;0;0;0;0;0;0;0;0;0;0;0;0;0;0
FR;10;2022-03-27;0;0;0;0;0;0;0;0;0;0;0;0;0;0;0;0;0;0
FR;10;2022-03-28;0;0;0;0;0;0;0;0;0;0;0;0;0;0;0;0;0;0
FR;10;2022-03-29;0;0;0;0;0;0;0;0;0;0;0;0;0;0;0;0;0;0
FR;10;2022-03-30;0;0;0;0;0;0;0;0;0;0;0;0;0;0;0;0;0;0
FR;10;2022-03-31;0;0;0;0;0;0;0;0;0;0;0;0;0;0;0;0;0;0
FR;10;2022-04-01;0;0;0;0;0;0;0;0;0;0;0;0;0;0;0;0;0;0
FR;10;2022-04-02;0;0;0;0;0;0;0;0;0;0;0;0;0;0;0;0;0;0
FR;10;2022-04-03;0;0;0;0;0;0;0;0;0;0;0;0;0;0;0;0;0;0
FR;10;2022-04-04;0;0;0;0;0;0;0;0;0;0;0;0;0;0;0;0;0;0
FR;10;2022-04-05;0;0;0;0;0;0;0;0;0;0;0;0;0;0;0;0;0;0
FR;10;2022-04-06;0;0;0;0;0;0;0;0;0;0;0;0;0;0;0;0;0;0
FR;10;2022-04-07;0;0;0;0;0;0;0;0;0;0;0;0;0;0;0;0;0;0
FR;10;2022-04-08;0;0;0;0;0;0;0;0;0;0;0;0;0;0;0;0;0;0
FR;10;2022-04-09;0;0;0;0;0;0;0;0;0;0;0;0;0;0;0;0;0;0
FR;10;2022-04-10;0;0;0;0;0;0;0;0;0;0;0;0;0;0;0;0;0;0
FR;10;2022-04-11;0;0;0;0;0;0;0;0;0;0;0;0;0;0;0;0;0;0
FR;10;2022-04-12;0;0;0;0;0;0;0;0;0;0;0;0;0;0;0;0;0;0
FR;10;2022-04-13;0;0;0;0;0;0;0;0;0;0;0;0;0;0;0;0;0;0
FR;10;2022-04-14;0;0;0;0;0;0;0;0;0;0;0;0;0;0;0;0;0;0
FR;10;2022-04-15;0;0;0;0;0;0;0;0;0;0;0;0;0;0;0;0;0;0
FR;10;2022-04-16;0;0;0;0;0;0;0;0;0;0;0;0;0;0;0;0;0;0
FR;10;2022-04-17;0;0;0;0;0;0;0;0;0;0;0;0;0;0;0;0;0;0
FR;10;2022-04-18;0;0;0;0;0;0;0;0;0;0;0;0;0;0;0;0;0;0
FR;10;2022-04-19;0;0;0;0;0;0;0;0;0;0;0;0;0;0;0;0;0;0
FR;10;2022-04-20;0;0;0;0;0;0;0;0;0;0;0;0;0;0;0;0;0;0
FR;10;2022-04-21;0;0;0;0;0;0;0;0;0;0;0;0;0;0;0;0;0;0
FR;10;2022-04-22;0;0;0;0;0;0;0;0;0;0;0;0;0;0;0;0;0;0
FR;10;2022-04-23;0;0;0;0;0;0;0;0;0;0;0;0;0;0;0;0;0;0
FR;10;2022-04-24;0;0;0;0;0;0;0;0;0;0;0;0;0;0;0;0;0;0
FR;10;2022-04-25;0;0;0;0;0;0;0;0;0;0;0;0;0;0;0;0;0;0
FR;10;2022-04-26;0;0;0;0;0;0;0;0;0;0;0;0;0;0;0;0;0;0
FR;10;2022-04-27;0;0;0;0;0;0;0;0;0;0;0;0;0;0;0;0;0;0
FR;10;2022-04-28;0;0;0;0;0;0;0;0;0;0;0;0;0;0;0;0;0;0
FR;10;2022-04-29;0;0;0;0;0;0;0;0;0;0;0;0;0;0;0;0;0;0
FR;10;2022-04-30;0;0;0;0;0;0;0;0;0;0;0;0;0;0;0;0;0;0
FR;10;2022-05-01;0;0;0;0;0;0;0;0;0;0;0;0;0;0;0;0;0;0
FR;10;2022-05-02;0;0;0;0;0;0;0;0;0;0;0;0;0;0;0;0;0;0
FR;10;2022-05-03;0;0;0;0;0;0;0;0;0;0;0;0;0;0;0;0;0;0
FR;10;2022-05-04;0;0;0;0;0;0;0;0;0;0;0;0;0;0;0;0;0;0
FR;10;2022-05-05;0;0;0;0;0;0;0;0;0;0;0;0;0;0;0;0;0;0
FR;10;2022-05-06;0;0;0;0;0;0;0;0;0;0;0;0;0;0;0;0;0;0
FR;10;2022-05-07;0;0;0;0;0;0;0;0;0;0;0;0;0;0;0;0;0;0
FR;10;2022-05-08;0;0;0;0;0;0;0;0;0;0;0;0;0;0;0;0;0;0
FR;10;2022-05-09;0;0;0;0;0;0;0;0;0;0;0;0;0;0;0;0;0;0
FR;10;2022-05-10;0;0;0;0;0;0;0;0;0;0;0;0;0;0;0;0;0;0
FR;10;2022-05-11;0;0;0;0;0;0;0;0;0;0;0;0;0;0;0;0;0;0
FR;10;2022-05-12;0;0;0;0;0;0;0;0;0;0;0;0;0;0;0;0;0;0
FR;10;2022-05-13;0;0;0;0;0;0;0;0;0;0;0;0;0;0;0;0;0;0
FR;10;2022-05-14;0;0;0;0;0;0;0;0;0;0;0;0;0;0;0;0;0;0
FR;10;2022-05-15;0;0;0;0;0;0;0;0;0;0;0;0;0;0;0;0;0;0
FR;10;2022-05-16;0;0;0;0;0;0;0;0;0;0;0;0;0;0;0;0;0;0
FR;10;2022-05-17;0;0;0;0;0;0;0;0;0;0;0;0;0;0;0;0;0;0
FR;10;2022-05-18;0;0;0;0;0;0;0;0;0;0;0;0;0;0;0;0;0;0
FR;10;2022-05-19;0;0;0;0;0;0;0;0;0;0;0;0;0;0;0;0;0;0
FR;10;2022-05-20;0;0;0;0;0;0;0;0;0;0;0;0;0;0;0;0;0;0
FR;10;2022-05-21;0;0;0;0;0;0;0;0;0;0;0;0;0;0;0;0;0;0
FR;10;2022-05-22;0;0;0;0;0;0;0;0;0;0;0;0;0;0;0;0;0;0
FR;10;2022-05-23;0;0;0;0;0;0;0;0;0;0;0;0;0;0;0;0;0;0
FR;10;2022-05-24;0;0;0;0;0;0;0;0;0;0;0;0;0;0;0;0;0;0
FR;10;2022-05-25;0;0;0;0;0;0;0;0;0;0;0;0;0;0;0;0;0;0
FR;10;2022-05-26;0;0;0;0;0;0;0;0;0;0;0;0;0;0;0;0;0;0
FR;10;2022-05-27;0;0;0;0;0;0;0;0;0;0;0;0;0;0;0;0;0;0
FR;10;2022-05-28;0;0;0;0;0;0;0;0;0;0;0;0;0;0;0;0;0;0
FR;10;2022-05-29;0;0;0;0;0;0;0;0;0;0;0;0;0;0;0;0;0;0
FR;10;2022-05-30;0;0;0;0;0;0;0;0;0;0;0;0;0;0;0;0;0;0
FR;10;2022-05-31;0;0;0;0;0;0;0;0;0;0;0;0;0;0;0;0;0;0
FR;10;2022-06-01;0;0;0;0;0;0;0;0;0;0;0;0;0;0;0;0;0;0
FR;10;2022-06-02;0;0;0;0;0;0;0;0;0;0;0;0;0;0;0;0;0;0
FR;10;2022-06-03;0;0;0;0;0;0;0;0;0;0;0;0;0;0;0;0;0;0
FR;10;2022-06-04;0;0;0;0;0;0;0;0;0;0;0;0;0;0;0;0;0;0
FR;10;2022-06-05;0;0;0;0;0;0;0;0;0;0;0;0;0;0;0;0;0;0
FR;10;2022-06-06;0;0;0;0;0;0;0;0;0;0;0;0;0;0;0;0;0;0
FR;10;2022-06-07;0;0;0;0;0;0;0;0;0;0;0;0;0;0;0;0;0;0
FR;10;2022-06-08;0;0;0;0;0;0;0;0;0;0;0;0;0;0;0;0;0;0
FR;10;2022-06-09;0;0;0;0;0;0;0;0;0;0;0;0;0;0;0;0;0;0
FR;10;2022-06-10;0;0;0;0;0;0;0;0;0;0;0;0;0;0;0;0;0;0
FR;10;2022-06-11;0;0;0;0;0;0;0;0;0;0;0;0;0;0;0;0;0;0
FR;10;2022-06-12;0;0;0;0;0;0;0;0;0;0;0;0;0;0;0;0;0;0
FR;10;2022-06-13;0;0;0;0;0;0;0;0;0;0;0;0;0;0;0;0;0;0
FR;10;2022-06-14;0;0;0;0;0;0;0;0;0;0;0;0;0;0;0;0;0;0
FR;10;2022-06-15;0;0;0;0;0;0;0;0;0;0;0;0;0;0;0;0;0;0
FR;10;2022-06-16;0;0;0;0;0;0;0;0;0;0;0;0;0;0;0;0;0;0
FR;10;2022-06-17;0;0;0;0;0;0;0;0;0;0;0;0;0;0;0;0;0;0
FR;10;2022-06-18;0;0;0;0;0;0;0;0;0;0;0;0;0;0;0;0;0;0
FR;10;2022-06-19;0;0;0;0;0;0;0;0;0;0;0;0;0;0;0;0;0;0
FR;10;2022-06-20;0;0;0;0;0;0;0;0;0;0;0;0;0;0;0;0;0;0
FR;10;2022-06-21;0;0;0;0;0;0;0;0;0;0;0;0;0;0;0;0;0;0
FR;10;2022-06-22;0;0;0;0;0;0;0;0;0;0;0;0;0;0;0;0;0;0
FR;10;2022-06-23;0;0;0;0;0;0;0;0;0;0;0;0;0;0;0;0;0;0
FR;10;2022-06-24;0;0;0;0;0;0;0;0;0;0;0;0;0;0;0;0;0;0
FR;10;2022-06-25;0;0;0;0;0;0;0;0;0;0;0;0;0;0;0;0;0;0
FR;10;2022-06-26;0;0;0;0;0;0;0;0;0;0;0;0;0;0;0;0;0;0
FR;10;2022-06-27;0;0;0;0;0;0;0;0;0;0;0;0;0;0;0;0;0;0
FR;10;2022-06-28;0;0;0;0;0;0;0;0;0;0;0;0;0;0;0;0;0;0
FR;10;2022-06-29;0;0;0;0;0;0;0;0;0;0;0;0;0;0;0;0;0;0
FR;10;2022-06-30;0;0;0;0;0;0;0;0;0;0;0;0;0;0;0;0;0;0
FR;10;2022-07-01;0;0;0;0;0;0;0;0;0;0;0;0;0;0;0;0;0;0
FR;10;2022-07-02;0;0;0;0;0;0;0;0;0;0;0;0;0;0;0;0;0;0
FR;10;2022-07-03;0;0;0;0;0;0;0;0;0;0;0;0;0;0;0;0;0;0
FR;10;2022-07-04;0;0;0;0;0;0;0;0;0;0;0;0;0;0;0;0;0;0
FR;10;2022-07-05;0;0;0;0;0;0;0;0;0;0;0;0;0;0;0;0;0;0
FR;10;2022-07-06;0;0;0;0;0;0;0;0;0;0;0;0;0;0;0;0;0;0
FR;10;2022-07-07;0;0;0;0;0;0;0;0;0;0;0;0;0;0;0;0;0;0
FR;10;2022-07-08;0;0;0;0;0;0;0;0;0;0;0;0;0;0;0;0;0;0
FR;10;2022-07-09;0;0;0;0;0;0;0;0;0;0;0;0;0;0;0;0;0;0
FR;10;2022-07-10;0;0;0;0;0;0;0;0;0;0;0;0;0;0;0;0;0;0
FR;10;2022-07-11;0;0;0;0;0;0;0;0;0;0;0;0;0;0;0;0;0;0
FR;10;2022-07-12;0;0;0;0;0;0;0;0;0;0;0;0;0;0;0;0;0;0
FR;10;2022-07-13;0;0;0;0;0;0;0;0;0;0;0;0;0;0;0;0;0;0
FR;10;2022-07-14;0;0;0;0;0;0;0;0;0;0;0;0;0;0;0;0;0;0
FR;10;2022-07-15;0;0;0;0;0;0;0;0;0;0;0;0;0;0;0;0;0;0
FR;10;2022-07-16;0;0;0;0;0;0;0;0;0;0;0;0;0;0;0;0;0;0
FR;10;2022-07-17;0;0;0;0;0;0;0;0;0;0;0;0;0;0;0;0;0;0
FR;10;2022-07-18;0;0;0;0;0;0;0;0;0;0;0;0;0;0;0;0;0;0
FR;10;2022-07-19;0;0;0;0;0;0;0;0;0;0;0;0;0;0;0;0;0;0
FR;10;2022-07-20;0;0;0;0;0;0;0;0;0;0;0;0;0;0;0;0;0;0
FR;10;2022-07-21;0;0;0;0;0;0;0;0;0;0;0;0;0;0;0;0;0;0
FR;10;2022-07-22;0;0;0;0;0;0;0;0;0;0;0;0;0;0;0;0;0;0
FR;10;2022-07-23;0;0;0;0;0;0;0;0;0;0;0;0;0;0;0;0;0;0
FR;10;2022-07-24;0;0;0;0;0;0;0;0;0;0;0;0;0;0;0;0;0;0
FR;10;2022-07-25;0;0;0;0;0;0;0;0;0;0;0;0;0;0;0;0;0;0
FR;10;2022-07-26;0;0;0;0;0;0;0;0;0;0;0;0;0;0;0;0;0;0
FR;10;2022-07-27;0;0;0;0;0;0;0;0;0;0;0;0;0;0;0;0;0;0
FR;10;2022-07-28;0;0;0;0;0;0;0;0;0;0;0;0;0;0;0;0;0;0
FR;10;2022-07-29;0;0;0;0;0;0;0;0;0;0;0;0;0;0;0;0;0;0
FR;10;2022-07-30;0;0;0;0;0;0;0;0;0;0;0;0;0;0;0;0;0;0
FR;10;2022-07-31;0;0;0;0;0;0;0;0;0;0;0;0;0;0;0;0;0;0
FR;10;2022-08-01;0;0;0;0;0;0;0;0;0;0;0;0;0;0;0;0;0;0
FR;10;2022-08-02;0;0;0;0;0;0;0;0;0;0;0;0;0;0;0;0;0;0
FR;10;2022-08-03;0;0;0;0;0;0;0;0;0;0;0;0;0;0;0;0;0;0
FR;10;2022-08-04;0;0;0;0;0;0;0;0;0;0;0;0;0;0;0;0;0;0
FR;10;2022-08-05;0;0;0;0;0;0;0;0;0;0;0;0;0;0;0;0;0;0
FR;10;2022-08-06;0;0;0;0;0;0;0;0;0;0;0;0;0;0;0;0;0;0
FR;10;2022-08-07;0;0;0;0;0;0;0;0;0;0;0;0;0;0;0;0;0;0
FR;10;2022-08-08;0;0;0;0;0;0;0;0;0;0;0;0;0;0;0;0;0;0
FR;10;2022-08-09;0;0;0;0;0;0;0;0;0;0;0;0;0;0;0;0;0;0
FR;10;2022-08-10;0;0;0;0;0;0;0;0;0;0;0;0;0;0;0;0;0;0
FR;10;2022-08-11;0;0;0;0;0;0;0;0;0;0;0;0;0;0;0;0;0;0
FR;10;2022-08-12;0;0;0;0;0;0;0;0;0;0;0;0;0;0;0;0;0;0
FR;10;2022-08-13;0;0;0;0;0;0;0;0;0;0;0;0;0;0;0;0;0;0
FR;10;2022-08-14;0;0;0;0;0;0;0;0;0;0;0;0;0;0;0;0;0;0
FR;10;2022-08-15;0;0;0;0;0;0;0;0;0;0;0;0;0;0;0;0;0;0
FR;10;2022-08-16;0;0;0;0;0;0;0;0;0;0;0;0;0;0;0;0;0;0
FR;10;2022-08-17;0;0;0;0;0;0;0;0;0;0;0;0;0;0;0;0;0;0
FR;10;2022-08-18;0;0;0;0;0;0;0;0;0;0;0;0;0;0;0;0;0;0
FR;10;2022-08-19;0;0;0;0;0;0;0;0;0;0;0;0;0;0;0;0;0;0
FR;10;2022-08-20;0;0;0;0;0;0;0;0;0;0;0;0;0;0;0;0;0;0
FR;10;2022-08-21;0;0;0;0;0;0;0;0;0;0;0;0;0;0;0;0;0;0
FR;10;2022-08-22;0;0;0;0;0;0;0;0;0;0;0;0;0;0;0;0;0;0
FR;10;2022-08-23;0;0;0;0;0;0;0;0;0;0;0;0;0;0;0;0;0;0
FR;10;2022-08-24;0;0;0;0;0;0;0;0;0;0;0;0;0;0;0;0;0;0
FR;10;2022-08-25;0;0;0;0;0;0;0;0;0;0;0;0;0;0;0;0;0;0
FR;10;2022-08-26;0;0;0;0;0;0;0;0;0;0;0;0;0;0;0;0;0;0
FR;10;2022-08-27;0;0;0;0;0;0;0;0;0;0;0;0;0;0;0;0;0;0
FR;10;2022-08-28;0;0;0;0;0;0;0;0;0;0;0;0;0;0;0;0;0;0
FR;10;2022-08-29;0;0;0;0;0;0;0;0;0;0;0;0;0;0;0;0;0;0
FR;10;2022-08-30;0;0;0;0;0;0;0;0;0;0;0;0;0;0;0;0;0;0
FR;10;2022-08-31;0;0;0;0;0;0;0;0;0;0;0;0;0;0;0;0;0;0
FR;10;2022-09-01;0;0;0;0;0;0;0;0;0;0;0;0;0;0;0;0;0;0
FR;10;2022-09-02;0;0;0;0;0;0;0;0;0;0;0;0;0;0;0;0;0;0
FR;10;2022-09-03;0;0;0;0;0;0;0;0;0;0;0;0;0;0;0;0;0;0
FR;10;2022-09-04;0;0;0;0;0;0;0;0;0;0;0;0;0;0;0;0;0;0
FR;10;2022-09-05;0;0;0;0;0;0;0;0;0;0;0;0;0;0;0;0;0;0
FR;10;2022-09-06;0;0;0;0;0;0;0;0;0;0;0;0;0;0;0;0;0;0
FR;10;2022-09-07;0;0;0;0;0;0;0;0;0;0;0;0;0;0;0;0;0;0
FR;10;2022-09-08;0;0;0;0;0;0;0;0;0;0;0;0;0;0;0;0;0;0
FR;10;2022-09-09;0;0;0;0;0;0;0;0;0;0;0;0;0;0;0;0;0;0
FR;10;2022-09-10;0;0;0;0;0;0;0;0;0;0;0;0;0;0;0;0;0;0
FR;10;2022-09-11;0;0;0;0;0;0;0;0;0;0;0;0;0;0;0;0;0;0
FR;10;2022-09-12;0;0;0;0;0;0;0;0;0;0;0;0;0;0;0;0;0;0
FR;10;2022-09-13;0;0;0;0;0;0;0;0;0;0;0;0;0;0;0;0;0;0
FR;10;2022-09-14;0;0;0;0;0;0;0;0;0;0;0;0;0;0;0;0;0;0
FR;10;2022-09-15;0;0;0;0;0;0;0;0;0;0;0;0;0;0;0;0;0;0
FR;10;2022-09-16;0;0;0;0;0;0;0;0;0;0;0;0;0;0;0;0;0;0
FR;10;2022-09-17;0;0;0;0;0;0;0;0;0;0;0;0;0;0;0;0;0;0
FR;10;2022-09-18;0;0;0;0;0;0;0;0;0;0;0;0;0;0;0;0;0;0
FR;10;2022-09-19;0;0;0;0;0;0;0;0;0;0;0;0;0;0;0;0;0;0
FR;10;2022-09-20;0;0;0;0;0;0;0;0;0;0;0;0;0;0;0;0;0;0
FR;10;2022-09-21;0;0;0;0;0;0;0;0;0;0;0;0;0;0;0;0;0;0
FR;10;2022-09-22;0;0;0;0;0;0;0;0;0;0;0;0;0;0;0;0;0;0
FR;10;2022-09-23;0;0;0;0;0;0;0;0;0;0;0;0;0;0;0;0;0;0
FR;10;2022-09-24;0;0;0;0;0;0;0;0;0;0;0;0;0;0;0;0;0;0
FR;10;2022-09-25;0;0;0;0;0;0;0;0;0;0;0;0;0;0;0;0;0;0
FR;10;2022-09-26;0;0;0;0;0;0;0;0;0;0;0;0;0;0;0;0;0;0
FR;10;2022-09-27;0;0;0;0;0;0;0;0;0;0;0;0;0;0;0;0;0;0
FR;10;2022-09-28;0;0;0;0;0;0;0;0;0;0;0;0;0;0;0;0;0;0
FR;10;2022-09-29;0;0;0;0;0;0;0;0;0;0;0;0;0;0;0;0;0;0
FR;10;2022-09-30;0;0;0;0;0;0;0;0;0;0;0;0;0;0;0;0;0;0
FR;10;2022-10-01;0;0;0;0;0;0;0;0;0;0;0;0;0;0;0;0;0;0
FR;10;2022-10-02;0;0;0;0;0;0;0;0;0;0;0;0;0;0;0;0;0;0
FR;10;2022-10-03;0;0;0;0;0;0;0;0;0;0;0;0;0;0;0;0;0;0
FR;10;2022-10-04;0;0;0;0;0;0;0;0;0;0;0;0;0;0;0;0;0;0
FR;10;2022-10-05;0;0;0;0;0;0;0;0;0;0;0;0;0;0;0;0;0;0
FR;10;2022-10-06;0;0;0;0;0;0;0;0;0;0;0;0;0;0;0;0;0;0
FR;10;2022-10-07;0;0;0;0;0;0;0;0;0;0;0;0;0;0;0;0;0;0
FR;10;2022-10-08;0;0;0;0;0;0;0;0;0;0;0;0;0;0;0;0;0;0
FR;10;2022-10-09;0;0;0;0;0;0;0;0;0;0;0;0;0;0;0;0;0;0
FR;10;2022-10-10;0;0;0;0;0;0;0;0;0;0;0;0;0;0;0;0;0;0
FR;10;2022-10-11;0;0;0;0;0;0;0;0;0;0;0;0;0;0;0;0;0;0
FR;10;2022-10-12;0;0;0;0;0;0;0;0;0;0;0;0;0;0;0;0;0;0
FR;10;2022-10-13;0;0;0;0;0;0;0;0;0;0;0;0;0;0;0;0;0;0
FR;10;2022-10-14;0;0;0;0;0;0;0;0;0;0;0;0;0;0;0;0;0;0
FR;10;2022-10-15;0;0;0;0;0;0;0;0;0;0;0;0;0;0;0;0;0;0
FR;10;2022-10-16;0;0;0;0;0;0;0;0;0;0;0;0;0;0;0;0;0;0
FR;10;2022-10-17;0;0;0;0;0;0;0;0;0;0;0;0;0;0;0;0;0;0
FR;10;2022-10-18;0;0;0;0;0;0;0;0;0;0;0;0;0;0;0;0;0;0
FR;10;2022-10-19;0;0;0;0;0;0;0;0;0;0;0;0;0;0;0;0;0;0
FR;10;2022-10-20;0;0;0;0;0;0;0;0;0;0;0;0;0;0;0;0;0;0
FR;10;2022-10-21;0;0;0;0;0;0;0;0;0;0;0;0;0;0;0;0;0;0
FR;10;2022-10-22;0;0;0;0;0;0;0;0;0;0;0;0;0;0;0;0;0;0
FR;10;2022-10-23;0;0;0;0;0;0;0;0;0;0;0;0;0;0;0;0;0;0
FR;10;2022-10-24;0;0;0;0;0;0;0;0;0;0;0;0;0;0;0;0;0;0
FR;10;2022-10-25;0;0;0;0;0;0;0;0;0;0;0;0;0;0;0;0;0;0
FR;10;2022-10-26;0;0;0;0;0;0;0;0;0;0;0;0;0;0;0;0;0;0
FR;10;2022-10-27;0;0;0;0;0;0;0;0;0;0;0;0;0;0;0;0;0;0
FR;10;2022-10-28;0;0;0;0;0;0;0;0;0;0;0;0;0;0;0;0;0;0
FR;10;2022-10-29;0;0;0;0;0;0;0;0;0;0;0;0;0;0;0;0;0;0
FR;10;2022-10-30;0;0;0;0;0;0;0;0;0;0;0;0;0;0;0;0;0;0
FR;10;2022-10-31;0;0;0;0;0;0;0;0;0;0;0;0;0;0;0;0;0;0
FR;10;2022-11-01;0;0;0;0;0;0;0;0;0;0;0;0;0;0;0;0;0;0
FR;10;2022-11-02;0;0;0;0;0;0;0;0;0;0;0;0;0;0;0;0;0;0
FR;10;2022-11-03;0;0;0;0;0;0;0;0;0;0;0;0;0;0;0;0;0;0
FR;10;2022-11-04;0;0;0;0;0;0;0;0;0;0;0;0;0;0;0;0;0;0
FR;10;2022-11-05;0;0;0;0;0;0;0;0;0;0;0;0;0;0;0;0;0;0
FR;10;2022-11-06;0;0;0;0;0;0;0;0;0;0;0;0;0;0;0;0;0;0
FR;10;2022-11-07;0;0;0;0;0;0;0;0;0;0;0;0;0;0;0;0;0;0
FR;10;2022-11-08;0;0;0;0;0;0;0;0;0;0;0;0;0;0;0;0;0;0
FR;10;2022-11-09;0;0;0;0;0;0;0;0;0;0;0;0;0;0;0;0;0;0
FR;10;2022-11-10;0;0;0;0;0;0;0;0;0;0;0;0;0;0;0;0;0;0
FR;10;2022-11-11;0;0;0;0;0;0;0;0;0;0;0;0;0;0;0;0;0;0
FR;10;2022-11-12;0;0;0;0;0;0;0;0;0;0;0;0;0;0;0;0;0;0
FR;10;2022-11-13;0;0;0;0;0;0;0;0;0;0;0;0;0;0;0;0;0;0
FR;10;2022-11-14;0;0;0;0;0;0;0;0;0;0;0;0;0;0;0;0;0;0
FR;10;2022-11-15;0;0;0;0;0;0;0;0;0;0;0;0;0;0;0;0;0;0
FR;10;2022-11-16;0;0;0;0;0;0;0;0;0;0;0;0;0;0;0;0;0;0
FR;10;2022-11-17;0;0;0;0;0;0;0;0;0;0;0;0;0;0;0;0;0;0
FR;10;2022-11-18;0;0;0;0;0;0;0;0;0;0;0;0;0;0;0;0;0;0
FR;10;2022-11-19;0;0;0;0;0;0;0;0;0;0;0;0;0;0;0;0;0;0
FR;10;2022-11-20;0;0;0;0;0;0;0;0;0;0;0;0;0;0;0;0;0;0
FR;10;2022-11-21;0;0;0;0;0;0;0;0;0;0;0;0;0;0;0;0;0;0
FR;10;2022-11-22;0;0;0;0;0;0;0;0;0;0;0;0;0;0;0;0;0;0
FR;10;2022-11-23;0;0;0;0;0;0;0;0;0;0;0;0;0;0;0;0;0;0
FR;10;2022-11-24;0;0;0;0;0;0;0;0;0;0;0;0;0;0;0;0;0;0
FR;10;2022-11-25;0;0;0;0;0;0;0;0;0;0;0;0;0;0;0;0;0;0
FR;10;2022-11-26;0;0;0;0;0;0;0;0;0;0;0;0;0;0;0;0;0;0
FR;10;2022-11-27;0;0;0;0;0;0;0;0;0;0;0;0;0;0;0;0;0;0
FR;10;2022-11-28;0;0;0;0;0;0;0;0;0;0;0;0;0;0;0;0;0;0
FR;10;2022-11-29;0;0;0;0;0;0;0;0;0;0;0;0;0;0;0;0;0;0
FR;10;2022-11-30;0;0;0;0;0;0;0;0;0;0;0;0;0;0;0;0;0;0
FR;10;2022-12-01;0;0;0;0;0;0;0;0;0;0;0;0;0;0;0;0;0;0
FR;10;2022-12-02;0;0;0;0;0;0;0;0;0;0;0;0;0;0;0;0;0;0
FR;10;2022-12-03;0;0;0;0;0;0;0;0;0;0;0;0;0;0;0;0;0;0
FR;10;2022-12-04;0;0;0;0;0;0;0;0;0;0;0;0;0;0;0;0;0;0
FR;10;2022-12-05;0;0;0;0;0;0;0;0;0;0;0;0;0;0;0;0;0;0
FR;10;2022-12-06;0;0;0;0;0;0;0;0;0;0;0;0;0;0;0;0;0;0
FR;10;2022-12-07;0;0;0;0;0;0;0;0;0;0;0;0;0;0;0;0;0;0
FR;10;2022-12-08;0;0;0;0;0;0;0;0;0;0;0;0;0;0;0;0;0;0
FR;10;2022-12-09;0;0;0;0;0;0;0;0;0;0;0;0;0;0;0;0;0;0
FR;10;2022-12-10;0;0;0;0;0;0;0;0;0;0;0;0;0;0;0;0;0;0
FR;10;2022-12-11;0;0;0;0;0;0;0;0;0;0;0;0;0;0;0;0;0;0
FR;10;2022-12-12;0;0;0;0;0;0;0;0;0;0;0;0;0;0;0;0;0;0
FR;10;2022-12-13;0;0;0;0;0;0;0;0;0;0;0;0;0;0;0;0;0;0
FR;10;2022-12-14;0;0;0;0;0;0;0;0;0;0;0;0;0;0;0;0;0;0
FR;10;2022-12-15;0;0;0;0;0;0;0;0;0;0;0;0;0;0;0;0;0;0
FR;10;2022-12-16;0;0;0;0;0;0;0;0;0;0;0;0;0;0;0;0;0;0
FR;10;2022-12-17;0;0;0;0;0;0;0;0;0;0;0;0;0;0;0;0;0;0
FR;10;2022-12-18;0;0;0;0;0;0;0;0;0;0;0;0;0;0;0;0;0;0
FR;10;2022-12-19;0;0;0;0;0;0;0;0;0;0;0;0;0;0;0;0;0;0
FR;10;2022-12-20;0;0;0;0;0;0;0;0;0;0;0;0;0;0;0;0;0;0
FR;10;2022-12-21;0;0;1;0;0;1;0;0;0;0;0;1;0;0;1;0;0;0
FR;10;2022-12-22;0;0;0;1;0;0;1;0;0;0;0;1;1;0;1;1;0;0
FR;10;2022-12-23;0;0;1;14;0;2;14;0;7;0;0;2;15;0;3;15;0;7
FR;10;2022-12-24;0;0;0;3;0;0;3;0;1;0;0;2;18;0;3;18;0;8
FR;10;2022-12-25;0;0;0;0;0;0;0;0;0;0;0;2;18;0;3;18;0;8
FR;10;2022-12-26;3;1;11;35;0;8;39;0;5;3;1;13;53;0;11;57;0;13
FR;10;2022-12-27;1;1;14;35;1;11;38;0;10;4;2;27;88;1;22;95;0;23
FR;10;2022-12-28;0;0;2;15;0;1;14;0;3;4;2;29;103;1;23;109;0;26
FR;10;2022-12-29;0;0;6;48;0;1;48;0;17;4;2;35;151;1;24;157;0;43
FR;10;2022-12-30;0;1;5;33;0;8;31;0;6;4;3;40;184;1;32;188;0;49
FR;10;2022-12-31;0;0;3;12;0;4;10;0;4;4;3;43;196;1;36;198;0;53
FR;10;2023-01-01;0;0;1;6;0;0;7;0;2;4;3;44;202;1;36;205;0;55
FR;10;2023-01-02;0;4;4;37;1;6;36;0;21;4;7;48;239;2;42;241;0;76
FR;10;2023-01-03;1;2;6;63;2;5;64;0;25;5;9;54;302;4;47;305;0;101
FR;10;2023-01-04;0;1;7;52;0;6;53;0;53;5;10;61;354;4;53;358;0;154
FR;10;2023-01-05;1;2;16;74;0;12;76;0;37;6;12;77;428;4;65;434;0;191
FR;10;2023-01-06;2;3;16;107;2;13;107;0;52;8;15;93;535;6;78;541;0;243
FR;10;2023-01-07;3;1;3;41;1;3;40;0;13;11;16;96;576;7;81;581;0;256
FR;10;2023-01-08;1;0;0;9;0;0;7;0;5;12;16;96;585;7;81;588;0;261
FR;10;2023-01-09;3;2;7;67;1;7;66;0;26;15;18;103;652;8;88;654;0;287
FR;10;2023-01-10;6;1;21;118;0;13;124;0;57;21;19;124;770;8;101;778;0;344
FR;10;2023-01-11;5;4;19;77;1;16;79;0;38;26;23;143;847;9;117;857;0;382
FR;10;2023-01-12;13;1;7;77;2;3;80;0;51;39;24;150;924;11;120;937;0;433
FR;10;2023-01-13;0;6;15;122;1;8;129;0;77;39;30;165;1046;12;128;1066;0;510
FR;10;2023-01-14;2;1;8;43;0;5;47;0;3;41;31;173;1089;12;133;1113;0;513
FR;10;2023-01-15;0;0;2;10;0;1;7;0;8;41;31;175;1099;12;134;1120;0;521
FR;10;2023-01-16;0;1;11;70;1;7;73;0;68;41;32;186;1169;13;141;1193;0;589
FR;10;2023-01-17;0;7;22;109;2;11;118;0;61;41;39;208;1278;15;152;1311;0;650
FR;10;2023-01-18;2;1;13;92;1;9;104;0;15;43;40;221;1370;16;161;1415;0;665
FR;10;2023-01-19;6;6;24;142;3;22;135;0;56;49;46;245;1512;19;183;1550;0;721
FR;10;2023-01-20;2;1;11;111;0;9;106;0;73;51;47;256;1623;19;192;1656;0;794
FR;10;2023-01-21;2;1;5;26;0;5;23;0;15;53;48;261;1649;19;197;1679;0;809
FR;10;2023-01-22;0;0;0;5;0;0;5;0;0;53;48;261;1654;19;197;1684;0;809
FR;10;2023-01-23;1;2;5;62;1;5;59;0;23;54;50;266;1716;20;202;1743;0;832
FR;10;2023-01-24;6;6;27;148;2;19;152;0;75;60;56;293;1864;22;221;1895;0;907
FR;10;2023-01-25;2;1;9;81;1;5;82;0;55;62;57;302;1945;23;226;1977;0;962
FR;10;2023-01-26;4;5;33;147;1;22;159;0;52;66;62;335;2092;24;248;2136;0;1014
FR;10;2023-01-27;1;1;16;117;1;6;118;0;78;67;63;351;2209;25;254;2254;0;1092
FR;10;2023-01-28;0;1;3;18;1;1;21;0;15;67;64;354;2227;26;255;2275;0;1107
FR;10;2023-01-29;0;0;1;0;0;1;0;0;1;67;64;355;2227;26;256;2275;0;1108
FR;10;2023-01-30;2;1;11;60;1;5;63;0;40;69;65;366;2287;27;261;2338;0;1148
FR;10;2023-01-31;5;2;25;121;3;18;121;0;51;74;67;391;2408;30;279;2459;0;1199
FR;10;2023-02-01;0;2;11;49;2;10;49;0;28;74;69;402;2457;32;289;2508;0;1227
FR;10;2023-02-02;3;0;21;104;0;16;108;0;48;77;69;423;2561;32;305;2616;0;1275
FR;10;2023-02-03;6;5;18;48;4;11;51;0;64;83;74;441;2609;36;316;2667;0;1339
FR;10;2023-02-04;1;0;1;8;0;0;10;0;6;84;74;442;2617;36;316;2677;0;1345
FR;10;2023-02-05;7;1;2;3;2;1;4;0;5;91;75;444;2620;38;317;2681;0;1350
FR;10;2023-02-06;1;0;9;28;0;8;22;0;46;92;75;453;2648;38;325;2703;0;1396
FR;10;2023-02-07;2;2;2;12;1;3;12;0;13;94;77;455;2660;39;328;2715;0;1409
FR;10;2023-02-08;1;3;3;15;2;4;15;0;12;95;80;458;2675;41;332;2730;0;1421
FR;10;2023-02-09;2;1;11;91;2;7;97;0;41;97;81;469;2766;43;339;2827;0;1462
FR;10;2023-02-10;8;3;12;29;0;6;37;0;25;105;84;481;2795;43;345;2864;0;1487
FR;10;2023-02-11;1;0;2;2;0;2;2;0;1;106;84;483;2797;43;347;2866;0;1488
FR;10;2023-02-12;1;1;0;0;1;0;0;0;0;107;85;483;2797;44;347;2866;0;1488
FR;10;2023-02-13;3;1;9;15;0;7;18;0;10;110;86;492;2812;44;354;2884;0;1498
FR;10;2023-02-14;2;4;11;49;3;9;50;0;17;112;90;503;2861;47;363;2934;0;1515
FR;10;2023-02-15;7;3;2;10;2;3;8;0;8;119;93;505;2871;49;366;2942;0;1523
FR;10;2023-02-16;0;0;8;17;0;5;18;0;8;119;93;513;2888;49;371;2960;0;1531
FR;10;2023-02-17;13;5;7;28;5;2;22;0;17;132;98;520;2916;54;373;2982;0;1548
FR;10;2023-02-18;2;0;3;11;0;3;10;0;6;134;98;523;2927;54;376;2992;0;1554
FR;10;2023-02-19;0;0;0;0;0;0;0;0;0;134;98;523;2927;54;376;2992;0;1554
FR;10;2023-02-20;2;1;2;25;1;1;23;0;23;136;99;525;2952;55;377;3015;0;1577
FR;10;2023-02-21;2;3;12;27;1;6;35;0;30;138;102;537;2979;56;383;3050;0;1607
FR;10;2023-02-22;5;4;2;7;3;3;6;0;1;143;106;539;2986;59;386;3056;0;1608
FR;10;2023-02-23;3;2;17;31;2;14;37;0;12;146;108;556;3017;61;400;3093;0;1620
FR;10;2023-02-24;1;2;8;27;0;5;27;0;29;147;110;564;3044;61;405;3120;0;1649
FR;10;2023-02-25;0;0;2;3;0;2;3;0;7;147;110;566;3047;61;407;3123;0;1656
FR;10;2023-02-26;0;0;0;0;0;0;0;0;0;147;110;566;3047;61;407;3123;0;1656
FR;10;2023-02-27;3;3;3;20;4;3;21;0;15;150;113;569;3067;65;410;3144;0;1671
FR;10;2023-02-28;3;2;3;10;2;1;11;0;10;153;115;572;3077;67;411;3155;0;1681
FR;10;2023-03-01;2;6;34;12;6;33;12;0;14;155;121;606;3089;73;444;3167;0;1695
FR;10;2023-03-02;2;1;10;22;2;6;22;0;31;157;122;616;3111;75;450;3189;0;1726
FR;10;2023-03-03;7;2;5;21;0;6;20;0;18;164;124;621;3132;75;456;3209;0;1744
FR;10;2023-03-04;0;1;0;6;1;0;6;0;2;164;125;621;3138;76;456;3215;0;1746
FR;10;2023-03-05;0;0;0;1;0;0;0;0;2;164;125;621;3139;76;456;3215;0;1748
FR;10;2023-03-06;2;2;8;8;3;7;9;0;8;166;127;629;3147;79;463;3224;0;1756
FR;10;2023-03-07;2;3;0;11;1;2;11;0;8;168;130;629;3158;80;465;3235;0;1764
FR;10;2023-03-08;1;4;4;20;3;3;22;0;9;169;134;633;3178;83;468;3257;0;1773
FR;10;2023-03-09;0;3;1;9;1;2;8;0;8;169;137;634;3187;84;470;3265;0;1781
FR;10;2023-03-10;1;2;1;8;2;1;9;0;9;170;139;635;3195;86;471;3274;0;1790
FR;10;2023-03-11;2;1;5;4;0;3;7;0;2;172;140;640;3199;86;474;3281;0;1792
FR;10;2023-03-12;0;0;0;0;0;0;0;0;0;172;140;640;3199;86;474;3281;0;1792
FR;10;2023-03-13;0;2;2;3;2;2;3;0;5;172;142;642;3202;88;476;3284;0;1797
FR;10;2023-03-14;2;0;6;25;0;4;27;0;21;174;142;648;3227;88;480;3311;0;1818
FR;10;2023-03-15;0;2;5;5;1;7;4;0;6;174;144;653;3232;89;487;3315;0;1824
FR;10;2023-03-16;3;1;7;12;0;5;15;0;11;177;145;660;3244;89;492;3330;0;1835
FR;10;2023-03-17;3;5;8;18;4;4;22;0;19;180;150;668;3262;93;496;3352;0;1854
FR;10;2023-03-18;0;1;1;3;0;2;2;0;3;180;151;669;3265;93;498;3354;0;1857
FR;10;2023-03-19;6;0;0;0;0;0;0;0;0;186;151;669;3265;93;498;3354;0;1857
FR;10;2023-03-20;5;4;0;12;3;1;13;0;12;191;155;669;3277;96;499;3367;0;1869
FR;10;2023-03-21;1;2;2;7;0;3;9;0;14;192;157;671;3284;96;502;3376;0;1883
FR;10;2023-03-22;0;0;3;4;0;3;3;0;3;192;157;674;3288;96;505;3379;0;1886
FR;10;2023-03-23;9;9;4;6;9;1;8;0;13;201;166;678;3294;105;506;3387;0;1899
FR;10;2023-03-24;3;3;2;14;2;1;10;0;17;204;169;680;3308;107;507;3397;0;1916
FR;10;2023-03-25;1;3;0;4;1;3;5;0;8;205;172;680;3312;108;510;3402;0;1924
FR;10;2023-03-26;1;1;0;0;1;0;0;0;0;206;173;680;3312;109;510;3402;0;1924
FR;10;2023-03-27;0;2;3;4;2;3;2;0;16;206;175;683;3316;111;513;3404;0;1940
FR;10;2023-03-28;9;8;3;5;8;1;6;0;6;215;183;686;3321;119;514;3410;0;1946
FR;10;2023-03-29;7;7;3;2;6;4;2;0;6;222;190;689;3323;125;518;3412;0;1952
FR;10;2023-03-30;16;13;3;7;13;2;8;0;6;238;203;692;3330;138;520;3420;0;1958
FR;10;2023-03-31;8;6;4;12;5;4;13;0;19;246;209;696;3342;143;524;3433;0;1977
FR;10;2023-04-01;9;8;1;0;8;1;0;0;0;255;217;697;3342;151;525;3433;0;1977
FR;10;2023-04-02;1;0;0;0;0;0;0;0;1;256;217;697;3342;151;525;3433;0;1978
FR;10;2023-04-03;2;1;0;3;1;0;2;0;5;258;218;697;3345;152;525;3435;0;1983
FR;10;2023-04-04;0;1;0;3;1;0;3;0;5;258;219;697;3348;153;525;3438;0;1988
FR;10;2023-04-05;0;0;2;1;0;2;3;0;2;258;219;699;3349;153;527;3441;0;1990
FR;10;2023-04-06;2;2;4;4;2;1;7;0;2;260;221;703;3353;155;528;3448;0;1992
FR;10;2023-04-07;3;0;2;3;0;1;3;0;9;263;221;705;3356;155;529;3451;0;2001
FR;10;2023-04-08;0;0;1;0;0;1;0;0;0;263;221;706;3356;155;530;3451;0;2001
FR;10;2023-04-09;0;0;0;0;0;0;0;0;0;263;221;706;3356;155;530;3451;0;2001
FR;10;2023-04-10;0;0;2;0;0;0;2;0;0;263;221;708;3356;155;530;3453;0;2001
FR;10;2023-04-11;1;0;1;3;0;1;2;0;3;264;221;709;3359;155;531;3455;0;2004
FR;10;2023-04-12;0;0;2;1;0;1;2;0;4;264;221;711;3360;155;532;3457;0;2008
FR;10;2023-04-13;0;1;0;5;1;0;5;0;5;264;222;711;3365;156;532;3462;0;2013
FR;10;2023-04-14;3;0;1;7;0;1;4;0;5;267;222;712;3372;156;533;3466;0;2018
FR;10;2023-04-15;0;1;1;3;1;0;4;0;0;267;223;713;3375;157;533;3470;0;2018
FR;10;2023-04-16;0;0;0;2;0;0;2;0;0;267;223;713;3377;157;533;3472;0;2018
FR;10;2023-04-17;1;2;2;0;1;2;0;0;0;268;225;715;3377;158;535;3472;0;2018
FR;10;2023-04-18;2;2;1;3;2;1;0;0;2;270;227;716;3380;160;536;3472;0;2020
FR;10;2023-04-19;0;0;1;0;0;1;0;0;1;270;227;717;3380;160;537;3472;0;2021
FR;10;2023-04-20;0;2;1;1;1;2;1;0;2;270;229;718;3381;161;539;3473;0;2023
FR;10;2023-04-21;0;1;5;7;0;4;9;0;3;270;230;723;3388;161;543;3482;0;2026
FR;10;2023-04-22;1;1;0;2;1;0;2;0;1;271;231;723;3390;162;543;3484;0;2027
FR;10;2023-04-23;0;0;0;0;0;0;0;0;0;271;231;723;3390;162;543;3484;0;2027
FR;10;2023-04-24;0;1;0;0;1;0;0;0;4;271;232;723;3390;163;543;3484;0;2031
FR;10;2023-04-25;0;0;1;0;0;1;0;0;2;271;232;724;3390;163;544;3484;0;2033
FR;10;2023-04-26;1;0;2;1;1;2;1;0;1;272;232;726;3391;164;546;3485;0;2034
FR;10;2023-04-27;0;0;1;1;0;1;1;0;1;272;232;727;3392;164;547;3486;0;2035
FR;10;2023-04-28;0;1;3;5;1;0;6;0;6;272;233;730;3397;165;547;3492;0;2041
FR;10;2023-04-29;0;0;0;1;0;0;0;0;1;272;233;730;3398;165;547;3492;0;2042
FR;10;2023-04-30;0;0;0;0;0;0;0;0;0;272;233;730;3398;165;547;3492;0;2042
FR;10;2023-05-01;0;0;0;0;0;0;0;0;0;272;233;730;3398;165;547;3492;0;2042
FR;10;2023-05-02;2;1;0;2;2;0;2;0;4;274;234;730;3400;167;547;3494;0;2046
FR;10;2023-05-03;0;1;1;2;1;1;1;0;17;274;235;731;3402;168;548;3495;0;2063
FR;10;2023-05-04;0;1;1;0;1;1;0;0;1;274;236;732;3402;169;549;3495;0;2064
FR;10;2023-05-05;0;1;2;6;0;2;6;0;9;274;237;734;3408;169;551;3501;0;2073
FR;10;2023-05-06;0;0;3;3;0;2;4;0;1;274;237;737;3411;169;553;3505;0;2074
FR;10;2023-05-07;0;0;0;0;0;0;0;0;0;274;237;737;3411;169;553;3505;0;2074
FR;10;2023-05-08;0;0;0;0;0;0;0;0;0;274;237;737;3411;169;553;3505;0;2074
FR;10;2023-05-09;0;1;1;0;0;1;1;0;1;274;238;738;3411;169;554;3506;0;2075
FR;10;2023-05-10;15;5;1;1;5;0;2;0;0;289;243;739;3412;174;554;3508;0;2075
FR;10;2023-05-11;0;0;0;2;0;0;2;0;4;289;243;739;3414;174;554;3510;0;2079
FR;10;2023-05-12;1;0;1;6;0;2;5;0;9;290;243;740;3420;174;556;3515;0;2088
FR;10;2023-05-13;0;0;1;0;0;0;1;0;0;290;243;741;3420;174;556;3516;0;2088
FR;10;2023-05-14;0;0;0;0;0;0;0;0;0;290;243;741;3420;174;556;3516;0;2088
FR;10;2023-05-15;0;1;0;0;0;1;0;0;1;290;244;741;3420;174;557;3516;0;2089
FR;10;2023-05-16;0;0;0;2;0;0;2;0;3;290;244;741;3422;174;557;3518;0;2092
FR;10;2023-05-17;0;0;0;1;0;0;1;0;1;290;244;741;3423;174;557;3519;0;2093
FR;10;2023-05-18;1;0;0;0;0;0;0;0;0;291;244;741;3423;174;557;3519;0;2093
FR;10;2023-05-19;1;0;1;2;0;1;2;0;0;292;244;742;3425;174;558;3521;0;2093
FR;10;2023-05-20;1;0;0;1;0;0;1;0;1;293;244;742;3426;174;558;3522;0;2094
FR;10;2023-05-21;0;0;0;0;0;0;0;0;0;293;244;742;3426;174;558;3522;0;2094
FR;10;2023-05-22;1;0;1;3;0;1;3;0;0;294;244;743;3429;174;559;3525;0;2094
FR;10;2023-05-23;0;0;3;1;0;1;4;0;2;294;244;746;3430;174;560;3529;0;2096
FR;10;2023-05-24;1;2;0;0;3;0;1;0;5;295;246;746;3430;177;560;3530;0;2101
FR;10;2023-05-25;1;1;1;1;2;0;2;0;4;296;247;747;3431;179;560;3532;0;2105
FR;10;2023-05-26;1;0;2;5;0;2;5;0;6;297;247;749;3436;179;562;3537;0;2111
FR;10;2023-05-27;1;0;0;0;0;0;0;0;0;298;247;749;3436;179;562;3537;0;2111
FR;10;2023-05-28;1;0;0;0;1;0;0;0;0;299;247;749;3436;180;562;3537;0;2111
FR;10;2023-05-29;1;1;0;0;1;0;0;0;0;300;248;749;3436;181;562;3537;0;2111
FR;10;2023-05-30;0;0;1;3;0;1;4;0;1;300;248;750;3439;181;563;3541;0;2112
FR;10;2023-05-31;1;2;0;2;1;1;2;0;5;301;250;750;3441;182;564;3543;0;2117
FR;10;2023-06-01;0;0;2;0;0;2;0;0;8;301;250;752;3441;182;566;3543;0;2125
FR;10;2023-06-02;0;1;0;3;1;0;2;0;5;301;251;752;3444;183;566;3545;0;2130
FR;10;2023-06-03;0;0;0;1;0;0;1;0;1;301;251;752;3445;183;566;3546;0;2131
FR;10;2023-06-04;0;0;0;0;0;0;0;0;0;301;251;752;3445;183;566;3546;0;2131
FR;10;2023-06-05;0;0;0;2;0;0;2;0;1;301;251;752;3447;183;566;3548;0;2132
FR;10;2023-06-06;0;0;3;6;0;2;7;0;11;301;251;755;3453;183;568;3555;0;2143
FR;10;2023-06-07;0;0;0;0;0;0;0;0;0;301;251;755;3453;183;568;3555;0;2143
FR;10;2023-06-08;1;1;0;3;1;0;3;0;6;302;252;755;3456;184;568;3558;0;2149
FR;10;2023-06-09;1;0;0;0;0;0;0;0;0;303;252;755;3456;184;568;3558;0;2149
FR;10;2023-06-10;0;0;0;0;0;0;0;0;1;303;252;755;3456;184;568;3558;0;2150
FR;10;2023-06-11;0;0;0;0;0;0;0;0;0;303;252;755;3456;184;568;3558;0;2150
FR;10;2023-06-12;0;0;1;0;0;1;0;0;1;303;252;756;3456;184;569;3558;0;2151
FR;10;2023-06-13;1;1;0;0;1;0;0;0;5;304;253;756;3456;185;569;3558;0;2156
FR;10;2023-06-14;0;0;0;3;0;0;6;0;3;304;253;756;3459;185;569;3564;0;2159
FR;10;2023-06-15;0;0;2;3;0;1;4;0;5;304;253;758;3462;185;570;3568;0;2164
FR;10;2023-06-16;0;0;0;5;0;0;4;0;5;304;253;758;3467;185;570;3572;0;2169
FR;10;2023-06-17;0;0;0;2;0;0;2;0;2;304;253;758;3469;185;570;3574;0;2171
FR;10;2023-06-18;0;0;0;0;0;0;0;0;0;304;253;758;3469;185;570;3574;0;2171
FR;10;2023-06-19;0;1;0;1;0;1;1;0;0;304;254;758;3470;185;571;3575;0;2171
FR;10;2023-06-20;0;1;0;0;1;0;0;0;6;304;255;758;3470;186;571;3575;0;2177
FR;10;2023-06-21;1;0;0;0;0;0;0;0;2;305;255;758;3470;186;571;3575;0;2179
FR;10;2023-06-22;0;0;0;0;0;0;0;0;3;305;255;758;3470;186;571;3575;0;2182
FR;10;2023-06-23;0;0;1;5;0;0;6;0;7;305;255;759;3475;186;571;3581;0;2189
FR;10;2023-06-24;0;0;0;2;0;0;1;0;3;305;255;759;3477;186;571;3582;0;2192
FR;10;2023-06-25;0;0;0;0;0;0;0;0;0;305;255;759;3477;186;571;3582;0;2192
FR;10;2023-06-26;0;0;0;0;0;0;0;0;1;305;255;759;3477;186;571;3582;0;2193
FR;10;2023-06-27;0;0;0;1;0;0;1;0;1;305;255;759;3478;186;571;3583;0;2194
FR;10;2023-06-28;0;0;0;0;0;0;0;0;0;305;255;759;3478;186;571;3583;0;2194
FR;10;2023-06-29;0;0;1;4;0;0;5;0;5;305;255;760;3482;186;571;3588;0;2199
FR;10;2023-06-30;0;0;0;6;0;0;5;0;8;305;255;760;3488;186;571;3593;0;2207
FR;10;2023-07-01;1;0;0;0;0;0;0;0;0;306;255;760;3488;186;571;3593;0;2207
FR;10;2023-07-02;0;0;0;0;0;0;0;0;0;306;255;760;3488;186;571;3593;0;2207
FR;10;2023-07-03;0;0;0;0;0;0;0;0;0;306;255;760;3488;186;571;3593;0;2207
FR;10;2023-07-04;0;0;0;1;0;0;1;0;1;306;255;760;3489;186;571;3594;0;2208
FR;10;2023-07-05;1;0;0;0;0;0;0;0;0;307;255;760;3489;186;571;3594;0;2208
FR;10;2023-07-06;0;0;1;1;0;1;1;0;0;307;255;761;3490;186;572;3595;0;2208
FR;10;2023-07-07;0;0;3;2;0;1;2;0;7;307;255;764;3492;186;573;3597;0;2215
FR;10;2023-07-08;0;0;0;0;0;0;0;0;0;307;255;764;3492;186;573;3597;0;2215
FR;10;2023-07-09;0;0;0;0;0;0;0;0;0;307;255;764;3492;186;573;3597;0;2215
FR;10;2023-07-10;0;0;2;1;0;2;1;0;0;307;255;766;3493;186;575;3598;0;2215
FR;11;2020-12-27;0;0;0;0;0;0;0;0;0;0;0;0;0;0;0;0;0;0
FR;11;2020-12-28;0;0;0;0;0;0;0;0;0;0;0;0;0;0;0;0;0;0
FR;11;2020-12-29;0;0;0;0;0;0;0;0;0;0;0;0;0;0;0;0;0;0
FR;11;2020-12-30;0;0;0;0;0;0;0;0;0;0;0;0;0;0;0;0;0;0
FR;11;2020-12-31;0;0;0;0;0;0;0;0;0;0;0;0;0;0;0;0;0;0
FR;11;2021-01-01;0;0;0;0;0;0;0;0;0;0;0;0;0;0;0;0;0;0
FR;11;2021-01-02;0;0;0;0;0;0;0;0;0;0;0;0;0;0;0;0;0;0
FR;11;2021-01-03;0;0;0;0;0;0;0;0;0;0;0;0;0;0;0;0;0;0
FR;11;2021-01-04;0;0;0;0;0;0;0;0;0;0;0;0;0;0;0;0;0;0
FR;11;2021-01-05;0;0;0;0;0;0;0;0;0;0;0;0;0;0;0;0;0;0
FR;11;2021-01-06;0;0;0;0;0;0;0;0;0;0;0;0;0;0;0;0;0;0
FR;11;2021-01-07;0;0;0;0;0;0;0;0;0;0;0;0;0;0;0;0;0;0
FR;11;2021-01-08;0;0;0;0;0;0;0;0;0;0;0;0;0;0;0;0;0;0
FR;11;2021-01-09;0;0;0;0;0;0;0;0;0;0;0;0;0;0;0;0;0;0
FR;11;2021-01-10;0;0;0;0;0;0;0;0;0;0;0;0;0;0;0;0;0;0
FR;11;2021-01-11;0;0;0;0;0;0;0;0;0;0;0;0;0;0;0;0;0;0
FR;11;2021-01-12;0;0;0;0;0;0;0;0;0;0;0;0;0;0;0;0;0;0
FR;11;2021-01-13;0;0;0;0;0;0;0;0;0;0;0;0;0;0;0;0;0;0
FR;11;2021-01-14;0;0;0;0;0;0;0;0;0;0;0;0;0;0;0;0;0;0
FR;11;2021-01-15;0;0;0;0;0;0;0;0;0;0;0;0;0;0;0;0;0;0
FR;11;2021-01-16;0;0;0;0;0;0;0;0;0;0;0;0;0;0;0;0;0;0
FR;11;2021-01-17;0;0;0;0;0;0;0;0;0;0;0;0;0;0;0;0;0;0
FR;11;2021-01-18;0;0;0;0;0;0;0;0;0;0;0;0;0;0;0;0;0;0
FR;11;2021-01-19;0;0;0;0;0;0;0;0;0;0;0;0;0;0;0;0;0;0
FR;11;2021-01-20;0;0;0;0;0;0;0;0;0;0;0;0;0;0;0;0;0;0
FR;11;2021-01-21;0;0;0;0;0;0;0;0;0;0;0;0;0;0;0;0;0;0
FR;11;2021-01-22;0;0;0;0;0;0;0;0;0;0;0;0;0;0;0;0;0;0
FR;11;2021-01-23;0;0;0;0;0;0;0;0;0;0;0;0;0;0;0;0;0;0
FR;11;2021-01-24;0;0;0;0;0;0;0;0;0;0;0;0;0;0;0;0;0;0
FR;11;2021-01-25;0;0;0;0;0;0;0;0;0;0;0;0;0;0;0;0;0;0
FR;11;2021-01-26;0;0;0;0;0;0;0;0;0;0;0;0;0;0;0;0;0;0
FR;11;2021-01-27;0;0;0;0;0;0;0;0;0;0;0;0;0;0;0;0;0;0
FR;11;2021-01-28;0;0;0;0;0;0;0;0;0;0;0;0;0;0;0;0;0;0
FR;11;2021-01-29;0;0;0;0;0;0;0;0;0;0;0;0;0;0;0;0;0;0
FR;11;2021-01-30;0;0;0;0;0;0;0;0;0;0;0;0;0;0;0;0;0;0
FR;11;2021-01-31;0;0;0;0;0;0;0;0;0;0;0;0;0;0;0;0;0;0
FR;11;2021-02-01;0;0;0;0;0;0;0;0;0;0;0;0;0;0;0;0;0;0
FR;11;2021-02-02;0;0;0;0;0;0;0;0;0;0;0;0;0;0;0;0;0;0
FR;11;2021-02-03;0;0;0;0;0;0;0;0;0;0;0;0;0;0;0;0;0;0
FR;11;2021-02-04;0;0;0;0;0;0;0;0;0;0;0;0;0;0;0;0;0;0
FR;11;2021-02-05;0;0;0;0;0;0;0;0;0;0;0;0;0;0;0;0;0;0
FR;11;2021-02-06;0;0;0;0;0;0;0;0;0;0;0;0;0;0;0;0;0;0
FR;11;2021-02-07;0;0;0;0;0;0;0;0;0;0;0;0;0;0;0;0;0;0
FR;11;2021-02-08;0;0;0;0;0;0;0;0;0;0;0;0;0;0;0;0;0;0
FR;11;2021-02-09;0;0;0;0;0;0;0;0;0;0;0;0;0;0;0;0;0;0
FR;11;2021-02-10;0;0;0;0;0;0;0;0;0;0;0;0;0;0;0;0;0;0
FR;11;2021-02-11;0;0;0;0;0;0;0;0;0;0;0;0;0;0;0;0;0;0
FR;11;2021-02-12;0;0;0;0;0;0;0;0;0;0;0;0;0;0;0;0;0;0
FR;11;2021-02-13;0;0;0;0;0;0;0;0;0;0;0;0;0;0;0;0;0;0
FR;11;2021-02-14;0;0;0;0;0;0;0;0;0;0;0;0;0;0;0;0;0;0
FR;11;2021-02-15;0;0;0;0;0;0;0;0;0;0;0;0;0;0;0;0;0;0
FR;11;2021-02-16;0;0;0;0;0;0;0;0;0;0;0;0;0;0;0;0;0;0
FR;11;2021-02-17;0;0;0;0;0;0;0;0;0;0;0;0;0;0;0;0;0;0
FR;11;2021-02-18;0;0;0;0;0;0;0;0;0;0;0;0;0;0;0;0;0;0
FR;11;2021-02-19;0;0;0;0;0;0;0;0;0;0;0;0;0;0;0;0;0;0
FR;11;2021-02-20;0;0;0;0;0;0;0;0;0;0;0;0;0;0;0;0;0;0
FR;11;2021-02-21;0;0;0;0;0;0;0;0;0;0;0;0;0;0;0;0;0;0
FR;11;2021-02-22;0;0;0;0;0;0;0;0;0;0;0;0;0;0;0;0;0;0
FR;11;2021-02-23;0;0;0;0;0;0;0;0;0;0;0;0;0;0;0;0;0;0
FR;11;2021-02-24;0;0;0;0;0;0;0;0;0;0;0;0;0;0;0;0;0;0
FR;11;2021-02-25;0;0;0;0;0;0;0;0;0;0;0;0;0;0;0;0;0;0
FR;11;2021-02-26;0;0;0;0;0;0;0;0;0;0;0;0;0;0;0;0;0;0
FR;11;2021-02-27;0;0;0;0;0;0;0;0;0;0;0;0;0;0;0;0;0;0
FR;11;2021-02-28;0;0;0;0;0;0;0;0;0;0;0;0;0;0;0;0;0;0
FR;11;2021-03-01;0;0;0;0;0;0;0;0;0;0;0;0;0;0;0;0;0;0
FR;11;2021-03-02;0;0;0;0;0;0;0;0;0;0;0;0;0;0;0;0;0;0
FR;11;2021-03-03;0;0;0;0;0;0;0;0;0;0;0;0;0;0;0;0;0;0
FR;11;2021-03-04;0;0;0;0;0;0;0;0;0;0;0;0;0;0;0;0;0;0
FR;11;2021-03-05;0;0;0;0;0;0;0;0;0;0;0;0;0;0;0;0;0;0
FR;11;2021-03-06;0;0;0;0;0;0;0;0;0;0;0;0;0;0;0;0;0;0
FR;11;2021-03-07;0;0;0;0;0;0;0;0;0;0;0;0;0;0;0;0;0;0
FR;11;2021-03-08;0;0;0;0;0;0;0;0;0;0;0;0;0;0;0;0;0;0
FR;11;2021-03-09;0;0;0;0;0;0;0;0;0;0;0;0;0;0;0;0;0;0
FR;11;2021-03-10;0;0;0;0;0;0;0;0;0;0;0;0;0;0;0;0;0;0
FR;11;2021-03-11;0;0;0;0;0;0;0;0;0;0;0;0;0;0;0;0;0;0
FR;11;2021-03-12;0;0;0;0;0;0;0;0;0;0;0;0;0;0;0;0;0;0
FR;11;2021-03-13;0;0;0;0;0;0;0;0;0;0;0;0;0;0;0;0;0;0
FR;11;2021-03-14;0;0;0;0;0;0;0;0;0;0;0;0;0;0;0;0;0;0
FR;11;2021-03-15;0;0;0;0;0;0;0;0;0;0;0;0;0;0;0;0;0;0
FR;11;2021-03-16;0;0;0;0;0;0;0;0;0;0;0;0;0;0;0;0;0;0
FR;11;2021-03-17;0;0;0;0;0;0;0;0;0;0;0;0;0;0;0;0;0;0
FR;11;2021-03-18;0;0;0;0;0;0;0;0;0;0;0;0;0;0;0;0;0;0
FR;11;2021-03-19;0;0;0;0;0;0;0;0;0;0;0;0;0;0;0;0;0;0
FR;11;2021-03-20;0;0;0;0;0;0;0;0;0;0;0;0;0;0;0;0;0;0
FR;11;2021-03-21;0;0;0;0;0;0;0;0;0;0;0;0;0;0;0;0;0;0
FR;11;2021-03-22;0;0;0;0;0;0;0;0;0;0;0;0;0;0;0;0;0;0
FR;11;2021-03-23;0;0;0;0;0;0;0;0;0;0;0;0;0;0;0;0;0;0
FR;11;2021-03-24;0;0;0;0;0;0;0;0;0;0;0;0;0;0;0;0;0;0
FR;11;2021-03-25;0;0;0;0;0;0;0;0;0;0;0;0;0;0;0;0;0;0
FR;11;2021-03-26;0;0;0;0;0;0;0;0;0;0;0;0;0;0;0;0;0;0
FR;11;2021-03-27;0;0;0;0;0;0;0;0;0;0;0;0;0;0;0;0;0;0
FR;11;2021-03-28;0;0;0;0;0;0;0;0;0;0;0;0;0;0;0;0;0;0
FR;11;2021-03-29;0;0;0;0;0;0;0;0;0;0;0;0;0;0;0;0;0;0
FR;11;2021-03-30;0;0;0;0;0;0;0;0;0;0;0;0;0;0;0;0;0;0
FR;11;2021-03-31;0;0;0;0;0;0;0;0;0;0;0;0;0;0;0;0;0;0
FR;11;2021-04-01;0;0;0;0;0;0;0;0;0;0;0;0;0;0;0;0;0;0
FR;11;2021-04-02;0;0;0;0;0;0;0;0;0;0;0;0;0;0;0;0;0;0
FR;11;2021-04-03;0;0;0;0;0;0;0;0;0;0;0;0;0;0;0;0;0;0
FR;11;2021-04-04;0;0;0;0;0;0;0;0;0;0;0;0;0;0;0;0;0;0
FR;11;2021-04-05;0;0;0;0;0;0;0;0;0;0;0;0;0;0;0;0;0;0
FR;11;2021-04-06;0;0;0;0;0;0;0;0;0;0;0;0;0;0;0;0;0;0
FR;11;2021-04-07;0;0;0;0;0;0;0;0;0;0;0;0;0;0;0;0;0;0
FR;11;2021-04-08;0;0;0;0;0;0;0;0;0;0;0;0;0;0;0;0;0;0
FR;11;2021-04-09;0;0;0;0;0;0;0;0;0;0;0;0;0;0;0;0;0;0
FR;11;2021-04-10;0;0;0;0;0;0;0;0;0;0;0;0;0;0;0;0;0;0
FR;11;2021-04-11;0;0;0;0;0;0;0;0;0;0;0;0;0;0;0;0;0;0
FR;11;2021-04-12;0;0;0;0;0;0;0;0;0;0;0;0;0;0;0;0;0;0
FR;11;2021-04-13;0;0;0;0;0;0;0;0;0;0;0;0;0;0;0;0;0;0
FR;11;2021-04-14;0;0;0;0;0;0;0;0;0;0;0;0;0;0;0;0;0;0
FR;11;2021-04-15;0;0;0;0;0;0;0;0;0;0;0;0;0;0;0;0;0;0
FR;11;2021-04-16;0;0;0;0;0;0;0;0;0;0;0;0;0;0;0;0;0;0
FR;11;2021-04-17;0;0;0;0;0;0;0;0;0;0;0;0;0;0;0;0;0;0
FR;11;2021-04-18;0;0;0;0;0;0;0;0;0;0;0;0;0;0;0;0;0;0
FR;11;2021-04-19;0;0;0;0;0;0;0;0;0;0;0;0;0;0;0;0;0;0
FR;11;2021-04-20;0;0;0;0;0;0;0;0;0;0;0;0;0;0;0;0;0;0
FR;11;2021-04-21;0;0;0;0;0;0;0;0;0;0;0;0;0;0;0;0;0;0
FR;11;2021-04-22;0;0;0;0;0;0;0;0;0;0;0;0;0;0;0;0;0;0
FR;11;2021-04-23;0;0;0;0;0;0;0;0;0;0;0;0;0;0;0;0;0;0
FR;11;2021-04-24;0;0;0;0;0;0;0;0;0;0;0;0;0;0;0;0;0;0
FR;11;2021-04-25;0;0;0;0;0;0;0;0;0;0;0;0;0;0;0;0;0;0
FR;11;2021-04-26;0;0;0;0;0;0;0;0;0;0;0;0;0;0;0;0;0;0
FR;11;2021-04-27;0;0;0;0;0;0;0;0;0;0;0;0;0;0;0;0;0;0
FR;11;2021-04-28;0;0;0;0;0;0;0;0;0;0;0;0;0;0;0;0;0;0
FR;11;2021-04-29;0;0;0;0;0;0;0;0;0;0;0;0;0;0;0;0;0;0
FR;11;2021-04-30;0;0;0;0;0;0;0;0;0;0;0;0;0;0;0;0;0;0
FR;11;2021-05-01;0;0;0;0;0;0;0;0;0;0;0;0;0;0;0;0;0;0
FR;11;2021-05-02;0;0;0;0;0;0;0;0;0;0;0;0;0;0;0;0;0;0
FR;11;2021-05-03;0;0;0;0;0;0;0;0;0;0;0;0;0;0;0;0;0;0
FR;11;2021-05-04;0;0;0;0;0;0;0;0;0;0;0;0;0;0;0;0;0;0
FR;11;2021-05-05;0;0;0;0;0;0;0;0;0;0;0;0;0;0;0;0;0;0
FR;11;2021-05-06;0;0;0;0;0;0;0;0;0;0;0;0;0;0;0;0;0;0
FR;11;2021-05-07;0;0;0;0;0;0;0;0;0;0;0;0;0;0;0;0;0;0
FR;11;2021-05-08;0;0;0;0;0;0;0;0;0;0;0;0;0;0;0;0;0;0
FR;11;2021-05-09;0;0;0;0;0;0;0;0;0;0;0;0;0;0;0;0;0;0
FR;11;2021-05-10;0;0;0;0;0;0;0;0;0;0;0;0;0;0;0;0;0;0
FR;11;2021-05-11;0;0;0;0;0;0;0;0;0;0;0;0;0;0;0;0;0;0
FR;11;2021-05-12;0;0;0;0;0;0;0;0;0;0;0;0;0;0;0;0;0;0
FR;11;2021-05-13;0;0;0;0;0;0;0;0;0;0;0;0;0;0;0;0;0;0
FR;11;2021-05-14;0;0;0;0;0;0;0;0;0;0;0;0;0;0;0;0;0;0
FR;11;2021-05-15;0;0;0;0;0;0;0;0;0;0;0;0;0;0;0;0;0;0
FR;11;2021-05-16;0;0;0;0;0;0;0;0;0;0;0;0;0;0;0;0;0;0
FR;11;2021-05-17;0;0;0;0;0;0;0;0;0;0;0;0;0;0;0;0;0;0
FR;11;2021-05-18;0;0;0;0;0;0;0;0;0;0;0;0;0;0;0;0;0;0
FR;11;2021-05-19;0;0;0;0;0;0;0;0;0;0;0;0;0;0;0;0;0;0
FR;11;2021-05-20;0;0;0;0;0;0;0;0;0;0;0;0;0;0;0;0;0;0
FR;11;2021-05-21;0;0;0;0;0;0;0;0;0;0;0;0;0;0;0;0;0;0
FR;11;2021-05-22;0;0;0;0;0;0;0;0;0;0;0;0;0;0;0;0;0;0
FR;11;2021-05-23;0;0;0;0;0;0;0;0;0;0;0;0;0;0;0;0;0;0
FR;11;2021-05-24;0;0;0;0;0;0;0;0;0;0;0;0;0;0;0;0;0;0
FR;11;2021-05-25;0;0;0;0;0;0;0;0;0;0;0;0;0;0;0;0;0;0
FR;11;2021-05-26;0;0;0;0;0;0;0;0;0;0;0;0;0;0;0;0;0;0
FR;11;2021-05-27;0;0;0;0;0;0;0;0;0;0;0;0;0;0;0;0;0;0
FR;11;2021-05-28;0;0;0;0;0;0;0;0;0;0;0;0;0;0;0;0;0;0
FR;11;2021-05-29;0;0;0;0;0;0;0;0;0;0;0;0;0;0;0;0;0;0
FR;11;2021-05-30;0;0;0;0;0;0;0;0;0;0;0;0;0;0;0;0;0;0
FR;11;2021-05-31;0;0;0;0;0;0;0;0;0;0;0;0;0;0;0;0;0;0
FR;11;2021-06-01;0;0;0;0;0;0;0;0;0;0;0;0;0;0;0;0;0;0
FR;11;2021-06-02;0;0;0;0;0;0;0;0;0;0;0;0;0;0;0;0;0;0
FR;11;2021-06-03;0;0;0;0;0;0;0;0;0;0;0;0;0;0;0;0;0;0
FR;11;2021-06-04;0;0;0;0;0;0;0;0;0;0;0;0;0;0;0;0;0;0
FR;11;2021-06-05;0;0;0;0;0;0;0;0;0;0;0;0;0;0;0;0;0;0
FR;11;2021-06-06;0;0;0;0;0;0;0;0;0;0;0;0;0;0;0;0;0;0
FR;11;2021-06-07;0;0;0;0;0;0;0;0;0;0;0;0;0;0;0;0;0;0
FR;11;2021-06-08;0;0;0;0;0;0;0;0;0;0;0;0;0;0;0;0;0;0
FR;11;2021-06-09;0;0;0;0;0;0;0;0;0;0;0;0;0;0;0;0;0;0
FR;11;2021-06-10;0;0;0;0;0;0;0;0;0;0;0;0;0;0;0;0;0;0
FR;11;2021-06-11;0;0;0;0;0;0;0;0;0;0;0;0;0;0;0;0;0;0
FR;11;2021-06-12;0;0;0;0;0;0;0;0;0;0;0;0;0;0;0;0;0;0
FR;11;2021-06-13;0;0;0;0;0;0;0;0;0;0;0;0;0;0;0;0;0;0
FR;11;2021-06-14;0;0;0;0;0;0;0;0;0;0;0;0;0;0;0;0;0;0
FR;11;2021-06-15;0;0;0;0;0;0;0;0;0;0;0;0;0;0;0;0;0;0
FR;11;2021-06-16;0;0;0;0;0;0;0;0;0;0;0;0;0;0;0;0;0;0
FR;11;2021-06-17;0;0;0;0;0;0;0;0;0;0;0;0;0;0;0;0;0;0
FR;11;2021-06-18;0;0;0;0;0;0;0;0;0;0;0;0;0;0;0;0;0;0
FR;11;2021-06-19;0;0;0;0;0;0;0;0;0;0;0;0;0;0;0;0;0;0
FR;11;2021-06-20;0;0;0;0;0;0;0;0;0;0;0;0;0;0;0;0;0;0
FR;11;2021-06-21;0;0;0;0;0;0;0;0;0;0;0;0;0;0;0;0;0;0
FR;11;2021-06-22;0;0;0;0;0;0;0;0;0;0;0;0;0;0;0;0;0;0
FR;11;2021-06-23;0;0;0;0;0;0;0;0;0;0;0;0;0;0;0;0;0;0
FR;11;2021-06-24;0;0;0;0;0;0;0;0;0;0;0;0;0;0;0;0;0;0
FR;11;2021-06-25;0;0;0;0;0;0;0;0;0;0;0;0;0;0;0;0;0;0
FR;11;2021-06-26;0;0;0;0;0;0;0;0;0;0;0;0;0;0;0;0;0;0
FR;11;2021-06-27;0;0;0;0;0;0;0;0;0;0;0;0;0;0;0;0;0;0
FR;11;2021-06-28;0;0;0;0;0;0;0;0;0;0;0;0;0;0;0;0;0;0
FR;11;2021-06-29;0;0;0;0;0;0;0;0;0;0;0;0;0;0;0;0;0;0
FR;11;2021-06-30;0;0;0;0;0;0;0;0;0;0;0;0;0;0;0;0;0;0
FR;11;2021-07-01;0;0;0;0;0;0;0;0;0;0;0;0;0;0;0;0;0;0
FR;11;2021-07-02;0;0;0;0;0;0;0;0;0;0;0;0;0;0;0;0;0;0
FR;11;2021-07-03;0;0;0;0;0;0;0;0;0;0;0;0;0;0;0;0;0;0
FR;11;2021-07-04;0;0;0;0;0;0;0;0;0;0;0;0;0;0;0;0;0;0
FR;11;2021-07-05;0;0;0;0;0;0;0;0;0;0;0;0;0;0;0;0;0;0
FR;11;2021-07-06;0;0;0;0;0;0;0;0;0;0;0;0;0;0;0;0;0;0
FR;11;2021-07-07;0;0;0;0;0;0;0;0;0;0;0;0;0;0;0;0;0;0
FR;11;2021-07-08;0;0;0;0;0;0;0;0;0;0;0;0;0;0;0;0;0;0
FR;11;2021-07-09;0;0;0;0;0;0;0;0;0;0;0;0;0;0;0;0;0;0
FR;11;2021-07-10;0;0;0;0;0;0;0;0;0;0;0;0;0;0;0;0;0;0
FR;11;2021-07-11;0;0;0;0;0;0;0;0;0;0;0;0;0;0;0;0;0;0
FR;11;2021-07-12;0;0;0;0;0;0;0;0;0;0;0;0;0;0;0;0;0;0
FR;11;2021-07-13;0;0;0;0;0;0;0;0;0;0;0;0;0;0;0;0;0;0
FR;11;2021-07-14;0;0;0;0;0;0;0;0;0;0;0;0;0;0;0;0;0;0
FR;11;2021-07-15;0;0;0;0;0;0;0;0;0;0;0;0;0;0;0;0;0;0
FR;11;2021-07-16;0;0;0;0;0;0;0;0;0;0;0;0;0;0;0;0;0;0
FR;11;2021-07-17;0;0;0;0;0;0;0;0;0;0;0;0;0;0;0;0;0;0
FR;11;2021-07-18;0;0;0;0;0;0;0;0;0;0;0;0;0;0;0;0;0;0
FR;11;2021-07-19;0;0;0;0;0;0;0;0;0;0;0;0;0;0;0;0;0;0
FR;11;2021-07-20;0;0;0;0;0;0;0;0;0;0;0;0;0;0;0;0;0;0
FR;11;2021-07-21;0;0;0;0;0;0;0;0;0;0;0;0;0;0;0;0;0;0
FR;11;2021-07-22;0;0;0;0;0;0;0;0;0;0;0;0;0;0;0;0;0;0
FR;11;2021-07-23;0;0;0;0;0;0;0;0;0;0;0;0;0;0;0;0;0;0
FR;11;2021-07-24;0;0;0;0;0;0;0;0;0;0;0;0;0;0;0;0;0;0
FR;11;2021-07-25;0;0;0;0;0;0;0;0;0;0;0;0;0;0;0;0;0;0
FR;11;2021-07-26;0;0;0;0;0;0;0;0;0;0;0;0;0;0;0;0;0;0
FR;11;2021-07-27;0;0;0;0;0;0;0;0;0;0;0;0;0;0;0;0;0;0
FR;11;2021-07-28;0;0;0;0;0;0;0;0;0;0;0;0;0;0;0;0;0;0
FR;11;2021-07-29;0;0;0;0;0;0;0;0;0;0;0;0;0;0;0;0;0;0
FR;11;2021-07-30;0;0;0;0;0;0;0;0;0;0;0;0;0;0;0;0;0;0
FR;11;2021-07-31;0;0;0;0;0;0;0;0;0;0;0;0;0;0;0;0;0;0
FR;11;2021-08-01;0;0;0;0;0;0;0;0;0;0;0;0;0;0;0;0;0;0
FR;11;2021-08-02;0;0;0;0;0;0;0;0;0;0;0;0;0;0;0;0;0;0
FR;11;2021-08-03;0;0;0;0;0;0;0;0;0;0;0;0;0;0;0;0;0;0
FR;11;2021-08-04;0;0;0;0;0;0;0;0;0;0;0;0;0;0;0;0;0;0
FR;11;2021-08-05;0;0;0;0;0;0;0;0;0;0;0;0;0;0;0;0;0;0
FR;11;2021-08-06;0;0;0;0;0;0;0;0;0;0;0;0;0;0;0;0;0;0
FR;11;2021-08-07;0;0;0;0;0;0;0;0;0;0;0;0;0;0;0;0;0;0
FR;11;2021-08-08;0;0;0;0;0;0;0;0;0;0;0;0;0;0;0;0;0;0
FR;11;2021-08-09;0;0;0;0;0;0;0;0;0;0;0;0;0;0;0;0;0;0
FR;11;2021-08-10;0;0;0;0;0;0;0;0;0;0;0;0;0;0;0;0;0;0
FR;11;2021-08-11;0;0;0;0;0;0;0;0;0;0;0;0;0;0;0;0;0;0
FR;11;2021-08-12;0;0;0;0;0;0;0;0;0;0;0;0;0;0;0;0;0;0
FR;11;2021-08-13;0;0;0;0;0;0;0;0;0;0;0;0;0;0;0;0;0;0
FR;11;2021-08-14;0;0;0;0;0;0;0;0;0;0;0;0;0;0;0;0;0;0
FR;11;2021-08-15;0;0;0;0;0;0;0;0;0;0;0;0;0;0;0;0;0;0
FR;11;2021-08-16;0;0;0;0;0;0;0;0;0;0;0;0;0;0;0;0;0;0
FR;11;2021-08-17;0;0;0;0;0;0;0;0;0;0;0;0;0;0;0;0;0;0
FR;11;2021-08-18;0;0;0;0;0;0;0;0;0;0;0;0;0;0;0;0;0;0
FR;11;2021-08-19;0;0;0;0;0;0;0;0;0;0;0;0;0;0;0;0;0;0
FR;11;2021-08-20;0;0;0;0;0;0;0;0;0;0;0;0;0;0;0;0;0;0
FR;11;2021-08-21;0;0;0;0;0;0;0;0;0;0;0;0;0;0;0;0;0;0
FR;11;2021-08-22;0;0;0;0;0;0;0;0;0;0;0;0;0;0;0;0;0;0
FR;11;2021-08-23;0;0;0;0;0;0;0;0;0;0;0;0;0;0;0;0;0;0
FR;11;2021-08-24;0;0;0;0;0;0;0;0;0;0;0;0;0;0;0;0;0;0
FR;11;2021-08-25;0;0;0;0;0;0;0;0;0;0;0;0;0;0;0;0;0;0
FR;11;2021-08-26;0;0;0;0;0;0;0;0;0;0;0;0;0;0;0;0;0;0
FR;11;2021-08-27;0;0;0;0;0;0;0;0;0;0;0;0;0;0;0;0;0;0
FR;11;2021-08-28;0;0;0;0;0;0;0;0;0;0;0;0;0;0;0;0;0;0
FR;11;2021-08-29;0;0;0;0;0;0;0;0;0;0;0;0;0;0;0;0;0;0
FR;11;2021-08-30;0;0;0;0;0;0;0;0;0;0;0;0;0;0;0;0;0;0
FR;11;2021-08-31;0;0;0;0;0;0;0;0;0;0;0;0;0;0;0;0;0;0
FR;11;2021-09-01;0;0;0;0;0;0;0;0;0;0;0;0;0;0;0;0;0;0
FR;11;2021-09-02;0;0;0;0;0;0;0;0;0;0;0;0;0;0;0;0;0;0
FR;11;2021-09-03;0;0;0;0;0;0;0;0;0;0;0;0;0;0;0;0;0;0
FR;11;2021-09-04;0;0;0;0;0;0;0;0;0;0;0;0;0;0;0;0;0;0
FR;11;2021-09-05;0;0;0;0;0;0;0;0;0;0;0;0;0;0;0;0;0;0
FR;11;2021-09-06;0;0;0;0;0;0;0;0;0;0;0;0;0;0;0;0;0;0
FR;11;2021-09-07;0;0;0;0;0;0;0;0;0;0;0;0;0;0;0;0;0;0
FR;11;2021-09-08;0;0;0;0;0;0;0;0;0;0;0;0;0;0;0;0;0;0
FR;11;2021-09-09;0;0;0;0;0;0;0;0;0;0;0;0;0;0;0;0;0;0
FR;11;2021-09-10;0;0;0;0;0;0;0;0;0;0;0;0;0;0;0;0;0;0
FR;11;2021-09-11;0;0;0;0;0;0;0;0;0;0;0;0;0;0;0;0;0;0
FR;11;2021-09-12;0;0;0;0;0;0;0;0;0;0;0;0;0;0;0;0;0;0
FR;11;2021-09-13;0;0;0;0;0;0;0;0;0;0;0;0;0;0;0;0;0;0
FR;11;2021-09-14;0;0;0;0;0;0;0;0;0;0;0;0;0;0;0;0;0;0
FR;11;2021-09-15;0;0;0;0;0;0;0;0;0;0;0;0;0;0;0;0;0;0
FR;11;2021-09-16;0;0;0;0;0;0;0;0;0;0;0;0;0;0;0;0;0;0
FR;11;2021-09-17;0;0;0;0;0;0;0;0;0;0;0;0;0;0;0;0;0;0
FR;11;2021-09-18;0;0;0;0;0;0;0;0;0;0;0;0;0;0;0;0;0;0
FR;11;2021-09-19;0;0;0;0;0;0;0;0;0;0;0;0;0;0;0;0;0;0
FR;11;2021-09-20;0;0;0;0;0;0;0;0;0;0;0;0;0;0;0;0;0;0
FR;11;2021-09-21;0;0;0;0;0;0;0;0;0;0;0;0;0;0;0;0;0;0
FR;11;2021-09-22;0;0;0;0;0;0;0;0;0;0;0;0;0;0;0;0;0;0
FR;11;2021-09-23;0;0;0;0;0;0;0;0;0;0;0;0;0;0;0;0;0;0
FR;11;2021-09-24;0;0;0;0;0;0;0;0;0;0;0;0;0;0;0;0;0;0
FR;11;2021-09-25;0;0;0;0;0;0;0;0;0;0;0;0;0;0;0;0;0;0
FR;11;2021-09-26;0;0;0;0;0;0;0;0;0;0;0;0;0;0;0;0;0;0
FR;11;2021-09-27;0;0;0;0;0;0;0;0;0;0;0;0;0;0;0;0;0;0
FR;11;2021-09-28;0;0;0;0;0;0;0;0;0;0;0;0;0;0;0;0;0;0
FR;11;2021-09-29;0;0;0;0;0;0;0;0;0;0;0;0;0;0;0;0;0;0
FR;11;2021-09-30;0;0;0;0;0;0;0;0;0;0;0;0;0;0;0;0;0;0
FR;11;2021-10-01;0;0;0;0;0;0;0;0;0;0;0;0;0;0;0;0;0;0
FR;11;2021-10-02;0;0;0;0;0;0;0;0;0;0;0;0;0;0;0;0;0;0
FR;11;2021-10-03;0;0;0;0;0;0;0;0;0;0;0;0;0;0;0;0;0;0
FR;11;2021-10-04;0;0;0;0;0;0;0;0;0;0;0;0;0;0;0;0;0;0
FR;11;2021-10-05;0;0;0;0;0;0;0;0;0;0;0;0;0;0;0;0;0;0
FR;11;2021-10-06;0;0;0;0;0;0;0;0;0;0;0;0;0;0;0;0;0;0
FR;11;2021-10-07;0;0;0;0;0;0;0;0;0;0;0;0;0;0;0;0;0;0
FR;11;2021-10-08;0;0;0;0;0;0;0;0;0;0;0;0;0;0;0;0;0;0
FR;11;2021-10-09;0;0;0;0;0;0;0;0;0;0;0;0;0;0;0;0;0;0
FR;11;2021-10-10;0;0;0;0;0;0;0;0;0;0;0;0;0;0;0;0;0;0
FR;11;2021-10-11;0;0;0;0;0;0;0;0;0;0;0;0;0;0;0;0;0;0
FR;11;2021-10-12;0;0;0;0;0;0;0;0;0;0;0;0;0;0;0;0;0;0
FR;11;2021-10-13;0;0;0;0;0;0;0;0;0;0;0;0;0;0;0;0;0;0
FR;11;2021-10-14;0;0;0;0;0;0;0;0;0;0;0;0;0;0;0;0;0;0
FR;11;2021-10-15;0;0;0;0;0;0;0;0;0;0;0;0;0;0;0;0;0;0
FR;11;2021-10-16;0;0;0;0;0;0;0;0;0;0;0;0;0;0;0;0;0;0
FR;11;2021-10-17;0;0;0;0;0;0;0;0;0;0;0;0;0;0;0;0;0;0
FR;11;2021-10-18;0;0;0;0;0;0;0;0;0;0;0;0;0;0;0;0;0;0
FR;11;2021-10-19;0;0;0;0;0;0;0;0;0;0;0;0;0;0;0;0;0;0
FR;11;2021-10-20;0;0;0;0;0;0;0;0;0;0;0;0;0;0;0;0;0;0
FR;11;2021-10-21;0;0;0;0;0;0;0;0;0;0;0;0;0;0;0;0;0;0
FR;11;2021-10-22;0;0;0;0;0;0;0;0;0;0;0;0;0;0;0;0;0;0
FR;11;2021-10-23;0;0;0;0;0;0;0;0;0;0;0;0;0;0;0;0;0;0
FR;11;2021-10-24;0;0;0;0;0;0;0;0;0;0;0;0;0;0;0;0;0;0
FR;11;2021-10-25;0;0;0;0;0;0;0;0;0;0;0;0;0;0;0;0;0;0
FR;11;2021-10-26;0;0;0;0;0;0;0;0;0;0;0;0;0;0;0;0;0;0
FR;11;2021-10-27;0;0;0;0;0;0;0;0;0;0;0;0;0;0;0;0;0;0
FR;11;2021-10-28;0;0;0;0;0;0;0;0;0;0;0;0;0;0;0;0;0;0
FR;11;2021-10-29;0;0;0;0;0;0;0;0;0;0;0;0;0;0;0;0;0;0
FR;11;2021-10-30;0;0;0;0;0;0;0;0;0;0;0;0;0;0;0;0;0;0
FR;11;2021-10-31;0;0;0;0;0;0;0;0;0;0;0;0;0;0;0;0;0;0
FR;11;2021-11-01;0;0;0;0;0;0;0;0;0;0;0;0;0;0;0;0;0;0
FR;11;2021-11-02;0;0;0;0;0;0;0;0;0;0;0;0;0;0;0;0;0;0
FR;11;2021-11-03;0;0;0;0;0;0;0;0;0;0;0;0;0;0;0;0;0;0
FR;11;2021-11-04;0;0;0;0;0;0;0;0;0;0;0;0;0;0;0;0;0;0
FR;11;2021-11-05;0;0;0;0;0;0;0;0;0;0;0;0;0;0;0;0;0;0
FR;11;2021-11-06;0;0;0;0;0;0;0;0;0;0;0;0;0;0;0;0;0;0
FR;11;2021-11-07;0;0;0;0;0;0;0;0;0;0;0;0;0;0;0;0;0;0
FR;11;2021-11-08;0;0;0;0;0;0;0;0;0;0;0;0;0;0;0;0;0;0
FR;11;2021-11-09;0;0;0;0;0;0;0;0;0;0;0;0;0;0;0;0;0;0
FR;11;2021-11-10;0;0;0;0;0;0;0;0;0;0;0;0;0;0;0;0;0;0
FR;11;2021-11-11;0;0;0;0;0;0;0;0;0;0;0;0;0;0;0;0;0;0
FR;11;2021-11-12;0;0;0;0;0;0;0;0;0;0;0;0;0;0;0;0;0;0
FR;11;2021-11-13;0;0;0;0;0;0;0;0;0;0;0;0;0;0;0;0;0;0
FR;11;2021-11-14;0;0;0;0;0;0;0;0;0;0;0;0;0;0;0;0;0;0
FR;11;2021-11-15;0;0;0;0;0;0;0;0;0;0;0;0;0;0;0;0;0;0
FR;11;2021-11-16;0;0;0;0;0;0;0;0;0;0;0;0;0;0;0;0;0;0
FR;11;2021-11-17;0;0;0;0;0;0;0;0;0;0;0;0;0;0;0;0;0;0
FR;11;2021-11-18;0;0;0;0;0;0;0;0;0;0;0;0;0;0;0;0;0;0
FR;11;2021-11-19;0;0;0;0;0;0;0;0;0;0;0;0;0;0;0;0;0;0
FR;11;2021-11-20;0;0;0;0;0;0;0;0;0;0;0;0;0;0;0;0;0;0
FR;11;2021-11-21;0;0;0;0;0;0;0;0;0;0;0;0;0;0;0;0;0;0
FR;11;2021-11-22;0;0;0;0;0;0;0;0;0;0;0;0;0;0;0;0;0;0
FR;11;2021-11-23;0;0;0;0;0;0;0;0;0;0;0;0;0;0;0;0;0;0
FR;11;2021-11-24;0;0;0;0;0;0;0;0;0;0;0;0;0;0;0;0;0;0
FR;11;2021-11-25;0;0;0;0;0;0;0;0;0;0;0;0;0;0;0;0;0;0
FR;11;2021-11-26;0;0;0;0;0;0;0;0;0;0;0;0;0;0;0;0;0;0
FR;11;2021-11-27;0;0;0;0;0;0;0;0;0;0;0;0;0;0;0;0;0;0
FR;11;2021-11-28;0;0;0;0;0;0;0;0;0;0;0;0;0;0;0;0;0;0
FR;11;2021-11-29;0;0;0;0;0;0;0;0;0;0;0;0;0;0;0;0;0;0
FR;11;2021-11-30;0;0;0;0;0;0;0;0;0;0;0;0;0;0;0;0;0;0
FR;11;2021-12-01;0;0;0;0;0;0;0;0;0;0;0;0;0;0;0;0;0;0
FR;11;2021-12-02;0;0;0;0;0;0;0;0;0;0;0;0;0;0;0;0;0;0
FR;11;2021-12-03;0;0;0;0;0;0;0;0;0;0;0;0;0;0;0;0;0;0
FR;11;2021-12-04;0;0;0;0;0;0;0;0;0;0;0;0;0;0;0;0;0;0
FR;11;2021-12-05;0;0;0;0;0;0;0;0;0;0;0;0;0;0;0;0;0;0
FR;11;2021-12-06;0;0;0;0;0;0;0;0;0;0;0;0;0;0;0;0;0;0
FR;11;2021-12-07;0;0;0;0;0;0;0;0;0;0;0;0;0;0;0;0;0;0
FR;11;2021-12-08;0;0;0;0;0;0;0;0;0;0;0;0;0;0;0;0;0;0
FR;11;2021-12-09;0;0;0;0;0;0;0;0;0;0;0;0;0;0;0;0;0;0
FR;11;2021-12-10;0;0;0;0;0;0;0;0;0;0;0;0;0;0;0;0;0;0
FR;11;2021-12-11;0;0;0;0;0;0;0;0;0;0;0;0;0;0;0;0;0;0
FR;11;2021-12-12;0;0;0;0;0;0;0;0;0;0;0;0;0;0;0;0;0;0
FR;11;2021-12-13;0;0;0;0;0;0;0;0;0;0;0;0;0;0;0;0;0;0
FR;11;2021-12-14;0;0;0;0;0;0;0;0;0;0;0;0;0;0;0;0;0;0
FR;11;2021-12-15;0;0;0;0;0;0;0;0;0;0;0;0;0;0;0;0;0;0
FR;11;2021-12-16;0;0;0;0;0;0;0;0;0;0;0;0;0;0;0;0;0;0
FR;11;2021-12-17;0;0;0;0;0;0;0;0;0;0;0;0;0;0;0;0;0;0
FR;11;2021-12-18;0;0;0;0;0;0;0;0;0;0;0;0;0;0;0;0;0;0
FR;11;2021-12-19;0;0;0;0;0;0;0;0;0;0;0;0;0;0;0;0;0;0
FR;11;2021-12-20;0;0;0;0;0;0;0;0;0;0;0;0;0;0;0;0;0;0
FR;11;2021-12-21;0;0;0;0;0;0;0;0;0;0;0;0;0;0;0;0;0;0
FR;11;2021-12-22;0;0;0;0;0;0;0;0;0;0;0;0;0;0;0;0;0;0
FR;11;2021-12-23;0;0;0;0;0;0;0;0;0;0;0;0;0;0;0;0;0;0
FR;11;2021-12-24;0;0;0;0;0;0;0;0;0;0;0;0;0;0;0;0;0;0
FR;11;2021-12-25;0;0;0;0;0;0;0;0;0;0;0;0;0;0;0;0;0;0
FR;11;2021-12-26;0;0;0;0;0;0;0;0;0;0;0;0;0;0;0;0;0;0
FR;11;2021-12-27;0;0;0;0;0;0;0;0;0;0;0;0;0;0;0;0;0;0
FR;11;2021-12-28;0;0;0;0;0;0;0;0;0;0;0;0;0;0;0;0;0;0
FR;11;2021-12-29;0;0;0;0;0;0;0;0;0;0;0;0;0;0;0;0;0;0
FR;11;2021-12-30;0;0;0;0;0;0;0;0;0;0;0;0;0;0;0;0;0;0
FR;11;2021-12-31;0;0;0;0;0;0;0;0;0;0;0;0;0;0;0;0;0;0
FR;11;2022-01-01;0;0;0;0;0;0;0;0;0;0;0;0;0;0;0;0;0;0
FR;11;2022-01-02;0;0;0;0;0;0;0;0;0;0;0;0;0;0;0;0;0;0
FR;11;2022-01-03;0;0;0;0;0;0;0;0;0;0;0;0;0;0;0;0;0;0
FR;11;2022-01-04;0;0;0;0;0;0;0;0;0;0;0;0;0;0;0;0;0;0
FR;11;2022-01-05;0;0;0;0;0;0;0;0;0;0;0;0;0;0;0;0;0;0
FR;11;2022-01-06;0;0;0;0;0;0;0;0;0;0;0;0;0;0;0;0;0;0
FR;11;2022-01-07;0;0;0;0;0;0;0;0;0;0;0;0;0;0;0;0;0;0
FR;11;2022-01-08;0;0;0;0;0;0;0;0;0;0;0;0;0;0;0;0;0;0
FR;11;2022-01-09;0;0;0;0;0;0;0;0;0;0;0;0;0;0;0;0;0;0
FR;11;2022-01-10;0;0;0;0;0;0;0;0;0;0;0;0;0;0;0;0;0;0
FR;11;2022-01-11;0;0;0;0;0;0;0;0;0;0;0;0;0;0;0;0;0;0
FR;11;2022-01-12;0;0;0;0;0;0;0;0;0;0;0;0;0;0;0;0;0;0
FR;11;2022-01-13;0;0;0;0;0;0;0;0;0;0;0;0;0;0;0;0;0;0
FR;11;2022-01-14;0;0;0;0;0;0;0;0;0;0;0;0;0;0;0;0;0;0
FR;11;2022-01-15;0;0;0;0;0;0;0;0;0;0;0;0;0;0;0;0;0;0
FR;11;2022-01-16;0;0;0;0;0;0;0;0;0;0;0;0;0;0;0;0;0;0
FR;11;2022-01-17;0;0;0;0;0;0;0;0;0;0;0;0;0;0;0;0;0;0
FR;11;2022-01-18;0;0;0;0;0;0;0;0;0;0;0;0;0;0;0;0;0;0
FR;11;2022-01-19;0;0;0;0;0;0;0;0;0;0;0;0;0;0;0;0;0;0
FR;11;2022-01-20;0;0;0;0;0;0;0;0;0;0;0;0;0;0;0;0;0;0
FR;11;2022-01-21;0;0;0;0;0;0;0;0;0;0;0;0;0;0;0;0;0;0
FR;11;2022-01-22;0;0;0;0;0;0;0;0;0;0;0;0;0;0;0;0;0;0
FR;11;2022-01-23;0;0;0;0;0;0;0;0;0;0;0;0;0;0;0;0;0;0
FR;11;2022-01-24;0;0;0;0;0;0;0;0;0;0;0;0;0;0;0;0;0;0
FR;11;2022-01-25;0;0;0;0;0;0;0;0;0;0;0;0;0;0;0;0;0;0
FR;11;2022-01-26;0;0;0;0;0;0;0;0;0;0;0;0;0;0;0;0;0;0
FR;11;2022-01-27;0;0;0;0;0;0;0;0;0;0;0;0;0;0;0;0;0;0
FR;11;2022-01-28;0;0;0;0;0;0;0;0;0;0;0;0;0;0;0;0;0;0
FR;11;2022-01-29;0;0;0;0;0;0;0;0;0;0;0;0;0;0;0;0;0;0
FR;11;2022-01-30;0;0;0;0;0;0;0;0;0;0;0;0;0;0;0;0;0;0
FR;11;2022-01-31;0;0;0;0;0;0;0;0;0;0;0;0;0;0;0;0;0;0
FR;11;2022-02-01;0;0;0;0;0;0;0;0;0;0;0;0;0;0;0;0;0;0
FR;11;2022-02-02;0;0;0;0;0;0;0;0;0;0;0;0;0;0;0;0;0;0
FR;11;2022-02-03;0;0;0;0;0;0;0;0;0;0;0;0;0;0;0;0;0;0
FR;11;2022-02-04;0;0;0;0;0;0;0;0;0;0;0;0;0;0;0;0;0;0
FR;11;2022-02-05;0;0;0;0;0;0;0;0;0;0;0;0;0;0;0;0;0;0
FR;11;2022-02-06;0;0;0;0;0;0;0;0;0;0;0;0;0;0;0;0;0;0
FR;11;2022-02-07;0;0;0;0;0;0;0;0;0;0;0;0;0;0;0;0;0;0
FR;11;2022-02-08;0;0;0;0;0;0;0;0;0;0;0;0;0;0;0;0;0;0
FR;11;2022-02-09;0;0;0;0;0;0;0;0;0;0;0;0;0;0;0;0;0;0
FR;11;2022-02-10;0;0;0;0;0;0;0;0;0;0;0;0;0;0;0;0;0;0
FR;11;2022-02-11;0;0;0;0;0;0;0;0;0;0;0;0;0;0;0;0;0;0
FR;11;2022-02-12;0;0;0;0;0;0;0;0;0;0;0;0;0;0;0;0;0;0
FR;11;2022-02-13;0;0;0;0;0;0;0;0;0;0;0;0;0;0;0;0;0;0
FR;11;2022-02-14;0;0;0;0;0;0;0;0;0;0;0;0;0;0;0;0;0;0
FR;11;2022-02-15;0;0;0;0;0;0;0;0;0;0;0;0;0;0;0;0;0;0
FR;11;2022-02-16;0;0;0;0;0;0;0;0;0;0;0;0;0;0;0;0;0;0
FR;11;2022-02-17;0;0;0;0;0;0;0;0;0;0;0;0;0;0;0;0;0;0
FR;11;2022-02-18;0;0;0;0;0;0;0;0;0;0;0;0;0;0;0;0;0;0
FR;11;2022-02-19;0;0;0;0;0;0;0;0;0;0;0;0;0;0;0;0;0;0
FR;11;2022-02-20;0;0;0;0;0;0;0;0;0;0;0;0;0;0;0;0;0;0
FR;11;2022-02-21;0;0;0;0;0;0;0;0;0;0;0;0;0;0;0;0;0;0
FR;11;2022-02-22;0;0;0;0;0;0;0;0;0;0;0;0;0;0;0;0;0;0
FR;11;2022-02-23;0;0;0;0;0;0;0;0;0;0;0;0;0;0;0;0;0;0
FR;11;2022-02-24;0;0;0;0;0;0;0;0;0;0;0;0;0;0;0;0;0;0
FR;11;2022-02-25;0;0;0;0;0;0;0;0;0;0;0;0;0;0;0;0;0;0
FR;11;2022-02-26;0;0;0;0;0;0;0;0;0;0;0;0;0;0;0;0;0;0
FR;11;2022-02-27;0;0;0;0;0;0;0;0;0;0;0;0;0;0;0;0;0;0
FR;11;2022-02-28;0;0;0;0;0;0;0;0;0;0;0;0;0;0;0;0;0;0
FR;11;2022-03-01;0;0;0;0;0;0;0;0;0;0;0;0;0;0;0;0;0;0
FR;11;2022-03-02;0;0;0;0;0;0;0;0;0;0;0;0;0;0;0;0;0;0
FR;11;2022-03-03;0;0;0;0;0;0;0;0;0;0;0;0;0;0;0;0;0;0
FR;11;2022-03-04;0;0;0;0;0;0;0;0;0;0;0;0;0;0;0;0;0;0
FR;11;2022-03-05;0;0;0;0;0;0;0;0;0;0;0;0;0;0;0;0;0;0
FR;11;2022-03-06;0;0;0;0;0;0;0;0;0;0;0;0;0;0;0;0;0;0
FR;11;2022-03-07;0;0;0;0;0;0;0;0;0;0;0;0;0;0;0;0;0;0
FR;11;2022-03-08;0;0;0;0;0;0;0;0;0;0;0;0;0;0;0;0;0;0
FR;11;2022-03-09;0;0;0;0;0;0;0;0;0;0;0;0;0;0;0;0;0;0
FR;11;2022-03-10;0;0;0;0;0;0;0;0;0;0;0;0;0;0;0;0;0;0
FR;11;2022-03-11;0;0;0;0;0;0;0;0;0;0;0;0;0;0;0;0;0;0
FR;11;2022-03-12;0;0;0;0;0;0;0;0;0;0;0;0;0;0;0;0;0;0
FR;11;2022-03-13;0;0;0;0;0;0;0;0;0;0;0;0;0;0;0;0;0;0
FR;11;2022-03-14;0;0;0;0;0;0;0;0;0;0;0;0;0;0;0;0;0;0
FR;11;2022-03-15;0;0;0;0;0;0;0;0;0;0;0;0;0;0;0;0;0;0
FR;11;2022-03-16;0;0;0;0;0;0;0;0;0;0;0;0;0;0;0;0;0;0
FR;11;2022-03-17;0;0;0;0;0;0;0;0;0;0;0;0;0;0;0;0;0;0
FR;11;2022-03-18;0;0;0;0;0;0;0;0;0;0;0;0;0;0;0;0;0;0
FR;11;2022-03-19;0;0;0;0;0;0;0;0;0;0;0;0;0;0;0;0;0;0
FR;11;2022-03-20;0;0;0;0;0;0;0;0;0;0;0;0;0;0;0;0;0;0
FR;11;2022-03-21;0;0;0;0;0;0;0;0;0;0;0;0;0;0;0;0;0;0
FR;11;2022-03-22;0;0;0;0;0;0;0;0;0;0;0;0;0;0;0;0;0;0
FR;11;2022-03-23;0;0;0;0;0;0;0;0;0;0;0;0;0;0;0;0;0;0
FR;11;2022-03-24;0;0;0;0;0;0;0;0;0;0;0;0;0;0;0;0;0;0
FR;11;2022-03-25;0;0;0;0;0;0;0;0;0;0;0;0;0;0;0;0;0;0
FR;11;2022-03-26;0;0;0;0;0;0;0;0;0;0;0;0;0;0;0;0;0;0
FR;11;2022-03-27;0;0;0;0;0;0;0;0;0;0;0;0;0;0;0;0;0;0
FR;11;2022-03-28;0;0;0;0;0;0;0;0;0;0;0;0;0;0;0;0;0;0
FR;11;2022-03-29;0;0;0;0;0;0;0;0;0;0;0;0;0;0;0;0;0;0
FR;11;2022-03-30;0;0;0;0;0;0;0;0;0;0;0;0;0;0;0;0;0;0
FR;11;2022-03-31;0;0;0;0;0;0;0;0;0;0;0;0;0;0;0;0;0;0
FR;11;2022-04-01;0;0;0;0;0;0;0;0;0;0;0;0;0;0;0;0;0;0
FR;11;2022-04-02;0;0;0;0;0;0;0;0;0;0;0;0;0;0;0;0;0;0
FR;11;2022-04-03;0;0;0;0;0;0;0;0;0;0;0;0;0;0;0;0;0;0
FR;11;2022-04-04;0;0;0;0;0;0;0;0;0;0;0;0;0;0;0;0;0;0
FR;11;2022-04-05;0;0;0;0;0;0;0;0;0;0;0;0;0;0;0;0;0;0
FR;11;2022-04-06;0;0;0;0;0;0;0;0;0;0;0;0;0;0;0;0;0;0
FR;11;2022-04-07;0;0;0;0;0;0;0;0;0;0;0;0;0;0;0;0;0;0
FR;11;2022-04-08;0;0;0;0;0;0;0;0;0;0;0;0;0;0;0;0;0;0
FR;11;2022-04-09;0;0;0;0;0;0;0;0;0;0;0;0;0;0;0;0;0;0
FR;11;2022-04-10;0;0;0;0;0;0;0;0;0;0;0;0;0;0;0;0;0;0
FR;11;2022-04-11;0;0;0;0;0;0;0;0;0;0;0;0;0;0;0;0;0;0
FR;11;2022-04-12;0;0;0;0;0;0;0;0;0;0;0;0;0;0;0;0;0;0
FR;11;2022-04-13;0;0;0;0;0;0;0;0;0;0;0;0;0;0;0;0;0;0
FR;11;2022-04-14;0;0;0;0;0;0;0;0;0;0;0;0;0;0;0;0;0;0
FR;11;2022-04-15;0;0;0;0;0;0;0;0;0;0;0;0;0;0;0;0;0;0
FR;11;2022-04-16;0;0;0;0;0;0;0;0;0;0;0;0;0;0;0;0;0;0
FR;11;2022-04-17;0;0;0;0;0;0;0;0;0;0;0;0;0;0;0;0;0;0
FR;11;2022-04-18;0;0;0;0;0;0;0;0;0;0;0;0;0;0;0;0;0;0
FR;11;2022-04-19;0;0;0;0;0;0;0;0;0;0;0;0;0;0;0;0;0;0
FR;11;2022-04-20;0;0;0;0;0;0;0;0;0;0;0;0;0;0;0;0;0;0
FR;11;2022-04-21;0;0;0;0;0;0;0;0;0;0;0;0;0;0;0;0;0;0
FR;11;2022-04-22;0;0;0;0;0;0;0;0;0;0;0;0;0;0;0;0;0;0
FR;11;2022-04-23;0;0;0;0;0;0;0;0;0;0;0;0;0;0;0;0;0;0
FR;11;2022-04-24;0;0;0;0;0;0;0;0;0;0;0;0;0;0;0;0;0;0
FR;11;2022-04-25;0;0;0;0;0;0;0;0;0;0;0;0;0;0;0;0;0;0
FR;11;2022-04-26;0;0;0;0;0;0;0;0;0;0;0;0;0;0;0;0;0;0
FR;11;2022-04-27;0;0;0;0;0;0;0;0;0;0;0;0;0;0;0;0;0;0
FR;11;2022-04-28;0;0;0;0;0;0;0;0;0;0;0;0;0;0;0;0;0;0
FR;11;2022-04-29;0;0;0;0;0;0;0;0;0;0;0;0;0;0;0;0;0;0
FR;11;2022-04-30;0;0;0;0;0;0;0;0;0;0;0;0;0;0;0;0;0;0
FR;11;2022-05-01;0;0;0;0;0;0;0;0;0;0;0;0;0;0;0;0;0;0
FR;11;2022-05-02;0;0;0;0;0;0;0;0;0;0;0;0;0;0;0;0;0;0
FR;11;2022-05-03;0;0;0;0;0;0;0;0;0;0;0;0;0;0;0;0;0;0
FR;11;2022-05-04;0;0;0;0;0;0;0;0;0;0;0;0;0;0;0;0;0;0
FR;11;2022-05-05;0;0;0;0;0;0;0;0;0;0;0;0;0;0;0;0;0;0
FR;11;2022-05-06;0;0;0;0;0;0;0;0;0;0;0;0;0;0;0;0;0;0
FR;11;2022-05-07;0;0;0;0;0;0;0;0;0;0;0;0;0;0;0;0;0;0
FR;11;2022-05-08;0;0;0;0;0;0;0;0;0;0;0;0;0;0;0;0;0;0
FR;11;2022-05-09;0;0;0;0;0;0;0;0;0;0;0;0;0;0;0;0;0;0
FR;11;2022-05-10;0;0;0;0;0;0;0;0;0;0;0;0;0;0;0;0;0;0
FR;11;2022-05-11;0;0;0;0;0;0;0;0;0;0;0;0;0;0;0;0;0;0
FR;11;2022-05-12;0;0;0;0;0;0;0;0;0;0;0;0;0;0;0;0;0;0
FR;11;2022-05-13;0;0;0;0;0;0;0;0;0;0;0;0;0;0;0;0;0;0
FR;11;2022-05-14;0;0;0;0;0;0;0;0;0;0;0;0;0;0;0;0;0;0
FR;11;2022-05-15;0;0;0;0;0;0;0;0;0;0;0;0;0;0;0;0;0;0
FR;11;2022-05-16;0;0;0;0;0;0;0;0;0;0;0;0;0;0;0;0;0;0
FR;11;2022-05-17;0;0;0;0;0;0;0;0;0;0;0;0;0;0;0;0;0;0
FR;11;2022-05-18;0;0;0;0;0;0;0;0;0;0;0;0;0;0;0;0;0;0
FR;11;2022-05-19;0;0;0;0;0;0;0;0;0;0;0;0;0;0;0;0;0;0
FR;11;2022-05-20;0;0;0;0;0;0;0;0;0;0;0;0;0;0;0;0;0;0
FR;11;2022-05-21;0;0;0;0;0;0;0;0;0;0;0;0;0;0;0;0;0;0
FR;11;2022-05-22;0;0;0;0;0;0;0;0;0;0;0;0;0;0;0;0;0;0
FR;11;2022-05-23;0;0;0;0;0;0;0;0;0;0;0;0;0;0;0;0;0;0
FR;11;2022-05-24;0;0;0;0;0;0;0;0;0;0;0;0;0;0;0;0;0;0
FR;11;2022-05-25;0;0;0;0;0;0;0;0;0;0;0;0;0;0;0;0;0;0
FR;11;2022-05-26;0;0;0;0;0;0;0;0;0;0;0;0;0;0;0;0;0;0
FR;11;2022-05-27;0;0;0;0;0;0;0;0;0;0;0;0;0;0;0;0;0;0
FR;11;2022-05-28;0;0;0;0;0;0;0;0;0;0;0;0;0;0;0;0;0;0
FR;11;2022-05-29;0;0;0;0;0;0;0;0;0;0;0;0;0;0;0;0;0;0
FR;11;2022-05-30;0;0;0;0;0;0;0;0;0;0;0;0;0;0;0;0;0;0
FR;11;2022-05-31;0;0;0;0;0;0;0;0;0;0;0;0;0;0;0;0;0;0
FR;11;2022-06-01;0;0;0;0;0;0;0;0;0;0;0;0;0;0;0;0;0;0
FR;11;2022-06-02;0;0;0;0;0;0;0;0;0;0;0;0;0;0;0;0;0;0
FR;11;2022-06-03;0;0;0;0;0;0;0;0;0;0;0;0;0;0;0;0;0;0
FR;11;2022-06-04;0;0;0;0;0;0;0;0;0;0;0;0;0;0;0;0;0;0
FR;11;2022-06-05;0;0;0;0;0;0;0;0;0;0;0;0;0;0;0;0;0;0
FR;11;2022-06-06;0;0;0;0;0;0;0;0;0;0;0;0;0;0;0;0;0;0
FR;11;2022-06-07;0;0;0;0;0;0;0;0;0;0;0;0;0;0;0;0;0;0
FR;11;2022-06-08;0;0;0;0;0;0;0;0;0;0;0;0;0;0;0;0;0;0
FR;11;2022-06-09;0;0;0;0;0;0;0;0;0;0;0;0;0;0;0;0;0;0
FR;11;2022-06-10;0;0;0;0;0;0;0;0;0;0;0;0;0;0;0;0;0;0
FR;11;2022-06-11;0;0;0;0;0;0;0;0;0;0;0;0;0;0;0;0;0;0
FR;11;2022-06-12;0;0;0;0;0;0;0;0;0;0;0;0;0;0;0;0;0;0
FR;11;2022-06-13;0;0;0;0;0;0;0;0;0;0;0;0;0;0;0;0;0;0
FR;11;2022-06-14;0;0;0;0;0;0;0;0;0;0;0;0;0;0;0;0;0;0
FR;11;2022-06-15;0;0;0;0;0;0;0;0;0;0;0;0;0;0;0;0;0;0
FR;11;2022-06-16;0;0;0;0;0;0;0;0;0;0;0;0;0;0;0;0;0;0
FR;11;2022-06-17;0;0;0;0;0;0;0;0;0;0;0;0;0;0;0;0;0;0
FR;11;2022-06-18;0;0;0;0;0;0;0;0;0;0;0;0;0;0;0;0;0;0
FR;11;2022-06-19;0;0;0;0;0;0;0;0;0;0;0;0;0;0;0;0;0;0
FR;11;2022-06-20;0;0;0;0;0;0;0;0;0;0;0;0;0;0;0;0;0;0
FR;11;2022-06-21;0;0;0;0;0;0;0;0;0;0;0;0;0;0;0;0;0;0
FR;11;2022-06-22;0;0;0;0;0;0;0;0;0;0;0;0;0;0;0;0;0;0
FR;11;2022-06-23;0;0;0;0;0;0;0;0;0;0;0;0;0;0;0;0;0;0
FR;11;2022-06-24;0;0;0;0;0;0;0;0;0;0;0;0;0;0;0;0;0;0
FR;11;2022-06-25;0;0;0;0;0;0;0;0;0;0;0;0;0;0;0;0;0;0
FR;11;2022-06-26;0;0;0;0;0;0;0;0;0;0;0;0;0;0;0;0;0;0
FR;11;2022-06-27;0;0;0;0;0;0;0;0;0;0;0;0;0;0;0;0;0;0
FR;11;2022-06-28;0;0;0;0;0;0;0;0;0;0;0;0;0;0;0;0;0;0
FR;11;2022-06-29;0;0;0;0;0;0;0;0;0;0;0;0;0;0;0;0;0;0
FR;11;2022-06-30;0;0;0;0;0;0;0;0;0;0;0;0;0;0;0;0;0;0
FR;11;2022-07-01;0;0;0;0;0;0;0;0;0;0;0;0;0;0;0;0;0;0
FR;11;2022-07-02;0;0;0;0;0;0;0;0;0;0;0;0;0;0;0;0;0;0
FR;11;2022-07-03;0;0;0;0;0;0;0;0;0;0;0;0;0;0;0;0;0;0
FR;11;2022-07-04;0;0;0;0;0;0;0;0;0;0;0;0;0;0;0;0;0;0
FR;11;2022-07-05;0;0;0;0;0;0;0;0;0;0;0;0;0;0;0;0;0;0
FR;11;2022-07-06;0;0;0;0;0;0;0;0;0;0;0;0;0;0;0;0;0;0
FR;11;2022-07-07;0;0;0;0;0;0;0;0;0;0;0;0;0;0;0;0;0;0
FR;11;2022-07-08;0;0;0;0;0;0;0;0;0;0;0;0;0;0;0;0;0;0
FR;11;2022-07-09;0;0;0;0;0;0;0;0;0;0;0;0;0;0;0;0;0;0
FR;11;2022-07-10;0;0;0;0;0;0;0;0;0;0;0;0;0;0;0;0;0;0
FR;11;2022-07-11;0;0;0;0;0;0;0;0;0;0;0;0;0;0;0;0;0;0
FR;11;2022-07-12;0;0;0;0;0;0;0;0;0;0;0;0;0;0;0;0;0;0
FR;11;2022-07-13;0;0;0;0;0;0;0;0;0;0;0;0;0;0;0;0;0;0
FR;11;2022-07-14;0;0;0;0;0;0;0;0;0;0;0;0;0;0;0;0;0;0
FR;11;2022-07-15;0;0;0;0;0;0;0;0;0;0;0;0;0;0;0;0;0;0
FR;11;2022-07-16;0;0;0;0;0;0;0;0;0;0;0;0;0;0;0;0;0;0
FR;11;2022-07-17;0;0;0;0;0;0;0;0;0;0;0;0;0;0;0;0;0;0
FR;11;2022-07-18;0;0;0;0;0;0;0;0;0;0;0;0;0;0;0;0;0;0
FR;11;2022-07-19;0;0;0;0;0;0;0;0;0;0;0;0;0;0;0;0;0;0
FR;11;2022-07-20;0;0;0;0;0;0;0;0;0;0;0;0;0;0;0;0;0;0
FR;11;2022-07-21;0;0;0;0;0;0;0;0;0;0;0;0;0;0;0;0;0;0
FR;11;2022-07-22;0;0;0;0;0;0;0;0;0;0;0;0;0;0;0;0;0;0
FR;11;2022-07-23;0;0;0;0;0;0;0;0;0;0;0;0;0;0;0;0;0;0
FR;11;2022-07-24;0;0;0;0;0;0;0;0;0;0;0;0;0;0;0;0;0;0
FR;11;2022-07-25;0;0;0;0;0;0;0;0;0;0;0;0;0;0;0;0;0;0
FR;11;2022-07-26;0;0;0;0;0;0;0;0;0;0;0;0;0;0;0;0;0;0
FR;11;2022-07-27;0;0;0;0;0;0;0;0;0;0;0;0;0;0;0;0;0;0
FR;11;2022-07-28;0;0;0;0;0;0;0;0;0;0;0;0;0;0;0;0;0;0
FR;11;2022-07-29;0;0;0;0;0;0;0;0;0;0;0;0;0;0;0;0;0;0
FR;11;2022-07-30;0;0;0;0;0;0;0;0;0;0;0;0;0;0;0;0;0;0
FR;11;2022-07-31;0;0;0;0;0;0;0;0;0;0;0;0;0;0;0;0;0;0
FR;11;2022-08-01;0;0;0;0;0;0;0;0;0;0;0;0;0;0;0;0;0;0
FR;11;2022-08-02;0;0;0;0;0;0;0;0;0;0;0;0;0;0;0;0;0;0
FR;11;2022-08-03;0;0;0;0;0;0;0;0;0;0;0;0;0;0;0;0;0;0
FR;11;2022-08-04;0;0;0;0;0;0;0;0;0;0;0;0;0;0;0;0;0;0
FR;11;2022-08-05;0;0;0;0;0;0;0;0;0;0;0;0;0;0;0;0;0;0
FR;11;2022-08-06;0;0;0;0;0;0;0;0;0;0;0;0;0;0;0;0;0;0
FR;11;2022-08-07;0;0;0;0;0;0;0;0;0;0;0;0;0;0;0;0;0;0
FR;11;2022-08-08;0;0;0;0;0;0;0;0;0;0;0;0;0;0;0;0;0;0
FR;11;2022-08-09;0;0;0;0;0;0;0;0;0;0;0;0;0;0;0;0;0;0
FR;11;2022-08-10;0;0;0;0;0;0;0;0;0;0;0;0;0;0;0;0;0;0
FR;11;2022-08-11;0;0;0;0;0;0;0;0;0;0;0;0;0;0;0;0;0;0
FR;11;2022-08-12;0;0;0;0;0;0;0;0;0;0;0;0;0;0;0;0;0;0
FR;11;2022-08-13;0;0;0;0;0;0;0;0;0;0;0;0;0;0;0;0;0;0
FR;11;2022-08-14;0;0;0;0;0;0;0;0;0;0;0;0;0;0;0;0;0;0
FR;11;2022-08-15;0;0;0;0;0;0;0;0;0;0;0;0;0;0;0;0;0;0
FR;11;2022-08-16;0;0;0;0;0;0;0;0;0;0;0;0;0;0;0;0;0;0
FR;11;2022-08-17;0;0;0;0;0;0;0;0;0;0;0;0;0;0;0;0;0;0
FR;11;2022-08-18;0;0;0;0;0;0;0;0;0;0;0;0;0;0;0;0;0;0
FR;11;2022-08-19;0;0;0;0;0;0;0;0;0;0;0;0;0;0;0;0;0;0
FR;11;2022-08-20;0;0;0;0;0;0;0;0;0;0;0;0;0;0;0;0;0;0
FR;11;2022-08-21;0;0;0;0;0;0;0;0;0;0;0;0;0;0;0;0;0;0
FR;11;2022-08-22;0;0;0;0;0;0;0;0;0;0;0;0;0;0;0;0;0;0
FR;11;2022-08-23;0;0;0;0;0;0;0;0;0;0;0;0;0;0;0;0;0;0
FR;11;2022-08-24;0;0;0;0;0;0;0;0;0;0;0;0;0;0;0;0;0;0
FR;11;2022-08-25;0;0;0;0;0;0;0;0;0;0;0;0;0;0;0;0;0;0
FR;11;2022-08-26;0;0;0;0;0;0;0;0;0;0;0;0;0;0;0;0;0;0
FR;11;2022-08-27;0;0;0;0;0;0;0;0;0;0;0;0;0;0;0;0;0;0
FR;11;2022-08-28;0;0;0;0;0;0;0;0;0;0;0;0;0;0;0;0;0;0
FR;11;2022-08-29;0;0;0;0;0;0;0;0;0;0;0;0;0;0;0;0;0;0
FR;11;2022-08-30;0;0;0;0;0;0;0;0;0;0;0;0;0;0;0;0;0;0
FR;11;2022-08-31;0;0;0;0;0;0;0;0;0;0;0;0;0;0;0;0;0;0
FR;11;2022-09-01;0;0;0;0;0;0;0;0;0;0;0;0;0;0;0;0;0;0
FR;11;2022-09-02;0;0;0;0;0;0;0;0;0;0;0;0;0;0;0;0;0;0
FR;11;2022-09-03;0;0;0;0;0;0;0;0;0;0;0;0;0;0;0;0;0;0
FR;11;2022-09-04;0;0;0;0;0;0;0;0;0;0;0;0;0;0;0;0;0;0
FR;11;2022-09-05;0;0;0;0;0;0;0;0;0;0;0;0;0;0;0;0;0;0
FR;11;2022-09-06;0;0;0;0;0;0;0;0;0;0;0;0;0;0;0;0;0;0
FR;11;2022-09-07;0;0;0;0;0;0;0;0;0;0;0;0;0;0;0;0;0;0
FR;11;2022-09-08;0;0;0;0;0;0;0;0;0;0;0;0;0;0;0;0;0;0
FR;11;2022-09-09;0;0;0;0;0;0;0;0;0;0;0;0;0;0;0;0;0;0
FR;11;2022-09-10;0;0;0;0;0;0;0;0;0;0;0;0;0;0;0;0;0;0
FR;11;2022-09-11;0;0;0;0;0;0;0;0;0;0;0;0;0;0;0;0;0;0
FR;11;2022-09-12;0;0;0;0;0;0;0;0;0;0;0;0;0;0;0;0;0;0
FR;11;2022-09-13;0;0;0;0;0;0;0;0;0;0;0;0;0;0;0;0;0;0
FR;11;2022-09-14;0;0;0;0;0;0;0;0;0;0;0;0;0;0;0;0;0;0
FR;11;2022-09-15;0;0;0;0;0;0;0;0;0;0;0;0;0;0;0;0;0;0
FR;11;2022-09-16;0;0;0;0;0;0;0;0;0;0;0;0;0;0;0;0;0;0
FR;11;2022-09-17;0;0;0;0;0;0;0;0;0;0;0;0;0;0;0;0;0;0
FR;11;2022-09-18;0;0;0;0;0;0;0;0;0;0;0;0;0;0;0;0;0;0
FR;11;2022-09-19;0;0;0;0;0;0;0;0;0;0;0;0;0;0;0;0;0;0
FR;11;2022-09-20;0;0;0;0;0;0;0;0;0;0;0;0;0;0;0;0;0;0
FR;11;2022-09-21;0;0;0;0;0;0;0;0;0;0;0;0;0;0;0;0;0;0
FR;11;2022-09-22;0;0;0;0;0;0;0;0;0;0;0;0;0;0;0;0;0;0
FR;11;2022-09-23;0;0;0;0;0;0;0;0;0;0;0;0;0;0;0;0;0;0
FR;11;2022-09-24;0;0;0;0;0;0;0;0;0;0;0;0;0;0;0;0;0;0
FR;11;2022-09-25;0;0;0;0;0;0;0;0;0;0;0;0;0;0;0;0;0;0
FR;11;2022-09-26;0;0;0;0;0;0;0;0;0;0;0;0;0;0;0;0;0;0
FR;11;2022-09-27;0;0;0;0;0;0;0;0;0;0;0;0;0;0;0;0;0;0
FR;11;2022-09-28;0;0;0;0;0;0;0;0;0;0;0;0;0;0;0;0;0;0
FR;11;2022-09-29;0;0;0;0;0;0;0;0;0;0;0;0;0;0;0;0;0;0
FR;11;2022-09-30;0;0;0;0;0;0;0;0;0;0;0;0;0;0;0;0;0;0
FR;11;2022-10-01;0;0;0;0;0;0;0;0;0;0;0;0;0;0;0;0;0;0
FR;11;2022-10-02;0;0;0;0;0;0;0;0;0;0;0;0;0;0;0;0;0;0
FR;11;2022-10-03;0;0;0;0;0;0;0;0;0;0;0;0;0;0;0;0;0;0
FR;11;2022-10-04;0;0;0;0;0;0;0;0;0;0;0;0;0;0;0;0;0;0
FR;11;2022-10-05;0;0;0;0;0;0;0;0;0;0;0;0;0;0;0;0;0;0
FR;11;2022-10-06;0;0;0;0;0;0;0;0;0;0;0;0;0;0;0;0;0;0
FR;11;2022-10-07;0;0;0;0;0;0;0;0;0;0;0;0;0;0;0;0;0;0
FR;11;2022-10-08;0;0;0;0;0;0;0;0;0;0;0;0;0;0;0;0;0;0
FR;11;2022-10-09;0;0;0;0;0;0;0;0;0;0;0;0;0;0;0;0;0;0
FR;11;2022-10-10;0;0;0;0;0;0;0;0;0;0;0;0;0;0;0;0;0;0
FR;11;2022-10-11;0;0;0;0;0;0;0;0;0;0;0;0;0;0;0;0;0;0
FR;11;2022-10-12;0;0;0;0;0;0;0;0;0;0;0;0;0;0;0;0;0;0
FR;11;2022-10-13;0;0;0;0;0;0;0;0;0;0;0;0;0;0;0;0;0;0
FR;11;2022-10-14;0;0;0;0;0;0;0;0;0;0;0;0;0;0;0;0;0;0
FR;11;2022-10-15;0;0;0;0;0;0;0;0;0;0;0;0;0;0;0;0;0;0
FR;11;2022-10-16;0;0;0;0;0;0;0;0;0;0;0;0;0;0;0;0;0;0
FR;11;2022-10-17;0;0;0;0;0;0;0;0;0;0;0;0;0;0;0;0;0;0
FR;11;2022-10-18;0;0;0;0;0;0;0;0;0;0;0;0;0;0;0;0;0;0
FR;11;2022-10-19;0;0;0;0;0;0;0;0;0;0;0;0;0;0;0;0;0;0
FR;11;2022-10-20;0;0;0;0;0;0;0;0;0;0;0;0;0;0;0;0;0;0
FR;11;2022-10-21;0;0;0;0;0;0;0;0;0;0;0;0;0;0;0;0;0;0
FR;11;2022-10-22;0;0;0;0;0;0;0;0;0;0;0;0;0;0;0;0;0;0
FR;11;2022-10-23;0;0;0;0;0;0;0;0;0;0;0;0;0;0;0;0;0;0
FR;11;2022-10-24;0;0;0;0;0;0;0;0;0;0;0;0;0;0;0;0;0;0
FR;11;2022-10-25;0;0;0;0;0;0;0;0;0;0;0;0;0;0;0;0;0;0
FR;11;2022-10-26;0;0;0;0;0;0;0;0;0;0;0;0;0;0;0;0;0;0
FR;11;2022-10-27;0;0;0;0;0;0;0;0;0;0;0;0;0;0;0;0;0;0
FR;11;2022-10-28;0;0;0;0;0;0;0;0;0;0;0;0;0;0;0;0;0;0
FR;11;2022-10-29;0;0;0;0;0;0;0;0;0;0;0;0;0;0;0;0;0;0
FR;11;2022-10-30;0;0;0;0;0;0;0;0;0;0;0;0;0;0;0;0;0;0
FR;11;2022-10-31;0;0;0;0;0;0;0;0;0;0;0;0;0;0;0;0;0;0
FR;11;2022-11-01;0;0;0;0;0;0;0;0;0;0;0;0;0;0;0;0;0;0
FR;11;2022-11-02;0;0;0;0;0;0;0;0;0;0;0;0;0;0;0;0;0;0
FR;11;2022-11-03;0;0;0;0;0;0;0;0;0;0;0;0;0;0;0;0;0;0
FR;11;2022-11-04;0;0;0;0;0;0;0;0;0;0;0;0;0;0;0;0;0;0
FR;11;2022-11-05;0;0;0;0;0;0;0;0;0;0;0;0;0;0;0;0;0;0
FR;11;2022-11-06;0;0;0;0;0;0;0;0;0;0;0;0;0;0;0;0;0;0
FR;11;2022-11-07;0;0;0;0;0;0;0;0;0;0;0;0;0;0;0;0;0;0
FR;11;2022-11-08;0;0;0;0;0;0;0;0;0;0;0;0;0;0;0;0;0;0
FR;11;2022-11-09;0;0;0;0;0;0;0;0;0;0;0;0;0;0;0;0;0;0
FR;11;2022-11-10;0;0;0;0;0;0;0;0;0;0;0;0;0;0;0;0;0;0
FR;11;2022-11-11;0;0;0;0;0;0;0;0;0;0;0;0;0;0;0;0;0;0
FR;11;2022-11-12;0;0;0;0;0;0;0;0;0;0;0;0;0;0;0;0;0;0
FR;11;2022-11-13;0;0;0;0;0;0;0;0;0;0;0;0;0;0;0;0;0;0
FR;11;2022-11-14;0;0;0;0;0;0;0;0;0;0;0;0;0;0;0;0;0;0
FR;11;2022-11-15;0;0;0;0;0;0;0;0;0;0;0;0;0;0;0;0;0;0
FR;11;2022-11-16;0;0;0;0;0;0;0;0;0;0;0;0;0;0;0;0;0;0
FR;11;2022-11-17;0;0;0;0;0;0;0;0;0;0;0;0;0;0;0;0;0;0
FR;11;2022-11-18;0;0;0;0;0;0;0;0;0;0;0;0;0;0;0;0;0;0
FR;11;2022-11-19;0;0;0;0;0;0;0;0;0;0;0;0;0;0;0;0;0;0
FR;11;2022-11-20;0;0;0;0;0;0;0;0;0;0;0;0;0;0;0;0;0;0
FR;11;2022-11-21;0;0;0;0;0;0;0;0;0;0;0;0;0;0;0;0;0;0
FR;11;2022-11-22;0;0;0;0;0;0;0;0;0;0;0;0;0;0;0;0;0;0
FR;11;2022-11-23;0;0;0;0;0;0;0;0;0;0;0;0;0;0;0;0;0;0
FR;11;2022-11-24;0;0;0;0;0;0;0;0;0;0;0;0;0;0;0;0;0;0
FR;11;2022-11-25;0;0;0;0;0;0;0;0;0;0;0;0;0;0;0;0;0;0
FR;11;2022-11-26;0;0;0;0;0;0;0;0;0;0;0;0;0;0;0;0;0;0
FR;11;2022-11-27;0;0;0;0;0;0;0;0;0;0;0;0;0;0;0;0;0;0
FR;11;2022-11-28;0;0;0;0;0;0;0;0;0;0;0;0;0;0;0;0;0;0
FR;11;2022-11-29;0;0;0;0;0;0;0;0;0;0;0;0;0;0;0;0;0;0
FR;11;2022-11-30;0;0;0;0;0;0;0;0;0;0;0;0;0;0;0;0;0;0
FR;11;2022-12-01;0;0;0;0;0;0;0;0;0;0;0;0;0;0;0;0;0;0
FR;11;2022-12-02;0;0;0;0;0;0;0;0;0;0;0;0;0;0;0;0;0;0
FR;11;2022-12-03;0;0;0;0;0;0;0;0;0;0;0;0;0;0;0;0;0;0
FR;11;2022-12-04;0;0;0;0;0;0;0;0;0;0;0;0;0;0;0;0;0;0
FR;11;2022-12-05;0;0;0;0;0;0;0;0;0;0;0;0;0;0;0;0;0;0
FR;11;2022-12-06;0;0;0;0;0;0;0;0;0;0;0;0;0;0;0;0;0;0
FR;11;2022-12-07;0;0;0;0;0;0;0;0;0;0;0;0;0;0;0;0;0;0
FR;11;2022-12-08;0;0;0;0;0;0;0;0;0;0;0;0;0;0;0;0;0;0
FR;11;2022-12-09;0;0;0;0;0;0;0;0;0;0;0;0;0;0;0;0;0;0
FR;11;2022-12-10;0;0;0;0;0;0;0;0;0;0;0;0;0;0;0;0;0;0
FR;11;2022-12-11;0;0;0;0;0;0;0;0;0;0;0;0;0;0;0;0;0;0
FR;11;2022-12-12;0;0;0;0;0;0;0;0;0;0;0;0;0;0;0;0;0;0
FR;11;2022-12-13;0;0;0;0;0;0;0;0;0;0;0;0;0;0;0;0;0;0
FR;11;2022-12-14;0;0;0;0;0;0;0;0;0;0;0;0;0;0;0;0;0;0
FR;11;2022-12-15;0;0;0;0;0;0;0;0;0;0;0;0;0;0;0;0;0;0
FR;11;2022-12-16;0;0;0;0;0;0;0;0;0;0;0;0;0;0;0;0;0;0
FR;11;2022-12-17;0;0;0;0;0;0;0;0;0;0;0;0;0;0;0;0;0;0
FR;11;2022-12-18;0;0;0;0;0;0;0;0;0;0;0;0;0;0;0;0;0;0
FR;11;2022-12-19;0;0;0;0;0;0;0;0;0;0;0;0;0;0;0;0;0;0
FR;11;2022-12-20;0;0;0;0;0;0;0;0;0;0;0;0;0;0;0;0;0;0
FR;11;2022-12-21;0;0;0;0;0;0;0;0;0;0;0;0;0;0;0;0;0;0
FR;11;2022-12-22;0;0;0;0;0;0;0;0;0;0;0;0;0;0;0;0;0;0
FR;11;2022-12-23;0;0;0;0;0;0;0;0;0;0;0;0;0;0;0;0;0;0
FR;11;2022-12-24;0;0;0;0;0;0;0;0;0;0;0;0;0;0;0;0;0;0
FR;11;2022-12-25;0;0;0;0;0;0;0;0;0;0;0;0;0;0;0;0;0;0
FR;11;2022-12-26;0;0;0;0;0;0;0;0;0;0;0;0;0;0;0;0;0;0
FR;11;2022-12-27;0;0;0;0;0;0;0;0;0;0;0;0;0;0;0;0;0;0
FR;11;2022-12-28;0;0;0;0;0;0;0;0;0;0;0;0;0;0;0;0;0;0
FR;11;2022-12-29;0;0;0;0;0;0;0;0;0;0;0;0;0;0;0;0;0;0
FR;11;2022-12-30;0;0;0;0;0;0;0;0;0;0;0;0;0;0;0;0;0;0
FR;11;2022-12-31;0;0;0;0;0;0;0;0;0;0;0;0;0;0;0;0;0;0
FR;11;2023-01-01;0;0;0;0;0;0;0;0;0;0;0;0;0;0;0;0;0;0
FR;11;2023-01-02;0;0;0;0;0;0;0;0;0;0;0;0;0;0;0;0;0;0
FR;11;2023-01-03;0;0;0;0;0;0;0;0;0;0;0;0;0;0;0;0;0;0
FR;11;2023-01-04;0;0;0;0;0;0;0;0;0;0;0;0;0;0;0;0;0;0
FR;11;2023-01-05;0;0;0;0;0;0;0;0;0;0;0;0;0;0;0;0;0;0
FR;11;2023-01-06;0;0;0;0;0;0;0;0;0;0;0;0;0;0;0;0;0;0
FR;11;2023-01-07;0;0;0;0;0;0;0;0;0;0;0;0;0;0;0;0;0;0
FR;11;2023-01-08;0;0;0;0;0;0;0;0;0;0;0;0;0;0;0;0;0;0
FR;11;2023-01-09;0;0;0;0;0;0;0;0;0;0;0;0;0;0;0;0;0;0
FR;11;2023-01-10;0;0;0;0;0;0;0;0;0;0;0;0;0;0;0;0;0;0
FR;11;2023-01-11;0;0;0;0;0;0;0;0;0;0;0;0;0;0;0;0;0;0
FR;11;2023-01-12;0;0;0;0;0;0;0;0;0;0;0;0;0;0;0;0;0;0
FR;11;2023-01-13;0;0;0;0;0;0;0;0;0;0;0;0;0;0;0;0;0;0
FR;11;2023-01-14;0;0;0;0;0;0;0;0;0;0;0;0;0;0;0;0;0;0
FR;11;2023-01-15;0;0;0;0;0;0;0;0;0;0;0;0;0;0;0;0;0;0
FR;11;2023-01-16;0;0;0;0;0;0;0;0;0;0;0;0;0;0;0;0;0;0
FR;11;2023-01-17;0;0;0;0;0;0;0;0;0;0;0;0;0;0;0;0;0;0
FR;11;2023-01-18;0;0;0;0;0;0;0;0;0;0;0;0;0;0;0;0;0;0
FR;11;2023-01-19;0;0;0;0;0;0;0;0;0;0;0;0;0;0;0;0;0;0
FR;11;2023-01-20;0;0;0;0;0;0;0;0;0;0;0;0;0;0;0;0;0;0
FR;11;2023-01-21;0;0;0;0;0;0;0;0;0;0;0;0;0;0;0;0;0;0
FR;11;2023-01-22;0;0;0;0;0;0;0;0;0;0;0;0;0;0;0;0;0;0
FR;11;2023-01-23;0;0;0;0;0;0;0;0;0;0;0;0;0;0;0;0;0;0
FR;11;2023-01-24;0;0;0;0;0;0;0;0;0;0;0;0;0;0;0;0;0;0
FR;11;2023-01-25;0;0;0;0;0;0;0;0;0;0;0;0;0;0;0;0;0;0
FR;11;2023-01-26;0;0;0;0;0;0;0;0;0;0;0;0;0;0;0;0;0;0
FR;11;2023-01-27;0;0;0;0;0;0;0;0;0;0;0;0;0;0;0;0;0;0
FR;11;2023-01-28;0;0;0;0;0;0;0;0;0;0;0;0;0;0;0;0;0;0
FR;11;2023-01-29;0;0;0;0;0;0;0;0;0;0;0;0;0;0;0;0;0;0
FR;11;2023-01-30;0;0;0;0;0;0;0;0;0;0;0;0;0;0;0;0;0;0
FR;11;2023-01-31;0;0;0;0;0;0;0;0;0;0;0;0;0;0;0;0;0;0
FR;11;2023-02-01;0;0;0;0;0;0;0;0;0;0;0;0;0;0;0;0;0;0
FR;11;2023-02-02;0;0;0;0;0;0;0;0;0;0;0;0;0;0;0;0;0;0
FR;11;2023-02-03;0;0;0;0;0;0;0;0;0;0;0;0;0;0;0;0;0;0
FR;11;2023-02-04;0;0;0;0;0;0;0;0;0;0;0;0;0;0;0;0;0;0
FR;11;2023-02-05;0;0;0;0;0;0;0;0;0;0;0;0;0;0;0;0;0;0
FR;11;2023-02-06;1;0;0;0;0;0;0;0;0;1;0;0;0;0;0;0;0;0
FR;11;2023-02-07;0;0;0;0;0;0;0;0;0;1;0;0;0;0;0;0;0;0
FR;11;2023-02-08;2;0;0;0;0;0;0;0;0;3;0;0;0;0;0;0;0;0
FR;11;2023-02-09;2;0;0;0;0;0;0;0;0;5;0;0;0;0;0;0;0;0
FR;11;2023-02-10;0;0;0;0;0;0;0;0;0;5;0;0;0;0;0;0;0;0
FR;11;2023-02-11;0;0;0;0;0;0;0;0;0;5;0;0;0;0;0;0;0;0
FR;11;2023-02-12;0;0;0;0;0;0;0;0;0;5;0;0;0;0;0;0;0;0
FR;11;2023-02-13;2;0;0;0;0;0;0;0;0;7;0;0;0;0;0;0;0;0
FR;11;2023-02-14;0;0;0;0;0;0;0;0;0;7;0;0;0;0;0;0;0;0
FR;11;2023-02-15;2;0;0;0;0;0;0;0;0;9;0;0;0;0;0;0;0;0
FR;11;2023-02-16;0;0;0;0;0;0;0;0;0;9;0;0;0;0;0;0;0;0
FR;11;2023-02-17;0;0;0;0;0;0;0;0;0;9;0;0;0;0;0;0;0;0
FR;11;2023-02-18;0;0;0;0;0;0;0;0;0;9;0;0;0;0;0;0;0;0
FR;11;2023-02-19;0;0;0;0;0;0;0;0;0;9;0;0;0;0;0;0;0;0
FR;11;2023-02-20;0;0;0;0;0;0;0;0;0;9;0;0;0;0;0;0;0;0
FR;11;2023-02-21;1;0;0;0;0;0;0;0;0;10;0;0;0;0;0;0;0;0
FR;11;2023-02-22;0;0;0;0;0;0;0;0;0;10;0;0;0;0;0;0;0;0
FR;11;2023-02-23;0;0;0;0;0;0;0;0;0;10;0;0;0;0;0;0;0;0
FR;11;2023-02-24;0;0;0;0;0;0;0;0;0;10;0;0;0;0;0;0;0;0
FR;11;2023-02-25;0;0;0;0;0;0;0;0;0;10;0;0;0;0;0;0;0;0
FR;11;2023-02-26;0;0;2;0;0;2;0;0;0;10;0;2;0;0;2;0;0;0
FR;11;2023-02-27;0;0;0;0;0;0;0;0;0;10;0;2;0;0;2;0;0;0
FR;11;2023-02-28;1;1;0;0;1;0;0;0;0;11;1;2;0;1;2;0;0;0
FR;11;2023-03-01;0;1;0;0;1;0;0;0;0;11;2;2;0;2;2;0;0;0
FR;11;2023-03-02;0;0;0;0;0;0;0;0;0;11;2;2;0;2;2;0;0;0
FR;11;2023-03-03;0;0;0;0;0;0;0;0;0;11;2;2;0;2;2;0;0;0
FR;11;2023-03-04;2;1;0;0;1;0;0;0;0;13;3;2;0;3;2;0;0;0
FR;11;2023-03-05;0;0;0;0;0;0;0;0;0;13;3;2;0;3;2;0;0;0
FR;11;2023-03-06;4;0;1;0;1;1;0;0;0;17;3;3;0;4;3;0;0;0
FR;11;2023-03-07;0;1;0;0;1;0;0;0;0;17;4;3;0;5;3;0;0;0
FR;11;2023-03-08;1;1;0;0;1;0;0;0;0;18;5;3;0;6;3;0;0;0
FR;11;2023-03-09;0;0;0;0;0;0;0;0;0;18;5;3;0;6;3;0;0;0
FR;11;2023-03-10;0;0;0;0;0;0;0;0;0;18;5;3;0;6;3;0;0;0
FR;11;2023-03-11;2;0;0;0;0;0;0;0;0;20;5;3;0;6;3;0;0;0
FR;11;2023-03-12;0;1;0;0;1;0;0;0;0;20;6;3;0;7;3;0;0;0
FR;11;2023-03-13;0;0;0;0;0;0;0;0;0;20;6;3;0;7;3;0;0;0
FR;11;2023-03-14;0;0;0;0;0;0;0;0;0;20;6;3;0;7;3;0;0;0
FR;11;2023-03-15;0;1;0;0;1;0;0;0;0;20;7;3;0;8;3;0;0;0
FR;11;2023-03-16;0;0;0;0;0;0;0;0;0;20;7;3;0;8;3;0;0;0
FR;11;2023-03-17;0;0;0;0;0;0;0;0;0;20;7;3;0;8;3;0;0;0
FR;11;2023-03-18;1;0;0;0;0;0;0;0;0;21;7;3;0;8;3;0;0;0
FR;11;2023-03-19;0;0;0;0;0;0;0;0;0;21;7;3;0;8;3;0;0;0
FR;11;2023-03-20;0;0;0;0;0;0;0;0;0;21;7;3;0;8;3;0;0;0
FR;11;2023-03-21;1;0;0;0;0;0;0;0;0;22;7;3;0;8;3;0;0;0
FR;11;2023-03-22;2;0;0;0;0;0;0;0;0;24;7;3;0;8;3;0;0;0
FR;11;2023-03-23;0;0;0;1;0;0;1;0;0;24;7;3;1;8;3;1;0;0
FR;11;2023-03-24;0;0;0;0;0;0;0;0;0;24;7;3;1;8;3;1;0;0
FR;11;2023-03-25;1;1;0;0;1;0;0;0;0;25;8;3;1;9;3;1;0;0
FR;11;2023-03-26;0;0;0;0;0;0;0;0;0;25;8;3;1;9;3;1;0;0
FR;11;2023-03-27;0;1;0;0;0;1;0;0;0;25;9;3;1;9;4;1;0;0
FR;11;2023-03-28;0;0;0;0;0;0;0;0;0;25;9;3;1;9;4;1;0;0
FR;11;2023-03-29;0;1;0;0;1;0;0;0;0;25;10;3;1;10;4;1;0;0
FR;11;2023-03-30;1;1;0;0;1;0;0;0;0;26;11;3;1;11;4;1;0;0
FR;11;2023-03-31;0;0;0;0;0;0;0;0;0;26;11;3;1;11;4;1;0;0
FR;11;2023-04-01;0;2;0;0;2;0;0;0;0;26;13;3;1;13;4;1;0;0
FR;11;2023-04-02;0;0;0;0;0;0;0;0;0;26;13;3;1;13;4;1;0;0
FR;11;2023-04-03;0;3;0;0;3;0;0;0;0;26;16;3;1;16;4;1;0;0
FR;11;2023-04-04;0;0;0;0;0;0;0;0;0;26;16;3;1;16;4;1;0;0
FR;11;2023-04-05;0;0;0;0;0;0;0;0;0;26;16;3;1;16;4;1;0;0
FR;11;2023-04-06;0;0;0;0;0;0;0;0;0;26;16;3;1;16;4;1;0;0
FR;11;2023-04-07;0;1;0;0;1;0;0;0;0;26;17;3;1;17;4;1;0;0
FR;11;2023-04-08;0;0;0;0;0;0;0;0;0;26;17;3;1;17;4;1;0;0
FR;11;2023-04-09;0;0;0;0;0;0;0;0;0;26;17;3;1;17;4;1;0;0
FR;11;2023-04-10;0;0;0;0;0;0;0;0;0;26;17;3;1;17;4;1;0;0
FR;11;2023-04-11;0;1;0;0;1;0;0;0;0;26;18;3;1;18;4;1;0;0
FR;11;2023-04-12;1;1;0;0;1;0;0;0;0;27;19;3;1;19;4;1;0;0
FR;11;2023-04-13;0;0;0;0;0;0;0;0;0;27;19;3;1;19;4;1;0;0
FR;11;2023-04-14;0;0;0;0;0;0;0;0;0;27;19;3;1;19;4;1;0;0
FR;11;2023-04-15;0;1;0;0;1;0;0;0;0;27;20;3;1;20;4;1;0;0
FR;11;2023-04-16;0;0;0;0;0;0;0;0;0;27;20;3;1;20;4;1;0;0
FR;11;2023-04-17;0;1;0;0;1;0;0;0;0;27;21;3;1;21;4;1;0;0
FR;11;2023-04-18;0;0;0;0;0;0;0;0;0;27;21;3;1;21;4;1;0;0
FR;11;2023-04-19;1;0;0;0;0;0;0;0;0;28;21;3;1;21;4;1;0;0
FR;11;2023-04-20;0;1;0;0;1;0;0;0;0;28;22;3;1;22;4;1;0;0
FR;11;2023-04-21;2;0;0;0;0;0;0;0;0;30;22;3;1;22;4;1;0;0
FR;11;2023-04-22;0;2;0;0;2;0;0;0;0;30;24;3;1;24;4;1;0;0
FR;11;2023-04-23;0;0;0;0;0;0;0;0;0;30;24;3;1;24;4;1;0;0
FR;11;2023-04-24;0;0;1;0;0;1;0;0;0;30;24;4;1;24;5;1;0;0
FR;11;2023-04-25;0;0;0;0;0;0;0;0;0;30;24;4;1;24;5;1;0;0
FR;11;2023-04-26;0;0;0;0;0;0;0;0;0;30;24;4;1;24;5;1;0;0
FR;11;2023-04-27;0;0;0;0;0;0;0;0;0;30;24;4;1;24;5;1;0;0
FR;11;2023-04-28;0;0;0;0;0;0;0;0;0;30;24;4;1;24;5;1;0;0
FR;11;2023-04-29;0;0;0;0;0;0;0;0;0;30;24;4;1;24;5;1;0;0
FR;11;2023-04-30;0;0;0;0;0;0;0;0;0;30;24;4;1;24;5;1;0;0
FR;11;2023-05-01;0;0;0;0;0;0;0;0;0;30;24;4;1;24;5;1;0;0
FR;11;2023-05-02;0;0;0;0;0;0;0;0;0;30;24;4;1;24;5;1;0;0
FR;11;2023-05-03;0;0;2;0;0;2;0;0;0;30;24;6;1;24;7;1;0;0
FR;11;2023-05-04;0;0;0;0;0;0;0;0;0;30;24;6;1;24;7;1;0;0
FR;11;2023-05-05;0;0;0;0;0;0;0;0;0;30;24;6;1;24;7;1;0;0
FR;11;2023-05-06;0;0;0;0;0;0;0;0;0;30;24;6;1;24;7;1;0;0
FR;11;2023-05-07;0;0;0;0;0;0;0;0;0;30;24;6;1;24;7;1;0;0
FR;11;2023-05-08;0;0;0;0;0;0;0;0;0;30;24;6;1;24;7;1;0;0
FR;11;2023-05-09;0;0;0;0;0;0;0;0;0;30;24;6;1;24;7;1;0;0
FR;11;2023-05-10;2;2;0;0;2;0;0;0;0;32;26;6;1;26;7;1;0;0
FR;11;2023-05-11;1;0;0;0;0;0;0;0;0;33;26;6;1;26;7;1;0;0
FR;11;2023-05-12;0;2;0;0;2;0;0;0;0;33;28;6;1;28;7;1;0;0
FR;11;2023-05-13;0;0;0;0;0;0;0;0;0;33;28;6;1;28;7;1;0;0
FR;11;2023-05-14;0;0;0;0;0;0;0;0;0;33;28;6;1;28;7;1;0;0
FR;11;2023-05-15;0;0;0;0;0;0;0;0;0;33;28;6;1;28;7;1;0;0
FR;11;2023-05-16;0;0;0;0;0;0;0;0;0;33;28;6;1;28;7;1;0;0
FR;11;2023-05-17;0;0;0;0;0;0;0;0;0;33;28;6;1;28;7;1;0;0
FR;11;2023-05-18;0;0;0;0;0;0;0;0;0;33;28;6;1;28;7;1;0;0
FR;11;2023-05-19;0;0;0;0;0;0;0;0;0;33;28;6;1;28;7;1;0;0
FR;11;2023-05-20;0;0;0;0;0;0;0;0;0;33;28;6;1;28;7;1;0;0
FR;11;2023-05-21;0;0;0;0;0;0;0;0;0;33;28;6;1;28;7;1;0;0
FR;11;2023-05-22;0;0;0;0;0;0;0;0;0;33;28;6;1;28;7;1;0;0
FR;11;2023-05-23;0;0;0;0;0;0;0;0;0;33;28;6;1;28;7;1;0;0
FR;11;2023-05-24;1;0;1;0;0;0;0;0;0;34;28;7;1;28;7;1;0;0
FR;11;2023-05-25;0;0;0;0;0;0;0;0;0;34;28;7;1;28;7;1;0;0
FR;11;2023-05-26;0;0;0;0;0;0;0;0;0;34;28;7;1;28;7;1;0;0
FR;11;2023-05-27;0;0;3;0;0;3;0;0;0;34;28;10;1;28;10;1;0;0
FR;11;2023-05-28;0;0;0;0;0;0;0;0;0;34;28;10;1;28;10;1;0;0
FR;11;2023-05-29;0;0;0;0;0;0;0;0;0;34;28;10;1;28;10;1;0;0
FR;11;2023-05-30;0;1;3;0;1;3;0;0;0;34;29;13;1;29;13;1;0;0
FR;11;2023-05-31;0;0;1;0;0;0;1;0;0;34;29;14;1;29;13;2;0;0
FR;11;2023-06-01;0;0;0;0;0;0;0;0;0;34;29;14;1;29;13;2;0;0
FR;11;2023-06-02;0;0;1;0;0;1;0;0;0;34;29;15;1;29;14;2;0;0
FR;11;2023-06-03;0;0;0;0;0;0;0;0;0;34;29;15;1;29;14;2;0;0
FR;11;2023-06-04;0;0;0;0;0;0;0;0;0;34;29;15;1;29;14;2;0;0
FR;11;2023-06-05;0;0;0;0;0;0;0;0;0;34;29;15;1;29;14;2;0;0
FR;11;2023-06-06;0;0;1;0;0;0;0;0;0;34;29;16;1;29;14;2;0;0
FR;11;2023-06-07;2;0;1;0;0;1;0;0;0;36;29;17;1;29;15;2;0;0
FR;11;2023-06-08;3;0;0;0;0;0;0;0;0;39;29;17;1;29;15;2;0;0
FR;11;2023-06-09;0;0;0;0;0;0;0;0;0;39;29;17;1;29;15;2;0;0
FR;11;2023-06-10;0;0;0;0;0;0;0;0;0;39;29;17;1;29;15;2;0;0
FR;11;2023-06-11;2;0;0;0;0;0;0;0;0;41;29;17;1;29;15;2;0;0
FR;11;2023-06-12;0;0;0;0;0;0;0;0;0;41;29;17;1;29;15;2;0;0
FR;11;2023-06-13;0;0;0;0;0;0;0;0;0;41;29;17;1;29;15;2;0;0
FR;11;2023-06-14;0;0;0;0;0;0;0;0;0;41;29;17;1;29;15;2;0;0
FR;11;2023-06-15;0;0;1;0;0;1;0;0;0;41;29;18;1;29;16;2;0;0
FR;11;2023-06-16;0;0;1;0;0;1;0;0;0;41;29;19;1;29;17;2;0;0
FR;11;2023-06-17;0;0;0;0;0;0;0;0;0;41;29;19;1;29;17;2;0;0
FR;11;2023-06-18;0;0;1;0;0;1;0;0;0;41;29;20;1;29;18;2;0;0
FR;11;2023-06-19;0;0;0;0;0;0;0;0;0;41;29;20;1;29;18;2;0;0
FR;11;2023-06-20;0;0;0;0;0;0;0;0;0;41;29;20;1;29;18;2;0;0
FR;11;2023-06-21;0;1;0;0;1;0;0;0;0;41;30;20;1;30;18;2;0;0
FR;11;2023-06-22;0;0;0;0;0;0;0;0;0;41;30;20;1;30;18;2;0;0
FR;11;2023-06-23;1;0;0;0;0;0;0;0;0;42;30;20;1;30;18;2;0;0
FR;11;2023-06-24;0;0;0;0;0;0;0;0;0;42;30;20;1;30;18;2;0;0
FR;11;2023-06-25;0;0;0;0;0;0;0;0;0;42;30;20;1;30;18;2;0;0
FR;11;2023-06-26;0;0;0;0;0;0;0;0;0;42;30;20;1;30;18;2;0;0
FR;11;2023-06-27;0;0;0;0;0;0;0;0;0;42;30;20;1;30;18;2;0;0
FR;11;2023-06-28;1;2;0;0;2;0;0;0;0;43;32;20;1;32;18;2;0;0
FR;11;2023-06-29;0;0;0;0;0;0;0;0;0;43;32;20;1;32;18;2;0;0
FR;11;2023-06-30;0;0;1;0;0;1;0;0;0;43;32;21;1;32;19;2;0;0
FR;11;2023-07-01;0;0;0;0;0;0;0;0;0;43;32;21;1;32;19;2;0;0
FR;11;2023-07-02;0;0;0;0;0;0;0;0;0;43;32;21;1;32;19;2;0;0
FR;11;2023-07-03;0;0;0;0;0;0;0;0;0;43;32;21;1;32;19;2;0;0
FR;11;2023-07-04;0;0;0;0;0;0;0;0;0;43;32;21;1;32;19;2;0;0
FR;11;2023-07-05;0;0;0;0;0;0;0;0;0;43;32;21;1;32;19;2;0;0
FR;11;2023-07-06;0;0;0;0;0;0;0;0;0;43;32;21;1;32;19;2;0;0
FR;11;2023-07-07;0;0;0;0;0;0;0;0;0;43;32;21;1;32;19;2;0;0
FR;11;2023-07-08;0;0;0;0;0;0;0;0;0;43;32;21;1;32;19;2;0;0
FR;11;2023-07-09;0;0;0;0;0;0;0;0;0;43;32;21;1;32;19;2;0;0
FR;11;2023-07-10;0;0;0;0;0;0;0;0;0;43;32;21;1;32;19;2;0;0
FR;12;2020-12-27;0;0;0;0;0;0;0;0;0;0;0;0;0;0;0;0;0;0
FR;12;2020-12-28;0;0;0;0;0;0;0;0;0;0;0;0;0;0;0;0;0;0
FR;12;2020-12-29;0;0;0;0;0;0;0;0;0;0;0;0;0;0;0;0;0;0
FR;12;2020-12-30;0;0;0;0;0;0;0;0;0;0;0;0;0;0;0;0;0;0
FR;12;2020-12-31;0;0;0;0;0;0;0;0;0;0;0;0;0;0;0;0;0;0
FR;12;2021-01-01;0;0;0;0;0;0;0;0;0;0;0;0;0;0;0;0;0;0
FR;12;2021-01-02;0;0;0;0;0;0;0;0;0;0;0;0;0;0;0;0;0;0
FR;12;2021-01-03;0;0;0;0;0;0;0;0;0;0;0;0;0;0;0;0;0;0
FR;12;2021-01-04;0;0;0;0;0;0;0;0;0;0;0;0;0;0;0;0;0;0
FR;12;2021-01-05;0;0;0;0;0;0;0;0;0;0;0;0;0;0;0;0;0;0
FR;12;2021-01-06;0;0;0;0;0;0;0;0;0;0;0;0;0;0;0;0;0;0
FR;12;2021-01-07;0;0;0;0;0;0;0;0;0;0;0;0;0;0;0;0;0;0
FR;12;2021-01-08;0;0;0;0;0;0;0;0;0;0;0;0;0;0;0;0;0;0
FR;12;2021-01-09;0;0;0;0;0;0;0;0;0;0;0;0;0;0;0;0;0;0
FR;12;2021-01-10;0;0;0;0;0;0;0;0;0;0;0;0;0;0;0;0;0;0
FR;12;2021-01-11;0;0;0;0;0;0;0;0;0;0;0;0;0;0;0;0;0;0
FR;12;2021-01-12;0;0;0;0;0;0;0;0;0;0;0;0;0;0;0;0;0;0
FR;12;2021-01-13;0;0;0;0;0;0;0;0;0;0;0;0;0;0;0;0;0;0
FR;12;2021-01-14;0;0;0;0;0;0;0;0;0;0;0;0;0;0;0;0;0;0
FR;12;2021-01-15;0;0;0;0;0;0;0;0;0;0;0;0;0;0;0;0;0;0
FR;12;2021-01-16;0;0;0;0;0;0;0;0;0;0;0;0;0;0;0;0;0;0
FR;12;2021-01-17;0;0;0;0;0;0;0;0;0;0;0;0;0;0;0;0;0;0
FR;12;2021-01-18;0;0;0;0;0;0;0;0;0;0;0;0;0;0;0;0;0;0
FR;12;2021-01-19;0;0;0;0;0;0;0;0;0;0;0;0;0;0;0;0;0;0
FR;12;2021-01-20;0;0;0;0;0;0;0;0;0;0;0;0;0;0;0;0;0;0
FR;12;2021-01-21;0;0;0;0;0;0;0;0;0;0;0;0;0;0;0;0;0;0
FR;12;2021-01-22;0;0;0;0;0;0;0;0;0;0;0;0;0;0;0;0;0;0
FR;12;2021-01-23;0;0;0;0;0;0;0;0;0;0;0;0;0;0;0;0;0;0
FR;12;2021-01-24;0;0;0;0;0;0;0;0;0;0;0;0;0;0;0;0;0;0
FR;12;2021-01-25;0;0;0;0;0;0;0;0;0;0;0;0;0;0;0;0;0;0
FR;12;2021-01-26;0;0;0;0;0;0;0;0;0;0;0;0;0;0;0;0;0;0
FR;12;2021-01-27;0;0;0;0;0;0;0;0;0;0;0;0;0;0;0;0;0;0
FR;12;2021-01-28;0;0;0;0;0;0;0;0;0;0;0;0;0;0;0;0;0;0
FR;12;2021-01-29;0;0;0;0;0;0;0;0;0;0;0;0;0;0;0;0;0;0
FR;12;2021-01-30;0;0;0;0;0;0;0;0;0;0;0;0;0;0;0;0;0;0
FR;12;2021-01-31;0;0;0;0;0;0;0;0;0;0;0;0;0;0;0;0;0;0
FR;12;2021-02-01;0;0;0;0;0;0;0;0;0;0;0;0;0;0;0;0;0;0
FR;12;2021-02-02;0;0;0;0;0;0;0;0;0;0;0;0;0;0;0;0;0;0
FR;12;2021-02-03;0;0;0;0;0;0;0;0;0;0;0;0;0;0;0;0;0;0
FR;12;2021-02-04;0;0;0;0;0;0;0;0;0;0;0;0;0;0;0;0;0;0
FR;12;2021-02-05;0;0;0;0;0;0;0;0;0;0;0;0;0;0;0;0;0;0
FR;12;2021-02-06;0;0;0;0;0;0;0;0;0;0;0;0;0;0;0;0;0;0
FR;12;2021-02-07;0;0;0;0;0;0;0;0;0;0;0;0;0;0;0;0;0;0
FR;12;2021-02-08;0;0;0;0;0;0;0;0;0;0;0;0;0;0;0;0;0;0
FR;12;2021-02-09;0;0;0;0;0;0;0;0;0;0;0;0;0;0;0;0;0;0
FR;12;2021-02-10;0;0;0;0;0;0;0;0;0;0;0;0;0;0;0;0;0;0
FR;12;2021-02-11;0;0;0;0;0;0;0;0;0;0;0;0;0;0;0;0;0;0
FR;12;2021-02-12;0;0;0;0;0;0;0;0;0;0;0;0;0;0;0;0;0;0
FR;12;2021-02-13;0;0;0;0;0;0;0;0;0;0;0;0;0;0;0;0;0;0
FR;12;2021-02-14;0;0;0;0;0;0;0;0;0;0;0;0;0;0;0;0;0;0
FR;12;2021-02-15;0;0;0;0;0;0;0;0;0;0;0;0;0;0;0;0;0;0
FR;12;2021-02-16;0;0;0;0;0;0;0;0;0;0;0;0;0;0;0;0;0;0
FR;12;2021-02-17;0;0;0;0;0;0;0;0;0;0;0;0;0;0;0;0;0;0
FR;12;2021-02-18;0;0;0;0;0;0;0;0;0;0;0;0;0;0;0;0;0;0
FR;12;2021-02-19;0;0;0;0;0;0;0;0;0;0;0;0;0;0;0;0;0;0
FR;12;2021-02-20;0;0;0;0;0;0;0;0;0;0;0;0;0;0;0;0;0;0
FR;12;2021-02-21;0;0;0;0;0;0;0;0;0;0;0;0;0;0;0;0;0;0
FR;12;2021-02-22;0;0;0;0;0;0;0;0;0;0;0;0;0;0;0;0;0;0
FR;12;2021-02-23;0;0;0;0;0;0;0;0;0;0;0;0;0;0;0;0;0;0
FR;12;2021-02-24;0;0;0;0;0;0;0;0;0;0;0;0;0;0;0;0;0;0
FR;12;2021-02-25;0;0;0;0;0;0;0;0;0;0;0;0;0;0;0;0;0;0
FR;12;2021-02-26;0;0;0;0;0;0;0;0;0;0;0;0;0;0;0;0;0;0
FR;12;2021-02-27;0;0;0;0;0;0;0;0;0;0;0;0;0;0;0;0;0;0
FR;12;2021-02-28;0;0;0;0;0;0;0;0;0;0;0;0;0;0;0;0;0;0
FR;12;2021-03-01;0;0;0;0;0;0;0;0;0;0;0;0;0;0;0;0;0;0
FR;12;2021-03-02;0;0;0;0;0;0;0;0;0;0;0;0;0;0;0;0;0;0
FR;12;2021-03-03;0;0;0;0;0;0;0;0;0;0;0;0;0;0;0;0;0;0
FR;12;2021-03-04;0;0;0;0;0;0;0;0;0;0;0;0;0;0;0;0;0;0
FR;12;2021-03-05;0;0;0;0;0;0;0;0;0;0;0;0;0;0;0;0;0;0
FR;12;2021-03-06;0;0;0;0;0;0;0;0;0;0;0;0;0;0;0;0;0;0
FR;12;2021-03-07;0;0;0;0;0;0;0;0;0;0;0;0;0;0;0;0;0;0
FR;12;2021-03-08;0;0;0;0;0;0;0;0;0;0;0;0;0;0;0;0;0;0
FR;12;2021-03-09;0;0;0;0;0;0;0;0;0;0;0;0;0;0;0;0;0;0
FR;12;2021-03-10;0;0;0;0;0;0;0;0;0;0;0;0;0;0;0;0;0;0
FR;12;2021-03-11;0;0;0;0;0;0;0;0;0;0;0;0;0;0;0;0;0;0
FR;12;2021-03-12;0;0;0;0;0;0;0;0;0;0;0;0;0;0;0;0;0;0
FR;12;2021-03-13;0;0;0;0;0;0;0;0;0;0;0;0;0;0;0;0;0;0
FR;12;2021-03-14;0;0;0;0;0;0;0;0;0;0;0;0;0;0;0;0;0;0
FR;12;2021-03-15;0;0;0;0;0;0;0;0;0;0;0;0;0;0;0;0;0;0
FR;12;2021-03-16;0;0;0;0;0;0;0;0;0;0;0;0;0;0;0;0;0;0
FR;12;2021-03-17;0;0;0;0;0;0;0;0;0;0;0;0;0;0;0;0;0;0
FR;12;2021-03-18;0;0;0;0;0;0;0;0;0;0;0;0;0;0;0;0;0;0
FR;12;2021-03-19;0;0;0;0;0;0;0;0;0;0;0;0;0;0;0;0;0;0
FR;12;2021-03-20;0;0;0;0;0;0;0;0;0;0;0;0;0;0;0;0;0;0
FR;12;2021-03-21;0;0;0;0;0;0;0;0;0;0;0;0;0;0;0;0;0;0
FR;12;2021-03-22;0;0;0;0;0;0;0;0;0;0;0;0;0;0;0;0;0;0
FR;12;2021-03-23;0;0;0;0;0;0;0;0;0;0;0;0;0;0;0;0;0;0
FR;12;2021-03-24;0;0;0;0;0;0;0;0;0;0;0;0;0;0;0;0;0;0
FR;12;2021-03-25;0;0;0;0;0;0;0;0;0;0;0;0;0;0;0;0;0;0
FR;12;2021-03-26;0;0;0;0;0;0;0;0;0;0;0;0;0;0;0;0;0;0
FR;12;2021-03-27;0;0;0;0;0;0;0;0;0;0;0;0;0;0;0;0;0;0
FR;12;2021-03-28;0;0;0;0;0;0;0;0;0;0;0;0;0;0;0;0;0;0
FR;12;2021-03-29;0;0;0;0;0;0;0;0;0;0;0;0;0;0;0;0;0;0
FR;12;2021-03-30;0;0;0;0;0;0;0;0;0;0;0;0;0;0;0;0;0;0
FR;12;2021-03-31;0;0;0;0;0;0;0;0;0;0;0;0;0;0;0;0;0;0
FR;12;2021-04-01;0;0;0;0;0;0;0;0;0;0;0;0;0;0;0;0;0;0
FR;12;2021-04-02;0;0;0;0;0;0;0;0;0;0;0;0;0;0;0;0;0;0
FR;12;2021-04-03;0;0;0;0;0;0;0;0;0;0;0;0;0;0;0;0;0;0
FR;12;2021-04-04;0;0;0;0;0;0;0;0;0;0;0;0;0;0;0;0;0;0
FR;12;2021-04-05;0;0;0;0;0;0;0;0;0;0;0;0;0;0;0;0;0;0
FR;12;2021-04-06;0;0;0;0;0;0;0;0;0;0;0;0;0;0;0;0;0;0
FR;12;2021-04-07;0;0;0;0;0;0;0;0;0;0;0;0;0;0;0;0;0;0
FR;12;2021-04-08;0;0;0;0;0;0;0;0;0;0;0;0;0;0;0;0;0;0
FR;12;2021-04-09;0;0;0;0;0;0;0;0;0;0;0;0;0;0;0;0;0;0
FR;12;2021-04-10;0;0;0;0;0;0;0;0;0;0;0;0;0;0;0;0;0;0
FR;12;2021-04-11;0;0;0;0;0;0;0;0;0;0;0;0;0;0;0;0;0;0
FR;12;2021-04-12;0;0;0;0;0;0;0;0;0;0;0;0;0;0;0;0;0;0
FR;12;2021-04-13;0;0;0;0;0;0;0;0;0;0;0;0;0;0;0;0;0;0
FR;12;2021-04-14;0;0;0;0;0;0;0;0;0;0;0;0;0;0;0;0;0;0
FR;12;2021-04-15;0;0;0;0;0;0;0;0;0;0;0;0;0;0;0;0;0;0
FR;12;2021-04-16;0;0;0;0;0;0;0;0;0;0;0;0;0;0;0;0;0;0
FR;12;2021-04-17;0;0;0;0;0;0;0;0;0;0;0;0;0;0;0;0;0;0
FR;12;2021-04-18;0;0;0;0;0;0;0;0;0;0;0;0;0;0;0;0;0;0
FR;12;2021-04-19;0;0;0;0;0;0;0;0;0;0;0;0;0;0;0;0;0;0
FR;12;2021-04-20;0;0;0;0;0;0;0;0;0;0;0;0;0;0;0;0;0;0
FR;12;2021-04-21;0;0;0;0;0;0;0;0;0;0;0;0;0;0;0;0;0;0
FR;12;2021-04-22;0;0;0;0;0;0;0;0;0;0;0;0;0;0;0;0;0;0
FR;12;2021-04-23;0;0;0;0;0;0;0;0;0;0;0;0;0;0;0;0;0;0
FR;12;2021-04-24;0;0;0;0;0;0;0;0;0;0;0;0;0;0;0;0;0;0
FR;12;2021-04-25;0;0;0;0;0;0;0;0;0;0;0;0;0;0;0;0;0;0
FR;12;2021-04-26;0;0;0;0;0;0;0;0;0;0;0;0;0;0;0;0;0;0
FR;12;2021-04-27;0;0;0;0;0;0;0;0;0;0;0;0;0;0;0;0;0;0
FR;12;2021-04-28;0;0;0;0;0;0;0;0;0;0;0;0;0;0;0;0;0;0
FR;12;2021-04-29;0;0;0;0;0;0;0;0;0;0;0;0;0;0;0;0;0;0
FR;12;2021-04-30;0;0;0;0;0;0;0;0;0;0;0;0;0;0;0;0;0;0
FR;12;2021-05-01;0;0;0;0;0;0;0;0;0;0;0;0;0;0;0;0;0;0
FR;12;2021-05-02;0;0;0;0;0;0;0;0;0;0;0;0;0;0;0;0;0;0
FR;12;2021-05-03;0;0;0;0;0;0;0;0;0;0;0;0;0;0;0;0;0;0
FR;12;2021-05-04;0;0;0;0;0;0;0;0;0;0;0;0;0;0;0;0;0;0
FR;12;2021-05-05;0;0;0;0;0;0;0;0;0;0;0;0;0;0;0;0;0;0
FR;12;2021-05-06;0;0;0;0;0;0;0;0;0;0;0;0;0;0;0;0;0;0
FR;12;2021-05-07;0;0;0;0;0;0;0;0;0;0;0;0;0;0;0;0;0;0
FR;12;2021-05-08;0;0;0;0;0;0;0;0;0;0;0;0;0;0;0;0;0;0
FR;12;2021-05-09;0;0;0;0;0;0;0;0;0;0;0;0;0;0;0;0;0;0
FR;12;2021-05-10;0;0;0;0;0;0;0;0;0;0;0;0;0;0;0;0;0;0
FR;12;2021-05-11;0;0;0;0;0;0;0;0;0;0;0;0;0;0;0;0;0;0
FR;12;2021-05-12;0;0;0;0;0;0;0;0;0;0;0;0;0;0;0;0;0;0
FR;12;2021-05-13;0;0;0;0;0;0;0;0;0;0;0;0;0;0;0;0;0;0
FR;12;2021-05-14;0;0;0;0;0;0;0;0;0;0;0;0;0;0;0;0;0;0
FR;12;2021-05-15;0;0;0;0;0;0;0;0;0;0;0;0;0;0;0;0;0;0
FR;12;2021-05-16;0;0;0;0;0;0;0;0;0;0;0;0;0;0;0;0;0;0
FR;12;2021-05-17;0;0;0;0;0;0;0;0;0;0;0;0;0;0;0;0;0;0
FR;12;2021-05-18;0;0;0;0;0;0;0;0;0;0;0;0;0;0;0;0;0;0
FR;12;2021-05-19;0;0;0;0;0;0;0;0;0;0;0;0;0;0;0;0;0;0
FR;12;2021-05-20;0;0;0;0;0;0;0;0;0;0;0;0;0;0;0;0;0;0
FR;12;2021-05-21;0;0;0;0;0;0;0;0;0;0;0;0;0;0;0;0;0;0
FR;12;2021-05-22;0;0;0;0;0;0;0;0;0;0;0;0;0;0;0;0;0;0
FR;12;2021-05-23;0;0;0;0;0;0;0;0;0;0;0;0;0;0;0;0;0;0
FR;12;2021-05-24;0;0;0;0;0;0;0;0;0;0;0;0;0;0;0;0;0;0
FR;12;2021-05-25;0;0;0;0;0;0;0;0;0;0;0;0;0;0;0;0;0;0
FR;12;2021-05-26;0;0;0;0;0;0;0;0;0;0;0;0;0;0;0;0;0;0
FR;12;2021-05-27;0;0;0;0;0;0;0;0;0;0;0;0;0;0;0;0;0;0
FR;12;2021-05-28;0;0;0;0;0;0;0;0;0;0;0;0;0;0;0;0;0;0
FR;12;2021-05-29;0;0;0;0;0;0;0;0;0;0;0;0;0;0;0;0;0;0
FR;12;2021-05-30;0;0;0;0;0;0;0;0;0;0;0;0;0;0;0;0;0;0
FR;12;2021-05-31;0;0;0;0;0;0;0;0;0;0;0;0;0;0;0;0;0;0
FR;12;2021-06-01;0;0;0;0;0;0;0;0;0;0;0;0;0;0;0;0;0;0
FR;12;2021-06-02;0;0;0;0;0;0;0;0;0;0;0;0;0;0;0;0;0;0
FR;12;2021-06-03;0;0;0;0;0;0;0;0;0;0;0;0;0;0;0;0;0;0
FR;12;2021-06-04;0;0;0;0;0;0;0;0;0;0;0;0;0;0;0;0;0;0
FR;12;2021-06-05;0;0;0;0;0;0;0;0;0;0;0;0;0;0;0;0;0;0
FR;12;2021-06-06;0;0;0;0;0;0;0;0;0;0;0;0;0;0;0;0;0;0
FR;12;2021-06-07;0;0;0;0;0;0;0;0;0;0;0;0;0;0;0;0;0;0
FR;12;2021-06-08;0;0;0;0;0;0;0;0;0;0;0;0;0;0;0;0;0;0
FR;12;2021-06-09;0;0;0;0;0;0;0;0;0;0;0;0;0;0;0;0;0;0
FR;12;2021-06-10;0;0;0;0;0;0;0;0;0;0;0;0;0;0;0;0;0;0
FR;12;2021-06-11;0;0;0;0;0;0;0;0;0;0;0;0;0;0;0;0;0;0
FR;12;2021-06-12;0;0;0;0;0;0;0;0;0;0;0;0;0;0;0;0;0;0
FR;12;2021-06-13;0;0;0;0;0;0;0;0;0;0;0;0;0;0;0;0;0;0
FR;12;2021-06-14;0;0;0;0;0;0;0;0;0;0;0;0;0;0;0;0;0;0
FR;12;2021-06-15;0;0;0;0;0;0;0;0;0;0;0;0;0;0;0;0;0;0
FR;12;2021-06-16;0;0;0;0;0;0;0;0;0;0;0;0;0;0;0;0;0;0
FR;12;2021-06-17;0;0;0;0;0;0;0;0;0;0;0;0;0;0;0;0;0;0
FR;12;2021-06-18;0;0;0;0;0;0;0;0;0;0;0;0;0;0;0;0;0;0
FR;12;2021-06-19;0;0;0;0;0;0;0;0;0;0;0;0;0;0;0;0;0;0
FR;12;2021-06-20;0;0;0;0;0;0;0;0;0;0;0;0;0;0;0;0;0;0
FR;12;2021-06-21;0;0;0;0;0;0;0;0;0;0;0;0;0;0;0;0;0;0
FR;12;2021-06-22;0;0;0;0;0;0;0;0;0;0;0;0;0;0;0;0;0;0
FR;12;2021-06-23;0;0;0;0;0;0;0;0;0;0;0;0;0;0;0;0;0;0
FR;12;2021-06-24;0;0;0;0;0;0;0;0;0;0;0;0;0;0;0;0;0;0
FR;12;2021-06-25;0;0;0;0;0;0;0;0;0;0;0;0;0;0;0;0;0;0
FR;12;2021-06-26;0;0;0;0;0;0;0;0;0;0;0;0;0;0;0;0;0;0
FR;12;2021-06-27;0;0;0;0;0;0;0;0;0;0;0;0;0;0;0;0;0;0
FR;12;2021-06-28;0;0;0;0;0;0;0;0;0;0;0;0;0;0;0;0;0;0
FR;12;2021-06-29;0;0;0;0;0;0;0;0;0;0;0;0;0;0;0;0;0;0
FR;12;2021-06-30;0;0;0;0;0;0;0;0;0;0;0;0;0;0;0;0;0;0
FR;12;2021-07-01;0;0;0;0;0;0;0;0;0;0;0;0;0;0;0;0;0;0
FR;12;2021-07-02;0;0;0;0;0;0;0;0;0;0;0;0;0;0;0;0;0;0
FR;12;2021-07-03;0;0;0;0;0;0;0;0;0;0;0;0;0;0;0;0;0;0
FR;12;2021-07-04;0;0;0;0;0;0;0;0;0;0;0;0;0;0;0;0;0;0
FR;12;2021-07-05;0;0;0;0;0;0;0;0;0;0;0;0;0;0;0;0;0;0
FR;12;2021-07-06;0;0;0;0;0;0;0;0;0;0;0;0;0;0;0;0;0;0
FR;12;2021-07-07;0;0;0;0;0;0;0;0;0;0;0;0;0;0;0;0;0;0
FR;12;2021-07-08;0;0;0;0;0;0;0;0;0;0;0;0;0;0;0;0;0;0
FR;12;2021-07-09;0;0;0;0;0;0;0;0;0;0;0;0;0;0;0;0;0;0
FR;12;2021-07-10;0;0;0;0;0;0;0;0;0;0;0;0;0;0;0;0;0;0
FR;12;2021-07-11;0;0;0;0;0;0;0;0;0;0;0;0;0;0;0;0;0;0
FR;12;2021-07-12;0;0;0;0;0;0;0;0;0;0;0;0;0;0;0;0;0;0
FR;12;2021-07-13;0;0;0;0;0;0;0;0;0;0;0;0;0;0;0;0;0;0
FR;12;2021-07-14;0;0;0;0;0;0;0;0;0;0;0;0;0;0;0;0;0;0
FR;12;2021-07-15;0;0;0;0;0;0;0;0;0;0;0;0;0;0;0;0;0;0
FR;12;2021-07-16;0;0;0;0;0;0;0;0;0;0;0;0;0;0;0;0;0;0
FR;12;2021-07-17;0;0;0;0;0;0;0;0;0;0;0;0;0;0;0;0;0;0
FR;12;2021-07-18;0;0;0;0;0;0;0;0;0;0;0;0;0;0;0;0;0;0
FR;12;2021-07-19;0;0;0;0;0;0;0;0;0;0;0;0;0;0;0;0;0;0
FR;12;2021-07-20;0;0;0;0;0;0;0;0;0;0;0;0;0;0;0;0;0;0
FR;12;2021-07-21;0;0;0;0;0;0;0;0;0;0;0;0;0;0;0;0;0;0
FR;12;2021-07-22;0;0;0;0;0;0;0;0;0;0;0;0;0;0;0;0;0;0
FR;12;2021-07-23;0;0;0;0;0;0;0;0;0;0;0;0;0;0;0;0;0;0
FR;12;2021-07-24;0;0;0;0;0;0;0;0;0;0;0;0;0;0;0;0;0;0
FR;12;2021-07-25;0;0;0;0;0;0;0;0;0;0;0;0;0;0;0;0;0;0
FR;12;2021-07-26;0;0;0;0;0;0;0;0;0;0;0;0;0;0;0;0;0;0
FR;12;2021-07-27;0;0;0;0;0;0;0;0;0;0;0;0;0;0;0;0;0;0
FR;12;2021-07-28;0;0;0;0;0;0;0;0;0;0;0;0;0;0;0;0;0;0
FR;12;2021-07-29;0;0;0;0;0;0;0;0;0;0;0;0;0;0;0;0;0;0
FR;12;2021-07-30;0;0;0;0;0;0;0;0;0;0;0;0;0;0;0;0;0;0
FR;12;2021-07-31;0;0;0;0;0;0;0;0;0;0;0;0;0;0;0;0;0;0
FR;12;2021-08-01;0;0;0;0;0;0;0;0;0;0;0;0;0;0;0;0;0;0
FR;12;2021-08-02;0;0;0;0;0;0;0;0;0;0;0;0;0;0;0;0;0;0
FR;12;2021-08-03;0;0;0;0;0;0;0;0;0;0;0;0;0;0;0;0;0;0
FR;12;2021-08-04;0;0;0;0;0;0;0;0;0;0;0;0;0;0;0;0;0;0
FR;12;2021-08-05;0;0;0;0;0;0;0;0;0;0;0;0;0;0;0;0;0;0
FR;12;2021-08-06;0;0;0;0;0;0;0;0;0;0;0;0;0;0;0;0;0;0
FR;12;2021-08-07;0;0;0;0;0;0;0;0;0;0;0;0;0;0;0;0;0;0
FR;12;2021-08-08;0;0;0;0;0;0;0;0;0;0;0;0;0;0;0;0;0;0
FR;12;2021-08-09;0;0;0;0;0;0;0;0;0;0;0;0;0;0;0;0;0;0
FR;12;2021-08-10;0;0;0;0;0;0;0;0;0;0;0;0;0;0;0;0;0;0
FR;12;2021-08-11;0;0;0;0;0;0;0;0;0;0;0;0;0;0;0;0;0;0
FR;12;2021-08-12;0;0;0;0;0;0;0;0;0;0;0;0;0;0;0;0;0;0
FR;12;2021-08-13;0;0;0;0;0;0;0;0;0;0;0;0;0;0;0;0;0;0
FR;12;2021-08-14;0;0;0;0;0;0;0;0;0;0;0;0;0;0;0;0;0;0
FR;12;2021-08-15;0;0;0;0;0;0;0;0;0;0;0;0;0;0;0;0;0;0
FR;12;2021-08-16;0;0;0;0;0;0;0;0;0;0;0;0;0;0;0;0;0;0
FR;12;2021-08-17;0;0;0;0;0;0;0;0;0;0;0;0;0;0;0;0;0;0
FR;12;2021-08-18;0;0;0;0;0;0;0;0;0;0;0;0;0;0;0;0;0;0
FR;12;2021-08-19;0;0;0;0;0;0;0;0;0;0;0;0;0;0;0;0;0;0
FR;12;2021-08-20;0;0;0;0;0;0;0;0;0;0;0;0;0;0;0;0;0;0
FR;12;2021-08-21;0;0;0;0;0;0;0;0;0;0;0;0;0;0;0;0;0;0
FR;12;2021-08-22;0;0;0;0;0;0;0;0;0;0;0;0;0;0;0;0;0;0
FR;12;2021-08-23;0;0;0;0;0;0;0;0;0;0;0;0;0;0;0;0;0;0
FR;12;2021-08-24;0;0;0;0;0;0;0;0;0;0;0;0;0;0;0;0;0;0
FR;12;2021-08-25;0;0;0;0;0;0;0;0;0;0;0;0;0;0;0;0;0;0
FR;12;2021-08-26;0;0;0;0;0;0;0;0;0;0;0;0;0;0;0;0;0;0
FR;12;2021-08-27;0;0;0;0;0;0;0;0;0;0;0;0;0;0;0;0;0;0
FR;12;2021-08-28;0;0;0;0;0;0;0;0;0;0;0;0;0;0;0;0;0;0
FR;12;2021-08-29;0;0;0;0;0;0;0;0;0;0;0;0;0;0;0;0;0;0
FR;12;2021-08-30;0;0;0;0;0;0;0;0;0;0;0;0;0;0;0;0;0;0
FR;12;2021-08-31;0;0;0;0;0;0;0;0;0;0;0;0;0;0;0;0;0;0
FR;12;2021-09-01;0;0;0;0;0;0;0;0;0;0;0;0;0;0;0;0;0;0
FR;12;2021-09-02;0;0;0;0;0;0;0;0;0;0;0;0;0;0;0;0;0;0
FR;12;2021-09-03;0;0;0;0;0;0;0;0;0;0;0;0;0;0;0;0;0;0
FR;12;2021-09-04;0;0;0;0;0;0;0;0;0;0;0;0;0;0;0;0;0;0
FR;12;2021-09-05;0;0;0;0;0;0;0;0;0;0;0;0;0;0;0;0;0;0
FR;12;2021-09-06;0;0;0;0;0;0;0;0;0;0;0;0;0;0;0;0;0;0
FR;12;2021-09-07;0;0;0;0;0;0;0;0;0;0;0;0;0;0;0;0;0;0
FR;12;2021-09-08;0;0;0;0;0;0;0;0;0;0;0;0;0;0;0;0;0;0
FR;12;2021-09-09;0;0;0;0;0;0;0;0;0;0;0;0;0;0;0;0;0;0
FR;12;2021-09-10;0;0;0;0;0;0;0;0;0;0;0;0;0;0;0;0;0;0
FR;12;2021-09-11;0;0;0;0;0;0;0;0;0;0;0;0;0;0;0;0;0;0
FR;12;2021-09-12;0;0;0;0;0;0;0;0;0;0;0;0;0;0;0;0;0;0
FR;12;2021-09-13;0;0;0;0;0;0;0;0;0;0;0;0;0;0;0;0;0;0
FR;12;2021-09-14;0;0;0;0;0;0;0;0;0;0;0;0;0;0;0;0;0;0
FR;12;2021-09-15;0;0;0;0;0;0;0;0;0;0;0;0;0;0;0;0;0;0
FR;12;2021-09-16;0;0;0;0;0;0;0;0;0;0;0;0;0;0;0;0;0;0
FR;12;2021-09-17;0;0;0;0;0;0;0;0;0;0;0;0;0;0;0;0;0;0
FR;12;2021-09-18;0;0;0;0;0;0;0;0;0;0;0;0;0;0;0;0;0;0
FR;12;2021-09-19;0;0;0;0;0;0;0;0;0;0;0;0;0;0;0;0;0;0
FR;12;2021-09-20;0;0;0;0;0;0;0;0;0;0;0;0;0;0;0;0;0;0
FR;12;2021-09-21;0;0;0;0;0;0;0;0;0;0;0;0;0;0;0;0;0;0
FR;12;2021-09-22;0;0;0;0;0;0;0;0;0;0;0;0;0;0;0;0;0;0
FR;12;2021-09-23;0;0;0;0;0;0;0;0;0;0;0;0;0;0;0;0;0;0
FR;12;2021-09-24;0;0;0;0;0;0;0;0;0;0;0;0;0;0;0;0;0;0
FR;12;2021-09-25;0;0;0;0;0;0;0;0;0;0;0;0;0;0;0;0;0;0
FR;12;2021-09-26;0;0;0;0;0;0;0;0;0;0;0;0;0;0;0;0;0;0
FR;12;2021-09-27;0;0;0;0;0;0;0;0;0;0;0;0;0;0;0;0;0;0
FR;12;2021-09-28;0;0;0;0;0;0;0;0;0;0;0;0;0;0;0;0;0;0
FR;12;2021-09-29;0;0;0;0;0;0;0;0;0;0;0;0;0;0;0;0;0;0
FR;12;2021-09-30;0;0;0;0;0;0;0;0;0;0;0;0;0;0;0;0;0;0
FR;12;2021-10-01;0;0;0;0;0;0;0;0;0;0;0;0;0;0;0;0;0;0
FR;12;2021-10-02;0;0;0;0;0;0;0;0;0;0;0;0;0;0;0;0;0;0
FR;12;2021-10-03;0;0;0;0;0;0;0;0;0;0;0;0;0;0;0;0;0;0
FR;12;2021-10-04;0;0;0;0;0;0;0;0;0;0;0;0;0;0;0;0;0;0
FR;12;2021-10-05;0;0;0;0;0;0;0;0;0;0;0;0;0;0;0;0;0;0
FR;12;2021-10-06;0;0;0;0;0;0;0;0;0;0;0;0;0;0;0;0;0;0
FR;12;2021-10-07;0;0;0;0;0;0;0;0;0;0;0;0;0;0;0;0;0;0
FR;12;2021-10-08;0;0;0;0;0;0;0;0;0;0;0;0;0;0;0;0;0;0
FR;12;2021-10-09;0;0;0;0;0;0;0;0;0;0;0;0;0;0;0;0;0;0
FR;12;2021-10-10;0;0;0;0;0;0;0;0;0;0;0;0;0;0;0;0;0;0
FR;12;2021-10-11;0;0;0;0;0;0;0;0;0;0;0;0;0;0;0;0;0;0
FR;12;2021-10-12;0;0;0;0;0;0;0;0;0;0;0;0;0;0;0;0;0;0
FR;12;2021-10-13;0;0;0;0;0;0;0;0;0;0;0;0;0;0;0;0;0;0
FR;12;2021-10-14;0;0;0;0;0;0;0;0;0;0;0;0;0;0;0;0;0;0
FR;12;2021-10-15;0;0;0;0;0;0;0;0;0;0;0;0;0;0;0;0;0;0
FR;12;2021-10-16;0;0;0;0;0;0;0;0;0;0;0;0;0;0;0;0;0;0
FR;12;2021-10-17;0;0;0;0;0;0;0;0;0;0;0;0;0;0;0;0;0;0
FR;12;2021-10-18;0;0;0;0;0;0;0;0;0;0;0;0;0;0;0;0;0;0
FR;12;2021-10-19;0;0;0;0;0;0;0;0;0;0;0;0;0;0;0;0;0;0
FR;12;2021-10-20;0;0;0;0;0;0;0;0;0;0;0;0;0;0;0;0;0;0
FR;12;2021-10-21;0;0;0;0;0;0;0;0;0;0;0;0;0;0;0;0;0;0
FR;12;2021-10-22;0;0;0;0;0;0;0;0;0;0;0;0;0;0;0;0;0;0
FR;12;2021-10-23;0;0;0;0;0;0;0;0;0;0;0;0;0;0;0;0;0;0
FR;12;2021-10-24;0;0;0;0;0;0;0;0;0;0;0;0;0;0;0;0;0;0
FR;12;2021-10-25;0;0;0;0;0;0;0;0;0;0;0;0;0;0;0;0;0;0
FR;12;2021-10-26;0;0;0;0;0;0;0;0;0;0;0;0;0;0;0;0;0;0
FR;12;2021-10-27;0;0;0;0;0;0;0;0;0;0;0;0;0;0;0;0;0;0
FR;12;2021-10-28;0;0;0;0;0;0;0;0;0;0;0;0;0;0;0;0;0;0
FR;12;2021-10-29;0;0;0;0;0;0;0;0;0;0;0;0;0;0;0;0;0;0
FR;12;2021-10-30;0;0;0;0;0;0;0;0;0;0;0;0;0;0;0;0;0;0
FR;12;2021-10-31;0;0;0;0;0;0;0;0;0;0;0;0;0;0;0;0;0;0
FR;12;2021-11-01;0;0;0;0;0;0;0;0;0;0;0;0;0;0;0;0;0;0
FR;12;2021-11-02;0;0;0;0;0;0;0;0;0;0;0;0;0;0;0;0;0;0
FR;12;2021-11-03;0;0;0;0;0;0;0;0;0;0;0;0;0;0;0;0;0;0
FR;12;2021-11-04;0;0;0;0;0;0;0;0;0;0;0;0;0;0;0;0;0;0
FR;12;2021-11-05;0;0;0;0;0;0;0;0;0;0;0;0;0;0;0;0;0;0
FR;12;2021-11-06;0;0;0;0;0;0;0;0;0;0;0;0;0;0;0;0;0;0
FR;12;2021-11-07;0;0;0;0;0;0;0;0;0;0;0;0;0;0;0;0;0;0
FR;12;2021-11-08;0;0;0;0;0;0;0;0;0;0;0;0;0;0;0;0;0;0
FR;12;2021-11-09;0;0;0;0;0;0;0;0;0;0;0;0;0;0;0;0;0;0
FR;12;2021-11-10;0;0;0;0;0;0;0;0;0;0;0;0;0;0;0;0;0;0
FR;12;2021-11-11;0;0;0;0;0;0;0;0;0;0;0;0;0;0;0;0;0;0
FR;12;2021-11-12;0;0;0;0;0;0;0;0;0;0;0;0;0;0;0;0;0;0
FR;12;2021-11-13;0;0;0;0;0;0;0;0;0;0;0;0;0;0;0;0;0;0
FR;12;2021-11-14;0;0;0;0;0;0;0;0;0;0;0;0;0;0;0;0;0;0
FR;12;2021-11-15;0;0;0;0;0;0;0;0;0;0;0;0;0;0;0;0;0;0
FR;12;2021-11-16;0;0;0;0;0;0;0;0;0;0;0;0;0;0;0;0;0;0
FR;12;2021-11-17;0;0;0;0;0;0;0;0;0;0;0;0;0;0;0;0;0;0
FR;12;2021-11-18;0;0;0;0;0;0;0;0;0;0;0;0;0;0;0;0;0;0
FR;12;2021-11-19;0;0;0;0;0;0;0;0;0;0;0;0;0;0;0;0;0;0
FR;12;2021-11-20;0;0;0;0;0;0;0;0;0;0;0;0;0;0;0;0;0;0
FR;12;2021-11-21;0;0;0;0;0;0;0;0;0;0;0;0;0;0;0;0;0;0
FR;12;2021-11-22;0;0;0;0;0;0;0;0;0;0;0;0;0;0;0;0;0;0
FR;12;2021-11-23;0;0;0;0;0;0;0;0;0;0;0;0;0;0;0;0;0;0
FR;12;2021-11-24;0;0;0;0;0;0;0;0;0;0;0;0;0;0;0;0;0;0
FR;12;2021-11-25;0;0;0;0;0;0;0;0;0;0;0;0;0;0;0;0;0;0
FR;12;2021-11-26;0;0;0;0;0;0;0;0;0;0;0;0;0;0;0;0;0;0
FR;12;2021-11-27;0;0;0;0;0;0;0;0;0;0;0;0;0;0;0;0;0;0
FR;12;2021-11-28;0;0;0;0;0;0;0;0;0;0;0;0;0;0;0;0;0;0
FR;12;2021-11-29;0;0;0;0;0;0;0;0;0;0;0;0;0;0;0;0;0;0
FR;12;2021-11-30;0;0;0;0;0;0;0;0;0;0;0;0;0;0;0;0;0;0
FR;12;2021-12-01;0;0;0;0;0;0;0;0;0;0;0;0;0;0;0;0;0;0
FR;12;2021-12-02;0;0;0;0;0;0;0;0;0;0;0;0;0;0;0;0;0;0
FR;12;2021-12-03;0;0;0;0;0;0;0;0;0;0;0;0;0;0;0;0;0;0
FR;12;2021-12-04;0;0;0;0;0;0;0;0;0;0;0;0;0;0;0;0;0;0
FR;12;2021-12-05;0;0;0;0;0;0;0;0;0;0;0;0;0;0;0;0;0;0
FR;12;2021-12-06;0;0;0;0;0;0;0;0;0;0;0;0;0;0;0;0;0;0
FR;12;2021-12-07;0;0;0;0;0;0;0;0;0;0;0;0;0;0;0;0;0;0
FR;12;2021-12-08;0;0;0;0;0;0;0;0;0;0;0;0;0;0;0;0;0;0
FR;12;2021-12-09;0;0;0;0;0;0;0;0;0;0;0;0;0;0;0;0;0;0
FR;12;2021-12-10;0;0;0;0;0;0;0;0;0;0;0;0;0;0;0;0;0;0
FR;12;2021-12-11;0;0;0;0;0;0;0;0;0;0;0;0;0;0;0;0;0;0
FR;12;2021-12-12;0;0;0;0;0;0;0;0;0;0;0;0;0;0;0;0;0;0
FR;12;2021-12-13;0;0;0;0;0;0;0;0;0;0;0;0;0;0;0;0;0;0
FR;12;2021-12-14;0;0;0;0;0;0;0;0;0;0;0;0;0;0;0;0;0;0
FR;12;2021-12-15;0;0;0;0;0;0;0;0;0;0;0;0;0;0;0;0;0;0
FR;12;2021-12-16;0;0;0;0;0;0;0;0;0;0;0;0;0;0;0;0;0;0
FR;12;2021-12-17;0;0;0;0;0;0;0;0;0;0;0;0;0;0;0;0;0;0
FR;12;2021-12-18;0;0;0;0;0;0;0;0;0;0;0;0;0;0;0;0;0;0
FR;12;2021-12-19;0;0;0;0;0;0;0;0;0;0;0;0;0;0;0;0;0;0
FR;12;2021-12-20;0;0;0;0;0;0;0;0;0;0;0;0;0;0;0;0;0;0
FR;12;2021-12-21;0;0;0;0;0;0;0;0;0;0;0;0;0;0;0;0;0;0
FR;12;2021-12-22;0;0;0;0;0;0;0;0;0;0;0;0;0;0;0;0;0;0
FR;12;2021-12-23;0;0;0;0;0;0;0;0;0;0;0;0;0;0;0;0;0;0
FR;12;2021-12-24;0;0;0;0;0;0;0;0;0;0;0;0;0;0;0;0;0;0
FR;12;2021-12-25;0;0;0;0;0;0;0;0;0;0;0;0;0;0;0;0;0;0
FR;12;2021-12-26;0;0;0;0;0;0;0;0;0;0;0;0;0;0;0;0;0;0
FR;12;2021-12-27;0;0;0;0;0;0;0;0;0;0;0;0;0;0;0;0;0;0
FR;12;2021-12-28;0;0;0;0;0;0;0;0;0;0;0;0;0;0;0;0;0;0
FR;12;2021-12-29;0;0;0;0;0;0;0;0;0;0;0;0;0;0;0;0;0;0
FR;12;2021-12-30;0;0;0;0;0;0;0;0;0;0;0;0;0;0;0;0;0;0
FR;12;2021-12-31;0;0;0;0;0;0;0;0;0;0;0;0;0;0;0;0;0;0
FR;12;2022-01-01;0;0;0;0;0;0;0;0;0;0;0;0;0;0;0;0;0;0
FR;12;2022-01-02;0;0;0;0;0;0;0;0;0;0;0;0;0;0;0;0;0;0
FR;12;2022-01-03;0;0;0;0;0;0;0;0;0;0;0;0;0;0;0;0;0;0
FR;12;2022-01-04;0;0;0;0;0;0;0;0;0;0;0;0;0;0;0;0;0;0
FR;12;2022-01-05;0;0;0;0;0;0;0;0;0;0;0;0;0;0;0;0;0;0
FR;12;2022-01-06;0;0;0;0;0;0;0;0;0;0;0;0;0;0;0;0;0;0
FR;12;2022-01-07;0;0;0;0;0;0;0;0;0;0;0;0;0;0;0;0;0;0
FR;12;2022-01-08;0;0;0;0;0;0;0;0;0;0;0;0;0;0;0;0;0;0
FR;12;2022-01-09;0;0;0;0;0;0;0;0;0;0;0;0;0;0;0;0;0;0
FR;12;2022-01-10;0;0;0;0;0;0;0;0;0;0;0;0;0;0;0;0;0;0
FR;12;2022-01-11;0;0;0;0;0;0;0;0;0;0;0;0;0;0;0;0;0;0
FR;12;2022-01-12;0;0;0;0;0;0;0;0;0;0;0;0;0;0;0;0;0;0
FR;12;2022-01-13;0;0;0;0;0;0;0;0;0;0;0;0;0;0;0;0;0;0
FR;12;2022-01-14;0;0;0;0;0;0;0;0;0;0;0;0;0;0;0;0;0;0
FR;12;2022-01-15;0;0;0;0;0;0;0;0;0;0;0;0;0;0;0;0;0;0
FR;12;2022-01-16;0;0;0;0;0;0;0;0;0;0;0;0;0;0;0;0;0;0
FR;12;2022-01-17;0;0;0;0;0;0;0;0;0;0;0;0;0;0;0;0;0;0
FR;12;2022-01-18;0;0;0;0;0;0;0;0;0;0;0;0;0;0;0;0;0;0
FR;12;2022-01-19;0;0;0;0;0;0;0;0;0;0;0;0;0;0;0;0;0;0
FR;12;2022-01-20;0;0;0;0;0;0;0;0;0;0;0;0;0;0;0;0;0;0
FR;12;2022-01-21;0;0;0;0;0;0;0;0;0;0;0;0;0;0;0;0;0;0
FR;12;2022-01-22;0;0;0;0;0;0;0;0;0;0;0;0;0;0;0;0;0;0
FR;12;2022-01-23;0;0;0;0;0;0;0;0;0;0;0;0;0;0;0;0;0;0
FR;12;2022-01-24;0;0;0;0;0;0;0;0;0;0;0;0;0;0;0;0;0;0
FR;12;2022-01-25;0;0;0;0;0;0;0;0;0;0;0;0;0;0;0;0;0;0
FR;12;2022-01-26;0;0;0;0;0;0;0;0;0;0;0;0;0;0;0;0;0;0
FR;12;2022-01-27;0;0;0;0;0;0;0;0;0;0;0;0;0;0;0;0;0;0
FR;12;2022-01-28;0;0;0;0;0;0;0;0;0;0;0;0;0;0;0;0;0;0
FR;12;2022-01-29;0;0;0;0;0;0;0;0;0;0;0;0;0;0;0;0;0;0
FR;12;2022-01-30;0;0;0;0;0;0;0;0;0;0;0;0;0;0;0;0;0;0
FR;12;2022-01-31;0;0;0;0;0;0;0;0;0;0;0;0;0;0;0;0;0;0
FR;12;2022-02-01;0;0;0;0;0;0;0;0;0;0;0;0;0;0;0;0;0;0
FR;12;2022-02-02;0;0;0;0;0;0;0;0;0;0;0;0;0;0;0;0;0;0
FR;12;2022-02-03;0;0;0;0;0;0;0;0;0;0;0;0;0;0;0;0;0;0
FR;12;2022-02-04;0;0;0;0;0;0;0;0;0;0;0;0;0;0;0;0;0;0
FR;12;2022-02-05;0;0;0;0;0;0;0;0;0;0;0;0;0;0;0;0;0;0
FR;12;2022-02-06;0;0;0;0;0;0;0;0;0;0;0;0;0;0;0;0;0;0
FR;12;2022-02-07;0;0;0;0;0;0;0;0;0;0;0;0;0;0;0;0;0;0
FR;12;2022-02-08;0;0;0;0;0;0;0;0;0;0;0;0;0;0;0;0;0;0
FR;12;2022-02-09;0;0;0;0;0;0;0;0;0;0;0;0;0;0;0;0;0;0
FR;12;2022-02-10;0;0;0;0;0;0;0;0;0;0;0;0;0;0;0;0;0;0
FR;12;2022-02-11;0;0;0;0;0;0;0;0;0;0;0;0;0;0;0;0;0;0
FR;12;2022-02-12;0;0;0;0;0;0;0;0;0;0;0;0;0;0;0;0;0;0
FR;12;2022-02-13;0;0;0;0;0;0;0;0;0;0;0;0;0;0;0;0;0;0
FR;12;2022-02-14;0;0;0;0;0;0;0;0;0;0;0;0;0;0;0;0;0;0
FR;12;2022-02-15;0;0;0;0;0;0;0;0;0;0;0;0;0;0;0;0;0;0
FR;12;2022-02-16;0;0;0;0;0;0;0;0;0;0;0;0;0;0;0;0;0;0
FR;12;2022-02-17;0;0;0;0;0;0;0;0;0;0;0;0;0;0;0;0;0;0
FR;12;2022-02-18;0;0;0;0;0;0;0;0;0;0;0;0;0;0;0;0;0;0
FR;12;2022-02-19;0;0;0;0;0;0;0;0;0;0;0;0;0;0;0;0;0;0
FR;12;2022-02-20;0;0;0;0;0;0;0;0;0;0;0;0;0;0;0;0;0;0
FR;12;2022-02-21;0;0;0;0;0;0;0;0;0;0;0;0;0;0;0;0;0;0
FR;12;2022-02-22;0;0;0;0;0;0;0;0;0;0;0;0;0;0;0;0;0;0
FR;12;2022-02-23;0;0;0;0;0;0;0;0;0;0;0;0;0;0;0;0;0;0
FR;12;2022-02-24;0;0;0;0;0;0;0;0;0;0;0;0;0;0;0;0;0;0
FR;12;2022-02-25;0;0;0;0;0;0;0;0;0;0;0;0;0;0;0;0;0;0
FR;12;2022-02-26;0;0;0;0;0;0;0;0;0;0;0;0;0;0;0;0;0;0
FR;12;2022-02-27;0;0;0;0;0;0;0;0;0;0;0;0;0;0;0;0;0;0
FR;12;2022-02-28;0;0;0;0;0;0;0;0;0;0;0;0;0;0;0;0;0;0
FR;12;2022-03-01;0;0;0;0;0;0;0;0;0;0;0;0;0;0;0;0;0;0
FR;12;2022-03-02;0;0;0;0;0;0;0;0;0;0;0;0;0;0;0;0;0;0
FR;12;2022-03-03;0;0;0;0;0;0;0;0;0;0;0;0;0;0;0;0;0;0
FR;12;2022-03-04;0;0;0;0;0;0;0;0;0;0;0;0;0;0;0;0;0;0
FR;12;2022-03-05;0;0;0;0;0;0;0;0;0;0;0;0;0;0;0;0;0;0
FR;12;2022-03-06;0;0;0;0;0;0;0;0;0;0;0;0;0;0;0;0;0;0
FR;12;2022-03-07;0;0;0;0;0;0;0;0;0;0;0;0;0;0;0;0;0;0
FR;12;2022-03-08;0;0;0;0;0;0;0;0;0;0;0;0;0;0;0;0;0;0
FR;12;2022-03-09;0;0;0;0;0;0;0;0;0;0;0;0;0;0;0;0;0;0
FR;12;2022-03-10;0;0;0;0;0;0;0;0;0;0;0;0;0;0;0;0;0;0
FR;12;2022-03-11;0;0;0;0;0;0;0;0;0;0;0;0;0;0;0;0;0;0
FR;12;2022-03-12;0;0;0;0;0;0;0;0;0;0;0;0;0;0;0;0;0;0
FR;12;2022-03-13;0;0;0;0;0;0;0;0;0;0;0;0;0;0;0;0;0;0
FR;12;2022-03-14;0;0;0;0;0;0;0;0;0;0;0;0;0;0;0;0;0;0
FR;12;2022-03-15;0;0;0;0;0;0;0;0;0;0;0;0;0;0;0;0;0;0
FR;12;2022-03-16;0;0;0;0;0;0;0;0;0;0;0;0;0;0;0;0;0;0
FR;12;2022-03-17;0;0;0;0;0;0;0;0;0;0;0;0;0;0;0;0;0;0
FR;12;2022-03-18;0;0;0;0;0;0;0;0;0;0;0;0;0;0;0;0;0;0
FR;12;2022-03-19;0;0;0;0;0;0;0;0;0;0;0;0;0;0;0;0;0;0
FR;12;2022-03-20;0;0;0;0;0;0;0;0;0;0;0;0;0;0;0;0;0;0
FR;12;2022-03-21;0;0;0;0;0;0;0;0;0;0;0;0;0;0;0;0;0;0
FR;12;2022-03-22;0;0;0;0;0;0;0;0;0;0;0;0;0;0;0;0;0;0
FR;12;2022-03-23;0;0;0;0;0;0;0;0;0;0;0;0;0;0;0;0;0;0
FR;12;2022-03-24;0;0;0;0;0;0;0;0;0;0;0;0;0;0;0;0;0;0
FR;12;2022-03-25;0;0;0;0;0;0;0;0;0;0;0;0;0;0;0;0;0;0
FR;12;2022-03-26;0;0;0;0;0;0;0;0;0;0;0;0;0;0;0;0;0;0
FR;12;2022-03-27;0;0;0;0;0;0;0;0;0;0;0;0;0;0;0;0;0;0
FR;12;2022-03-28;0;0;0;0;0;0;0;0;0;0;0;0;0;0;0;0;0;0
FR;12;2022-03-29;0;0;0;0;0;0;0;0;0;0;0;0;0;0;0;0;0;0
FR;12;2022-03-30;0;0;0;0;0;0;0;0;0;0;0;0;0;0;0;0;0;0
FR;12;2022-03-31;0;0;0;0;0;0;0;0;0;0;0;0;0;0;0;0;0;0
FR;12;2022-04-01;0;0;0;0;0;0;0;0;0;0;0;0;0;0;0;0;0;0
FR;12;2022-04-02;0;0;0;0;0;0;0;0;0;0;0;0;0;0;0;0;0;0
FR;12;2022-04-03;0;0;0;0;0;0;0;0;0;0;0;0;0;0;0;0;0;0
FR;12;2022-04-04;0;0;0;0;0;0;0;0;0;0;0;0;0;0;0;0;0;0
FR;12;2022-04-05;0;0;0;0;0;0;0;0;0;0;0;0;0;0;0;0;0;0
FR;12;2022-04-06;0;0;0;0;0;0;0;0;0;0;0;0;0;0;0;0;0;0
FR;12;2022-04-07;0;0;0;0;0;0;0;0;0;0;0;0;0;0;0;0;0;0
FR;12;2022-04-08;0;0;0;0;0;0;0;0;0;0;0;0;0;0;0;0;0;0
FR;12;2022-04-09;0;0;0;0;0;0;0;0;0;0;0;0;0;0;0;0;0;0
FR;12;2022-04-10;0;0;0;0;0;0;0;0;0;0;0;0;0;0;0;0;0;0
FR;12;2022-04-11;0;0;0;0;0;0;0;0;0;0;0;0;0;0;0;0;0;0
FR;12;2022-04-12;0;0;0;0;0;0;0;0;0;0;0;0;0;0;0;0;0;0
FR;12;2022-04-13;0;0;0;0;0;0;0;0;0;0;0;0;0;0;0;0;0;0
FR;12;2022-04-14;0;0;0;0;0;0;0;0;0;0;0;0;0;0;0;0;0;0
FR;12;2022-04-15;0;0;0;0;0;0;0;0;0;0;0;0;0;0;0;0;0;0
FR;12;2022-04-16;0;0;0;0;0;0;0;0;0;0;0;0;0;0;0;0;0;0
FR;12;2022-04-17;0;0;0;0;0;0;0;0;0;0;0;0;0;0;0;0;0;0
FR;12;2022-04-18;0;0;0;0;0;0;0;0;0;0;0;0;0;0;0;0;0;0
FR;12;2022-04-19;0;0;0;0;0;0;0;0;0;0;0;0;0;0;0;0;0;0
FR;12;2022-04-20;0;0;0;0;0;0;0;0;0;0;0;0;0;0;0;0;0;0
FR;12;2022-04-21;0;0;0;0;0;0;0;0;0;0;0;0;0;0;0;0;0;0
FR;12;2022-04-22;0;0;0;0;0;0;0;0;0;0;0;0;0;0;0;0;0;0
FR;12;2022-04-23;0;0;0;0;0;0;0;0;0;0;0;0;0;0;0;0;0;0
FR;12;2022-04-24;0;0;0;0;0;0;0;0;0;0;0;0;0;0;0;0;0;0
FR;12;2022-04-25;0;0;0;0;0;0;0;0;0;0;0;0;0;0;0;0;0;0
FR;12;2022-04-26;0;0;0;0;0;0;0;0;0;0;0;0;0;0;0;0;0;0
FR;12;2022-04-27;0;0;0;0;0;0;0;0;0;0;0;0;0;0;0;0;0;0
FR;12;2022-04-28;0;0;0;0;0;0;0;0;0;0;0;0;0;0;0;0;0;0
FR;12;2022-04-29;0;0;0;0;0;0;0;0;0;0;0;0;0;0;0;0;0;0
FR;12;2022-04-30;0;0;0;0;0;0;0;0;0;0;0;0;0;0;0;0;0;0
FR;12;2022-05-01;0;0;0;0;0;0;0;0;0;0;0;0;0;0;0;0;0;0
FR;12;2022-05-02;0;0;0;0;0;0;0;0;0;0;0;0;0;0;0;0;0;0
FR;12;2022-05-03;0;0;0;0;0;0;0;0;0;0;0;0;0;0;0;0;0;0
FR;12;2022-05-04;0;0;0;0;0;0;0;0;0;0;0;0;0;0;0;0;0;0
FR;12;2022-05-05;0;0;0;0;0;0;0;0;0;0;0;0;0;0;0;0;0;0
FR;12;2022-05-06;0;0;0;0;0;0;0;0;0;0;0;0;0;0;0;0;0;0
FR;12;2022-05-07;0;0;0;0;0;0;0;0;0;0;0;0;0;0;0;0;0;0
FR;12;2022-05-08;0;0;0;0;0;0;0;0;0;0;0;0;0;0;0;0;0;0
FR;12;2022-05-09;0;0;0;0;0;0;0;0;0;0;0;0;0;0;0;0;0;0
FR;12;2022-05-10;0;0;0;0;0;0;0;0;0;0;0;0;0;0;0;0;0;0
FR;12;2022-05-11;0;0;0;0;0;0;0;0;0;0;0;0;0;0;0;0;0;0
FR;12;2022-05-12;0;0;0;0;0;0;0;0;0;0;0;0;0;0;0;0;0;0
FR;12;2022-05-13;0;0;0;0;0;0;0;0;0;0;0;0;0;0;0;0;0;0
FR;12;2022-05-14;0;0;0;0;0;0;0;0;0;0;0;0;0;0;0;0;0;0
FR;12;2022-05-15;0;0;0;0;0;0;0;0;0;0;0;0;0;0;0;0;0;0
FR;12;2022-05-16;0;0;0;0;0;0;0;0;0;0;0;0;0;0;0;0;0;0
FR;12;2022-05-17;0;0;0;0;0;0;0;0;0;0;0;0;0;0;0;0;0;0
FR;12;2022-05-18;0;0;0;0;0;0;0;0;0;0;0;0;0;0;0;0;0;0
FR;12;2022-05-19;0;0;0;0;0;0;0;0;0;0;0;0;0;0;0;0;0;0
FR;12;2022-05-20;0;0;0;0;0;0;0;0;0;0;0;0;0;0;0;0;0;0
FR;12;2022-05-21;0;0;0;0;0;0;0;0;0;0;0;0;0;0;0;0;0;0
FR;12;2022-05-22;0;0;0;0;0;0;0;0;0;0;0;0;0;0;0;0;0;0
FR;12;2022-05-23;0;0;0;0;0;0;0;0;0;0;0;0;0;0;0;0;0;0
FR;12;2022-05-24;0;0;0;0;0;0;0;0;0;0;0;0;0;0;0;0;0;0
FR;12;2022-05-25;0;0;0;0;0;0;0;0;0;0;0;0;0;0;0;0;0;0
FR;12;2022-05-26;0;0;0;0;0;0;0;0;0;0;0;0;0;0;0;0;0;0
FR;12;2022-05-27;0;0;0;0;0;0;0;0;0;0;0;0;0;0;0;0;0;0
FR;12;2022-05-28;0;0;0;0;0;0;0;0;0;0;0;0;0;0;0;0;0;0
FR;12;2022-05-29;0;0;0;0;0;0;0;0;0;0;0;0;0;0;0;0;0;0
FR;12;2022-05-30;0;0;0;0;0;0;0;0;0;0;0;0;0;0;0;0;0;0
FR;12;2022-05-31;0;0;0;0;0;0;0;0;0;0;0;0;0;0;0;0;0;0
FR;12;2022-06-01;0;0;0;0;0;0;0;0;0;0;0;0;0;0;0;0;0;0
FR;12;2022-06-02;0;0;0;0;0;0;0;0;0;0;0;0;0;0;0;0;0;0
FR;12;2022-06-03;0;0;0;0;0;0;0;0;0;0;0;0;0;0;0;0;0;0
FR;12;2022-06-04;0;0;0;0;0;0;0;0;0;0;0;0;0;0;0;0;0;0
FR;12;2022-06-05;0;0;0;0;0;0;0;0;0;0;0;0;0;0;0;0;0;0
FR;12;2022-06-06;0;0;0;0;0;0;0;0;0;0;0;0;0;0;0;0;0;0
FR;12;2022-06-07;0;0;0;0;0;0;0;0;0;0;0;0;0;0;0;0;0;0
FR;12;2022-06-08;0;0;0;0;0;0;0;0;0;0;0;0;0;0;0;0;0;0
FR;12;2022-06-09;0;0;0;0;0;0;0;0;0;0;0;0;0;0;0;0;0;0
FR;12;2022-06-10;0;0;0;0;0;0;0;0;0;0;0;0;0;0;0;0;0;0
FR;12;2022-06-11;0;0;0;0;0;0;0;0;0;0;0;0;0;0;0;0;0;0
FR;12;2022-06-12;0;0;0;0;0;0;0;0;0;0;0;0;0;0;0;0;0;0
FR;12;2022-06-13;0;0;0;0;0;0;0;0;0;0;0;0;0;0;0;0;0;0
FR;12;2022-06-14;0;0;0;0;0;0;0;0;0;0;0;0;0;0;0;0;0;0
FR;12;2022-06-15;0;0;0;0;0;0;0;0;0;0;0;0;0;0;0;0;0;0
FR;12;2022-06-16;0;0;0;0;0;0;0;0;0;0;0;0;0;0;0;0;0;0
FR;12;2022-06-17;0;0;0;0;0;0;0;0;0;0;0;0;0;0;0;0;0;0
FR;12;2022-06-18;0;0;0;0;0;0;0;0;0;0;0;0;0;0;0;0;0;0
FR;12;2022-06-19;0;0;0;0;0;0;0;0;0;0;0;0;0;0;0;0;0;0
FR;12;2022-06-20;0;0;0;0;0;0;0;0;0;0;0;0;0;0;0;0;0;0
FR;12;2022-06-21;0;0;0;0;0;0;0;0;0;0;0;0;0;0;0;0;0;0
FR;12;2022-06-22;0;0;0;0;0;0;0;0;0;0;0;0;0;0;0;0;0;0
FR;12;2022-06-23;0;0;0;0;0;0;0;0;0;0;0;0;0;0;0;0;0;0
FR;12;2022-06-24;0;0;0;0;0;0;0;0;0;0;0;0;0;0;0;0;0;0
FR;12;2022-06-25;0;0;0;0;0;0;0;0;0;0;0;0;0;0;0;0;0;0
FR;12;2022-06-26;0;0;0;0;0;0;0;0;0;0;0;0;0;0;0;0;0;0
FR;12;2022-06-27;0;0;0;0;0;0;0;0;0;0;0;0;0;0;0;0;0;0
FR;12;2022-06-28;0;0;0;0;0;0;0;0;0;0;0;0;0;0;0;0;0;0
FR;12;2022-06-29;0;0;0;0;0;0;0;0;0;0;0;0;0;0;0;0;0;0
FR;12;2022-06-30;0;0;0;0;0;0;0;0;0;0;0;0;0;0;0;0;0;0
FR;12;2022-07-01;0;0;0;0;0;0;0;0;0;0;0;0;0;0;0;0;0;0
FR;12;2022-07-02;0;0;0;0;0;0;0;0;0;0;0;0;0;0;0;0;0;0
FR;12;2022-07-03;0;0;0;0;0;0;0;0;0;0;0;0;0;0;0;0;0;0
FR;12;2022-07-04;0;0;0;0;0;0;0;0;0;0;0;0;0;0;0;0;0;0
FR;12;2022-07-05;0;0;0;0;0;0;0;0;0;0;0;0;0;0;0;0;0;0
FR;12;2022-07-06;0;0;0;0;0;0;0;0;0;0;0;0;0;0;0;0;0;0
FR;12;2022-07-07;0;0;0;0;0;0;0;0;0;0;0;0;0;0;0;0;0;0
FR;12;2022-07-08;0;0;0;0;0;0;0;0;0;0;0;0;0;0;0;0;0;0
FR;12;2022-07-09;0;0;0;0;0;0;0;0;0;0;0;0;0;0;0;0;0;0
FR;12;2022-07-10;0;0;0;0;0;0;0;0;0;0;0;0;0;0;0;0;0;0
FR;12;2022-07-11;0;0;0;0;0;0;0;0;0;0;0;0;0;0;0;0;0;0
FR;12;2022-07-12;0;0;0;0;0;0;0;0;0;0;0;0;0;0;0;0;0;0
FR;12;2022-07-13;0;0;0;0;0;0;0;0;0;0;0;0;0;0;0;0;0;0
FR;12;2022-07-14;0;0;0;0;0;0;0;0;0;0;0;0;0;0;0;0;0;0
FR;12;2022-07-15;0;0;0;0;0;0;0;0;0;0;0;0;0;0;0;0;0;0
FR;12;2022-07-16;0;0;0;0;0;0;0;0;0;0;0;0;0;0;0;0;0;0
FR;12;2022-07-17;0;0;0;0;0;0;0;0;0;0;0;0;0;0;0;0;0;0
FR;12;2022-07-18;0;0;0;0;0;0;0;0;0;0;0;0;0;0;0;0;0;0
FR;12;2022-07-19;0;0;0;0;0;0;0;0;0;0;0;0;0;0;0;0;0;0
FR;12;2022-07-20;0;0;0;0;0;0;0;0;0;0;0;0;0;0;0;0;0;0
FR;12;2022-07-21;0;0;0;0;0;0;0;0;0;0;0;0;0;0;0;0;0;0
FR;12;2022-07-22;0;0;0;0;0;0;0;0;0;0;0;0;0;0;0;0;0;0
FR;12;2022-07-23;0;0;0;0;0;0;0;0;0;0;0;0;0;0;0;0;0;0
FR;12;2022-07-24;0;0;0;0;0;0;0;0;0;0;0;0;0;0;0;0;0;0
FR;12;2022-07-25;0;0;0;0;0;0;0;0;0;0;0;0;0;0;0;0;0;0
FR;12;2022-07-26;0;0;0;0;0;0;0;0;0;0;0;0;0;0;0;0;0;0
FR;12;2022-07-27;0;0;0;0;0;0;0;0;0;0;0;0;0;0;0;0;0;0
FR;12;2022-07-28;0;0;0;0;0;0;0;0;0;0;0;0;0;0;0;0;0;0
FR;12;2022-07-29;0;0;0;0;0;0;0;0;0;0;0;0;0;0;0;0;0;0
FR;12;2022-07-30;0;0;0;0;0;0;0;0;0;0;0;0;0;0;0;0;0;0
FR;12;2022-07-31;0;0;0;0;0;0;0;0;0;0;0;0;0;0;0;0;0;0
FR;12;2022-08-01;0;0;0;0;0;0;0;0;0;0;0;0;0;0;0;0;0;0
FR;12;2022-08-02;0;0;0;0;0;0;0;0;0;0;0;0;0;0;0;0;0;0
FR;12;2022-08-03;0;0;0;0;0;0;0;0;0;0;0;0;0;0;0;0;0;0
FR;12;2022-08-04;0;0;0;0;0;0;0;0;0;0;0;0;0;0;0;0;0;0
FR;12;2022-08-05;0;0;0;0;0;0;0;0;0;0;0;0;0;0;0;0;0;0
FR;12;2022-08-06;0;0;0;0;0;0;0;0;0;0;0;0;0;0;0;0;0;0
FR;12;2022-08-07;0;0;0;0;0;0;0;0;0;0;0;0;0;0;0;0;0;0
FR;12;2022-08-08;0;0;0;0;0;0;0;0;0;0;0;0;0;0;0;0;0;0
FR;12;2022-08-09;0;0;0;0;0;0;0;0;0;0;0;0;0;0;0;0;0;0
FR;12;2022-08-10;0;0;0;0;0;0;0;0;0;0;0;0;0;0;0;0;0;0
FR;12;2022-08-11;0;0;0;0;0;0;0;0;0;0;0;0;0;0;0;0;0;0
FR;12;2022-08-12;0;0;0;0;0;0;0;0;0;0;0;0;0;0;0;0;0;0
FR;12;2022-08-13;0;0;0;0;0;0;0;0;0;0;0;0;0;0;0;0;0;0
FR;12;2022-08-14;0;0;0;0;0;0;0;0;0;0;0;0;0;0;0;0;0;0
FR;12;2022-08-15;0;0;0;0;0;0;0;0;0;0;0;0;0;0;0;0;0;0
FR;12;2022-08-16;0;0;0;0;0;0;0;0;0;0;0;0;0;0;0;0;0;0
FR;12;2022-08-17;0;0;0;0;0;0;0;0;0;0;0;0;0;0;0;0;0;0
FR;12;2022-08-18;0;0;0;0;0;0;0;0;0;0;0;0;0;0;0;0;0;0
FR;12;2022-08-19;0;0;0;0;0;0;0;0;0;0;0;0;0;0;0;0;0;0
FR;12;2022-08-20;0;0;0;0;0;0;0;0;0;0;0;0;0;0;0;0;0;0
FR;12;2022-08-21;0;0;0;0;0;0;0;0;0;0;0;0;0;0;0;0;0;0
FR;12;2022-08-22;0;0;0;0;0;0;0;0;0;0;0;0;0;0;0;0;0;0
FR;12;2022-08-23;0;0;0;0;0;0;0;0;0;0;0;0;0;0;0;0;0;0
FR;12;2022-08-24;0;0;0;0;0;0;0;0;0;0;0;0;0;0;0;0;0;0
FR;12;2022-08-25;0;0;0;0;0;0;0;0;0;0;0;0;0;0;0;0;0;0
FR;12;2022-08-26;0;0;0;0;0;0;0;0;0;0;0;0;0;0;0;0;0;0
FR;12;2022-08-27;0;0;0;0;0;0;0;0;0;0;0;0;0;0;0;0;0;0
FR;12;2022-08-28;0;0;0;0;0;0;0;0;0;0;0;0;0;0;0;0;0;0
FR;12;2022-08-29;0;0;0;0;0;0;0;0;0;0;0;0;0;0;0;0;0;0
FR;12;2022-08-30;0;0;0;0;0;0;0;0;0;0;0;0;0;0;0;0;0;0
FR;12;2022-08-31;0;0;0;0;0;0;0;0;0;0;0;0;0;0;0;0;0;0
FR;12;2022-09-01;0;0;0;0;0;0;0;0;0;0;0;0;0;0;0;0;0;0
FR;12;2022-09-02;0;0;0;0;0;0;0;0;0;0;0;0;0;0;0;0;0;0
FR;12;2022-09-03;0;0;0;0;0;0;0;0;0;0;0;0;0;0;0;0;0;0
FR;12;2022-09-04;0;0;0;0;0;0;0;0;0;0;0;0;0;0;0;0;0;0
FR;12;2022-09-05;0;0;0;0;0;0;0;0;0;0;0;0;0;0;0;0;0;0
FR;12;2022-09-06;0;0;0;0;0;0;0;0;0;0;0;0;0;0;0;0;0;0
FR;12;2022-09-07;0;0;0;0;0;0;0;0;0;0;0;0;0;0;0;0;0;0
FR;12;2022-09-08;0;0;0;0;0;0;0;0;0;0;0;0;0;0;0;0;0;0
FR;12;2022-09-09;0;0;0;0;0;0;0;0;0;0;0;0;0;0;0;0;0;0
FR;12;2022-09-10;0;0;0;0;0;0;0;0;0;0;0;0;0;0;0;0;0;0
FR;12;2022-09-11;0;0;0;0;0;0;0;0;0;0;0;0;0;0;0;0;0;0
FR;12;2022-09-12;0;0;0;0;0;0;0;0;0;0;0;0;0;0;0;0;0;0
FR;12;2022-09-13;0;0;0;0;0;0;0;0;0;0;0;0;0;0;0;0;0;0
FR;12;2022-09-14;0;0;0;0;0;0;0;0;0;0;0;0;0;0;0;0;0;0
FR;12;2022-09-15;0;0;0;0;0;0;0;0;0;0;0;0;0;0;0;0;0;0
FR;12;2022-09-16;0;0;0;0;0;0;0;0;0;0;0;0;0;0;0;0;0;0
FR;12;2022-09-17;0;0;0;0;0;0;0;0;0;0;0;0;0;0;0;0;0;0
FR;12;2022-09-18;0;0;0;0;0;0;0;0;0;0;0;0;0;0;0;0;0;0
FR;12;2022-09-19;0;0;0;0;0;0;0;0;0;0;0;0;0;0;0;0;0;0
FR;12;2022-09-20;0;0;0;0;0;0;0;0;0;0;0;0;0;0;0;0;0;0
FR;12;2022-09-21;0;0;0;0;0;0;0;0;0;0;0;0;0;0;0;0;0;0
FR;12;2022-09-22;0;0;0;0;0;0;0;0;0;0;0;0;0;0;0;0;0;0
FR;12;2022-09-23;0;0;0;0;0;0;0;0;0;0;0;0;0;0;0;0;0;0
FR;12;2022-09-24;0;0;0;0;0;0;0;0;0;0;0;0;0;0;0;0;0;0
FR;12;2022-09-25;0;0;0;0;0;0;0;0;0;0;0;0;0;0;0;0;0;0
FR;12;2022-09-26;0;0;0;0;0;0;0;0;0;0;0;0;0;0;0;0;0;0
FR;12;2022-09-27;0;0;0;0;0;0;0;0;0;0;0;0;0;0;0;0;0;0
FR;12;2022-09-28;0;0;0;0;0;0;0;0;0;0;0;0;0;0;0;0;0;0
FR;12;2022-09-29;0;0;0;0;0;0;0;0;0;0;0;0;0;0;0;0;0;0
FR;12;2022-09-30;0;0;0;0;0;0;0;0;0;0;0;0;0;0;0;0;0;0
FR;12;2022-10-01;0;0;0;0;0;0;0;0;0;0;0;0;0;0;0;0;0;0
FR;12;2022-10-02;0;0;0;0;0;0;0;0;0;0;0;0;0;0;0;0;0;0
FR;12;2022-10-03;0;0;0;0;0;0;0;0;0;0;0;0;0;0;0;0;0;0
FR;12;2022-10-04;0;0;0;0;0;0;0;0;0;0;0;0;0;0;0;0;0;0
FR;12;2022-10-05;0;0;0;0;0;0;0;0;0;0;0;0;0;0;0;0;0;0
FR;12;2022-10-06;0;0;0;0;0;0;0;0;0;0;0;0;0;0;0;0;0;0
FR;12;2022-10-07;0;0;0;0;0;0;0;0;0;0;0;0;0;0;0;0;0;0
FR;12;2022-10-08;0;0;0;0;0;0;0;0;0;0;0;0;0;0;0;0;0;0
FR;12;2022-10-09;0;0;0;0;0;0;0;0;0;0;0;0;0;0;0;0;0;0
FR;12;2022-10-10;0;0;0;0;0;0;0;0;0;0;0;0;0;0;0;0;0;0
FR;12;2022-10-11;0;0;0;0;0;0;0;0;0;0;0;0;0;0;0;0;0;0
FR;12;2022-10-12;0;0;0;0;0;0;0;0;0;0;0;0;0;0;0;0;0;0
FR;12;2022-10-13;0;0;0;0;0;0;0;0;0;0;0;0;0;0;0;0;0;0
FR;12;2022-10-14;0;0;0;0;0;0;0;0;0;0;0;0;0;0;0;0;0;0
FR;12;2022-10-15;0;0;0;0;0;0;0;0;0;0;0;0;0;0;0;0;0;0
FR;12;2022-10-16;0;0;0;0;0;0;0;0;0;0;0;0;0;0;0;0;0;0
FR;12;2022-10-17;0;0;0;0;0;0;0;0;0;0;0;0;0;0;0;0;0;0
FR;12;2022-10-18;0;0;0;0;0;0;0;0;0;0;0;0;0;0;0;0;0;0
FR;12;2022-10-19;0;0;0;0;0;0;0;0;0;0;0;0;0;0;0;0;0;0
FR;12;2022-10-20;0;0;0;0;0;0;0;0;0;0;0;0;0;0;0;0;0;0
FR;12;2022-10-21;0;0;0;0;0;0;0;0;0;0;0;0;0;0;0;0;0;0
FR;12;2022-10-22;0;0;0;0;0;0;0;0;0;0;0;0;0;0;0;0;0;0
FR;12;2022-10-23;0;0;0;0;0;0;0;0;0;0;0;0;0;0;0;0;0;0
FR;12;2022-10-24;0;0;0;0;0;0;0;0;0;0;0;0;0;0;0;0;0;0
FR;12;2022-10-25;0;0;0;0;0;0;0;0;0;0;0;0;0;0;0;0;0;0
FR;12;2022-10-26;0;0;0;0;0;0;0;0;0;0;0;0;0;0;0;0;0;0
FR;12;2022-10-27;0;0;0;0;0;0;0;0;0;0;0;0;0;0;0;0;0;0
FR;12;2022-10-28;0;0;0;0;0;0;0;0;0;0;0;0;0;0;0;0;0;0
FR;12;2022-10-29;0;0;0;0;0;0;0;0;0;0;0;0;0;0;0;0;0;0
FR;12;2022-10-30;0;0;0;0;0;0;0;0;0;0;0;0;0;0;0;0;0;0
FR;12;2022-10-31;0;0;0;0;0;0;0;0;0;0;0;0;0;0;0;0;0;0
FR;12;2022-11-01;0;0;0;0;0;0;0;0;0;0;0;0;0;0;0;0;0;0
FR;12;2022-11-02;0;0;0;0;0;0;0;0;0;0;0;0;0;0;0;0;0;0
FR;12;2022-11-03;0;0;0;0;0;0;0;0;0;0;0;0;0;0;0;0;0;0
FR;12;2022-11-04;0;0;0;0;0;0;0;0;0;0;0;0;0;0;0;0;0;0
FR;12;2022-11-05;0;0;0;0;0;0;0;0;0;0;0;0;0;0;0;0;0;0
FR;12;2022-11-06;0;0;0;0;0;0;0;0;0;0;0;0;0;0;0;0;0;0
FR;12;2022-11-07;0;0;0;0;0;0;0;0;0;0;0;0;0;0;0;0;0;0
FR;12;2022-11-08;0;0;0;0;0;0;0;0;0;0;0;0;0;0;0;0;0;0
FR;12;2022-11-09;0;0;0;0;0;0;0;0;0;0;0;0;0;0;0;0;0;0
FR;12;2022-11-10;0;0;0;0;0;0;0;0;0;0;0;0;0;0;0;0;0;0
FR;12;2022-11-11;0;0;0;0;0;0;0;0;0;0;0;0;0;0;0;0;0;0
FR;12;2022-11-12;0;0;0;0;0;0;0;0;0;0;0;0;0;0;0;0;0;0
FR;12;2022-11-13;0;0;0;0;0;0;0;0;0;0;0;0;0;0;0;0;0;0
FR;12;2022-11-14;0;0;0;0;0;0;0;0;0;0;0;0;0;0;0;0;0;0
FR;12;2022-11-15;0;0;0;0;0;0;0;0;0;0;0;0;0;0;0;0;0;0
FR;12;2022-11-16;0;0;0;0;0;0;0;0;0;0;0;0;0;0;0;0;0;0
FR;12;2022-11-17;0;0;0;0;0;0;0;0;0;0;0;0;0;0;0;0;0;0
FR;12;2022-11-18;0;0;0;0;0;0;0;0;0;0;0;0;0;0;0;0;0;0
FR;12;2022-11-19;0;0;0;0;0;0;0;0;0;0;0;0;0;0;0;0;0;0
FR;12;2022-11-20;0;0;0;0;0;0;0;0;0;0;0;0;0;0;0;0;0;0
FR;12;2022-11-21;0;0;0;0;0;0;0;0;0;0;0;0;0;0;0;0;0;0
FR;12;2022-11-22;0;0;0;0;0;0;0;0;0;0;0;0;0;0;0;0;0;0
FR;12;2022-11-23;0;0;0;0;0;0;0;0;0;0;0;0;0;0;0;0;0;0
FR;12;2022-11-24;0;0;0;0;0;0;0;0;0;0;0;0;0;0;0;0;0;0
FR;12;2022-11-25;0;0;0;0;0;0;0;0;0;0;0;0;0;0;0;0;0;0
FR;12;2022-11-26;0;0;0;0;0;0;0;0;0;0;0;0;0;0;0;0;0;0
FR;12;2022-11-27;0;0;0;0;0;0;0;0;0;0;0;0;0;0;0;0;0;0
FR;12;2022-11-28;0;0;0;0;0;0;0;0;0;0;0;0;0;0;0;0;0;0
FR;12;2022-11-29;0;0;0;0;0;0;0;0;0;0;0;0;0;0;0;0;0;0
FR;12;2022-11-30;0;0;0;0;0;0;0;0;0;0;0;0;0;0;0;0;0;0
FR;12;2022-12-01;0;0;0;0;0;0;0;0;0;0;0;0;0;0;0;0;0;0
FR;12;2022-12-02;0;0;0;0;0;0;0;0;0;0;0;0;0;0;0;0;0;0
FR;12;2022-12-03;0;0;0;0;0;0;0;0;0;0;0;0;0;0;0;0;0;0
FR;12;2022-12-04;0;0;0;0;0;0;0;0;0;0;0;0;0;0;0;0;0;0
FR;12;2022-12-05;0;0;0;0;0;0;0;0;0;0;0;0;0;0;0;0;0;0
FR;12;2022-12-06;0;0;0;0;0;0;0;0;0;0;0;0;0;0;0;0;0;0
FR;12;2022-12-07;0;0;0;0;0;0;0;0;0;0;0;0;0;0;0;0;0;0
FR;12;2022-12-08;0;0;0;0;0;0;0;0;0;0;0;0;0;0;0;0;0;0
FR;12;2022-12-09;0;0;0;0;0;0;0;0;0;0;0;0;0;0;0;0;0;0
FR;12;2022-12-10;0;0;0;0;0;0;0;0;0;0;0;0;0;0;0;0;0;0
FR;12;2022-12-11;0;0;0;0;0;0;0;0;0;0;0;0;0;0;0;0;0;0
FR;12;2022-12-12;0;0;0;0;0;0;0;0;0;0;0;0;0;0;0;0;0;0
FR;12;2022-12-13;0;0;0;0;0;0;0;0;0;0;0;0;0;0;0;0;0;0
FR;12;2022-12-14;0;0;0;0;0;0;0;0;0;0;0;0;0;0;0;0;0;0
FR;12;2022-12-15;0;0;0;0;0;0;0;0;0;0;0;0;0;0;0;0;0;0
FR;12;2022-12-16;0;0;0;0;0;0;0;0;0;0;0;0;0;0;0;0;0;0
FR;12;2022-12-17;0;0;0;0;0;0;0;0;0;0;0;0;0;0;0;0;0;0
FR;12;2022-12-18;0;0;0;0;0;0;0;0;0;0;0;0;0;0;0;0;0;0
FR;12;2022-12-19;0;0;0;0;0;0;0;0;0;0;0;0;0;0;0;0;0;0
FR;12;2022-12-20;0;0;0;0;0;0;0;0;0;0;0;0;0;0;0;0;0;0
FR;12;2022-12-21;0;0;0;0;0;0;0;0;0;0;0;0;0;0;0;0;0;0
FR;12;2022-12-22;0;0;0;0;0;0;0;0;0;0;0;0;0;0;0;0;0;0
FR;12;2022-12-23;0;0;0;0;0;0;0;0;0;0;0;0;0;0;0;0;0;0
FR;12;2022-12-24;0;0;0;0;0;0;0;0;0;0;0;0;0;0;0;0;0;0
FR;12;2022-12-25;0;0;0;0;0;0;0;0;0;0;0;0;0;0;0;0;0;0
FR;12;2022-12-26;0;0;0;0;0;0;0;0;0;0;0;0;0;0;0;0;0;0
FR;12;2022-12-27;0;0;0;0;0;0;0;0;0;0;0;0;0;0;0;0;0;0
FR;12;2022-12-28;0;0;0;0;0;0;0;0;0;0;0;0;0;0;0;0;0;0
FR;12;2022-12-29;0;0;0;0;0;0;0;0;0;0;0;0;0;0;0;0;0;0
FR;12;2022-12-30;0;0;0;0;0;0;0;0;0;0;0;0;0;0;0;0;0;0
FR;12;2022-12-31;0;0;0;0;0;0;0;0;0;0;0;0;0;0;0;0;0;0
FR;12;2023-01-01;0;0;0;0;0;0;0;0;0;0;0;0;0;0;0;0;0;0
FR;12;2023-01-02;0;0;0;0;0;0;0;0;0;0;0;0;0;0;0;0;0;0
FR;12;2023-01-03;0;0;0;0;0;0;0;0;0;0;0;0;0;0;0;0;0;0
FR;12;2023-01-04;0;0;0;0;0;0;0;0;0;0;0;0;0;0;0;0;0;0
FR;12;2023-01-05;0;0;0;0;0;0;0;0;0;0;0;0;0;0;0;0;0;0
FR;12;2023-01-06;0;0;0;0;0;0;0;0;0;0;0;0;0;0;0;0;0;0
FR;12;2023-01-07;0;0;0;0;0;0;0;0;0;0;0;0;0;0;0;0;0;0
FR;12;2023-01-08;0;0;0;0;0;0;0;0;0;0;0;0;0;0;0;0;0;0
FR;12;2023-01-09;0;0;0;0;0;0;0;0;0;0;0;0;0;0;0;0;0;0
FR;12;2023-01-10;0;0;0;0;0;0;0;0;0;0;0;0;0;0;0;0;0;0
FR;12;2023-01-11;0;0;0;0;0;0;0;0;0;0;0;0;0;0;0;0;0;0
FR;12;2023-01-12;0;0;0;0;0;0;0;0;0;0;0;0;0;0;0;0;0;0
FR;12;2023-01-13;0;0;0;0;0;0;0;0;0;0;0;0;0;0;0;0;0;0
FR;12;2023-01-14;0;0;0;0;0;0;0;0;0;0;0;0;0;0;0;0;0;0
FR;12;2023-01-15;0;0;0;0;0;0;0;0;0;0;0;0;0;0;0;0;0;0
FR;12;2023-01-16;0;0;0;0;0;0;0;0;0;0;0;0;0;0;0;0;0;0
FR;12;2023-01-17;0;0;0;0;0;0;0;0;0;0;0;0;0;0;0;0;0;0
FR;12;2023-01-18;0;0;0;0;0;0;0;0;0;0;0;0;0;0;0;0;0;0
FR;12;2023-01-19;0;0;0;0;0;0;0;0;0;0;0;0;0;0;0;0;0;0
FR;12;2023-01-20;0;0;0;0;0;0;0;0;0;0;0;0;0;0;0;0;0;0
FR;12;2023-01-21;0;0;0;0;0;0;0;0;0;0;0;0;0;0;0;0;0;0
FR;12;2023-01-22;0;0;0;0;0;0;0;0;0;0;0;0;0;0;0;0;0;0
FR;12;2023-01-23;0;0;0;0;0;0;0;0;0;0;0;0;0;0;0;0;0;0
FR;12;2023-01-24;0;0;0;0;0;0;0;0;0;0;0;0;0;0;0;0;0;0
FR;12;2023-01-25;0;0;0;0;0;0;0;0;0;0;0;0;0;0;0;0;0;0
FR;12;2023-01-26;0;0;0;0;0;0;0;0;0;0;0;0;0;0;0;0;0;0
FR;12;2023-01-27;0;0;0;0;0;0;0;0;0;0;0;0;0;0;0;0;0;0
FR;12;2023-01-28;0;0;0;0;0;0;0;0;0;0;0;0;0;0;0;0;0;0
FR;12;2023-01-29;0;0;0;0;0;0;0;0;0;0;0;0;0;0;0;0;0;0
FR;12;2023-01-30;0;0;0;0;0;0;0;0;0;0;0;0;0;0;0;0;0;0
FR;12;2023-01-31;0;0;0;0;0;0;0;0;0;0;0;0;0;0;0;0;0;0
FR;12;2023-02-01;0;0;0;0;0;0;0;0;0;0;0;0;0;0;0;0;0;0
FR;12;2023-02-02;0;0;0;1;0;0;0;2;2;0;0;0;1;0;0;0;2;2
FR;12;2023-02-03;0;1;6;57;0;4;58;141;77;0;1;6;58;0;4;58;143;79
FR;12;2023-02-04;1;3;6;51;1;5;52;110;52;1;4;12;109;1;9;110;253;131
FR;12;2023-02-05;0;0;0;0;0;0;0;1;1;1;4;12;109;1;9;110;254;132
FR;12;2023-02-06;3;2;13;63;0;11;69;154;69;4;6;25;172;1;20;179;408;201
FR;12;2023-02-07;2;7;18;95;4;13;98;237;121;6;13;43;267;5;33;277;645;322
FR;12;2023-02-08;1;3;10;62;1;10;69;170;89;7;16;53;329;6;43;346;815;411
FR;12;2023-02-09;5;3;12;75;2;13;78;284;190;12;19;65;404;8;56;424;1099;601
FR;12;2023-02-10;4;2;22;140;4;12;150;327;162;16;21;87;544;12;68;574;1426;763
FR;12;2023-02-11;0;2;8;59;1;3;58;123;60;16;23;95;603;13;71;632;1549;823
FR;12;2023-02-12;0;0;0;3;0;0;3;7;3;16;23;95;606;13;71;635;1556;826
FR;12;2023-02-13;0;0;17;78;0;8;85;217;114;16;23;112;684;13;79;720;1773;940
FR;12;2023-02-14;3;5;17;96;5;14;99;229;108;19;28;129;780;18;93;819;2002;1048
FR;12;2023-02-15;3;5;19;85;0;13;86;236;132;22;33;148;865;18;106;905;2238;1180
FR;12;2023-02-16;5;3;16;107;3;13;103;247;129;27;36;164;972;21;119;1008;2485;1309
FR;12;2023-02-17;2;4;12;115;3;11;110;280;153;29;40;176;1087;24;130;1118;2765;1462
FR;12;2023-02-18;1;4;10;51;2;12;52;102;36;30;44;186;1138;26;142;1170;2867;1498
FR;12;2023-02-19;0;0;0;2;0;0;1;2;1;30;44;186;1140;26;142;1171;2869;1499
FR;12;2023-02-20;10;2;11;65;6;11;69;219;132;40;46;197;1205;32;153;1240;3088;1631
FR;12;2023-02-21;6;6;19;98;4;14;94;280;167;46;52;216;1303;36;167;1334;3368;1798
FR;12;2023-02-22;2;4;19;74;2;20;78;231;125;48;56;235;1377;38;187;1412;3599;1923
FR;12;2023-02-23;4;3;20;88;2;16;87;265;155;52;59;255;1465;40;203;1499;3864;2078
FR;12;2023-02-24;3;7;20;135;3;17;142;360;189;55;66;275;1600;43;220;1641;4224;2267
FR;12;2023-02-25;7;1;19;92;1;10;106;200;77;62;67;294;1692;44;230;1747;4424;2344
FR;12;2023-02-26;0;0;0;0;0;0;0;2;2;62;67;294;1692;44;230;1747;4426;2346
FR;12;2023-02-27;6;10;20;92;8;16;95;270;156;68;77;314;1784;52;246;1842;4696;2502
FR;12;2023-02-28;6;9;21;125;0;23;128;385;227;74;86;335;1909;52;269;1970;5081;2729
FR;12;2023-03-01;3;7;23;78;2;18;91;292;175;77;93;358;1987;54;287;2061;5373;2904
FR;12;2023-03-02;9;9;21;110;6;18;117;304;163;86;102;379;2097;60;305;2178;5677;3067
FR;12;2023-03-03;10;8;45;142;7;39;148;418;220;96;110;424;2239;67;344;2326;6095;3287
FR;12;2023-03-04;3;2;12;55;0;10;53;119;49;99;112;436;2294;67;354;2379;6214;3336
FR;12;2023-03-05;0;1;1;2;1;1;2;8;5;99;113;437;2296;68;355;2381;6222;3341
FR;12;2023-03-06;4;5;27;74;2;20;82;268;157;103;118;464;2370;70;375;2463;6490;3498
FR;12;2023-03-07;6;10;29;130;9;24;132;356;191;109;128;493;2500;79;399;2595;6846;3689
FR;12;2023-03-08;4;7;27;71;5;22;77;249;137;113;135;520;2571;84;421;2672;7095;3826
FR;12;2023-03-09;4;8;18;91;4;22;85;323;197;117;143;538;2662;88;443;2757;7418;4023
FR;12;2023-03-10;11;7;23;137;9;23;133;368;209;128;150;561;2799;97;466;2890;7786;4232
FR;12;2023-03-11;1;4;15;45;4;9;50;132;72;129;154;576;2844;101;475;2940;7918;4304
FR;12;2023-03-12;0;2;0;2;0;2;1;5;2;129;156;576;2846;101;477;2941;7923;4306
FR;12;2023-03-13;3;4;32;102;1;28;104;297;158;132;160;608;2948;102;505;3045;8220;4464
FR;12;2023-03-14;3;7;16;85;2;15;83;322;210;135;167;624;3033;104;520;3128;8542;4674
FR;12;2023-03-15;1;4;20;66;2;19;69;225;124;136;171;644;3099;106;539;3197;8767;4798
FR;12;2023-03-16;5;5;20;100;5;13;116;300;157;141;176;664;3199;111;552;3313;9067;4955
FR;12;2023-03-17;4;11;30;112;4;28;113;388;224;145;187;694;3311;115;580;3426;9455;5179
FR;12;2023-03-18;1;4;21;53;4;17;59;144;64;146;191;715;3364;119;597;3485;9599;5243
FR;12;2023-03-19;0;0;0;6;0;0;5;10;5;146;191;715;3370;119;597;3490;9609;5248
FR;12;2023-03-20;9;8;27;87;7;23;90;258;134;155;199;742;3457;126;620;3580;9867;5382
FR;12;2023-03-21;2;7;42;81;3;36;93;356;210;157;206;784;3538;129;656;3673;10223;5592
FR;12;2023-03-22;6;4;36;50;5;29;58;241;139;163;210;820;3588;134;685;3731;10464;5731
FR;12;2023-03-23;3;8;26;80;5;25;82;264;147;166;218;846;3668;139;710;3813;10728;5878
FR;12;2023-03-24;6;2;25;100;3;22;109;348;204;172;220;871;3768;142;732;3922;11076;6082
FR;12;2023-03-25;7;8;25;61;3;14;75;162;62;179;228;896;3829;145;746;3997;11238;6144
FR;12;2023-03-26;0;1;0;1;1;0;1;7;6;179;229;896;3830;146;746;3998;11245;6150
FR;12;2023-03-27;5;10;28;77;7;23;85;283;159;184;239;924;3907;153;769;4083;11528;6309
FR;12;2023-03-28;2;5;29;95;2;25;91;344;207;186;244;953;4002;155;794;4174;11872;6516
FR;12;2023-03-29;4;8;18;52;5;20;56;201;105;190;252;971;4054;160;814;4230;12073;6621
FR;12;2023-03-30;9;2;27;65;4;19;81;281;168;199;254;998;4119;164;833;4311;12354;6789
FR;12;2023-03-31;4;14;41;120;4;39;126;424;233;203;268;1039;4239;168;872;4437;12778;7022
FR;12;2023-04-01;1;8;17;44;4;13;48;139;63;204;276;1056;4283;172;885;4485;12917;7085
FR;12;2023-04-02;0;2;1;0;0;3;0;6;3;204;278;1057;4283;172;888;4485;12923;7088
FR;12;2023-04-03;6;3;35;90;4;18;112;300;159;210;281;1092;4373;176;906;4597;13223;7247
FR;12;2023-04-04;4;7;22;85;0;26;87;383;247;214;288;1114;4458;176;932;4684;13606;7494
FR;12;2023-04-05;4;9;21;60;5;23;57;231;138;218;297;1135;4518;181;955;4741;13837;7632
FR;12;2023-04-06;10;8;25;57;3;23;67;280;164;228;305;1160;4575;184;978;4808;14117;7796
FR;12;2023-04-07;4;11;29;98;8;25;110;389;221;232;316;1189;4673;192;1003;4918;14506;8017
FR;12;2023-04-08;1;5;11;38;3;9;38;117;56;233;321;1200;4711;195;1012;4956;14623;8073
FR;12;2023-04-09;0;0;2;1;0;1;2;5;2;233;321;1202;4712;195;1013;4958;14628;8075
FR;12;2023-04-10;0;1;2;2;1;0;5;9;4;233;322;1204;4714;196;1013;4963;14637;8079
FR;12;2023-04-11;5;8;27;87;6;16;98;297;161;238;330;1231;4801;202;1029;5061;14934;8240
FR;12;2023-04-12;5;12;16;52;5;23;60;260;154;243;342;1247;4853;207;1052;5121;15194;8394
FR;12;2023-04-13;3;5;22;58;2;17;64;251;140;246;347;1269;4911;209;1069;5185;15445;8534
FR;12;2023-04-14;6;15;21;91;9;18;97;397;248;252;362;1290;5002;218;1087;5282;15842;8782
FR;12;2023-04-15;5;0;14;34;0;8;40;110;49;257;362;1304;5036;218;1095;5322;15952;8831
FR;12;2023-04-16;0;0;1;2;0;0;2;4;2;257;362;1305;5038;218;1095;5324;15956;8833
FR;12;2023-04-17;3;2;18;40;2;19;40;181;97;260;364;1323;5078;220;1114;5364;16137;8930
FR;12;2023-04-18;6;6;18;56;2;14;63;273;145;266;370;1341;5134;222;1128;5427;16410;9075
FR;12;2023-04-19;3;7;11;40;2;11;38;149;81;269;377;1352;5174;224;1139;5465;16559;9156
FR;12;2023-04-20;2;3;15;51;1;11;58;215;120;271;380;1367;5225;225;1150;5523;16774;9276
FR;12;2023-04-21;4;6;25;60;5;19;68;255;148;275;386;1392;5285;230;1169;5591;17029;9424
FR;12;2023-04-22;3;8;11;22;6;9;29;94;36;278;394;1403;5307;236;1178;5620;17123;9460
FR;12;2023-04-23;0;0;1;0;0;1;1;3;1;278;394;1404;5307;236;1179;5621;17126;9461
FR;12;2023-04-24;2;6;11;42;5;11;49;172;99;280;400;1415;5349;241;1190;5670;17298;9560
FR;12;2023-04-25;1;3;15;46;1;15;51;207;120;281;403;1430;5395;242;1205;5721;17505;9680
FR;12;2023-04-26;3;4;16;36;2;14;42;170;88;284;407;1446;5431;244;1219;5763;17675;9768
FR;12;2023-04-27;4;4;13;46;3;13;46;194;108;288;411;1459;5477;247;1232;5809;17869;9876
FR;12;2023-04-28;5;9;24;63;3;24;74;317;181;293;420;1483;5540;250;1256;5883;18186;10057
FR;12;2023-04-29;2;4;10;25;4;6;30;94;44;295;424;1493;5565;254;1262;5913;18280;10101
FR;12;2023-04-30;0;0;0;0;0;0;0;0;0;295;424;1493;5565;254;1262;5913;18280;10101
FR;12;2023-05-01;0;0;0;0;0;0;0;4;3;295;424;1493;5565;254;1262;5913;18284;10104
FR;12;2023-05-02;8;3;12;48;2;15;48;248;128;303;427;1505;5613;256;1277;5961;18532;10232
FR;12;2023-05-03;7;6;10;44;7;9;47;228;122;310;433;1515;5657;263;1286;6008;18760;10354
FR;12;2023-05-04;5;4;20;37;1;17;51;222;110;315;437;1535;5694;264;1303;6059;18982;10464
FR;12;2023-05-05;4;12;18;49;5;19;48;284;151;319;449;1553;5743;269;1322;6107;19266;10615
FR;12;2023-05-06;2;5;7;15;2;11;15;69;29;321;454;1560;5758;271;1333;6122;19335;10644
FR;12;2023-05-07;2;0;1;0;2;1;2;3;0;323;454;1561;5758;273;1334;6124;19338;10644
FR;12;2023-05-08;1;1;1;0;1;0;1;5;2;324;455;1562;5758;274;1334;6125;19343;10646
FR;12;2023-05-09;1;6;11;46;3;14;53;246;119;325;461;1573;5804;277;1348;6178;19589;10765
FR;12;2023-05-10;5;8;10;39;7;13;42;208;105;330;469;1583;5843;284;1361;6220;19797;10870
FR;12;2023-05-11;4;6;8;43;4;8;45;208;108;334;475;1591;5886;288;1369;6265;20005;10978
FR;12;2023-05-12;3;3;8;58;1;7;56;308;165;337;478;1599;5944;289;1376;6321;20313;11143
FR;12;2023-05-13;3;3;4;18;1;7;20;75;39;340;481;1603;5962;290;1383;6341;20388;11182
FR;12;2023-05-14;0;0;0;0;0;0;0;1;1;340;481;1603;5962;290;1383;6341;20389;11183
FR;12;2023-05-15;2;1;6;35;2;4;40;203;99;342;482;1609;5997;292;1387;6381;20592;11282
FR;12;2023-05-16;5;9;7;39;4;11;42;268;142;347;491;1616;6036;296;1398;6423;20860;11424
FR;12;2023-05-17;3;7;10;31;5;8;34;194;86;350;498;1626;6067;301;1406;6457;21054;11510
FR;12;2023-05-18;1;0;1;2;0;0;3;4;1;351;498;1627;6069;301;1406;6460;21058;11511
FR;12;2023-05-19;1;4;11;32;3;10;39;175;82;352;502;1638;6101;304;1416;6499;21233;11593
FR;12;2023-05-20;1;3;3;6;2;2;9;51;20;353;505;1641;6107;306;1418;6508;21284;11613
FR;12;2023-05-21;0;3;0;2;0;3;2;10;1;353;508;1641;6109;306;1421;6510;21294;11614
FR;12;2023-05-22;3;5;9;24;1;13;27;137;61;356;513;1650;6133;307;1434;6537;21431;11675
FR;12;2023-05-23;4;5;12;67;4;13;72;251;102;360;518;1662;6200;311;1447;6609;21682;11777
FR;12;2023-05-24;4;5;5;32;4;6;37;169;77;364;523;1667;6232;315;1453;6646;21851;11854
FR;12;2023-05-25;5;3;8;18;4;10;25;176;79;369;526;1675;6250;319;1463;6671;22027;11933
FR;12;2023-05-26;5;9;11;31;9;10;35;250;107;374;535;1686;6281;328;1473;6706;22277;12040
FR;12;2023-05-27;3;2;7;9;1;4;13;70;36;377;537;1693;6290;329;1477;6719;22347;12076
FR;12;2023-05-28;0;0;0;0;0;0;0;1;0;377;537;1693;6290;329;1477;6719;22348;12076
FR;12;2023-05-29;0;2;0;0;1;1;0;1;0;377;539;1693;6290;330;1478;6719;22349;12076
FR;12;2023-05-30;6;5;10;28;2;12;33;240;104;383;544;1703;6318;332;1490;6752;22589;12180
FR;12;2023-05-31;4;5;6;24;6;6;25;167;77;387;549;1709;6342;338;1496;6777;22756;12257
FR;12;2023-06-01;1;2;12;22;2;7;32;223;97;388;551;1721;6364;340;1503;6809;22979;12354
FR;12;2023-06-02;7;2;9;34;1;9;35;312;151;395;553;1730;6398;341;1512;6844;23291;12505
FR;12;2023-06-03;2;2;3;11;1;3;15;88;25;397;555;1733;6409;342;1515;6859;23379;12530
FR;12;2023-06-04;0;0;0;2;0;0;1;8;5;397;555;1733;6411;342;1515;6860;23387;12535
FR;12;2023-06-05;5;4;3;25;2;7;28;238;110;402;559;1736;6436;344;1522;6888;23625;12645
FR;12;2023-06-06;2;7;15;24;4;11;33;278;127;404;566;1751;6460;348;1533;6921;23903;12772
FR;12;2023-06-07;2;5;7;16;1;13;22;195;76;406;571;1758;6476;349;1546;6943;24098;12848
FR;12;2023-06-08;4;6;8;17;5;10;19;186;84;410;577;1766;6493;354;1556;6962;24284;12932
FR;12;2023-06-09;5;3;8;25;2;7;31;272;128;415;580;1774;6518;356;1563;6993;24556;13060
FR;12;2023-06-10;1;3;2;11;4;1;13;82;32;416;583;1776;6529;360;1564;7006;24638;13092
FR;12;2023-06-11;0;1;0;0;0;1;0;2;0;416;584;1776;6529;360;1565;7006;24640;13092
FR;12;2023-06-12;2;2;2;23;0;3;22;173;82;418;586;1778;6552;360;1568;7028;24813;13174
FR;12;2023-06-13;0;1;10;24;1;7;27;213;89;418;587;1788;6576;361;1575;7055;25026;13263
FR;12;2023-06-14;1;1;9;17;0;4;25;174;59;419;588;1797;6593;361;1579;7080;25200;13322
FR;12;2023-06-15;1;2;8;20;1;2;28;228;85;420;590;1805;6613;362;1581;7108;25428;13407
FR;12;2023-06-16;7;3;9;26;5;13;22;302;117;427;593;1814;6639;367;1594;7130;25730;13524
FR;12;2023-06-17;0;3;6;12;3;3;11;106;53;427;596;1820;6651;370;1597;7141;25836;13577
FR;12;2023-06-18;0;0;0;0;0;0;0;0;0;427;596;1820;6651;370;1597;7141;25836;13577
FR;12;2023-06-19;3;7;6;28;6;4;31;218;80;430;603;1826;6679;376;1601;7172;26054;13657
FR;12;2023-06-20;1;0;6;23;0;5;30;297;148;431;603;1832;6702;376;1606;7202;26351;13805
FR;12;2023-06-21;2;6;6;21;3;7;22;233;101;433;609;1838;6723;379;1613;7224;26584;13906
FR;12;2023-06-22;2;2;5;23;2;5;24;267;118;435;611;1843;6746;381;1618;7248;26851;14024
FR;12;2023-06-23;1;2;4;33;2;4;42;341;124;436;613;1847;6779;383;1622;7290;27192;14148
FR;12;2023-06-24;0;0;6;10;0;5;18;77;21;436;613;1853;6789;383;1627;7308;27269;14169
FR;12;2023-06-25;0;0;0;2;0;0;1;5;4;436;613;1853;6791;383;1627;7309;27274;14173
FR;12;2023-06-26;4;0;4;18;0;6;21;184;58;440;613;1857;6809;383;1633;7330;27458;14231
FR;12;2023-06-27;2;5;7;30;3;8;33;241;65;442;618;1864;6839;386;1641;7363;27699;14296
FR;12;2023-06-28;1;2;5;23;1;6;24;180;54;443;620;1869;6862;387;1647;7387;27879;14350
FR;12;2023-06-29;4;1;6;22;1;5;27;212;76;447;621;1875;6884;388;1652;7414;28091;14426
FR;12;2023-06-30;4;5;6;25;5;6;28;256;113;451;626;1881;6909;393;1658;7442;28347;14539
FR;12;2023-07-01;0;2;0;9;1;2;7;50;19;451;628;1881;6918;394;1660;7449;28397;14558
FR;12;2023-07-02;0;0;0;0;0;0;0;1;1;451;628;1881;6918;394;1660;7449;28398;14559
FR;12;2023-07-03;0;2;4;8;1;5;11;126;39;451;630;1885;6926;395;1665;7460;28524;14598
FR;12;2023-07-04;1;1;4;11;1;4;11;126;42;452;631;1889;6937;396;1669;7471;28650;14640
FR;12;2023-07-05;1;2;5;8;1;4;10;105;35;453;633;1894;6945;397;1673;7481;28755;14675
FR;12;2023-07-06;0;1;3;11;1;3;11;113;42;453;634;1897;6956;398;1676;7492;28868;14717
FR;12;2023-07-07;0;4;5;20;2;7;21;179;60;453;638;1902;6976;400;1683;7513;29047;14777
FR;12;2023-07-08;3;1;1;2;1;1;4;32;10;456;639;1903;6978;401;1684;7517;29079;14787
FR;12;2023-07-09;0;0;0;0;0;0;0;1;1;456;639;1903;6978;401;1684;7517;29080;14788
FR;12;2023-07-10;4;3;4;10;5;4;6;116;37;460;642;1907;6988;406;1688;7523;29196;14825
FR;0;2020-12-27;616;0;0;0;55;0;0;0;0;616;0;0;0;55;0;0;0;0
FR;0;2020-12-28;710;1;0;0;44;0;0;0;0;1326;1;0;0;99;0;0;0;0
FR;0;2020-12-29;390;0;0;0;19;0;0;0;0;1716;1;0;0;118;0;0;0;0
FR;0;2020-12-30;456;0;0;0;20;0;0;0;0;2172;1;0;0;138;0;0;0;0
FR;0;2020-12-31;451;1;0;0;21;0;0;0;0;2623;2;0;0;159;0;0;0;0
FR;0;2021-01-01;1199;2;0;0;66;0;0;0;0;3822;4;0;0;225;0;0;0;0
FR;0;2021-01-02;370;4;0;0;29;0;0;0;0;4192;8;0;0;254;0;0;0;0
FR;0;2021-01-03;419;0;0;0;23;0;0;0;0;4611;8;0;0;277;0;0;0;0
FR;0;2021-01-04;2152;5;0;0;51;0;0;0;0;6763;13;0;0;328;0;0;0;0
FR;0;2021-01-05;7794;6;0;0;128;0;0;0;0;14557;19;0;0;456;0;0;0;0
FR;0;2021-01-06;12491;23;0;0;128;0;0;0;0;27048;42;0;0;584;0;0;0;0
FR;0;2021-01-07;29481;25;0;0;160;0;0;0;0;56529;67;0;0;744;0;0;0;0
FR;0;2021-01-08;37170;36;0;0;205;0;0;0;0;93699;103;0;0;949;0;0;0;0
FR;0;2021-01-09;11221;9;0;0;77;0;0;0;0;104920;112;0;0;1026;0;0;0;0
FR;0;2021-01-10;6017;8;0;0;28;0;0;0;0;110937;120;0;0;1054;0;0;0;0
FR;0;2021-01-11;39956;39;0;0;232;0;0;0;0;150893;159;0;0;1286;0;0;0;0
FR;0;2021-01-12;62166;31;0;0;296;0;0;0;0;213059;190;0;0;1582;0;0;0;0
FR;0;2021-01-13;65150;63;0;0;432;0;0;0;0;278209;253;0;0;2014;0;0;0;0
FR;0;2021-01-14;83109;263;0;0;1166;0;0;0;0;361318;516;0;0;3180;0;0;0;0
FR;0;2021-01-15;69040;103;1;0;555;0;0;0;0;430358;619;1;0;3735;0;0;0;0
FR;0;2021-01-16;20219;73;0;0;183;0;0;0;0;450577;692;1;0;3918;0;0;0;0
FR;0;2021-01-17;10993;54;0;0;137;0;0;0;0;461570;746;1;0;4055;0;0;0;0
FR;0;2021-01-18;85924;179;0;0;614;0;0;0;0;547494;925;1;0;4669;0;0;0;0
FR;0;2021-01-19;130616;211;0;0;860;0;0;0;0;678110;1136;1;0;5529;0;0;0;0
FR;0;2021-01-20;137578;197;0;0;836;0;0;0;0;815688;1333;1;0;6365;0;0;0;0
FR;0;2021-01-21;158435;205;0;0;947;0;0;0;0;974123;1538;1;0;7312;0;0;0;0
FR;0;2021-01-22;121091;259;0;0;846;0;0;0;0;1095214;1797;1;0;8158;0;0;0;0
FR;0;2021-01-23;38494;86;0;0;223;0;0;0;0;1133708;1883;1;0;8381;0;0;0;0
FR;0;2021-01-24;9752;131;0;0;196;0;0;0;0;1143460;2014;1;0;8577;0;0;0;0
FR;0;2021-01-25;78257;1458;0;0;1808;0;0;0;0;1221717;3472;1;0;10385;0;0;0;0
FR;0;2021-01-26;100401;3713;1;0;4189;0;0;0;0;1322118;7185;2;0;14574;0;0;0;0
FR;0;2021-01-27;107266;6447;0;0;7161;0;0;0;0;1429384;13632;2;0;21735;0;0;0;0
FR;0;2021-01-28;124384;16428;0;0;17250;0;0;0;0;1553768;30060;2;0;38985;0;0;0;0
FR;0;2021-01-29;92211;18809;0;0;19386;0;0;0;0;1645979;48869;2;0;58371;0;0;0;0
FR;0;2021-01-30;29128;4541;0;0;4678;0;0;0;0;1675107;53410;2;0;63049;0;0;0;0
FR;0;2021-01-31;5241;1900;0;0;1945;0;0;0;0;1680348;55310;2;0;64994;0;0;0;0
FR;0;2021-02-01;53160;23087;0;0;23361;0;0;0;0;1733508;78397;2;0;88355;0;0;0;0
FR;0;2021-02-02;72339;38227;0;0;38720;0;0;0;0;1805847;116624;2;0;127075;0;0;0;0
FR;0;2021-02-03;72329;40321;0;0;40827;0;0;0;0;1878176;156945;2;0;167902;0;0;0;0
FR;0;2021-02-04;82100;55172;0;0;55767;0;0;0;0;1960276;212117;2;0;223669;0;0;0;0
FR;0;2021-02-05;68252;48262;0;0;48700;0;0;0;0;2028528;260379;2;0;272369;0;0;0;0
FR;0;2021-02-06;22948;11434;0;0;11672;0;0;0;0;2051476;271813;2;0;284041;0;0;0;0
FR;0;2021-02-07;5195;6088;0;0;6214;0;0;0;0;2056671;277901;2;0;290255;0;0;0;0
FR;0;2021-02-08;46857;48830;0;0;49319;0;0;0;0;2103528;326731;2;0;339574;0;0;0;0
FR;0;2021-02-09;66051;78513;0;0;79611;0;0;0;0;2169579;405244;2;0;419185;0;0;0;0
FR;0;2021-02-10;71049;83572;0;0;84871;0;0;0;0;2240628;488816;2;0;504056;0;0;0;0
FR;0;2021-02-11;87309;105786;0;0;107736;0;0;0;0;2327937;594602;2;0;611792;0;0;0;0
FR;0;2021-02-12;79358;76104;0;0;77851;0;0;0;0;2407295;670706;2;0;689643;0;0;0;0
FR;0;2021-02-13;22391;19531;0;0;19898;0;0;0;0;2429686;690237;2;0;709541;0;0;0;0
FR;0;2021-02-14;5080;7325;0;0;7453;0;0;0;0;2434766;697562;2;0;716994;0;0;0;0
FR;0;2021-02-15;38132;76800;0;0;77825;0;0;0;0;2472898;774362;2;0;794819;0;0;0;0
FR;0;2021-02-16;50420;99677;0;0;101031;0;0;0;0;2523318;874039;2;0;895850;0;0;0;0
FR;0;2021-02-17;50561;106953;20;0;108405;0;0;0;0;2573879;980992;22;0;1004255;0;0;0;0
FR;0;2021-02-18;69814;123798;0;0;125848;0;0;0;0;2643693;1104790;22;0;1130103;0;0;0;0
FR;0;2021-02-19;65093;92337;1;0;94228;0;0;0;0;2708786;1197127;23;0;1224331;0;0;0;0
FR;0;2021-02-20;18602;28543;0;0;28914;0;0;0;0;2727388;1225670;23;0;1253245;0;0;0;0
FR;0;2021-02-21;3335;6038;0;0;6143;0;0;0;0;2730723;1231708;23;0;1259388;0;0;0;0
FR;0;2021-02-22;37512;73156;2;0;74173;0;0;0;0;2768235;1304864;25;0;1333561;0;0;0;0
FR;0;2021-02-23;53802;85328;1;0;86852;0;0;0;0;2822037;1390192;26;0;1420413;0;0;0;0
FR;0;2021-02-24;60039;82959;1;0;84541;0;0;0;0;2882076;1473151;27;0;1504954;0;0;0;0
FR;0;2021-02-25;100614;91197;1;0;94197;0;0;0;0;2982690;1564348;28;0;1599151;0;0;0;0
FR;0;2021-02-26;113492;70751;1;0;73903;0;0;0;0;3096182;1635099;29;0;1673054;0;0;0;0
FR;0;2021-02-27;52131;22440;1;0;23686;0;0;0;0;3148313;1657539;30;0;1696740;0;0;0;0
FR;0;2021-02-28;6209;4104;2;0;4302;0;0;0;0;3154522;1661643;32;0;1701042;0;0;0;0
FR;0;2021-03-01;65946;54075;1;0;55949;0;0;0;0;3220468;1715718;33;0;1756991;0;0;0;0
FR;0;2021-03-02;101417;67182;3;0;70229;0;0;0;0;3321885;1782900;36;0;1827220;0;0;0;0
FR;0;2021-03-03;116567;65484;0;0;69179;0;0;0;0;3438452;1848384;36;0;1896399;0;0;0;0
FR;0;2021-03-04;163664;72649;3;0;78223;0;0;0;0;3602116;1921033;39;0;1974622;0;0;0;0
FR;0;2021-03-05;200962;62702;3;0;69436;0;0;0;0;3803078;1983735;42;0;2044058;0;0;0;0
FR;0;2021-03-06;207995;17478;3;0;22781;0;0;0;0;4011073;2001213;45;0;2066839;0;0;0;0
FR;0;2021-03-07;121293;3963;1;0;7258;0;0;0;0;4132366;2005176;46;0;2074097;0;0;0;0
FR;0;2021-03-08;107180;49542;2;0;53032;0;0;0;0;4239546;2054718;48;0;2127129;0;0;0;0
FR;0;2021-03-09;172489;56026;2;0;61527;0;0;0;0;4412035;2110744;50;0;2188656;0;0;0;0
FR;0;2021-03-10;179044;57061;5;0;62737;0;0;0;0;4591079;2167805;55;0;2251393;0;0;0;0
FR;0;2021-03-11;242934;64044;2;0;72141;0;0;0;0;4834013;2231849;57;0;2323534;0;0;0;0
FR;0;2021-03-12;294876;53360;1;0;62818;0;0;0;0;5128889;2285209;58;0;2386352;0;0;0;0
FR;0;2021-03-13;231445;15263;1;0;21242;0;0;0;0;5360334;2300472;59;0;2407594;0;0;0;0
FR;0;2021-03-14;63365;3032;1;0;5068;0;0;0;0;5423699;2303504;60;0;2412662;0;0;0;0
FR;0;2021-03-15;158701;31483;3;0;36140;0;0;0;0;5582400;2334987;63;0;2448802;0;0;0;0
FR;0;2021-03-16;141599;38814;6;0;42967;0;0;0;0;5723999;2373801;69;0;2491769;0;0;0;0
FR;0;2021-03-17;150519;37581;4;0;42350;0;0;0;0;5874518;2411382;73;0;2534119;0;0;0;0
FR;0;2021-03-18;167873;44321;5;0;49888;0;0;0;0;6042391;2455703;78;0;2584007;0;0;0;0
FR;0;2021-03-19;230057;36746;2;0;44106;0;0;0;0;6272448;2492449;80;0;2628113;0;0;0;0
FR;0;2021-03-20;166721;11384;1;0;16009;0;0;0;0;6439169;2503833;81;0;2644122;0;0;0;0
FR;0;2021-03-21;49960;2128;1;0;3887;0;0;0;0;6489129;2505961;82;0;2648009;0;0;0;0
FR;0;2021-03-22;170085;33532;2;0;39038;0;0;0;0;6659214;2539493;84;0;2687047;0;0;0;0
FR;0;2021-03-23;250442;42362;1;0;50210;0;0;0;0;6909656;2581855;85;0;2737257;0;0;0;0
FR;0;2021-03-24;256953;43596;0;0;51699;0;0;0;0;7166609;2625451;85;0;2788956;0;0;0;0
FR;0;2021-03-25;341877;45292;5;0;56293;0;0;0;0;7508486;2670743;90;0;2845249;0;0;0;0
FR;0;2021-03-26;358851;41789;5;1;53547;0;0;0;0;7867337;2712532;95;1;2898796;0;0;0;0
FR;0;2021-03-27;195297;16954;1;0;23398;0;0;0;0;8062634;2729486;96;1;2922194;0;0;0;0
FR;0;2021-03-28;59361;4587;3;0;6652;0;0;0;0;8121995;2734073;99;1;2928846;0;0;0;0
FR;0;2021-03-29;203028;53389;4;0;60154;0;0;0;0;8325023;2787462;103;1;2989000;0;0;0;0
FR;0;2021-03-30;285550;70041;5;0;80456;0;0;0;0;8610573;2857503;108;1;3069456;0;0;0;0
FR;0;2021-03-31;263083;74062;4;0;84734;0;0;0;0;8873656;2931565;112;1;3154190;0;0;0;0
FR;0;2021-04-01;315587;92827;11;0;106413;0;0;0;0;9189243;3024392;123;1;3260603;0;0;0;0
FR;0;2021-04-02;281385;94818;7;0;106651;0;0;0;0;9470628;3119210;130;1;3367254;0;0;0;0
FR;0;2021-04-03;141097;62621;6;0;67884;0;0;0;0;9611725;3181831;136;1;3435138;0;0;0;0
FR;0;2021-04-04;46552;19022;2;0;21077;0;0;0;0;9658277;3200853;138;1;3456215;0;0;0;0
FR;0;2021-04-05;63373;10402;11;0;13059;0;0;0;0;9721650;3211255;149;1;3469274;0;0;0;0
FR;0;2021-04-06;217276;113157;17;0;122028;0;0;0;0;9938926;3324412;166;1;3591302;0;0;0;0
FR;0;2021-04-07;260325;115292;17;0;126648;0;0;0;0;10199251;3439704;183;1;3717950;0;0;0;0
FR;0;2021-04-08;337917;123232;15;0;138865;0;0;0;0;10537168;3562936;198;1;3856815;0;0;0;0
FR;0;2021-04-09;410245;116883;50;0;134295;0;0;0;0;10947413;3679819;248;1;3991110;0;0;0;0
FR;0;2021-04-10;212666;82878;15;0;91272;0;0;0;0;11160079;3762697;263;1;4082382;0;0;0;0
FR;0;2021-04-11;56162;34179;7;0;36705;0;0;0;0;11216241;3796876;270;1;4119087;0;0;0;0
FR;0;2021-04-12;237130;115831;46;0;125444;0;0;0;0;11453371;3912707;316;1;4244531;0;0;0;0
FR;0;2021-04-13;309558;144150;98;1;157113;0;0;0;0;11762929;4056857;414;2;4401644;0;0;0;0
FR;0;2021-04-14;294609;139867;215;0;153247;0;0;0;0;12057538;4196724;629;2;4554891;0;0;0;0
FR;0;2021-04-15;337206;150556;340;0;166100;0;0;0;0;12394744;4347280;969;2;4720991;0;0;0;0
FR;0;2021-04-16;339362;147042;354;0;161701;0;0;0;0;12734106;4494322;1323;2;4882692;0;0;0;0
FR;0;2021-04-17;188689;89983;109;0;97683;0;0;0;0;12922795;4584305;1432;2;4980375;0;0;0;0
FR;0;2021-04-18;51645;35459;48;0;37881;0;0;0;0;12974440;4619764;1480;2;5018256;0;0;0;0
FR;0;2021-04-19;205752;138304;457;0;147464;0;0;0;0;13180192;4758068;1937;2;5165720;0;0;0;0
FR;0;2021-04-20;254497;172052;569;0;183713;0;0;0;0;13434689;4930120;2506;2;5349433;0;0;0;0
FR;0;2021-04-21;253347;170248;837;0;182271;0;0;0;0;13688036;5100368;3343;2;5531704;0;0;0;0
FR;0;2021-04-22;287635;190469;820;0;205065;0;0;0;0;13975671;5290837;4163;2;5736769;0;0;0;0
FR;0;2021-04-23;297684;184749;747;0;203508;0;0;0;0;14273355;5475586;4910;2;5940277;0;0;0;0
FR;0;2021-04-24;190483;112059;252;0;122514;0;0;0;0;14463838;5587645;5162;2;6062791;0;0;0;0
FR;0;2021-04-25;69580;38860;51;0;42590;0;0;0;0;14533418;5626505;5213;2;6105381;0;0;0;0
FR;0;2021-04-26;221007;158708;564;0;171909;0;0;0;0;14754425;5785213;5777;2;6277290;0;0;0;0
FR;0;2021-04-27;284658;188072;941;0;211387;0;0;0;0;15039083;5973285;6718;2;6488677;0;0;0;0
FR;0;2021-04-28;299598;184735;1427;1;209816;1;0;0;0;15338681;6158020;8145;3;6698493;1;0;0;0
FR;0;2021-04-29;357220;198336;1281;0;233421;0;0;0;0;15695901;6356356;9426;3;6931914;1;0;0;0
FR;0;2021-04-30;372271;186156;1124;1;225495;0;0;0;0;16068172;6542512;10550;4;7157409;1;0;0;0
FR;0;2021-05-01;167680;52538;179;0;63784;0;0;0;0;16235852;6595050;10729;4;7221193;1;0;0;0
FR;0;2021-05-02;91771;37869;83;0;43598;0;0;0;0;16327623;6632919;10812;4;7264791;1;0;0;0
FR;0;2021-05-03;288988;165093;843;0;185618;0;0;0;0;16616611;6798012;11655;4;7450409;1;0;0;0
FR;0;2021-05-04;315761;225645;1237;0;251818;0;0;0;0;16932372;7023657;12892;4;7702227;1;0;0;0
FR;0;2021-05-05;327323;226692;1316;0;251771;0;0;0;0;17259695;7250349;14208;4;7953998;1;0;0;0
FR;0;2021-05-06;379658;241301;1634;0;275547;0;0;0;0;17639353;7491650;15842;4;8229545;1;0;0;0
FR;0;2021-05-07;372838;258924;1225;0;299980;0;0;0;0;18012191;7750574;17067;4;8529525;1;0;0;0
FR;0;2021-05-08;222192;71531;300;0;86740;0;0;0;0;18234383;7822105;17367;4;8616265;1;0;0;0
FR;0;2021-05-09;129735;44485;243;0;53123;0;0;0;0;18364118;7866590;17610;4;8669388;1;0;0;0
FR;0;2021-05-10;313436;229741;1239;0;255522;0;0;0;0;18677554;8096331;18849;4;8924910;1;0;0;0
FR;0;2021-05-11;403988;258457;1566;0;296884;0;0;0;0;19081542;8354788;20415;4;9221794;1;0;0;0
FR;0;2021-05-12;434234;233895;1545;0;270184;0;0;0;0;19515776;8588683;21960;4;9491978;1;0;0;0
FR;0;2021-05-13;338644;56433;432;0;77926;0;0;0;0;19854420;8645116;22392;4;9569904;1;0;0;0
FR;0;2021-05-14;454194;167502;1130;0;203114;0;0;0;0;20308614;8812618;23522;4;9773018;1;0;0;0
FR;0;2021-05-15;375023;94404;445;0;120802;0;0;0;0;20683637;8907022;23967;4;9893820;1;0;0;0
FR;0;2021-05-16;202779;20695;168;0;34096;0;0;0;0;20886416;8927717;24135;4;9927916;1;0;0;0
FR;0;2021-05-17;376171;148881;1555;0;178671;0;0;0;0;21262587;9076598;25690;4;10106587;1;0;0;0
FR;0;2021-05-18;460233;154158;1991;0;193311;0;0;0;0;21722820;9230756;27681;4;10299898;1;0;0;0
FR;0;2021-05-19;467483;142579;2466;0;179842;0;0;0;0;22190303;9373335;30147;4;10479740;1;0;0;0
FR;0;2021-05-20;507610;160253;2340;0;204204;0;0;0;0;22697913;9533588;32487;4;10683944;1;0;0;0
FR;0;2021-05-21;489737;175266;1997;0;221811;0;0;0;0;23187650;9708854;34484;4;10905755;1;0;0;0
FR;0;2021-05-22;347231;80251;670;0;108682;0;0;0;0;23534881;9789105;35154;4;11014437;1;0;0;0
FR;0;2021-05-23;161720;14211;246;0;26680;0;0;0;0;23696601;9803316;35400;4;11041117;1;0;0;0
FR;0;2021-05-24;263223;33110;604;0;52945;0;0;0;0;23959824;9836426;36004;4;11094062;1;0;0;0
FR;0;2021-05-25;400322;190461;2357;1;227030;0;0;0;0;24360146;10026887;38361;5;11321092;1;0;0;0
FR;0;2021-05-26;413524;191308;2227;0;229357;0;0;0;0;24773670;10218195;40588;5;11550449;1;0;0;0
FR;0;2021-05-27;449888;220120;2163;0;267258;0;0;0;0;25223558;10438315;42751;5;11817707;1;0;0;0
FR;0;2021-05-28;429618;261153;1895;0;319254;0;0;0;0;25653176;10699468;44646;5;12136961;1;0;0;0
FR;0;2021-05-29;299010;150536;586;0;183390;0;0;0;0;25952186;10850004;45232;5;12320351;1;0;0;0
FR;0;2021-05-30;107156;32504;164;0;42087;0;0;0;0;26059342;10882508;45396;5;12362438;1;0;0;0
FR;0;2021-05-31;358084;203497;1474;1;241779;1;0;0;0;26417426;11086005;46870;6;12604217;2;0;0;0
FR;0;2021-06-01;431169;251293;1969;1;302938;1;0;0;0;26848595;11337298;48839;7;12907155;3;0;0;0
FR;0;2021-06-02;420196;232807;1986;0;280195;0;0;0;0;27268791;11570105;50825;7;13187350;3;0;0;0
FR;0;2021-06-03;465724;257772;1826;0;312546;0;0;0;0;27734515;11827877;52651;7;13499896;3;0;0;0
FR;0;2021-06-04;456313;305909;1735;1;363322;1;0;0;0;28190828;12133786;54386;8;13863218;4;0;0;0
FR;0;2021-06-05;304842;189572;653;0;222796;0;0;0;0;28495670;12323358;55039;8;14086014;4;0;0;0
FR;0;2021-06-06;133344;49020;227;0;61159;0;0;0;0;28629014;12372378;55266;8;14147173;4;0;0;0
FR;0;2021-06-07;340029;261515;1529;0;298606;0;0;0;0;28969043;12633893;56795;8;14445779;4;0;0;0
FR;0;2021-06-08;393974;291418;1806;0;338283;0;0;0;0;29363017;12925311;58601;8;14784062;4;0;0;0
FR;0;2021-06-09;384977;273770;1734;0;318165;0;0;0;0;29747994;13199081;60335;8;15102227;4;0;0;0
FR;0;2021-06-10;404264;286270;1729;1;335721;0;0;0;0;30152258;13485351;62064;9;15437948;4;0;0;0
FR;0;2021-06-11;386737;356535;1468;1;406981;0;0;0;0;30538995;13841886;63532;10;15844929;4;0;0;0
FR;0;2021-06-12;283301;210994;497;0;243140;0;0;0;0;30822296;14052880;64029;10;16088069;4;0;0;0
FR;0;2021-06-13;104907;73842;204;0;84835;0;0;0;0;30927203;14126722;64233;10;16172904;4;0;0;0
FR;0;2021-06-14;240894;354027;1429;1;383225;0;0;0;0;31168097;14480749;65662;11;16556129;4;0;0;0
FR;0;2021-06-15;308241;384334;1574;1;423111;0;0;0;0;31476338;14865083;67236;12;16979240;4;0;0;0
FR;0;2021-06-16;314028;357610;1419;1;395376;0;0;0;0;31790366;15222693;68655;13;17374616;4;0;0;0
FR;0;2021-06-17;317745;373169;1432;1;414367;0;0;0;0;32108111;15595862;70087;14;17788983;4;0;0;0
FR;0;2021-06-18;321786;442592;1342;2;486000;0;0;0;0;32429897;16038454;71429;16;18274983;4;0;0;0
FR;0;2021-06-19;224368;274026;449;0;301219;0;0;0;0;32654265;16312480;71878;16;18576202;4;0;0;0
FR;0;2021-06-20;74459;102286;131;0;111479;0;0;0;0;32728724;16414766;72009;16;18687681;4;0;0;0
FR;0;2021-06-21;195821;401760;1038;1;427726;1;0;0;0;32924545;16816526;73047;17;19115407;5;0;0;0
FR;0;2021-06-22;223250;467832;1266;10;500506;1;0;0;0;33147795;17284358;74313;27;19615913;6;0;0;0
FR;0;2021-06-23;234087;440157;1198;1;474268;1;0;0;0;33381882;17724515;75511;28;20090181;7;0;0;0
FR;0;2021-06-24;241909;409783;1359;0;447277;0;0;0;0;33623791;18134298;76870;28;20537458;7;0;0;0
FR;0;2021-06-25;227678;523087;1404;0;562088;0;0;0;0;33851469;18657385;78274;28;21099546;7;0;0;0
FR;0;2021-06-26;153296;371100;589;1;395907;0;0;0;0;34004765;19028485;78863;29;21495453;7;0;0;0
FR;0;2021-06-27;55925;155941;169;1;164851;0;0;0;0;34060690;19184426;79032;30;21660304;7;0;0;0
FR;0;2021-06-28;154813;452530;1178;0;478128;0;0;0;0;34215503;19636956;80210;30;22138432;7;0;0;0
FR;0;2021-06-29;182754;507863;2124;0;539234;0;0;0;0;34398257;20144819;82334;30;22677666;7;0;0;0
FR;0;2021-06-30;204047;485266;2016;21;519529;1;0;0;0;34602304;20630085;84350;51;23197195;8;0;0;0
FR;0;2021-07-01;231467;458582;2226;5;498518;0;0;0;0;34833771;21088667;86576;56;23695713;8;0;0;0
FR;0;2021-07-02;228706;520026;2120;5;562334;2;0;0;0;35062477;21608693;88696;61;24258047;10;0;0;0
FR;0;2021-07-03;142060;368758;908;3;395245;1;0;0;0;35204537;21977451;89604;64;24653292;11;0;0;0
FR;0;2021-07-04;56765;141007;265;0;150696;0;0;0;0;35261302;22118458;89869;64;24803988;11;0;0;0
FR;0;2021-07-05;168555;418640;1668;8;448583;0;0;0;0;35429857;22537098;91537;72;25252571;11;0;0;0
FR;0;2021-07-06;196812;474529;1830;45;511119;8;0;0;0;35626669;23011627;93367;117;25763690;19;0;0;0
FR;0;2021-07-07;213258;438966;1881;25;477426;2;0;0;0;35839927;23450593;95248;142;26241116;21;0;0;0
FR;0;2021-07-08;231680;424139;2090;20;468068;2;0;0;0;36071607;23874732;97338;162;26709184;23;0;0;0
FR;0;2021-07-09;228644;511069;2185;4;557353;1;0;0;0;36300251;24385801;99523;166;27266537;24;0;0;0
FR;0;2021-07-10;148640;339926;986;1;368867;0;0;0;0;36448891;24725727;100509;167;27635404;24;0;0;0
FR;0;2021-07-11;60217;110048;284;0;120957;0;0;0;0;36509108;24835775;100793;167;27756361;24;0;0;0
FR;0;2021-07-12;169444;477697;1766;4;512423;0;0;0;0;36678552;25313472;102559;171;28268784;24;0;0;0
FR;0;2021-07-13;287312;526603;2050;8;585623;0;0;0;0;36965864;25840075;104609;179;28854407;24;0;0;0
FR;0;2021-07-14;181123;157330;435;0;186637;0;0;0;0;37146987;25997405;105044;179;29041044;24;0;0;0
FR;0;2021-07-15;347131;501594;2100;1;571553;0;0;0;0;37494118;26498999;107144;180;29612597;24;0;0;0
FR;0;2021-07-16;380125;494951;2023;3;574119;1;0;0;0;37874243;26993950;109167;183;30186716;25;0;0;0
FR;0;2021-07-17;259757;319631;877;1;368585;0;0;0;0;38134000;27313581;110044;184;30555301;25;0;0;0
FR;0;2021-07-18;109747;114564;310;0;132999;0;0;0;0;38243747;27428145;110354;184;30688300;25;0;0;0
FR;0;2021-07-19;285528;423871;1631;3;478874;0;0;0;0;38529275;27852016;111985;187;31167174;25;0;0;0
FR;0;2021-07-20;376946;451200;1725;0;523530;0;0;0;0;38906221;28303216;113710;187;31690704;25;0;0;0
FR;0;2021-07-21;395847;406819;1550;4;481800;1;0;0;0;39302068;28710035;115260;191;32172504;26;0;0;0
FR;0;2021-07-22;441094;387299;1715;4;471766;1;0;0;0;39743162;29097334;116975;195;32644270;27;0;0;0
FR;0;2021-07-23;440353;421951;1883;4;509907;1;0;0;0;40183515;29519285;118858;199;33154177;28;0;0;0
FR;0;2021-07-24;285264;269310;804;1;321989;0;0;0;0;40468779;29788595;119662;200;33476166;28;0;0;0
FR;0;2021-07-25;121130;79919;234;0;100272;0;0;0;0;40589909;29868514;119896;200;33576438;28;0;0;0
FR;0;2021-07-26;347455;322125;1614;3;384677;1;0;0;0;40937364;30190639;121510;203;33961115;29;0;0;0
FR;0;2021-07-27;464124;319255;1699;4;400403;1;0;0;0;41401488;30509894;123209;207;34361518;30;0;0;0
FR;0;2021-07-28;459485;289367;1637;4;366978;1;0;0;0;41860973;30799261;124846;211;34728496;31;0;0;0
FR;0;2021-07-29;489869;276098;1797;2;356963;0;0;0;0;42350842;31075359;126643;213;35085459;31;0;0;0
FR;0;2021-07-30;461863;302324;1942;5;380803;1;0;0;0;42812705;31377683;128585;218;35466262;32;0;0;0
FR;0;2021-07-31;285426;185020;916;1;231505;0;0;0;0;43098131;31562703;129501;219;35697767;32;0;0;0
FR;0;2021-08-01;112056;49907;257;0;65685;0;0;0;0;43210187;31612610;129758;219;35763452;32;0;0;0
FR;0;2021-08-02;341681;234023;1603;2;284711;0;0;0;0;43551868;31846633;131361;221;36048163;32;0;0;0
FR;0;2021-08-03;398648;244423;1729;2;304491;1;0;0;0;43950516;32091056;133090;223;36352654;33;0;0;0
FR;0;2021-08-04;384887;209509;1594;6;265628;3;0;0;0;44335403;32300565;134684;229;36618282;36;0;0;0
FR;0;2021-08-05;366208;228341;1711;0;281715;0;0;0;0;44701611;32528906;136395;229;36899997;36;0;0;0
FR;0;2021-08-06;359762;271207;1835;4;326583;0;0;0;0;45061373;32800113;138230;233;37226580;36;0;0;0
FR;0;2021-08-07;213153;178314;756;5;210039;1;0;0;0;45274526;32978427;138986;238;37436619;37;0;0;0
FR;0;2021-08-08;74213;63188;276;0;73621;0;0;0;0;45348739;33041615;139262;238;37510240;37;0;0;0
FR;0;2021-08-09;258780;258563;1549;4;297472;2;0;0;0;45607519;33300178;140811;242;37807712;39;0;0;0
FR;0;2021-08-10;306900;277036;1662;2;323418;0;0;0;0;45914419;33577214;142473;244;38131130;39;0;0;0
FR;0;2021-08-11;279770;259534;1442;5;301601;0;0;0;0;46194189;33836748;143915;249;38432731;39;0;0;0
FR;0;2021-08-12;271575;277997;1669;3;320250;0;0;0;0;46465764;34114745;145584;252;38752981;39;0;0;0
FR;0;2021-08-13;252181;278116;1595;3;316947;2;0;0;0;46717945;34392861;147179;255;39069928;41;0;0;0
FR;0;2021-08-14;145366;197058;740;0;218979;0;0;0;0;46863311;34589919;147919;255;39288907;41;0;0;0
FR;0;2021-08-15;39403;50088;218;1;55668;0;0;0;0;46902714;34640007;148137;256;39344575;41;0;0;0
FR;0;2021-08-16;186198;317460;1543;0;345378;0;0;0;0;47088912;34957467;149680;256;39689953;41;0;0;0
FR;0;2021-08-17;215721;335790;1638;7;368821;0;0;0;0;47304633;35293257;151318;263;40058774;41;0;0;0
FR;0;2021-08-18;199083;324368;1599;7;354528;3;0;0;0;47503716;35617625;152917;270;40413302;44;0;0;0
FR;0;2021-08-19;192053;325392;1642;1;355946;0;0;0;0;47695769;35943017;154559;271;40769248;44;0;0;0
FR;0;2021-08-20;186495;366172;1823;3;396598;2;0;0;0;47882264;36309189;156382;274;41165846;46;0;0;0
FR;0;2021-08-21;104816;238131;709;0;254561;0;0;0;0;47987080;36547320;157091;274;41420407;46;0;0;0
FR;0;2021-08-22;31950;87210;256;1;92162;1;0;0;0;48019030;36634530;157347;275;41512569;47;0;0;0
FR;0;2021-08-23;141003;356999;1561;3;379588;0;0;0;0;48160033;36991529;158908;278;41892157;47;0;0;0
FR;0;2021-08-24;162524;376568;1850;5;402814;0;0;0;0;48322557;37368097;160758;283;42294971;47;0;0;0
FR;0;2021-08-25;151165;350707;2038;8;375393;2;0;0;0;48473722;37718804;162796;291;42670364;49;0;0;0
FR;0;2021-08-26;142899;342773;2564;10;367561;0;0;0;0;48616621;38061577;165360;301;43037925;49;0;0;0
FR;0;2021-08-27;148458;388231;2791;11;414864;1;0;0;0;48765079;38449808;168151;312;43452789;50;0;0;0
FR;0;2021-08-28;90682;249640;1407;0;264964;0;0;0;0;48855761;38699448;169558;312;43717753;50;0;0;0
FR;0;2021-08-29;27325;83357;518;1;88273;0;0;0;0;48883086;38782805;170076;313;43806026;50;0;0;0
FR;0;2021-08-30;117432;324564;4714;6;342387;5830;0;0;0;49000518;39107369;174790;319;44148413;5880;0;0;0
FR;0;2021-08-31;128835;334445;10189;19;353926;11764;2;0;0;49129353;39441814;184979;338;44502339;17644;2;0;0
FR;0;2021-09-01;136169;285659;22437;8;302401;24412;1;0;0;49265522;39727473;207416;346;44804740;42056;3;0;0
FR;0;2021-09-02;114655;247201;26525;20;262098;29009;0;0;0;49380177;39974674;233941;366;45066838;71065;3;0;0
FR;0;2021-09-03;118331;292648;29968;24;309304;33076;1;0;0;49498508;40267322;263909;390;45376142;104141;4;0;0
FR;0;2021-09-04;89894;217796;12587;12;230487;14157;7;0;0;49588402;40485118;276496;402;45606629;118298;11;0;0
FR;0;2021-09-05;21367;44794;4397;2;48279;4714;0;0;0;49609769;40529912;280893;404;45654908;123012;11;0;0
FR;0;2021-09-06;75702;180483;31957;16;190660;34305;2;0;0;49685471;40710395;312850;420;45845568;157317;13;0;0
FR;0;2021-09-07;80317;181179;33251;43;191036;36321;2;0;0;49765788;40891574;346101;463;46036604;193638;15;0;0
FR;0;2021-09-08;91014;206088;29666;28;216567;32572;4;0;0;49856802;41097662;375767;491;46253171;226210;19;0;0
FR;0;2021-09-09;76986;165315;33086;27;174119;36699;5;0;0;49933788;41262977;408853;518;46427290;262909;24;0;0
FR;0;2021-09-10;96051;203821;35743;28;214897;40790;7;0;0;50029839;41466798;444596;546;46642187;303699;31;0;0
FR;0;2021-09-11;67169;169341;12140;19;178184;14414;0;0;0;50097008;41636139;456736;565;46820371;318113;31;0;0
FR;0;2021-09-12;12830;32093;2784;1;34139;3190;2;0;0;50109838;41668232;459520;566;46854510;321303;33;0;0
FR;0;2021-09-13;64581;126152;41249;35;134168;44267;17;0;0;50174419;41794384;500769;601;46988678;365570;50;0;0
FR;0;2021-09-14;73504;129008;56393;80;135745;62458;39;0;0;50247923;41923392;557162;681;47124423;428028;89;0;0
FR;0;2021-09-15;76668;167735;55671;58;174677;54852;76;0;0;50324591;42091127;612833;739;47299100;482880;165;0;0
FR;0;2021-09-16;63898;114504;60099;82;117880;60179;59;0;0;50388489;42205631;672932;821;47416980;543059;224;0;0
FR;0;2021-09-17;75093;156849;53871;71;159726;57366;67;0;0;50463582;42362480;726803;892;47576706;600425;291;0;0
FR;0;2021-09-18;48244;139637;15603;25;144317;17321;20;0;0;50511826;42502117;742406;917;47721023;617746;311;0;0
FR;0;2021-09-19;7908;23645;2443;1;24875;2619;1;0;0;50519734;42525762;744849;918;47745898;620365;312;0;0
FR;0;2021-09-20;44580;93751;50086;72;96241;50346;34;0;0;50564314;42619513;794935;990;47842139;670711;346;0;0
FR;0;2021-09-21;45918;98367;62772;77;98384;63506;79;0;0;50610232;42717880;857707;1067;47940523;734217;425;0;0
FR;0;2021-09-22;48711;142399;55393;82;144842;55496;46;0;0;50658943;42860279;913100;1149;48085365;789713;471;0;0
FR;0;2021-09-23;43298;92062;62408;95;91269;63589;86;0;0;50702241;42952341;975508;1244;48176634;853302;557;0;0
FR;0;2021-09-24;52324;133291;54571;107;132387;59234;77;0;0;50754565;43085632;1030079;1351;48309021;912536;634;0;0
FR;0;2021-09-25;35225;115667;16277;36;118647;18319;22;0;0;50789790;43201299;1046356;1387;48427668;930855;656;0;0
FR;0;2021-09-26;5561;17804;2273;5;18691;2331;5;0;0;50795351;43219103;1048629;1392;48446359;933186;661;0;0
FR;0;2021-09-27;33988;76894;47221;97;78781;48206;80;0;1;50829339;43295997;1095850;1489;48525140;981392;741;0;1
FR;0;2021-09-28;36524;75246;54984;90;74326;56604;44;0;0;50865863;43371243;1150834;1579;48599466;1037996;785;0;1
FR;0;2021-09-29;44426;100683;53376;113;102843;54911;41;0;0;50910289;43471926;1204210;1692;48702309;1092907;826;0;1
FR;0;2021-09-30;36349;72980;57048;96;71482;59614;57;0;0;50946638;43544906;1261258;1788;48773791;1152521;883;0;1
FR;0;2021-10-01;61720;102863;57837;108;101413;64020;23;0;0;51008358;43647769;1319095;1896;48875204;1216541;906;0;1
FR;0;2021-10-02;39473;78461;20965;39;81737;23386;12;0;0;51047831;43726230;1340060;1935;48956941;1239927;918;0;1
FR;0;2021-10-03;5290;10488;2536;4;11255;2542;4;0;0;51053121;43736718;1342596;1939;48968196;1242469;922;0;1
FR;0;2021-10-04;35208;58501;52638;84;59500;54860;37;0;0;51088329;43795219;1395234;2023;49027696;1297329;959;0;1
FR;0;2021-10-05;33937;64382;61032;135;62111;65122;47;0;0;51122266;43859601;1456266;2158;49089807;1362451;1006;0;1
FR;0;2021-10-06;42728;79312;65764;112;80184;68386;28;0;0;51164994;43938913;1522030;2270;49169991;1430837;1034;0;1
FR;0;2021-10-07;30577;62280;65451;88;59498;68900;37;0;0;51195571;44001193;1587481;2358;49229489;1499737;1071;0;1
FR;0;2021-10-08;49486;91943;77772;111;89884;84806;39;0;0;51245057;44093136;1665253;2469;49319373;1584543;1110;0;1
FR;0;2021-10-09;33677;60951;31549;35;64141;33933;17;0;0;51278734;44154087;1696802;2504;49383514;1618476;1127;0;1
FR;0;2021-10-10;4722;7424;3199;9;7940;3475;2;0;0;51283456;44161511;1700001;2513;49391454;1621951;1129;0;1
FR;0;2021-10-11;30736;49887;61050;105;50603;64120;46;0;0;51314192;44211398;1761051;2618;49442057;1686071;1175;0;1
FR;0;2021-10-12;31651;54484;70635;141;51309;76051;27;0;0;51345843;44265882;1831686;2759;49493366;1762122;1202;0;1
FR;0;2021-10-13;40168;62850;74443;137;62797;79398;29;0;1;51386011;44328732;1906129;2896;49556163;1841520;1231;0;2
FR;0;2021-10-14;30364;52873;68779;116;49694;73871;31;0;0;51416375;44381605;1974908;3012;49605857;1915391;1262;0;2
FR;0;2021-10-15;44961;75241;93255;191;70334;103057;26;0;0;51461336;44456846;2068163;3203;49676191;2018448;1288;0;2
FR;0;2021-10-16;31335;44080;36701;45;46700;39650;15;0;0;51492671;44500926;2104864;3248;49722891;2058098;1303;0;2
FR;0;2021-10-17;3898;5229;3604;2;5677;3674;4;0;0;51496569;44506155;2108468;3250;49728568;2061772;1307;0;2
FR;0;2021-10-18;29217;42342;67522;134;42559;71384;27;0;0;51525786;44548497;2175990;3384;49771127;2133156;1334;0;2
FR;0;2021-10-19;27196;45546;76431;140;43201;81679;43;0;0;51552982;44594043;2252421;3524;49814328;2214835;1377;0;2
FR;0;2021-10-20;35347;52402;96961;181;51808;101582;44;0;0;51588329;44646445;2349382;3705;49866136;2316417;1421;0;2
FR;0;2021-10-21;26169;45174;83999;112;41971;89195;30;0;0;51614498;44691619;2433381;3817;49908107;2405612;1451;0;2
FR;0;2021-10-22;38450;62487;104928;200;59354;112654;61;0;0;51652948;44754106;2538309;4017;49967461;2518266;1512;0;2
FR;0;2021-10-23;27034;41204;45467;57;42426;48637;14;0;0;51679982;44795310;2583776;4074;50009887;2566903;1526;0;2
FR;0;2021-10-24;2947;4763;3686;6;5014;3923;1;0;0;51682929;44800073;2587462;4080;50014901;2570826;1527;0;2
FR;0;2021-10-25;26110;36208;82347;144;35481;86681;38;0;0;51709039;44836281;2669809;4224;50050382;2657507;1565;0;2
FR;0;2021-10-26;23770;34993;87283;166;32158;92413;35;0;0;51732809;44871274;2757092;4390;50082540;2749920;1600;0;2
FR;0;2021-10-27;30116;46297;109035;257;44036;114753;48;0;0;51762925;44917571;2866127;4647;50126576;2864673;1648;0;2
FR;0;2021-10-28;23611;34927;88745;153;31193;94544;35;0;0;51786536;44952498;2954872;4800;50157769;2959217;1683;0;2
FR;0;2021-10-29;31590;51449;117349;206;46497;125437;52;0;0;51818126;45003947;3072221;5006;50204266;3084654;1735;0;2
FR;0;2021-10-30;20578;33236;50361;76;32918;53430;20;0;0;51838704;45037183;3122582;5082;50237184;3138084;1755;0;2
FR;0;2021-10-31;2519;3732;3595;3;3844;3881;3;0;0;51841223;45040915;3126177;5085;50241028;3141965;1758;0;2
FR;0;2021-11-01;8544;4869;3224;3;5020;3587;10;0;0;51849767;45045784;3129401;5088;50246048;3145552;1768;0;2
FR;0;2021-11-02;26387;40098;93612;156;36236;99674;44;0;1;51876154;45085882;3223013;5244;50282284;3245226;1812;0;3
FR;0;2021-11-03;30134;47903;118933;222;43556;125912;62;0;0;51906288;45133785;3341946;5466;50325840;3371138;1874;0;3
FR;0;2021-11-04;23824;37461;107603;217;31574;114483;46;0;0;51930112;45171246;3449549;5683;50357414;3485621;1920;0;3
FR;0;2021-11-05;32422;52936;141679;236;44651;151469;54;0;0;51962534;45224182;3591228;5919;50402065;3637090;1974;0;3
FR;0;2021-11-06;21554;34551;64911;123;32384;68353;26;0;0;51984088;45258733;3656139;6042;50434449;3705443;2000;0;3
FR;0;2021-11-07;2430;4153;5209;6;3999;5598;7;0;0;51986518;45262886;3661348;6048;50438448;3711041;2007;0;3
FR;0;2021-11-08;20634;37741;127237;227;30950;134364;50;0;0;52007152;45300627;3788585;6275;50469398;3845405;2057;0;3
FR;0;2021-11-09;22443;44652;161745;339;32853;172362;65;0;0;52029595;45345279;3950330;6614;50502251;4017767;2122;0;3
FR;0;2021-11-10;31621;54874;187071;447;44022;198890;91;0;0;52061216;45400153;4137401;7061;50546273;4216657;2213;0;3
FR;0;2021-11-11;4750;6744;12999;28;5906;13982;17;0;0;52065966;45406897;4150400;7089;50552179;4230639;2230;0;3
FR;0;2021-11-12;29104;55049;183839;252;41712;197506;86;0;0;52095070;45461946;4334239;7341;50593891;4428145;2316;0;3
FR;0;2021-11-13;20357;32596;80731;118;28226;86355;44;0;0;52115427;45494542;4414970;7459;50622117;4514500;2360;0;3
FR;0;2021-11-14;2367;3854;7184;6;3362;7847;9;0;0;52117794;45498396;4422154;7465;50625479;4522347;2369;0;3
FR;0;2021-11-15;20525;38547;160911;314;27780;171652;77;0;0;52138319;45536943;4583065;7779;50653259;4693999;2446;0;3
FR;0;2021-11-16;23675;43823;200492;394;27699;215191;115;0;1;52161994;45580766;4783557;8173;50680958;4909190;2561;0;4
FR;0;2021-11-17;30545;50240;199905;406;36446;212974;98;0;0;52192539;45631006;4983462;8579;50717404;5122164;2659;0;4
FR;0;2021-11-18;23460;45679;191757;469;29388;205744;94;0;0;52215999;45676685;5175219;9048;50746792;5327908;2753;0;4
FR;0;2021-11-19;33696;61265;243294;551;39903;262312;147;0;0;52249695;45737950;5418513;9599;50786695;5590220;2900;0;4
FR;0;2021-11-20;25426;36659;102195;207;29267;109768;43;0;0;52275121;45774609;5520708;9806;50815962;5699988;2943;0;4
FR;0;2021-11-21;2666;4444;9683;19;3443;10609;19;0;0;52277787;45779053;5530391;9825;50819405;5710597;2962;0;4
FR;0;2021-11-22;22824;33109;180437;472;18909;194924;90;0;0;52300611;45812162;5710828;10297;50838314;5905521;3052;0;4
FR;0;2021-11-23;25738;45457;229496;549;24111;247987;85;0;0;52326349;45857619;5940324;10846;50862425;6153508;3137;0;4
FR;0;2021-11-24;31823;53590;224910;715;34472;243364;80;0;0;52358172;45911209;6165234;11561;50896897;6396872;3217;0;4
FR;0;2021-11-25;25654;49133;256031;739;25046;277941;112;0;0;52383826;45960342;6421265;12300;50921943;6674813;3329;0;4
FR;0;2021-11-26;33256;74669;379565;867;37393;414798;172;0;0;52417082;46035011;6800830;13167;50959336;7089611;3501;0;4
FR;0;2021-11-27;23508;49550;214980;391;28438;236787;135;0;0;52440590;46084561;7015810;13558;50987774;7326398;3636;0;4
FR;0;2021-11-28;3528;10441;56787;66;4057;63332;42;0;0;52444118;46095002;7072597;13624;50991831;7389730;3678;0;4
FR;0;2021-11-29;19449;54060;341575;864;23088;371913;178;0;0;52463567;46149062;7414172;14488;51014919;7761643;3856;0;4
FR;0;2021-11-30;24789;71796;457493;988;26790;500939;291;0;0;52488356;46220858;7871665;15476;51041709;8262582;4147;0;4
FR;0;2021-12-01;27401;75417;469225;1162;31306;511449;304;0;0;52515757;46296275;8340890;16638;51073015;8774031;4451;0;4
FR;0;2021-12-02;22133;71460;527256;1282;20993;575060;309;0;0;52537890;46367735;8868146;17920;51094008;9349091;4760;0;4
FR;0;2021-12-03;25582;92758;596539;1421;34320;651331;343;0;0;52563472;46460493;9464685;19341;51128328;10000422;5103;0;4
FR;0;2021-12-04;18342;60284;336314;692;25659;369891;197;0;0;52581814;46520777;9800999;20033;51153987;10370313;5300;0;4
FR;0;2021-12-05;4158;16083;95820;157;4852;107050;92;0;0;52585972;46536860;9896819;20190;51158839;10477363;5392;0;4
FR;0;2021-12-06;28452;72656;493297;1175;25213;540116;387;0;0;52614424;46609516;10390116;21365;51184052;11017479;5779;0;4
FR;0;2021-12-07;23569;91183;645592;1774;28502;706604;416;0;0;52637993;46700699;11035708;23139;51212554;11724083;6195;0;4
FR;0;2021-12-08;25527;91859;591910;1875;34931;647777;439;0;0;52663520;46792558;11627618;25014;51247485;12371860;6634;0;4
FR;0;2021-12-09;24087;94006;663388;2179;28950;726834;463;0;0;52687607;46886564;12291006;27193;51276435;13098694;7097;0;4
FR;0;2021-12-10;28079;110826;736226;2075;37923;806404;472;0;1;52715686;46997390;13027232;29268;51314358;13905098;7569;0;5
FR;0;2021-12-11;20255;76042;435258;990;29937;480485;343;0;0;52735941;47073432;13462490;30258;51344295;14385583;7912;0;5
FR;0;2021-12-12;5685;23103;142363;262;6383;159236;108;0;0;52741626;47096535;13604853;30520;51350678;14544819;8020;0;5
FR;0;2021-12-13;21372;90671;587855;1699;29628;649470;397;0;0;52762998;47187206;14192708;32219;51380306;15194289;8417;0;5
FR;0;2021-12-14;27991;118203;765826;2658;35393;847811;701;0;1;52790989;47305409;14958534;34877;51415699;16042100;9118;0;6
FR;0;2021-12-15;28458;114125;694537;2267;39482;769317;503;0;1;52819447;47419534;15653071;37144;51455181;16811417;9621;0;7
FR;0;2021-12-16;28058;115555;764279;2559;35072;844701;516;0;0;52847505;47535089;16417350;39703;51490253;17656118;10137;0;7
FR;0;2021-12-17;31665;128217;808045;2713;43319;892197;611;0;0;52879170;47663306;17225395;42416;51533572;18548315;10748;0;7
FR;0;2021-12-18;24945;81468;470067;1179;30036;522271;353;0;0;52904115;47744774;17695462;43595;51563608;19070586;11101;0;7
FR;0;2021-12-19;8771;28504;169449;376;7832;191057;143;0;0;52912886;47773278;17864911;43971;51571440;19261643;11244;0;7
FR;0;2021-12-20;31785;97009;591633;1789;33807;658845;503;0;0;52944671;47870287;18456544;45760;51605247;19920488;11747;0;7
FR;0;2021-12-21;39484;111842;682567;2391;38745;759706;607;0;0;52984155;47982129;19139111;48151;51643992;20680194;12354;0;7
FR;0;2021-12-22;39566;99103;575913;2169;37074;642230;687;0;2;53023721;48081232;19715024;50320;51681066;21322424;13041;0;9
FR;0;2021-12-23;33794;79312;441114;1659;30087;494449;589;0;0;53057515;48160544;20156138;51979;51711153;21816873;13630;0;9
FR;0;2021-12-24;10701;26011;111060;398;11636;126675;236;0;1;53068216;48186555;20267198;52377;51722789;21943548;13866;0;10
FR;0;2021-12-25;780;3565;7603;25;2047;9022;72;0;0;53068996;48190120;20274801;52402;51724836;21952570;13938;0;10
FR;0;2021-12-26;4699;11876;52128;142;4735;60172;170;0;0;53073695;48201996;20326929;52544;51729571;22012742;14108;0;10
FR;0;2021-12-27;30510;83903;453634;1364;33013;509282;665;0;0;53104205;48285899;20780563;53908;51762584;22522024;14773;0;10
FR;0;2021-12-28;38369;98787;564243;1769;35081;632340;1558;0;2;53142574;48384686;21344806;55677;51797665;23154364;16331;0;12
FR;0;2021-12-29;39882;88133;501293;1687;33081;561058;1738;0;1;53182456;48472819;21846099;57364;51830746;23715422;18069;0;13
FR;0;2021-12-30;35928;75051;421077;1521;29500;471185;1880;0;0;53218384;48547870;22267176;58885;51860246;24186607;19949;0;13
FR;0;2021-12-31;12053;25073;116896;405;11263;131680;741;0;0;53230437;48572943;22384072;59290;51871509;24318287;20690;0;13
FR;0;2022-01-01;1597;3217;8533;37;1808;9942;103;0;0;53232034;48576160;22392605;59327;51873317;24328229;20793;0;13
FR;0;2022-01-02;6131;13014;58437;126;5109;66975;408;0;0;53238165;48589174;22451042;59453;51878426;24395204;21201;0;13
FR;0;2022-01-03;39751;90136;494910;1597;36875;551790;2650;0;1;53277916;48679310;22945952;61050;51915301;24946994;23851;0;14
FR;0;2022-01-04;42316;110968;641488;2309;40642;714496;3836;0;3;53320232;48790278;23587440;63359;51955943;25661490;27687;0;17
FR;0;2022-01-05;61226;103574;569289;1985;43793;634324;3429;0;2;53381458;48893852;24156729;65344;51999736;26295814;31116;0;19
FR;0;2022-01-06;44321;110302;639069;2702;40216;711593;4555;0;2;53425779;49004154;24795798;68046;52039952;27007407;35671;0;21
FR;0;2022-01-07;50847;123278;711079;2811;46837;790563;4995;0;2;53476626;49127432;25506877;70857;52086789;27797970;40666;0;23
FR;0;2022-01-08;45015;80262;423847;1213;35043;472910;2447;0;3;53521641;49207694;25930724;72070;52121832;28270880;43113;0;26
FR;0;2022-01-09;15614;26591;128585;300;11481;145663;829;0;0;53537255;49234285;26059309;72370;52133313;28416543;43942;0;26
FR;0;2022-01-10;35425;93246;469405;1816;43021;522791;3722;0;1;53572680;49327531;26528714;74186;52176334;28939334;47664;0;27
FR;0;2022-01-11;41956;100434;548351;2311;42393;608601;5218;0;2;53614636;49427965;27077065;76497;52218727;29547935;52882;0;29
FR;0;2022-01-12;60425;95678;452752;1969;49481;504415;4497;0;8;53675061;49523643;27529817;78466;52268208;30052350;57379;0;37
FR;0;2022-01-13;38275;92511;487423;2084;40546;541105;5467;0;8;53713336;49616154;28017240;80550;52308754;30593455;62846;0;45
FR;0;2022-01-14;42590;103287;568676;2286;43497;629062;6463;0;2;53755926;49719441;28585916;82836;52352251;31222517;69309;0;47
FR;0;2022-01-15;39433;65880;340170;985;31449;377583;3296;0;1;53795359;49785321;28926086;83821;52383700;31600100;72605;0;48
FR;0;2022-01-16;11415;19194;87447;216;9016;99404;764;0;0;53806774;49804515;29013533;84037;52392716;31699504;73369;0;48
FR;0;2022-01-17;24757;59975;320338;1384;28033;354175;3960;0;4;53831531;49864490;29333871;85421;52420749;32053679;77329;0;52
FR;0;2022-01-18;28332;68677;361152;1802;32010;397600;5771;0;1;53859863;49933167;29695023;87223;52452759;32451279;83100;0;53
FR;0;2022-01-19;43231;67008;281355;1452;40384;311093;4392;0;5;53903094;50000175;29976378;88675;52493143;32762372;87492;0;58
FR;0;2022-01-20;23681;59591;299074;1750;29562;328542;5637;0;4;53926775;50059766;30275452;90425;52522705;33090914;93129;0;62
FR;0;2022-01-21;28214;68762;366415;2086;33069;401222;6580;0;3;53954989;50128528;30641867;92511;52555774;33492136;99709;0;65
FR;0;2022-01-22;27630;47971;218811;840;27302;241796;2838;0;2;53982619;50176499;30860678;93351;52583076;33733932;102547;0;67
FR;0;2022-01-23;6740;12962;48696;173;7502;55170;591;0;1;53989359;50189461;30909374;93524;52590578;33789102;103138;0;68
FR;0;2022-01-24;16287;47439;217358;1149;25400;239358;4103;0;3;54005646;50236900;31126732;94673;52615978;34028460;107241;0;71
FR;0;2022-01-25;19034;54316;243104;1548;28807;267104;6067;0;5;54024680;50291216;31369836;96221;52644785;34295564;113308;0;76
FR;0;2022-01-26;28148;60551;209319;1299;41362;229549;4479;0;3;54052828;50351767;31579155;97520;52686147;34525113;117787;0;79
FR;0;2022-01-27;16338;46488;207675;1287;26148;226066;5693;0;4;54069166;50398255;31786830;98807;52712295;34751179;123480;0;83
FR;0;2022-01-28;21594;78647;290091;1574;44966;321350;7411;0;4;54090760;50476902;32076921;100381;52757261;35072529;130891;0;87
FR;0;2022-01-29;18424;52844;184145;689;32752;204574;3255;0;2;54109184;50529746;32261066;101070;52790013;35277103;134146;0;89
FR;0;2022-01-30;4477;14461;39152;124;9129;45055;637;0;1;54113661;50544207;32300218;101194;52799142;35322158;134783;0;90
FR;0;2022-01-31;11262;43902;148219;742;26128;164720;4230;0;5;54124923;50588109;32448437;101936;52825270;35486878;139013;0;95
FR;0;2022-02-01;13653;48290;174148;1145;27329;191333;7036;0;1;54138576;50636399;32622585;103081;52852599;35678211;146049;0;96
FR;0;2022-02-02;20761;66292;171561;1035;46157;190078;5969;0;10;54159337;50702691;32794146;104116;52898756;35868289;152018;0;106
FR;0;2022-02-03;11760;44789;157585;990;25345;173287;6932;0;6;54171097;50747480;32951731;105106;52924101;36041576;158950;0;112
FR;0;2022-02-04;14647;67979;239263;1267;37603;264080;9153;0;6;54185744;50815459;33190994;106373;52961704;36305656;168103;0;118
FR;0;2022-02-05;12903;51439;153565;523;31977;172293;3784;0;3;54198647;50866898;33344559;106896;52993681;36477949;171887;0;121
FR;0;2022-02-06;2726;12168;28898;103;7289;33830;663;0;0;54201373;50879066;33373457;106999;53000970;36511779;172550;0;121
FR;0;2022-02-07;9620;46620;156906;594;24516;176303;5294;0;6;54210993;50925686;33530363;107593;53025486;36688082;177844;0;127
FR;0;2022-02-08;9817;43102;166665;870;20967;184460;7054;0;6;54220810;50968788;33697028;108463;53046453;36872542;184898;0;133
FR;0;2022-02-09;14463;58262;172360;876;35361;193068;5788;0;9;54235273;51027050;33869388;109339;53081814;37065610;190686;0;142
FR;0;2022-02-10;8731;39228;150244;881;18705;166722;6503;0;2;54244004;51066278;34019632;110220;53100519;37232332;197189;0;144
FR;0;2022-02-11;10864;55704;218522;1101;25847;243117;8322;0;3;54254868;51121982;34238154;111321;53126366;37475449;205511;0;147
FR;0;2022-02-12;8409;40970;134741;465;22637;151770;3508;0;4;54263277;51162952;34372895;111786;53149003;37627219;209019;0;151
FR;0;2022-02-13;1940;8605;26568;86;4411;30930;544;0;3;54265217;51171557;34399463;111872;53153414;37658149;209563;0;154
FR;0;2022-02-14;6998;35260;148389;487;14672;166385;4789;0;5;54272215;51206817;34547852;112359;53168086;37824534;214352;0;159
FR;0;2022-02-15;7070;36238;147003;751;16008;162588;6849;0;3;54279285;51243055;34694855;113110;53184094;37987122;221201;0;162
FR;0;2022-02-16;9417;42994;132550;722;25985;146769;5727;0;6;54288702;51286049;34827405;113832;53210079;38133891;226928;0;168
FR;0;2022-02-17;5582;24348;87320;587;13147;94895;5408;0;5;54294284;51310397;34914725;114419;53223226;38228786;232336;0;173
FR;0;2022-02-18;7003;33597;119673;807;18770;129339;7416;0;2;54301287;51343994;35034398;115226;53241996;38358125;239752;0;175
FR;0;2022-02-19;5372;24558;70030;371;15910;77340;3020;0;2;54306659;51368552;35104428;115597;53257906;38435465;242772;0;177
FR;0;2022-02-20;1152;4661;12175;39;2916;13957;460;0;1;54307811;51373213;35116603;115636;53260822;38449422;243232;0;178
FR;0;2022-02-21;4100;17896;61958;351;10173;67188;4059;0;2;54311911;51391109;35178561;115987;53270995;38516610;247291;0;180
FR;0;2022-02-22;4468;18669;60840;577;11271;64481;5255;0;1;54316379;51409778;35239401;116564;53282266;38581091;252546;0;181
FR;0;2022-02-23;6593;27364;66512;593;19632;71911;4595;0;3;54322972;51437142;35305913;117157;53301898;38653002;257141;0;184
FR;0;2022-02-24;3852;15564;50435;519;9524;53259;4531;0;2;54326824;51452706;35356348;117676;53311422;38706261;261672;0;186
FR;0;2022-02-25;5287;24299;76372;804;15274;80104;7336;0;7;54332111;51477005;35432720;118480;53326696;38786365;269008;0;193
FR;0;2022-02-26;3994;17772;47421;359;12174;51488;3083;0;3;54336105;51494777;35480141;118839;53338870;38837853;272091;0;196
FR;0;2022-02-27;881;3011;8040;47;1980;8949;531;0;0;54336986;51497788;35488181;118886;53340850;38846802;272622;0;196
FR;0;2022-02-28;3127;12563;40496;359;7597;42930;3857;0;0;54340113;51510351;35528677;119245;53348447;38889732;276479;0;196
FR;0;2022-03-01;4013;12615;44203;438;7639;44875;5519;0;6;54344126;51522966;35572880;119683;53356086;38934607;281998;0;202
FR;0;2022-03-02;5338;17901;47155;448;12961;49087;4931;0;2;54349464;51540867;35620035;120131;53369047;38983694;286929;0;204
FR;0;2022-03-03;2830;9362;29902;372;6260;30025;4051;0;2;54352294;51550229;35649937;120503;53375307;39013719;290980;0;206
FR;0;2022-03-04;3231;12524;40343;669;8522;39493;6235;0;4;54355525;51562753;35690280;121172;53383829;39053212;297215;0;210
FR;0;2022-03-05;3075;9291;24962;315;7133;25126;3136;0;1;54358600;51572044;35715242;121487;53390962;39078338;300351;0;211
FR;0;2022-03-06;522;1410;3199;43;1031;3444;379;0;0;54359122;51573454;35718441;121530;53391993;39081782;300730;0;211
FR;0;2022-03-07;2501;5636;18439;315;3853;17710;3308;0;4;54361623;51579090;35736880;121845;53395846;39099492;304038;0;215
FR;0;2022-03-08;2154;6082;19452;363;4336;17925;4093;0;3;54363777;51585172;35756332;122208;53400182;39117417;308131;0;218
FR;0;2022-03-09;3583;10572;22200;408;8799;21295;4042;0;4;54367360;51595744;35778532;122616;53408981;39138712;312173;0;222
FR;0;2022-03-10;1834;5849;17013;345;4399;15839;3408;0;3;54369194;51601593;35795545;122961;53413380;39154551;315581;0;225
FR;0;2022-03-11;2422;7568;24511;545;5446;22280;5479;0;2;54371616;51609161;35820056;123506;53418826;39176831;321060;0;227
FR;0;2022-03-12;2699;6776;17168;309;5494;16522;3137;0;2;54374315;51615937;35837224;123815;53424320;39193353;324197;0;229
FR;0;2022-03-13;407;795;2323;150;605;2272;538;0;0;54374722;51616732;35839547;123965;53424925;39195625;324735;0;229
FR;0;2022-03-14;1563;4278;14990;4412;2813;13843;7295;0;8;54376285;51621010;35854537;128377;53427738;39209468;332030;0;237
FR;0;2022-03-15;1751;6295;16387;7556;4810;14618;11036;0;9;54378036;51627305;35870924;135933;53432548;39224086;343066;0;246
FR;0;2022-03-16;3041;7415;19436;13142;6217;18113;16299;0;8;54381077;51634720;35890360;149075;53438765;39242199;359365;0;254
FR;0;2022-03-17;1466;3988;13157;10846;2809;11996;13315;0;9;54382543;51638708;35903517;159921;53441574;39254195;372680;0;263
FR;0;2022-03-18;2268;5758;20020;18307;4099;18116;22039;0;15;54384811;51644466;35923537;178228;53445673;39272311;394719;0;278
FR;0;2022-03-19;2294;4806;13116;9406;4142;12421;11409;0;6;54387105;51649272;35936653;187634;53449815;39284732;406128;0;284
FR;0;2022-03-20;302;738;1920;1074;530;1933;1340;0;2;54387407;51650010;35938573;188708;53450345;39286665;407468;0;286
FR;0;2022-03-21;1395;3222;12736;14951;2157;11962;16910;0;11;54388802;51653232;35951309;203659;53452502;39298627;424378;0;297
FR;0;2022-03-22;1557;3743;13808;20554;2581;12564;22846;0;5;54390359;51656975;35965117;224213;53455083;39311191;447224;0;302
FR;0;2022-03-23;2692;6300;17743;23152;5232;17251;25269;0;40;54393051;51663275;35982860;247365;53460315;39328442;472493;0;342
FR;0;2022-03-24;1411;3160;11601;17619;2248;10685;19395;0;23;54394462;51666435;35994461;264984;53462563;39339127;491888;0;365
FR;0;2022-03-25;2090;5160;18583;27777;3691;16922;30810;0;31;54396552;51671595;36013044;292761;53466254;39356049;522698;0;396
FR;0;2022-03-26;2232;4418;12080;12680;3866;11521;14402;0;26;54398784;51676013;36025124;305441;53470120;39367570;537100;0;422
FR;0;2022-03-27;365;693;1909;1483;515;1943;1740;0;1;54399149;51676706;36027033;306924;53470635;39369513;538840;0;423
FR;0;2022-03-28;1468;3083;11133;17490;2121;10621;19070;0;16;54400617;51679789;36038166;324414;53472756;39380134;557910;0;439
FR;0;2022-03-29;1452;3286;12913;27586;2100;12055;29285;0;34;54402069;51683075;36051079;352000;53474856;39392189;587195;0;473
FR;0;2022-03-30;2854;5590;15691;27435;4774;15091;29341;0;21;54404923;51688665;36066770;379435;53479630;39407280;616536;0;494
FR;0;2022-03-31;1615;3585;12992;25042;2570;12331;26652;0;43;54406538;51692250;36079762;404477;53482200;39419611;643188;0;537
FR;0;2022-04-01;2690;4588;20084;30896;2974;18726;33489;0;62;54409228;51696838;36099846;435373;53485174;39438337;676677;0;599
FR;0;2022-04-02;1532;2649;9054;10136;2009;8728;11298;0;29;54410760;51699487;36108900;445509;53487183;39447065;687975;0;628
FR;0;2022-04-03;294;516;1563;1171;360;1581;1382;0;2;54411054;51700003;36110463;446680;53487543;39448646;689357;0;630
FR;0;2022-04-04;4570;3032;12390;19132;2055;11598;20605;0;35;54415624;51703035;36122853;465812;53489598;39460244;709962;0;665
FR;0;2022-04-05;2608;3178;14354;34151;2055;13207;35769;0;85;54418232;51706213;36137207;499963;53491653;39473451;745731;0;750
FR;0;2022-04-06;2613;3964;13546;26556;3030;12821;28025;0;72;54420845;51710177;36150753;526519;53494683;39486272;773756;0;822
FR;0;2022-04-07;1989;3151;13687;33822;1999;12901;35178;0;76;54422834;51713328;36164440;560341;53496682;39499173;808934;0;898
FR;0;2022-04-08;2310;4345;19236;44016;2675;17862;46369;0;89;54425144;51717673;36183676;604357;53499357;39517035;855303;0;987
FR;0;2022-04-09;1374;2682;9315;13568;1905;8869;14800;0;30;54426518;51720355;36192991;617925;53501262;39525904;870103;0;1017
FR;0;2022-04-10;296;757;1985;2017;555;2007;2279;0;7;54426814;51721112;36194976;619942;53501817;39527911;872382;0;1024
FR;0;2022-04-11;1351;2634;11876;23935;1655;11483;25207;0;74;54428165;51723746;36206852;643877;53503472;39539394;897589;0;1098
FR;0;2022-04-12;1729;3083;14025;40929;1967;13397;41819;0;127;54429894;51726829;36220877;684806;53505439;39552791;939408;0;1225
FR;0;2022-04-13;1978;3723;13416;33118;2720;13038;34087;0;96;54431872;51730552;36234293;717924;53508159;39565829;973495;0;1321
FR;0;2022-04-14;1510;3016;13216;36355;1944;13074;37024;0;105;54433382;51733568;36247509;754279;53510103;39578903;1010519;0;1426
FR;0;2022-04-15;1884;3882;15645;35584;2624;14927;37235;0;115;54435266;51737450;36263154;789863;53512727;39593830;1047754;0;1541
FR;0;2022-04-16;1046;1834;6400;8553;1263;6263;9435;0;40;54436312;51739284;36269554;798416;53513990;39600093;1057189;0;1581
FR;0;2022-04-17;195;340;993;1174;224;1036;1242;0;7;54436507;51739624;36270547;799590;53514214;39601129;1058431;0;1588
FR;0;2022-04-18;201;561;2768;1072;358;2787;1287;0;5;54436708;51740185;36273315;800662;53514572;39603916;1059718;0;1593
FR;0;2022-04-19;1547;3031;12919;29691;1879;12480;30738;0;78;54438255;51743216;36286234;830353;53516451;39616396;1090456;0;1671
FR;0;2022-04-20;2009;3499;13308;29072;2612;12996;30088;0;96;54440264;51746715;36299542;859425;53519063;39629392;1120544;0;1767
FR;0;2022-04-21;1516;2857;12554;35212;1828;12647;35786;0;117;54441780;51749572;36312096;894637;53520891;39642039;1156330;0;1884
FR;0;2022-04-22;1880;3627;16482;37646;2402;15847;39178;0;132;54443660;51753199;36328578;932283;53523293;39657886;1195508;0;2016
FR;0;2022-04-23;1151;2072;7391;10661;1482;7242;11446;0;38;54444811;51755271;36335969;942944;53524775;39665128;1206954;0;2054
FR;0;2022-04-24;249;467;1478;1592;326;1414;1850;0;7;54445060;51755738;36337447;944536;53525101;39666542;1208804;0;2061
FR;0;2022-04-25;1308;2535;10688;21082;1614;10501;22096;0;79;54446368;51758273;36348135;965618;53526715;39677043;1230900;0;2140
FR;0;2022-04-26;1627;3008;13671;38666;1967;13114;39463;0;181;54447995;51761281;36361806;1004284;53528682;39690157;1270363;0;2321
FR;0;2022-04-27;1965;3068;11540;31089;2283;11597;31507;0;131;54449960;51764349;36373346;1035373;53530965;39701754;1301870;0;2452
FR;0;2022-04-28;1571;2783;12530;36269;1866;12271;36586;0;139;54451531;51767132;36385876;1071642;53532831;39714025;1338456;0;2591
FR;0;2022-04-29;2011;4834;15561;37281;3639;14938;38751;0;164;54453542;51771966;36401437;1108923;53536470;39728963;1377207;0;2755
FR;0;2022-04-30;1225;4702;6929;9717;4196;6758;10608;0;44;54454767;51776668;36408366;1118640;53540666;39735721;1387815;0;2799
FR;0;2022-05-01;221;325;916;1000;229;911;1141;0;6;54454988;51776993;36409282;1119640;53540895;39736632;1388956;0;2805
FR;0;2022-05-02;2364;2970;11160;18182;2066;10994;19026;0;69;54457352;51779963;36420442;1137822;53542961;39747626;1407982;0;2874
FR;0;2022-05-03;2067;3269;13727;34707;2129;13571;35625;0;163;54459419;51783232;36434169;1172529;53545090;39761197;1443607;0;3037
FR;0;2022-05-04;1926;3302;12188;25650;2302;12305;26202;0;110;54461345;51786534;36446357;1198179;53547392;39773502;1469809;0;3147
FR;0;2022-05-05;1796;3041;13070;33602;2018;12916;34270;0;180;54463141;51789575;36459427;1231781;53549410;39786418;1504079;0;3327
FR;0;2022-05-06;2218;3667;15360;36828;2326;14877;38283;0;182;54465359;51793242;36474787;1268609;53551736;39801295;1542362;0;3509
FR;0;2022-05-07;1210;1783;6464;9614;1255;6456;10339;0;48;54466569;51795025;36481251;1278223;53552991;39807751;1552701;0;3557
FR;0;2022-05-08;267;400;1175;1548;288;1236;1654;0;8;54466836;51795425;36482426;1279771;53553279;39808987;1554355;0;3565
FR;0;2022-05-09;1404;2307;9927;20259;1414;9798;21175;0;102;54468240;51797732;36492353;1300030;53554693;39818785;1575530;0;3667
FR;0;2022-05-10;1803;3432;13576;39001;2296;13133;40027;0;200;54470043;51801164;36505929;1339031;53556989;39831918;1615557;0;3867
FR;0;2022-05-11;2004;3022;10756;27943;2326;10701;28447;0;146;54472047;51804186;36516685;1366974;53559315;39842619;1644004;0;4013
FR;0;2022-05-12;1595;2747;11387;35762;1817;11056;36527;0;211;54473642;51806933;36528072;1402736;53561132;39853675;1680531;0;4224
FR;0;2022-05-13;1985;3224;13761;37981;2069;13350;39246;0;162;54475627;51810157;36541833;1440717;53563201;39867025;1719777;0;4386
FR;0;2022-05-14;1150;1648;5938;10778;1207;5801;11366;0;58;54476777;51811805;36547771;1451495;53564408;39872826;1731143;0;4444
FR;0;2022-05-15;283;480;1278;1440;303;1361;1593;0;6;54477060;51812285;36549049;1452935;53564711;39874187;1732736;0;4450
FR;0;2022-05-16;1200;2047;8696;21072;1248;8702;21599;0;128;54478260;51814332;36557745;1474007;53565959;39882889;1754335;0;4578
FR;0;2022-05-17;1593;2605;11828;37885;1671;11405;38726;0;180;54479853;51816937;36569573;1511892;53567630;39894294;1793061;0;4758
FR;0;2022-05-18;1816;2655;9694;27166;1957;9667;27785;0;109;54481669;51819592;36579267;1539058;53569587;39903961;1820846;0;4867
FR;0;2022-05-19;1451;2660;10581;35846;1636;10721;36037;0;162;54483120;51822252;36589848;1574904;53571223;39914682;1856883;0;5029
FR;0;2022-05-20;1876;3118;13426;39369;2080;12913;40389;0;168;54484996;51825370;36603274;1614273;53573303;39927595;1897272;0;5197
FR;0;2022-05-21;1159;1718;5662;9897;1314;5533;10534;0;45;54486155;51827088;36608936;1624170;53574617;39933128;1907806;0;5242
FR;0;2022-05-22;241;341;1032;1440;263;1017;1585;0;10;54486396;51827429;36609968;1625610;53574880;39934145;1909391;0;5252
FR;0;2022-05-23;1176;2127;8880;20375;1411;8830;21030;0;86;54487572;51829556;36618848;1645985;53576291;39942975;1930421;0;5338
FR;0;2022-05-24;1542;2759;11367;38886;1736;11239;39515;0;190;54489114;51832315;36630215;1684871;53578027;39954214;1969936;0;5528
FR;0;2022-05-25;1814;2842;9343;24847;2080;9481;25323;0;116;54490928;51835157;36639558;1709718;53580107;39963695;1995259;0;5644
FR;0;2022-05-26;216;430;1666;1201;293;1677;1344;0;26;54491144;51835587;36641224;1710919;53580400;39965372;1996603;0;5670
FR;0;2022-05-27;1390;2477;9266;21291;1670;9006;22325;0;94;54492534;51838064;36650490;1732210;53582070;39974378;2018928;0;5764
FR;0;2022-05-28;669;1272;3919;6795;852;3968;7204;0;38;54493203;51839336;36654409;1739005;53582922;39978346;2026132;0;5802
FR;0;2022-05-29;157;315;753;921;200;774;1033;0;4;54493360;51839651;36655162;1739926;53583122;39979120;2027165;0;5806
FR;0;2022-05-30;1026;1969;6995;19296;1249;7013;19808;0;91;54494386;51841620;36662157;1759222;53584371;39986133;2046973;0;5897
FR;0;2022-05-31;1488;2522;9823;35664;1649;9645;36295;0;171;54495874;51844142;36671980;1794886;53586020;39995778;2083268;0;6068
FR;0;2022-06-01;1754;3106;11028;24538;2256;10896;25490;0;122;54497628;51847248;36683008;1819424;53588276;40006674;2108758;0;6190
FR;0;2022-06-02;1480;2615;11310;35606;1718;10865;36552;0;174;54499108;51849863;36694318;1855030;53589994;40017539;2145310;0;6364
FR;0;2022-06-03;1729;3085;13424;38731;2054;12789;40001;0;176;54500837;51852948;36707742;1893761;53592048;40030328;2185311;0;6540
FR;0;2022-06-04;975;1517;5046;9114;1077;5117;9650;0;73;54501812;51854465;36712788;1902875;53593125;40035445;2194961;0;6613
FR;0;2022-06-05;181;336;876;1108;207;887;1230;0;4;54501993;51854801;36713664;1903983;53593332;40036332;2196191;0;6617
FR;0;2022-06-06;896;1255;2125;1329;1081;2142;1510;0;13;54502889;51856056;36715789;1905312;53594413;40038474;2197701;0;6630
FR;0;2022-06-07;1499;2713;9857;35598;1794;9435;36825;0;153;54504388;51858769;36725646;1940910;53596207;40047909;2234526;0;6783
FR;0;2022-06-08;1585;2699;9178;28791;1942;9021;29757;0;112;54505973;51861468;36734824;1969701;53598149;40056930;2264283;0;6895
FR;0;2022-06-09;1297;2443;10622;39505;1556;10267;40280;0;167;54507270;51863911;36745446;2009206;53599705;40067197;2304563;0;7062
FR;0;2022-06-10;1631;3195;13107;44828;2161;12669;46153;0;223;54508901;51867106;36758553;2054034;53601866;40079866;2350716;0;7285
FR;0;2022-06-11;962;1739;5432;11627;1125;5465;12212;0;55;54509863;51868845;36763985;2065661;53602991;40085331;2362928;0;7340
FR;0;2022-06-12;203;446;1079;1765;255;1143;1866;0;11;54510066;51869291;36765064;2067426;53603246;40086474;2364794;0;7351
FR;0;2022-06-13;1127;2070;7440;23183;1344;7270;24099;0;90;54511193;51871361;36772504;2090609;53604590;40093744;2388893;0;7441
FR;0;2022-06-14;1347;2550;10449;44949;1598;9808;46144;0;200;54512540;51873911;36782953;2135558;53606188;40103552;2435037;0;7641
FR;0;2022-06-15;1529;2466;9326;30927;1935;8965;31617;0;180;54514069;51876377;36792279;2166485;53608123;40112517;2466654;0;7821
FR;0;2022-06-16;1189;2045;9921;39933;1281;9330;40954;0;201;54515258;51878422;36802200;2206418;53609404;40121847;2507608;0;8022
FR;0;2022-06-17;1494;2859;12513;46699;1788;11920;47935;0;240;54516752;51881281;36814713;2253117;53611192;40133767;2555543;0;8262
FR;0;2022-06-18;857;1527;4567;11125;1038;4501;11720;0;67;54517609;51882808;36819280;2264242;53612230;40138268;2567263;0;8329
FR;0;2022-06-19;183;363;1059;1615;208;1131;1701;0;14;54517792;51883171;36820339;2265857;53612438;40139399;2568964;0;8343
FR;0;2022-06-20;1027;1928;8908;26081;1204;8569;27022;0;156;54518819;51885099;36829247;2291938;53613642;40147968;2595986;0;8499
FR;0;2022-06-21;1329;2405;10310;49898;1540;9340;51283;0;264;54520148;51887504;36839557;2341836;53615182;40157308;2647269;0;8763
FR;0;2022-06-22;1398;2519;8920;39067;1809;8430;40009;0;256;54521546;51890023;36848477;2380903;53616991;40165738;2687278;0;9019
FR;0;2022-06-23;1229;2371;10680;55115;1366;9886;56247;0;320;54522775;51892394;36859157;2436018;53618357;40175624;2743525;0;9339
FR;0;2022-06-24;1493;2997;13647;69186;1751;12309;71005;0;405;54524268;51895391;36872804;2505204;53620108;40187933;2814530;0;9744
FR;0;2022-06-25;939;1781;6236;19923;1112;5989;20778;0;177;54525207;51897172;36879040;2525127;53621220;40193922;2835308;0;9921
FR;0;2022-06-26;229;459;1953;3688;259;1818;3966;0;39;54525436;51897631;36880993;2528815;53621479;40195740;2839274;0;9960
FR;0;2022-06-27;1134;2026;10493;48497;1179;9636;49765;0;339;54526570;51899657;36891486;2577312;53622658;40205376;2889039;0;10299
FR;0;2022-06-28;1464;2816;14673;91426;1585;13092;93194;0;624;54528034;51902473;36906159;2668738;53624243;40218468;2982233;0;10923
FR;0;2022-06-29;1713;2835;12294;71899;1848;11242;73040;0;548;54529747;51905308;36918453;2740637;53626091;40229710;3055273;0;11471
FR;0;2022-06-30;1538;2737;14395;95168;1661;12477;97185;0;724;54531285;51908045;36932848;2835805;53627752;40242187;3152458;0;12195
FR;0;2022-07-01;2017;3807;21509;115937;2310;18861;118587;0;954;54533302;51911852;36954357;2951742;53630062;40261048;3271045;0;13149
FR;0;2022-07-02;1088;1859;8529;35755;1108;7705;36876;0;342;54534390;51913711;36962886;2987497;53631170;40268753;3307921;0;13491
FR;0;2022-07-03;294;539;2095;6456;320;1898;6805;0;79;54534684;51914250;36964981;2993953;53631490;40270651;3314726;0;13570
FR;0;2022-07-04;1972;3471;14714;79236;2338;12993;81308;0;639;54536656;51917721;36979695;3073189;53633828;40283644;3396034;0;14209
FR;0;2022-07-05;1799;3173;18842;133282;1805;16025;135573;0;1146;54538455;51920894;36998537;3206471;53635633;40299669;3531607;0;15355
FR;0;2022-07-06;1849;2794;15858;99604;1856;13651;101172;0;900;54540304;51923688;37014395;3306075;53637489;40313320;3632779;0;16255
FR;0;2022-07-07;1717;2872;18010;126042;1712;14789;128369;0;1179;54542021;51926560;37032405;3432117;53639201;40328109;3761148;0;17434
FR;0;2022-07-08;1894;3153;20756;137093;1857;16769;140085;0;1347;54543915;51929713;37053161;3569210;53641058;40344878;3901233;0;18781
FR;0;2022-07-09;868;1464;7746;37928;883;6693;38769;0;426;54544783;51931177;37060907;3607138;53641941;40351571;3940002;0;19207
FR;0;2022-07-10;272;687;2346;7004;441;2125;7395;0;94;54545055;51931864;37063253;3614142;53642382;40353696;3947397;0;19301
FR;0;2022-07-11;1459;2483;15020;88289;1405;12514;90476;0;801;54546514;51934347;37078273;3702431;53643787;40366210;4037873;0;20102
FR;0;2022-07-12;1844;3121;20538;143974;1716;16735;146678;0;1604;54548358;51937468;37098811;3846405;53645503;40382945;4184551;0;21706
FR;0;2022-07-13;1784;2755;15697;94543;1666;13278;96402;0;1080;54550142;51940223;37114508;3940948;53647169;40396223;4280953;0;22786
FR;0;2022-07-14;187;371;1957;5540;221;1836;5707;0;82;54550329;51940594;37116465;3946488;53647390;40398059;4286660;0;22868
FR;0;2022-07-15;1487;2575;15118;84465;1441;12601;86624;0;1035;54551816;51943169;37131583;4030953;53648831;40410660;4373284;0;23903
FR;0;2022-07-16;628;1193;5949;24982;699;5155;25674;0;327;54552444;51944362;37137532;4055935;53649530;40415815;4398958;0;24230
FR;0;2022-07-17;182;395;1738;4666;218;1570;4938;0;66;54552626;51944757;37139270;4060601;53649748;40417385;4403896;0;24296
FR;0;2022-07-18;1132;2252;11829;61810;1342;9979;63673;0;780;54553758;51947009;37151099;4122411;53651090;40427364;4467569;0;25076
FR;0;2022-07-19;1423;2355;15475;103709;1396;12296;105898;0;1459;54555181;51949364;37166574;4226120;53652486;40439660;4573467;0;26535
FR;0;2022-07-20;1430;2302;12970;77586;1470;10744;79173;0;1051;54556611;51951666;37179544;4303706;53653956;40450404;4652640;0;27586
FR;0;2022-07-21;1289;2172;13098;88245;1372;10500;89730;0;1316;54557900;51953838;37192642;4391951;53655328;40460904;4742370;0;28902
FR;0;2022-07-22;1433;2490;14833;89554;1470;11974;91420;0;1347;54559333;51956328;37207475;4481505;53656798;40472878;4833790;0;30249
FR;0;2022-07-23;685;1310;5536;22482;821;4858;23081;0;411;54560018;51957638;37213011;4503987;53657619;40477736;4856871;0;30660
FR;0;2022-07-24;186;353;1401;3905;204;1243;4132;0;72;54560204;51957991;37214412;4507892;53657823;40478979;4861003;0;30732
FR;0;2022-07-25;1061;1797;9493;48082;1149;7845;49519;0;737;54561265;51959788;37223905;4555974;53658972;40486824;4910522;0;31469
FR;0;2022-07-26;1301;2214;13308;85439;1323;10829;87137;0;1311;54562566;51962002;37237213;4641413;53660295;40497653;4997659;0;32780
FR;0;2022-07-27;1226;2008;10236;61318;1341;8530;62522;0;971;54563792;51964010;37247449;4702731;53661636;40506183;5060181;0;33751
FR;0;2022-07-28;1094;1864;10313;64420;1261;8226;65648;0;1046;54564886;51965874;37257762;4767151;53662897;40514409;5125829;0;34797
FR;0;2022-07-29;1282;2078;11011;65901;1387;8765;67331;0;1140;54566168;51967952;37268773;4833052;53664284;40523174;5193160;0;35937
FR;0;2022-07-30;503;867;3523;15283;604;2974;15666;0;303;54566671;51968819;37272296;4848335;53664888;40526148;5208826;0;36240
FR;0;2022-07-31;154;289;929;2439;185;788;2588;0;49;54566825;51969108;37273225;4850774;53665073;40526936;5211414;0;36289
FR;0;2022-08-01;1005;1670;7600;30240;1262;6399;31314;0;549;54567830;51970778;37280825;4881014;53666335;40533335;5242728;0;36838
FR;0;2022-08-02;1056;1650;8582;56131;1157;6895;56808;0;1170;54568886;51972428;37289407;4937145;53667492;40540230;5299536;0;38008
FR;0;2022-08-03;852;1266;6430;38683;903;5150;39421;0;702;54569738;51973694;37295837;4975828;53668395;40545380;5338957;0;38710
FR;0;2022-08-04;741;1187;6575;43161;783;5307;43726;0;917;54570479;51974881;37302412;5018989;53669178;40550687;5382683;0;39627
FR;0;2022-08-05;861;1364;7099;44976;972;5681;45631;0;993;54571340;51976245;37309511;5063965;53670150;40556368;5428314;0;40620
FR;0;2022-08-06;341;560;2101;9368;401;1759;9568;0;228;54571681;51976805;37311612;5073333;53670551;40558127;5437882;0;40848
FR;0;2022-08-07;104;163;536;1627;120;453;1703;0;38;54571785;51976968;37312148;5074960;53670671;40558580;5439585;0;40886
FR;0;2022-08-08;676;1165;4030;22109;921;3293;22544;0;490;54572461;51978133;37316178;5097069;53671592;40561873;5462129;0;41376
FR;0;2022-08-09;748;1167;5973;39963;854;4804;40446;0;844;54573209;51979300;37322151;5137032;53672446;40566677;5502575;0;42220
FR;0;2022-08-10;674;1293;4656;28058;1008;3797;28392;0;652;54573883;51980593;37326807;5165090;53673454;40570474;5530967;0;42872
FR;0;2022-08-11;640;1030;4493;29253;744;3713;29589;0;676;54574523;51981623;37331300;5194343;53674198;40574187;5560556;0;43548
FR;0;2022-08-12;849;1167;4747;28219;851;3920;28656;0;704;54575372;51982790;37336047;5222562;53675049;40578107;5589212;0;44252
FR;0;2022-08-13;363;428;1295;5260;325;1120;5419;0;121;54575735;51983218;37337342;5227822;53675374;40579227;5594631;0;44373
FR;0;2022-08-14;74;121;289;923;104;247;995;0;25;54575809;51983339;37337631;5228745;53675478;40579474;5595626;0;44398
FR;0;2022-08-15;117;232;610;564;198;558;618;0;19;54575926;51983571;37338241;5229309;53675676;40580032;5596244;0;44417
FR;0;2022-08-16;646;1078;3962;22179;840;3356;22372;0;615;54576572;51984649;37342203;5251488;53676516;40583388;5618616;0;45032
FR;0;2022-08-17;654;1041;3890;22900;816;3294;23141;0;620;54577226;51985690;37346093;5274388;53677332;40586682;5641757;0;45652
FR;0;2022-08-18;637;1002;4124;26312;806;3262;26545;0;673;54577863;51986692;37350217;5300700;53678138;40589944;5668302;0;46325
FR;0;2022-08-19;607;1167;4493;27259;875;3694;27565;0;766;54578470;51987859;37354710;5327959;53679013;40593638;5695867;0;47091
FR;0;2022-08-20;311;504;1356;5569;402;1171;5728;0;146;54578781;51988363;37356066;5333528;53679415;40594809;5701595;0;47237
FR;0;2022-08-21;97;135;305;1009;96;267;1044;0;27;54578878;51988498;37356371;5334537;53679511;40595076;5702639;0;47264
FR;0;2022-08-22;584;1002;3274;15358;780;2798;15688;0;425;54579462;51989500;37359645;5349895;53680291;40597874;5718327;0;47689
FR;0;2022-08-23;733;1180;4299;29002;853;3610;29091;0;870;54580195;51990680;37363944;5378897;53681144;40601484;5747418;0;48559
FR;0;2022-08-24;670;940;3498;19539;786;2860;19729;0;608;54580865;51991620;37367442;5398436;53681930;40604344;5767147;0;49167
FR;0;2022-08-25;626;1025;3947;23402;731;3295;23666;0;673;54581491;51992645;37371389;5421838;53682661;40607639;5790813;0;49840
FR;0;2022-08-26;862;1266;4478;25884;961;3671;26257;0;777;54582353;51993911;37375867;5447722;53683622;40611310;5817070;0;50617
FR;0;2022-08-27;299;500;1379;5469;362;1244;5533;0;194;54582652;51994411;37377246;5453191;53683984;40612554;5822603;0;50811
FR;0;2022-08-28;125;163;303;921;117;288;966;0;38;54582777;51994574;37377549;5454112;53684101;40612842;5823569;0;50849
FR;0;2022-08-29;623;970;3076;14679;770;2614;14985;0;433;54583400;51995544;37380625;5468791;53684871;40615456;5838554;0;51282
FR;0;2022-08-30;855;1224;4796;28553;900;3914;28883;0;823;54584255;51996768;37385421;5497344;53685771;40619370;5867437;0;52105
FR;0;2022-08-31;697;958;3207;17647;745;2718;17911;0;508;54584952;51997726;37388628;5514991;53686516;40622088;5885348;0;52613
FR;0;2022-09-01;763;997;4480;22502;709;3827;22768;0;623;54585715;51998723;37393108;5537493;53687225;40625915;5908116;0;53236
FR;0;2022-09-02;998;1161;5045;28615;849;4258;28909;0;914;54586713;51999884;37398153;5566108;53688074;40630173;5937025;0;54150
FR;0;2022-09-03;422;571;1920;6086;425;1667;6323;0;181;54587135;52000455;37400073;5572194;53688499;40631840;5943348;0;54331
FR;0;2022-09-04;135;150;351;876;85;347;945;0;24;54587270;52000605;37400424;5573070;53688584;40632187;5944293;0;54355
FR;0;2022-09-05;779;918;3178;16065;739;2658;16379;0;523;54588049;52001523;37403602;5589135;53689323;40634845;5960672;0;54878
FR;0;2022-09-06;925;1051;4740;31853;681;3873;32082;0;1040;54588974;52002574;37408342;5620988;53690004;40638718;5992754;0;55918
FR;0;2022-09-07;713;791;3000;16822;573;2482;16972;0;573;54589687;52003365;37411342;5637810;53690577;40641200;6009726;0;56491
FR;0;2022-09-08;635;862;3810;24866;597;3142;24957;0;818;54590322;52004227;37415152;5662676;53691174;40644342;6034683;0;57309
FR;0;2022-09-09;852;1041;4444;27660;683;3686;27836;0;951;54591174;52005268;37419596;5690336;53691857;40648028;6062519;0;58260
FR;0;2022-09-10;408;654;1739;5711;480;1539;5917;0;207;54591582;52005922;37421335;5696047;53692337;40649567;6068436;0;58467
FR;0;2022-09-11;124;131;324;657;93;307;716;0;17;54591706;52006053;37421659;5696704;53692430;40649874;6069152;0;58484
FR;0;2022-09-12;523;646;2691;13297;463;2296;13590;0;478;54592229;52006699;37424350;5710001;53692893;40652170;6082742;0;58962
FR;0;2022-09-13;683;873;4001;26521;562;3490;26398;0;875;54592912;52007572;37428351;5736522;53693455;40655660;6109140;0;59837
FR;0;2022-09-14;710;803;2968;16188;595;2485;16421;0;573;54593622;52008375;37431319;5752710;53694050;40658145;6125561;0;60410
FR;0;2022-09-15;579;849;3478;23587;602;2967;23656;0;728;54594201;52009224;37434797;5776297;53694652;40661112;6149217;0;61138
FR;0;2022-09-16;799;1051;4147;25919;734;3489;26139;0;932;54595000;52010275;37438944;5802216;53695386;40664601;6175356;0;62070
FR;0;2022-09-17;395;513;1454;6146;392;1284;6238;0;243;54595395;52010788;37440398;5808362;53695778;40665885;6181594;0;62313
FR;0;2022-09-18;117;144;324;962;123;292;1017;0;37;54595512;52010932;37440722;5809324;53695901;40666177;6182611;0;62350
FR;0;2022-09-19;482;648;2262;13220;451;1936;13402;0;437;54595994;52011580;37442984;5822544;53696352;40668113;6196013;0;62787
FR;0;2022-09-20;646;904;3791;26462;659;3158;26516;0;893;54596640;52012484;37446775;5849006;53697011;40671271;6222529;0;63680
FR;0;2022-09-21;591;776;2740;16259;580;2355;16250;0;587;54597231;52013260;37449515;5865265;53697591;40673626;6238779;0;64267
FR;0;2022-09-22;601;853;3426;23636;575;2810;23850;0;775;54597832;52014113;37452941;5888901;53698166;40676436;6262629;0;65042
FR;0;2022-09-23;839;1053;4495;28732;776;3764;28903;0;1021;54598671;52015166;37457436;5917633;53698942;40680200;6291532;0;66063
FR;0;2022-09-24;428;615;1648;6907;474;1422;7091;0;308;54599099;52015781;37459084;5924540;53699416;40681622;6298623;0;66371
FR;0;2022-09-25;99;194;336;1101;149;307;1143;0;37;54599198;52015975;37459420;5925641;53699565;40681929;6299766;0;66408
FR;0;2022-09-26;437;715;2300;13545;485;2019;13650;0;435;54599635;52016690;37461720;5939186;53700050;40683948;6313416;0;66843
FR;0;2022-09-27;615;845;3627;25944;615;2910;26099;0;959;54600250;52017535;37465347;5965130;53700665;40686858;6339515;0;67802
FR;0;2022-09-28;635;828;2557;15403;635;2305;15516;0;622;54600885;52018363;37467904;5980533;53701300;40689163;6355031;0;68424
FR;0;2022-09-29;566;770;3138;21058;547;2651;21088;43;810;54601451;52019133;37471042;6001591;53701847;40691814;6376119;43;69234
FR;0;2022-09-30;787;1125;3957;25563;845;3302;25831;715;1052;54602238;52020258;37474999;6027154;53702692;40695116;6401950;758;70286
FR;0;2022-10-01;431;718;2009;5975;566;1737;6212;396;318;54602669;52020976;37477008;6033129;53703258;40696853;6408162;1154;70604
FR;0;2022-10-02;63;136;218;639;97;215;665;66;42;54602732;52021112;37477226;6033768;53703355;40697068;6408827;1220;70646
FR;0;2022-10-03;632;951;2469;12053;785;2195;12231;2074;745;54603364;52022063;37479695;6045821;53704140;40699263;6421058;3294;71391
FR;0;2022-10-04;756;834;3394;23508;580;2786;23685;4704;1585;54604120;52022897;37483089;6069329;53704720;40702049;6444743;7998;72976
FR;0;2022-10-05;607;854;2448;14609;633;2163;14750;3658;1210;54604727;52023751;37485537;6083938;53705353;40704212;6459493;11656;74186
FR;0;2022-10-06;552;742;3090;21689;543;2522;21898;6668;1910;54605279;52024493;37488627;6105627;53705896;40706734;6481391;18324;76096
FR;0;2022-10-07;735;1015;4129;30310;742;3478;30398;16875;3207;54606014;52025508;37492756;6135937;53706638;40710212;6511789;35199;79303
FR;0;2022-10-08;356;521;1651;8432;383;1410;8601;6699;1171;54606370;52026029;37494407;6144369;53707021;40711622;6520390;41898;80474
FR;0;2022-10-09;109;143;337;1587;117;312;1650;1511;297;54606479;52026172;37494744;6145956;53707138;40711934;6522040;43409;80771
FR;0;2022-10-10;509;842;2932;20565;658;2523;20887;19597;3272;54606988;52027014;37497676;6166521;53707796;40714457;6542927;63006;84043
FR;0;2022-10-11;620;814;4270;40342;555;3573;40685;40193;6391;54607608;52027828;37501946;6206863;53708351;40718030;6583612;103199;90434
FR;0;2022-10-12;605;858;3268;26759;639;2776;27089;27307;4696;54608213;52028686;37505214;6233622;53708990;40720806;6610701;130506;95130
FR;0;2022-10-13;627;818;4017;38465;609;3138;38924;40609;6608;54608840;52029504;37509231;6272087;53709599;40723944;6649625;171115;101738
FR;0;2022-10-14;761;1074;4873;47668;784;3959;48143;51137;7864;54609601;52030578;37514104;6319755;53710383;40727903;6697768;222252;109602
FR;0;2022-10-15;368;590;1868;11851;429;1630;11965;13091;2274;54609969;52031168;37515972;6331606;53710812;40729533;6709733;235343;111876
FR;0;2022-10-16;94;136;372;1967;86;356;2012;2347;479;54610063;52031304;37516344;6333573;53710898;40729889;6711745;237690;112355
FR;0;2022-10-17;440;712;3044;26466;497;2487;26838;30793;5409;54610503;52032016;37519388;6360039;53711395;40732376;6738583;268483;117764
FR;0;2022-10-18;610;736;4706;46102;535;3762;46667;55450;11701;54611113;52032752;37524094;6406141;53711930;40736138;6785250;323933;129465
FR;0;2022-10-19;570;820;3645;34378;625;3076;34756;42482;9263;54611683;52033572;37527739;6440519;53712555;40739214;6820006;366415;138728
FR;0;2022-10-20;617;807;4844;49475;595;3731;50132;60538;12937;54612300;52034379;37532583;6489994;53713150;40742945;6870138;426953;151665
FR;0;2022-10-21;690;996;5710;57045;711;4519;57715;70967;14299;54612990;52035375;37538293;6547039;53713861;40747464;6927853;497920;165964
FR;0;2022-10-22;335;413;1655;12950;335;1321;13107;15939;3386;54613325;52035788;37539948;6559989;53714196;40748785;6940960;513859;169350
FR;0;2022-10-23;98;107;350;2064;102;266;2166;2758;631;54613423;52035895;37540298;6562053;53714298;40749051;6943126;516617;169981
FR;0;2022-10-24;552;600;3137;27137;425;2687;27565;35497;7810;54613975;52036495;37543435;6589190;53714723;40751738;6970691;552114;177791
FR;0;2022-10-25;598;726;4873;49117;535;3805;49791;65256;15451;54614573;52037221;37548308;6638307;53715258;40755543;7020482;617370;193242
FR;0;2022-10-26;535;645;3476;32623;485;2901;32930;44001;11024;54615108;52037866;37551784;6670930;53715743;40758444;7053412;661371;204266
FR;0;2022-10-27;592;698;4082;40797;499;3349;41274;54477;13138;54615700;52038564;37555866;6711727;53716242;40761793;7094686;715848;217404
FR;0;2022-10-28;706;872;4610;44190;638;3505;45009;58280;13189;54616406;52039436;37560476;6755917;53716880;40765298;7139695;774128;230593
FR;0;2022-10-29;260;364;1328;9499;262;1082;9633;12523;3012;54616666;52039800;37561804;6765416;53717142;40766380;7149328;786651;233605
FR;0;2022-10-30;87;122;287;1598;98;249;1646;2145;540;54616753;52039922;37562091;6767014;53717240;40766629;7150974;788796;234145
FR;0;2022-10-31;382;489;2075;16062;358;1626;16427;22207;5505;54617135;52040411;37564166;6783076;53717598;40768255;7167401;811003;239650
FR;0;2022-11-01;136;196;929;1123;153;963;1166;1697;504;54617271;52040607;37565095;6784199;53717751;40769218;7168567;812700;240154
FR;0;2022-11-02;527;676;3038;25403;506;2584;25881;36654;10143;54617798;52041283;37568133;6809602;53718257;40771802;7194448;849354;250297
FR;0;2022-11-03;645;704;4114;40066;538;3119;40799;57043;15380;54618443;52041987;37572247;6849668;53718795;40774921;7235247;906397;265677
FR;0;2022-11-04;660;831;4427;43663;578;3519;44289;60568;15270;54619103;52042818;37576674;6893331;53719373;40778440;7279536;966965;280947
FR;0;2022-11-05;255;389;1450;9718;312;1166;9927;13466;3295;54619358;52043207;37578124;6903049;53719685;40779606;7289463;980431;284242
FR;0;2022-11-06;94;119;263;1604;102;246;1633;2340;654;54619452;52043326;37578387;6904653;53719787;40779852;7291096;982771;284896
FR;0;2022-11-07;564;610;2763;26770;526;2249;27402;39125;11012;54620016;52043936;37581150;6931423;53720313;40782101;7318498;1021896;295908
FR;0;2022-11-08;688;820;5004;52023;606;3849;53032;74334;20088;54620704;52044756;37586154;6983446;53720919;40785950;7371530;1096230;315996
FR;0;2022-11-09;534;700;3363;31612;524;2691;32389;46374;13242;54621238;52045456;37589517;7015058;53721443;40788641;7403919;1142604;329238
FR;0;2022-11-10;632;1001;4581;43696;751;3639;44595;62889;17363;54621870;52046457;37594098;7058754;53722194;40792280;7448514;1205493;346601
FR;0;2022-11-11;82;124;370;1666;92;313;1729;2800;1013;54621952;52046581;37594468;7060420;53722286;40792593;7450243;1208293;347614
FR;0;2022-11-12;212;353;1195;7102;261;979;7337;10289;2765;54622164;52046934;37595663;7067522;53722547;40793572;7457580;1218582;350379
FR;0;2022-11-13;73;118;249;1208;97;213;1262;1978;628;54622237;52047052;37595912;7068730;53722644;40793785;7458842;1220560;351007
FR;0;2022-11-14;452;532;2592;24046;379;2070;24663;36316;10964;54622689;52047584;37598504;7092776;53723023;40795855;7483505;1256876;361971
FR;0;2022-11-15;626;895;4332;45075;721;3380;46025;66961;19641;54623315;52048479;37602836;7137851;53723744;40799235;7529530;1323837;381612
FR;0;2022-11-16;572;681;3074;28601;553;2580;29142;43290;13334;54623887;52049160;37605910;7166452;53724297;40801815;7558672;1367127;394946
FR;0;2022-11-17;575;693;3830;39280;540;2991;39887;58421;17439;54624462;52049853;37609740;7205732;53724837;40804806;7598559;1425548;412385
FR;0;2022-11-18;628;786;4609;45148;601;3458;46058;65732;18360;54625090;52050639;37614349;7250880;53725438;40808264;7644617;1491280;430745
FR;0;2022-11-19;270;346;1502;9808;279;1098;10004;14333;4016;54625360;52050985;37615851;7260688;53725717;40809362;7654621;1505613;434761
FR;0;2022-11-20;79;190;305;1701;172;262;1775;2721;860;54625439;52051175;37616156;7262389;53725889;40809624;7656396;1508334;435621
FR;0;2022-11-21;437;516;2425;21452;354;1956;22023;33160;10371;54625876;52051691;37618581;7283841;53726243;40811580;7678419;1541494;445992
FR;0;2022-11-22;542;611;4036;39842;438;3171;40421;59845;18302;54626418;52052302;37622617;7323683;53726681;40814751;7718840;1601339;464294
FR;0;2022-11-23;477;569;2759;26033;416;2325;26525;40430;12915;54626895;52052871;37625376;7349716;53727097;40817076;7745365;1641769;477209
FR;0;2022-11-24;517;609;3768;37195;432;2965;37907;56896;17984;54627412;52053480;37629144;7386911;53727529;40820041;7783272;1698665;495193
FR;0;2022-11-25;581;735;4191;40160;589;3152;41009;59652;17483;54627993;52054215;37633335;7427071;53728118;40823193;7824281;1758317;512676
FR;0;2022-11-26;301;339;1335;9375;263;1064;9525;14013;3972;54628294;52054554;37634670;7436446;53728381;40824257;7833806;1772330;516648
FR;0;2022-11-27;74;88;268;1666;70;228;1700;2568;808;54628368;52054642;37634938;7438112;53728451;40824485;7835506;1774898;517456
FR;0;2022-11-28;421;483;2638;24817;365;1983;25556;38492;12211;54628789;52055125;37637576;7462929;53728816;40826468;7861062;1813390;529667
FR;0;2022-11-29;500;613;4403;46551;382;3293;47280;71156;22345;54629289;52055738;37641979;7509480;53729198;40829761;7908342;1884546;552012
FR;0;2022-11-30;509;708;3741;36932;510;2899;37738;56336;17237;54629798;52056446;37645720;7546412;53729708;40832660;7946080;1940882;569249
FR;0;2022-12-01;569;685;5325;51908;464;3916;52720;79737;25275;54630367;52057131;37651045;7598320;53730172;40836576;7998800;2020619;594524
FR;0;2022-12-02;646;751;6175;61553;536;4385;62785;92484;27483;54631013;52057882;37657220;7659873;53730708;40840961;8061585;2113103;622007
FR;0;2022-12-03;305;354;2289;18052;232;1630;18482;26731;7618;54631318;52058236;37659509;7677925;53730940;40842591;8080067;2139834;629625
FR;0;2022-12-04;98;125;524;4305;92;434;4356;6441;1856;54631416;52058361;37660033;7682230;53731032;40843025;8084423;2146275;631481
FR;0;2022-12-05;493;620;4319;44739;457;2928;45710;69089;21916;54631909;52058981;37664352;7726969;53731489;40845953;8130133;2215364;653397
FR;0;2022-12-06;645;777;6859;78306;517;4662;79832;121779;39610;54632554;52059758;37671211;7805275;53732006;40850615;8209965;2337143;693007
FR;0;2022-12-07;562;657;5367;58171;491;3613;59323;90545;29582;54633116;52060415;37676578;7863446;53732497;40854228;8269288;2427688;722589
FR;0;2022-12-08;611;725;6991;79680;465;4594;81375;124200;40887;54633727;52061140;37683569;7943126;53732962;40858822;8350663;2551888;763476
FR;0;2022-12-09;784;849;8684;95697;561;5739;97592;147387;46829;54634511;52061989;37692253;8038823;53733523;40864561;8448255;2699275;810305
FR;0;2022-12-10;410;562;3827;33958;406;2481;34855;50557;14712;54634921;52062551;37696080;8072781;53733929;40867042;8483110;2749832;825017
FR;0;2022-12-11;133;146;994;8364;105;688;8570;12258;3276;54635054;52062697;37697074;8081145;53734034;40867730;8491680;2762090;828293
FR;0;2022-12-12;523;598;6385;67488;389;4139;69085;106305;34852;54635577;52063295;37703459;8148633;53734423;40871869;8560765;2868395;863145
FR;0;2022-12-13;717;795;9055;103640;509;5647;106227;164991;55128;54636294;52064090;37712514;8252273;53734932;40877516;8666992;3033386;918273
FR;0;2022-12-14;596;726;6827;73348;489;4559;75031;117011;38772;54636890;52064816;37719341;8325621;53735421;40882075;8742023;3150397;957045
FR;0;2022-12-15;665;894;8904;95933;583;5727;98250;153335;51776;54637555;52065710;37728245;8421554;53736004;40887802;8840273;3303732;1008821
FR;0;2022-12-16;828;982;9787;104883;656;6467;107125;166680;55414;54638383;52066692;37738032;8526437;53736660;40894269;8947398;3470412;1064235
FR;0;2022-12-17;346;430;3504;31808;295;2296;32598;48448;14450;54638729;52067122;37741536;8558245;53736955;40896565;8979996;3518860;1078685
FR;0;2022-12-18;93;127;791;6336;81;544;6487;9642;2763;54638822;52067249;37742327;8564581;53737036;40897109;8986483;3528502;1081448
FR;0;2022-12-19;593;621;5757;56227;437;3684;57859;90288;30103;54639415;52067870;37748084;8620808;53737473;40900793;9044342;3618790;1111551
FR;0;2022-12-20;747;797;7954;79864;533;5249;82010;130834;45060;54640162;52068667;37756038;8700672;53738006;40906042;9126352;3749624;1156611
FR;0;2022-12-21;605;630;5341;50981;442;3592;52333;84194;29343;54640767;52069297;37761379;8751653;53738448;40909634;9178685;3833818;1185954
FR;0;2022-12-22;649;668;4917;46293;468;3437;47530;76918;26916;54641416;52069965;37766296;8797946;53738916;40913071;9226215;3910736;1212870
FR;0;2022-12-23;480;588;3452;26235;426;2635;26896;43427;14919;54641896;52070553;37769748;8824181;53739342;40915706;9253111;3954163;1227789
FR;0;2022-12-24;105;108;447;2709;80;338;2833;4290;1231;54642001;52070661;37770195;8826890;53739422;40916044;9255944;3958453;1229020
FR;0;2022-12-25;34;43;134;566;34;106;592;926;273;54642035;52070704;37770329;8827456;53739456;40916150;9256536;3959379;1229293
FR;0;2022-12-26;370;393;2500;16947;293;1830;17577;27646;8847;54642405;52071097;37772829;8844403;53739749;40917980;9274113;3987025;1238140
FR;0;2022-12-27;540;662;4220;33739;447;2956;34889;56755;19759;54642945;52071759;37777049;8878142;53740196;40920936;9309002;4043780;1257899
FR;0;2022-12-28;480;523;3243;25723;357;2319;26344;42954;14847;54643425;52072282;37780292;8903865;53740553;40923255;9335346;4086734;1272746
FR;0;2022-12-29;431;552;3424;26592;364;2408;27599;45115;15664;54643856;52072834;37783716;8930457;53740917;40925663;9362945;4131849;1288410
FR;0;2022-12-30;464;508;2632;19576;366;1868;20248;32641;11003;54644320;52073342;37786348;8950033;53741283;40927531;9383193;4164490;1299413
FR;0;2022-12-31;137;157;508;3195;121;413;3339;4954;1341;54644457;52073499;37786856;8953228;53741404;40927944;9386532;4169444;1300754
FR;0;2023-01-01;25;46;177;711;27;150;737;1026;246;54644482;52073545;37787033;8953939;53741431;40928094;9387269;4170470;1301000
FR;0;2023-01-02;926;607;3021;19051;433;2335;19534;33035;12103;54645408;52074152;37790054;8972990;53741864;40930429;9406803;4203505;1313103
FR;0;2023-01-03;676;700;4767;44196;480;3378;45140;82805;34835;54646084;52074852;37794821;9017186;53742344;40933807;9451943;4286310;1347938
FR;0;2023-01-04;548;618;3879;31106;426;2772;31920;59893;25829;54646632;52075470;37798700;9048292;53742770;40936579;9483863;4346203;1373767
FR;0;2023-01-05;669;770;4693;43320;569;3197;44251;84065;37187;54647301;52076240;37803393;9091612;53743339;40939776;9528114;4430268;1410954
FR;0;2023-01-06;753;861;5530;48580;582;3670;49638;92110;39516;54648054;52077101;37808923;9140192;53743921;40943446;9577752;4522378;1450470
FR;0;2023-01-07;350;413;1949;12940;302;1415;13260;23039;8768;54648404;52077514;37810872;9153132;53744223;40944861;9591012;4545417;1459238
FR;0;2023-01-08;106;144;496;2918;100;357;3015;5232;1993;54648510;52077658;37811368;9156050;53744323;40945218;9594027;4550649;1461231
FR;0;2023-01-09;585;641;2866;22366;464;2081;22938;45875;21215;54649095;52078299;37814234;9178416;53744787;40947299;9616965;4596524;1482446
FR;0;2023-01-10;620;824;4826;41599;578;3462;42430;87058;41791;54649715;52079123;37819060;9220015;53745365;40950761;9659395;4683582;1524237
FR;0;2023-01-11;506;605;3147;25105;441;2290;25640;52881;25250;54650221;52079728;37822207;9245120;53745806;40953051;9685035;4736463;1549487
FR;0;2023-01-12;609;699;3987;34353;477;2889;34978;72521;35110;54650830;52080427;37826194;9279473;53746283;40955940;9720013;4808984;1584597
FR;0;2023-01-13;801;815;4386;36241;570;3161;36907;74675;35225;54651631;52081242;37830580;9315714;53746853;40959101;9756920;4883659;1619822
FR;0;2023-01-14;354;346;1590;9312;237;1201;9505;17775;7419;54651985;52081588;37832170;9325026;53747090;40960302;9766425;4901434;1627241
FR;0;2023-01-15;100;139;378;1573;94;291;1684;3280;1424;54652085;52081727;37832548;9326599;53747184;40960593;9768109;4904714;1628665
FR;0;2023-01-16;425;484;2382;16351;338;1789;16610;35994;18105;54652510;52082211;37834930;9342950;53747522;40962382;9784719;4940708;1646770
FR;0;2023-01-17;504;599;3540;29064;414;2568;29627;65751;33910;54653014;52082810;37838470;9372014;53747936;40964950;9814346;5006459;1680680
FR;0;2023-01-18;472;562;2373;17448;409;1840;17764;39176;19887;54653486;52083372;37840843;9389462;53748345;40966790;9832110;5045635;1700567
FR;0;2023-01-19;506;523;2878;23076;357;2143;23421;52314;27024;54653992;52083895;37843721;9412538;53748702;40968933;9855531;5097949;1727591
FR;0;2023-01-20;637;709;3473;25813;509;2628;26298;57786;29439;54654629;52084604;37847194;9438351;53749211;40971561;9881829;5155735;1757030
FR;0;2023-01-21;261;306;1143;6423;221;881;6533;13246;6020;54654890;52084910;37848337;9444774;53749432;40972442;9888362;5168981;1763050
FR;0;2023-01-22;47;65;181;880;34;156;931;1922;874;54654937;52084975;37848518;9445654;53749466;40972598;9889293;5170903;1763924
FR;0;2023-01-23;324;415;1739;11043;274;1304;11268;27228;14820;54655261;52085390;37850257;9456697;53749740;40973902;9900561;5198131;1778744
FR;0;2023-01-24;479;533;2598;20756;377;1946;21059;51084;28342;54655740;52085923;37852855;9477453;53750117;40975848;9921620;5249215;1807086
FR;0;2023-01-25;408;556;1955;12617;399;1483;13050;30759;16455;54656148;52086479;37854810;9490070;53750516;40977331;9934670;5279974;1823541
FR;0;2023-01-26;435;533;2396;17202;387;1796;17515;42525;23441;54656583;52087012;37857206;9507272;53750903;40979127;9952185;5322499;1846982
FR;0;2023-01-27;528;1139;2657;18543;963;2018;18793;45090;24586;54657111;52088151;37859863;9525815;53751866;40981145;9970978;5367589;1871568
FR;0;2023-01-28;237;291;868;4526;234;693;4645;9987;4762;54657348;52088442;37860731;9530341;53752100;40981838;9975623;5377576;1876330
FR;0;2023-01-29;42;72;124;466;55;102;504;1099;549;54657390;52088514;37860855;9530807;53752155;40981940;9976127;5378675;1876879
FR;0;2023-01-30;367;453;1349;8311;327;1118;8505;20975;11444;54657757;52088967;37862204;9539118;53752482;40983058;9984632;5399650;1888323
FR;0;2023-01-31;426;493;2056;14133;335;1536;14385;36907;21265;54658183;52089460;37864260;9553251;53752817;40984594;9999017;5436557;1909588
FR;0;2023-02-01;412;544;1729;8353;418;1473;8512;22234;12623;54658595;52090004;37865989;9561604;53753235;40986067;10007529;5458791;1922211
FR;0;2023-02-02;370;514;1731;11936;356;1439;12146;31730;18278;54658965;52090518;37867720;9573540;53753591;40987506;10019675;5490521;1940489
FR;0;2023-02-03;481;658;2064;12631;492;1648;12809;33771;19459;54659446;52091176;37869784;9586171;53754083;40989154;10032484;5524292;1959948
FR;0;2023-02-04;200;278;672;3138;240;565;3183;7458;3826;54659646;52091454;37870456;9589309;53754323;40989719;10035667;5531750;1963774
FR;0;2023-02-05;25;65;91;245;42;89;261;590;284;54659671;52091519;37870547;9589554;53754365;40989808;10035928;5532340;1964058
FR;0;2023-02-06;314;361;1108;5435;292;871;5621;15410;9063;54659985;52091880;37871655;9594989;53754657;40990679;10041549;5547750;1973121
FR;0;2023-02-07;351;508;1611;9771;377;1324;9941;28288;16956;54660336;52092388;37873266;9604760;53755034;40992003;10051490;5576038;1990077
FR;0;2023-02-08;302;394;1135;6079;312;921;6243;17038;9799;54660638;52092782;37874401;9610839;53755346;40992924;10057733;5593076;1999876
FR;0;2023-02-09;339;476;1310;7929;346;1117;8107;22869;13709;54660977;52093258;37875711;9618768;53755692;40994041;10065840;5615945;2013585
FR;0;2023-02-10;468;555;1522;8365;441;1280;8510;23776;13967;54661445;52093813;37877233;9627133;53756133;40995321;10074350;5639721;2027552
FR;0;2023-02-11;169;225;583;2149;182;512;2237;5435;2770;54661614;52094038;37877816;9629282;53756315;40995833;10076587;5645156;2030322
FR;0;2023-02-12;43;49;62;178;48;56;200;443;208;54661657;52094087;37877878;9629460;53756363;40995889;10076787;5645599;2030530
FR;0;2023-02-13;251;346;756;3358;271;688;3450;9626;5506;54661908;52094433;37878634;9632818;53756634;40996577;10080237;5655225;2036036
FR;0;2023-02-14;300;381;1185;5984;278;1011;6129;17570;10421;54662208;52094814;37879819;9638802;53756912;40997588;10086366;5672795;2046457
FR;0;2023-02-15;293;407;970;4078;302;846;4255;12221;7170;54662501;52095221;37880789;9642880;53757214;40998434;10090621;5685016;2053627
FR;0;2023-02-16;266;406;1163;5206;270;1019;5350;15066;8765;54662767;52095627;37881952;9648086;53757484;40999453;10095971;5700082;2062392
FR;0;2023-02-17;372;476;1320;5482;386;1159;5704;16397;9638;54663139;52096103;37883272;9653568;53757870;41000612;10101675;5716479;2072030
FR;0;2023-02-18;162;218;565;1628;173;494;1698;4073;2060;54663301;52096321;37883837;9655196;53758043;41001106;10103373;5720552;2074090
FR;0;2023-02-19;37;38;49;139;35;40;141;338;167;54663338;52096359;37883886;9655335;53758078;41001146;10103514;5720890;2074257
FR;0;2023-02-20;249;350;720;2861;263;678;2981;8544;4895;54663587;52096709;37884606;9658196;53758341;41001824;10106495;5729434;2079152
FR;0;2023-02-21;270;413;1075;4539;268;939;4747;14014;8281;54663857;52097122;37885681;9662735;53758609;41002763;10111242;5743448;2087433
FR;0;2023-02-22;246;376;743;2950;289;704;2998;9101;5322;54664103;52097498;37886424;9665685;53758898;41003467;10114240;5752549;2092755
FR;0;2023-02-23;227;365;936;4008;251;847;4195;12283;7174;54664330;52097863;37887360;9669693;53759149;41004314;10118435;5764832;2099929
FR;0;2023-02-24;291;472;1049;4414;350;922;4613;13009;7450;54664621;52098335;37888409;9674107;53759499;41005236;10123048;5777841;2107379
FR;0;2023-02-25;126;169;448;1193;148;364;1273;3189;1624;54664747;52098504;37888857;9675300;53759647;41005600;10124321;5781030;2109003
FR;0;2023-02-26;20;28;34;101;28;35;113;258;113;54664767;52098532;37888891;9675401;53759675;41005635;10124434;5781288;2109116
FR;0;2023-02-27;213;329;602;1995;256;584;2068;6563;3946;54664980;52098861;37889493;9677396;53759931;41006219;10126502;5787851;2113062
FR;0;2023-02-28;270;371;842;3592;253;809;3736;12188;7493;54665250;52099232;37890335;9680988;53760184;41007028;10130238;5800039;2120555
FR;0;2023-03-01;227;345;835;1997;284;762;2180;6609;3928;54665477;52099577;37891170;9682985;53760468;41007790;10132418;5806648;2124483
FR;0;2023-03-02;223;318;852;2987;231;730;3204;10080;6261;54665700;52099895;37892022;9685972;53760699;41008520;10135622;5816728;2130744
FR;0;2023-03-03;334;469;1039;3688;357;931;3827;11853;7018;54666034;52100364;37893061;9689660;53761056;41009451;10139449;5828581;2137762
FR;0;2023-03-04;131;220;409;1081;160;392;1096;2792;1372;54666165;52100584;37893470;9690741;53761216;41009843;10140545;5831373;2139134
FR;0;2023-03-05;23;27;29;52;24;32;53;201;113;54666188;52100611;37893499;9690793;53761240;41009875;10140598;5831574;2139247
FR;0;2023-03-06;227;268;539;1418;192;520;1495;4729;2725;54666415;52100879;37894038;9692211;53761432;41010395;10142093;5836303;2141972
FR;0;2023-03-07;191;318;660;2363;222;614;2456;7983;4886;54666606;52101197;37894698;9694574;53761654;41011009;10144549;5844286;2146858
FR;0;2023-03-08;161;291;526;1457;225;467;1566;5023;2923;54666767;52101488;37895224;9696031;53761879;41011476;10146115;5849309;2149781
FR;0;2023-03-09;172;283;633;2012;190;608;2083;7228;4480;54666939;52101771;37895857;9698043;53762069;41012084;10148198;5856537;2154261
FR;0;2023-03-10;324;461;894;2645;345;821;2785;9020;5373;54667263;52102232;37896751;9700688;53762414;41012905;10150983;5865557;2159634
FR;0;2023-03-11;126;178;352;801;136;311;853;2299;1179;54667389;52102410;37897103;9701489;53762550;41013216;10151836;5867856;2160813
FR;0;2023-03-12;10;26;30;62;25;30;63;177;87;54667399;52102436;37897133;9701551;53762575;41013246;10151899;5868033;2160900
FR;0;2023-03-13;146;237;473;1149;181;429;1207;3778;2143;54667545;52102673;37897606;9702700;53762756;41013675;10153106;5871811;2163043
FR;0;2023-03-14;198;284;648;1900;195;635;1979;6801;4136;54667743;52102957;37898254;9704600;53762951;41014310;10155085;5878612;2167179
FR;0;2023-03-15;161;263;522;1289;214;485;1339;4342;2579;54667904;52103220;37898776;9705889;53763165;41014795;10156424;5882954;2169758
FR;0;2023-03-16;174;269;629;1650;200;579;1758;5956;3579;54668078;52103489;37899405;9707539;53763365;41015374;10158182;5888910;2173337
FR;0;2023-03-17;282;361;800;2050;272;720;2193;7339;4398;54668360;52103850;37900205;9709589;53763637;41016094;10160375;5896249;2177735
FR;0;2023-03-18;123;163;452;607;115;440;679;2042;1043;54668483;52104013;37900657;9710196;53763752;41016534;10161054;5898291;2178778
FR;0;2023-03-19;20;21;27;53;22;14;60;126;54;54668503;52104034;37900684;9710249;53763774;41016548;10161114;5898417;2178832
FR;0;2023-03-20;152;265;486;1083;176;490;1159;3826;2190;54668655;52104299;37901170;9711332;53763950;41017038;10162273;5902243;2181022
FR;0;2023-03-21;212;283;670;1631;201;638;1828;6534;3933;54668867;52104582;37901840;9712963;53764151;41017676;10164101;5908777;2184955
FR;0;2023-03-22;196;244;483;1040;191;462;1160;3955;2298;54669063;52104826;37902323;9714003;53764342;41018138;10165261;5912732;2187253
FR;0;2023-03-23;166;241;593;1418;167;536;1510;5205;3080;54669229;52105067;37902916;9715421;53764509;41018674;10166771;5917937;2190333
FR;0;2023-03-24;241;394;925;1788;290;869;1971;6634;3818;54669470;52105461;37903841;9717209;53764799;41019543;10168742;5924571;2194151
FR;0;2023-03-25;129;172;354;575;141;315;650;1794;841;54669599;52105633;37904195;9717784;53764940;41019858;10169392;5926365;2194992
FR;0;2023-03-26;10;18;26;31;12;26;33;92;47;54669609;52105651;37904221;9717815;53764952;41019884;10169425;5926457;2195039
FR;0;2023-03-27;230;256;515;891;209;493;992;3441;1954;54669839;52105907;37904736;9718706;53765161;41020377;10170417;5929898;2196993
FR;0;2023-03-28;186;250;592;1594;170;547;1723;6196;3715;54670025;52106157;37905328;9720300;53765331;41020924;10172140;5936094;2200708
FR;0;2023-03-29;172;253;437;980;165;441;1121;3776;2105;54670197;52106410;37905765;9721280;53765496;41021365;10173261;5939870;2202813
FR;0;2023-03-30;193;242;577;1362;163;564;1530;5393;3118;54670390;52106652;37906342;9722642;53765659;41021929;10174791;5945263;2205931
FR;0;2023-03-31;215;366;721;1795;272;647;1934;6856;4019;54670605;52107018;37907063;9724437;53765931;41022576;10176725;5952119;2209950
FR;0;2023-04-01;109;196;437;594;134;394;698;1982;949;54670714;52107214;37907500;9725031;53766065;41022970;10177423;5954101;2210899
FR;0;2023-04-02;10;26;30;35;14;38;37;116;50;54670724;52107240;37907530;9725066;53766079;41023008;10177460;5954217;2210949
FR;0;2023-04-03;184;215;552;876;161;509;998;3300;1831;54670908;52107455;37908082;9725942;53766240;41023517;10178458;5957517;2212780
FR;0;2023-04-04;131;257;540;1233;177;475;1394;5370;3218;54671039;52107712;37908622;9727175;53766417;41023992;10179852;5962887;2215998
FR;0;2023-04-05;101;199;413;841;141;394;941;3480;2003;54671140;52107911;37909035;9728016;53766558;41024386;10180793;5966367;2218001
FR;0;2023-04-06;153;184;438;1041;129;402;1170;4266;2454;54671293;52108095;37909473;9729057;53766687;41024788;10181963;5970633;2220455
FR;0;2023-04-07;194;308;558;1289;218;524;1421;5069;2850;54671487;52108403;37910031;9730346;53766905;41025312;10183384;5975702;2223305
FR;0;2023-04-08;67;142;240;399;96;239;436;1341;609;54671554;52108545;37910271;9730745;53767001;41025551;10183820;5977043;2223914
FR;0;2023-04-09;9;19;19;15;11;22;20;62;19;54671563;52108564;37910290;9730760;53767012;41025573;10183840;5977105;2223933
FR;0;2023-04-10;12;32;53;35;25;52;49;106;30;54671575;52108596;37910343;9730795;53767037;41025625;10183889;5977211;2223963
FR;0;2023-04-11;125;254;518;997;165;501;1109;4350;2408;54671700;52108850;37910861;9731792;53767202;41026126;10184998;5981561;2226371
FR;0;2023-04-12;131;207;382;744;154;383;819;3290;1881;54671831;52109057;37911243;9732536;53767356;41026509;10185817;5984851;2228252
FR;0;2023-04-13;109;218;408;954;148;400;1042;4252;2469;54671940;52109275;37911651;9733490;53767504;41026909;10186859;5989103;2230721
FR;0;2023-04-14;198;292;634;1240;231;576;1326;5274;3075;54672138;52109567;37912285;9734730;53767735;41027485;10188185;5994377;2233796
FR;0;2023-04-15;79;118;251;417;81;245;453;1486;683;54672217;52109685;37912536;9735147;53767816;41027730;10188638;5995863;2234479
FR;0;2023-04-16;18;19;13;38;15;17;34;111;48;54672235;52109704;37912549;9735185;53767831;41027747;10188672;5995974;2234527
FR;0;2023-04-17;110;195;383;675;134;397;775;3063;1629;54672345;52109899;37912932;9735860;53767965;41028144;10189447;5999037;2236156
FR;0;2023-04-18;149;189;404;875;129;417;978;4186;2387;54672494;52110088;37913336;9736735;53768094;41028561;10190425;6003223;2238543
FR;0;2023-04-19;111;167;291;605;126;274;699;2781;1481;54672605;52110255;37913627;9737340;53768220;41028835;10191124;6006004;2240024
FR;0;2023-04-20;106;190;350;810;135;343;869;3465;1905;54672711;52110445;37913977;9738150;53768355;41029178;10191993;6009469;2241929
FR;0;2023-04-21;146;260;542;990;169;542;1124;4307;2308;54672857;52110705;37914519;9739140;53768524;41029720;10193117;6013776;2244237
FR;0;2023-04-22;57;113;186;271;79;201;300;1114;540;54672914;52110818;37914705;9739411;53768603;41029921;10193417;6014890;2244777
FR;0;2023-04-23;5;8;15;19;7;16;23;75;31;54672919;52110826;37914720;9739430;53768610;41029937;10193440;6014965;2244808
FR;0;2023-04-24;137;177;294;550;126;284;636;2425;1248;54673056;52111003;37915014;9739980;53768736;41030221;10194076;6017390;2246056
FR;0;2023-04-25;120;175;367;825;121;375;888;4059;2215;54673176;52111178;37915381;9740805;53768857;41030596;10194964;6021449;2248271
FR;0;2023-04-26;104;135;278;504;110;276;571;2552;1317;54673280;52111313;37915659;9741309;53768967;41030872;10195535;6024001;2249588
FR;0;2023-04-27;135;172;338;784;118;352;880;3658;1954;54673415;52111485;37915997;9742093;53769085;41031224;10196415;6027659;2251542
FR;0;2023-04-28;192;265;412;852;158;435;979;4286;2199;54673607;52111750;37916409;9742945;53769243;41031659;10197394;6031945;2253741
FR;0;2023-04-29;82;96;155;271;78;139;322;1105;516;54673689;52111846;37916564;9743216;53769321;41031798;10197716;6033050;2254257
FR;0;2023-04-30;7;8;10;11;4;9;12;63;34;54673696;52111854;37916574;9743227;53769325;41031807;10197728;6033113;2254291
FR;0;2023-05-01;16;20;57;11;18;58;14;66;24;54673712;52111874;37916631;9743238;53769343;41031865;10197742;6033179;2254315
FR;0;2023-05-02;202;213;468;643;159;460;761;3524;1829;54673914;52112087;37917099;9743881;53769502;41032325;10198503;6036703;2256144
FR;0;2023-05-03;143;139;275;482;106;280;532;2759;1426;54674057;52112226;37917374;9744363;53769608;41032605;10199035;6039462;2257570
FR;0;2023-05-04;95;167;358;740;126;429;796;4001;2061;54674152;52112393;37917732;9745103;53769734;41033034;10199831;6043463;2259631
FR;0;2023-05-05;126;205;349;783;132;386;868;4447;2349;54674278;52112598;37918081;9745886;53769866;41033420;10200699;6047910;2261980
FR;0;2023-05-06;68;72;126;249;52;145;262;1135;532;54674346;52112670;37918207;9746135;53769918;41033565;10200961;6049045;2262512
FR;0;2023-05-07;9;9;12;21;8;12;23;88;32;54674355;52112679;37918219;9746156;53769926;41033577;10200984;6049133;2262544
FR;0;2023-05-08;21;15;28;18;12;26;42;128;63;54674376;52112694;37918247;9746174;53769938;41033603;10201026;6049261;2262607
FR;0;2023-05-09;86;127;234;562;95;250;626;3503;1757;54674462;52112821;37918481;9746736;53770033;41033853;10201652;6052764;2264364
FR;0;2023-05-10;114;134;199;524;109;242;566;3292;1560;54674576;52112955;37918680;9747260;53770142;41034095;10202218;6056056;2265924
FR;0;2023-05-11;85;108;224;661;85;214;739;3978;1983;54674661;52113063;37918904;9747921;53770227;41034309;10202957;6060034;2267907
FR;0;2023-05-12;96;147;274;778;112;283;816;4498;2158;54674757;52113210;37919178;9748699;53770339;41034592;10203773;6064532;2270065
FR;0;2023-05-13;50;81;118;210;57;134;233;1012;428;54674807;52113291;37919296;9748909;53770396;41034726;10204006;6065544;2270493
FR;0;2023-05-14;15;13;8;14;8;12;15;83;30;54674822;52113304;37919304;9748923;53770404;41034738;10204021;6065627;2270523
FR;0;2023-05-15;65;89;201;480;61;191;529;3355;1598;54674887;52113393;37919505;9749403;53770465;41034929;10204550;6068982;2272121
FR;0;2023-05-16;89;158;228;869;112;247;1019;6024;2890;54674976;52113551;37919733;9750272;53770577;41035176;10205569;6075006;2275011
FR;0;2023-05-17;98;142;208;515;107;207;582;3289;1460;54675074;52113693;37919941;9750787;53770684;41035383;10206151;6078295;2276471
FR;0;2023-05-18;5;9;11;29;7;12;36;172;67;54675079;52113702;37919952;9750816;53770691;41035395;10206187;6078467;2276538
FR;0;2023-05-19;74;135;245;498;95;243;564;2933;1281;54675153;52113837;37920197;9751314;53770786;41035638;10206751;6081400;2277819
FR;0;2023-05-20;46;45;111;128;32;102;148;840;330;54675199;52113882;37920308;9751442;53770818;41035740;10206899;6082240;2278149
FR;0;2023-05-21;11;9;5;16;7;8;17;152;45;54675210;52113891;37920313;9751458;53770825;41035748;10206916;6082392;2278194
FR;0;2023-05-22;91;69;176;480;57;178;541;3224;1451;54675301;52113960;37920489;9751938;53770882;41035926;10207457;6085616;2279645
FR;0;2023-05-23;48;86;191;672;68;178;817;4867;2220;54675349;52114046;37920680;9752610;53770950;41036104;10208274;6090483;2281865
FR;0;2023-05-24;70;88;184;539;72;178;624;3400;1547;54675419;52114134;37920864;9753149;53771022;41036282;10208898;6093883;2283412
FR;0;2023-05-25;78;88;181;575;70;178;663;4706;2124;54675497;52114222;37921045;9753724;53771092;41036460;10209561;6098589;2285536
FR;0;2023-05-26;94;139;226;661;105;232;722;4804;2214;54675591;52114361;37921271;9754385;53771197;41036692;10210283;6103393;2287750
FR;0;2023-05-27;35;66;80;140;47;82;168;885;421;54675626;52114427;37921351;9754525;53771244;41036774;10210451;6104278;2288171
FR;0;2023-05-28;4;5;4;8;7;3;14;71;34;54675630;52114432;37921355;9754533;53771251;41036777;10210465;6104349;2288205
FR;0;2023-05-29;6;7;7;33;4;10;44;309;122;54675636;52114439;37921362;9754566;53771255;41036787;10210509;6104658;2288327
FR;0;2023-05-30;97;102;168;652;71;189;812;4802;2015;54675733;52114541;37921530;9755218;53771326;41036976;10211321;6109460;2290342
FR;0;2023-05-31;73;120;131;520;84;147;602;3594;1691;54675806;52114661;37921661;9755738;53771410;41037123;10211923;6113054;2292033
FR;0;2023-06-01;77;97;197;585;71;207;692;4806;1991;54675883;52114758;37921858;9756323;53771481;41037330;10212615;6117860;2294024
FR;0;2023-06-02;74;124;203;637;82;225;745;5301;2395;54675957;52114882;37922061;9756960;53771563;41037555;10213360;6123161;2296419
FR;0;2023-06-03;26;52;74;159;33;78;184;1071;412;54675983;52114934;37922135;9757119;53771596;41037633;10213544;6124232;2296831
FR;0;2023-06-04;2;17;5;13;14;8;15;118;35;54675985;52114951;37922140;9757132;53771610;41037641;10213559;6124350;2296866
FR;0;2023-06-05;113;97;162;564;74;196;657;4405;1808;54676098;52115048;37922302;9757696;53771684;41037837;10214216;6128755;2298674
FR;0;2023-06-06;96;126;245;813;102;273;931;7312;3105;54676194;52115174;37922547;9758509;53771786;41038110;10215147;6136067;2301779
FR;0;2023-06-07;67;90;154;565;61;151;615;4172;1751;54676261;52115264;37922701;9759074;53771847;41038261;10215762;6140239;2303530
FR;0;2023-06-08;76;86;195;758;68;209;864;6384;2704;54676337;52115350;37922896;9759832;53771915;41038470;10216626;6146623;2306234
FR;0;2023-06-09;75;136;195;613;113;196;673;5270;2227;54676412;52115486;37923091;9760445;53772028;41038666;10217299;6151893;2308461
FR;0;2023-06-10;31;43;66;143;34;62;172;997;379;54676443;52115529;37923157;9760588;53772062;41038728;10217471;6152890;2308840
FR;0;2023-06-11;3;8;5;15;6;8;18;145;59;54676446;52115537;37923162;9760603;53772068;41038736;10217489;6153035;2308899
FR;0;2023-06-12;41;101;170;628;79;171;684;5037;2156;54676487;52115638;37923332;9761231;53772147;41038907;10218173;6158072;2311055
FR;0;2023-06-13;66;69;239;846;57;209;968;7206;3035;54676553;52115707;37923571;9762077;53772204;41039116;10219141;6165278;2314090
FR;0;2023-06-14;50;121;140;574;103;154;646;4741;2089;54676603;52115828;37923711;9762651;53772307;41039270;10219787;6170019;2316179
FR;0;2023-06-15;56;76;198;783;58;203;896;6551;2918;54676659;52115904;37923909;9763434;53772365;41039473;10220683;6176570;2319097
FR;0;2023-06-16;72;96;194;801;86;168;810;6138;2645;54676731;52116000;37924103;9764235;53772451;41039641;10221493;6182708;2321742
FR;0;2023-06-17;20;48;52;106;38;57;125;944;366;54676751;52116048;37924155;9764341;53772489;41039698;10221618;6183652;2322108
FR;0;2023-06-18;3;7;9;29;7;11;27;217;95;54676754;52116055;37924164;9764370;53772496;41039709;10221645;6183869;2322203
FR;0;2023-06-19;58;62;155;508;47;159;626;4416;1739;54676812;52116117;37924319;9764878;53772543;41039868;10222271;6188285;2323942
FR;0;2023-06-20;104;62;210;740;55;230;775;6422;2837;54676916;52116179;37924529;9765618;53772598;41040098;10223046;6194707;2326779
FR;0;2023-06-21;42;70;145;640;59;208;772;4533;1859;54676958;52116249;37924674;9766258;53772657;41040306;10223818;6199240;2328638
FR;0;2023-06-22;56;53;170;660;39;204;761;5037;1988;54677014;52116302;37924844;9766918;53772696;41040510;10224579;6204277;2330626
FR;0;2023-06-23;80;89;148;653;68;149;788;5292;2000;54677094;52116391;37924992;9767571;53772764;41040659;10225367;6209569;2332626
FR;0;2023-06-24;12;20;57;101;12;60;127;836;275;54677106;52116411;37925049;9767672;53772776;41040719;10225494;6210405;2332901
FR;0;2023-06-25;4;5;11;14;3;10;14;104;45;54677110;52116416;37925060;9767686;53772779;41040729;10225508;6210509;2332946
FR;0;2023-06-26;49;48;157;351;39;155;414;2920;1131;54677159;52116464;37925217;9768037;53772818;41040884;10225922;6213429;2334077
FR;0;2023-06-27;72;62;166;628;46;157;662;4746;1811;54677231;52116526;37925383;9768665;53772864;41041041;10226584;6218175;2335888
FR;0;2023-06-28;47;51;134;460;45;113;486;3148;1335;54677278;52116577;37925517;9769125;53772909;41041154;10227070;6221323;2337223
FR;0;2023-06-29;34;54;122;429;38;129;472;3919;1613;54677312;52116631;37925639;9769554;53772947;41041283;10227542;6225242;2338836
FR;0;2023-06-30;44;73;128;461;53;142;472;4088;1526;54677356;52116704;37925767;9770015;53773000;41041425;10228014;6229330;2340362
FR;0;2023-07-01;35;32;41;90;33;41;113;846;328;54677391;52116736;37925808;9770105;53773033;41041466;10228127;6230176;2340690
FR;0;2023-07-02;0;0;1;8;0;2;7;46;25;54677391;52116736;37925809;9770113;53773033;41041468;10228134;6230222;2340715
FR;0;2023-07-03;58;38;137;231;36;134;246;2055;715;54677449;52116774;37925946;9770344;53773069;41041602;10228380;6232277;2341430
FR;0;2023-07-04;43;56;114;375;45;130;390;3020;1171;54677492;52116830;37926060;9770719;53773114;41041732;10228770;6235297;2342601
FR;0;2023-07-05;46;38;102;322;33;99;392;2488;986;54677538;52116868;37926162;9771041;53773147;41041831;10229162;6237785;2343587
FR;0;2023-07-06;49;42;109;415;35;133;494;2857;1044;54677587;52116910;37926271;9771456;53773182;41041964;10229656;6240642;2344631
FR;0;2023-07-07;53;60;130;348;49;133;389;2841;998;54677640;52116970;37926401;9771804;53773231;41042097;10230045;6243483;2345629
FR;0;2023-07-08;17;27;49;71;19;50;86;525;169;54677657;52116997;37926450;9771875;53773250;41042147;10230131;6244008;2345798
FR;0;2023-07-09;1;5;2;6;4;1;7;41;18;54677658;52117002;37926452;9771881;53773254;41042148;10230138;6244049;2345816
FR;0;2023-07-10;23;28;80;154;25;89;176;1431;471;54677681;52117030;37926532;9772035;53773279;41042237;10230314;6245480;2346287
