fra;vaccin;jour;n_dose1;n_dose2;n_dose3;n_dose4;n_rappel;n_cum_dose1;n_cum_dose2;n_cum_dose3;n_cum_dose4;n_cum_rappel
FR;1;2020-12-27;602;0;0;0;0;602;0;0;0;0
FR;1;2020-12-28;665;1;0;0;0;1267;1;0;0;0
FR;1;2020-12-29;373;0;0;0;0;1640;1;0;0;0
FR;1;2020-12-30;439;0;0;0;0;2079;1;0;0;0
FR;1;2020-12-31;415;0;0;0;0;2494;1;0;0;0
FR;1;2021-01-01;1135;1;0;0;0;3629;2;0;0;0
FR;1;2021-01-02;356;3;0;0;0;3985;5;0;0;0
FR;1;2021-01-03;400;0;0;0;0;4385;5;0;0;0
FR;1;2021-01-04;2087;2;0;0;0;6472;7;0;0;0
FR;1;2021-01-05;7564;3;0;0;0;14036;10;0;0;0
FR;1;2021-01-06;12414;10;0;0;0;26450;20;0;0;0
FR;1;2021-01-07;29446;9;0;0;0;55896;29;0;0;0
FR;1;2021-01-08;37121;9;0;0;0;93017;38;0;0;0
FR;1;2021-01-09;11209;4;0;0;0;104226;42;0;0;0
FR;1;2021-01-10;5996;3;0;0;0;110222;45;0;0;0
FR;1;2021-01-11;39923;17;0;0;0;150145;62;0;0;0
FR;1;2021-01-12;62120;15;0;0;0;212265;77;0;0;0
FR;1;2021-01-13;65096;28;0;0;0;277361;105;0;0;0
FR;1;2021-01-14;81434;75;0;0;0;358795;180;0;0;0
FR;1;2021-01-15;68594;29;0;0;0;427389;209;0;0;0
FR;1;2021-01-16;19893;70;0;0;0;447282;279;0;0;0
FR;1;2021-01-17;10896;46;0;0;0;458178;325;0;0;0
FR;1;2021-01-18;82806;162;0;0;0;540984;487;0;0;0
FR;1;2021-01-19;125897;171;0;0;0;666881;658;0;0;0
FR;1;2021-01-20;132389;168;0;0;0;799270;826;0;0;0
FR;1;2021-01-21;153035;160;0;0;0;952305;986;0;0;0
FR;1;2021-01-22;115923;196;0;0;0;1068228;1182;0;0;0
FR;1;2021-01-23;36598;63;0;0;0;1104826;1245;0;0;0
FR;1;2021-01-24;9580;68;0;0;0;1114406;1313;0;0;0
FR;1;2021-01-25;74406;1260;0;0;0;1188812;2573;0;0;0
FR;1;2021-01-26;96441;3284;1;0;0;1285253;5857;1;0;0
FR;1;2021-01-27;103625;5897;0;0;0;1388878;11754;1;0;0
FR;1;2021-01-28;120579;14951;0;0;0;1509457;26705;1;0;0
FR;1;2021-01-29;88878;17694;0;0;0;1598335;44399;1;0;0
FR;1;2021-01-30;27981;4259;0;0;0;1626316;48658;1;0;0
FR;1;2021-01-31;5180;1734;0;0;0;1631496;50392;1;0;0
FR;1;2021-02-01;49704;21502;0;0;0;1681200;71894;1;0;0
FR;1;2021-02-02;67788;35647;0;0;0;1748988;107541;1;0;0
FR;1;2021-02-03;67071;37921;0;0;0;1816059;145462;1;0;0
FR;1;2021-02-04;77116;51474;0;0;0;1893175;196936;1;0;0
FR;1;2021-02-05;63405;46118;0;0;0;1956580;243054;1;0;0
FR;1;2021-02-06;19403;10745;0;0;0;1975983;253799;1;0;0
FR;1;2021-02-07;3658;5256;0;0;0;1979641;259055;1;0;0
FR;1;2021-02-08;36480;46850;0;0;0;2016121;305905;1;0;0
FR;1;2021-02-09;50788;74302;0;0;0;2066909;380207;1;0;0
FR;1;2021-02-10;52044;79149;0;0;0;2118953;459356;1;0;0
FR;1;2021-02-11;63347;100975;0;0;0;2182300;560331;1;0;0
FR;1;2021-02-12;55838;74640;0;0;0;2238138;634971;1;0;0
FR;1;2021-02-13;15450;19242;0;0;0;2253588;654213;1;0;0
FR;1;2021-02-14;3744;7187;0;0;0;2257332;661400;1;0;0
FR;1;2021-02-15;24128;73498;0;0;0;2281460;734898;1;0;0
FR;1;2021-02-16;32754;96529;0;0;0;2314214;831427;1;0;0
FR;1;2021-02-17;35095;100093;1;0;0;2349309;931520;2;0;0
FR;1;2021-02-18;49422;115194;0;0;0;2398731;1046714;2;0;0
FR;1;2021-02-19;45365;86617;1;0;0;2444096;1133331;3;0;0
FR;1;2021-02-20;13376;27065;0;0;0;2457472;1160396;3;0;0
FR;1;2021-02-21;2454;6223;0;0;0;2459926;1166619;3;0;0
FR;1;2021-02-22;24703;69394;2;0;0;2484629;1236013;5;0;0
FR;1;2021-02-23;37413;80730;1;0;0;2522042;1316743;6;0;0
FR;1;2021-02-24;40670;78246;1;0;0;2562712;1394989;7;0;0
FR;1;2021-02-25;50132;87996;1;0;0;2612844;1482985;8;0;0
FR;1;2021-02-26;47186;67594;1;0;0;2660030;1550579;9;0;0
FR;1;2021-02-27;15667;21083;0;0;0;2675697;1571662;9;0;0
FR;1;2021-02-28;3551;4254;1;0;0;2679248;1575916;10;0;0
FR;1;2021-03-01;40143;49547;1;0;0;2719391;1625463;11;0;0
FR;1;2021-03-02;55955;61823;2;0;0;2775346;1687286;13;0;0
FR;1;2021-03-03;61201;60567;0;0;0;2836547;1747853;13;0;0
FR;1;2021-03-04;72970;66114;3;0;0;2909517;1813967;16;0;0
FR;1;2021-03-05;74732;59020;3;0;0;2984249;1872987;19;0;0
FR;1;2021-03-06;82433;15994;2;0;0;3066682;1888981;21;0;0
FR;1;2021-03-07;63702;4946;1;0;0;3130384;1893927;22;0;0
FR;1;2021-03-08;60140;42025;2;0;0;3190524;1935952;24;0;0
FR;1;2021-03-09;85958;47973;1;0;0;3276482;1983925;25;0;0
FR;1;2021-03-10;90872;47944;5;0;0;3367354;2031869;30;0;0
FR;1;2021-03-11;105032;54142;1;0;0;3472386;2086011;31;0;0
FR;1;2021-03-12;104080;45088;1;0;0;3576466;2131099;32;0;0
FR;1;2021-03-13;89179;12706;1;0;0;3665645;2143805;33;0;0
FR;1;2021-03-14;44442;2886;1;0;0;3710087;2146691;34;0;0
FR;1;2021-03-15;95473;28633;3;0;0;3805560;2175324;37;0;0
FR;1;2021-03-16;123569;34477;5;0;0;3929129;2209801;42;0;0
FR;1;2021-03-17;129279;34189;4;0;0;4058408;2243990;46;0;0
FR;1;2021-03-18;142851;39557;5;0;0;4201259;2283547;51;0;0
FR;1;2021-03-19;136212;32547;2;0;0;4337471;2316094;53;0;0
FR;1;2021-03-20;75972;10004;1;0;0;4413443;2326098;54;0;0
FR;1;2021-03-21;26494;2362;1;0;0;4439937;2328460;55;0;0
FR;1;2021-03-22;114716;30798;2;0;0;4554653;2359258;57;0;0
FR;1;2021-03-23;142993;38115;1;0;0;4697646;2397373;58;0;0
FR;1;2021-03-24;141959;38603;0;0;0;4839605;2435976;58;0;0
FR;1;2021-03-25;164966;39595;4;0;0;5004571;2475571;62;0;0
FR;1;2021-03-26;166358;37497;4;1;0;5170929;2513068;66;1;0
FR;1;2021-03-27;110865;15280;1;0;0;5281794;2528348;67;1;0
FR;1;2021-03-28;42291;3865;3;0;0;5324085;2532213;70;1;0
FR;1;2021-03-29;129784;49659;4;0;0;5453869;2581872;74;1;0
FR;1;2021-03-30;167672;63512;4;0;0;5621541;2645384;78;1;0
FR;1;2021-03-31;170886;67211;4;0;0;5792427;2712595;82;1;0
FR;1;2021-04-01;194715;80583;11;0;0;5987142;2793178;93;1;0
FR;1;2021-04-02;164409;84916;7;0;0;6151551;2878094;100;1;0
FR;1;2021-04-03;88223;58030;5;0;0;6239774;2936124;105;1;0
FR;1;2021-04-04;33574;17694;0;0;0;6273348;2953818;105;1;0
FR;1;2021-04-05;46374;9973;11;0;0;6319722;2963791;116;1;0
FR;1;2021-04-06;160256;102101;17;0;0;6479978;3065892;133;1;0
FR;1;2021-04-07;196928;108180;16;0;0;6676906;3174072;149;1;0
FR;1;2021-04-08;222045;112718;13;0;0;6898951;3286790;162;1;0
FR;1;2021-04-09;214499;107334;21;0;0;7113450;3394124;183;1;0
FR;1;2021-04-10;117148;73259;14;0;0;7230598;3467383;197;1;0
FR;1;2021-04-11;40872;30134;6;0;0;7271470;3497517;203;1;0
FR;1;2021-04-12;168409;103869;45;0;0;7439879;3601386;248;1;0
FR;1;2021-04-13;203750;127990;97;1;0;7643629;3729376;345;2;0
FR;1;2021-04-14;208537;122660;206;0;0;7852166;3852036;551;2;0
FR;1;2021-04-15;221601;127016;311;0;0;8073767;3979052;862;2;0
FR;1;2021-04-16;206001;125162;307;0;0;8279768;4104214;1169;2;0
FR;1;2021-04-17;122057;67285;103;0;0;8401825;4171499;1272;2;0
FR;1;2021-04-18;35953;20942;41;0;0;8437778;4192441;1313;2;0
FR;1;2021-04-19;163706;121705;430;0;0;8601484;4314146;1743;2;0
FR;1;2021-04-20;189355;148819;530;0;0;8790839;4462965;2273;2;0
FR;1;2021-04-21;193929;146883;758;0;0;8984768;4609848;3031;2;0
FR;1;2021-04-22;208976;163040;777;0;0;9193744;4772888;3808;2;0
FR;1;2021-04-23;198911;157025;671;0;0;9392655;4929913;4479;2;0
FR;1;2021-04-24;126298;95466;147;0;0;9518953;5025379;4626;2;0
FR;1;2021-04-25;53616;30014;46;0;0;9572569;5055393;4672;2;0
FR;1;2021-04-26;181082;138324;539;0;0;9753651;5193717;5211;2;0
FR;1;2021-04-27;221315;161832;900;0;0;9974966;5355549;6111;2;0
FR;1;2021-04-28;238233;155027;1310;1;1;10213199;5510576;7421;3;1
FR;1;2021-04-29;270220;160339;1207;0;0;10483419;5670915;8628;3;1
FR;1;2021-04-30;271922;148091;1069;0;0;10755341;5819006;9697;3;1
FR;1;2021-05-01;141113;40629;172;0;0;10896454;5859635;9869;3;1
FR;1;2021-05-02;81519;28087;81;0;0;10977973;5887722;9950;3;1
FR;1;2021-05-03;250726;145327;799;0;0;11228699;6033049;10749;3;1
FR;1;2021-05-04;265802;186845;1197;0;0;11494501;6219894;11946;3;1
FR;1;2021-05-05;283799;184725;1264;0;0;11778300;6404619;13210;3;1
FR;1;2021-05-06;309885;183203;1498;0;0;12088185;6587822;14708;3;1
FR;1;2021-05-07;284033;195629;1125;0;0;12372218;6783451;15833;3;1
FR;1;2021-05-08;191636;48585;284;0;0;12563854;6832036;16117;3;1
FR;1;2021-05-09;114045;35895;236;0;0;12677899;6867931;16353;3;1
FR;1;2021-05-10;258129;193972;1182;0;0;12936028;7061903;17535;3;1
FR;1;2021-05-11;318814;210991;1462;0;0;13254842;7272894;18997;3;1
FR;1;2021-05-12;356558;185662;1399;0;0;13611400;7458556;20396;3;1
FR;1;2021-05-13;283400;47707;399;0;0;13894800;7506263;20795;3;1
FR;1;2021-05-14;370437;128563;990;0;0;14265237;7634826;21785;3;1
FR;1;2021-05-15;298045;66093;402;0;0;14563282;7700919;22187;3;1
FR;1;2021-05-16;157745;15539;158;0;0;14721027;7716458;22345;3;1
FR;1;2021-05-17;318884;116317;1436;0;0;15039911;7832775;23781;3;1
FR;1;2021-05-18;383262;111176;1795;0;0;15423173;7943951;25576;3;1
FR;1;2021-05-19;395201;102596;2174;0;0;15818374;8046547;27750;3;1
FR;1;2021-05-20;421744;96109;2041;0;0;16240118;8142656;29791;3;1
FR;1;2021-05-21;399751;97167;1755;0;0;16639869;8239823;31546;3;1
FR;1;2021-05-22;275642;42017;602;0;0;16915511;8281840;32148;3;1
FR;1;2021-05-23;122984;11152;224;0;0;17038495;8292992;32372;3;1
FR;1;2021-05-24;243962;26216;565;0;0;17282457;8319208;32937;3;1
FR;1;2021-05-25;366122;131620;2108;1;0;17648579;8450828;35045;4;1
FR;1;2021-05-26;380733;125842;1987;0;0;18029312;8576670;37032;4;1
FR;1;2021-05-27;406049;127975;1973;0;0;18435361;8704645;39005;4;1
FR;1;2021-05-28;365932;145261;1697;0;0;18801293;8849906;40702;4;1
FR;1;2021-05-29;253800;80831;525;0;0;19055093;8930737;41227;4;1
FR;1;2021-05-30;100934;22540;157;0;0;19156027;8953277;41384;4;1
FR;1;2021-05-31;314213;148739;1279;1;1;19470240;9102016;42663;5;2
FR;1;2021-06-01;361477;166442;1724;1;1;19831717;9268458;44387;6;3
FR;1;2021-06-02;364623;153150;1791;0;0;20196340;9421608;46178;6;3
FR;1;2021-06-03;390426;147552;1647;0;0;20586766;9569160;47825;6;3
FR;1;2021-06-04;363560;175500;1492;1;1;20950326;9744660;49317;7;4
FR;1;2021-06-05;258460;112644;596;0;0;21208786;9857304;49913;7;4
FR;1;2021-06-06;126739;37543;215;0;0;21335525;9894847;50128;7;4
FR;1;2021-06-07;300145;207786;1361;0;0;21635670;10102633;51489;7;4
FR;1;2021-06-08;330541;220761;1636;0;0;21966211;10323394;53125;7;4
FR;1;2021-06-09;336388;212211;1607;0;0;22302599;10535605;54732;7;4
FR;1;2021-06-10;343682;201881;1608;0;0;22646281;10737486;56340;7;4
FR;1;2021-06-11;311727;235262;1291;0;0;22958008;10972748;57631;7;4
FR;1;2021-06-12;244025;150651;431;0;0;23202033;11123399;58062;7;4
FR;1;2021-06-13;100315;61001;188;0;0;23302348;11184400;58250;7;4
FR;1;2021-06-14;207668;288786;1316;1;0;23510016;11473186;59566;8;4
FR;1;2021-06-15;256701;282130;1390;1;0;23766717;11755316;60956;9;4
FR;1;2021-06-16;273519;270587;1262;1;0;24040236;12025903;62218;10;4
FR;1;2021-06-17;268095;244720;1231;1;0;24308331;12270623;63449;11;4
FR;1;2021-06-18;260418;295653;1149;1;0;24568749;12566276;64598;12;4
FR;1;2021-06-19;193412;209488;387;0;0;24762161;12775764;64985;12;4
FR;1;2021-06-20;69649;89151;117;0;0;24831810;12864915;65102;12;4
FR;1;2021-06-21;172197;319804;929;1;1;25004007;13184719;66031;13;5
FR;1;2021-06-22;185683;347817;1096;10;2;25189690;13532536;67127;23;7
FR;1;2021-06-23;204044;339478;1048;0;0;25393734;13872014;68175;23;7
FR;1;2021-06-24;203401;282095;1166;0;0;25597135;14154109;69341;23;7
FR;1;2021-06-25;182494;371815;1196;0;0;25779629;14525924;70537;23;7
FR;1;2021-06-26;131347;278310;502;0;0;25910976;14804234;71039;23;7
FR;1;2021-06-27;52372;122903;145;0;0;25963348;14927137;71184;23;7
FR;1;2021-06-28;136506;368132;1057;0;0;26099854;15295269;72241;23;7
FR;1;2021-06-29;154749;390699;1849;0;0;26254603;15685968;74090;23;7
FR;1;2021-06-30;179905;379446;1662;4;2;26434508;16065414;75752;27;9
FR;1;2021-07-01;201269;332197;1886;5;1;26635777;16397611;77638;32;10
FR;1;2021-07-02;193526;367666;1764;5;3;26829303;16765277;79402;37;13
FR;1;2021-07-03;124376;280452;704;3;1;26953679;17045729;80106;40;14
FR;1;2021-07-04;53908;113684;244;0;0;27007587;17159413;80350;40;14
FR;1;2021-07-05;153672;356024;1500;8;2;27161259;17515437;81850;48;16
FR;1;2021-07-06;173303;382524;1601;45;8;27334562;17897961;83451;93;24
FR;1;2021-07-07;190589;362564;1656;24;5;27525151;18260525;85107;117;29
FR;1;2021-07-08;201383;323117;1825;20;7;27726534;18583642;86932;137;36
FR;1;2021-07-09;189713;387596;1851;3;2;27916247;18971238;88783;140;38
FR;1;2021-07-10;129874;281134;814;1;1;28046121;19252372;89597;141;39
FR;1;2021-07-11;57627;102502;261;0;0;28103748;19354874;89858;141;39
FR;1;2021-07-12;149468;417024;1579;4;0;28253216;19771898;91437;145;39
FR;1;2021-07-13;234074;439499;1805;8;2;28487290;20211397;93242;153;41
FR;1;2021-07-14;171731;151539;416;0;0;28659021;20362936;93658;153;41
FR;1;2021-07-15;279469;424771;1856;1;0;28938490;20787707;95514;154;41
FR;1;2021-07-16;290260;401238;1710;3;1;29228750;21188945;97224;157;42
FR;1;2021-07-17;217276;282117;754;1;0;29446026;21471062;97978;158;42
FR;1;2021-07-18;101962;107309;288;0;0;29547988;21578371;98266;158;42
FR;1;2021-07-19;238073;379152;1495;3;0;29786061;21957523;99761;161;42
FR;1;2021-07-20;305580;380742;1467;0;0;30091641;22338265;101228;161;42
FR;1;2021-07-21;333132;353440;1412;4;2;30424773;22691705;102640;165;44
FR;1;2021-07-22;364521;319260;1501;3;2;30789294;23010965;104141;168;46
FR;1;2021-07-23;348952;343618;1586;4;2;31138246;23354583;105727;172;48
FR;1;2021-07-24;238910;240983;696;1;0;31377156;23595566;106423;173;48
FR;1;2021-07-25;112748;76059;215;0;0;31489904;23671625;106638;173;48
FR;1;2021-07-26;299017;290063;1496;2;2;31788921;23961688;108134;175;50
FR;1;2021-07-27;385701;268702;1457;4;2;32174622;24230390;109591;179;52
FR;1;2021-07-28;390085;251449;1460;4;2;32564707;24481839;111051;183;54
FR;1;2021-07-29;406017;228249;1538;2;1;32970724;24710088;112589;185;55
FR;1;2021-07-30;370595;246988;1632;4;1;33341319;24957076;114221;189;56
FR;1;2021-07-31;243351;165118;793;1;0;33584670;25122194;115014;190;56
FR;1;2021-08-01;105521;47234;232;0;0;33690191;25169428;115246;190;56
FR;1;2021-08-02;297028;213212;1475;2;0;33987219;25382640;116721;192;56
FR;1;2021-08-03;331163;209220;1545;2;1;34318382;25591860;118266;194;57
FR;1;2021-08-04;327837;184342;1436;5;3;34646219;25776202;119702;199;60
FR;1;2021-08-05;301116;193569;1482;0;0;34947335;25969771;121184;199;60
FR;1;2021-08-06;290833;224521;1558;3;1;35238168;26194292;122742;202;61
FR;1;2021-08-07;182599;158828;654;4;3;35420767;26353120;123396;206;64
FR;1;2021-08-08;68835;59130;247;0;0;35489602;26412250;123643;206;64
FR;1;2021-08-09;222630;235884;1438;4;3;35712232;26648134;125081;210;67
FR;1;2021-08-10;252505;240633;1486;2;1;35964737;26888767;126567;212;68
FR;1;2021-08-11;236043;232377;1270;5;1;36200780;27121144;127837;217;69
FR;1;2021-08-12;220624;240223;1484;3;1;36421404;27361367;129321;220;70
FR;1;2021-08-13;201624;238546;1355;2;2;36623028;27599913;130676;222;72
FR;1;2021-08-14;122811;174162;645;0;0;36745839;27774075;131321;222;72
FR;1;2021-08-15;34658;46120;198;1;0;36780497;27820195;131519;223;72
FR;1;2021-08-16;156835;289853;1421;0;0;36937332;28110048;132940;223;72
FR;1;2021-08-17;171503;291587;1420;5;1;37108835;28401635;134360;228;73
FR;1;2021-08-18;161317;286998;1389;6;3;37270152;28688633;135749;234;76
FR;1;2021-08-19;148821;277715;1397;1;0;37418973;28966348;137146;235;76
FR;1;2021-08-20;140411;309069;1524;2;2;37559384;29275417;138670;237;78
FR;1;2021-08-21;84235;213250;586;0;0;37643619;29488667;139256;237;78
FR;1;2021-08-22;28543;82693;230;0;0;37672162;29571360;139486;237;78
FR;1;2021-08-23;118582;321169;1420;2;1;37790744;29892529;140906;239;79
FR;1;2021-08-24;126592;319895;1599;5;1;37917336;30212424;142505;244;80
FR;1;2021-08-25;121458;306582;1776;8;3;38038794;30519006;144281;252;83
FR;1;2021-08-26;106512;286191;2156;10;1;38145306;30805197;146437;262;84
FR;1;2021-08-27;107591;321543;2300;8;3;38252897;31126740;148737;270;87
FR;1;2021-08-28;70969;220707;1100;0;0;38323866;31347447;149837;270;87
FR;1;2021-08-29;24136;78153;467;1;0;38348002;31425600;150304;271;87
FR;1;2021-08-30;96805;286529;4307;6;5123;38444807;31712129;154611;277;5210
FR;1;2021-08-31;98029;276452;9285;15;10176;38542836;31988581;163896;292;15386
FR;1;2021-09-01;111962;245334;21103;7;22074;38654798;32233915;184999;299;37460
FR;1;2021-09-02;84715;198008;24521;11;25429;38739513;32431923;209520;310;62889
FR;1;2021-09-03;82312;227614;26943;20;27974;38821825;32659537;236463;330;90863
FR;1;2021-09-04;71545;189716;11138;11;11651;38893370;32849253;247601;341;102514
FR;1;2021-09-05;18595;41192;4121;2;4288;38911965;32890445;251722;343;106802
FR;1;2021-09-06;59467;151632;30171;15;31145;38971432;33042077;281893;358;137947
FR;1;2021-09-07;57176;139712;30200;27;31102;39028608;33181789;312093;385;169049
FR;1;2021-09-08;71082;173877;26916;20;27863;39099690;33355666;339009;405;196912
FR;1;2021-09-09;54204;124560;28599;23;29646;39153894;33480226;367608;428;226558
FR;1;2021-09-10;65779;152092;30430;22;31563;39219673;33632318;398038;450;258121
FR;1;2021-09-11;52266;146616;9727;14;10303;39271939;33778934;407765;464;268424
FR;1;2021-09-12;10766;29240;2481;1;2635;39282705;33808174;410246;465;271059
FR;1;2021-09-13;51325;104598;38726;28;39907;39334030;33912772;448972;493;310966
FR;1;2021-09-14;53174;96054;51252;65;52871;39387204;34008826;500224;558;363837
FR;1;2021-09-15;60345;139294;50458;55;46963;39447549;34148120;550682;613;410800
FR;1;2021-09-16;46530;81418;53285;71;49465;39494079;34229538;603967;684;460265
FR;1;2021-09-17;53109;109389;45046;60;42634;39547188;34338927;649013;744;502899
FR;1;2021-09-18;37832;118490;11789;19;11254;39585020;34457417;660802;763;514153
FR;1;2021-09-19;6492;21035;2037;1;1973;39591512;34478452;662839;764;516126
FR;1;2021-09-20;36426;74920;46173;66;44087;39627938;34553372;709012;830;560213
FR;1;2021-09-21;34120;68142;56227;71;52611;39662058;34621514;765239;901;612824
FR;1;2021-09-22;38744;118515;49832;76;46813;39700802;34740029;815071;977;659637
FR;1;2021-09-23;31927;62837;54459;85;50811;39732729;34802866;869530;1062;710448
FR;1;2021-09-24;36705;90044;43639;91;41868;39769434;34892910;913169;1153;752316
FR;1;2021-09-25;27624;96607;12297;27;12161;39797058;34989517;925466;1180;764477
FR;1;2021-09-26;4357;15204;1770;5;1696;39801415;35004721;927236;1185;766173
FR;1;2021-09-27;27307;60230;42882;89;41560;39828722;35064951;970118;1274;807733
FR;1;2021-09-28;26841;49450;47155;75;44373;39855563;35114401;1017273;1349;852106
FR;1;2021-09-29;35826;80389;47244;87;45519;39891389;35194790;1064517;1436;897625
FR;1;2021-09-30;26008;46761;47490;79;45364;39917397;35241551;1112007;1515;942989
FR;1;2021-10-01;47124;64992;44855;83;44399;39964521;35306543;1156862;1598;987388
FR;1;2021-10-02;32331;62343;16104;32;16294;39996852;35368886;1172966;1630;1003682
FR;1;2021-10-03;4318;8574;2031;3;2024;40001170;35377460;1174997;1633;1005706
FR;1;2021-10-04;28750;44410;47088;79;46897;40029920;35421870;1222085;1712;1052603
FR;1;2021-10-05;24211;41625;49827;116;49173;40054131;35463495;1271912;1828;1101776
FR;1;2021-10-06;34364;61309;57441;102;57119;40088495;35524804;1329353;1930;1158895
FR;1;2021-10-07;20925;39797;52988;76;51806;40109420;35564601;1382341;2006;1210701
FR;1;2021-10-08;34944;59577;60356;83;61046;40144364;35624178;1442697;2089;1271747
FR;1;2021-10-09;27419;47969;25473;30;25970;40171783;35672147;1468170;2119;1297717
FR;1;2021-10-10;3597;5779;2746;7;2845;40175380;35677926;1470916;2126;1300562
FR;1;2021-10-11;24694;38163;54559;88;55164;40200074;35716089;1525475;2214;1355726
FR;1;2021-10-12;23085;36577;58020;126;59079;40223159;35752666;1583495;2340;1414805
FR;1;2021-10-13;32794;47794;64142;124;65611;40255953;35800460;1647637;2464;1480416
FR;1;2021-10-14;21590;34750;53723;103;54283;40277543;35835210;1701360;2567;1534699
FR;1;2021-10-15;32546;48796;72295;165;74907;40310089;35884006;1773655;2732;1609606
FR;1;2021-10-16;25955;35274;34857;44;36390;40336044;35919280;1808512;2776;1645996
FR;1;2021-10-17;3096;4064;3407;2;3318;40339140;35923344;1811919;2778;1649314
FR;1;2021-10-18;23434;34904;66803;131;69645;40362574;35958248;1878722;2909;1718959
FR;1;2021-10-19;20585;34433;75625;136;79511;40383159;35992681;1954347;3045;1798470
FR;1;2021-10-20;29795;44189;96136;177;99751;40412954;36036870;2050483;3222;1898221
FR;1;2021-10-21;19582;35077;83118;107;86973;40432536;36071947;2133601;3329;1985194
FR;1;2021-10-22;29524;47626;103697;195;109562;40462060;36119573;2237298;3524;2094756
FR;1;2021-10-23;23001;35150;44846;57;47344;40485061;36154723;2282144;3581;2142100
FR;1;2021-10-24;2373;3878;3579;6;3732;40487434;36158601;2285723;3587;2145832
FR;1;2021-10-25;22385;30821;81991;143;85755;40509819;36189422;2367714;3730;2231587
FR;1;2021-10-26;19294;27702;86058;162;90275;40529113;36217124;2453772;3892;2321862
FR;1;2021-10-27;26127;39656;107752;252;112590;40555240;36256780;2561524;4144;2434452
FR;1;2021-10-28;18582;27038;86890;150;91559;40573822;36283818;2648414;4294;2526011
FR;1;2021-10-29;25868;40146;114782;200;121507;40599690;36323964;2763196;4494;2647518
FR;1;2021-10-30;17665;28604;49339;75;51914;40617355;36352568;2812535;4569;2699432
FR;1;2021-10-31;2053;3202;3442;2;3677;40619408;36355770;2815977;4571;2703109
FR;1;2021-11-01;7697;4199;3021;3;3263;40627105;36359969;2818998;4574;2706372
FR;1;2021-11-02;21828;33198;92339;157;97676;40648933;36393167;2911337;4731;2804048
FR;1;2021-11-03;26273;41519;117434;215;123781;40675206;36434686;3028771;4946;2927829
FR;1;2021-11-04;19483;30285;105729;213;111812;40694689;36464971;3134500;5159;3039641
FR;1;2021-11-05;26897;42237;138712;227;147285;40721586;36507208;3273212;5386;3186926
FR;1;2021-11-06;18801;29819;63441;123;66406;40740387;36537027;3336653;5509;3253332
FR;1;2021-11-07;1787;3354;4952;6;5292;40742174;36540381;3341605;5515;3258624
FR;1;2021-11-08;17651;32309;125899;224;132450;40759825;36572690;3467504;5739;3391074
FR;1;2021-11-09;19214;37714;159210;335;168910;40779039;36610404;3626714;6074;3559984
FR;1;2021-11-10;28654;49134;181811;440;192349;40807693;36659538;3808525;6514;3752333
FR;1;2021-11-11;3777;5924;12188;26;12994;40811470;36665462;3820713;6540;3765327
FR;1;2021-11-12;25929;46871;174735;243;186330;40837399;36712333;3995448;6783;3951657
FR;1;2021-11-13;18679;29251;76800;111;81738;40856078;36741584;4072248;6894;4033395
FR;1;2021-11-14;2022;3316;6812;5;7386;40858100;36744900;4079060;6899;4040781
FR;1;2021-11-15;18577;34886;156330;303;166090;40876677;36779786;4235390;7202;4206871
FR;1;2021-11-16;21056;37921;191997;376;204770;40897733;36817707;4427387;7578;4411641
FR;1;2021-11-17;28488;45728;193140;399;204916;40926221;36863435;4620527;7977;4616557
FR;1;2021-11-18;21043;38818;182381;457;194348;40947264;36902253;4802908;8434;4810905
FR;1;2021-11-19;30770;53376;230136;529;246549;40978034;36955629;5033044;8963;5057454
FR;1;2021-11-20;23675;33319;96938;201;103573;41001709;36988948;5129982;9164;5161027
FR;1;2021-11-21;2313;4015;9095;18;9968;41004022;36992963;5139077;9182;5170995
FR;1;2021-11-22;21354;30461;175789;465;189303;41025376;37023424;5314866;9647;5360298
FR;1;2021-11-23;23871;41174;221086;538;237786;41049247;37064598;5535952;10185;5598084
FR;1;2021-11-24;30253;49746;217252;703;234357;41079500;37114344;5753204;10888;5832441
FR;1;2021-11-25;23478;43941;244337;719;263885;41102978;37158285;5997541;11607;6096326
FR;1;2021-11-26;30580;66553;356666;832;388354;41133558;37224838;6354207;12439;6484680
FR;1;2021-11-27;21758;45362;202546;371;222520;41155316;37270200;6556753;12810;6707200
FR;1;2021-11-28;3137;9675;54752;63;61027;41158453;37279875;6611505;12873;6768227
FR;1;2021-11-29;17853;49516;326260;840;354235;41176306;37329391;6937765;13713;7122462
FR;1;2021-11-30;22735;64980;431023;948;470591;41199041;37394371;7368788;14661;7593053
FR;1;2021-12-01;24849;69365;442732;1130;481571;41223890;37463736;7811520;15791;8074624
FR;1;2021-12-02;19959;64422;489238;1227;532671;41243849;37528158;8300758;17018;8607295
FR;1;2021-12-03;22823;81815;542595;1307;591573;41266672;37609973;8843353;18325;9198868
FR;1;2021-12-04;16366;53933;299018;652;328847;41283038;37663906;9142371;18977;9527715
FR;1;2021-12-05;3622;13921;81495;143;91052;41286660;37677827;9223866;19120;9618767
FR;1;2021-12-06;20197;62785;415297;1065;455012;41306857;37740612;9639163;20185;10073779
FR;1;2021-12-07;19783;75821;522795;1531;572390;41326640;37816433;10161958;21716;10646169
FR;1;2021-12-08;21547;75806;458208;1543;501887;41348187;37892239;10620166;23259;11148056
FR;1;2021-12-09;19386;74106;492749;1625;540608;41367573;37966345;11112915;24884;11688664
FR;1;2021-12-10;22934;87631;547255;1584;599841;41390507;38053976;11660170;26468;12288505
FR;1;2021-12-11;16512;59022;302673;747;335423;41407019;38112998;11962843;27215;12623928
FR;1;2021-12-12;4343;16026;83178;179;94082;41411362;38129024;12046021;27394;12718010
FR;1;2021-12-13;15466;63829;366821;1094;406186;41426828;38192853;12412842;28488;13124196
FR;1;2021-12-14;20465;80302;464535;1738;515010;41447293;38273155;12877377;30226;13639206
FR;1;2021-12-15;21380;77503;408910;1307;452988;41468673;38350658;13286287;31533;14092194
FR;1;2021-12-16;19952;77388;451670;1574;500456;41488625;38428046;13737957;33107;14592650
FR;1;2021-12-17;22512;86715;479782;1732;530920;41511137;38514761;14217739;34839;15123570
FR;1;2021-12-18;17582;54713;257556;730;288463;41528719;38569474;14475295;35569;15412033
FR;1;2021-12-19;5537;17136;79129;194;90741;41534256;38586610;14554424;35763;15502774
FR;1;2021-12-20;20770;63161;316094;1081;355160;41555026;38649771;14870518;36844;15857934
FR;1;2021-12-21;26094;73239;372617;1421;417977;41581120;38723010;15243135;38265;16275911
FR;1;2021-12-22;24891;65988;310500;1215;349470;41606011;38788998;15553635;39480;16625381
FR;1;2021-12-23;21233;52357;241385;954;272982;41627244;38841355;15795020;40434;16898363
FR;1;2021-12-24;7099;18244;67105;256;77023;41634343;38859599;15862125;40690;16975386
FR;1;2021-12-25;499;2764;5566;15;6526;41634842;38862363;15867691;40705;16981912
FR;1;2021-12-26;2747;7597;26922;70;31447;41637589;38869960;15894613;40775;17013359
FR;1;2021-12-27;18182;53567;235011;707;265698;41655771;38923527;16129624;41482;17279057
FR;1;2021-12-28;23240;61996;291944;1025;330127;41679011;38985523;16421568;42507;17609184
FR;1;2021-12-29;22192;55557;254909;918;288125;41701203;39041080;16676477;43425;17897309
FR;1;2021-12-30;21220;46349;212093;857;239562;41722423;39087429;16888570;44282;18136871
FR;1;2021-12-31;7456;16613;61832;229;70356;41729879;39104042;16950402;44511;18207227
FR;1;2022-01-01;907;2476;5643;29;6573;41730786;39106518;16956045;44540;18213800
FR;1;2022-01-02;3041;8062;28869;50;33521;41733827;39114580;16984914;44590;18247321
FR;1;2022-01-03;19945;53841;228101;786;257505;41753772;39168421;17213015;45376;18504826
FR;1;2022-01-04;24975;64827;299144;1235;337182;41778747;39233248;17512159;46611;18842008
FR;1;2022-01-05;29672;63902;274761;1098;310106;41808419;39297150;17786920;47709;19152114
FR;1;2022-01-06;26487;65983;306793;1395;346426;41834906;39363133;18093713;49104;19498540
FR;1;2022-01-07;31294;74653;349751;1534;393829;41866200;39437786;18443464;50638;19892369
FR;1;2022-01-08;23342;51381;222457;695;251091;41889542;39489167;18665921;51333;20143460
FR;1;2022-01-09;7075;17196;66011;163;76154;41896617;39506363;18731932;51496;20219614
FR;1;2022-01-10;21432;55643;236688;952;267063;41918049;39562006;18968620;52448;20486677
FR;1;2022-01-11;26480;63057;282194;1277;317740;41944529;39625063;19250814;53725;20804417
FR;1;2022-01-12;28706;62235;246143;1102;277915;41973235;39687298;19496957;54827;21082332
FR;1;2022-01-13;24430;59922;262701;1253;296046;41997665;39747220;19759658;56080;21378378
FR;1;2022-01-14;27774;66527;313898;1366;351178;42025439;39813747;20073556;57446;21729556
FR;1;2022-01-15;19258;44322;199266;619;223840;42044697;39858069;20272822;58065;21953396
FR;1;2022-01-16;5133;12988;51495;135;59568;42049830;39871057;20324317;58200;22012964
FR;1;2022-01-17;16737;39715;184771;779;206821;42066567;39910772;20509088;58979;22219785
FR;1;2022-01-18;19238;45700;212350;1151;236975;42085805;39956472;20721438;60130;22456760
FR;1;2022-01-19;20143;43910;176031;894;197161;42105948;40000382;20897469;61024;22653921
FR;1;2022-01-20;16588;40377;183579;1137;204670;42122536;40040759;21081048;62161;22858591
FR;1;2022-01-21;19705;46948;228879;1405;253293;42142241;40087707;21309927;63566;23111884
FR;1;2022-01-22;13826;33214;144465;578;161364;42156067;40120921;21454392;64144;23273248
FR;1;2022-01-23;3344;8808;33400;130;38327;42159411;40129729;21487792;64274;23311575
FR;1;2022-01-24;11726;32640;142155;706;158238;42171137;40162369;21629947;64980;23469813
FR;1;2022-01-25;14093;37985;163333;1049;181515;42185230;40200354;21793280;66029;23651328
FR;1;2022-01-26;14823;37363;150194;931;166253;42200053;40237717;21943474;66960;23817581
FR;1;2022-01-27;12281;32876;143385;882;157868;42212334;40270593;22086859;67842;23975449
FR;1;2022-01-28;16247;53847;198243;1143;222449;42228581;40324440;22285102;68985;24197898
FR;1;2022-01-29;10257;35437;135173;522;151544;42238838;40359877;22420275;69507;24349442
FR;1;2022-01-30;2475;9303;29667;86;34465;42241313;40369180;22449942;69593;24383907
FR;1;2022-01-31;8726;32346;104297;530;117386;42250039;40401526;22554239;70123;24501293
FR;1;2022-02-01;10173;36255;127016;862;141224;42260212;40437781;22681255;70985;24642517
FR;1;2022-02-02;11425;41108;130289;780;145836;42271637;40478889;22811544;71765;24788353
FR;1;2022-02-03;8734;33382;116949;780;130348;42280371;40512271;22928493;72545;24918701
FR;1;2022-02-04;11384;48084;172519;965;192781;42291755;40560355;23101012;73510;25111482
FR;1;2022-02-05;7882;33901;117549;391;133051;42299637;40594256;23218561;73901;25244533
FR;1;2022-02-06;1689;8054;22734;83;26905;42301326;40602310;23241295;73984;25271438
FR;1;2022-02-07;7071;35347;119038;452;134963;42308397;40637657;23360333;74436;25406401
FR;1;2022-02-08;7557;31535;125597;693;140571;42315954;40669192;23485930;75129;25546972
FR;1;2022-02-09;8447;36126;135200;694;152414;42324401;40705318;23621130;75823;25699386
FR;1;2022-02-10;6575;29269;116291;674;130034;42330976;40734587;23737421;76497;25829420
FR;1;2022-02-11;8545;41316;165071;875;185277;42339521;40775903;23902492;77372;26014697
FR;1;2022-02-12;5287;27525;106671;378;120842;42344808;40803428;24009163;77750;26135539
FR;1;2022-02-13;1222;5699;21703;62;25315;42346030;40809127;24030866;77812;26160854
FR;1;2022-02-14;5373;27071;118031;388;133051;42351403;40836198;24148897;78200;26293905
FR;1;2022-02-15;5581;28091;118843;609;132433;42356984;40864289;24267740;78809;26426338
FR;1;2022-02-16;5639;28110;110369;592;122963;42362623;40892399;24378109;79401;26549301
FR;1;2022-02-17;4407;19115;73088;486;80136;42367030;40911514;24451197;79887;26629437
FR;1;2022-02-18;5487;26439;99142;668;108082;42372517;40937953;24550339;80555;26737519
FR;1;2022-02-19;3524;17077;59457;304;66027;42376041;40955030;24609796;80859;26803546
FR;1;2022-02-20;780;3223;10690;35;12311;42376821;40958253;24620486;80894;26815857
FR;1;2022-02-21;3354;14465;52790;286;57634;42380175;40972718;24673276;81180;26873491
FR;1;2022-02-22;3712;15354;51869;499;55590;42383887;40988072;24725145;81679;26929081
FR;1;2022-02-23;4154;17600;57441;508;62542;42388041;41005672;24782586;82187;26991623
FR;1;2022-02-24;3240;12747;43567;436;46346;42391281;41018419;24826153;82623;27037969
FR;1;2022-02-25;4390;19387;64838;695;68699;42395671;41037806;24890991;83318;27106668
FR;1;2022-02-26;2677;12682;41343;308;45096;42398348;41050488;24932334;83626;27151764
FR;1;2022-02-27;639;2167;7115;42;7980;42398987;41052655;24939449;83668;27159744
FR;1;2022-02-28;2561;10117;34920;301;37341;42401548;41062772;24974369;83969;27197085
FR;1;2022-03-01;2709;10379;38639;389;39561;42404257;41073151;25013008;84358;27236646
FR;1;2022-03-02;3433;11858;41804;390;43852;42407690;41085009;25054812;84748;27280498
FR;1;2022-03-03;2287;7525;26116;319;26427;42409977;41092534;25080928;85067;27306925
FR;1;2022-03-04;2645;10207;35385;575;34863;42412622;41102741;25116313;85642;27341788
FR;1;2022-03-05;1671;6289;21940;277;22325;42414293;41109030;25138253;85919;27364113
FR;1;2022-03-06;349;936;2914;37;3112;42414642;41109966;25141167;85956;27367225
FR;1;2022-03-07;1363;4562;16404;244;15860;42416005;41114528;25157571;86200;27383085
FR;1;2022-03-08;1533;5080;17124;307;15942;42417538;41119608;25174695;86507;27399027
FR;1;2022-03-09;1859;6459;19772;366;19119;42419397;41126067;25194467;86873;27418146
FR;1;2022-03-10;1296;4372;15186;305;14193;42420693;41130439;25209653;87178;27432339
FR;1;2022-03-11;1690;6143;21670;480;19819;42422383;41136582;25231323;87658;27452158
FR;1;2022-03-12;1227;4592;15350;276;14895;42423610;41141174;25246673;87934;27467053
FR;1;2022-03-13;239;602;2102;115;2049;42423849;41141776;25248775;88049;27469102
FR;1;2022-03-14;1062;3551;13361;3873;12484;42424911;41145327;25262136;91922;27481586
FR;1;2022-03-15;1255;3822;14516;6861;12993;42426166;41149149;25276652;98783;27494579
FR;1;2022-03-16;1600;4727;17325;11513;16375;42427766;41153876;25293977;110296;27510954
FR;1;2022-03-17;1092;3150;11675;9637;10769;42428858;41157026;25305652;119933;27521723
FR;1;2022-03-18;1660;4678;17907;16484;16334;42430518;41161704;25323559;136417;27538057
FR;1;2022-03-19;1109;3165;11878;8450;11342;42431627;41164869;25335437;144867;27549399
FR;1;2022-03-20;217;531;1714;1006;1746;42431844;41165400;25337151;145873;27551145
FR;1;2022-03-21;1037;2675;11468;13442;10813;42432881;41168075;25348619;159315;27561958
FR;1;2022-03-22;1188;3056;12216;18681;11203;42434069;41171131;25360835;177996;27573161
FR;1;2022-03-23;1459;4149;15952;20090;15632;42435528;41175280;25376787;198086;27588793
FR;1;2022-03-24;1070;2508;10349;16012;9600;42436598;41177788;25387136;214098;27598393
FR;1;2022-03-25;1497;4006;16664;25278;15309;42438095;41181794;25403800;239376;27613702
FR;1;2022-03-26;1096;2837;10836;11429;10494;42439191;41184631;25414636;250805;27624196
FR;1;2022-03-27;227;536;1721;1376;1773;42439418;41185167;25416357;252181;27625969
FR;1;2022-03-28;1031;2331;9910;15859;9528;42440449;41187498;25426267;268040;27635497
FR;1;2022-03-29;1109;2693;11509;25060;10875;42441558;41190191;25437776;293100;27646372
FR;1;2022-03-30;1590;3454;14092;24144;13621;42443148;41193645;25451868;317244;27659993
FR;1;2022-03-31;1259;2592;11575;22542;11080;42444407;41196237;25463443;339786;27671073
FR;1;2022-04-01;1644;3718;18390;28446;17236;42446051;41199955;25481833;368232;27688309
FR;1;2022-04-02;880;1852;8168;9203;7916;42446931;41201807;25490001;377435;27696225
FR;1;2022-04-03;185;362;1426;1056;1426;42447116;41202169;25491427;378491;27697651
FR;1;2022-04-04;1040;2127;11161;17615;10531;42448156;41204296;25502588;396106;27708182
FR;1;2022-04-05;1236;2466;12904;31089;11918;42449392;41206762;25515492;427195;27720100
FR;1;2022-04-06;1312;2680;12077;23738;11488;42450704;41209442;25527569;450933;27731588
FR;1;2022-04-07;1126;2461;12254;30862;11711;42451830;41211903;25539823;481795;27743299
FR;1;2022-04-08;1553;3450;17455;40387;16367;42453383;41215353;25557278;522182;27759666
FR;1;2022-04-09;797;1969;8379;12473;8073;42454180;41217322;25565657;534655;27767739
FR;1;2022-04-10;180;454;1818;1831;1850;42454360;41217776;25567475;536486;27769589
FR;1;2022-04-11;933;2094;10909;22104;10619;42455293;41219870;25578384;558590;27780208
FR;1;2022-04-12;1189;2373;12694;37779;12184;42456482;41222243;25591078;596369;27792392
FR;1;2022-04-13;1149;2577;12150;30263;11866;42457631;41224820;25603228;626632;27804258
FR;1;2022-04-14;1165;2275;11937;33199;11917;42458796;41227095;25615165;659831;27816175
FR;1;2022-04-15;1401;2765;14264;32913;13638;42460197;41229860;25629429;692744;27829813
FR;1;2022-04-16;646;1387;5811;7968;5732;42460843;41231247;25635240;700712;27835545
FR;1;2022-04-17;148;270;927;1101;969;42460991;41231517;25636167;701813;27836514
FR;1;2022-04-18;114;366;2597;968;2620;42461105;41231883;25638764;702781;27839134
FR;1;2022-04-19;1178;2471;11694;27573;11370;42462283;41234354;25650458;730354;27850504
FR;1;2022-04-20;1246;2503;12019;26538;11843;42463529;41236857;25662477;756892;27862347
FR;1;2022-04-21;1198;2321;11401;32795;11558;42464727;41239178;25673878;789687;27873905
FR;1;2022-04-22;1464;2932;15115;35242;14693;42466191;41242110;25688993;824929;27888598
FR;1;2022-04-23;730;1552;6698;9861;6600;42466921;41243662;25695691;834790;27895198
FR;1;2022-04-24;180;353;1362;1504;1315;42467101;41244015;25697053;836294;27896513
FR;1;2022-04-25;979;2026;9778;19476;9665;42468080;41246041;25706831;855770;27906178
FR;1;2022-04-26;1277;2560;12500;36114;12089;42469357;41248601;25719331;891884;27918267
FR;1;2022-04-27;1258;2344;10533;28705;10645;42470615;41250945;25729864;920589;27928912
FR;1;2022-04-28;1239;2266;11409;33719;11230;42471854;41253211;25741273;954308;27940142
FR;1;2022-04-29;1553;2877;14199;35059;13621;42473407;41256088;25755472;989367;27953763
FR;1;2022-04-30;797;1425;6278;9086;6108;42474204;41257513;25761750;998453;27959871
FR;1;2022-05-01;138;257;796;909;792;42474342;41257770;25762546;999362;27960663
FR;1;2022-05-02;868;1773;9839;16515;9719;42475210;41259543;25772385;1015877;27970382
FR;1;2022-05-03;1335;2480;12212;32247;12112;42476545;41262023;25784597;1048124;27982494
FR;1;2022-05-04;1249;2359;10418;23246;10564;42477794;41264382;25795015;1071370;27993058
FR;1;2022-05-05;1293;2297;11146;31072;10955;42479087;41266679;25806161;1102442;28004013
FR;1;2022-05-06;1634;3054;13796;34482;13349;42480721;41269733;25819957;1136924;28017362
FR;1;2022-05-07;808;1426;5693;9029;5739;42481529;41271159;25825650;1145953;28023101
FR;1;2022-05-08;180;306;975;1437;1043;42481709;41271465;25826625;1147390;28024144
FR;1;2022-05-09;980;1785;8388;18809;8319;42482689;41273250;25835013;1166199;28032463
FR;1;2022-05-10;1321;2410;11350;36265;11021;42484010;41275660;25846363;1202464;28043484
FR;1;2022-05-11;1339;2110;9113;25382;9019;42485349;41277770;25855476;1227846;28052503
FR;1;2022-05-12;1223;2166;9942;32729;9584;42486572;41279936;25865418;1260575;28062087
FR;1;2022-05-13;1530;2633;12150;35072;11812;42488102;41282569;25877568;1295647;28073899
FR;1;2022-05-14;748;1237;5035;10080;4919;42488850;41283806;25882603;1305727;28078818
FR;1;2022-05-15;201;336;1015;1320;1097;42489051;41284142;25883618;1307047;28079915
FR;1;2022-05-16;887;1558;6787;19296;6848;42489938;41285700;25890405;1326343;28086763
FR;1;2022-05-17;1203;2086;9689;34922;9349;42491141;41287786;25900094;1361265;28096112
FR;1;2022-05-18;1201;1889;7792;24781;7743;42492342;41289675;25907886;1386046;28103855
FR;1;2022-05-19;1105;2119;8708;32196;8647;42493447;41291794;25916594;1418242;28112502
FR;1;2022-05-20;1470;2455;10902;36212;10547;42494917;41294249;25927496;1454454;28123049
FR;1;2022-05-21;742;1259;4556;9054;4533;42495659;41295508;25932052;1463508;28127582
FR;1;2022-05-22;166;253;870;1216;866;42495825;41295761;25932922;1464724;28128448
FR;1;2022-05-23;821;1507;6251;17562;6122;42496646;41297268;25939173;1482286;28134570
FR;2;2020-12-27;0;0;0;0;0;0;0;0;0;0
FR;2;2020-12-28;0;0;0;0;0;0;0;0;0;0
FR;2;2020-12-29;0;0;0;0;0;0;0;0;0;0
FR;2;2020-12-30;0;0;0;0;0;0;0;0;0;0
FR;2;2020-12-31;0;0;0;0;0;0;0;0;0;0
FR;2;2021-01-01;0;0;0;0;0;0;0;0;0;0
FR;2;2021-01-02;0;0;0;0;0;0;0;0;0;0
FR;2;2021-01-03;0;0;0;0;0;0;0;0;0;0
FR;2;2021-01-04;0;0;0;0;0;0;0;0;0;0
FR;2;2021-01-05;0;0;0;0;0;0;0;0;0;0
FR;2;2021-01-06;0;0;0;0;0;0;0;0;0;0
FR;2;2021-01-07;0;0;0;0;0;0;0;0;0;0
FR;2;2021-01-08;0;0;0;0;0;0;0;0;0;0
FR;2;2021-01-09;0;0;0;0;0;0;0;0;0;0
FR;2;2021-01-10;0;0;0;0;0;0;0;0;0;0
FR;2;2021-01-11;0;0;0;0;0;0;0;0;0;0
FR;2;2021-01-12;0;0;0;0;0;0;0;0;0;0
FR;2;2021-01-13;0;0;0;0;0;0;0;0;0;0
FR;2;2021-01-14;1689;0;0;0;0;1689;0;0;0;0
FR;2;2021-01-15;394;0;0;0;0;2083;0;0;0;0
FR;2;2021-01-16;315;0;0;0;0;2398;0;0;0;0
FR;2;2021-01-17;80;0;0;0;0;2478;0;0;0;0
FR;2;2021-01-18;3073;2;0;0;0;5551;2;0;0;0
FR;2;2021-01-19;4675;0;0;0;0;10226;2;0;0;0
FR;2;2021-01-20;5135;4;0;0;0;15361;6;0;0;0
FR;2;2021-01-21;5336;8;0;0;0;20697;14;0;0;0
FR;2;2021-01-22;5115;6;0;0;0;25812;20;0;0;0
FR;2;2021-01-23;1866;0;0;0;0;27678;20;0;0;0
FR;2;2021-01-24;160;1;0;0;0;27838;21;0;0;0
FR;2;2021-01-25;3811;3;0;0;0;31649;24;0;0;0
FR;2;2021-01-26;3918;1;0;0;0;35567;25;0;0;0
FR;2;2021-01-27;3598;2;0;0;0;39165;27;0;0;0
FR;2;2021-01-28;3745;7;0;0;0;42910;34;0;0;0
FR;2;2021-01-29;3291;2;0;0;0;46201;36;0;0;0
FR;2;2021-01-30;1130;1;0;0;0;47331;37;0;0;0
FR;2;2021-01-31;45;1;0;0;0;47376;38;0;0;0
FR;2;2021-02-01;3399;3;0;0;0;50775;41;0;0;0
FR;2;2021-02-02;4487;10;0;0;0;55262;51;0;0;0
FR;2;2021-02-03;5216;6;0;0;0;60478;57;0;0;0
FR;2;2021-02-04;4931;10;0;0;0;65409;67;0;0;0
FR;2;2021-02-05;4810;13;0;0;0;70219;80;0;0;0
FR;2;2021-02-06;2040;12;0;0;0;72259;92;0;0;0
FR;2;2021-02-07;101;4;0;0;0;72360;96;0;0;0
FR;2;2021-02-08;7553;19;0;0;0;79913;115;0;0;0
FR;2;2021-02-09;8420;27;0;0;0;88333;142;0;0;0
FR;2;2021-02-10;9337;56;0;0;0;97670;198;0;0;0
FR;2;2021-02-11;10279;96;0;0;0;107949;294;0;0;0
FR;2;2021-02-12;10053;260;0;0;0;118002;554;0;0;0
FR;2;2021-02-13;3118;225;0;0;0;121120;779;0;0;0
FR;2;2021-02-14;355;8;0;0;0;121475;787;0;0;0
FR;2;2021-02-15;3454;3094;0;0;0;124929;3881;0;0;0
FR;2;2021-02-16;5067;4022;0;0;0;129996;7903;0;0;0
FR;2;2021-02-17;4252;4466;0;0;0;134248;12369;0;0;0
FR;2;2021-02-18;5399;5115;0;0;0;139647;17484;0;0;0
FR;2;2021-02-19;5324;4396;0;0;0;144971;21880;0;0;0
FR;2;2021-02-20;1868;1508;0;0;0;146839;23388;0;0;0
FR;2;2021-02-21;242;88;0;0;0;147081;23476;0;0;0
FR;2;2021-02-22;3611;3745;0;0;0;150692;27221;0;0;0
FR;2;2021-02-23;4952;3693;0;0;0;155644;30914;0;0;0
FR;2;2021-02-24;5010;3495;0;0;0;160654;34409;0;0;0
FR;2;2021-02-25;5481;3452;0;0;0;166135;37861;0;0;0
FR;2;2021-02-26;4360;3147;0;0;0;170495;41008;0;0;0
FR;2;2021-02-27;1623;1053;0;0;0;172118;42061;0;0;0
FR;2;2021-02-28;176;29;0;0;0;172294;42090;0;0;0
FR;2;2021-03-01;5177;3728;0;0;0;177471;45818;0;0;0
FR;2;2021-03-02;6528;4727;0;0;0;183999;50545;0;0;0
FR;2;2021-03-03;6533;4919;0;0;0;190532;55464;0;0;0
FR;2;2021-03-04;8395;4052;0;0;0;198927;59516;0;0;0
FR;2;2021-03-05;8027;4062;0;0;0;206954;63578;0;0;0
FR;2;2021-03-06;4783;1683;0;0;0;211737;65261;0;0;0
FR;2;2021-03-07;2372;30;0;0;0;214109;65291;0;0;0
FR;2;2021-03-08;4164;8331;0;0;0;218273;73622;0;0;0
FR;2;2021-03-09;7485;8494;1;0;0;225758;82116;1;0;0
FR;2;2021-03-10;7098;9141;0;0;0;232856;91257;1;0;0
FR;2;2021-03-11;9372;9239;1;0;0;242228;100496;2;0;0
FR;2;2021-03-12;7972;8222;0;0;0;250200;108718;2;0;0
FR;2;2021-03-13;10046;2555;0;0;0;260246;111273;2;0;0
FR;2;2021-03-14;4838;404;0;0;0;265084;111677;2;0;0
FR;2;2021-03-15;10905;3487;0;0;0;275989;115164;2;0;0
FR;2;2021-03-16;16760;4646;1;0;0;292749;119810;3;0;0
FR;2;2021-03-17;20225;3973;0;0;0;312974;123783;3;0;0
FR;2;2021-03-18;23364;4970;0;0;0;336338;128753;3;0;0
FR;2;2021-03-19;23301;4576;0;0;0;359639;133329;3;0;0
FR;2;2021-03-20;25441;1547;0;0;0;385080;134876;3;0;0
FR;2;2021-03-21;17669;150;0;0;0;402749;135026;3;0;0
FR;2;2021-03-22;17782;3138;0;0;0;420531;138164;3;0;0
FR;2;2021-03-23;22686;4202;0;0;0;443217;142366;3;0;0
FR;2;2021-03-24;23954;5016;0;0;0;467171;147382;3;0;0
FR;2;2021-03-25;26736;5137;1;0;0;493907;152519;4;0;0
FR;2;2021-03-26;26975;4203;0;0;0;520882;156722;4;0;0
FR;2;2021-03-27;15917;1329;0;0;0;536799;158051;4;0;0
FR;2;2021-03-28;10561;119;0;0;0;547360;158170;4;0;0
FR;2;2021-03-29;18984;4286;0;0;0;566344;162456;4;0;0
FR;2;2021-03-30;24575;6029;0;0;0;590919;168485;4;0;0
FR;2;2021-03-31;28553;5929;0;0;0;619472;174414;4;0;0
FR;2;2021-04-01;34544;8495;1;0;0;654016;182909;5;0;0
FR;2;2021-04-02;29976;7669;0;0;0;683992;190578;5;0;0
FR;2;2021-04-03;16953;3774;0;0;0;700945;194352;5;0;0
FR;2;2021-04-04;9305;1022;2;0;0;710250;195374;7;0;0
FR;2;2021-04-05;12443;806;0;0;0;722693;196180;7;0;0
FR;2;2021-04-06;27142;7025;0;0;0;749835;203205;7;0;0
FR;2;2021-04-07;30926;7141;1;0;0;780761;210346;8;0;0
FR;2;2021-04-08;36879;8731;1;0;0;817640;219077;9;0;0
FR;2;2021-04-09;33834;8549;28;0;0;851474;227626;37;0;0
FR;2;2021-04-10;19678;9054;1;0;0;871152;236680;38;0;0
FR;2;2021-04-11;7941;4256;1;0;0;879093;240936;39;0;0
FR;2;2021-04-12;17121;11144;0;0;0;896214;252080;39;0;0
FR;2;2021-04-13;19448;16203;1;0;0;915662;268283;40;0;0
FR;2;2021-04-14;18060;16300;7;0;0;933722;284583;47;0;0
FR;2;2021-04-15;22186;20976;27;0;0;955908;305559;74;0;0
FR;2;2021-04-16;20705;20135;45;0;0;976613;325694;119;0;0
FR;2;2021-04-17;13253;22428;5;0;0;989866;348122;124;0;0
FR;2;2021-04-18;5907;14394;6;0;0;995773;362516;130;0;0
FR;2;2021-04-19;16830;16273;24;0;0;1012603;378789;154;0;0
FR;2;2021-04-20;19318;21588;38;0;0;1031921;400377;192;0;0
FR;2;2021-04-21;20280;21700;76;0;0;1052201;422077;268;0;0
FR;2;2021-04-22;23809;24864;41;0;0;1076010;446941;309;0;0
FR;2;2021-04-23;24516;25349;76;0;0;1100526;472290;385;0;0
FR;2;2021-04-24;25300;15091;104;0;0;1125826;487381;489;0;0
FR;2;2021-04-25;9592;8600;5;0;0;1135418;495981;494;0;0
FR;2;2021-04-26;17157;17247;21;0;0;1152575;513228;515;0;0
FR;2;2021-04-27;19240;24220;40;0;0;1171815;537448;555;0;0
FR;2;2021-04-28;22333;26216;112;0;0;1194148;563664;667;0;0
FR;2;2021-04-29;25465;30148;69;0;0;1219613;593812;736;0;0
FR;2;2021-04-30;25529;27741;49;1;0;1245142;621553;785;1;0
FR;2;2021-05-01;14981;9875;6;0;0;1260123;631428;791;1;0
FR;2;2021-05-02;6635;9172;2;0;0;1266758;640600;793;1;0
FR;2;2021-05-03;20012;19250;40;0;0;1286770;659850;833;1;0
FR;2;2021-05-04;18280;29039;33;0;0;1305050;688889;866;1;0
FR;2;2021-05-05;18359;29387;48;0;0;1323409;718276;914;1;0
FR;2;2021-05-06;23538;35236;131;0;0;1346947;753512;1045;1;0
FR;2;2021-05-07;25322;33198;97;0;0;1372269;786710;1142;1;0
FR;2;2021-05-08;21337;9810;14;0;0;1393606;796520;1156;1;0
FR;2;2021-05-09;13162;7842;7;0;0;1406768;804362;1163;1;0
FR;2;2021-05-10;32937;22117;49;0;0;1439705;826479;1212;1;0
FR;2;2021-05-11;43595;21031;101;0;0;1483300;847510;1313;1;0
FR;2;2021-05-12;50039;19841;143;0;0;1533339;867351;1456;1;0
FR;2;2021-05-13;51289;5746;31;0;0;1584628;873097;1487;1;0
FR;2;2021-05-14;61343;12916;132;0;0;1645971;886013;1619;1;0
FR;2;2021-05-15;65925;7137;39;0;0;1711896;893150;1658;1;0
FR;2;2021-05-16;43581;2566;10;0;0;1755477;895716;1668;1;0
FR;2;2021-05-17;44742;12569;114;0;0;1800219;908285;1782;1;0
FR;2;2021-05-18;54633;12238;191;0;0;1854852;920523;1973;1;0
FR;2;2021-05-19;57163;10596;281;0;0;1912015;931119;2254;1;0
FR;2;2021-05-20;63430;10835;287;0;0;1975445;941954;2541;1;0
FR;2;2021-05-21;64288;11636;230;0;0;2039733;953590;2771;1;0
FR;2;2021-05-22;61479;4505;65;0;0;2101212;958095;2836;1;0
FR;2;2021-05-23;37531;570;22;0;0;2138743;958665;2858;1;0
FR;2;2021-05-24;17235;2035;34;0;0;2155978;960700;2892;1;0
FR;2;2021-05-25;21103;12223;240;0;0;2177081;972923;3132;1;0
FR;2;2021-05-26;19933;11453;229;0;0;2197014;984376;3361;1;0
FR;2;2021-05-27;22993;12662;182;0;0;2220007;997038;3543;1;0
FR;2;2021-05-28;29387;14947;190;0;0;2249394;1011985;3733;1;0
FR;2;2021-05-29;30417;8176;57;0;0;2279811;1020161;3790;1;0
FR;2;2021-05-30;4646;1816;6;0;0;2284457;1021977;3796;1;0
FR;2;2021-05-31;28584;18715;183;0;0;2313041;1040692;3979;1;0
FR;2;2021-06-01;45711;20006;224;0;0;2358752;1060698;4203;1;0
FR;2;2021-06-02;37461;19290;181;0;0;2396213;1079988;4384;1;0
FR;2;2021-06-03;51270;23315;161;0;0;2447483;1103303;4545;1;0
FR;2;2021-06-04;65508;24053;215;0;0;2512991;1127356;4760;1;0
FR;2;2021-06-05;34598;24032;51;0;0;2547589;1151388;4811;1;0
FR;2;2021-06-06;4953;6198;10;0;0;2552542;1157586;4821;1;0
FR;2;2021-06-07;28165;23039;146;0;0;2580707;1180625;4967;1;0
FR;2;2021-06-08;46368;22919;143;0;0;2627075;1203544;5110;1;0
FR;2;2021-06-09;34284;20916;107;0;0;2661359;1224460;5217;1;0
FR;2;2021-06-10;42635;19133;95;1;0;2703994;1243593;5312;2;0
FR;2;2021-06-11;55287;25221;134;0;0;2759281;1268814;5446;2;0
FR;2;2021-06-12;30559;19777;53;0;0;2789840;1288591;5499;2;0
FR;2;2021-06-13;3329;9186;13;0;0;2793169;1297777;5512;2;0
FR;2;2021-06-14;25295;24156;92;0;0;2818464;1321933;5604;2;0
FR;2;2021-06-15;39033;22841;154;0;0;2857497;1344774;5758;2;0
FR;2;2021-06-16;30159;21437;134;0;0;2887656;1366211;5892;2;0
FR;2;2021-06-17;36904;25858;150;0;0;2924560;1392069;6042;2;0
FR;2;2021-06-18;46845;28815;122;0;0;2971405;1420884;6164;2;0
FR;2;2021-06-19;24524;24890;39;0;0;2995929;1445774;6203;2;0
FR;2;2021-06-20;3740;10065;10;0;0;2999669;1455839;6213;2;0
FR;2;2021-06-21;17521;42838;87;0;0;3017190;1498677;6300;2;0
FR;2;2021-06-22;28353;49561;110;0;0;3045543;1548238;6410;2;0
FR;2;2021-06-23;21788;49556;106;1;1;3067331;1597794;6516;3;1
FR;2;2021-06-24;28375;50281;133;0;0;3095706;1648075;6649;3;1
FR;2;2021-06-25;33398;60395;127;0;0;3129104;1708470;6776;3;1
FR;2;2021-06-26;16379;59247;54;1;0;3145483;1767717;6830;4;1
FR;2;2021-06-27;2564;29322;22;1;0;3148047;1797039;6852;5;1
FR;2;2021-06-28;12637;54339;82;0;0;3160684;1851378;6934;5;1
FR;2;2021-06-29;19841;59885;178;0;0;3180525;1911263;7112;5;1
FR;2;2021-06-30;16322;57872;252;17;0;3196847;1969135;7364;22;1
FR;2;2021-07-01;20482;59889;227;0;0;3217329;2029024;7591;22;1
FR;2;2021-07-02;24069;62138;184;0;0;3241398;2091162;7775;22;1
FR;2;2021-07-03;12111;57086;153;0;0;3253509;2148248;7928;22;1
FR;2;2021-07-04;1958;23309;18;0;0;3255467;2171557;7946;22;1
FR;2;2021-07-05;9170;29365;106;0;0;3264637;2200922;8052;22;1
FR;2;2021-07-06;14575;36204;135;0;0;3279212;2237126;8187;22;1
FR;2;2021-07-07;14403;33672;139;0;0;3293615;2270798;8326;22;1
FR;2;2021-07-08;19713;40295;162;0;0;3313328;2311093;8488;22;1
FR;2;2021-07-09;27093;54277;202;1;0;3340421;2365370;8690;23;1
FR;2;2021-07-10;13384;33667;107;0;0;3353805;2399037;8797;23;1
FR;2;2021-07-11;1805;4350;16;0;0;3355610;2403387;8813;23;1
FR;2;2021-07-12;12960;37278;118;0;0;3368570;2440665;8931;23;1
FR;2;2021-07-13;37110;53220;150;0;0;3405680;2493885;9081;23;1
FR;2;2021-07-14;6607;3559;15;0;0;3412287;2497444;9096;23;1
FR;2;2021-07-15;47232;47029;156;0;0;3459519;2544473;9252;23;1
FR;2;2021-07-16;64306;55814;187;0;0;3523825;2600287;9439;23;1
FR;2;2021-07-17;31592;23931;96;0;0;3555417;2624218;9535;23;1
FR;2;2021-07-18;6087;4881;19;0;0;3561504;2629099;9554;23;1
FR;2;2021-07-19;32987;28678;94;0;0;3594491;2657777;9648;23;1
FR;2;2021-07-20;51989;44569;155;0;0;3646480;2702346;9803;23;1
FR;2;2021-07-21;45243;34753;93;0;0;3691723;2737099;9896;23;1
FR;2;2021-07-22;56272;41092;128;1;0;3747995;2778191;10024;24;1
FR;2;2021-07-23;68276;49083;170;0;0;3816271;2827274;10194;24;1
FR;2;2021-07-24;36165;21593;82;0;0;3852436;2848867;10276;24;1
FR;2;2021-07-25;6742;2654;10;0;0;3859178;2851521;10286;24;1
FR;2;2021-07-26;36296;22450;91;1;0;3895474;2873971;10377;25;1
FR;2;2021-07-27;62355;34619;180;0;0;3957829;2908590;10557;25;1
FR;2;2021-07-28;55298;26456;132;0;0;4013127;2935046;10689;25;1
FR;2;2021-07-29;68455;32787;189;0;0;4081582;2967833;10878;25;1
FR;2;2021-07-30;74432;37774;222;1;1;4156014;3005607;11100;26;2
FR;2;2021-07-31;34750;16190;104;0;0;4190764;3021797;11204;26;2
FR;2;2021-08-01;5397;2280;19;0;0;4196161;3024077;11223;26;2
FR;2;2021-08-02;35862;16203;101;0;0;4232023;3040280;11324;26;2
FR;2;2021-08-03;55959;28287;142;0;0;4287982;3068567;11466;26;2
FR;2;2021-08-04;46623;20863;128;1;0;4334605;3089430;11594;27;2
FR;2;2021-08-05;54617;31584;215;0;0;4389222;3121014;11809;27;2
FR;2;2021-08-06;58081;42391;242;1;0;4447303;3163405;12051;28;2
FR;2;2021-08-07;25134;17604;89;0;0;4472437;3181009;12140;28;2
FR;2;2021-08-08;3832;3668;21;0;0;4476269;3184677;12161;28;2
FR;2;2021-08-09;29297;21132;91;0;0;4505566;3205809;12252;28;2
FR;2;2021-08-10;44989;33515;154;0;0;4550555;3239324;12406;28;2
FR;2;2021-08-11;35264;25170;151;0;0;4585819;3264494;12557;28;2
FR;2;2021-08-12;41893;35730;162;0;0;4627712;3300224;12719;28;2
FR;2;2021-08-13;42585;37062;218;0;0;4670297;3337286;12937;28;2
FR;2;2021-08-14;18509;22251;93;0;0;4688806;3359537;13030;28;2
FR;2;2021-08-15;3819;3814;17;0;0;4692625;3363351;13047;28;2
FR;2;2021-08-16;25079;27197;110;0;0;4717704;3390548;13157;28;2
FR;2;2021-08-17;38249;43485;205;2;0;4755953;3434033;13362;30;2
FR;2;2021-08-18;32246;36368;195;1;1;4788199;3470401;13557;31;3
FR;2;2021-08-19;37427;46584;224;0;0;4825626;3516985;13781;31;3
FR;2;2021-08-20;40556;55605;269;1;0;4866182;3572590;14050;32;3
FR;2;2021-08-21;18116;24308;115;0;0;4884298;3596898;14165;32;3
FR;2;2021-08-22;2902;4318;22;1;1;4887200;3601216;14187;33;4
FR;2;2021-08-23;19239;35160;131;1;1;4906439;3636376;14318;34;5
FR;2;2021-08-24;31941;56034;235;0;0;4938380;3692410;14553;34;5
FR;2;2021-08-25;25926;43427;250;0;0;4964306;3735837;14803;34;5
FR;2;2021-08-26;32350;55789;387;0;0;4996656;3791626;15190;34;5
FR;2;2021-08-27;36992;65593;478;2;0;5033648;3857219;15668;36;5
FR;2;2021-08-28;17814;28475;300;0;0;5051462;3885694;15968;36;5
FR;2;2021-08-29;2655;5038;47;0;0;5054117;3890732;16015;36;5
FR;2;2021-08-30;18409;37749;399;0;755;5072526;3928481;16414;36;760
FR;2;2021-08-31;28077;57492;885;4;1537;5100603;3985973;17299;40;2297
FR;2;2021-09-01;21589;39841;1307;0;2091;5122192;4025814;18606;40;4388
FR;2;2021-09-02;25476;48614;1960;2;3292;5147668;4074428;20566;42;7680
FR;2;2021-09-03;33404;64475;2986;3;4827;5181072;4138903;23552;45;12507
FR;2;2021-09-04;16826;27704;1442;1;2355;5197898;4166607;24994;46;14862
FR;2;2021-09-05;2259;3608;265;0;413;5200157;4170215;25259;46;15275
FR;2;2021-09-06;14034;28733;1769;1;2930;5214191;4198948;27028;47;18205
FR;2;2021-09-07;21103;41050;3020;13;4855;5235294;4239998;30048;60;23060
FR;2;2021-09-08;17241;31936;2732;6;4468;5252535;4271934;32780;66;27528
FR;2;2021-09-09;20973;40429;4432;3;6753;5273508;4312363;37212;69;34281
FR;2;2021-09-10;28195;51155;5282;4;8828;5301703;4363518;42494;73;43109
FR;2;2021-09-11;13652;22356;2403;5;3938;5315355;4385874;44897;78;47047
FR;2;2021-09-12;1822;2787;284;0;506;5317177;4388661;45181;78;47553
FR;2;2021-09-13;11656;21447;2468;4;4010;5328833;4410108;47649;82;51563
FR;2;2021-09-14;18567;32770;5084;13;9036;5347400;4442878;52733;95;60599
FR;2;2021-09-15;14910;28283;5164;3;7780;5362310;4471161;57897;98;68379
FR;2;2021-09-16;16071;32764;6735;14;10529;5378381;4503925;64632;112;78908
FR;2;2021-09-17;20911;47090;8776;10;14574;5399292;4551015;73408;122;93482
FR;2;2021-09-18;9855;20922;3803;6;6020;5409147;4571937;77211;128;99502
FR;2;2021-09-19;1165;2648;395;0;645;5410312;4574585;77606;128;100147
FR;2;2021-09-20;7491;18783;3851;7;6153;5417803;4593368;81457;135;106300
FR;2;2021-09-21;11205;30001;6494;5;10740;5429008;4623369;87951;140;117040
FR;2;2021-09-22;9406;23543;5491;7;8513;5438414;4646912;93442;147;125553
FR;2;2021-09-23;10722;28873;7879;9;12636;5449136;4675785;101321;156;138189
FR;2;2021-09-24;15065;42865;10874;18;17192;5464201;4718650;112195;174;155381
FR;2;2021-09-25;7257;18736;3962;10;6085;5471458;4737386;116157;184;161466
FR;2;2021-09-26;1079;2555;494;0;631;5472537;4739941;116651;184;162097
FR;2;2021-09-27;6313;16452;4286;8;6552;5478850;4756393;120937;192;168649
FR;2;2021-09-28;9239;25546;7768;13;12068;5488089;4781939;128705;205;180717
FR;2;2021-09-29;8079;20212;6066;25;9261;5496168;4802151;134771;230;189978
FR;2;2021-09-30;9863;25787;9503;16;14078;5506031;4827938;144274;246;204056
FR;2;2021-10-01;13967;35634;12912;25;19230;5519998;4863572;157186;271;223286
FR;2;2021-10-02;6873;15879;4845;6;7009;5526871;4879451;162031;277;230295
FR;2;2021-10-03;841;1938;491;1;513;5527712;4881389;162522;278;230808
FR;2;2021-10-04;5818;13931;5516;5;7859;5533530;4895320;168038;283;238667
FR;2;2021-10-05;9052;22546;11121;19;15713;5542582;4917866;179159;302;254380
FR;2;2021-10-06;7778;17736;8239;11;11069;5550360;4935602;187398;313;265449
FR;2;2021-10-07;9194;22172;12378;15;16834;5559554;4957774;199776;328;282283
FR;2;2021-10-08;13423;32054;17346;27;23535;5572977;4989828;217122;355;305818
FR;2;2021-10-09;5998;12822;6041;6;7875;5578975;5002650;223163;361;313693
FR;2;2021-10-10;883;1635;436;2;633;5579858;5004285;223599;363;314326
FR;2;2021-10-11;5604;11602;6454;17;8837;5585462;5015887;230053;380;323163
FR;2;2021-10-12;8034;17755;12537;13;16730;5593496;5033642;242590;393;339893
FR;2;2021-10-13;6944;14848;10245;11;13608;5600440;5048490;252835;404;353501
FR;2;2021-10-14;8310;17939;14989;13;19449;5608750;5066429;267824;417;372950
FR;2;2021-10-15;11845;26275;20901;26;27943;5620595;5092704;288725;443;400893
FR;2;2021-10-16;5137;8723;1816;0;3204;5625732;5101427;290541;443;404097
FR;2;2021-10-17;651;1189;184;0;373;5626383;5102616;290725;443;404470
FR;2;2021-10-18;4558;7421;661;2;1674;5630941;5110037;291386;445;406144
FR;2;2021-10-19;6238;9897;729;5;2053;5637179;5119934;292115;450;408197
FR;2;2021-10-20;5162;8096;756;3;1684;5642341;5128030;292871;453;409881
FR;2;2021-10-21;6088;9968;779;5;2101;5648429;5137998;293650;458;411982
FR;2;2021-10-22;8446;14576;1147;4;2874;5656875;5152574;294797;462;414856
FR;2;2021-10-23;3840;5997;584;0;1234;5660715;5158571;295381;462;416090
FR;2;2021-10-24;494;888;100;0;203;5661209;5159459;295481;462;416293
FR;2;2021-10-25;3357;5368;301;1;823;5664566;5164827;295782;463;417116
FR;2;2021-10-26;4173;7257;1124;4;2005;5668739;5172084;296906;467;419121
FR;2;2021-10-27;3673;6627;1193;5;1997;5672412;5178711;298099;472;421118
FR;2;2021-10-28;4596;7695;1727;3;2746;5677008;5186406;299826;475;423864
FR;2;2021-10-29;5405;11077;2430;4;3666;5682413;5197483;302256;479;427530
FR;2;2021-10-30;2748;4433;972;1;1428;5685161;5201916;303228;480;428958
FR;2;2021-10-31;363;535;139;1;186;5685524;5202451;303367;481;429144
FR;2;2021-11-01;416;558;175;0;267;5685940;5203009;303542;481;429411
FR;2;2021-11-02;3287;6760;1179;0;1756;5689227;5209769;304721;481;431167
FR;2;2021-11-03;3338;6249;1383;2;1965;5692565;5216018;306104;483;433132
FR;2;2021-11-04;3985;7097;1761;4;2491;5696550;5223115;307865;487;435623
FR;2;2021-11-05;5226;10510;2863;5;3944;5701776;5233625;310728;492;439567
FR;2;2021-11-06;2594;4669;1397;0;1809;5704370;5238294;312125;492;441376
FR;2;2021-11-07;508;864;216;0;285;5704878;5239158;312341;492;441661
FR;2;2021-11-08;2575;5360;1201;3;1677;5707453;5244518;313542;495;443338
FR;2;2021-11-09;2749;6946;2392;6;3173;5710202;5251464;315934;501;446511
FR;2;2021-11-10;2584;5712;5093;6;6272;5712786;5257176;321027;507;452783
FR;2;2021-11-11;433;744;732;2;915;5713219;5257920;321759;509;453698
FR;2;2021-11-12;2951;8110;8963;8;10901;5716170;5266030;330722;517;464599
FR;2;2021-11-13;1534;3382;3865;7;4528;5717704;5269412;334587;524;469127
FR;2;2021-11-14;254;603;348;1;485;5717958;5270015;334935;525;469612
FR;2;2021-11-15;1622;3691;4434;9;5318;5719580;5273706;339369;534;474930
FR;2;2021-11-16;2184;5944;8294;14;10071;5721764;5279650;347663;548;485001
FR;2;2021-11-17;1740;4565;6619;8;7836;5723504;5284215;354282;556;492837
FR;2;2021-11-18;2189;5948;9168;11;10993;5725693;5290163;363450;567;503830
FR;2;2021-11-19;2697;7802;12958;19;15464;5728390;5297965;376408;586;519294
FR;2;2021-11-20;1563;3333;5170;5;6074;5729953;5301298;381578;591;525368
FR;2;2021-11-21;246;518;540;0;663;5730199;5301816;382118;591;526031
FR;2;2021-11-22;1275;2622;4469;5;5400;5731474;5304438;386587;596;531431
FR;2;2021-11-23;1613;4313;8186;9;9895;5733087;5308751;394773;605;541326
FR;2;2021-11-24;1418;3797;7462;14;8719;5734505;5312548;402235;619;550045
FR;2;2021-11-25;1812;4894;11447;21;13644;5736317;5317442;413682;640;563689
FR;2;2021-11-26;2537;7778;22653;31;26068;5738854;5325220;436335;671;589757
FR;2;2021-11-27;1497;4130;12255;18;13991;5740351;5329350;448590;689;603748
FR;2;2021-11-28;291;842;1965;3;2287;5740642;5330192;450555;692;606035
FR;2;2021-11-29;1444;4388;15073;23;17244;5742086;5334580;465628;715;623279
FR;2;2021-11-30;1913;6749;26221;36;29972;5743999;5341329;491849;751;653251
FR;2;2021-12-01;1904;6100;26183;29;29503;5745903;5347429;518032;780;682754
FR;2;2021-12-02;1908;6829;37684;52;41928;5747811;5354258;555716;832;724682
FR;2;2021-12-03;2550;10111;53586;112;59310;5750361;5364369;609302;944;783992
FR;2;2021-12-04;1849;6305;37089;38;40764;5752210;5370674;646391;982;824756
FR;2;2021-12-05;458;2263;14252;14;15988;5752668;5372937;660643;996;840744
FR;2;2021-12-06;2464;9896;77682;109;84731;5755132;5382833;738325;1105;925475
FR;2;2021-12-07;3445;15329;122407;238;133690;5758577;5398162;860732;1343;1059165
FR;2;2021-12-08;3717;16056;133169;330;145369;5762294;5414218;993901;1673;1204534
FR;2;2021-12-09;4543;19629;170143;554;185500;5766837;5433847;1164044;2227;1390034
FR;2;2021-12-10;4672;22812;188607;490;206037;5771509;5456659;1352651;2717;1596071
FR;2;2021-12-11;3682;16626;132420;239;144856;5775191;5473285;1485071;2956;1740927
FR;2;2021-12-12;1257;7128;59082;83;65129;5776448;5480413;1544153;3039;1806056
FR;2;2021-12-13;5525;26859;220652;604;242931;5781973;5507272;1764805;3643;2048987
FR;2;2021-12-14;7017;37530;300712;910;332180;5788990;5544802;2065517;4553;2381167
FR;2;2021-12-15;6557;36239;285172;955;315769;5795547;5581041;2350689;5508;2696936
FR;2;2021-12-16;7762;37922;312101;981;343682;5803309;5618963;2662790;6489;3040618
FR;2;2021-12-17;8680;41246;327828;976;360909;5811989;5660209;2990618;7465;3401527
FR;2;2021-12-18;6514;26563;212316;448;233617;5818503;5686772;3202934;7913;3635144
FR;2;2021-12-19;2600;11492;90201;183;100379;5821103;5698264;3293135;8096;3735523
FR;2;2021-12-20;9549;33614;275152;706;303327;5830652;5731878;3568287;8802;4038850
FR;2;2021-12-21;11555;38327;309588;969;341374;5842207;5770205;3877875;9771;4380224
FR;2;2021-12-22;10457;32854;265080;952;292466;5852664;5803059;4142955;10723;4672690
FR;2;2021-12-23;9427;26711;199458;700;221259;5862091;5829770;4342413;11423;4893949
FR;2;2021-12-24;2781;7493;43845;140;49559;5864872;5837263;4386258;11563;4943508
FR;2;2021-12-25;201;699;2000;10;2494;5865073;5837962;4388258;11573;4946002
FR;2;2021-12-26;1322;4216;25146;71;28677;5866395;5842178;4413404;11644;4974679
FR;2;2021-12-27;8077;29942;218378;659;243302;5874472;5872120;4631782;12303;5217981
FR;2;2021-12-28;9840;36339;272062;741;301948;5884312;5908459;4903844;13044;5519929
FR;2;2021-12-29;9494;32287;246104;766;272677;5893806;5940746;5149948;13810;5792606
FR;2;2021-12-30;9453;28140;208807;662;231464;5903259;5968886;5358755;14472;6024070
FR;2;2021-12-31;3007;8375;54980;177;61236;5906266;5977261;5413735;14649;6085306
FR;2;2022-01-01;227;692;2849;7;3344;5906493;5977953;5416584;14656;6088650
FR;2;2022-01-02;1505;4855;29505;75;33390;5907998;5982808;5446089;14731;6122040
FR;2;2022-01-03;9583;35374;266501;806;293863;5917581;6018182;5712590;15537;6415903
FR;2;2022-01-04;12842;45374;342062;1067;376944;5930423;6063556;6054652;16604;6792847
FR;2;2022-01-05;11268;38664;294152;885;323807;5941691;6102220;6348804;17489;7116654
FR;2;2022-01-06;13649;43490;331928;1298;364702;5955340;6145710;6680732;18787;7481356
FR;2;2022-01-07;14220;47638;361073;1270;396404;5969560;6193348;7041805;20057;7877760
FR;2;2022-01-08;7945;28149;201255;515;221684;5977505;6221497;7243060;20572;8099444
FR;2;2022-01-09;2749;8995;62519;137;69522;5980254;6230492;7305579;20709;8168966
FR;2;2022-01-10;10086;31923;232448;858;255035;5990340;6262415;7538027;21567;8424001
FR;2;2022-01-11;11470;36252;265881;1030;290569;6001810;6298667;7803908;22597;8714570
FR;2;2022-01-12;8758;29831;206299;862;226170;6010568;6328498;8010207;23459;8940740
FR;2;2022-01-13;9387;31346;224463;831;244811;6019955;6359844;8234670;24290;9185551
FR;2;2022-01-14;9743;35666;254515;920;277680;6029698;6395510;8489185;25210;9463231
FR;2;2022-01-15;5356;19455;140767;363;153635;6035054;6414965;8629952;25573;9616866
FR;2;2022-01-16;1512;5522;35871;80;39849;6036566;6420487;8665823;25653;9656715
FR;2;2022-01-17;5545;19301;135385;601;147248;6042111;6439788;8801208;26254;9803963
FR;2;2022-01-18;6417;21526;148608;648;160466;6048528;6461314;8949816;26902;9964429
FR;2;2022-01-19;4389;16363;105081;552;113701;6052917;6477677;9054897;27454;10078130
FR;2;2022-01-20;4867;17599;115275;603;123674;6057784;6495276;9170172;28057;10201804
FR;2;2022-01-21;5195;20064;137324;678;147745;6062979;6515340;9307496;28735;10349549
FR;2;2022-01-22;3027;10961;74255;259;80325;6066006;6526301;9381751;28994;10429874
FR;2;2022-01-23;722;2736;15236;41;16837;6066728;6529037;9396987;29035;10446711
FR;2;2022-01-24;3293;12825;75057;430;81017;6070021;6541862;9472044;29465;10527728
FR;2;2022-01-25;3570;14437;79612;496;85451;6073591;6556299;9551656;29961;10613179
FR;2;2022-01-26;2515;10658;58959;363;62981;6076106;6566957;9610615;30324;10676160
FR;2;2022-01-27;2682;11271;64164;388;67903;6078788;6578228;9674779;30712;10744063
FR;2;2022-01-28;3543;18383;91710;430;98958;6082331;6596611;9766489;31142;10843021
FR;2;2022-01-29;1892;9251;48836;164;52922;6084223;6605862;9815325;31306;10895943
FR;2;2022-01-30;466;2242;9452;38;10605;6084689;6608104;9824777;31344;10906548
FR;2;2022-01-31;1887;9587;43817;208;47340;6086576;6617691;9868594;31552;10953888
FR;2;2022-02-01;1912;10051;47019;278;50100;6088488;6627742;9915613;31830;11003988
FR;2;2022-02-02;1606;9032;41100;251;44173;6090094;6636774;9956713;32081;11048161
FR;2;2022-02-03;1723;8941;40508;204;42907;6091817;6645715;9997221;32285;11091068
FR;2;2022-02-04;2152;15216;66626;297;71344;6093969;6660931;10063847;32582;11162412
FR;2;2022-02-05;1362;8534;35935;131;39232;6095331;6669465;10099782;32713;11201644
FR;2;2022-02-06;274;1780;6124;16;6899;6095605;6671245;10105906;32729;11208543
FR;2;2022-02-07;1350;9608;37747;134;41304;6096955;6680853;10143653;32863;11249847
FR;2;2022-02-08;1298;9811;40926;173;43710;6098253;6690664;10184579;33036;11293557
FR;2;2022-02-09;1160;8813;37032;174;40451;6099413;6699477;10221611;33210;11334008
FR;2;2022-02-10;1024;7985;33831;204;36498;6100437;6707462;10255442;33414;11370506
FR;2;2022-02-11;1388;12077;53338;222;57683;6101825;6719539;10308780;33636;11428189
FR;2;2022-02-12;749;6529;27985;83;30802;6102574;6726068;10336765;33719;11458991
FR;2;2022-02-13;200;1336;4833;20;5574;6102774;6727404;10341598;33739;11464565
FR;2;2022-02-14;834;6726;30263;89;33226;6103608;6734130;10371861;33828;11497791
FR;2;2022-02-15;771;6448;28044;141;29982;6104379;6740578;10399905;33969;11527773
FR;2;2022-02-16;656;5341;22049;123;23608;6105035;6745919;10421954;34092;11551381
FR;2;2022-02-17;515;3771;14144;98;14608;6105550;6749690;10436098;34190;11565989
FR;2;2022-02-18;721;5361;20428;134;21124;6106271;6755051;10456526;34324;11587113
FR;2;2022-02-19;430;3047;10527;66;11241;6106701;6758098;10467053;34390;11598354
FR;2;2022-02-20;101;512;1456;3;1604;6106802;6758610;10468509;34393;11599958
FR;2;2022-02-21;421;2682;9117;65;9493;6107223;6761292;10477626;34458;11609451
FR;2;2022-02-22;389;2565;8887;76;8791;6107612;6763857;10486513;34534;11618242
FR;2;2022-02-23;432;2600;8985;82;9264;6108044;6766457;10495498;34616;11627506
FR;2;2022-02-24;313;2028;6796;81;6824;6108357;6768485;10502294;34697;11634330
FR;2;2022-02-25;455;3194;11414;108;11277;6108812;6771679;10513708;34805;11645607
FR;2;2022-02-26;294;1889;6035;49;6340;6109106;6773568;10519743;34854;11651947
FR;2;2022-02-27;75;312;905;5;948;6109181;6773880;10520648;34859;11652895
FR;2;2022-02-28;330;1680;5522;53;5529;6109511;6775560;10526170;34912;11658424
FR;2;2022-03-01;274;1558;5474;44;5191;6109785;6777118;10531644;34956;11663615
FR;2;2022-03-02;296;1429;5242;45;5082;6110081;6778547;10536886;35001;11668697
FR;2;2022-03-03;225;1101;3703;42;3478;6110306;6779648;10540589;35043;11672175
FR;2;2022-03-04;240;1463;4852;73;4498;6110546;6781111;10545441;35116;11676673
FR;2;2022-03-05;172;903;2973;32;2716;6110718;6782014;10548414;35148;11679389
FR;2;2022-03-06;40;181;277;5;316;6110758;6782195;10548691;35153;11679705
FR;2;2022-03-07;155;652;1981;69;1772;6110913;6782847;10550672;35222;11681477
FR;2;2022-03-08;143;652;2270;51;1902;6111056;6783499;10552942;35273;11683379
FR;2;2022-03-09;152;695;2341;37;2042;6111208;6784194;10555283;35310;11685421
FR;2;2022-03-10;119;595;1686;35;1458;6111327;6784789;10556969;35345;11686879
FR;2;2022-03-11;169;753;2767;57;2366;6111496;6785542;10559736;35402;11689245
FR;2;2022-03-12;144;480;1784;27;1553;6111640;6786022;10561520;35429;11690798
FR;2;2022-03-13;25;75;201;29;202;6111665;6786097;10561721;35458;11691000
FR;2;2022-03-14;124;464;1560;529;1289;6111789;6786561;10563281;35987;11692289
FR;2;2022-03-15;138;417;1705;688;1321;6111927;6786978;10564986;36675;11693610
FR;2;2022-03-16;141;463;2010;1611;1588;6112068;6787441;10566996;38286;11695198
FR;2;2022-03-17;93;412;1405;1192;1142;6112161;6787853;10568401;39478;11696340
FR;2;2022-03-18;144;489;2017;1787;1659;6112305;6788342;10570418;41265;11697999
FR;2;2022-03-19;108;318;1209;940;1013;6112413;6788660;10571627;42205;11699012
FR;2;2022-03-20;12;76;190;59;166;6112425;6788736;10571817;42264;11699178
FR;2;2022-03-21;96;301;1209;1481;1073;6112521;6789037;10573026;43745;11700251
FR;2;2022-03-22;116;382;1528;1828;1290;6112637;6789419;10574554;45573;11701541
FR;2;2022-03-23;137;343;1665;3031;1455;6112774;6789762;10576219;48604;11702996
FR;2;2022-03-24;115;290;1180;1546;996;6112889;6790052;10577399;50150;11703992
FR;2;2022-03-25;119;360;1801;2449;1471;6113008;6790412;10579200;52599;11705463
FR;2;2022-03-26;76;246;1202;1220;952;6113084;6790658;10580402;53819;11706415
FR;2;2022-03-27;19;36;151;98;131;6113103;6790694;10580553;53917;11706546
FR;2;2022-03-28;93;285;1133;1588;992;6113196;6790979;10581686;55505;11707538
FR;2;2022-03-29;106;257;1324;2462;1104;6113302;6791236;10583010;57967;11708642
FR;2;2022-03-30;91;312;1482;3183;1315;6113393;6791548;10584492;61150;11709957
FR;2;2022-03-31;103;279;1268;2312;1082;6113496;6791827;10585760;63462;11711039
FR;2;2022-04-01;119;313;1562;2340;1313;6113615;6792140;10587322;65802;11712352
FR;2;2022-04-02;72;160;845;889;737;6113687;6792300;10588167;66691;11713089
FR;2;2022-04-03;16;53;128;112;142;6113703;6792353;10588295;66803;11713231
FR;2;2022-04-04;106;224;982;1434;789;6113809;6792577;10589277;68237;11714020
FR;2;2022-04-05;142;286;1302;2870;1130;6113951;6792863;10590579;71107;11715150
FR;2;2022-04-06;87;242;1303;2498;1113;6114038;6793105;10591882;73605;11716263
FR;2;2022-04-07;118;214;1295;2681;1034;6114156;6793319;10593177;76286;11717297
FR;2;2022-04-08;123;327;1622;3207;1319;6114279;6793646;10594799;79493;11718616
FR;2;2022-04-09;90;218;896;1045;731;6114369;6793864;10595695;80538;11719347
FR;2;2022-04-10;37;44;143;161;116;6114406;6793908;10595838;80699;11719463
FR;2;2022-04-11;85;184;878;1518;769;6114491;6794092;10596716;82217;11720232
FR;2;2022-04-12;176;260;1170;2708;1043;6114667;6794352;10597886;84925;11721275
FR;2;2022-04-13;141;222;1113;2405;971;6114808;6794574;10598999;87330;11722246
FR;2;2022-04-14;114;216;1078;2653;907;6114922;6794790;10600077;89983;11723153
FR;2;2022-04-15;111;240;1186;2248;1043;6115033;6795030;10601263;92231;11724196
FR;2;2022-04-16;64;108;538;543;450;6115097;6795138;10601801;92774;11724646
FR;2;2022-04-17;14;26;57;53;53;6115111;6795164;10601858;92827;11724699
FR;2;2022-04-18;11;35;118;65;113;6115122;6795199;10601976;92892;11724812
FR;2;2022-04-19;108;235;1114;1702;945;6115230;6795434;10603090;94594;11725757
FR;2;2022-04-20;94;236;1090;2099;918;6115324;6795670;10604180;96693;11726675
FR;2;2022-04-21;109;228;971;1822;828;6115433;6795898;10605151;98515;11727503
FR;2;2022-04-22;96;265;1236;2080;1017;6115529;6796163;10606387;100595;11728520
FR;2;2022-04-23;66;154;644;762;573;6115595;6796317;10607031;101357;11729093
FR;2;2022-04-24;10;28;99;68;77;6115605;6796345;10607130;101425;11729170
FR;2;2022-04-25;100;200;815;1312;705;6115705;6796545;10607945;102737;11729875
FR;2;2022-04-26;104;182;1029;1901;869;6115809;6796727;10608974;104638;11730744
FR;2;2022-04-27;93;175;850;1665;755;6115902;6796902;10609824;106303;11731499
FR;2;2022-04-28;90;208;942;1891;836;6115992;6797110;10610766;108194;11732335
FR;2;2022-04-29;75;277;1120;1685;1030;6116067;6797387;10611886;109879;11733365
FR;2;2022-04-30;63;124;463;534;422;6116130;6797511;10612349;110413;11733787
FR;2;2022-05-01;14;22;79;42;80;6116144;6797533;10612428;110455;11733867
FR;2;2022-05-02;111;206;729;1201;628;6116255;6797739;10613157;111656;11734495
FR;2;2022-05-03;145;221;974;1728;912;6116400;6797960;10614131;113384;11735407
FR;2;2022-05-04;84;217;898;1754;844;6116484;6798177;10615029;115138;11736251
FR;2;2022-05-05;119;189;828;1653;737;6116603;6798366;10615857;116791;11736988
FR;2;2022-05-06;125;232;1082;1844;996;6116728;6798598;10616939;118635;11737984
FR;2;2022-05-07;39;95;462;501;399;6116767;6798693;10617401;119136;11738383
FR;2;2022-05-08;42;45;103;70;91;6116809;6798738;10617504;119206;11738474
FR;2;2022-05-09;100;162;620;960;570;6116909;6798900;10618124;120166;11739044
FR;2;2022-05-10;110;228;872;1735;827;6117019;6799128;10618996;121901;11739871
FR;2;2022-05-11;94;160;772;1823;755;6117113;6799288;10619768;123724;11740626
FR;2;2022-05-12;106;165;820;2054;782;6117219;6799453;10620588;125778;11741408
FR;2;2022-05-13;93;225;939;1903;876;6117312;6799678;10621527;127681;11742284
FR;2;2022-05-14;75;116;427;549;387;6117387;6799794;10621954;128230;11742671
FR;2;2022-05-15;23;34;89;86;100;6117410;6799828;10622043;128316;11742771
FR;2;2022-05-16;101;156;544;903;484;6117511;6799984;10622587;129219;11743255
FR;2;2022-05-17;94;176;637;1654;610;6117605;6800160;10623224;130873;11743865
FR;2;2022-05-18;80;165;586;1315;567;6117685;6800325;10623810;132188;11744432
FR;2;2022-05-19;67;149;665;1613;606;6117752;6800474;10624475;133801;11745038
FR;2;2022-05-20;96;153;788;1606;688;6117848;6800627;10625263;135407;11745726
FR;2;2022-05-21;43;74;365;496;298;6117891;6800701;10625628;135903;11746024
FR;2;2022-05-22;8;19;62;35;53;6117899;6800720;10625690;135938;11746077
FR;2;2022-05-23;74;118;406;784;392;6117973;6800838;10626096;136722;11746469
FR;3;2020-12-27;0;0;0;0;0;0;0;0;0;0
FR;3;2020-12-28;0;0;0;0;0;0;0;0;0;0
FR;3;2020-12-29;0;0;0;0;0;0;0;0;0;0
FR;3;2020-12-30;0;0;0;0;0;0;0;0;0;0
FR;3;2020-12-31;0;0;0;0;0;0;0;0;0;0
FR;3;2021-01-01;0;0;0;0;0;0;0;0;0;0
FR;3;2021-01-02;0;0;0;0;0;0;0;0;0;0
FR;3;2021-01-03;0;0;0;0;0;0;0;0;0;0
FR;3;2021-01-04;0;0;0;0;0;0;0;0;0;0
FR;3;2021-01-05;0;0;0;0;0;0;0;0;0;0
FR;3;2021-01-06;0;0;0;0;0;0;0;0;0;0
FR;3;2021-01-07;0;0;0;0;0;0;0;0;0;0
FR;3;2021-01-08;0;0;0;0;0;0;0;0;0;0
FR;3;2021-01-09;0;0;0;0;0;0;0;0;0;0
FR;3;2021-01-10;0;0;0;0;0;0;0;0;0;0
FR;3;2021-01-11;0;0;0;0;0;0;0;0;0;0
FR;3;2021-01-12;0;0;0;0;0;0;0;0;0;0
FR;3;2021-01-13;0;0;0;0;0;0;0;0;0;0
FR;3;2021-01-14;0;0;0;0;0;0;0;0;0;0
FR;3;2021-01-15;0;0;0;0;0;0;0;0;0;0
FR;3;2021-01-16;0;0;0;0;0;0;0;0;0;0
FR;3;2021-01-17;0;0;0;0;0;0;0;0;0;0
FR;3;2021-01-18;0;0;0;0;0;0;0;0;0;0
FR;3;2021-01-19;0;0;0;0;0;0;0;0;0;0
FR;3;2021-01-20;0;0;0;0;0;0;0;0;0;0
FR;3;2021-01-21;0;0;0;0;0;0;0;0;0;0
FR;3;2021-01-22;0;0;0;0;0;0;0;0;0;0
FR;3;2021-01-23;0;0;0;0;0;0;0;0;0;0
FR;3;2021-01-24;0;0;0;0;0;0;0;0;0;0
FR;3;2021-01-25;0;0;0;0;0;0;0;0;0;0
FR;3;2021-01-26;0;0;0;0;0;0;0;0;0;0
FR;3;2021-01-27;0;0;0;0;0;0;0;0;0;0
FR;3;2021-01-28;0;0;0;0;0;0;0;0;0;0
FR;3;2021-01-29;0;0;0;0;0;0;0;0;0;0
FR;3;2021-01-30;0;0;0;0;0;0;0;0;0;0
FR;3;2021-01-31;0;0;0;0;0;0;0;0;0;0
FR;3;2021-02-01;0;0;0;0;0;0;0;0;0;0
FR;3;2021-02-02;0;0;0;0;0;0;0;0;0;0
FR;3;2021-02-03;0;0;0;0;0;0;0;0;0;0
FR;3;2021-02-04;0;0;0;0;0;0;0;0;0;0
FR;3;2021-02-05;0;0;0;0;0;0;0;0;0;0
FR;3;2021-02-06;1666;0;0;0;0;1666;0;0;0;0
FR;3;2021-02-07;1423;0;0;0;0;3089;0;0;0;0
FR;3;2021-02-08;2782;1;0;0;0;5871;1;0;0;0
FR;3;2021-02-09;6782;0;0;0;0;12653;1;0;0;0
FR;3;2021-02-10;9603;0;0;0;0;22256;1;0;0;0
FR;3;2021-02-11;13611;0;0;0;0;35867;1;0;0;0
FR;3;2021-02-12;13397;0;0;0;0;49264;1;0;0;0
FR;3;2021-02-13;3783;1;0;0;0;53047;2;0;0;0
FR;3;2021-02-14;972;0;0;0;0;54019;2;0;0;0
FR;3;2021-02-15;10486;0;0;0;0;64505;2;0;0;0
FR;3;2021-02-16;12542;1;0;0;0;77047;3;0;0;0
FR;3;2021-02-17;11151;0;0;0;0;88198;3;0;0;0
FR;3;2021-02-18;14934;2;0;0;0;103132;5;0;0;0
FR;3;2021-02-19;14359;1;0;0;0;117491;6;0;0;0
FR;3;2021-02-20;3329;0;0;0;0;120820;6;0;0;0
FR;3;2021-02-21;618;0;0;0;0;121438;6;0;0;0
FR;3;2021-02-22;9162;0;0;0;0;130600;6;0;0;0
FR;3;2021-02-23;11394;1;0;0;0;141994;7;0;0;0
FR;3;2021-02-24;14299;0;0;0;0;156293;7;0;0;0
FR;3;2021-02-25;44929;1;0;0;0;201222;8;0;0;0
FR;3;2021-02-26;61883;3;0;0;0;263105;11;0;0;0
FR;3;2021-02-27;34801;5;0;0;0;297906;16;0;0;0
FR;3;2021-02-28;2463;0;0;0;0;300369;16;0;0;0
FR;3;2021-03-01;20510;10;0;0;0;320879;26;0;0;0
FR;3;2021-03-02;38862;18;0;0;0;359741;44;0;0;0
FR;3;2021-03-03;48729;16;0;0;0;408470;60;0;0;0
FR;3;2021-03-04;82217;20;0;0;0;490687;80;0;0;0
FR;3;2021-03-05;118123;40;0;0;0;608810;120;0;0;0
FR;3;2021-03-06;120709;55;1;0;0;729519;175;1;0;0
FR;3;2021-03-07;55176;27;0;0;0;784695;202;1;0;0
FR;3;2021-03-08;42807;24;0;0;0;827502;226;1;0;0
FR;3;2021-03-09;78966;42;0;0;0;906468;268;1;0;0
FR;3;2021-03-10;80966;47;0;0;0;987434;315;1;0;0
FR;3;2021-03-11;128419;55;0;0;0;1115853;370;1;0;0
FR;3;2021-03-12;182721;90;0;0;0;1298574;460;1;0;0
FR;3;2021-03-13;132144;63;0;0;0;1430718;523;1;0;0
FR;3;2021-03-14;14054;4;0;0;0;1444772;527;1;0;0
FR;3;2021-03-15;52223;47;0;0;0;1496995;574;1;0;0
FR;3;2021-03-16;1209;24;0;0;0;1498204;598;1;0;0
FR;3;2021-03-17;942;30;0;0;0;1499146;628;1;0;0
FR;3;2021-03-18;1564;12;0;0;0;1500710;640;1;0;0
FR;3;2021-03-19;70448;48;0;0;0;1571158;688;1;0;0
FR;3;2021-03-20;65226;44;0;0;0;1636384;732;1;0;0
FR;3;2021-03-21;5755;6;0;0;0;1642139;738;1;0;0
FR;3;2021-03-22;37495;38;0;0;0;1679634;776;1;0;0
FR;3;2021-03-23;84650;61;0;0;0;1764284;837;1;0;0
FR;3;2021-03-24;90935;93;0;0;0;1855219;930;1;0;0
FR;3;2021-03-25;150043;126;0;0;0;2005262;1056;1;0;0
FR;3;2021-03-26;165412;152;0;0;0;2170674;1208;1;0;0
FR;3;2021-03-27;68456;100;0;0;0;2239130;1308;1;0;0
FR;3;2021-03-28;6469;19;0;0;0;2245599;1327;1;0;0
FR;3;2021-03-29;54159;75;0;0;0;2299758;1402;1;0;0
FR;3;2021-03-30;93159;100;0;0;0;2392917;1502;1;0;0
FR;3;2021-03-31;63522;93;0;0;0;2456439;1595;1;0;0
FR;3;2021-04-01;86121;103;0;0;0;2542560;1698;1;0;0
FR;3;2021-04-02;86891;153;0;0;0;2629451;1851;1;0;0
FR;3;2021-04-03;35872;115;0;0;0;2665323;1966;1;0;0
FR;3;2021-04-04;3570;18;0;0;0;2668893;1984;1;0;0
FR;3;2021-04-05;4487;28;0;0;0;2673380;2012;1;0;0
FR;3;2021-04-06;29742;83;0;0;0;2703122;2095;1;0;0
FR;3;2021-04-07;32334;79;0;0;0;2735456;2174;1;0;0
FR;3;2021-04-08;78808;243;0;0;0;2814264;2417;1;0;0
FR;3;2021-04-09;161746;415;0;0;0;2976010;2832;1;0;0
FR;3;2021-04-10;75755;331;0;0;0;3051765;3163;1;0;0
FR;3;2021-04-11;7309;45;0;0;0;3059074;3208;1;0;0
FR;3;2021-04-12;51467;206;0;0;0;3110541;3414;1;0;0
FR;3;2021-04-13;86218;318;0;0;0;3196759;3732;1;0;0
FR;3;2021-04-14;67834;341;0;0;0;3264593;4073;1;0;0
FR;3;2021-04-15;93219;370;0;0;0;3357812;4443;1;0;0
FR;3;2021-04-16;112516;581;0;0;0;3470328;5024;1;0;0
FR;3;2021-04-17;53311;324;1;0;0;3523639;5348;2;0;0
FR;3;2021-04-18;9741;35;0;0;0;3533380;5383;2;0;0
FR;3;2021-04-19;25103;240;0;0;0;3558483;5623;2;0;0
FR;3;2021-04-20;45670;398;0;0;0;3604153;6021;2;0;0
FR;3;2021-04-21;38967;466;0;0;0;3643120;6487;2;0;0
FR;3;2021-04-22;54701;786;0;0;0;3697821;7273;2;0;0
FR;3;2021-04-23;70480;1021;0;0;0;3768301;8294;2;0;0
FR;3;2021-04-24;37240;996;0;0;0;3805541;9290;2;0;0
FR;3;2021-04-25;6204;156;0;0;0;3811745;9446;2;0;0
FR;3;2021-04-26;19781;652;0;0;0;3831526;10098;2;0;0
FR;3;2021-04-27;34470;1259;0;0;0;3865996;11357;2;0;0
FR;3;2021-04-28;28964;1943;0;0;0;3894960;13300;2;0;0
FR;3;2021-04-29;45376;5959;0;0;0;3940336;19259;2;0;0
FR;3;2021-04-30;55451;8931;1;0;0;3995787;28190;3;0;0
FR;3;2021-05-01;9510;1977;0;0;0;4005297;30167;3;0;0
FR;3;2021-05-02;3070;488;0;0;0;4008367;30655;3;0;0
FR;3;2021-05-03;13057;3885;0;0;0;4021424;34540;3;0;0
FR;3;2021-05-04;23109;8412;0;0;0;4044533;42952;3;0;0
FR;3;2021-05-05;18753;10617;0;0;0;4063286;53569;3;0;0
FR;3;2021-05-06;34618;20909;0;0;0;4097904;74478;3;0;0
FR;3;2021-05-07;44202;28448;0;0;0;4142106;102926;3;0;0
FR;3;2021-05-08;6784;8931;0;0;0;4148890;111857;3;0;0
FR;3;2021-05-09;1792;2659;0;0;0;4150682;114516;3;0;0
FR;3;2021-05-10;14989;12603;0;0;0;4165671;127119;3;0;0
FR;3;2021-05-11;27092;25784;0;0;0;4192763;152903;3;0;0
FR;3;2021-05-12;17266;27508;0;0;0;4210029;180411;3;0;0
FR;3;2021-05-13;2277;3472;0;0;0;4212306;183883;3;0;0
FR;3;2021-05-14;14513;25760;0;0;0;4226819;209643;3;0;0
FR;3;2021-05-15;7230;20792;0;0;0;4234049;230435;3;0;0
FR;3;2021-05-16;975;2674;0;0;0;4235024;233109;3;0;0
FR;3;2021-05-17;7960;19944;0;0;0;4242984;253053;3;0;0
FR;3;2021-05-18;13409;29651;0;0;0;4256393;282704;3;0;0
FR;3;2021-05-19;9262;31552;0;0;0;4265655;314256;3;0;0
FR;3;2021-05-20;12801;53226;3;0;0;4278456;367482;6;0;0
FR;3;2021-05-21;12759;65536;2;0;0;4291215;433018;8;0;0
FR;3;2021-05-22;4960;33315;1;0;0;4296175;466333;9;0;0
FR;3;2021-05-23;649;2668;0;0;0;4296824;469001;9;0;0
FR;3;2021-05-24;879;4918;0;0;0;4297703;473919;9;0;0
FR;3;2021-05-25;5296;45227;1;0;0;4302999;519146;10;0;0
FR;3;2021-05-26;4970;51093;1;0;0;4307969;570239;11;0;0
FR;3;2021-05-27;6325;77876;3;0;0;4314294;648115;14;0;0
FR;3;2021-05-28;7540;99091;2;0;0;4321834;747206;16;0;0
FR;3;2021-05-29;3345;60320;1;0;0;4325179;807526;17;0;0
FR;3;2021-05-30;545;8219;0;0;0;4325724;815745;17;0;0
FR;3;2021-05-31;2434;35892;3;0;0;4328158;851637;20;0;0
FR;3;2021-06-01;3400;64749;10;0;0;4331558;916386;30;0;0
FR;3;2021-06-02;2726;58324;6;0;0;4334284;974710;36;0;0
FR;3;2021-06-03;3491;87495;10;0;0;4337775;1062205;46;0;0
FR;3;2021-06-04;4110;105088;22;0;0;4341885;1167293;68;0;0
FR;3;2021-06-05;1978;52233;4;0;0;4343863;1219526;72;0;0
FR;3;2021-06-06;505;5392;1;0;0;4344368;1224918;73;0;0
FR;3;2021-06-07;1469;31086;11;0;0;4345837;1256004;84;0;0
FR;3;2021-06-08;2047;47236;18;0;0;4347884;1303240;102;0;0
FR;3;2021-06-09;1787;42316;13;0;0;4349671;1345556;115;0;0
FR;3;2021-06-10;2242;67883;17;0;0;4351913;1413439;132;0;0
FR;3;2021-06-11;2471;96697;34;0;0;4354384;1510136;166;0;0
FR;3;2021-06-12;1174;40830;6;0;0;4355558;1550966;172;0;0
FR;3;2021-06-13;278;3805;3;0;0;4355836;1554771;175;0;0
FR;3;2021-06-14;1038;42599;17;0;0;4356874;1597370;192;0;0
FR;3;2021-06-15;1363;80608;20;0;0;4358237;1677978;212;0;0
FR;3;2021-06-16;1255;65690;19;0;0;4359492;1743668;231;0;0
FR;3;2021-06-17;1659;101809;41;0;0;4361151;1845477;272;0;0
FR;3;2021-06-18;1868;117923;61;0;0;4363019;1963400;333;0;0
FR;3;2021-06-19;801;39387;22;0;0;4363820;2002787;355;0;0
FR;3;2021-06-20;158;3372;0;0;0;4363978;2006159;355;0;0
FR;3;2021-06-21;768;39244;16;0;0;4364746;2045403;371;0;0
FR;3;2021-06-22;1060;69945;52;0;0;4365806;2115348;423;0;0
FR;3;2021-06-23;942;50821;39;0;0;4366748;2166169;462;0;0
FR;3;2021-06-24;1305;77150;48;0;0;4368053;2243319;510;0;0
FR;3;2021-06-25;1399;89979;73;0;0;4369452;2333298;583;0;0
FR;3;2021-06-26;625;33118;29;0;0;4370077;2366416;612;0;0
FR;3;2021-06-27;165;3989;1;0;0;4370242;2370405;613;0;0
FR;3;2021-06-28;648;30403;27;0;0;4370890;2400808;640;0;0
FR;3;2021-06-29;853;56168;95;0;0;4371743;2456976;735;0;0
FR;3;2021-06-30;901;45077;93;0;0;4372644;2502053;828;0;0
FR;3;2021-07-01;1160;65677;108;0;0;4373804;2567730;936;0;0
FR;3;2021-07-02;1299;90361;170;0;0;4375103;2658091;1106;0;0
FR;3;2021-07-03;600;31186;52;0;0;4375703;2689277;1158;0;0
FR;3;2021-07-04;141;4256;3;0;0;4375844;2693533;1161;0;0
FR;3;2021-07-05;608;33900;60;0;0;4376452;2727433;1221;0;0
FR;3;2021-07-06;956;56047;88;0;0;4377408;2783480;1309;0;0
FR;3;2021-07-07;870;43032;79;0;0;4378278;2826512;1388;0;0
FR;3;2021-07-08;1123;60726;99;0;0;4379401;2887238;1487;0;0
FR;3;2021-07-09;1258;68813;128;0;0;4380659;2956051;1615;0;0
FR;3;2021-07-10;640;25064;59;0;0;4381299;2981115;1674;0;0
FR;3;2021-07-11;127;3288;4;0;0;4381426;2984403;1678;0;0
FR;3;2021-07-12;659;23877;59;0;0;4382085;3008280;1737;0;0
FR;3;2021-07-13;1645;34724;90;0;0;4383730;3043004;1827;0;0
FR;3;2021-07-14;261;2626;2;0;0;4383991;3045630;1829;0;0
FR;3;2021-07-15;1932;30657;85;0;0;4385923;3076287;1914;0;0
FR;3;2021-07-16;2520;38859;122;0;0;4388443;3115146;2036;0;0
FR;3;2021-07-17;1046;13749;26;0;0;4389489;3128895;2062;0;0
FR;3;2021-07-18;262;2605;3;0;0;4389751;3131500;2065;0;0
FR;3;2021-07-19;1273;17190;37;0;0;4391024;3148690;2102;0;0
FR;3;2021-07-20;1823;27133;98;0;0;4392847;3175823;2200;0;0
FR;3;2021-07-21;1647;19707;44;0;0;4394494;3195530;2244;0;0
FR;3;2021-07-22;1848;27745;82;0;0;4396342;3223275;2326;0;0
FR;3;2021-07-23;2212;30448;117;0;0;4398554;3253723;2443;0;0
FR;3;2021-07-24;822;7005;25;0;0;4399376;3260728;2468;0;0
FR;3;2021-07-25;210;1339;1;0;0;4399586;3262067;2469;0;0
FR;3;2021-07-26;921;10704;28;0;0;4400507;3272771;2497;0;0
FR;3;2021-07-27;1165;16947;56;0;0;4401672;3289718;2553;0;0
FR;3;2021-07-28;988;12097;40;0;0;4402660;3301815;2593;0;0
FR;3;2021-07-29;1126;15842;63;0;0;4403786;3317657;2656;0;0
FR;3;2021-07-30;1125;18094;79;0;0;4404911;3335751;2735;0;0
FR;3;2021-07-31;406;3746;15;0;0;4405317;3339497;2750;0;0
FR;3;2021-08-01;113;486;1;0;0;4405430;3339983;2751;0;0
FR;3;2021-08-02;419;5155;22;0;0;4405849;3345138;2773;0;0
FR;3;2021-08-03;488;7585;27;0;0;4406337;3352723;2800;0;0
FR;3;2021-08-04;435;4886;26;0;0;4406772;3357609;2826;0;0
FR;3;2021-08-05;428;3738;12;0;0;4407200;3361347;2838;0;0
FR;3;2021-08-06;452;4789;30;0;0;4407652;3366136;2868;0;0
FR;3;2021-08-07;214;1922;11;0;0;4407866;3368058;2879;0;0
FR;3;2021-08-08;247;432;2;0;0;4408113;3368490;2881;0;0
FR;3;2021-08-09;313;2501;11;0;0;4408426;3370991;2892;0;0
FR;3;2021-08-10;363;3879;15;0;0;4408789;3374870;2907;0;0
FR;3;2021-08-11;285;2723;15;0;0;4409074;3377593;2922;0;0
FR;3;2021-08-12;276;2639;12;0;0;4409350;3380232;2934;0;0
FR;3;2021-08-13;277;2265;16;0;0;4409627;3382497;2950;0;0
FR;3;2021-08-14;169;916;1;0;0;4409796;3383413;2951;0;0
FR;3;2021-08-15;55;171;0;0;0;4409851;3383584;2951;0;0
FR;3;2021-08-16;123;1085;8;0;0;4409974;3384669;2959;0;0
FR;3;2021-08-17;186;1502;8;0;0;4410160;3386171;2967;0;0
FR;3;2021-08-18;200;1370;10;0;0;4410360;3387541;2977;0;0
FR;3;2021-08-19;165;1411;10;0;0;4410525;3388952;2987;0;0
FR;3;2021-08-20;166;1634;16;0;0;4410691;3390586;3003;0;0
FR;3;2021-08-21;93;587;2;0;0;4410784;3391173;3005;0;0
FR;3;2021-08-22;39;189;1;0;0;4410823;3391362;3006;0;0
FR;3;2021-08-23;140;929;7;0;0;4410963;3392291;3013;0;0
FR;3;2021-08-24;124;966;10;0;0;4411087;3393257;3023;0;0
FR;3;2021-08-25;136;843;2;0;0;4411223;3394100;3025;0;0
FR;3;2021-08-26;170;874;9;0;0;4411393;3394974;3034;0;0
FR;3;2021-08-27;172;964;9;0;0;4411565;3395938;3043;0;0
FR;3;2021-08-28;98;372;4;0;0;4411663;3396310;3047;0;0
FR;3;2021-08-29;127;133;1;0;0;4411790;3396443;3048;0;0
FR;3;2021-08-30;98;599;0;0;135;4411888;3397042;3048;0;135
FR;3;2021-08-31;127;711;7;0;153;4412015;3397753;3055;0;288
FR;3;2021-09-01;113;480;5;0;124;4412128;3398233;3060;0;412
FR;3;2021-09-02;99;633;22;0;120;4412227;3398866;3082;0;532
FR;3;2021-09-03;115;586;17;0;128;4412342;3399452;3099;0;660
FR;3;2021-09-04;51;301;3;0;58;4412393;3399753;3102;0;718
FR;3;2021-09-05;51;68;5;0;28;4412444;3399821;3107;0;746
FR;3;2021-09-06;113;394;4;0;144;4412557;3400215;3111;0;890
FR;3;2021-09-07;123;473;14;0;128;4412680;3400688;3125;0;1018
FR;3;2021-09-08;115;371;2;0;103;4412795;3401059;3127;0;1121
FR;3;2021-09-09;92;397;8;0;114;4412887;3401456;3135;0;1235
FR;3;2021-09-10;100;422;3;0;104;4412987;3401878;3138;0;1339
FR;3;2021-09-11;74;239;4;0;66;4413061;3402117;3142;0;1405
FR;3;2021-09-12;36;48;1;0;17;4413097;3402165;3143;0;1422
FR;3;2021-09-13;70;320;7;0;109;4413167;3402485;3150;0;1531
FR;3;2021-09-14;70;293;6;0;107;4413237;3402778;3156;0;1638
FR;3;2021-09-15;59;264;3;0;6;4413296;3403042;3159;0;1644
FR;3;2021-09-16;59;339;5;0;5;4413355;3403381;3164;0;1649
FR;3;2021-09-17;51;348;3;0;7;4413406;3403729;3167;0;1656
FR;3;2021-09-18;36;172;1;0;1;4413442;3403901;3168;0;1657
FR;3;2021-09-19;27;32;2;0;1;4413469;3403933;3170;0;1658
FR;3;2021-09-20;79;211;0;0;1;4413548;3404144;3170;0;1659
FR;3;2021-09-21;58;288;6;0;7;4413606;3404432;3176;0;1666
FR;3;2021-09-22;63;229;6;0;7;4413669;3404661;3182;0;1673
FR;3;2021-09-23;36;274;11;0;7;4413705;3404935;3193;0;1680
FR;3;2021-09-24;25;323;12;0;19;4413730;3405258;3205;0;1699
FR;3;2021-09-25;29;152;3;0;3;4413759;3405410;3208;0;1702
FR;3;2021-09-26;15;55;1;0;1;4413774;3405465;3209;0;1703
FR;3;2021-09-27;39;290;3;0;5;4413813;3405755;3212;0;1708
FR;3;2021-09-28;49;255;6;0;10;4413862;3406010;3218;0;1718
FR;3;2021-09-29;34;223;10;0;13;4413896;3406233;3228;0;1731
FR;3;2021-09-30;38;199;8;0;10;4413934;3406432;3236;0;1741
FR;3;2021-10-01;17;169;6;0;7;4413951;3406601;3242;0;1748
FR;3;2021-10-02;14;91;0;0;0;4413965;3406692;3242;0;1748
FR;3;2021-10-03;18;20;1;0;2;4413983;3406712;3243;0;1750
FR;3;2021-10-04;30;161;4;0;4;4414013;3406873;3247;0;1754
FR;3;2021-10-05;16;153;10;0;13;4414029;3407026;3257;0;1767
FR;3;2021-10-06;31;157;7;0;8;4414060;3407183;3264;0;1775
FR;3;2021-10-07;18;142;6;0;6;4414078;3407325;3270;0;1781
FR;3;2021-10-08;22;144;10;0;9;4414100;3407469;3280;0;1790
FR;3;2021-10-09;12;73;1;0;1;4414112;3407542;3281;0;1791
FR;3;2021-10-10;11;16;2;0;2;4414123;3407558;3283;0;1793
FR;3;2021-10-11;14;124;4;0;5;4414137;3407682;3287;0;1798
FR;3;2021-10-12;17;116;5;0;5;4414154;3407798;3292;0;1803
FR;3;2021-10-13;23;120;7;0;5;4414177;3407918;3299;0;1808
FR;3;2021-10-14;16;160;3;0;4;4414193;3408078;3302;0;1812
FR;3;2021-10-15;21;157;8;0;11;4414214;3408235;3310;0;1823
FR;3;2021-10-16;11;79;6;0;8;4414225;3408314;3316;0;1831
FR;3;2021-10-17;10;24;0;0;0;4414235;3408338;3316;0;1831
FR;3;2021-10-18;17;128;2;0;1;4414252;3408466;3318;0;1832
FR;3;2021-10-19;16;125;19;0;21;4414268;3408591;3337;0;1853
FR;3;2021-10-20;21;133;5;0;6;4414289;3408724;3342;0;1859
FR;3;2021-10-21;24;137;17;0;13;4414313;3408861;3359;0;1872
FR;3;2021-10-22;18;128;16;0;20;4414331;3408989;3375;0;1892
FR;3;2021-10-23;12;57;2;0;1;4414343;3409046;3377;0;1893
FR;3;2021-10-24;7;31;0;0;0;4414350;3409077;3377;0;1893
FR;3;2021-10-25;22;150;7;0;7;4414372;3409227;3384;0;1900
FR;3;2021-10-26;18;113;22;0;19;4414390;3409340;3406;0;1919
FR;3;2021-10-27;15;118;9;0;9;4414405;3409458;3415;0;1928
FR;3;2021-10-28;20;126;33;0;36;4414425;3409584;3448;0;1964
FR;3;2021-10-29;10;123;64;0;54;4414435;3409707;3512;0;2018
FR;3;2021-10-30;8;66;11;1;10;4414443;3409773;3523;1;2028
FR;3;2021-10-31;5;22;1;0;1;4414448;3409795;3524;1;2029
FR;3;2021-11-01;7;22;2;0;1;4414455;3409817;3526;1;2030
FR;3;2021-11-02;9;108;8;0;10;4414464;3409925;3534;1;2040
FR;3;2021-11-03;19;119;10;0;10;4414483;3410044;3544;1;2050
FR;3;2021-11-04;18;97;4;0;3;4414501;3410141;3548;1;2053
FR;3;2021-11-05;17;142;8;1;5;4414518;3410283;3556;2;2058
FR;3;2021-11-06;6;67;3;0;3;4414524;3410350;3559;2;2061
FR;3;2021-11-07;6;21;1;0;1;4414530;3410371;3560;2;2062
FR;3;2021-11-08;11;140;7;0;5;4414541;3410511;3567;2;2067
FR;3;2021-11-09;12;151;5;0;5;4414553;3410662;3572;2;2072
FR;3;2021-11-10;12;180;13;0;14;4414565;3410842;3585;2;2086
FR;3;2021-11-11;8;51;3;0;3;4414573;3410893;3588;2;2089
FR;3;2021-11-12;10;155;6;0;4;4414583;3411048;3594;2;2093
FR;3;2021-11-13;7;77;8;0;10;4414590;3411125;3602;2;2103
FR;3;2021-11-14;2;21;0;0;0;4414592;3411146;3602;2;2103
FR;3;2021-11-15;4;191;9;0;9;4414596;3411337;3611;2;2112
FR;3;2021-11-16;2;166;11;0;10;4414598;3411503;3622;2;2122
FR;3;2021-11-17;5;180;10;0;7;4414603;3411683;3632;2;2129
FR;3;2021-11-18;13;178;10;0;11;4414616;3411861;3642;2;2140
FR;3;2021-11-19;8;228;22;0;27;4414624;3412089;3664;2;2167
FR;3;2021-11-20;6;117;5;0;5;4414630;3412206;3669;2;2172
FR;3;2021-11-21;3;26;3;0;3;4414633;3412232;3672;2;2175
FR;3;2021-11-22;10;237;10;0;10;4414643;3412469;3682;2;2185
FR;3;2021-11-23;6;233;15;0;14;4414649;3412702;3697;2;2199
FR;3;2021-11-24;5;240;9;0;17;4414654;3412942;3706;2;2216
FR;3;2021-11-25;9;284;11;0;10;4414663;3413226;3717;2;2226
FR;3;2021-11-26;5;367;35;0;32;4414668;3413593;3752;2;2258
FR;3;2021-11-27;8;173;20;0;21;4414676;3413766;3772;2;2279
FR;3;2021-11-28;3;65;7;0;7;4414679;3413831;3779;2;2286
FR;3;2021-11-29;4;325;19;0;20;4414683;3414156;3798;2;2306
FR;3;2021-11-30;5;416;26;0;29;4414688;3414572;3824;2;2335
FR;3;2021-12-01;18;462;32;0;33;4414706;3415034;3856;2;2368
FR;3;2021-12-02;9;496;33;0;36;4414715;3415530;3889;2;2404
FR;3;2021-12-03;3;566;37;0;38;4414718;3416096;3926;2;2442
FR;3;2021-12-04;3;282;26;0;28;4414721;3416378;3952;2;2470
FR;3;2021-12-05;1;81;5;0;5;4414722;3416459;3957;2;2475
FR;3;2021-12-06;5;507;14;0;16;4414727;3416966;3971;2;2491
FR;3;2021-12-07;4;609;20;0;24;4414731;3417575;3991;2;2515
FR;3;2021-12-08;3;537;29;0;30;4414734;3418112;4020;2;2545
FR;3;2021-12-09;3;587;17;0;22;4414737;3418699;4037;2;2567
FR;3;2021-12-10;9;623;29;0;25;4414746;3419322;4066;2;2592
FR;3;2021-12-11;4;385;10;0;9;4414750;3419707;4076;2;2601
FR;3;2021-12-12;1;121;3;0;3;4414751;3419828;4079;2;2604
FR;3;2021-12-13;2;599;19;0;21;4414753;3420427;4098;2;2625
FR;3;2021-12-14;7;753;18;0;21;4414760;3421180;4116;2;2646
FR;3;2021-12-15;9;720;17;0;21;4414769;3421900;4133;2;2667
FR;3;2021-12-16;9;726;19;0;18;4414778;3422626;4152;2;2685
FR;3;2021-12-17;4;793;18;0;19;4414782;3423419;4170;2;2704
FR;3;2021-12-18;4;413;4;0;5;4414786;3423832;4174;2;2709
FR;3;2021-12-19;3;207;2;0;2;4414789;3424039;4176;2;2711
FR;3;2021-12-20;8;719;23;0;28;4414797;3424758;4199;2;2739
FR;3;2021-12-21;3;808;10;0;13;4414800;3425566;4209;2;2752
FR;3;2021-12-22;6;755;9;0;10;4414806;3426321;4218;2;2762
FR;3;2021-12-23;1;648;9;0;8;4414807;3426969;4227;2;2770
FR;3;2021-12-24;2;271;3;0;6;4414809;3427240;4230;2;2776
FR;3;2021-12-25;0;25;0;0;0;4414809;3427265;4230;2;2776
FR;3;2021-12-26;0;95;1;0;1;4414809;3427360;4231;2;2777
FR;3;2021-12-27;7;542;17;0;19;4414816;3427902;4248;2;2796
FR;3;2021-12-28;1;690;6;0;5;4414817;3428592;4254;2;2801
FR;3;2021-12-29;4;574;14;0;16;4414821;3429166;4268;2;2817
FR;3;2021-12-30;1;599;7;0;10;4414822;3429765;4275;2;2827
FR;3;2021-12-31;0;204;5;0;6;4414822;3429969;4280;2;2833
FR;3;2022-01-01;0;27;0;0;2;4414822;3429996;4280;2;2835
FR;3;2022-01-02;0;82;0;0;0;4414822;3430078;4280;2;2835
FR;3;2022-01-03;3;564;17;0;20;4414825;3430642;4297;2;2855
FR;3;2022-01-04;6;623;9;0;8;4414831;3431265;4306;2;2863
FR;3;2022-01-05;4;552;10;0;14;4414835;3431817;4316;2;2877
FR;3;2022-01-06;5;547;9;0;12;4414840;3432364;4325;2;2889
FR;3;2022-01-07;2;576;11;0;14;4414842;3432940;4336;2;2903
FR;3;2022-01-08;2;283;4;0;5;4414844;3433223;4340;2;2908
FR;3;2022-01-09;0;118;0;0;0;4414844;3433341;4340;2;2908
FR;3;2022-01-10;2;479;12;0;12;4414846;3433820;4352;2;2920
FR;3;2022-01-11;2;531;1;0;1;4414848;3434351;4353;2;2921
FR;3;2022-01-12;2;445;9;0;10;4414850;3434796;4362;2;2931
FR;3;2022-01-13;3;423;11;0;12;4414853;3435219;4373;2;2943
FR;3;2022-01-14;3;474;10;0;13;4414856;3435693;4383;2;2956
FR;3;2022-01-15;0;298;2;0;3;4414856;3435991;4385;2;2959
FR;3;2022-01-16;0;116;1;0;1;4414856;3436107;4386;2;2960
FR;3;2022-01-17;2;349;8;0;10;4414858;3436456;4394;2;2970
FR;3;2022-01-18;2;413;1;0;2;4414860;3436869;4395;2;2972
FR;3;2022-01-19;1;349;5;0;10;4414861;3437218;4400;2;2982
FR;3;2022-01-20;1;379;5;0;3;4414862;3437597;4405;2;2985
FR;3;2022-01-21;3;373;5;0;7;4414865;3437970;4410;2;2992
FR;3;2022-01-22;2;231;1;0;2;4414867;3438201;4411;2;2994
FR;3;2022-01-23;0;82;0;0;1;4414867;3438283;4411;2;2995
FR;3;2022-01-24;2;348;1;0;6;4414869;3438631;4412;2;3001
FR;3;2022-01-25;0;192;0;0;0;4414869;3438823;4412;2;3001
FR;3;2022-01-26;0;88;0;0;0;4414869;3438911;4412;2;3001
FR;3;2022-01-27;0;58;0;0;0;4414869;3438969;4412;2;3001
FR;3;2022-01-28;0;133;0;0;0;4414869;3439102;4412;2;3001
FR;3;2022-01-29;0;110;0;0;0;4414869;3439212;4412;2;3001
FR;3;2022-01-30;0;51;0;0;0;4414869;3439263;4412;2;3001
FR;3;2022-01-31;0;97;0;0;0;4414869;3439360;4412;2;3001
FR;3;2022-02-01;0;108;0;0;1;4414869;3439468;4412;2;3002
FR;3;2022-02-02;0;95;0;0;0;4414869;3439563;4412;2;3002
FR;3;2022-02-03;0;101;0;0;0;4414869;3439664;4412;2;3002
FR;3;2022-02-04;0;124;0;0;0;4414869;3439788;4412;2;3002
FR;3;2022-02-05;0;73;0;0;0;4414869;3439861;4412;2;3002
FR;3;2022-02-06;0;11;0;0;0;4414869;3439872;4412;2;3002
FR;3;2022-02-07;0;89;0;0;1;4414869;3439961;4412;2;3003
FR;3;2022-02-08;0;0;0;0;0;4414869;3439961;4412;2;3003
FR;3;2022-02-09;0;0;0;0;0;4414869;3439961;4412;2;3003
FR;3;2022-02-10;0;0;0;0;0;4414869;3439961;4412;2;3003
FR;3;2022-02-11;0;0;0;0;0;4414869;3439961;4412;2;3003
FR;3;2022-02-12;0;0;0;0;0;4414869;3439961;4412;2;3003
FR;3;2022-02-13;0;0;0;0;0;4414869;3439961;4412;2;3003
FR;3;2022-02-14;0;0;0;0;0;4414869;3439961;4412;2;3003
FR;3;2022-02-15;0;0;0;0;0;4414869;3439961;4412;2;3003
FR;3;2022-02-16;0;0;0;0;0;4414869;3439961;4412;2;3003
FR;3;2022-02-17;0;0;0;0;0;4414869;3439961;4412;2;3003
FR;3;2022-02-18;0;0;0;0;0;4414869;3439961;4412;2;3003
FR;3;2022-02-19;0;0;0;0;0;4414869;3439961;4412;2;3003
FR;3;2022-02-20;0;0;0;0;0;4414869;3439961;4412;2;3003
FR;3;2022-02-21;2;0;0;0;0;4414871;3439961;4412;2;3003
FR;3;2022-02-22;0;0;0;0;0;4414871;3439961;4412;2;3003
FR;3;2022-02-23;0;0;0;0;0;4414871;3439961;4412;2;3003
FR;3;2022-02-24;0;0;0;0;0;4414871;3439961;4412;2;3003
FR;3;2022-02-25;0;0;0;0;0;4414871;3439961;4412;2;3003
FR;3;2022-02-26;0;0;0;0;0;4414871;3439961;4412;2;3003
FR;3;2022-02-27;0;0;0;0;0;4414871;3439961;4412;2;3003
FR;3;2022-02-28;1;0;0;0;0;4414872;3439961;4412;2;3003
FR;3;2022-03-01;1;0;0;0;0;4414873;3439961;4412;2;3003
FR;3;2022-03-02;0;0;0;0;0;4414873;3439961;4412;2;3003
FR;3;2022-03-03;0;0;0;0;0;4414873;3439961;4412;2;3003
FR;3;2022-03-04;0;0;0;0;0;4414873;3439961;4412;2;3003
FR;3;2022-03-05;0;0;0;0;0;4414873;3439961;4412;2;3003
FR;3;2022-03-06;1;0;0;0;0;4414874;3439961;4412;2;3003
FR;3;2022-03-07;0;0;0;0;0;4414874;3439961;4412;2;3003
FR;3;2022-03-08;1;0;0;0;0;4414875;3439961;4412;2;3003
FR;3;2022-03-09;0;0;0;0;0;4414875;3439961;4412;2;3003
FR;3;2022-03-10;0;0;0;0;0;4414875;3439961;4412;2;3003
FR;3;2022-03-11;0;0;0;0;0;4414875;3439961;4412;2;3003
FR;3;2022-03-12;0;0;0;0;0;4414875;3439961;4412;2;3003
FR;3;2022-03-13;0;0;0;0;0;4414875;3439961;4412;2;3003
FR;3;2022-03-14;0;0;0;0;0;4414875;3439961;4412;2;3003
FR;3;2022-03-15;0;0;0;0;0;4414875;3439961;4412;2;3003
FR;3;2022-03-16;0;0;0;0;0;4414875;3439961;4412;2;3003
FR;3;2022-03-17;0;0;0;0;0;4414875;3439961;4412;2;3003
FR;3;2022-03-18;0;0;0;0;0;4414875;3439961;4412;2;3003
FR;3;2022-03-19;0;0;0;0;0;4414875;3439961;4412;2;3003
FR;3;2022-03-20;1;0;0;0;0;4414876;3439961;4412;2;3003
FR;3;2022-03-21;0;0;0;0;0;4414876;3439961;4412;2;3003
FR;3;2022-03-22;0;0;0;0;0;4414876;3439961;4412;2;3003
FR;3;2022-03-23;1;0;0;0;0;4414877;3439961;4412;2;3003
FR;3;2022-03-24;0;0;0;0;0;4414877;3439961;4412;2;3003
FR;3;2022-03-25;1;0;0;0;0;4414878;3439961;4412;2;3003
FR;3;2022-03-26;0;0;0;0;0;4414878;3439961;4412;2;3003
FR;3;2022-03-27;0;0;0;0;0;4414878;3439961;4412;2;3003
FR;3;2022-03-28;0;0;0;0;0;4414878;3439961;4412;2;3003
FR;3;2022-03-29;0;0;0;0;0;4414878;3439961;4412;2;3003
FR;3;2022-03-30;0;0;0;0;0;4414878;3439961;4412;2;3003
FR;3;2022-03-31;0;0;0;0;0;4414878;3439961;4412;2;3003
FR;3;2022-04-01;0;0;0;0;0;4414878;3439961;4412;2;3003
FR;3;2022-04-02;0;0;0;0;0;4414878;3439961;4412;2;3003
FR;3;2022-04-03;0;0;0;0;0;4414878;3439961;4412;2;3003
FR;3;2022-04-04;0;0;0;0;0;4414878;3439961;4412;2;3003
FR;3;2022-04-05;0;0;0;0;0;4414878;3439961;4412;2;3003
FR;3;2022-04-06;0;0;0;0;0;4414878;3439961;4412;2;3003
FR;3;2022-04-07;0;0;0;0;0;4414878;3439961;4412;2;3003
FR;3;2022-04-08;0;0;0;0;0;4414878;3439961;4412;2;3003
FR;3;2022-04-09;0;0;0;0;0;4414878;3439961;4412;2;3003
FR;3;2022-04-10;0;0;0;0;0;4414878;3439961;4412;2;3003
FR;3;2022-04-11;0;0;0;0;0;4414878;3439961;4412;2;3003
FR;3;2022-04-12;0;0;0;0;0;4414878;3439961;4412;2;3003
FR;3;2022-04-13;0;0;0;0;0;4414878;3439961;4412;2;3003
FR;3;2022-04-14;0;0;0;0;0;4414878;3439961;4412;2;3003
FR;3;2022-04-15;1;0;0;0;0;4414879;3439961;4412;2;3003
FR;3;2022-04-16;0;0;0;0;0;4414879;3439961;4412;2;3003
FR;3;2022-04-17;0;0;0;0;0;4414879;3439961;4412;2;3003
FR;3;2022-04-18;0;0;0;0;0;4414879;3439961;4412;2;3003
FR;3;2022-04-19;0;0;0;0;0;4414879;3439961;4412;2;3003
FR;3;2022-04-20;0;0;0;0;0;4414879;3439961;4412;2;3003
FR;3;2022-04-21;0;0;0;0;0;4414879;3439961;4412;2;3003
FR;3;2022-04-22;0;0;0;0;0;4414879;3439961;4412;2;3003
FR;3;2022-04-23;0;0;0;0;0;4414879;3439961;4412;2;3003
FR;3;2022-04-24;0;0;0;0;0;4414879;3439961;4412;2;3003
FR;3;2022-04-25;0;0;0;0;0;4414879;3439961;4412;2;3003
FR;3;2022-04-26;0;0;0;0;0;4414879;3439961;4412;2;3003
FR;3;2022-04-27;0;0;0;0;0;4414879;3439961;4412;2;3003
FR;3;2022-04-28;0;0;0;0;0;4414879;3439961;4412;2;3003
FR;3;2022-04-29;0;0;0;0;0;4414879;3439961;4412;2;3003
FR;3;2022-04-30;0;0;0;0;0;4414879;3439961;4412;2;3003
FR;3;2022-05-01;0;0;0;0;0;4414879;3439961;4412;2;3003
FR;3;2022-05-02;0;0;0;0;0;4414879;3439961;4412;2;3003
FR;3;2022-05-03;0;0;0;0;0;4414879;3439961;4412;2;3003
FR;3;2022-05-04;0;0;0;0;0;4414879;3439961;4412;2;3003
FR;3;2022-05-05;0;0;0;0;0;4414879;3439961;4412;2;3003
FR;3;2022-05-06;0;0;0;0;0;4414879;3439961;4412;2;3003
FR;3;2022-05-07;0;0;0;0;0;4414879;3439961;4412;2;3003
FR;3;2022-05-08;0;0;0;0;0;4414879;3439961;4412;2;3003
FR;3;2022-05-09;0;0;0;0;0;4414879;3439961;4412;2;3003
FR;3;2022-05-10;0;0;0;0;0;4414879;3439961;4412;2;3003
FR;3;2022-05-11;0;0;0;0;0;4414879;3439961;4412;2;3003
FR;3;2022-05-12;0;0;0;0;0;4414879;3439961;4412;2;3003
FR;3;2022-05-13;0;0;0;0;0;4414879;3439961;4412;2;3003
FR;3;2022-05-14;1;0;0;0;0;4414880;3439961;4412;2;3003
FR;3;2022-05-15;0;0;0;0;0;4414880;3439961;4412;2;3003
FR;3;2022-05-16;0;0;0;0;0;4414880;3439961;4412;2;3003
FR;3;2022-05-17;0;0;0;0;0;4414880;3439961;4412;2;3003
FR;3;2022-05-18;0;0;0;0;0;4414880;3439961;4412;2;3003
FR;3;2022-05-19;0;0;0;0;0;4414880;3439961;4412;2;3003
FR;3;2022-05-20;0;0;0;0;0;4414880;3439961;4412;2;3003
FR;3;2022-05-21;0;0;0;0;0;4414880;3439961;4412;2;3003
FR;3;2022-05-22;0;0;0;0;0;4414880;3439961;4412;2;3003
FR;3;2022-05-23;0;0;0;0;0;4414880;3439961;4412;2;3003
FR;4;2020-12-27;0;0;0;0;0;0;0;0;0;0
FR;4;2020-12-28;0;0;0;0;0;0;0;0;0;0
FR;4;2020-12-29;0;0;0;0;0;0;0;0;0;0
FR;4;2020-12-30;0;0;0;0;0;0;0;0;0;0
FR;4;2020-12-31;0;0;0;0;0;0;0;0;0;0
FR;4;2021-01-01;0;0;0;0;0;0;0;0;0;0
FR;4;2021-01-02;0;0;0;0;0;0;0;0;0;0
FR;4;2021-01-03;0;0;0;0;0;0;0;0;0;0
FR;4;2021-01-04;0;0;0;0;0;0;0;0;0;0
FR;4;2021-01-05;0;0;0;0;0;0;0;0;0;0
FR;4;2021-01-06;0;0;0;0;0;0;0;0;0;0
FR;4;2021-01-07;0;0;0;0;0;0;0;0;0;0
FR;4;2021-01-08;0;0;0;0;0;0;0;0;0;0
FR;4;2021-01-09;0;0;0;0;0;0;0;0;0;0
FR;4;2021-01-10;0;0;0;0;0;0;0;0;0;0
FR;4;2021-01-11;0;0;0;0;0;0;0;0;0;0
FR;4;2021-01-12;0;0;0;0;0;0;0;0;0;0
FR;4;2021-01-13;0;0;0;0;0;0;0;0;0;0
FR;4;2021-01-14;0;0;0;0;0;0;0;0;0;0
FR;4;2021-01-15;0;0;0;0;0;0;0;0;0;0
FR;4;2021-01-16;0;0;0;0;0;0;0;0;0;0
FR;4;2021-01-17;0;0;0;0;0;0;0;0;0;0
FR;4;2021-01-18;0;0;0;0;0;0;0;0;0;0
FR;4;2021-01-19;0;0;0;0;0;0;0;0;0;0
FR;4;2021-01-20;0;0;0;0;0;0;0;0;0;0
FR;4;2021-01-21;0;0;0;0;0;0;0;0;0;0
FR;4;2021-01-22;0;0;0;0;0;0;0;0;0;0
FR;4;2021-01-23;0;0;0;0;0;0;0;0;0;0
FR;4;2021-01-24;0;0;0;0;0;0;0;0;0;0
FR;4;2021-01-25;0;0;0;0;0;0;0;0;0;0
FR;4;2021-01-26;0;0;0;0;0;0;0;0;0;0
FR;4;2021-01-27;0;0;0;0;0;0;0;0;0;0
FR;4;2021-01-28;0;0;0;0;0;0;0;0;0;0
FR;4;2021-01-29;0;0;0;0;0;0;0;0;0;0
FR;4;2021-01-30;0;0;0;0;0;0;0;0;0;0
FR;4;2021-01-31;0;0;0;0;0;0;0;0;0;0
FR;4;2021-02-01;0;0;0;0;0;0;0;0;0;0
FR;4;2021-02-02;0;0;0;0;0;0;0;0;0;0
FR;4;2021-02-03;0;0;0;0;0;0;0;0;0;0
FR;4;2021-02-04;0;0;0;0;0;0;0;0;0;0
FR;4;2021-02-05;0;0;0;0;0;0;0;0;0;0
FR;4;2021-02-06;0;0;0;0;0;0;0;0;0;0
FR;4;2021-02-07;0;0;0;0;0;0;0;0;0;0
FR;4;2021-02-08;0;0;0;0;0;0;0;0;0;0
FR;4;2021-02-09;0;0;0;0;0;0;0;0;0;0
FR;4;2021-02-10;0;0;0;0;0;0;0;0;0;0
FR;4;2021-02-11;0;0;0;0;0;0;0;0;0;0
FR;4;2021-02-12;0;0;0;0;0;0;0;0;0;0
FR;4;2021-02-13;0;0;0;0;0;0;0;0;0;0
FR;4;2021-02-14;0;0;0;0;0;0;0;0;0;0
FR;4;2021-02-15;0;0;0;0;0;0;0;0;0;0
FR;4;2021-02-16;0;0;0;0;0;0;0;0;0;0
FR;4;2021-02-17;0;0;0;0;0;0;0;0;0;0
FR;4;2021-02-18;0;0;0;0;0;0;0;0;0;0
FR;4;2021-02-19;0;0;0;0;0;0;0;0;0;0
FR;4;2021-02-20;0;0;0;0;0;0;0;0;0;0
FR;4;2021-02-21;0;0;0;0;0;0;0;0;0;0
FR;4;2021-02-22;0;0;0;0;0;0;0;0;0;0
FR;4;2021-02-23;0;0;0;0;0;0;0;0;0;0
FR;4;2021-02-24;0;0;0;0;0;0;0;0;0;0
FR;4;2021-02-25;0;0;0;0;0;0;0;0;0;0
FR;4;2021-02-26;0;0;0;0;0;0;0;0;0;0
FR;4;2021-02-27;0;0;0;0;0;0;0;0;0;0
FR;4;2021-02-28;0;0;0;0;0;0;0;0;0;0
FR;4;2021-03-01;0;0;0;0;0;0;0;0;0;0
FR;4;2021-03-02;0;0;0;0;0;0;0;0;0;0
FR;4;2021-03-03;0;0;0;0;0;0;0;0;0;0
FR;4;2021-03-04;0;0;0;0;0;0;0;0;0;0
FR;4;2021-03-05;0;0;0;0;0;0;0;0;0;0
FR;4;2021-03-06;0;0;0;0;0;0;0;0;0;0
FR;4;2021-03-07;0;0;0;0;0;0;0;0;0;0
FR;4;2021-03-08;0;0;0;0;0;0;0;0;0;0
FR;4;2021-03-09;0;0;0;0;0;0;0;0;0;0
FR;4;2021-03-10;0;0;0;0;0;0;0;0;0;0
FR;4;2021-03-11;0;0;0;0;0;0;0;0;0;0
FR;4;2021-03-12;0;0;0;0;0;0;0;0;0;0
FR;4;2021-03-13;0;0;0;0;0;0;0;0;0;0
FR;4;2021-03-14;0;0;0;0;0;0;0;0;0;0
FR;4;2021-03-15;0;0;0;0;0;0;0;0;0;0
FR;4;2021-03-16;0;0;0;0;0;0;0;0;0;0
FR;4;2021-03-17;0;0;0;0;0;0;0;0;0;0
FR;4;2021-03-18;0;0;0;0;0;0;0;0;0;0
FR;4;2021-03-19;0;0;0;0;0;0;0;0;0;0
FR;4;2021-03-20;0;0;0;0;0;0;0;0;0;0
FR;4;2021-03-21;0;0;0;0;0;0;0;0;0;0
FR;4;2021-03-22;0;0;0;0;0;0;0;0;0;0
FR;4;2021-03-23;0;0;0;0;0;0;0;0;0;0
FR;4;2021-03-24;0;0;0;0;0;0;0;0;0;0
FR;4;2021-03-25;0;0;0;0;0;0;0;0;0;0
FR;4;2021-03-26;0;0;0;0;0;0;0;0;0;0
FR;4;2021-03-27;0;0;0;0;0;0;0;0;0;0
FR;4;2021-03-28;0;0;0;0;0;0;0;0;0;0
FR;4;2021-03-29;0;0;0;0;0;0;0;0;0;0
FR;4;2021-03-30;0;0;0;0;0;0;0;0;0;0
FR;4;2021-03-31;0;0;0;0;0;0;0;0;0;0
FR;4;2021-04-01;0;0;0;0;0;0;0;0;0;0
FR;4;2021-04-02;0;0;0;0;0;0;0;0;0;0
FR;4;2021-04-03;0;0;0;0;0;0;0;0;0;0
FR;4;2021-04-04;0;0;0;0;0;0;0;0;0;0
FR;4;2021-04-05;0;0;0;0;0;0;0;0;0;0
FR;4;2021-04-06;0;0;0;0;0;0;0;0;0;0
FR;4;2021-04-07;0;0;0;0;0;0;0;0;0;0
FR;4;2021-04-08;0;0;0;0;0;0;0;0;0;0
FR;4;2021-04-09;0;0;0;0;0;0;0;0;0;0
FR;4;2021-04-10;0;0;0;0;0;0;0;0;0;0
FR;4;2021-04-11;0;0;0;0;0;0;0;0;0;0
FR;4;2021-04-12;0;0;0;0;0;0;0;0;0;0
FR;4;2021-04-13;0;0;0;0;0;0;0;0;0;0
FR;4;2021-04-14;0;0;0;0;0;0;0;0;0;0
FR;4;2021-04-15;0;0;0;0;0;0;0;0;0;0
FR;4;2021-04-16;0;0;0;0;0;0;0;0;0;0
FR;4;2021-04-17;0;0;0;0;0;0;0;0;0;0
FR;4;2021-04-18;0;0;0;0;0;0;0;0;0;0
FR;4;2021-04-19;0;0;0;0;0;0;0;0;0;0
FR;4;2021-04-20;0;0;0;0;0;0;0;0;0;0
FR;4;2021-04-21;0;0;0;0;0;0;0;0;0;0
FR;4;2021-04-22;0;0;0;0;0;0;0;0;0;0
FR;4;2021-04-23;4021;0;0;0;0;4021;0;0;0;0
FR;4;2021-04-24;1569;0;0;0;0;5590;0;0;0;0
FR;4;2021-04-25;125;0;0;0;0;5715;0;0;0;0
FR;4;2021-04-26;2869;1;0;0;0;8584;1;0;0;0
FR;4;2021-04-27;9519;3;0;0;0;18103;4;0;0;0
FR;4;2021-04-28;9904;6;0;0;0;28007;10;0;0;0
FR;4;2021-04-29;15991;8;0;0;0;43998;18;0;0;0
FR;4;2021-04-30;19228;10;0;0;0;63226;28;0;0;0
FR;4;2021-05-01;1993;6;0;0;0;65219;34;0;0;0
FR;4;2021-05-02;482;0;0;0;0;65701;34;0;0;0
FR;4;2021-05-03;5058;2;0;0;0;70759;36;0;0;0
FR;4;2021-05-04;8397;10;0;0;0;79156;46;0;0;0
FR;4;2021-05-05;6182;7;0;0;0;85338;53;0;0;0
FR;4;2021-05-06;11378;11;0;0;0;96716;64;0;0;0
FR;4;2021-05-07;19121;9;0;0;0;115837;73;0;0;0
FR;4;2021-05-08;2377;6;0;0;0;118214;79;0;0;0
FR;4;2021-05-09;685;3;0;0;0;118899;82;0;0;0
FR;4;2021-05-10;7239;5;1;0;0;126138;87;1;0;0
FR;4;2021-05-11;14313;12;0;0;0;140451;99;1;0;0
FR;4;2021-05-12;10161;15;0;0;0;150612;114;1;0;0
FR;4;2021-05-13;1579;3;0;0;0;152191;117;1;0;0
FR;4;2021-05-14;7758;6;0;0;0;159949;123;1;0;0
FR;4;2021-05-15;3717;8;1;0;0;163666;131;2;0;0
FR;4;2021-05-16;417;1;0;0;0;164083;132;2;0;0
FR;4;2021-05-17;4475;6;0;0;0;168558;138;2;0;0
FR;4;2021-05-18;8751;10;0;0;0;177309;148;2;0;0
FR;4;2021-05-19;5690;7;0;0;0;182999;155;2;0;0
FR;4;2021-05-20;9478;7;0;0;0;192477;162;2;0;0
FR;4;2021-05-21;12790;30;0;0;0;205267;192;2;0;0
FR;4;2021-05-22;5057;15;0;0;0;210324;207;2;0;0
FR;4;2021-05-23;494;4;0;0;0;210818;211;2;0;0
FR;4;2021-05-24;1054;7;0;0;0;211872;218;2;0;0
FR;4;2021-05-25;7620;16;0;0;0;219492;234;2;0;0
FR;4;2021-05-26;7723;16;0;0;0;227215;250;2;0;0
FR;4;2021-05-27;14327;35;0;0;0;241542;285;2;0;0
FR;4;2021-05-28;26583;82;1;0;0;268125;367;3;0;0
FR;4;2021-05-29;11380;18;0;0;0;279505;385;3;0;0
FR;4;2021-05-30;971;6;0;0;0;280476;391;3;0;0
FR;4;2021-05-31;12686;21;0;0;0;293162;412;3;0;0
FR;4;2021-06-01;20248;46;1;0;0;313410;458;4;0;0
FR;4;2021-06-02;14518;33;0;0;0;327928;491;4;0;0
FR;4;2021-06-03;19409;24;1;0;0;347337;515;5;0;0
FR;4;2021-06-04;22509;47;0;0;0;369846;562;5;0;0
FR;4;2021-06-05;9712;32;0;0;0;379558;594;5;0;0
FR;4;2021-06-06;1039;1;0;0;0;380597;595;5;0;0
FR;4;2021-06-07;9224;19;0;0;0;389821;614;5;0;0
FR;4;2021-06-08;14605;31;0;0;0;404426;645;5;0;0
FR;4;2021-06-09;12202;25;0;0;0;416628;670;5;0;0
FR;4;2021-06-10;15397;30;0;0;0;432025;700;5;0;0
FR;4;2021-06-11;16979;56;0;0;0;449004;756;5;0;0
FR;4;2021-06-12;7445;27;0;0;0;456449;783;5;0;0
FR;4;2021-06-13;906;2;0;0;0;457355;785;5;0;0
FR;4;2021-06-14;6646;25;0;0;0;464001;810;5;0;0
FR;4;2021-06-15;10882;37;0;0;0;474883;847;5;0;0
FR;4;2021-06-16;8904;15;0;0;0;483787;862;5;0;0
FR;4;2021-06-17;10897;36;0;0;0;494684;898;5;0;0
FR;4;2021-06-18;12420;45;0;0;0;507104;943;5;0;0
FR;4;2021-06-19;5567;25;0;0;0;512671;968;5;0;0
FR;4;2021-06-20;817;5;0;0;0;513488;973;5;0;0
FR;4;2021-06-21;5081;20;0;0;0;518569;993;5;0;0
FR;4;2021-06-22;7905;28;2;0;0;526474;1021;7;0;0
FR;4;2021-06-23;7092;39;2;0;0;533566;1060;9;0;0
FR;4;2021-06-24;8645;45;1;0;0;542211;1105;10;0;0
FR;4;2021-06-25;10172;39;2;0;0;552383;1144;12;0;0
FR;4;2021-06-26;4841;21;0;0;0;557224;1165;12;0;0
FR;4;2021-06-27;760;3;0;0;0;557984;1168;12;0;0
FR;4;2021-06-28;4821;16;1;0;0;562805;1184;13;0;0
FR;4;2021-06-29;7097;27;2;0;0;569902;1211;15;0;0
FR;4;2021-06-30;6707;39;2;0;0;576609;1250;17;0;0
FR;4;2021-07-01;8191;40;0;0;0;584800;1290;17;0;0
FR;4;2021-07-02;9412;52;1;0;0;594212;1342;18;0;0
FR;4;2021-07-03;4844;19;0;0;0;599056;1361;18;0;0
FR;4;2021-07-04;686;5;0;0;0;599742;1366;18;0;0
FR;4;2021-07-05;4765;19;2;0;0;604507;1385;20;0;0
FR;4;2021-07-06;7717;28;4;0;0;612224;1413;24;0;0
FR;4;2021-07-07;7067;34;2;0;0;619291;1447;26;0;0
FR;4;2021-07-08;9219;40;2;0;0;628510;1487;28;0;0
FR;4;2021-07-09;10275;34;1;0;0;638785;1521;29;0;0
FR;4;2021-07-10;4633;14;2;0;0;643418;1535;31;0;0
FR;4;2021-07-11;582;4;1;0;0;644000;1539;32;0;0
FR;4;2021-07-12;5867;29;0;0;0;649867;1568;32;0;0
FR;4;2021-07-13;14230;29;0;0;0;664097;1597;32;0;0
FR;4;2021-07-14;2282;14;0;0;0;666379;1611;32;0;0
FR;4;2021-07-15;18231;36;0;0;0;684610;1647;32;0;0
FR;4;2021-07-16;22815;70;2;0;0;707425;1717;34;0;0
FR;4;2021-07-17;9735;20;0;0;0;717160;1737;34;0;0
FR;4;2021-07-18;1354;4;0;0;0;718514;1741;34;0;0
FR;4;2021-07-19;12979;28;1;0;0;731493;1769;35;0;0
FR;4;2021-07-20;17331;26;1;0;0;748824;1795;36;0;0
FR;4;2021-07-21;15604;33;0;0;0;764428;1828;36;0;0
FR;4;2021-07-22;18237;44;2;0;0;782665;1872;38;0;0
FR;4;2021-07-23;20404;57;7;0;0;803069;1929;45;0;0
FR;4;2021-07-24;9282;32;0;0;0;812351;1961;45;0;0
FR;4;2021-07-25;1350;8;0;0;0;813701;1969;45;0;0
FR;4;2021-07-26;11030;20;0;0;0;824731;1989;45;0;0
FR;4;2021-07-27;14660;35;3;0;0;839391;2024;48;0;0
FR;4;2021-07-28;12921;26;2;0;0;852312;2050;50;0;0
FR;4;2021-07-29;14079;54;4;0;0;866391;2104;54;0;0
FR;4;2021-07-30;15478;45;2;0;0;881869;2149;56;0;0
FR;4;2021-07-31;6830;14;2;0;0;888699;2163;58;0;0
FR;4;2021-08-01;904;1;0;0;0;889603;2164;58;0;0
FR;4;2021-08-02;7902;29;0;0;0;897505;2193;58;0;0
FR;4;2021-08-03;10788;32;2;0;0;908293;2225;60;0;0
FR;4;2021-08-04;9732;29;0;0;0;918025;2254;60;0;0
FR;4;2021-08-05;9812;41;0;0;0;927837;2295;60;0;0
FR;4;2021-08-06;10181;30;3;0;0;938018;2325;63;0;0
FR;4;2021-08-07;5088;30;1;0;0;943106;2355;64;0;0
FR;4;2021-08-08;1217;13;0;0;0;944323;2368;64;0;0
FR;4;2021-08-09;6334;31;0;0;0;950657;2399;64;0;0
FR;4;2021-08-10;8741;18;0;0;0;959398;2417;64;0;0
FR;4;2021-08-11;7929;33;4;0;0;967327;2450;68;0;0
FR;4;2021-08-12;8579;29;1;0;0;975906;2479;69;0;0
FR;4;2021-08-13;7546;24;0;1;0;983452;2503;69;1;0
FR;4;2021-08-14;3787;20;0;0;0;987239;2523;69;1;0
FR;4;2021-08-15;769;5;0;0;0;988008;2528;69;1;0
FR;4;2021-08-16;4003;16;0;0;0;992011;2544;69;1;0
FR;4;2021-08-17;5616;16;1;0;0;997627;2560;70;1;0
FR;4;2021-08-18;5162;34;0;0;0;1002789;2594;70;1;0
FR;4;2021-08-19;5474;33;3;0;0;1008263;2627;73;1;0
FR;4;2021-08-20;5210;24;1;0;0;1013473;2651;74;1;0
FR;4;2021-08-21;2307;21;1;0;0;1015780;2672;75;1;0
FR;4;2021-08-22;401;2;0;0;0;1016181;2674;75;1;0
FR;4;2021-08-23;2924;19;1;0;0;1019105;2693;76;1;0
FR;4;2021-08-24;3744;15;0;0;0;1022849;2708;76;1;0
FR;4;2021-08-25;3538;25;0;0;0;1026387;2733;76;1;0
FR;4;2021-08-26;3701;20;2;0;0;1030088;2753;78;1;0
FR;4;2021-08-27;3605;31;2;0;0;1033693;2784;80;1;0
FR;4;2021-08-28;1723;9;1;0;0;1035416;2793;81;1;0
FR;4;2021-08-29;387;7;1;0;0;1035803;2800;82;1;0
FR;4;2021-08-30;2008;24;0;0;14;1037811;2824;82;1;14
FR;4;2021-08-31;2481;20;0;0;13;1040292;2844;82;1;27
FR;4;2021-09-01;2078;38;1;0;21;1042370;2882;83;1;48
FR;4;2021-09-02;2301;31;4;0;18;1044671;2913;87;1;66
FR;4;2021-09-03;2357;44;5;0;32;1047028;2957;92;1;98
FR;4;2021-09-04;1374;17;0;0;7;1048402;2974;92;1;105
FR;4;2021-09-05;431;2;0;0;2;1048833;2976;92;1;107
FR;4;2021-09-06;1705;62;0;0;23;1050538;3038;92;1;130
FR;4;2021-09-07;1672;18;1;0;9;1052210;3056;93;1;139
FR;4;2021-09-08;1279;27;3;1;20;1053489;3083;96;2;159
FR;4;2021-09-09;1385;23;2;0;9;1054874;3106;98;2;168
FR;4;2021-09-10;1516;31;2;0;23;1056390;3137;100;2;191
FR;4;2021-09-11;738;11;0;0;3;1057128;3148;100;2;194
FR;4;2021-09-12;168;4;0;0;2;1057296;3152;100;2;196
FR;4;2021-09-13;1315;22;1;0;16;1058611;3174;101;2;212
FR;4;2021-09-14;1497;9;2;0;6;1060108;3183;103;2;218
FR;4;2021-09-15;1091;27;1;0;24;1061199;3210;104;2;242
FR;4;2021-09-16;1095;22;2;0;15;1062294;3232;106;2;257
FR;4;2021-09-17;892;21;1;0;12;1063186;3253;107;2;269
FR;4;2021-09-18;462;6;1;0;5;1063648;3259;108;2;274
FR;4;2021-09-19;182;3;0;0;2;1063830;3262;108;2;276
FR;4;2021-09-20;446;18;0;0;12;1064276;3280;108;2;288
FR;4;2021-09-21;423;11;0;0;7;1064699;3291;108;2;295
FR;4;2021-09-22;372;19;2;0;13;1065071;3310;110;2;308
FR;4;2021-09-23;477;16;1;0;15;1065548;3326;111;2;323
FR;4;2021-09-24;409;13;2;0;9;1065957;3339;113;2;332
FR;4;2021-09-25;281;9;1;0;4;1066238;3348;114;2;336
FR;4;2021-09-26;73;2;0;0;1;1066311;3350;114;2;337
FR;4;2021-09-27;261;10;1;0;8;1066572;3360;115;2;345
FR;4;2021-09-28;315;8;0;0;8;1066887;3368;115;2;353
FR;4;2021-09-29;372;18;1;0;12;1067259;3386;116;2;365
FR;4;2021-09-30;359;40;0;0;21;1067618;3426;116;2;386
FR;4;2021-10-01;407;49;0;0;43;1068025;3475;116;2;429
FR;4;2021-10-02;195;22;1;0;13;1068220;3497;117;2;442
FR;4;2021-10-03;84;1;0;0;0;1068304;3498;117;2;442
FR;4;2021-10-04;355;19;1;0;15;1068659;3517;118;2;457
FR;4;2021-10-05;276;19;2;0;15;1068935;3536;120;2;472
FR;4;2021-10-06;243;21;1;0;17;1069178;3557;121;2;489
FR;4;2021-10-07;254;25;2;0;13;1069432;3582;123;2;502
FR;4;2021-10-08;352;23;2;0;19;1069784;3605;125;2;521
FR;4;2021-10-09;192;6;6;0;7;1069976;3611;131;2;528
FR;4;2021-10-10;95;3;2;0;3;1070071;3614;133;2;531
FR;4;2021-10-11;246;15;1;0;14;1070317;3629;134;2;545
FR;4;2021-10-12;204;14;0;0;13;1070521;3643;134;2;558
FR;4;2021-10-13;218;27;1;0;24;1070739;3670;135;2;582
FR;4;2021-10-14;307;22;4;0;16;1071046;3692;139;2;598
FR;4;2021-10-15;322;24;5;0;25;1071368;3716;144;2;623
FR;4;2021-10-16;166;6;2;0;6;1071534;3722;146;2;629
FR;4;2021-10-17;70;2;0;0;1;1071604;3724;146;2;630
FR;4;2021-10-18;278;16;1;0;12;1071882;3740;147;2;642
FR;4;2021-10-19;210;14;2;0;15;1072092;3754;149;2;657
FR;4;2021-10-20;224;27;4;0;15;1072316;3781;153;2;672
FR;4;2021-10-21;235;17;0;0;13;1072551;3798;153;2;685
FR;4;2021-10-22;211;25;2;0;20;1072762;3823;155;2;705
FR;4;2021-10-23;115;16;1;0;15;1072877;3839;156;2;720
FR;4;2021-10-24;38;4;0;0;1;1072915;3843;156;2;721
FR;4;2021-10-25;209;7;2;0;9;1073124;3850;158;2;730
FR;4;2021-10-26;196;14;0;0;12;1073320;3864;158;2;742
FR;4;2021-10-27;190;11;4;0;11;1073510;3875;162;2;753
FR;4;2021-10-28;182;18;4;0;21;1073692;3893;166;2;774
FR;4;2021-10-29;220;15;2;0;13;1073912;3908;168;2;787
FR;4;2021-10-30;102;2;1;0;2;1074014;3910;169;2;789
FR;4;2021-10-31;56;3;2;0;3;1074070;3913;171;2;792
FR;4;2021-11-01;75;27;4;0;24;1074145;3940;175;2;816
FR;4;2021-11-02;153;20;2;0;21;1074298;3960;177;2;837
FR;4;2021-11-03;127;20;8;1;18;1074425;3980;185;3;855
FR;4;2021-11-04;175;14;1;0;11;1074600;3994;186;3;866
FR;4;2021-11-05;126;17;1;0;16;1074726;4011;187;3;882
FR;4;2021-11-06;77;6;1;0;6;1074803;4017;188;3;888
FR;4;2021-11-07;76;2;2;0;4;1074879;4019;190;3;892
FR;4;2021-11-08;158;20;1;0;20;1075037;4039;191;3;912
FR;4;2021-11-09;151;14;3;0;16;1075188;4053;194;3;928
FR;4;2021-11-10;114;29;6;0;31;1075302;4082;200;3;959
FR;4;2021-11-11;86;10;0;0;10;1075388;4092;200;3;969
FR;4;2021-11-12;97;18;2;0;17;1075485;4110;202;3;986
FR;4;2021-11-13;73;15;2;0;14;1075558;4125;204;3;1000
FR;4;2021-11-14;53;5;3;0;7;1075611;4130;207;3;1007
FR;4;2021-11-15;97;26;2;0;24;1075708;4156;209;3;1031
FR;4;2021-11-16;99;12;2;0;14;1075807;4168;211;3;1045
FR;4;2021-11-17;116;29;4;0;29;1075923;4197;215;3;1074
FR;4;2021-11-18;99;34;12;0;41;1076022;4231;227;3;1115
FR;4;2021-11-19;79;19;3;0;20;1076101;4250;230;3;1135
FR;4;2021-11-20;75;8;1;0;8;1076176;4258;231;3;1143
FR;4;2021-11-21;61;7;2;0;9;1076237;4265;233;3;1152
FR;4;2021-11-22;101;27;6;0;29;1076338;4292;239;3;1181
FR;4;2021-11-23;73;29;5;0;26;1076411;4321;244;3;1207
FR;4;2021-11-24;85;23;9;0;22;1076496;4344;253;3;1229
FR;4;2021-11-25;84;28;14;0;30;1076580;4372;267;3;1259
FR;4;2021-11-26;80;43;12;0;45;1076660;4415;279;3;1304
FR;4;2021-11-27;35;22;14;0;24;1076695;4437;293;3;1328
FR;4;2021-11-28;48;8;0;0;7;1076743;4445;293;3;1335
FR;4;2021-11-29;83;31;15;0;39;1076826;4476;308;3;1374
FR;4;2021-11-30;72;36;12;0;40;1076898;4512;320;3;1414
FR;4;2021-12-01;79;59;19;0;66;1076977;4571;339;3;1480
FR;4;2021-12-02;98;47;19;0;52;1077075;4618;358;3;1532
FR;4;2021-12-03;98;36;15;0;44;1077173;4654;373;3;1576
FR;4;2021-12-04;69;31;18;0;44;1077242;4685;391;3;1620
FR;4;2021-12-05;61;5;1;0;6;1077303;4690;392;3;1626
FR;4;2021-12-06;96;45;20;0;59;1077399;4735;412;3;1685
FR;4;2021-12-07;77;33;9;0;33;1077476;4768;421;3;1718
FR;4;2021-12-08;66;29;16;0;34;1077542;4797;437;3;1752
FR;4;2021-12-09;59;32;10;0;38;1077601;4829;447;3;1790
FR;4;2021-12-10;60;62;21;0;66;1077661;4891;468;3;1856
FR;4;2021-12-11;24;34;7;0;34;1077685;4925;475;3;1890
FR;4;2021-12-12;23;10;3;0;13;1077708;4935;478;3;1903
FR;4;2021-12-13;68;38;13;0;47;1077776;4973;491;3;1950
FR;4;2021-12-14;56;43;15;0;52;1077832;5016;506;3;2002
FR;4;2021-12-15;59;63;28;0;83;1077891;5079;534;3;2085
FR;4;2021-12-16;30;44;18;0;56;1077921;5123;552;3;2141
FR;4;2021-12-17;38;55;12;0;60;1077959;5178;564;3;2201
FR;4;2021-12-18;48;29;2;0;30;1078007;5207;566;3;2231
FR;4;2021-12-19;15;4;1;0;4;1078022;5211;567;3;2235
FR;4;2021-12-20;35;38;10;0;41;1078057;5249;577;3;2276
FR;4;2021-12-21;26;30;15;0;36;1078083;5279;592;3;2312
FR;4;2021-12-22;35;35;10;0;36;1078118;5314;602;3;2348
FR;4;2021-12-23;39;43;8;0;47;1078157;5357;610;3;2395
FR;4;2021-12-24;23;25;10;0;29;1078180;5382;620;3;2424
FR;4;2021-12-25;6;3;3;0;4;1078186;5385;623;3;2428
FR;4;2021-12-26;4;3;1;0;2;1078190;5388;624;3;2430
FR;4;2021-12-27;26;41;8;0;42;1078216;5429;632;3;2472
FR;4;2021-12-28;24;28;8;0;29;1078240;5457;640;3;2501
FR;4;2021-12-29;48;24;10;0;28;1078288;5481;650;3;2529
FR;4;2021-12-30;40;16;12;0;19;1078328;5497;662;3;2548
FR;4;2021-12-31;18;5;8;0;10;1078346;5502;670;3;2558
FR;4;2022-01-01;5;4;4;0;6;1078351;5506;674;3;2564
FR;4;2022-01-02;40;4;14;0;17;1078391;5510;688;3;2581
FR;4;2022-01-03;37;52;20;1;57;1078428;5562;708;4;2638
FR;4;2022-01-04;28;26;13;0;29;1078456;5588;721;4;2667
FR;4;2022-01-05;46;20;16;0;21;1078502;5608;737;4;2688
FR;4;2022-01-06;43;20;21;0;33;1078545;5628;758;4;2721
FR;4;2022-01-07;24;19;15;0;19;1078569;5647;773;4;2740
FR;4;2022-01-08;8;5;9;0;11;1078577;5652;782;4;2751
FR;4;2022-01-09;17;2;1;0;2;1078594;5654;783;4;2753
FR;4;2022-01-10;39;22;16;0;33;1078633;5676;799;4;2786
FR;4;2022-01-11;23;30;12;0;34;1078656;5706;811;4;2820
FR;4;2022-01-12;30;18;12;0;19;1078686;5724;823;4;2839
FR;4;2022-01-13;48;18;26;0;35;1078734;5742;849;4;2874
FR;4;2022-01-14;21;28;13;0;31;1078755;5770;862;4;2905
FR;4;2022-01-15;10;6;7;0;11;1078765;5776;869;4;2916
FR;4;2022-01-16;9;9;11;0;19;1078774;5785;880;4;2935
FR;4;2022-01-17;23;17;12;0;23;1078797;5802;892;4;2958
FR;4;2022-01-18;15;13;7;0;17;1078812;5815;899;4;2975
FR;4;2022-01-19;28;22;9;0;29;1078840;5837;908;4;3004
FR;4;2022-01-20;31;33;11;0;36;1078871;5870;919;4;3040
FR;4;2022-01-21;9;12;18;1;15;1078880;5882;937;5;3055
FR;4;2022-01-22;30;9;2;0;9;1078910;5891;939;5;3064
FR;4;2022-01-23;6;3;4;0;7;1078916;5894;943;5;3071
FR;4;2022-01-24;14;21;8;0;27;1078930;5915;951;5;3098
FR;4;2022-01-25;20;30;8;1;34;1078950;5945;959;6;3132
FR;4;2022-01-26;18;15;6;1;16;1078968;5960;965;7;3148
FR;4;2022-01-27;19;18;5;0;21;1078987;5978;970;7;3169
FR;4;2022-01-28;12;23;7;0;25;1078999;6001;977;7;3194
FR;4;2022-01-29;15;6;4;0;9;1079014;6007;981;7;3203
FR;4;2022-01-30;16;2;0;0;2;1079030;6009;981;7;3205
FR;4;2022-01-31;19;27;6;0;29;1079049;6036;987;7;3234
FR;4;2022-02-01;9;19;11;0;19;1079058;6055;998;7;3253
FR;4;2022-02-02;16;11;10;2;16;1079074;6066;1008;9;3269
FR;4;2022-02-03;12;22;9;0;25;1079086;6088;1017;9;3294
FR;4;2022-02-04;6;5;7;0;9;1079092;6093;1024;9;3303
FR;4;2022-02-05;6;14;1;0;13;1079098;6107;1025;9;3316
FR;4;2022-02-06;5;2;1;0;2;1079103;6109;1026;9;3318
FR;4;2022-02-07;12;19;6;0;19;1079115;6128;1032;9;3337
FR;4;2022-02-08;14;19;13;1;20;1079129;6147;1045;10;3357
FR;4;2022-02-09;14;10;7;0;13;1079143;6157;1052;10;3370
FR;4;2022-02-10;18;23;9;0;24;1079161;6180;1061;10;3394
FR;4;2022-02-11;17;14;8;0;19;1079178;6194;1069;10;3413
FR;4;2022-02-12;23;7;1;0;6;1079201;6201;1070;10;3419
FR;4;2022-02-13;7;3;3;0;6;1079208;6204;1073;10;3425
FR;4;2022-02-14;18;10;7;0;13;1079226;6214;1080;10;3438
FR;4;2022-02-15;16;7;1;0;7;1079242;6221;1081;10;3445
FR;4;2022-02-16;11;9;10;0;15;1079253;6230;1091;10;3460
FR;4;2022-02-17;10;4;4;0;6;1079263;6234;1095;10;3466
FR;4;2022-02-18;17;13;6;0;17;1079280;6247;1101;10;3483
FR;4;2022-02-19;16;2;2;0;4;1079296;6249;1103;10;3487
FR;4;2022-02-20;7;2;0;0;1;1079303;6251;1103;10;3488
FR;4;2022-02-21;22;3;2;0;3;1079325;6254;1105;10;3491
FR;4;2022-02-22;8;4;8;0;8;1079333;6258;1113;10;3499
FR;4;2022-02-23;16;6;8;0;8;1079349;6264;1121;10;3507
FR;4;2022-02-24;9;3;2;0;3;1079358;6267;1123;10;3510
FR;4;2022-02-25;15;5;7;0;6;1079373;6272;1130;10;3516
FR;4;2022-02-26;26;3;0;0;3;1079399;6275;1130;10;3519
FR;4;2022-02-27;9;0;1;0;1;1079408;6275;1131;10;3520
FR;4;2022-02-28;14;3;2;0;3;1079422;6278;1133;10;3523
FR;4;2022-03-01;6;2;7;0;3;1079428;6280;1140;10;3526
FR;4;2022-03-02;9;2;3;0;4;1079437;6282;1143;10;3530
FR;4;2022-03-03;14;5;1;0;4;1079451;6287;1144;10;3534
FR;4;2022-03-04;6;7;2;1;5;1079457;6294;1146;11;3539
FR;4;2022-03-05;8;2;0;0;2;1079465;6296;1146;11;3541
FR;4;2022-03-06;4;0;1;0;1;1079469;6296;1147;11;3542
FR;4;2022-03-07;10;4;1;0;3;1079479;6300;1148;11;3545
FR;4;2022-03-08;13;2;0;0;2;1079492;6302;1148;11;3547
FR;4;2022-03-09;7;3;2;0;4;1079499;6305;1150;11;3551
FR;4;2022-03-10;5;1;5;0;2;1079504;6306;1155;11;3553
FR;4;2022-03-11;8;2;5;0;1;1079512;6308;1160;11;3554
FR;4;2022-03-12;9;2;0;0;0;1079521;6310;1160;11;3554
FR;4;2022-03-13;5;0;1;0;1;1079526;6310;1161;11;3555
FR;4;2022-03-14;4;1;0;0;1;1079530;6311;1161;11;3556
FR;4;2022-03-15;5;3;1;0;1;1079535;6314;1162;11;3557
FR;4;2022-03-16;6;3;3;0;3;1079541;6317;1165;11;3560
FR;4;2022-03-17;1;4;1;0;5;1079542;6321;1166;11;3565
FR;4;2022-03-18;7;2;0;0;2;1079549;6323;1166;11;3567
FR;4;2022-03-19;1;1;0;0;1;1079550;6324;1166;11;3568
FR;4;2022-03-20;2;0;2;0;1;1079552;6324;1168;11;3569
FR;4;2022-03-21;5;3;0;0;3;1079557;6327;1168;11;3572
FR;4;2022-03-22;3;2;1;0;2;1079560;6329;1169;11;3574
FR;4;2022-03-23;6;3;3;0;5;1079566;6332;1172;11;3579
FR;4;2022-03-24;2;4;3;1;5;1079568;6336;1175;12;3584
FR;4;2022-03-25;3;1;2;0;1;1079571;6337;1177;12;3585
FR;4;2022-03-26;5;5;0;0;5;1079576;6342;1177;12;3590
FR;4;2022-03-27;1;0;1;0;0;1079577;6342;1178;12;3590
FR;4;2022-03-28;4;1;1;0;1;1079581;6343;1179;12;3591
FR;4;2022-03-29;7;0;4;1;0;1079588;6343;1183;13;3591
FR;4;2022-03-30;1;4;0;0;4;1079589;6347;1183;13;3595
FR;4;2022-03-31;1;3;1;1;3;1079590;6350;1184;14;3598
FR;4;2022-04-01;13;3;5;0;6;1079603;6353;1189;14;3604
FR;4;2022-04-02;4;4;0;0;3;1079607;6357;1189;14;3607
FR;4;2022-04-03;0;0;0;0;0;1079607;6357;1189;14;3607
FR;4;2022-04-04;3;3;4;0;3;1079610;6360;1193;14;3610
FR;4;2022-04-05;3;4;1;1;2;1079613;6364;1194;15;3612
FR;4;2022-04-06;3;0;0;0;0;1079616;6364;1194;15;3612
FR;4;2022-04-07;3;3;1;2;4;1079619;6367;1195;17;3616
FR;4;2022-04-08;4;1;1;0;1;1079623;6368;1196;17;3617
FR;4;2022-04-09;0;0;1;1;1;1079623;6368;1197;18;3618
FR;4;2022-04-10;1;2;0;0;2;1079624;6370;1197;18;3620
FR;4;2022-04-11;3;2;4;0;4;1079627;6372;1201;18;3624
FR;4;2022-04-12;2;1;4;0;2;1079629;6373;1205;18;3626
FR;4;2022-04-13;3;6;1;0;7;1079632;6379;1206;18;3633
FR;4;2022-04-14;3;2;0;1;2;1079635;6381;1206;19;3635
FR;4;2022-04-15;2;7;1;0;8;1079637;6388;1207;19;3643
FR;4;2022-04-16;0;0;0;0;0;1079637;6388;1207;19;3643
FR;4;2022-04-17;1;0;0;0;0;1079638;6388;1207;19;3643
FR;4;2022-04-18;1;2;4;0;2;1079639;6390;1211;19;3645
FR;4;2022-04-19;2;0;1;0;0;1079641;6390;1212;19;3645
FR;4;2022-04-20;13;4;1;0;2;1079654;6394;1213;19;3647
FR;4;2022-04-21;5;0;0;0;0;1079659;6394;1213;19;3647
FR;4;2022-04-22;1;0;1;0;0;1079660;6394;1214;19;3647
FR;4;2022-04-23;1;3;2;0;5;1079661;6397;1216;19;3652
FR;4;2022-04-24;0;2;0;0;2;1079661;6399;1216;19;3654
FR;4;2022-04-25;2;4;2;0;6;1079663;6403;1218;19;3660
FR;4;2022-04-26;2;4;1;0;4;1079665;6407;1219;19;3664
FR;4;2022-04-27;4;0;0;0;0;1079669;6407;1219;19;3664
FR;4;2022-04-28;2;3;5;0;4;1079671;6410;1224;19;3668
FR;4;2022-04-29;2;2;0;0;1;1079673;6412;1224;19;3669
FR;4;2022-04-30;0;1;1;0;2;1079673;6413;1225;19;3671
FR;4;2022-05-01;0;0;0;0;0;1079673;6413;1225;19;3671
FR;4;2022-05-02;4;5;3;0;5;1079677;6418;1228;19;3676
FR;4;2022-05-03;0;3;1;0;3;1079677;6421;1229;19;3679
FR;4;2022-05-04;3;2;1;0;2;1079680;6423;1230;19;3681
FR;4;2022-05-05;2;1;1;0;1;1079682;6424;1231;19;3682
FR;4;2022-05-06;2;0;0;0;0;1079684;6424;1231;19;3682
FR;4;2022-05-07;0;0;0;0;0;1079684;6424;1231;19;3682
FR;4;2022-05-08;1;1;0;0;1;1079685;6425;1231;19;3683
FR;4;2022-05-09;2;0;0;0;0;1079687;6425;1231;19;3683
FR;4;2022-05-10;0;1;0;2;3;1079687;6426;1231;21;3686
FR;4;2022-05-11;2;0;1;0;0;1079689;6426;1232;21;3686
FR;4;2022-05-12;5;1;0;1;1;1079694;6427;1232;22;3687
FR;4;2022-05-13;0;0;1;0;1;1079694;6427;1233;22;3688
FR;4;2022-05-14;0;1;0;0;1;1079694;6428;1233;22;3689
FR;4;2022-05-15;0;0;0;0;0;1079694;6428;1233;22;3689
FR;4;2022-05-16;3;0;0;0;0;1079697;6428;1233;22;3689
FR;4;2022-05-17;2;0;0;0;0;1079699;6428;1233;22;3689
FR;4;2022-05-18;0;0;0;0;0;1079699;6428;1233;22;3689
FR;4;2022-05-19;2;1;1;0;2;1079701;6429;1234;22;3691
FR;4;2022-05-20;1;0;0;0;0;1079702;6429;1234;22;3691
FR;4;2022-05-21;2;0;0;0;0;1079704;6429;1234;22;3691
FR;4;2022-05-22;0;0;1;0;1;1079704;6429;1235;22;3692
FR;4;2022-05-23;0;0;0;0;0;1079704;6429;1235;22;3692
FR;5;2020-12-27;0;0;0;0;0;0;0;0;0;0
FR;5;2020-12-28;0;0;0;0;0;0;0;0;0;0
FR;5;2020-12-29;0;0;0;0;0;0;0;0;0;0
FR;5;2020-12-30;0;0;0;0;0;0;0;0;0;0
FR;5;2020-12-31;0;0;0;0;0;0;0;0;0;0
FR;5;2021-01-01;0;0;0;0;0;0;0;0;0;0
FR;5;2021-01-02;0;0;0;0;0;0;0;0;0;0
FR;5;2021-01-03;0;0;0;0;0;0;0;0;0;0
FR;5;2021-01-04;0;0;0;0;0;0;0;0;0;0
FR;5;2021-01-05;0;0;0;0;0;0;0;0;0;0
FR;5;2021-01-06;0;0;0;0;0;0;0;0;0;0
FR;5;2021-01-07;0;0;0;0;0;0;0;0;0;0
FR;5;2021-01-08;0;0;0;0;0;0;0;0;0;0
FR;5;2021-01-09;0;0;0;0;0;0;0;0;0;0
FR;5;2021-01-10;0;0;0;0;0;0;0;0;0;0
FR;5;2021-01-11;0;0;0;0;0;0;0;0;0;0
FR;5;2021-01-12;0;0;0;0;0;0;0;0;0;0
FR;5;2021-01-13;0;0;0;0;0;0;0;0;0;0
FR;5;2021-01-14;0;0;0;0;0;0;0;0;0;0
FR;5;2021-01-15;0;0;0;0;0;0;0;0;0;0
FR;5;2021-01-16;0;0;0;0;0;0;0;0;0;0
FR;5;2021-01-17;0;0;0;0;0;0;0;0;0;0
FR;5;2021-01-18;0;0;0;0;0;0;0;0;0;0
FR;5;2021-01-19;0;0;0;0;0;0;0;0;0;0
FR;5;2021-01-20;0;0;0;0;0;0;0;0;0;0
FR;5;2021-01-21;0;0;0;0;0;0;0;0;0;0
FR;5;2021-01-22;0;0;0;0;0;0;0;0;0;0
FR;5;2021-01-23;0;0;0;0;0;0;0;0;0;0
FR;5;2021-01-24;0;0;0;0;0;0;0;0;0;0
FR;5;2021-01-25;0;0;0;0;0;0;0;0;0;0
FR;5;2021-01-26;0;0;0;0;0;0;0;0;0;0
FR;5;2021-01-27;0;0;0;0;0;0;0;0;0;0
FR;5;2021-01-28;0;0;0;0;0;0;0;0;0;0
FR;5;2021-01-29;0;0;0;0;0;0;0;0;0;0
FR;5;2021-01-30;0;0;0;0;0;0;0;0;0;0
FR;5;2021-01-31;0;0;0;0;0;0;0;0;0;0
FR;5;2021-02-01;0;0;0;0;0;0;0;0;0;0
FR;5;2021-02-02;0;0;0;0;0;0;0;0;0;0
FR;5;2021-02-03;0;0;0;0;0;0;0;0;0;0
FR;5;2021-02-04;0;0;0;0;0;0;0;0;0;0
FR;5;2021-02-05;0;0;0;0;0;0;0;0;0;0
FR;5;2021-02-06;0;0;0;0;0;0;0;0;0;0
FR;5;2021-02-07;0;0;0;0;0;0;0;0;0;0
FR;5;2021-02-08;0;0;0;0;0;0;0;0;0;0
FR;5;2021-02-09;0;0;0;0;0;0;0;0;0;0
FR;5;2021-02-10;0;0;0;0;0;0;0;0;0;0
FR;5;2021-02-11;0;0;0;0;0;0;0;0;0;0
FR;5;2021-02-12;0;0;0;0;0;0;0;0;0;0
FR;5;2021-02-13;0;0;0;0;0;0;0;0;0;0
FR;5;2021-02-14;0;0;0;0;0;0;0;0;0;0
FR;5;2021-02-15;0;0;0;0;0;0;0;0;0;0
FR;5;2021-02-16;0;0;0;0;0;0;0;0;0;0
FR;5;2021-02-17;0;0;0;0;0;0;0;0;0;0
FR;5;2021-02-18;0;0;0;0;0;0;0;0;0;0
FR;5;2021-02-19;0;0;0;0;0;0;0;0;0;0
FR;5;2021-02-20;0;0;0;0;0;0;0;0;0;0
FR;5;2021-02-21;0;0;0;0;0;0;0;0;0;0
FR;5;2021-02-22;0;0;0;0;0;0;0;0;0;0
FR;5;2021-02-23;0;0;0;0;0;0;0;0;0;0
FR;5;2021-02-24;0;0;0;0;0;0;0;0;0;0
FR;5;2021-02-25;0;0;0;0;0;0;0;0;0;0
FR;5;2021-02-26;0;0;0;0;0;0;0;0;0;0
FR;5;2021-02-27;0;0;0;0;0;0;0;0;0;0
FR;5;2021-02-28;0;0;0;0;0;0;0;0;0;0
FR;5;2021-03-01;0;0;0;0;0;0;0;0;0;0
FR;5;2021-03-02;0;0;0;0;0;0;0;0;0;0
FR;5;2021-03-03;0;0;0;0;0;0;0;0;0;0
FR;5;2021-03-04;0;0;0;0;0;0;0;0;0;0
FR;5;2021-03-05;0;0;0;0;0;0;0;0;0;0
FR;5;2021-03-06;0;0;0;0;0;0;0;0;0;0
FR;5;2021-03-07;0;0;0;0;0;0;0;0;0;0
FR;5;2021-03-08;0;0;0;0;0;0;0;0;0;0
FR;5;2021-03-09;0;0;0;0;0;0;0;0;0;0
FR;5;2021-03-10;0;0;0;0;0;0;0;0;0;0
FR;5;2021-03-11;0;0;0;0;0;0;0;0;0;0
FR;5;2021-03-12;0;0;0;0;0;0;0;0;0;0
FR;5;2021-03-13;0;0;0;0;0;0;0;0;0;0
FR;5;2021-03-14;0;0;0;0;0;0;0;0;0;0
FR;5;2021-03-15;0;0;0;0;0;0;0;0;0;0
FR;5;2021-03-16;0;0;0;0;0;0;0;0;0;0
FR;5;2021-03-17;0;0;0;0;0;0;0;0;0;0
FR;5;2021-03-18;0;0;0;0;0;0;0;0;0;0
FR;5;2021-03-19;0;0;0;0;0;0;0;0;0;0
FR;5;2021-03-20;0;0;0;0;0;0;0;0;0;0
FR;5;2021-03-21;0;0;0;0;0;0;0;0;0;0
FR;5;2021-03-22;0;0;0;0;0;0;0;0;0;0
FR;5;2021-03-23;0;0;0;0;0;0;0;0;0;0
FR;5;2021-03-24;0;0;0;0;0;0;0;0;0;0
FR;5;2021-03-25;0;0;0;0;0;0;0;0;0;0
FR;5;2021-03-26;0;0;0;0;0;0;0;0;0;0
FR;5;2021-03-27;0;0;0;0;0;0;0;0;0;0
FR;5;2021-03-28;0;0;0;0;0;0;0;0;0;0
FR;5;2021-03-29;0;0;0;0;0;0;0;0;0;0
FR;5;2021-03-30;0;0;0;0;0;0;0;0;0;0
FR;5;2021-03-31;0;0;0;0;0;0;0;0;0;0
FR;5;2021-04-01;0;0;0;0;0;0;0;0;0;0
FR;5;2021-04-02;0;0;0;0;0;0;0;0;0;0
FR;5;2021-04-03;0;0;0;0;0;0;0;0;0;0
FR;5;2021-04-04;0;0;0;0;0;0;0;0;0;0
FR;5;2021-04-05;0;0;0;0;0;0;0;0;0;0
FR;5;2021-04-06;0;0;0;0;0;0;0;0;0;0
FR;5;2021-04-07;0;0;0;0;0;0;0;0;0;0
FR;5;2021-04-08;0;0;0;0;0;0;0;0;0;0
FR;5;2021-04-09;0;0;0;0;0;0;0;0;0;0
FR;5;2021-04-10;0;0;0;0;0;0;0;0;0;0
FR;5;2021-04-11;0;0;0;0;0;0;0;0;0;0
FR;5;2021-04-12;0;0;0;0;0;0;0;0;0;0
FR;5;2021-04-13;0;0;0;0;0;0;0;0;0;0
FR;5;2021-04-14;0;0;0;0;0;0;0;0;0;0
FR;5;2021-04-15;0;0;0;0;0;0;0;0;0;0
FR;5;2021-04-16;0;0;0;0;0;0;0;0;0;0
FR;5;2021-04-17;0;0;0;0;0;0;0;0;0;0
FR;5;2021-04-18;0;0;0;0;0;0;0;0;0;0
FR;5;2021-04-19;0;0;0;0;0;0;0;0;0;0
FR;5;2021-04-20;0;0;0;0;0;0;0;0;0;0
FR;5;2021-04-21;0;0;0;0;0;0;0;0;0;0
FR;5;2021-04-22;0;0;0;0;0;0;0;0;0;0
FR;5;2021-04-23;0;0;0;0;0;0;0;0;0;0
FR;5;2021-04-24;0;0;0;0;0;0;0;0;0;0
FR;5;2021-04-25;0;0;0;0;0;0;0;0;0;0
FR;5;2021-04-26;0;0;0;0;0;0;0;0;0;0
FR;5;2021-04-27;0;0;0;0;0;0;0;0;0;0
FR;5;2021-04-28;0;0;0;0;0;0;0;0;0;0
FR;5;2021-04-29;0;0;0;0;0;0;0;0;0;0
FR;5;2021-04-30;0;0;0;0;0;0;0;0;0;0
FR;5;2021-05-01;0;0;0;0;0;0;0;0;0;0
FR;5;2021-05-02;0;0;0;0;0;0;0;0;0;0
FR;5;2021-05-03;0;0;0;0;0;0;0;0;0;0
FR;5;2021-05-04;0;0;0;0;0;0;0;0;0;0
FR;5;2021-05-05;0;0;0;0;0;0;0;0;0;0
FR;5;2021-05-06;0;0;0;0;0;0;0;0;0;0
FR;5;2021-05-07;0;0;0;0;0;0;0;0;0;0
FR;5;2021-05-08;0;0;0;0;0;0;0;0;0;0
FR;5;2021-05-09;0;0;0;0;0;0;0;0;0;0
FR;5;2021-05-10;0;0;0;0;0;0;0;0;0;0
FR;5;2021-05-11;0;0;0;0;0;0;0;0;0;0
FR;5;2021-05-12;0;0;0;0;0;0;0;0;0;0
FR;5;2021-05-13;0;0;0;0;0;0;0;0;0;0
FR;5;2021-05-14;0;0;0;0;0;0;0;0;0;0
FR;5;2021-05-15;0;0;0;0;0;0;0;0;0;0
FR;5;2021-05-16;0;0;0;0;0;0;0;0;0;0
FR;5;2021-05-17;0;0;0;0;0;0;0;0;0;0
FR;5;2021-05-18;0;0;0;0;0;0;0;0;0;0
FR;5;2021-05-19;0;0;0;0;0;0;0;0;0;0
FR;5;2021-05-20;0;0;0;0;0;0;0;0;0;0
FR;5;2021-05-21;0;0;0;0;0;0;0;0;0;0
FR;5;2021-05-22;0;0;0;0;0;0;0;0;0;0
FR;5;2021-05-23;0;0;0;0;0;0;0;0;0;0
FR;5;2021-05-24;0;0;0;0;0;0;0;0;0;0
FR;5;2021-05-25;0;0;0;0;0;0;0;0;0;0
FR;5;2021-05-26;0;0;0;0;0;0;0;0;0;0
FR;5;2021-05-27;0;0;0;0;0;0;0;0;0;0
FR;5;2021-05-28;0;0;0;0;0;0;0;0;0;0
FR;5;2021-05-29;0;0;0;0;0;0;0;0;0;0
FR;5;2021-05-30;0;0;0;0;0;0;0;0;0;0
FR;5;2021-05-31;0;0;0;0;0;0;0;0;0;0
FR;5;2021-06-01;0;0;0;0;0;0;0;0;0;0
FR;5;2021-06-02;0;0;0;0;0;0;0;0;0;0
FR;5;2021-06-03;0;0;0;0;0;0;0;0;0;0
FR;5;2021-06-04;0;0;0;0;0;0;0;0;0;0
FR;5;2021-06-05;0;0;0;0;0;0;0;0;0;0
FR;5;2021-06-06;0;0;0;0;0;0;0;0;0;0
FR;5;2021-06-07;0;0;0;0;0;0;0;0;0;0
FR;5;2021-06-08;0;0;0;0;0;0;0;0;0;0
FR;5;2021-06-09;0;0;0;0;0;0;0;0;0;0
FR;5;2021-06-10;0;0;0;0;0;0;0;0;0;0
FR;5;2021-06-11;0;0;0;0;0;0;0;0;0;0
FR;5;2021-06-12;0;0;0;0;0;0;0;0;0;0
FR;5;2021-06-13;0;0;0;0;0;0;0;0;0;0
FR;5;2021-06-14;0;0;0;0;0;0;0;0;0;0
FR;5;2021-06-15;0;0;0;0;0;0;0;0;0;0
FR;5;2021-06-16;0;0;0;0;0;0;0;0;0;0
FR;5;2021-06-17;0;0;0;0;0;0;0;0;0;0
FR;5;2021-06-18;0;0;0;0;0;0;0;0;0;0
FR;5;2021-06-19;0;0;0;0;0;0;0;0;0;0
FR;5;2021-06-20;0;0;0;0;0;0;0;0;0;0
FR;5;2021-06-21;0;0;0;0;0;0;0;0;0;0
FR;5;2021-06-22;0;0;0;0;0;0;0;0;0;0
FR;5;2021-06-23;0;0;0;0;0;0;0;0;0;0
FR;5;2021-06-24;0;0;0;0;0;0;0;0;0;0
FR;5;2021-06-25;0;0;0;0;0;0;0;0;0;0
FR;5;2021-06-26;0;0;0;0;0;0;0;0;0;0
FR;5;2021-06-27;0;0;0;0;0;0;0;0;0;0
FR;5;2021-06-28;0;0;0;0;0;0;0;0;0;0
FR;5;2021-06-29;0;0;0;0;0;0;0;0;0;0
FR;5;2021-06-30;0;0;0;0;0;0;0;0;0;0
FR;5;2021-07-01;0;0;0;0;0;0;0;0;0;0
FR;5;2021-07-02;0;0;0;0;0;0;0;0;0;0
FR;5;2021-07-03;0;0;0;0;0;0;0;0;0;0
FR;5;2021-07-04;0;0;0;0;0;0;0;0;0;0
FR;5;2021-07-05;0;0;0;0;0;0;0;0;0;0
FR;5;2021-07-06;0;0;0;0;0;0;0;0;0;0
FR;5;2021-07-07;0;0;0;0;0;0;0;0;0;0
FR;5;2021-07-08;0;0;0;0;0;0;0;0;0;0
FR;5;2021-07-09;0;0;0;0;0;0;0;0;0;0
FR;5;2021-07-10;0;0;0;0;0;0;0;0;0;0
FR;5;2021-07-11;0;0;0;0;0;0;0;0;0;0
FR;5;2021-07-12;0;0;0;0;0;0;0;0;0;0
FR;5;2021-07-13;0;0;0;0;0;0;0;0;0;0
FR;5;2021-07-14;0;0;0;0;0;0;0;0;0;0
FR;5;2021-07-15;0;0;0;0;0;0;0;0;0;0
FR;5;2021-07-16;0;0;0;0;0;0;0;0;0;0
FR;5;2021-07-17;0;0;0;0;0;0;0;0;0;0
FR;5;2021-07-18;0;0;0;0;0;0;0;0;0;0
FR;5;2021-07-19;0;0;0;0;0;0;0;0;0;0
FR;5;2021-07-20;0;0;0;0;0;0;0;0;0;0
FR;5;2021-07-21;0;0;0;0;0;0;0;0;0;0
FR;5;2021-07-22;0;0;0;0;0;0;0;0;0;0
FR;5;2021-07-23;0;0;0;0;0;0;0;0;0;0
FR;5;2021-07-24;0;0;0;0;0;0;0;0;0;0
FR;5;2021-07-25;0;0;0;0;0;0;0;0;0;0
FR;5;2021-07-26;0;0;0;0;0;0;0;0;0;0
FR;5;2021-07-27;0;0;0;0;0;0;0;0;0;0
FR;5;2021-07-28;0;0;0;0;0;0;0;0;0;0
FR;5;2021-07-29;0;0;0;0;0;0;0;0;0;0
FR;5;2021-07-30;0;0;0;0;0;0;0;0;0;0
FR;5;2021-07-31;0;0;0;0;0;0;0;0;0;0
FR;5;2021-08-01;0;0;0;0;0;0;0;0;0;0
FR;5;2021-08-02;0;0;0;0;0;0;0;0;0;0
FR;5;2021-08-03;0;0;0;0;0;0;0;0;0;0
FR;5;2021-08-04;0;0;0;0;0;0;0;0;0;0
FR;5;2021-08-05;0;0;0;0;0;0;0;0;0;0
FR;5;2021-08-06;0;0;0;0;0;0;0;0;0;0
FR;5;2021-08-07;0;0;0;0;0;0;0;0;0;0
FR;5;2021-08-08;0;0;0;0;0;0;0;0;0;0
FR;5;2021-08-09;0;0;0;0;0;0;0;0;0;0
FR;5;2021-08-10;0;0;0;0;0;0;0;0;0;0
FR;5;2021-08-11;0;0;0;0;0;0;0;0;0;0
FR;5;2021-08-12;0;0;0;0;0;0;0;0;0;0
FR;5;2021-08-13;0;0;0;0;0;0;0;0;0;0
FR;5;2021-08-14;0;0;0;0;0;0;0;0;0;0
FR;5;2021-08-15;0;0;0;0;0;0;0;0;0;0
FR;5;2021-08-16;0;0;0;0;0;0;0;0;0;0
FR;5;2021-08-17;0;0;0;0;0;0;0;0;0;0
FR;5;2021-08-18;0;0;0;0;0;0;0;0;0;0
FR;5;2021-08-19;0;0;0;0;0;0;0;0;0;0
FR;5;2021-08-20;0;0;0;0;0;0;0;0;0;0
FR;5;2021-08-21;0;0;0;0;0;0;0;0;0;0
FR;5;2021-08-22;0;0;0;0;0;0;0;0;0;0
FR;5;2021-08-23;0;0;0;0;0;0;0;0;0;0
FR;5;2021-08-24;0;0;0;0;0;0;0;0;0;0
FR;5;2021-08-25;0;0;0;0;0;0;0;0;0;0
FR;5;2021-08-26;0;0;0;0;0;0;0;0;0;0
FR;5;2021-08-27;0;0;0;0;0;0;0;0;0;0
FR;5;2021-08-28;0;0;0;0;0;0;0;0;0;0
FR;5;2021-08-29;0;0;0;0;0;0;0;0;0;0
FR;5;2021-08-30;0;0;0;0;0;0;0;0;0;0
FR;5;2021-08-31;0;0;0;0;0;0;0;0;0;0
FR;5;2021-09-01;0;0;0;0;0;0;0;0;0;0
FR;5;2021-09-02;0;0;0;0;0;0;0;0;0;0
FR;5;2021-09-03;0;0;0;0;0;0;0;0;0;0
FR;5;2021-09-04;0;0;0;0;0;0;0;0;0;0
FR;5;2021-09-05;0;0;0;0;0;0;0;0;0;0
FR;5;2021-09-06;0;0;0;0;0;0;0;0;0;0
FR;5;2021-09-07;0;0;0;0;0;0;0;0;0;0
FR;5;2021-09-08;0;0;0;0;0;0;0;0;0;0
FR;5;2021-09-09;0;0;0;0;0;0;0;0;0;0
FR;5;2021-09-10;0;0;0;0;0;0;0;0;0;0
FR;5;2021-09-11;0;0;0;0;0;0;0;0;0;0
FR;5;2021-09-12;0;0;0;0;0;0;0;0;0;0
FR;5;2021-09-13;0;0;0;0;0;0;0;0;0;0
FR;5;2021-09-14;0;0;0;0;0;0;0;0;0;0
FR;5;2021-09-15;0;0;0;0;0;0;0;0;0;0
FR;5;2021-09-16;0;0;0;0;0;0;0;0;0;0
FR;5;2021-09-17;0;0;0;0;0;0;0;0;0;0
FR;5;2021-09-18;0;0;0;0;0;0;0;0;0;0
FR;5;2021-09-19;0;0;0;0;0;0;0;0;0;0
FR;5;2021-09-20;0;0;0;0;0;0;0;0;0;0
FR;5;2021-09-21;0;0;0;0;0;0;0;0;0;0
FR;5;2021-09-22;0;0;0;0;0;0;0;0;0;0
FR;5;2021-09-23;0;0;0;0;0;0;0;0;0;0
FR;5;2021-09-24;0;0;0;0;0;0;0;0;0;0
FR;5;2021-09-25;0;0;0;0;0;0;0;0;0;0
FR;5;2021-09-26;0;0;0;0;0;0;0;0;0;0
FR;5;2021-09-27;0;0;0;0;0;0;0;0;0;0
FR;5;2021-09-28;0;0;0;0;0;0;0;0;0;0
FR;5;2021-09-29;0;0;0;0;0;0;0;0;0;0
FR;5;2021-09-30;0;0;0;0;0;0;0;0;0;0
FR;5;2021-10-01;0;0;0;0;0;0;0;0;0;0
FR;5;2021-10-02;0;0;0;0;0;0;0;0;0;0
FR;5;2021-10-03;0;0;0;0;0;0;0;0;0;0
FR;5;2021-10-04;0;0;0;0;0;0;0;0;0;0
FR;5;2021-10-05;0;0;0;0;0;0;0;0;0;0
FR;5;2021-10-06;0;0;0;0;0;0;0;0;0;0
FR;5;2021-10-07;0;0;0;0;0;0;0;0;0;0
FR;5;2021-10-08;0;0;0;0;0;0;0;0;0;0
FR;5;2021-10-09;0;0;0;0;0;0;0;0;0;0
FR;5;2021-10-10;0;0;0;0;0;0;0;0;0;0
FR;5;2021-10-11;0;0;0;0;0;0;0;0;0;0
FR;5;2021-10-12;0;0;0;0;0;0;0;0;0;0
FR;5;2021-10-13;0;0;0;0;0;0;0;0;0;0
FR;5;2021-10-14;0;0;0;0;0;0;0;0;0;0
FR;5;2021-10-15;0;0;0;0;0;0;0;0;0;0
FR;5;2021-10-16;0;0;0;0;0;0;0;0;0;0
FR;5;2021-10-17;0;0;0;0;0;0;0;0;0;0
FR;5;2021-10-18;0;0;0;0;0;0;0;0;0;0
FR;5;2021-10-19;0;0;0;0;0;0;0;0;0;0
FR;5;2021-10-20;0;0;0;0;0;0;0;0;0;0
FR;5;2021-10-21;0;0;0;0;0;0;0;0;0;0
FR;5;2021-10-22;0;0;0;0;0;0;0;0;0;0
FR;5;2021-10-23;0;0;0;0;0;0;0;0;0;0
FR;5;2021-10-24;0;0;0;0;0;0;0;0;0;0
FR;5;2021-10-25;0;0;0;0;0;0;0;0;0;0
FR;5;2021-10-26;0;0;0;0;0;0;0;0;0;0
FR;5;2021-10-27;0;0;0;0;0;0;0;0;0;0
FR;5;2021-10-28;0;0;0;0;0;0;0;0;0;0
FR;5;2021-10-29;0;0;0;0;0;0;0;0;0;0
FR;5;2021-10-30;0;0;0;0;0;0;0;0;0;0
FR;5;2021-10-31;0;0;0;0;0;0;0;0;0;0
FR;5;2021-11-01;0;0;0;0;0;0;0;0;0;0
FR;5;2021-11-02;0;0;0;0;0;0;0;0;0;0
FR;5;2021-11-03;0;0;0;0;0;0;0;0;0;0
FR;5;2021-11-04;0;0;0;0;0;0;0;0;0;0
FR;5;2021-11-05;0;0;0;0;0;0;0;0;0;0
FR;5;2021-11-06;0;0;0;0;0;0;0;0;0;0
FR;5;2021-11-07;0;0;0;0;0;0;0;0;0;0
FR;5;2021-11-08;0;0;0;0;0;0;0;0;0;0
FR;5;2021-11-09;0;0;0;0;0;0;0;0;0;0
FR;5;2021-11-10;0;0;0;0;0;0;0;0;0;0
FR;5;2021-11-11;0;0;0;0;0;0;0;0;0;0
FR;5;2021-11-12;0;0;0;0;0;0;0;0;0;0
FR;5;2021-11-13;0;0;0;0;0;0;0;0;0;0
FR;5;2021-11-14;0;0;0;0;0;0;0;0;0;0
FR;5;2021-11-15;0;0;0;0;0;0;0;0;0;0
FR;5;2021-11-16;0;0;0;0;0;0;0;0;0;0
FR;5;2021-11-17;0;0;0;0;0;0;0;0;0;0
FR;5;2021-11-18;0;0;0;0;0;0;0;0;0;0
FR;5;2021-11-19;0;0;0;0;0;0;0;0;0;0
FR;5;2021-11-20;0;0;0;0;0;0;0;0;0;0
FR;5;2021-11-21;0;0;0;0;0;0;0;0;0;0
FR;5;2021-11-22;0;0;0;0;0;0;0;0;0;0
FR;5;2021-11-23;0;0;0;0;0;0;0;0;0;0
FR;5;2021-11-24;0;0;0;0;0;0;0;0;0;0
FR;5;2021-11-25;0;0;0;0;0;0;0;0;0;0
FR;5;2021-11-26;0;0;0;0;0;0;0;0;0;0
FR;5;2021-11-27;0;0;0;0;0;0;0;0;0;0
FR;5;2021-11-28;0;0;0;0;0;0;0;0;0;0
FR;5;2021-11-29;0;0;0;0;0;0;0;0;0;0
FR;5;2021-11-30;0;0;0;0;0;0;0;0;0;0
FR;5;2021-12-01;0;0;0;0;0;0;0;0;0;0
FR;5;2021-12-02;0;0;0;0;0;0;0;0;0;0
FR;5;2021-12-03;0;0;0;0;0;0;0;0;0;0
FR;5;2021-12-04;0;0;0;0;0;0;0;0;0;0
FR;5;2021-12-05;0;0;0;0;0;0;0;0;0;0
FR;5;2021-12-06;0;0;0;0;0;0;0;0;0;0
FR;5;2021-12-07;0;0;0;0;0;0;0;0;0;0
FR;5;2021-12-08;0;0;0;0;0;0;0;0;0;0
FR;5;2021-12-09;0;0;0;0;0;0;0;0;0;0
FR;5;2021-12-10;0;0;0;0;0;0;0;0;0;0
FR;5;2021-12-11;0;0;0;0;0;0;0;0;0;0
FR;5;2021-12-12;0;0;0;0;0;0;0;0;0;0
FR;5;2021-12-13;0;0;0;0;0;0;0;0;0;0
FR;5;2021-12-14;29;45;77;0;88;29;45;77;0;88
FR;5;2021-12-15;196;44;37;0;49;225;89;114;0;137
FR;5;2021-12-16;180;21;44;0;48;405;110;158;0;185
FR;5;2021-12-17;310;16;72;0;74;715;126;230;0;259
FR;5;2021-12-18;764;24;22;0;29;1479;150;252;0;288
FR;5;2021-12-19;586;15;15;0;17;2065;165;267;0;305
FR;5;2021-12-20;1223;31;35;0;38;3288;196;302;0;343
FR;5;2021-12-21;1535;22;54;1;60;4823;218;356;1;403
FR;5;2021-12-22;4069;40;37;0;46;8892;258;393;1;449
FR;5;2021-12-23;3042;16;21;0;25;11934;274;414;1;474
FR;5;2021-12-24;759;18;9;0;15;12693;292;423;1;489
FR;5;2021-12-25;61;5;1;0;2;12754;297;424;1;491
FR;5;2021-12-26;623;6;3;0;4;13377;303;427;1;495
FR;5;2021-12-27;4080;25;21;0;23;17457;328;448;1;518
FR;5;2021-12-28;5202;23;41;1;43;22659;351;489;2;561
FR;5;2021-12-29;8104;34;65;2;68;30763;385;554;4;629
FR;5;2021-12-30;5172;18;33;0;39;35935;403;587;4;668
FR;5;2021-12-31;1553;8;10;0;11;37488;411;597;4;679
FR;5;2022-01-01;185;2;2;0;3;37673;413;599;4;682
FR;5;2022-01-02;1489;1;1;0;1;39162;414;600;4;683
FR;5;2022-01-03;3058;36;33;0;32;42220;450;633;4;715
FR;5;2022-01-04;3034;39;33;0;42;45254;489;666;4;757
FR;5;2022-01-05;19323;203;97;1;108;64577;692;763;5;865
FR;5;2022-01-06;3742;133;122;0;142;68319;825;885;5;1007
FR;5;2022-01-07;5007;200;48;2;56;73326;1025;933;7;1063
FR;5;2022-01-08;13654;514;45;0;52;86980;1539;978;7;1115
FR;5;2022-01-09;5755;399;15;0;20;92735;1938;993;7;1135
FR;5;2022-01-10;3453;326;25;0;29;96188;2264;1018;7;1164
FR;5;2022-01-11;3668;284;38;0;41;99856;2548;1056;7;1205
FR;5;2022-01-12;22652;3003;90;0;113;122508;5551;1146;7;1318
FR;5;2022-01-13;4035;622;30;0;32;126543;6173;1176;7;1350
FR;5;2022-01-14;4843;581;44;0;51;131386;6754;1220;7;1401
FR;5;2022-01-15;14681;1746;38;3;49;146067;8500;1258;10;1450
FR;5;2022-01-16;4727;666;3;0;5;150794;9166;1261;10;1455
FR;5;2022-01-17;2293;715;26;0;29;153087;9881;1287;10;1484
FR;5;2022-01-18;2430;870;30;0;40;155517;10751;1317;10;1524
FR;5;2022-01-19;18481;6422;74;2;142;173998;17173;1391;12;1666
FR;5;2022-01-20;1920;1067;25;0;34;175918;18240;1416;12;1700
FR;5;2022-01-21;3076;1371;47;1;59;178994;19611;1463;13;1759
FR;5;2022-01-22;10722;3454;33;1;43;189716;23065;1496;14;1802
FR;5;2022-01-23;2629;1415;5;0;9;192345;24480;1501;14;1811
FR;5;2022-01-24;1159;1340;19;0;23;193504;25820;1520;14;1834
FR;5;2022-01-25;1219;1548;19;2;29;194723;27368;1539;16;1863
FR;5;2022-01-26;10751;12024;50;1;89;205474;39392;1589;17;1952
FR;5;2022-01-27;1291;1693;10;0;17;206765;41085;1599;17;1969
FR;5;2022-01-28;1695;3347;16;0;19;208460;44432;1615;17;1988
FR;5;2022-01-29;6237;8040;68;0;96;214697;52472;1683;17;2084
FR;5;2022-01-30;1509;2950;5;0;18;216206;55422;1688;17;2102
FR;5;2022-01-31;588;1773;23;0;24;216794;57195;1711;17;2126
FR;5;2022-02-01;712;1702;10;0;15;217506;58897;1721;17;2141
FR;5;2022-02-02;6957;15654;52;0;94;224463;74551;1773;17;2235
FR;5;2022-02-03;488;1690;14;0;13;224951;76241;1787;17;2248
FR;5;2022-02-04;943;3001;19;0;31;225894;79242;1806;17;2279
FR;5;2022-02-05;3532;8916;23;0;37;229426;88158;1829;17;2316
FR;5;2022-02-06;737;2397;10;0;19;230163;90555;1839;17;2335
FR;5;2022-02-07;883;1595;22;0;24;231046;92150;1861;17;2359
FR;5;2022-02-08;722;1285;18;0;20;231768;93435;1879;17;2379
FR;5;2022-02-09;4535;12876;44;0;76;236303;106311;1923;17;2455
FR;5;2022-02-10;646;1058;14;0;15;236949;107369;1937;17;2470
FR;5;2022-02-11;793;2026;16;0;21;237742;109395;1953;17;2491
FR;5;2022-02-12;2285;6811;33;0;53;240027;116206;1986;17;2544
FR;5;2022-02-13;465;1540;8;0;8;240492;117746;1994;17;2552
FR;5;2022-02-14;678;1288;10;0;13;241170;119034;2004;17;2565
FR;5;2022-02-15;482;885;9;0;14;241652;119919;2013;17;2579
FR;5;2022-02-16;2980;9123;41;1;58;244632;129042;2054;18;2637
FR;5;2022-02-17;435;805;6;0;7;245067;129847;2060;18;2644
FR;5;2022-02-18;650;1407;13;0;17;245717;131254;2073;18;2661
FR;5;2022-02-19;1371;4314;16;0;28;247088;135568;2089;18;2689
FR;5;2022-02-20;247;879;6;0;8;247335;136447;2095;18;2697
FR;5;2022-02-21;221;607;2;0;4;247556;137054;2097;18;2701
FR;5;2022-02-22;259;545;17;0;17;247815;137599;2114;18;2718
FR;5;2022-02-23;1907;6923;22;1;42;249722;144522;2136;19;2760
FR;5;2022-02-24;182;374;5;1;6;249904;144896;2141;20;2766
FR;5;2022-02-25;336;949;13;0;12;250240;145845;2154;20;2778
FR;5;2022-02-26;972;3069;10;0;14;251212;148914;2164;20;2792
FR;5;2022-02-27;147;506;0;0;3;251359;149420;2164;20;2795
FR;5;2022-02-28;161;369;1;0;1;251520;149789;2165;20;2796
FR;5;2022-03-01;128;279;6;0;7;251648;150068;2171;20;2803
FR;5;2022-03-02;1240;4150;28;3;40;252888;154218;2199;23;2843
FR;5;2022-03-03;121;250;6;0;9;253009;154468;2205;23;2852
FR;5;2022-03-04;193;488;13;0;14;253202;154956;2218;23;2866
FR;5;2022-03-05;676;1990;8;0;16;253878;156946;2226;23;2882
FR;5;2022-03-06;108;260;0;0;0;253986;157206;2226;23;2882
FR;5;2022-03-07;71;228;5;0;3;254057;157434;2231;23;2885
FR;5;2022-03-08;46;130;7;1;7;254103;157564;2238;24;2892
FR;5;2022-03-09;909;3076;24;0;36;255012;160640;2262;24;2928
FR;5;2022-03-10;82;200;8;0;11;255094;160840;2270;24;2939
FR;5;2022-03-11;147;369;13;1;15;255241;161209;2283;25;2954
FR;5;2022-03-12;758;1613;13;1;30;255999;162822;2296;26;2984
FR;5;2022-03-13;76;100;0;0;0;256075;162922;2296;26;2984
FR;5;2022-03-14;67;118;7;1;7;256142;163040;2303;27;2991
FR;5;2022-03-15;83;99;3;0;6;256225;163139;2306;27;2997
FR;5;2022-03-16;884;1822;15;3;34;257109;164961;2321;30;3031
FR;5;2022-03-17;66;123;8;4;10;257175;165084;2329;34;3041
FR;5;2022-03-18;172;318;13;4;18;257347;165402;2342;38;3059
FR;5;2022-03-19;749;1162;12;5;33;258096;166564;2354;43;3092
FR;5;2022-03-20;45;93;1;0;1;258141;166657;2355;43;3093
FR;5;2022-03-21;71;120;10;6;15;258212;166777;2365;49;3108
FR;5;2022-03-22;56;119;8;8;9;258268;166896;2373;57;3117
FR;5;2022-03-23;803;1461;14;8;36;259071;168357;2387;65;3153
FR;5;2022-03-24;68;93;8;7;7;259139;168450;2395;72;3160
FR;5;2022-03-25;222;290;14;8;18;259361;168740;2409;80;3178
FR;5;2022-03-26;706;853;12;5;26;260067;169593;2421;85;3204
FR;5;2022-03-27;74;78;0;0;3;260141;169671;2421;85;3207
FR;5;2022-03-28;81;91;1;2;3;260222;169762;2422;87;3210
FR;5;2022-03-29;71;82;10;4;12;260293;169844;2432;91;3222
FR;5;2022-03-30;820;1115;16;13;29;261113;170959;2448;104;3251
FR;5;2022-03-31;102;124;1;4;6;261215;171083;2449;108;3257
FR;5;2022-04-01;107;86;7;12;11;261322;171169;2456;120;3268
FR;5;2022-04-02;329;348;3;3;14;261651;171517;2459;123;3282
FR;5;2022-04-03;54;59;1;0;1;261705;171576;2460;123;3283
FR;5;2022-04-04;36;57;4;1;8;261741;171633;2464;124;3291
FR;5;2022-04-05;51;60;6;7;9;261792;171693;2470;131;3300
FR;5;2022-04-06;421;439;7;15;16;262213;172132;2477;146;3316
FR;5;2022-04-07;45;68;5;7;7;262258;172200;2482;153;3323
FR;5;2022-04-08;130;110;12;14;15;262388;172310;2494;167;3338
FR;5;2022-04-09;309;321;2;5;16;262697;172631;2496;172;3354
FR;5;2022-04-10;43;31;2;0;2;262740;172662;2498;172;3356
FR;5;2022-04-11;50;60;3;2;4;262790;172722;2501;174;3360
FR;5;2022-04-12;57;54;3;3;5;262847;172776;2504;177;3365
FR;5;2022-04-13;382;413;3;8;16;263229;173189;2507;185;3381
FR;5;2022-04-14;47;48;5;5;9;263276;173237;2512;190;3390
FR;5;2022-04-15;91;109;3;5;5;263367;173346;2515;195;3395
FR;5;2022-04-16;188;183;2;1;13;263555;173529;2517;196;3408
FR;5;2022-04-17;12;10;1;0;1;263567;173539;2518;196;3409
FR;5;2022-04-18;8;9;2;0;2;263575;173548;2520;196;3411
FR;5;2022-04-19;73;70;6;1;6;263648;173618;2526;197;3417
FR;5;2022-04-20;360;349;9;6;12;264008;173967;2535;203;3429
FR;5;2022-04-21;42;64;9;10;12;264050;174031;2544;213;3441
FR;5;2022-04-22;113;96;5;4;5;264163;174127;2549;217;3446
FR;5;2022-04-23;209;192;3;2;10;264372;174319;2552;219;3456
FR;5;2022-04-24;37;35;0;0;3;264409;174354;2552;219;3459
FR;5;2022-04-25;67;65;1;1;4;264476;174419;2553;220;3463
FR;5;2022-04-26;60;61;2;1;5;264536;174480;2555;221;3468
FR;5;2022-04-27;332;316;2;7;14;264868;174796;2557;228;3482
FR;5;2022-04-28;75;54;4;5;8;264943;174850;2561;233;3490
FR;5;2022-04-29;117;79;5;18;12;265060;174929;2566;251;3502
FR;5;2022-04-30;182;115;1;3;10;265242;175044;2567;254;3512
FR;5;2022-05-01;10;7;0;0;0;265252;175051;2567;254;3512
FR;5;2022-05-02;46;27;4;5;2;265298;175078;2571;259;3514
FR;5;2022-05-03;83;55;2;5;11;265381;175133;2573;264;3525
FR;5;2022-05-04;276;204;1;2;7;265657;175337;2574;266;3532
FR;5;2022-05-05;62;32;2;4;4;265719;175369;2576;270;3536
FR;5;2022-05-06;103;64;2;3;5;265822;175433;2578;273;3541
FR;5;2022-05-07;170;115;3;10;13;265992;175548;2581;283;3554
FR;5;2022-05-08;7;8;0;0;2;265999;175556;2581;283;3556
FR;5;2022-05-09;44;32;15;3;16;266043;175588;2596;286;3572
FR;5;2022-05-10;54;48;3;4;5;266097;175636;2599;290;3577
FR;5;2022-05-11;324;236;12;7;21;266421;175872;2611;297;3598
FR;5;2022-05-12;46;34;1;3;2;266467;175906;2612;300;3600
FR;5;2022-05-13;108;83;2;8;8;266575;175989;2614;308;3608
FR;5;2022-05-14;203;129;0;1;8;266778;176118;2614;309;3616
FR;5;2022-05-15;22;7;2;0;1;266800;176125;2616;309;3617
FR;5;2022-05-16;49;31;2;5;4;266849;176156;2618;314;3621
FR;5;2022-05-17;72;40;5;0;2;266921;176196;2623;314;3623
FR;5;2022-05-18;288;213;4;4;8;267209;176409;2627;318;3631
FR;5;2022-05-19;44;35;4;3;2;267253;176444;2631;321;3633
FR;5;2022-05-20;73;62;2;4;1;267326;176506;2633;325;3634
FR;5;2022-05-21;241;164;2;3;17;267567;176670;2635;328;3651
FR;5;2022-05-22;20;14;2;5;2;267587;176684;2637;333;3653
FR;5;2022-05-23;40;23;4;3;6;267627;176707;2641;336;3659
FR;6;2020-12-27;0;0;0;0;0;0;0;0;0;0
FR;6;2020-12-28;0;0;0;0;0;0;0;0;0;0
FR;6;2020-12-29;0;0;0;0;0;0;0;0;0;0
FR;6;2020-12-30;0;0;0;0;0;0;0;0;0;0
FR;6;2020-12-31;0;0;0;0;0;0;0;0;0;0
FR;6;2021-01-01;0;0;0;0;0;0;0;0;0;0
FR;6;2021-01-02;0;0;0;0;0;0;0;0;0;0
FR;6;2021-01-03;0;0;0;0;0;0;0;0;0;0
FR;6;2021-01-04;0;0;0;0;0;0;0;0;0;0
FR;6;2021-01-05;0;0;0;0;0;0;0;0;0;0
FR;6;2021-01-06;0;0;0;0;0;0;0;0;0;0
FR;6;2021-01-07;0;0;0;0;0;0;0;0;0;0
FR;6;2021-01-08;0;0;0;0;0;0;0;0;0;0
FR;6;2021-01-09;0;0;0;0;0;0;0;0;0;0
FR;6;2021-01-10;0;0;0;0;0;0;0;0;0;0
FR;6;2021-01-11;0;0;0;0;0;0;0;0;0;0
FR;6;2021-01-12;0;0;0;0;0;0;0;0;0;0
FR;6;2021-01-13;0;0;0;0;0;0;0;0;0;0
FR;6;2021-01-14;0;0;0;0;0;0;0;0;0;0
FR;6;2021-01-15;0;0;0;0;0;0;0;0;0;0
FR;6;2021-01-16;0;0;0;0;0;0;0;0;0;0
FR;6;2021-01-17;0;0;0;0;0;0;0;0;0;0
FR;6;2021-01-18;0;0;0;0;0;0;0;0;0;0
FR;6;2021-01-19;0;0;0;0;0;0;0;0;0;0
FR;6;2021-01-20;0;0;0;0;0;0;0;0;0;0
FR;6;2021-01-21;0;0;0;0;0;0;0;0;0;0
FR;6;2021-01-22;0;0;0;0;0;0;0;0;0;0
FR;6;2021-01-23;0;0;0;0;0;0;0;0;0;0
FR;6;2021-01-24;0;0;0;0;0;0;0;0;0;0
FR;6;2021-01-25;0;0;0;0;0;0;0;0;0;0
FR;6;2021-01-26;0;0;0;0;0;0;0;0;0;0
FR;6;2021-01-27;0;0;0;0;0;0;0;0;0;0
FR;6;2021-01-28;0;0;0;0;0;0;0;0;0;0
FR;6;2021-01-29;0;0;0;0;0;0;0;0;0;0
FR;6;2021-01-30;0;0;0;0;0;0;0;0;0;0
FR;6;2021-01-31;0;0;0;0;0;0;0;0;0;0
FR;6;2021-02-01;0;0;0;0;0;0;0;0;0;0
FR;6;2021-02-02;0;0;0;0;0;0;0;0;0;0
FR;6;2021-02-03;0;0;0;0;0;0;0;0;0;0
FR;6;2021-02-04;0;0;0;0;0;0;0;0;0;0
FR;6;2021-02-05;0;0;0;0;0;0;0;0;0;0
FR;6;2021-02-06;0;0;0;0;0;0;0;0;0;0
FR;6;2021-02-07;0;0;0;0;0;0;0;0;0;0
FR;6;2021-02-08;0;0;0;0;0;0;0;0;0;0
FR;6;2021-02-09;0;0;0;0;0;0;0;0;0;0
FR;6;2021-02-10;0;0;0;0;0;0;0;0;0;0
FR;6;2021-02-11;0;0;0;0;0;0;0;0;0;0
FR;6;2021-02-12;0;0;0;0;0;0;0;0;0;0
FR;6;2021-02-13;0;0;0;0;0;0;0;0;0;0
FR;6;2021-02-14;0;0;0;0;0;0;0;0;0;0
FR;6;2021-02-15;0;0;0;0;0;0;0;0;0;0
FR;6;2021-02-16;0;0;0;0;0;0;0;0;0;0
FR;6;2021-02-17;0;0;0;0;0;0;0;0;0;0
FR;6;2021-02-18;0;0;0;0;0;0;0;0;0;0
FR;6;2021-02-19;0;0;0;0;0;0;0;0;0;0
FR;6;2021-02-20;0;0;0;0;0;0;0;0;0;0
FR;6;2021-02-21;0;0;0;0;0;0;0;0;0;0
FR;6;2021-02-22;0;0;0;0;0;0;0;0;0;0
FR;6;2021-02-23;0;0;0;0;0;0;0;0;0;0
FR;6;2021-02-24;0;0;0;0;0;0;0;0;0;0
FR;6;2021-02-25;0;0;0;0;0;0;0;0;0;0
FR;6;2021-02-26;0;0;0;0;0;0;0;0;0;0
FR;6;2021-02-27;0;0;0;0;0;0;0;0;0;0
FR;6;2021-02-28;0;0;0;0;0;0;0;0;0;0
FR;6;2021-03-01;0;0;0;0;0;0;0;0;0;0
FR;6;2021-03-02;0;0;0;0;0;0;0;0;0;0
FR;6;2021-03-03;0;0;0;0;0;0;0;0;0;0
FR;6;2021-03-04;0;0;0;0;0;0;0;0;0;0
FR;6;2021-03-05;0;0;0;0;0;0;0;0;0;0
FR;6;2021-03-06;0;0;0;0;0;0;0;0;0;0
FR;6;2021-03-07;0;0;0;0;0;0;0;0;0;0
FR;6;2021-03-08;0;0;0;0;0;0;0;0;0;0
FR;6;2021-03-09;0;0;0;0;0;0;0;0;0;0
FR;6;2021-03-10;0;0;0;0;0;0;0;0;0;0
FR;6;2021-03-11;0;0;0;0;0;0;0;0;0;0
FR;6;2021-03-12;0;0;0;0;0;0;0;0;0;0
FR;6;2021-03-13;0;0;0;0;0;0;0;0;0;0
FR;6;2021-03-14;0;0;0;0;0;0;0;0;0;0
FR;6;2021-03-15;0;0;0;0;0;0;0;0;0;0
FR;6;2021-03-16;0;0;0;0;0;0;0;0;0;0
FR;6;2021-03-17;0;0;0;0;0;0;0;0;0;0
FR;6;2021-03-18;0;0;0;0;0;0;0;0;0;0
FR;6;2021-03-19;0;0;0;0;0;0;0;0;0;0
FR;6;2021-03-20;0;0;0;0;0;0;0;0;0;0
FR;6;2021-03-21;0;0;0;0;0;0;0;0;0;0
FR;6;2021-03-22;0;0;0;0;0;0;0;0;0;0
FR;6;2021-03-23;0;0;0;0;0;0;0;0;0;0
FR;6;2021-03-24;0;0;0;0;0;0;0;0;0;0
FR;6;2021-03-25;0;0;0;0;0;0;0;0;0;0
FR;6;2021-03-26;0;0;0;0;0;0;0;0;0;0
FR;6;2021-03-27;0;0;0;0;0;0;0;0;0;0
FR;6;2021-03-28;0;0;0;0;0;0;0;0;0;0
FR;6;2021-03-29;0;0;0;0;0;0;0;0;0;0
FR;6;2021-03-30;0;0;0;0;0;0;0;0;0;0
FR;6;2021-03-31;0;0;0;0;0;0;0;0;0;0
FR;6;2021-04-01;0;0;0;0;0;0;0;0;0;0
FR;6;2021-04-02;0;0;0;0;0;0;0;0;0;0
FR;6;2021-04-03;0;0;0;0;0;0;0;0;0;0
FR;6;2021-04-04;0;0;0;0;0;0;0;0;0;0
FR;6;2021-04-05;0;0;0;0;0;0;0;0;0;0
FR;6;2021-04-06;0;0;0;0;0;0;0;0;0;0
FR;6;2021-04-07;0;0;0;0;0;0;0;0;0;0
FR;6;2021-04-08;0;0;0;0;0;0;0;0;0;0
FR;6;2021-04-09;0;0;0;0;0;0;0;0;0;0
FR;6;2021-04-10;0;0;0;0;0;0;0;0;0;0
FR;6;2021-04-11;0;0;0;0;0;0;0;0;0;0
FR;6;2021-04-12;0;0;0;0;0;0;0;0;0;0
FR;6;2021-04-13;0;0;0;0;0;0;0;0;0;0
FR;6;2021-04-14;0;0;0;0;0;0;0;0;0;0
FR;6;2021-04-15;0;0;0;0;0;0;0;0;0;0
FR;6;2021-04-16;0;0;0;0;0;0;0;0;0;0
FR;6;2021-04-17;0;0;0;0;0;0;0;0;0;0
FR;6;2021-04-18;0;0;0;0;0;0;0;0;0;0
FR;6;2021-04-19;0;0;0;0;0;0;0;0;0;0
FR;6;2021-04-20;0;0;0;0;0;0;0;0;0;0
FR;6;2021-04-21;0;0;0;0;0;0;0;0;0;0
FR;6;2021-04-22;0;0;0;0;0;0;0;0;0;0
FR;6;2021-04-23;0;0;0;0;0;0;0;0;0;0
FR;6;2021-04-24;0;0;0;0;0;0;0;0;0;0
FR;6;2021-04-25;0;0;0;0;0;0;0;0;0;0
FR;6;2021-04-26;0;0;0;0;0;0;0;0;0;0
FR;6;2021-04-27;0;0;0;0;0;0;0;0;0;0
FR;6;2021-04-28;0;0;0;0;0;0;0;0;0;0
FR;6;2021-04-29;0;0;0;0;0;0;0;0;0;0
FR;6;2021-04-30;0;0;0;0;0;0;0;0;0;0
FR;6;2021-05-01;0;0;0;0;0;0;0;0;0;0
FR;6;2021-05-02;0;0;0;0;0;0;0;0;0;0
FR;6;2021-05-03;0;0;0;0;0;0;0;0;0;0
FR;6;2021-05-04;0;0;0;0;0;0;0;0;0;0
FR;6;2021-05-05;0;0;0;0;0;0;0;0;0;0
FR;6;2021-05-06;0;0;0;0;0;0;0;0;0;0
FR;6;2021-05-07;0;0;0;0;0;0;0;0;0;0
FR;6;2021-05-08;0;0;0;0;0;0;0;0;0;0
FR;6;2021-05-09;0;0;0;0;0;0;0;0;0;0
FR;6;2021-05-10;0;0;0;0;0;0;0;0;0;0
FR;6;2021-05-11;0;0;0;0;0;0;0;0;0;0
FR;6;2021-05-12;0;0;0;0;0;0;0;0;0;0
FR;6;2021-05-13;0;0;0;0;0;0;0;0;0;0
FR;6;2021-05-14;0;0;0;0;0;0;0;0;0;0
FR;6;2021-05-15;0;0;0;0;0;0;0;0;0;0
FR;6;2021-05-16;0;0;0;0;0;0;0;0;0;0
FR;6;2021-05-17;0;0;0;0;0;0;0;0;0;0
FR;6;2021-05-18;0;0;0;0;0;0;0;0;0;0
FR;6;2021-05-19;0;0;0;0;0;0;0;0;0;0
FR;6;2021-05-20;0;0;0;0;0;0;0;0;0;0
FR;6;2021-05-21;0;0;0;0;0;0;0;0;0;0
FR;6;2021-05-22;0;0;0;0;0;0;0;0;0;0
FR;6;2021-05-23;0;0;0;0;0;0;0;0;0;0
FR;6;2021-05-24;0;0;0;0;0;0;0;0;0;0
FR;6;2021-05-25;0;0;0;0;0;0;0;0;0;0
FR;6;2021-05-26;0;0;0;0;0;0;0;0;0;0
FR;6;2021-05-27;0;0;0;0;0;0;0;0;0;0
FR;6;2021-05-28;0;0;0;0;0;0;0;0;0;0
FR;6;2021-05-29;0;0;0;0;0;0;0;0;0;0
FR;6;2021-05-30;0;0;0;0;0;0;0;0;0;0
FR;6;2021-05-31;0;0;0;0;0;0;0;0;0;0
FR;6;2021-06-01;0;0;0;0;0;0;0;0;0;0
FR;6;2021-06-02;0;0;0;0;0;0;0;0;0;0
FR;6;2021-06-03;0;0;0;0;0;0;0;0;0;0
FR;6;2021-06-04;0;0;0;0;0;0;0;0;0;0
FR;6;2021-06-05;0;0;0;0;0;0;0;0;0;0
FR;6;2021-06-06;0;0;0;0;0;0;0;0;0;0
FR;6;2021-06-07;0;0;0;0;0;0;0;0;0;0
FR;6;2021-06-08;0;0;0;0;0;0;0;0;0;0
FR;6;2021-06-09;0;0;0;0;0;0;0;0;0;0
FR;6;2021-06-10;0;0;0;0;0;0;0;0;0;0
FR;6;2021-06-11;0;0;0;0;0;0;0;0;0;0
FR;6;2021-06-12;0;0;0;0;0;0;0;0;0;0
FR;6;2021-06-13;0;0;0;0;0;0;0;0;0;0
FR;6;2021-06-14;0;0;0;0;0;0;0;0;0;0
FR;6;2021-06-15;0;0;0;0;0;0;0;0;0;0
FR;6;2021-06-16;0;0;0;0;0;0;0;0;0;0
FR;6;2021-06-17;0;0;0;0;0;0;0;0;0;0
FR;6;2021-06-18;0;0;0;0;0;0;0;0;0;0
FR;6;2021-06-19;0;0;0;0;0;0;0;0;0;0
FR;6;2021-06-20;0;0;0;0;0;0;0;0;0;0
FR;6;2021-06-21;0;0;0;0;0;0;0;0;0;0
FR;6;2021-06-22;0;0;0;0;0;0;0;0;0;0
FR;6;2021-06-23;0;0;0;0;0;0;0;0;0;0
FR;6;2021-06-24;0;0;0;0;0;0;0;0;0;0
FR;6;2021-06-25;0;0;0;0;0;0;0;0;0;0
FR;6;2021-06-26;0;0;0;0;0;0;0;0;0;0
FR;6;2021-06-27;0;0;0;0;0;0;0;0;0;0
FR;6;2021-06-28;0;0;0;0;0;0;0;0;0;0
FR;6;2021-06-29;0;0;0;0;0;0;0;0;0;0
FR;6;2021-06-30;0;0;0;0;0;0;0;0;0;0
FR;6;2021-07-01;0;0;0;0;0;0;0;0;0;0
FR;6;2021-07-02;0;0;0;0;0;0;0;0;0;0
FR;6;2021-07-03;0;0;0;0;0;0;0;0;0;0
FR;6;2021-07-04;0;0;0;0;0;0;0;0;0;0
FR;6;2021-07-05;0;0;0;0;0;0;0;0;0;0
FR;6;2021-07-06;0;0;0;0;0;0;0;0;0;0
FR;6;2021-07-07;0;0;0;0;0;0;0;0;0;0
FR;6;2021-07-08;0;0;0;0;0;0;0;0;0;0
FR;6;2021-07-09;0;0;0;0;0;0;0;0;0;0
FR;6;2021-07-10;0;0;0;0;0;0;0;0;0;0
FR;6;2021-07-11;0;0;0;0;0;0;0;0;0;0
FR;6;2021-07-12;0;0;0;0;0;0;0;0;0;0
FR;6;2021-07-13;0;0;0;0;0;0;0;0;0;0
FR;6;2021-07-14;0;0;0;0;0;0;0;0;0;0
FR;6;2021-07-15;0;0;0;0;0;0;0;0;0;0
FR;6;2021-07-16;0;0;0;0;0;0;0;0;0;0
FR;6;2021-07-17;0;0;0;0;0;0;0;0;0;0
FR;6;2021-07-18;0;0;0;0;0;0;0;0;0;0
FR;6;2021-07-19;0;0;0;0;0;0;0;0;0;0
FR;6;2021-07-20;0;0;0;0;0;0;0;0;0;0
FR;6;2021-07-21;0;0;0;0;0;0;0;0;0;0
FR;6;2021-07-22;0;0;0;0;0;0;0;0;0;0
FR;6;2021-07-23;0;0;0;0;0;0;0;0;0;0
FR;6;2021-07-24;0;0;0;0;0;0;0;0;0;0
FR;6;2021-07-25;0;0;0;0;0;0;0;0;0;0
FR;6;2021-07-26;0;0;0;0;0;0;0;0;0;0
FR;6;2021-07-27;0;0;0;0;0;0;0;0;0;0
FR;6;2021-07-28;0;0;0;0;0;0;0;0;0;0
FR;6;2021-07-29;0;0;0;0;0;0;0;0;0;0
FR;6;2021-07-30;0;0;0;0;0;0;0;0;0;0
FR;6;2021-07-31;0;0;0;0;0;0;0;0;0;0
FR;6;2021-08-01;0;0;0;0;0;0;0;0;0;0
FR;6;2021-08-02;0;0;0;0;0;0;0;0;0;0
FR;6;2021-08-03;0;0;0;0;0;0;0;0;0;0
FR;6;2021-08-04;0;0;0;0;0;0;0;0;0;0
FR;6;2021-08-05;0;0;0;0;0;0;0;0;0;0
FR;6;2021-08-06;0;0;0;0;0;0;0;0;0;0
FR;6;2021-08-07;0;0;0;0;0;0;0;0;0;0
FR;6;2021-08-08;0;0;0;0;0;0;0;0;0;0
FR;6;2021-08-09;0;0;0;0;0;0;0;0;0;0
FR;6;2021-08-10;0;0;0;0;0;0;0;0;0;0
FR;6;2021-08-11;0;0;0;0;0;0;0;0;0;0
FR;6;2021-08-12;0;0;0;0;0;0;0;0;0;0
FR;6;2021-08-13;0;0;0;0;0;0;0;0;0;0
FR;6;2021-08-14;0;0;0;0;0;0;0;0;0;0
FR;6;2021-08-15;0;0;0;0;0;0;0;0;0;0
FR;6;2021-08-16;0;0;0;0;0;0;0;0;0;0
FR;6;2021-08-17;0;0;0;0;0;0;0;0;0;0
FR;6;2021-08-18;0;0;0;0;0;0;0;0;0;0
FR;6;2021-08-19;0;0;0;0;0;0;0;0;0;0
FR;6;2021-08-20;0;0;0;0;0;0;0;0;0;0
FR;6;2021-08-21;0;0;0;0;0;0;0;0;0;0
FR;6;2021-08-22;0;0;0;0;0;0;0;0;0;0
FR;6;2021-08-23;0;0;0;0;0;0;0;0;0;0
FR;6;2021-08-24;0;0;0;0;0;0;0;0;0;0
FR;6;2021-08-25;0;0;0;0;0;0;0;0;0;0
FR;6;2021-08-26;0;0;0;0;0;0;0;0;0;0
FR;6;2021-08-27;0;0;0;0;0;0;0;0;0;0
FR;6;2021-08-28;0;0;0;0;0;0;0;0;0;0
FR;6;2021-08-29;0;0;0;0;0;0;0;0;0;0
FR;6;2021-08-30;0;0;0;0;0;0;0;0;0;0
FR;6;2021-08-31;0;0;0;0;0;0;0;0;0;0
FR;6;2021-09-01;0;0;0;0;0;0;0;0;0;0
FR;6;2021-09-02;0;0;0;0;0;0;0;0;0;0
FR;6;2021-09-03;0;0;0;0;0;0;0;0;0;0
FR;6;2021-09-04;0;0;0;0;0;0;0;0;0;0
FR;6;2021-09-05;0;0;0;0;0;0;0;0;0;0
FR;6;2021-09-06;0;0;0;0;0;0;0;0;0;0
FR;6;2021-09-07;0;0;0;0;0;0;0;0;0;0
FR;6;2021-09-08;0;0;0;0;0;0;0;0;0;0
FR;6;2021-09-09;0;0;0;0;0;0;0;0;0;0
FR;6;2021-09-10;0;0;0;0;0;0;0;0;0;0
FR;6;2021-09-11;0;0;0;0;0;0;0;0;0;0
FR;6;2021-09-12;0;0;0;0;0;0;0;0;0;0
FR;6;2021-09-13;0;0;0;0;0;0;0;0;0;0
FR;6;2021-09-14;0;0;0;0;0;0;0;0;0;0
FR;6;2021-09-15;0;0;0;0;0;0;0;0;0;0
FR;6;2021-09-16;0;0;0;0;0;0;0;0;0;0
FR;6;2021-09-17;0;0;0;0;0;0;0;0;0;0
FR;6;2021-09-18;0;0;0;0;0;0;0;0;0;0
FR;6;2021-09-19;0;0;0;0;0;0;0;0;0;0
FR;6;2021-09-20;0;0;0;0;0;0;0;0;0;0
FR;6;2021-09-21;0;0;0;0;0;0;0;0;0;0
FR;6;2021-09-22;0;0;0;0;0;0;0;0;0;0
FR;6;2021-09-23;0;0;0;0;0;0;0;0;0;0
FR;6;2021-09-24;0;0;0;0;0;0;0;0;0;0
FR;6;2021-09-25;0;0;0;0;0;0;0;0;0;0
FR;6;2021-09-26;0;0;0;0;0;0;0;0;0;0
FR;6;2021-09-27;0;0;0;0;0;0;0;0;0;0
FR;6;2021-09-28;0;0;0;0;0;0;0;0;0;0
FR;6;2021-09-29;0;0;0;0;0;0;0;0;0;0
FR;6;2021-09-30;0;0;0;0;0;0;0;0;0;0
FR;6;2021-10-01;0;0;0;0;0;0;0;0;0;0
FR;6;2021-10-02;0;0;0;0;0;0;0;0;0;0
FR;6;2021-10-03;0;0;0;0;0;0;0;0;0;0
FR;6;2021-10-04;0;0;0;0;0;0;0;0;0;0
FR;6;2021-10-05;0;0;0;0;0;0;0;0;0;0
FR;6;2021-10-06;0;0;0;0;0;0;0;0;0;0
FR;6;2021-10-07;0;0;0;0;0;0;0;0;0;0
FR;6;2021-10-08;0;0;0;0;0;0;0;0;0;0
FR;6;2021-10-09;0;0;0;0;0;0;0;0;0;0
FR;6;2021-10-10;0;0;0;0;0;0;0;0;0;0
FR;6;2021-10-11;0;0;0;0;0;0;0;0;0;0
FR;6;2021-10-12;0;0;0;0;0;0;0;0;0;0
FR;6;2021-10-13;0;0;0;0;0;0;0;0;0;0
FR;6;2021-10-14;0;0;0;0;0;0;0;0;0;0
FR;6;2021-10-15;0;0;0;0;0;0;0;0;0;0
FR;6;2021-10-16;0;0;0;0;0;0;0;0;0;0
FR;6;2021-10-17;0;0;0;0;0;0;0;0;0;0
FR;6;2021-10-18;0;0;0;0;0;0;0;0;0;0
FR;6;2021-10-19;0;0;0;0;0;0;0;0;0;0
FR;6;2021-10-20;0;0;0;0;0;0;0;0;0;0
FR;6;2021-10-21;0;0;0;0;0;0;0;0;0;0
FR;6;2021-10-22;0;0;0;0;0;0;0;0;0;0
FR;6;2021-10-23;0;0;0;0;0;0;0;0;0;0
FR;6;2021-10-24;0;0;0;0;0;0;0;0;0;0
FR;6;2021-10-25;0;0;0;0;0;0;0;0;0;0
FR;6;2021-10-26;0;0;0;0;0;0;0;0;0;0
FR;6;2021-10-27;0;0;0;0;0;0;0;0;0;0
FR;6;2021-10-28;0;0;0;0;0;0;0;0;0;0
FR;6;2021-10-29;0;0;0;0;0;0;0;0;0;0
FR;6;2021-10-30;0;0;0;0;0;0;0;0;0;0
FR;6;2021-10-31;0;0;0;0;0;0;0;0;0;0
FR;6;2021-11-01;0;0;0;0;0;0;0;0;0;0
FR;6;2021-11-02;0;0;0;0;0;0;0;0;0;0
FR;6;2021-11-03;0;0;0;0;0;0;0;0;0;0
FR;6;2021-11-04;0;0;0;0;0;0;0;0;0;0
FR;6;2021-11-05;0;0;0;0;0;0;0;0;0;0
FR;6;2021-11-06;0;0;0;0;0;0;0;0;0;0
FR;6;2021-11-07;0;0;0;0;0;0;0;0;0;0
FR;6;2021-11-08;0;0;0;0;0;0;0;0;0;0
FR;6;2021-11-09;0;0;0;0;0;0;0;0;0;0
FR;6;2021-11-10;0;0;0;0;0;0;0;0;0;0
FR;6;2021-11-11;0;0;0;0;0;0;0;0;0;0
FR;6;2021-11-12;0;0;0;0;0;0;0;0;0;0
FR;6;2021-11-13;0;0;0;0;0;0;0;0;0;0
FR;6;2021-11-14;0;0;0;0;0;0;0;0;0;0
FR;6;2021-11-15;0;0;0;0;0;0;0;0;0;0
FR;6;2021-11-16;0;0;0;0;0;0;0;0;0;0
FR;6;2021-11-17;0;0;0;0;0;0;0;0;0;0
FR;6;2021-11-18;0;0;0;0;0;0;0;0;0;0
FR;6;2021-11-19;0;0;0;0;0;0;0;0;0;0
FR;6;2021-11-20;0;0;0;0;0;0;0;0;0;0
FR;6;2021-11-21;0;0;0;0;0;0;0;0;0;0
FR;6;2021-11-22;0;0;0;0;0;0;0;0;0;0
FR;6;2021-11-23;0;0;0;0;0;0;0;0;0;0
FR;6;2021-11-24;0;0;0;0;0;0;0;0;0;0
FR;6;2021-11-25;0;0;0;0;0;0;0;0;0;0
FR;6;2021-11-26;0;0;0;0;0;0;0;0;0;0
FR;6;2021-11-27;0;0;0;0;0;0;0;0;0;0
FR;6;2021-11-28;0;0;0;0;0;0;0;0;0;0
FR;6;2021-11-29;0;0;0;0;0;0;0;0;0;0
FR;6;2021-11-30;0;0;0;0;0;0;0;0;0;0
FR;6;2021-12-01;0;0;0;0;0;0;0;0;0;0
FR;6;2021-12-02;0;0;0;0;0;0;0;0;0;0
FR;6;2021-12-03;0;0;0;0;0;0;0;0;0;0
FR;6;2021-12-04;0;0;0;0;0;0;0;0;0;0
FR;6;2021-12-05;0;0;0;0;0;0;0;0;0;0
FR;6;2021-12-06;0;0;0;0;0;0;0;0;0;0
FR;6;2021-12-07;0;0;0;0;0;0;0;0;0;0
FR;6;2021-12-08;0;0;0;0;0;0;0;0;0;0
FR;6;2021-12-09;0;0;0;0;0;0;0;0;0;0
FR;6;2021-12-10;0;0;0;0;0;0;0;0;0;0
FR;6;2021-12-11;0;0;0;0;0;0;0;0;0;0
FR;6;2021-12-12;0;0;0;0;0;0;0;0;0;0
FR;6;2021-12-13;0;0;0;0;0;0;0;0;0;0
FR;6;2021-12-14;0;0;0;0;0;0;0;0;0;0
FR;6;2021-12-15;0;0;0;0;0;0;0;0;0;0
FR;6;2021-12-16;0;0;0;0;0;0;0;0;0;0
FR;6;2021-12-17;0;0;0;0;0;0;0;0;0;0
FR;6;2021-12-18;0;0;0;0;0;0;0;0;0;0
FR;6;2021-12-19;0;0;0;0;0;0;0;0;0;0
FR;6;2021-12-20;0;0;0;0;0;0;0;0;0;0
FR;6;2021-12-21;0;0;0;0;0;0;0;0;0;0
FR;6;2021-12-22;0;0;0;0;0;0;0;0;0;0
FR;6;2021-12-23;0;0;0;0;0;0;0;0;0;0
FR;6;2021-12-24;0;0;0;0;0;0;0;0;0;0
FR;6;2021-12-25;0;0;0;0;0;0;0;0;0;0
FR;6;2021-12-26;0;0;0;0;0;0;0;0;0;0
FR;6;2021-12-27;0;0;0;0;0;0;0;0;0;0
FR;6;2021-12-28;0;0;0;0;0;0;0;0;0;0
FR;6;2021-12-29;0;0;0;0;0;0;0;0;0;0
FR;6;2021-12-30;0;0;0;0;0;0;0;0;0;0
FR;6;2021-12-31;0;0;0;0;0;0;0;0;0;0
FR;6;2022-01-01;0;0;0;0;0;0;0;0;0;0
FR;6;2022-01-02;0;0;0;0;0;0;0;0;0;0
FR;6;2022-01-03;0;0;0;0;0;0;0;0;0;0
FR;6;2022-01-04;0;0;0;0;0;0;0;0;0;0
FR;6;2022-01-05;0;0;0;0;0;0;0;0;0;0
FR;6;2022-01-06;0;0;0;0;0;0;0;0;0;0
FR;6;2022-01-07;0;0;0;0;0;0;0;0;0;0
FR;6;2022-01-08;0;0;0;0;0;0;0;0;0;0
FR;6;2022-01-09;0;0;0;0;0;0;0;0;0;0
FR;6;2022-01-10;0;0;0;0;0;0;0;0;0;0
FR;6;2022-01-11;0;0;0;0;0;0;0;0;0;0
FR;6;2022-01-12;0;0;0;0;0;0;0;0;0;0
FR;6;2022-01-13;0;0;0;0;0;0;0;0;0;0
FR;6;2022-01-14;0;0;0;0;0;0;0;0;0;0
FR;6;2022-01-15;0;0;0;0;0;0;0;0;0;0
FR;6;2022-01-16;0;0;0;0;0;0;0;0;0;0
FR;6;2022-01-17;0;0;0;0;0;0;0;0;0;0
FR;6;2022-01-18;0;0;0;0;0;0;0;0;0;0
FR;6;2022-01-19;0;0;0;0;0;0;0;0;0;0
FR;6;2022-01-20;0;0;0;0;0;0;0;0;0;0
FR;6;2022-01-21;0;0;0;0;0;0;0;0;0;0
FR;6;2022-01-22;0;0;0;0;0;0;0;0;0;0
FR;6;2022-01-23;0;0;0;0;0;0;0;0;0;0
FR;6;2022-01-24;0;0;0;0;0;0;0;0;0;0
FR;6;2022-01-25;0;0;0;0;0;0;0;0;0;0
FR;6;2022-01-26;0;0;0;0;0;0;0;0;0;0
FR;6;2022-01-27;0;0;0;0;0;0;0;0;0;0
FR;6;2022-01-28;0;0;0;0;0;0;0;0;0;0
FR;6;2022-01-29;0;0;0;0;0;0;0;0;0;0
FR;6;2022-01-30;0;0;0;0;0;0;0;0;0;0
FR;6;2022-01-31;0;0;0;0;0;0;0;0;0;0
FR;6;2022-02-01;0;0;0;0;0;0;0;0;0;0
FR;6;2022-02-02;0;0;0;0;0;0;0;0;0;0
FR;6;2022-02-03;0;0;0;0;0;0;0;0;0;0
FR;6;2022-02-04;0;0;0;0;0;0;0;0;0;0
FR;6;2022-02-05;0;0;0;0;0;0;0;0;0;0
FR;6;2022-02-06;0;0;0;0;0;0;0;0;0;0
FR;6;2022-02-07;0;0;0;0;0;0;0;0;0;0
FR;6;2022-02-08;0;0;0;0;0;0;0;0;0;0
FR;6;2022-02-09;0;0;0;0;0;0;0;0;0;0
FR;6;2022-02-10;0;0;0;0;0;0;0;0;0;0
FR;6;2022-02-11;0;0;0;0;0;0;0;0;0;0
FR;6;2022-02-12;0;0;0;0;0;0;0;0;0;0
FR;6;2022-02-13;0;0;0;0;0;0;0;0;0;0
FR;6;2022-02-14;0;0;0;0;0;0;0;0;0;0
FR;6;2022-02-15;0;0;0;0;0;0;0;0;0;0
FR;6;2022-02-16;0;0;0;0;0;0;0;0;0;0
FR;6;2022-02-17;0;0;0;0;0;0;0;0;0;0
FR;6;2022-02-18;0;0;0;0;0;0;0;0;0;0
FR;6;2022-02-19;0;0;0;0;0;0;0;0;0;0
FR;6;2022-02-20;0;0;0;0;0;0;0;0;0;0
FR;6;2022-02-21;0;0;0;0;0;0;0;0;0;0
FR;6;2022-02-22;0;0;0;0;0;0;0;0;0;0
FR;6;2022-02-23;0;0;0;0;0;0;0;0;0;0
FR;6;2022-02-24;0;0;0;0;0;0;0;0;0;0
FR;6;2022-02-25;0;0;0;0;0;0;0;0;0;0
FR;6;2022-02-26;1;0;0;0;0;1;0;0;0;0
FR;6;2022-02-27;0;0;0;0;0;1;0;0;0;0
FR;6;2022-02-28;0;0;0;0;0;1;0;0;0;0
FR;6;2022-03-01;3;0;0;0;0;4;0;0;0;0
FR;6;2022-03-02;97;9;2;0;7;101;9;2;0;7
FR;6;2022-03-03;0;0;0;0;0;101;9;2;0;7
FR;6;2022-03-04;91;4;0;0;4;192;13;2;0;11
FR;6;2022-03-05;391;23;2;0;14;583;36;4;0;25
FR;6;2022-03-06;7;1;0;0;0;590;37;4;0;25
FR;6;2022-03-07;337;19;0;0;13;927;56;4;0;38
FR;6;2022-03-08;230;14;0;0;5;1157;70;4;0;43
FR;6;2022-03-09;519;29;2;0;21;1676;99;6;0;64
FR;6;2022-03-10;207;18;0;1;12;1883;117;6;1;76
FR;6;2022-03-11;328;21;6;0;21;2211;138;12;1;97
FR;6;2022-03-12;518;25;1;0;20;2729;163;13;1;117
FR;6;2022-03-13;40;2;0;0;1;2769;165;13;1;118
FR;6;2022-03-14;201;4;2;0;3;2970;169;15;1;121
FR;6;2022-03-15;112;11;2;0;9;3082;180;17;1;130
FR;6;2022-03-16;310;17;1;1;14;3392;197;18;2;144
FR;6;2022-03-17;117;6;1;2;4;3509;203;19;4;148
FR;6;2022-03-18;214;11;0;0;6;3723;214;19;4;154
FR;6;2022-03-19;307;19;2;0;9;4030;233;21;4;163
FR;6;2022-03-20;15;5;0;0;1;4045;238;21;4;164
FR;6;2022-03-21;132;23;1;0;4;4177;261;22;4;168
FR;6;2022-03-22;97;15;0;0;4;4274;276;22;4;172
FR;6;2022-03-23;226;108;3;0;14;4500;384;25;4;186
FR;6;2022-03-24;99;15;1;3;4;4599;399;26;7;190
FR;6;2022-03-25;203;141;2;1;15;4802;540;28;8;205
FR;6;2022-03-26;332;295;7;1;19;5134;835;35;9;224
FR;6;2022-03-27;32;30;1;0;1;5166;865;36;9;225
FR;6;2022-03-28;200;208;8;1;17;5366;1073;44;10;242
FR;6;2022-03-29;126;189;12;2;12;5492;1262;56;12;254
FR;6;2022-03-30;305;476;10;2;22;5797;1738;66;14;276
FR;6;2022-03-31;124;140;9;0;13;5921;1878;75;14;289
FR;6;2022-04-01;194;150;11;2;23;6115;2028;86;16;312
FR;6;2022-04-02;205;241;9;1;13;6320;2269;95;17;325
FR;6;2022-04-03;17;21;0;0;1;6337;2290;95;17;326
FR;6;2022-04-04;132;114;6;1;9;6469;2404;101;18;335
FR;6;2022-04-05;145;88;15;1;11;6614;2492;116;19;346
FR;6;2022-04-06;203;245;22;26;27;6817;2737;138;45;373
FR;6;2022-04-07;127;96;15;5;17;6944;2833;153;50;390
FR;6;2022-04-08;199;170;16;3;17;7143;3003;169;53;407
FR;6;2022-04-09;145;139;6;12;13;7288;3142;175;65;420
FR;6;2022-04-10;10;20;3;0;1;7298;3162;178;65;421
FR;6;2022-04-11;101;106;4;0;5;7399;3268;182;65;426
FR;6;2022-04-12;135;75;5;8;10;7534;3343;187;73;436
FR;6;2022-04-13;160;175;7;5;13;7694;3518;194;78;449
FR;6;2022-04-14;100;103;5;10;8;7794;3621;199;88;457
FR;6;2022-04-15;160;148;11;7;19;7954;3769;210;95;476
FR;6;2022-04-16;127;132;5;0;14;8081;3901;215;95;490
FR;6;2022-04-17;8;9;4;0;4;8089;3910;219;95;494
FR;6;2022-04-18;8;15;3;0;4;8097;3925;222;95;498
FR;6;2022-04-19;97;112;4;3;3;8194;4037;226;98;501
FR;6;2022-04-20;172;227;8;7;15;8366;4264;234;105;516
FR;6;2022-04-21;111;93;8;4;11;8477;4357;242;109;527
FR;6;2022-04-22;136;160;13;12;13;8613;4517;255;121;540
FR;6;2022-04-23;104;129;1;1;7;8717;4646;256;122;547
FR;6;2022-04-24;5;21;1;0;0;8722;4667;257;122;547
FR;6;2022-04-25;90;128;3;8;11;8812;4795;260;130;558
FR;6;2022-04-26;101;128;18;2;16;8913;4923;278;132;574
FR;6;2022-04-27;197;159;21;1;27;9110;5082;299;133;601
FR;6;2022-04-28;108;87;6;1;8;9218;5169;305;134;609
FR;6;2022-04-29;188;168;16;2;20;9406;5337;321;136;629
FR;6;2022-04-30;131;125;7;1;24;9537;5462;328;137;653
FR;6;2022-05-01;7;6;0;0;0;9544;5468;328;137;653
FR;6;2022-05-02;94;65;3;4;3;9638;5533;331;141;656
FR;6;2022-05-03;136;92;11;2;7;9774;5625;342;143;663
FR;6;2022-05-04;165;118;25;12;29;9939;5743;367;155;692
FR;6;2022-05-05;101;70;8;3;12;10040;5813;375;158;704
FR;6;2022-05-06;150;110;10;9;16;10190;5923;385;167;720
FR;6;2022-05-07;138;93;13;3;23;10328;6016;398;170;743
FR;6;2022-05-08;20;8;6;5;7;10348;6024;404;175;750
FR;6;2022-05-09;83;73;9;7;13;10431;6097;413;182;763
FR;6;2022-05-10;111;80;15;7;12;10542;6177;428;189;775
FR;6;2022-05-11;130;120;11;14;20;10672;6297;439;203;795
FR;6;2022-05-12;105;75;6;5;13;10777;6372;445;208;808
FR;6;2022-05-13;154;95;17;21;20;10931;6467;462;229;828
FR;6;2022-05-14;81;59;6;7;15;11012;6526;468;236;843
FR;6;2022-05-15;12;7;1;0;1;11024;6533;469;236;844
FR;6;2022-05-16;64;53;7;2;12;11088;6586;476;238;856
FR;6;2022-05-17;123;76;5;7;11;11211;6662;481;245;867
FR;6;2022-05-18;130;116;6;1;14;11341;6778;487;246;881
FR;6;2022-05-19;123;56;6;8;9;11464;6834;493;254;890
FR;6;2022-05-20;128;117;13;3;18;11592;6951;506;257;908
FR;6;2022-05-21;90;67;14;3;12;11682;7018;520;260;920
FR;6;2022-05-22;19;12;5;0;4;11701;7030;525;260;924
FR;6;2022-05-23;70;70;2;1;5;11771;7100;527;261;929
FR;0;2020-12-27;602;0;0;0;0;602;0;0;0;0
FR;0;2020-12-28;665;1;0;0;0;1267;1;0;0;0
FR;0;2020-12-29;373;0;0;0;0;1640;1;0;0;0
FR;0;2020-12-30;439;0;0;0;0;2079;1;0;0;0
FR;0;2020-12-31;415;0;0;0;0;2494;1;0;0;0
FR;0;2021-01-01;1135;1;0;0;0;3629;2;0;0;0
FR;0;2021-01-02;356;3;0;0;0;3985;5;0;0;0
FR;0;2021-01-03;400;0;0;0;0;4385;5;0;0;0
FR;0;2021-01-04;2087;2;0;0;0;6472;7;0;0;0
FR;0;2021-01-05;7564;3;0;0;0;14036;10;0;0;0
FR;0;2021-01-06;12414;10;0;0;0;26450;20;0;0;0
FR;0;2021-01-07;29446;9;0;0;0;55896;29;0;0;0
FR;0;2021-01-08;37121;9;0;0;0;93017;38;0;0;0
FR;0;2021-01-09;11209;4;0;0;0;104226;42;0;0;0
FR;0;2021-01-10;5996;3;0;0;0;110222;45;0;0;0
FR;0;2021-01-11;39923;17;0;0;0;150145;62;0;0;0
FR;0;2021-01-12;62120;15;0;0;0;212265;77;0;0;0
FR;0;2021-01-13;65096;28;0;0;0;277361;105;0;0;0
FR;0;2021-01-14;83123;75;0;0;0;360484;180;0;0;0
FR;0;2021-01-15;68988;29;0;0;0;429472;209;0;0;0
FR;0;2021-01-16;20208;70;0;0;0;449680;279;0;0;0
FR;0;2021-01-17;10976;46;0;0;0;460656;325;0;0;0
FR;0;2021-01-18;85879;164;0;0;0;546535;489;0;0;0
FR;0;2021-01-19;130572;171;0;0;0;677107;660;0;0;0
FR;0;2021-01-20;137524;172;0;0;0;814631;832;0;0;0
FR;0;2021-01-21;158371;168;0;0;0;973002;1000;0;0;0
FR;0;2021-01-22;121038;202;0;0;0;1094040;1202;0;0;0
FR;0;2021-01-23;38464;63;0;0;0;1132504;1265;0;0;0
FR;0;2021-01-24;9740;69;0;0;0;1142244;1334;0;0;0
FR;0;2021-01-25;78217;1263;0;0;0;1220461;2597;0;0;0
FR;0;2021-01-26;100359;3285;1;0;0;1320820;5882;1;0;0
FR;0;2021-01-27;107223;5899;0;0;0;1428043;11781;1;0;0
FR;0;2021-01-28;124324;14958;0;0;0;1552367;26739;1;0;0
FR;0;2021-01-29;92169;17696;0;0;0;1644536;44435;1;0;0
FR;0;2021-01-30;29111;4260;0;0;0;1673647;48695;1;0;0
FR;0;2021-01-31;5225;1735;0;0;0;1678872;50430;1;0;0
FR;0;2021-02-01;53103;21505;0;0;0;1731975;71935;1;0;0
FR;0;2021-02-02;72275;35657;0;0;0;1804250;107592;1;0;0
FR;0;2021-02-03;72287;37927;0;0;0;1876537;145519;1;0;0
FR;0;2021-02-04;82047;51484;0;0;0;1958584;197003;1;0;0
FR;0;2021-02-05;68215;46131;0;0;0;2026799;243134;1;0;0
FR;0;2021-02-06;23109;10757;0;0;0;2049908;253891;1;0;0
FR;0;2021-02-07;5182;5260;0;0;0;2055090;259151;1;0;0
FR;0;2021-02-08;46815;46870;0;0;0;2101905;306021;1;0;0
FR;0;2021-02-09;65990;74329;0;0;0;2167895;380350;1;0;0
FR;0;2021-02-10;70984;79205;0;0;0;2238879;459555;1;0;0
FR;0;2021-02-11;87237;101071;0;0;0;2326116;560626;1;0;0
FR;0;2021-02-12;79288;74900;0;0;0;2405404;635526;1;0;0
FR;0;2021-02-13;22351;19468;0;0;0;2427755;654994;1;0;0
FR;0;2021-02-14;5071;7195;0;0;0;2432826;662189;1;0;0
FR;0;2021-02-15;38068;76592;0;0;0;2470894;738781;1;0;0
FR;0;2021-02-16;50363;100552;0;0;0;2521257;839333;1;0;0
FR;0;2021-02-17;50498;104559;1;0;0;2571755;943892;2;0;0
FR;0;2021-02-18;69755;120311;0;0;0;2641510;1064203;2;0;0
FR;0;2021-02-19;65048;91014;1;0;0;2706558;1155217;3;0;0
FR;0;2021-02-20;18573;28573;0;0;0;2725131;1183790;3;0;0
FR;0;2021-02-21;3314;6311;0;0;0;2728445;1190101;3;0;0
FR;0;2021-02-22;37476;73139;2;0;0;2765921;1263240;5;0;0
FR;0;2021-02-23;53759;84424;1;0;0;2819680;1347664;6;0;0
FR;0;2021-02-24;59979;81741;1;0;0;2879659;1429405;7;0;0
FR;0;2021-02-25;100542;91449;1;0;0;2980201;1520854;8;0;0
FR;0;2021-02-26;113429;70744;1;0;0;3093630;1591598;9;0;0
FR;0;2021-02-27;52091;22141;0;0;0;3145721;1613739;9;0;0
FR;0;2021-02-28;6190;4283;1;0;0;3151911;1618022;10;0;0
FR;0;2021-03-01;65830;53285;1;0;0;3217741;1671307;11;0;0
FR;0;2021-03-02;101345;66568;2;0;0;3319086;1737875;13;0;0
FR;0;2021-03-03;116463;65502;0;0;0;3435549;1803377;13;0;0
FR;0;2021-03-04;163582;70186;3;0;0;3599131;1873563;16;0;0
FR;0;2021-03-05;200882;63122;3;0;0;3800013;1936685;19;0;0
FR;0;2021-03-06;207925;17732;3;0;0;4007938;1954417;22;0;0
FR;0;2021-03-07;121250;5003;1;0;0;4129188;1959420;23;0;0
FR;0;2021-03-08;107111;50380;2;0;0;4236299;2009800;25;0;0
FR;0;2021-03-09;172409;56509;2;0;0;4408708;2066309;27;0;0
FR;0;2021-03-10;178936;57132;5;0;0;4587644;2123441;32;0;0
FR;0;2021-03-11;242823;63436;2;0;0;4830467;2186877;34;0;0
FR;0;2021-03-12;294773;53400;1;0;0;5125240;2240277;35;0;0
FR;0;2021-03-13;231370;15324;1;0;0;5356610;2255601;36;0;0
FR;0;2021-03-14;63334;3294;1;0;0;5419944;2258895;37;0;0
FR;0;2021-03-15;158601;32167;3;0;0;5578545;2291062;40;0;0
FR;0;2021-03-16;141538;39147;6;0;0;5720083;2330209;46;0;0
FR;0;2021-03-17;150446;38192;4;0;0;5870529;2368401;50;0;0
FR;0;2021-03-18;167779;44539;5;0;0;6038308;2412940;55;0;0
FR;0;2021-03-19;229961;37171;2;0;0;6268269;2450111;57;0;0
FR;0;2021-03-20;166639;11595;1;0;0;6434908;2461706;58;0;0
FR;0;2021-03-21;49918;2518;1;0;0;6484826;2464224;59;0;0
FR;0;2021-03-22;169993;33974;2;0;0;6654819;2498198;61;0;0
FR;0;2021-03-23;250329;42378;1;0;0;6905148;2540576;62;0;0
FR;0;2021-03-24;256848;43712;0;0;0;7161996;2584288;62;0;0
FR;0;2021-03-25;341745;44858;5;0;0;7503741;2629146;67;0;0
FR;0;2021-03-26;358745;41852;4;1;0;7862486;2670998;71;1;0
FR;0;2021-03-27;195238;16709;1;0;0;8057724;2687707;72;1;0
FR;0;2021-03-28;59321;4003;3;0;0;8117045;2691710;75;1;0
FR;0;2021-03-29;202927;54020;4;0;0;8319972;2745730;79;1;0
FR;0;2021-03-30;285406;69641;4;0;0;8605378;2815371;83;1;0
FR;0;2021-03-31;262961;73233;4;0;0;8868339;2888604;87;1;0
FR;0;2021-04-01;315380;89181;12;0;0;9183719;2977785;99;1;0
FR;0;2021-04-02;281276;92738;7;0;0;9464995;3070523;106;1;0
FR;0;2021-04-03;141048;61919;5;0;0;9606043;3132442;111;1;0
FR;0;2021-04-04;46449;18734;2;0;0;9652492;3151176;113;1;0
FR;0;2021-04-05;63304;10807;11;0;0;9715796;3161983;124;1;0
FR;0;2021-04-06;217140;109209;17;0;0;9932936;3271192;141;1;0
FR;0;2021-04-07;260188;115400;17;0;0;10193124;3386592;158;1;0
FR;0;2021-04-08;337732;121692;14;0;0;10530856;3508284;172;1;0
FR;0;2021-04-09;410079;116299;49;0;0;10940935;3624583;221;1;0
FR;0;2021-04-10;212581;82644;15;0;0;11153516;3707227;236;1;0
FR;0;2021-04-11;56122;34435;7;0;0;11209638;3741662;243;1;0
FR;0;2021-04-12;236997;115219;45;0;0;11446635;3856881;288;1;0
FR;0;2021-04-13;309416;144511;98;1;0;11756051;4001392;386;2;0
FR;0;2021-04-14;294431;139301;213;0;0;12050482;4140693;599;2;0
FR;0;2021-04-15;337006;148362;338;0;0;12387488;4289055;937;2;0
FR;0;2021-04-16;339222;145878;352;0;0;12726710;4434933;1289;2;0
FR;0;2021-04-17;188621;90037;109;0;0;12915331;4524970;1398;2;0
FR;0;2021-04-18;51601;35371;47;0;0;12966932;4560341;1445;2;0
FR;0;2021-04-19;205639;138218;454;0;0;13172571;4698559;1899;2;0
FR;0;2021-04-20;254343;170805;568;0;0;13426914;4869364;2467;2;0
FR;0;2021-04-21;253176;169049;834;0;0;13680090;5038413;3301;2;0
FR;0;2021-04-22;287486;188690;818;0;0;13967576;5227103;4119;2;0
FR;0;2021-04-23;297928;183395;747;0;0;14265504;5410498;4866;2;0
FR;0;2021-04-24;190407;111553;251;0;0;14455911;5522051;5117;2;0
FR;0;2021-04-25;69537;38770;51;0;0;14525448;5560821;5168;2;0
FR;0;2021-04-26;220889;156224;560;0;0;14746337;5717045;5728;2;0
FR;0;2021-04-27;284544;187314;940;0;0;15030881;5904359;6668;2;0
FR;0;2021-04-28;299434;183192;1422;1;1;15330315;6087551;8090;3;1
FR;0;2021-04-29;357052;196454;1276;0;0;15687367;6284005;9366;3;1
FR;0;2021-04-30;372130;184773;1119;1;0;16059497;6468778;10485;4;1
FR;0;2021-05-01;167597;52487;178;0;0;16227094;6521265;10663;4;1
FR;0;2021-05-02;91706;37747;83;0;0;16318800;6559012;10746;4;1
FR;0;2021-05-03;288853;168464;839;0;0;16607653;6727476;11585;4;1
FR;0;2021-05-04;315588;224306;1230;0;0;16923241;6951782;12815;4;1
FR;0;2021-05-05;327093;224736;1312;0;0;17250334;7176518;14127;4;1
FR;0;2021-05-06;379419;239359;1629;0;0;17629753;7415877;15756;4;1
FR;0;2021-05-07;372678;257285;1222;0;0;18002431;7673162;16978;4;1
FR;0;2021-05-08;222134;67332;298;0;0;18224565;7740494;17276;4;1
FR;0;2021-05-09;129684;46399;243;0;0;18354249;7786893;17519;4;1
FR;0;2021-05-10;313294;228697;1232;0;0;18667543;8015590;18751;4;1
FR;0;2021-05-11;403814;257818;1563;0;0;19071357;8273408;20314;4;1
FR;0;2021-05-12;434024;233026;1542;0;0;19505381;8506434;21856;4;1
FR;0;2021-05-13;338545;56928;430;0;0;19843926;8563362;22286;4;1
FR;0;2021-05-14;454051;167245;1122;0;0;20297977;8730607;23408;4;1
FR;0;2021-05-15;374917;94030;442;0;0;20672894;8824637;23850;4;1
FR;0;2021-05-16;202718;20780;168;0;0;20875612;8845417;24018;4;1
FR;0;2021-05-17;376061;148836;1550;0;0;21251673;8994253;25568;4;1
FR;0;2021-05-18;460055;153075;1986;0;0;21711728;9147328;27554;4;1
FR;0;2021-05-19;467316;144751;2455;0;0;22179044;9292079;30009;4;1
FR;0;2021-05-20;507453;160177;2331;0;0;22686497;9452256;32340;4;1
FR;0;2021-05-21;489588;174369;1987;0;0;23176085;9626625;34327;4;1
FR;0;2021-05-22;347138;79852;668;0;0;23523223;9706477;34995;4;1
FR;0;2021-05-23;161658;14394;246;0;0;23684881;9720871;35241;4;1
FR;0;2021-05-24;263130;33176;599;0;0;23948011;9754047;35840;4;1
FR;0;2021-05-25;400141;189086;2349;1;0;24348152;9943133;38189;5;1
FR;0;2021-05-26;413359;188404;2217;0;0;24761511;10131537;40406;5;1
FR;0;2021-05-27;449694;218549;2158;0;0;25211205;10350086;42564;5;1
FR;0;2021-05-28;429442;259381;1890;0;0;25640647;10609467;44454;5;1
FR;0;2021-05-29;298942;149345;583;0;0;25939589;10758812;45037;5;1
FR;0;2021-05-30;107096;32581;163;0;0;26046685;10791393;45200;5;1
FR;0;2021-05-31;357917;203367;1465;1;1;26404602;10994760;46665;6;2
FR;0;2021-06-01;430836;251243;1959;1;1;26835438;11246003;48624;7;3
FR;0;2021-06-02;419328;230797;1978;0;0;27254766;11476800;50602;7;3
FR;0;2021-06-03;464596;258386;1819;0;0;27719362;11735186;52421;7;3
FR;0;2021-06-04;455687;304688;1729;1;1;28175049;12039874;54150;8;4
FR;0;2021-06-05;304748;188941;651;0;0;28479797;12228815;54801;8;4
FR;0;2021-06-06;133236;49134;226;0;0;28613033;12277949;55027;8;4
FR;0;2021-06-07;339003;261930;1518;0;0;28952036;12539879;56545;8;4
FR;0;2021-06-08;393561;290947;1797;0;0;29345597;12830826;58342;8;4
FR;0;2021-06-09;384661;275468;1727;0;0;29730258;13106294;60069;8;4
FR;0;2021-06-10;403956;288927;1720;1;0;30134214;13395221;61789;9;4
FR;0;2021-06-11;386464;357236;1459;0;0;30520678;13752457;63248;9;4
FR;0;2021-06-12;283203;211285;490;0;0;30803881;13963742;63738;9;4
FR;0;2021-06-13;104828;73994;204;0;0;30908709;14037736;63942;9;4
FR;0;2021-06-14;240647;355566;1425;1;0;31149356;14393302;65367;10;4
FR;0;2021-06-15;307979;385616;1564;1;0;31457335;14778918;66931;11;4
FR;0;2021-06-16;313837;357729;1415;1;0;31771172;15136647;68346;12;4
FR;0;2021-06-17;317555;372423;1422;1;0;32088727;15509070;69768;13;4
FR;0;2021-06-18;321551;442436;1332;1;0;32410278;15951506;71100;14;4
FR;0;2021-06-19;224304;273790;448;0;0;32634582;16225296;71548;14;4
FR;0;2021-06-20;74364;102593;127;0;0;32708946;16327889;71675;14;4
FR;0;2021-06-21;195567;401906;1032;1;1;32904513;16729795;72707;15;5
FR;0;2021-06-22;223001;467351;1260;10;2;33127514;17197146;73967;25;7
FR;0;2021-06-23;233866;439894;1195;1;1;33361380;17637040;75162;26;8
FR;0;2021-06-24;241726;409571;1348;0;0;33603106;18046611;76510;26;8
FR;0;2021-06-25;227463;522228;1398;0;0;33830569;18568839;77908;26;8
FR;0;2021-06-26;153192;370696;585;1;0;33983761;18939535;78493;27;8
FR;0;2021-06-27;55861;156217;168;1;0;34039622;19095752;78661;28;8
FR;0;2021-06-28;154612;452890;1167;0;0;34194234;19548642;79828;28;8
FR;0;2021-06-29;182540;506779;2124;0;0;34376774;20055421;81952;28;8
FR;0;2021-06-30;203835;482434;2009;21;2;34580609;20537855;83961;49;10
FR;0;2021-07-01;231102;457803;2221;5;1;34811711;20995658;86182;54;11
FR;0;2021-07-02;228306;520217;2119;5;3;35040017;21515875;88301;59;14
FR;0;2021-07-03;141931;368743;909;3;1;35181948;21884618;89210;62;15
FR;0;2021-07-04;56693;141254;265;0;0;35238641;22025872;89475;62;15
FR;0;2021-07-05;168215;419308;1668;8;2;35406856;22445180;91143;70;17
FR;0;2021-07-06;196551;474803;1828;45;8;35603407;22919983;92971;115;25
FR;0;2021-07-07;212929;439302;1876;24;5;35816336;23359285;94847;139;30
FR;0;2021-07-08;231438;424178;2088;20;7;36047774;23783463;96935;159;37
FR;0;2021-07-09;228339;510720;2182;4;2;36276113;24294183;99117;163;39
FR;0;2021-07-10;148531;339879;982;1;1;36424644;24634062;100099;164;40
FR;0;2021-07-11;60141;110144;282;0;0;36484785;24744206;100381;164;40
FR;0;2021-07-12;168954;478208;1756;4;0;36653739;25222414;102137;168;40
FR;0;2021-07-13;287059;527472;2045;8;2;36940798;25749886;104182;176;42
FR;0;2021-07-14;180881;157738;433;0;0;37121679;25907624;104615;176;42
FR;0;2021-07-15;346864;502493;2097;1;0;37468543;26410117;106712;177;42
FR;0;2021-07-16;379901;495981;2021;3;1;37848444;26906098;108733;180;43
FR;0;2021-07-17;259649;319817;876;1;0;38108093;27225915;109609;181;43
FR;0;2021-07-18;109665;114799;310;0;0;38217758;27340714;109919;181;43
FR;0;2021-07-19;285312;425048;1627;3;0;38503070;27765762;111546;184;43
FR;0;2021-07-20;376723;452470;1721;0;0;38879793;28218232;113267;184;43
FR;0;2021-07-21;395626;407933;1549;4;2;39275419;28626165;114816;188;45
FR;0;2021-07-22;440878;388141;1713;4;2;39716297;29014306;116529;192;47
FR;0;2021-07-23;439844;423206;1880;4;2;40156141;29437512;118409;196;49
FR;0;2021-07-24;285179;269613;803;1;0;40441320;29707125;119212;197;49
FR;0;2021-07-25;121050;80060;226;0;0;40562370;29787185;119438;197;49
FR;0;2021-07-26;347264;323237;1615;3;2;40909634;30110422;121053;200;51
FR;0;2021-07-27;463881;320303;1696;4;2;41373515;30430725;122749;204;53
FR;0;2021-07-28;459292;290028;1634;4;2;41832807;30720753;124383;208;55
FR;0;2021-07-29;489677;276932;1794;2;1;42322484;30997685;126177;210;56
FR;0;2021-07-30;461630;302901;1935;5;2;42784114;31300586;128112;215;58
FR;0;2021-07-31;285337;185068;914;1;0;43069451;31485654;129026;216;58
FR;0;2021-08-01;111935;50001;252;0;0;43181386;31535655;129278;216;58
FR;0;2021-08-02;341211;234599;1598;2;0;43522597;31770254;130876;218;58
FR;0;2021-08-03;398398;245124;1716;2;1;43920995;32015378;132592;220;59
FR;0;2021-08-04;384627;210120;1590;6;3;44305622;32225498;134182;226;62
FR;0;2021-08-05;365973;228932;1709;0;0;44671595;32454430;135891;226;62
FR;0;2021-08-06;359547;271731;1833;4;1;45031142;32726161;137724;230;63
FR;0;2021-08-07;213035;178384;755;4;3;45244177;32904545;138479;234;66
FR;0;2021-08-08;74131;63243;270;0;0;45318308;32967788;138749;234;66
FR;0;2021-08-09;258574;259548;1540;4;3;45576882;33227336;140289;238;69
FR;0;2021-08-10;306598;278045;1655;2;1;45883480;33505381;141944;240;70
FR;0;2021-08-11;279521;260303;1440;5;1;46163001;33765684;143384;245;71
FR;0;2021-08-12;271372;278621;1659;3;1;46434373;34044305;145043;248;72
FR;0;2021-08-13;252032;277897;1589;3;2;46686405;34322202;146632;251;74
FR;0;2021-08-14;145276;197349;739;0;0;46831681;34519551;147371;251;74
FR;0;2021-08-15;39301;50110;215;1;0;46870982;34569661;147586;252;74
FR;0;2021-08-16;186040;318151;1539;0;0;47057022;34887812;149125;252;74
FR;0;2021-08-17;215554;336590;1634;7;1;47272576;35224402;150759;259;75
FR;0;2021-08-18;198925;324770;1594;7;4;47471501;35549172;152353;266;79
FR;0;2021-08-19;191887;325743;1634;1;0;47663388;35874915;153987;267;79
FR;0;2021-08-20;186343;366332;1810;3;2;47849731;36241247;155797;270;81
FR;0;2021-08-21;104751;238166;704;0;0;47954482;36479413;156501;270;81
FR;0;2021-08-22;31885;87202;253;1;1;47986367;36566615;156754;271;82
FR;0;2021-08-23;140885;357277;1559;3;2;48127252;36923892;158313;274;84
FR;0;2021-08-24;162401;376910;1844;5;1;48289653;37300802;160157;279;85
FR;0;2021-08-25;151058;350877;2028;8;3;48440711;37651679;162185;287;88
FR;0;2021-08-26;142733;342874;2554;10;1;48583444;37994553;164739;297;89
FR;0;2021-08-27;148360;388131;2789;10;3;48731804;38382684;167528;307;92
FR;0;2021-08-28;90604;249563;1405;0;0;48822408;38632247;168933;307;92
FR;0;2021-08-29;27305;83331;516;1;0;48849713;38715578;169449;308;92
FR;0;2021-08-30;117320;324901;4706;6;6027;48967033;39040479;174155;314;6119
FR;0;2021-08-31;128714;334675;10177;19;11879;49095747;39375154;184332;333;17998
FR;0;2021-09-01;135742;285693;22416;7;24310;49231489;39660847;206748;340;42308
FR;0;2021-09-02;112591;247286;26507;13;28859;49344080;39908133;233255;353;71167
FR;0;2021-09-03;118188;292719;29951;23;32961;49462268;40200852;263206;376;104128
FR;0;2021-09-04;89796;217738;12583;12;14071;49552064;40418590;275789;388;118199
FR;0;2021-09-05;21336;44870;4391;2;4731;49573400;40463460;280180;390;122930
FR;0;2021-09-06;75319;180821;31944;16;34242;49648719;40644281;312124;406;157172
FR;0;2021-09-07;80074;181253;33235;40;36094;49728793;40825534;345359;446;193266
FR;0;2021-09-08;89717;206211;29653;27;32454;49818510;41031745;375012;473;225720
FR;0;2021-09-09;76654;165409;33041;26;36522;49895164;41197154;408053;499;262242
FR;0;2021-09-10;95590;203700;35717;26;40518;49990754;41400854;443770;525;302760
FR;0;2021-09-11;66730;169222;12134;19;14310;50057484;41570076;455904;544;317070
FR;0;2021-09-12;12792;32079;2766;1;3160;50070276;41602155;458670;545;320230
FR;0;2021-09-13;64366;126387;41202;32;44042;50134642;41728542;499872;577;364272
FR;0;2021-09-14;73308;129126;56344;78;62020;50207950;41857668;556216;655;426292
FR;0;2021-09-15;76405;167868;55626;58;54773;50284355;42025536;611842;713;481065
FR;0;2021-09-16;63755;114543;60027;85;60014;50348110;42140079;671869;798;541079
FR;0;2021-09-17;74963;156848;53826;70;57227;50423073;42296927;725695;868;598306
FR;0;2021-09-18;48185;139590;15594;25;17280;50471258;42436517;741289;893;615586
FR;0;2021-09-19;7866;23718;2434;1;2621;50479124;42460235;743723;894;618207
FR;0;2021-09-20;44442;93932;50024;73;50253;50523566;42554167;793747;967;668460
FR;0;2021-09-21;45806;98442;62727;76;63365;50569372;42652609;856474;1043;731825
FR;0;2021-09-22;48585;142306;55331;83;55346;50617957;42794915;911805;1126;787171
FR;0;2021-09-23;43162;92000;62350;94;63469;50661119;42886915;974155;1220;850640
FR;0;2021-09-24;52204;133245;54527;109;59088;50713323;43020160;1028682;1329;909728
FR;0;2021-09-25;35191;115504;16263;37;18253;50748514;43135664;1044945;1366;927981
FR;0;2021-09-26;5524;17816;2265;5;2329;50754038;43153480;1047210;1371;930310
FR;0;2021-09-27;33920;76982;47172;97;48125;50787958;43230462;1094382;1468;978435
FR;0;2021-09-28;36444;75259;54929;88;56459;50824402;43305721;1149311;1556;1034894
FR;0;2021-09-29;44311;100842;53321;112;54805;50868713;43406563;1202632;1668;1089699
FR;0;2021-09-30;36268;72787;57001;95;59473;50904981;43479350;1259633;1763;1149172
FR;0;2021-10-01;61515;100844;57773;108;63679;50966496;43580194;1317406;1871;1212851
FR;0;2021-10-02;39413;78335;20950;38;23316;51005909;43658529;1338356;1909;1236167
FR;0;2021-10-03;5261;10533;2523;4;2539;51011170;43669062;1340879;1913;1238706
FR;0;2021-10-04;34953;58521;52609;84;54775;51046123;43727583;1393488;1997;1293481
FR;0;2021-10-05;33555;64343;60960;135;64914;51079678;43791926;1454448;2132;1358395
FR;0;2021-10-06;42416;79223;65688;113;68213;51122094;43871149;1520136;2245;1426608
FR;0;2021-10-07;30391;62136;65374;91;68659;51152485;43933285;1585510;2336;1495267
FR;0;2021-10-08;48741;91798;77714;110;84609;51201226;44025083;1663224;2446;1579876
FR;0;2021-10-09;33621;60870;31521;36;33853;51234847;44085953;1694745;2482;1613729
FR;0;2021-10-10;4586;7433;3186;9;3483;51239433;44093386;1697931;2491;1617212
FR;0;2021-10-11;30558;49904;61018;105;64020;51269991;44143290;1758949;2596;1681232
FR;0;2021-10-12;31340;54462;70562;139;75827;51301331;44197752;1829511;2735;1757059
FR;0;2021-10-13;39979;62789;74395;135;79248;51341310;44260541;1903906;2870;1836307
FR;0;2021-10-14;30223;52871;68719;116;73752;51371533;44313412;1972625;2986;1910059
FR;0;2021-10-15;44734;75252;93209;191;102886;51416267;44388664;2065834;3177;2012945
FR;0;2021-10-16;31269;44082;36681;44;39608;51447536;44432746;2102515;3221;2052553
FR;0;2021-10-17;3827;5279;3591;2;3692;51451363;44438025;2106106;3223;2056245
FR;0;2021-10-18;28287;42469;67467;133;71332;51479650;44480494;2173573;3356;2127577
FR;0;2021-10-19;27049;44469;76375;141;81600;51506699;44524963;2249948;3497;2209177
FR;0;2021-10-20;35202;52445;96901;180;101456;51541901;44577408;2346849;3677;2310633
FR;0;2021-10-21;25929;45199;83914;112;89100;51567830;44622607;2430763;3789;2399733
FR;0;2021-10-22;38199;62355;104862;199;112476;51606029;44684962;2535625;3988;2512209
FR;0;2021-10-23;26968;41220;45433;57;48594;51632997;44726182;2581058;4045;2560803
FR;0;2021-10-24;2912;4801;3679;6;3936;51635909;44730983;2584737;4051;2564739
FR;0;2021-10-25;25973;36346;82301;144;86594;51661882;44767329;2667038;4195;2651333
FR;0;2021-10-26;23681;35086;87204;166;92311;51685563;44802415;2754242;4361;2743644
FR;0;2021-10-27;30005;46412;108958;257;114607;51715568;44848827;2863200;4618;2858251
FR;0;2021-10-28;23380;34877;88654;153;94362;51738948;44883704;2951854;4771;2952613
FR;0;2021-10-29;31503;51361;117278;204;125240;51770451;44935065;3069132;4975;3077853
FR;0;2021-10-30;20523;33105;50323;77;53354;51790974;44968170;3119455;5052;3131207
FR;0;2021-10-31;2477;3762;3584;3;3867;51793451;44971932;3123039;5055;3135074
FR;0;2021-11-01;8195;4806;3202;3;3555;51801646;44976738;3126241;5058;3138629
FR;0;2021-11-02;25277;40086;93528;157;99463;51826923;45016824;3219769;5215;3238092
FR;0;2021-11-03;29757;47907;118835;218;125774;51856680;45064731;3338604;5433;3363866
FR;0;2021-11-04;23661;37493;107495;217;114317;51880341;45102224;3446099;5650;3478183
FR;0;2021-11-05;32266;52906;141584;233;151250;51912607;45155130;3587683;5883;3629433
FR;0;2021-11-06;21478;34561;64842;123;68224;51934085;45189691;3652525;6006;3697657
FR;0;2021-11-07;2377;4241;5171;6;5582;51936462;45193932;3657696;6012;3703239
FR;0;2021-11-08;20395;37829;127108;227;134152;51956857;45231761;3784804;6239;3837391
FR;0;2021-11-09;22126;44825;161610;341;172104;51978983;45276586;3946414;6580;4009495
FR;0;2021-11-10;31364;55055;186923;446;198666;52010347;45331641;4133337;7026;4208161
FR;0;2021-11-11;4304;6729;12923;28;13922;52014651;45338370;4146260;7054;4222083
FR;0;2021-11-12;28987;55154;183706;251;197252;52043638;45393524;4329966;7305;4419335
FR;0;2021-11-13;20293;32725;80675;118;86290;52063931;45426249;4410641;7423;4505625
FR;0;2021-11-14;2331;3945;7163;6;7878;52066262;45430194;4417804;7429;4513503
FR;0;2021-11-15;20300;38794;160775;312;171441;52086562;45468988;4578579;7741;4684944
FR;0;2021-11-16;23341;44043;200304;390;214865;52109903;45513031;4778883;8131;4899809
FR;0;2021-11-17;30349;50502;199773;407;212788;52140252;45563533;4978656;8538;5112597
FR;0;2021-11-18;23344;44978;191571;468;205393;52163596;45608511;5170227;9006;5317990
FR;0;2021-11-19;33554;61425;243119;548;262060;52197150;45669936;5413346;9554;5580050
FR;0;2021-11-20;25319;36777;102114;206;109660;52222469;45706713;5515460;9760;5689710
FR;0;2021-11-21;2623;4566;9640;18;10643;52225092;45711279;5525100;9778;5700353
FR;0;2021-11-22;22740;33347;180274;470;194742;52247832;45744626;5705374;10248;5895095
FR;0;2021-11-23;25563;45749;229292;547;247721;52273395;45790375;5934666;10795;6142816
FR;0;2021-11-24;31761;53806;224732;717;243115;52305156;45844181;6159398;11512;6385931
FR;0;2021-11-25;25383;49147;255809;740;277569;52330539;45893328;6415207;12252;6663500
FR;0;2021-11-26;33202;74741;379366;863;414499;52363741;45968069;6794573;13115;7077999
FR;0;2021-11-27;23298;49687;214835;389;236556;52387039;46017756;7009408;13504;7314555
FR;0;2021-11-28;3479;10590;56724;66;63328;52390518;46028346;7066132;13570;7377883
FR;0;2021-11-29;19384;54260;341367;863;371538;52409902;46082606;7407499;14433;7749421
FR;0;2021-11-30;24725;72181;457282;984;500632;52434627;46154787;7864781;15417;8250053
FR;0;2021-12-01;26850;75986;468966;1159;511173;52461477;46230773;8333747;16576;8761226
FR;0;2021-12-02;21974;71794;526974;1279;574687;52483451;46302567;8860721;17855;9335913
FR;0;2021-12-03;25474;92528;596233;1419;650965;52508925;46395095;9456954;19274;9986878
FR;0;2021-12-04;18287;60551;336151;690;369683;52527212;46455646;9793105;19964;10356561
FR;0;2021-12-05;4142;16270;95753;157;107051;52531354;46471916;9888858;20121;10463612
FR;0;2021-12-06;22762;73233;493013;1174;539818;52554116;46545149;10381871;21295;11003430
FR;0;2021-12-07;23309;91792;645231;1769;706137;52577425;46636941;11027102;23064;11709567
FR;0;2021-12-08;25333;92428;591422;1873;647320;52602758;46729369;11618524;24937;12356887
FR;0;2021-12-09;23991;94354;662919;2179;726168;52626749;46823723;12281443;27116;13083055
FR;0;2021-12-10;27675;111128;735912;2074;805969;52654424;46934851;13017355;29190;13889024
FR;0;2021-12-11;20222;76067;435110;986;480322;52674646;47010918;13452465;30176;14369346
FR;0;2021-12-12;5624;23285;142266;262;159227;52680270;47034203;13594731;30438;14528573
FR;0;2021-12-13;21061;91325;587505;1698;649185;52701331;47125528;14182236;32136;15177758
FR;0;2021-12-14;27574;118673;765357;2648;847351;52728905;47244201;14947593;34784;16025109
FR;0;2021-12-15;28201;114569;694164;2262;768910;52757106;47358770;15641757;37046;16794019
FR;0;2021-12-16;27933;116101;763852;2555;844260;52785039;47474871;16405609;39601;17638279
FR;0;2021-12-17;31544;128825;807712;2708;891982;52816583;47603696;17213321;42309;18530261
FR;0;2021-12-18;24912;81742;469900;1178;522144;52841495;47685438;17683221;43487;19052405
FR;0;2021-12-19;8741;28854;169348;377;191143;52850236;47714292;17852569;43864;19243548
FR;0;2021-12-20;31585;97563;591314;1787;658594;52881821;47811855;18443883;45651;19902142
FR;0;2021-12-21;39213;112426;682284;2391;759460;52921034;47924281;19126167;48042;20661602
FR;0;2021-12-22;39458;99672;575636;2167;642028;52960492;48023953;19701803;50209;21303630
FR;0;2021-12-23;33742;79775;440881;1654;494321;52994234;48103728;20142684;51863;21797951
FR;0;2021-12-24;10664;26051;110972;396;126632;53004898;48129779;20253656;52259;21924583
FR;0;2021-12-25;767;3496;7570;25;9026;53005665;48133275;20261226;52284;21933609
FR;0;2021-12-26;4696;11917;52073;141;60131;53010361;48145192;20313299;52425;21993740
FR;0;2021-12-27;30372;84117;453435;1366;509084;53040733;48229309;20766734;53791;22502824
FR;0;2021-12-28;38307;99076;564061;1767;632152;53079040;48328385;21330795;55558;23134976
FR;0;2021-12-29;39842;88476;501102;1686;560914;53118882;48416861;21831897;57244;23695890
FR;0;2021-12-30;35886;75122;420952;1519;471094;53154768;48491983;22252849;58763;24166984
FR;0;2021-12-31;12034;25205;116835;406;131619;53166802;48517188;22369684;59169;24298603
FR;0;2022-01-01;1324;3201;8498;36;9928;53168126;48520389;22378182;59205;24308531
FR;0;2022-01-02;6075;13004;58389;125;66929;53174201;48533393;22436571;59330;24375460
FR;0;2022-01-03;32626;89867;494672;1593;551477;53206827;48623260;22931243;60923;24926937
FR;0;2022-01-04;40885;110889;641261;2302;714205;53247712;48734149;23572504;63225;25641142
FR;0;2022-01-05;60313;103341;569036;1984;634056;53308025;48837490;24141540;65209;26275198
FR;0;2022-01-06;43926;110173;638873;2693;711315;53351951;48947663;24780413;67902;26986513
FR;0;2022-01-07;50547;123086;710898;2806;790322;53402498;49070749;25491311;70708;27776835
FR;0;2022-01-08;44951;80332;423770;1210;472843;53447449;49151081;25915081;71918;28249678
FR;0;2022-01-09;15596;26710;128546;300;145698;53463045;49177791;26043627;72218;28395376
FR;0;2022-01-10;35012;88393;469189;1810;522172;53498057;49266184;26512816;74028;28917548
FR;0;2022-01-11;41643;100154;548126;2307;608385;53539700;49366338;27060942;76335;29525933
FR;0;2022-01-12;60148;95532;452553;1964;504227;53599848;49461870;27513495;78299;30030160
FR;0;2022-01-13;37903;92331;487231;2084;540936;53637751;49554201;28000726;80383;30571096
FR;0;2022-01-14;42384;103276;568480;2286;628953;53680135;49657477;28569206;82669;31200049
FR;0;2022-01-15;39305;65827;340080;985;377538;53719440;49723304;28909286;83654;31577587
FR;0;2022-01-16;11381;19301;87381;215;99442;53730821;49742605;28996667;83869;31677029
FR;0;2022-01-17;24600;60097;320202;1380;354131;53755421;49802702;29316869;85249;32031160
FR;0;2022-01-18;28102;68522;360996;1799;397500;53783523;49871224;29677865;87048;32428660
FR;0;2022-01-19;43042;67066;281200;1448;311043;53826565;49938290;29959065;88496;32739703
FR;0;2022-01-20;23407;59455;298895;1740;328417;53849972;49997745;30257960;90236;33068120
FR;0;2022-01-21;27988;68768;366273;2085;401119;53877960;50066513;30624233;92321;33469239
FR;0;2022-01-22;27607;47869;218756;838;241743;53905567;50114382;30842989;93159;33710982
FR;0;2022-01-23;6701;13044;48645;171;55181;53912268;50127426;30891634;93330;33766163
FR;0;2022-01-24;16194;47174;217240;1136;239311;53928462;50174600;31108874;94466;34005474
FR;0;2022-01-25;18902;54192;242972;1548;267029;53947364;50228792;31351846;96014;34272503
FR;0;2022-01-26;28107;60148;209209;1296;229339;53975471;50288940;31561055;97310;34501842
FR;0;2022-01-27;16273;45916;207564;1270;225809;53991744;50334856;31768619;98580;34727651
FR;0;2022-01-28;21497;75733;289976;1573;321451;54013241;50410589;32058595;100153;35049102
FR;0;2022-01-29;18401;52844;184081;686;204571;54031642;50463433;32242676;100839;35253673
FR;0;2022-01-30;4466;14548;39124;124;45090;54036108;50477981;32281800;100963;35298763
FR;0;2022-01-31;11220;43830;148143;738;164779;54047328;50521811;32429943;101701;35463542
FR;0;2022-02-01;12806;48135;174056;1140;191359;54060134;50569946;32603999;102841;35654901
FR;0;2022-02-02;20004;65900;171451;1033;190119;54080138;50635846;32775450;103874;35845020
FR;0;2022-02-03;10957;44136;157480;984;173293;54091095;50679982;32932930;104858;36018313
FR;0;2022-02-04;14485;66430;239171;1262;264165;54105580;50746412;33172101;106120;36282478
FR;0;2022-02-05;12782;51438;153508;522;172333;54118362;50797850;33325609;106642;36454811
FR;0;2022-02-06;2705;12244;28869;99;33825;54121067;50810094;33354478;106741;36488636
FR;0;2022-02-07;9316;46658;156813;586;176311;54130383;50856752;33511291;107327;36664947
FR;0;2022-02-08;9591;42650;166554;867;184321;54139974;50899402;33677845;108194;36849268
FR;0;2022-02-09;14156;57825;172283;868;192954;54154130;50957227;33850128;109062;37042222
FR;0;2022-02-10;8263;38335;150145;878;166571;54162393;50995562;34000273;109940;37208793
FR;0;2022-02-11;10743;55433;218433;1097;243000;54173136;51050995;34218706;111037;37451793
FR;0;2022-02-12;8344;40872;134690;461;151703;54181480;51091867;34353396;111498;37603496
FR;0;2022-02-13;1894;8578;26547;82;30903;54183374;51100445;34379943;111580;37634399
FR;0;2022-02-14;6903;35095;148311;477;166303;54190277;51135540;34528254;112057;37800702
FR;0;2022-02-15;6850;35431;146897;750;162436;54197127;51170971;34675151;112807;37963138
FR;0;2022-02-16;9286;42583;132469;716;146644;54206413;51213554;34807620;113523;38109782
FR;0;2022-02-17;5367;23695;87242;584;94757;54211780;51237249;34894862;114107;38204539
FR;0;2022-02-18;6875;33220;119589;802;129240;54218655;51270469;35014451;114909;38333779
FR;0;2022-02-19;5341;24440;70002;370;77300;54223996;51294909;35084453;115279;38411079
FR;0;2022-02-20;1135;4616;12152;38;13924;54225131;51299525;35096605;115317;38425003
FR;0;2022-02-21;4020;17757;61911;351;67134;54229151;51317282;35158516;115668;38492137
FR;0;2022-02-22;4368;18468;60781;575;64406;54233519;51335750;35219297;116243;38556543
FR;0;2022-02-23;6509;27129;66456;591;71856;54240028;51362879;35285753;116834;38628399
FR;0;2022-02-24;3744;15152;50370;518;53179;54243772;51378031;35336123;117352;38681578
FR;0;2022-02-25;5196;23535;76272;803;79994;54248968;51401566;35412395;118155;38761572
FR;0;2022-02-26;3970;17643;47388;357;51453;54252938;51419209;35459783;118512;38813025
FR;0;2022-02-27;870;2985;8021;47;8932;54253808;51422194;35467804;118559;38821957
FR;0;2022-02-28;3067;12169;40445;354;42874;54256875;51434363;35508249;118913;38864831
FR;0;2022-03-01;3121;12218;44126;433;44762;54259996;51446581;35552375;119346;38909593
FR;0;2022-03-02;5075;17448;47079;438;48985;54265071;51464029;35599454;119784;38958578
FR;0;2022-03-03;2647;8881;29826;361;29918;54267718;51472910;35629280;120145;38988496
FR;0;2022-03-04;3175;12169;40252;649;39384;54270893;51485079;35669532;120794;39027880
FR;0;2022-03-05;2918;9207;24923;309;25073;54273811;51494286;35694455;121103;39052953
FR;0;2022-03-06;509;1378;3192;42;3429;54274320;51495664;35697647;121145;39056382
FR;0;2022-03-07;1936;5465;18391;313;17651;54276256;51501129;35716038;121458;39074033
FR;0;2022-03-08;1966;5878;19401;359;17858;54278222;51507007;35735439;121817;39091891
FR;0;2022-03-09;3446;10262;22141;403;21222;54281668;51517269;35757580;122220;39113113
FR;0;2022-03-10;1709;5186;16885;341;15676;54283377;51522455;35774465;122561;39128789
FR;0;2022-03-11;2342;7288;24461;538;22222;54285719;51529743;35798926;123099;39151011
FR;0;2022-03-12;2656;6712;17148;304;16498;54288375;51536455;35816074;123403;39167509
FR;0;2022-03-13;385;779;2304;144;2253;54288760;51537234;35818378;123547;39169762
FR;0;2022-03-14;1458;4138;14930;4403;13784;54290218;51541372;35833308;127950;39183546
FR;0;2022-03-15;1593;4352;16227;7549;14330;54291811;51545724;35849535;135499;39197876
FR;0;2022-03-16;2941;7032;19354;13128;18014;54294752;51552756;35868889;148627;39215890
FR;0;2022-03-17;1369;3695;13090;10835;11930;54296121;51556451;35881979;159462;39227820
FR;0;2022-03-18;2197;5498;19937;18275;18019;54298318;51561949;35901916;177737;39245839
FR;0;2022-03-19;2274;4665;13101;9395;12398;54300592;51566614;35915017;187132;39258237
FR;0;2022-03-20;292;705;1907;1065;1915;54300884;51567319;35916924;188197;39260152
FR;0;2022-03-21;1341;3122;12688;14929;11908;54302225;51570441;35929612;203126;39272060
FR;0;2022-03-22;1460;3574;13753;20517;12508;54303685;51574015;35943365;223643;39284568
FR;0;2022-03-23;2632;6064;17637;23129;17142;54306317;51580079;35961002;246772;39301710
FR;0;2022-03-24;1354;2910;11541;17569;10612;54307671;51582989;35972543;264341;39312322
FR;0;2022-03-25;2045;4798;18483;27736;16814;54309716;51587787;35991026;292077;39329136
FR;0;2022-03-26;2215;4236;12057;12655;11496;54311931;51592023;36003083;304732;39340632
FR;0;2022-03-27;353;680;1874;1474;1908;54312284;51592703;36004957;306206;39342540
FR;0;2022-03-28;1409;2916;11053;17450;10541;54313693;51595619;36016010;323656;39353081
FR;0;2022-03-29;1419;3221;12859;27529;12003;54315112;51598840;36028869;351185;39365084
FR;0;2022-03-30;2807;5361;15600;27342;14991;54317919;51604201;36044469;378527;39380075
FR;0;2022-03-31;1589;3138;12854;24859;12184;54319508;51607339;36057323;403386;39392259
FR;0;2022-04-01;2077;4270;19975;30800;18589;54321585;51611609;36077298;434186;39410848
FR;0;2022-04-02;1490;2605;9025;10096;8683;54323075;51614214;36086323;444282;39419531
FR;0;2022-04-03;272;495;1555;1168;1570;54323347;51614709;36087878;445450;39421101
FR;0;2022-04-04;1317;2525;12157;19051;11340;54324664;51617234;36100035;464501;39432441
FR;0;2022-04-05;1577;2904;14228;33968;13070;54326241;51620138;36114263;498469;39445511
FR;0;2022-04-06;2026;3606;13409;26277;12644;54328267;51623744;36127672;524746;39458155
FR;0;2022-04-07;1419;2842;13570;33557;12773;54329686;51626586;36141242;558303;39470928
FR;0;2022-04-08;2009;4058;19106;43611;17719;54331695;51630644;36160348;601914;39488647
FR;0;2022-04-09;1341;2647;9284;13536;8834;54333036;51633291;36169632;615450;39497481
FR;0;2022-04-10;271;551;1966;1992;1971;54333307;51633842;36171598;617442;39499452
FR;0;2022-04-11;1172;2446;11798;23624;11401;54334479;51636288;36183396;641066;39510853
FR;0;2022-04-12;1559;2763;13876;40498;13244;54336038;51639051;36197272;681564;39524097
FR;0;2022-04-13;1835;3393;13274;32681;12873;54337873;51642444;36210546;714245;39536970
FR;0;2022-04-14;1429;2644;13025;35868;12843;54339302;51645088;36223571;750113;39549813
FR;0;2022-04-15;1766;3269;15465;35173;14713;54341068;51648357;36239036;785286;39564526
FR;0;2022-04-16;1025;1810;6356;8512;6209;54342093;51650167;36245392;793798;39570735
FR;0;2022-04-17;183;315;989;1154;1027;54342276;51650482;36246381;794952;39571762
FR;0;2022-04-18;142;427;2724;1033;2741;54342418;51650909;36249105;795985;39574503
FR;0;2022-04-19;1458;2888;12819;29279;12324;54343876;51653797;36261924;825264;39586827
FR;0;2022-04-20;1885;3319;13127;28650;12790;54345761;51657116;36275051;853914;39599617
FR;0;2022-04-21;1465;2706;12389;34631;12409;54347226;51659822;36287440;888545;39612026
FR;0;2022-04-22;1810;3453;16370;37338;15728;54349036;51663275;36303810;925883;39627754
FR;0;2022-04-23;1110;2030;7348;10626;7195;54350146;51665305;36311158;936509;39634949
FR;0;2022-04-24;232;439;1462;1572;1397;54350378;51665744;36312620;938081;39636346
FR;0;2022-04-25;1238;2423;10599;20797;10391;54351616;51668167;36323219;958878;39646737
FR;0;2022-04-26;1544;2935;13550;38018;12983;54353160;51671102;36336769;996896;39659720
FR;0;2022-04-27;1884;2994;11406;30378;11441;54355044;51674096;36348175;1027274;39671161
FR;0;2022-04-28;1514;2618;12366;35616;12086;54356558;51676714;36360541;1062890;39683247
FR;0;2022-04-29;1935;3403;15340;36764;14684;54358493;51680117;36375881;1099654;39697931
FR;0;2022-04-30;1173;1790;6750;9624;6566;54359666;51681907;36382631;1109278;39704497
FR;0;2022-05-01;169;292;875;951;872;54359835;51682199;36383506;1110229;39705369
FR;0;2022-05-02;1123;2076;10578;17725;10357;54360958;51684275;36394084;1127954;39715726
FR;0;2022-05-03;1699;2851;13200;33982;13045;54362657;51687126;36407284;1161936;39728771
FR;0;2022-05-04;1777;2900;11343;25014;11446;54364434;51690026;36418627;1186950;39740217
FR;0;2022-05-05;1577;2589;11985;32732;11709;54366011;51692615;36430612;1219682;39751926
FR;0;2022-05-06;2014;3460;14890;36338;14366;54368025;51696075;36445502;1256020;39766292
FR;0;2022-05-07;1155;1729;6171;9543;6174;54369180;51697804;36451673;1265563;39772466
FR;0;2022-05-08;250;368;1084;1512;1144;54369430;51698172;36452757;1267075;39773610
FR;0;2022-05-09;1209;2052;9032;19779;8918;54370639;51700224;36461789;1286854;39782528
FR;0;2022-05-10;1596;2767;12240;38013;11868;54372235;51702991;36474029;1324867;39794396
FR;0;2022-05-11;1889;2626;9909;27226;9815;54374124;51705617;36483938;1352093;39804211
FR;0;2022-05-12;1485;2441;10769;34792;10382;54375609;51708058;36494707;1386885;39814593
FR;0;2022-05-13;1885;3036;13109;37004;12717;54377494;51711094;36507816;1423889;39827310
FR;0;2022-05-14;1108;1542;5468;10637;5330;54378602;51712636;36513284;1434526;39832640
FR;0;2022-05-15;258;384;1107;1406;1199;54378860;51713020;36514391;1435932;39833839
FR;0;2022-05-16;1104;1798;7340;20206;7348;54379964;51714818;36521731;1456138;39841187
FR;0;2022-05-17;1494;2378;10336;36583;9972;54381458;51717196;36532067;1492721;39851159
FR;0;2022-05-18;1699;2383;8388;26101;8332;54383157;51719579;36540455;1518822;39859491
FR;0;2022-05-19;1341;2360;9384;33820;9266;54384498;51721939;36549839;1552642;39868757
FR;0;2022-05-20;1768;2787;11705;37825;11254;54386266;51724726;36561544;1590467;39880011
FR;0;2022-05-21;1118;1564;4937;9556;4860;54387384;51726290;36566481;1600023;39884871
FR;0;2022-05-22;213;298;940;1256;926;54387597;51726588;36567421;1601279;39885797
FR;0;2022-05-23;1005;1718;6663;18350;6525;54388602;51728306;36574084;1619629;39892322
