fra;vaccin;jour;n_dose1;n_dose2;n_cum_dose1;n_cum_dose2
FR;1;2020-12-27;20;0;20;0
FR;1;2020-12-28;70;0;90;0
FR;1;2020-12-29;108;0;198;0
FR;1;2020-12-30;123;0;321;0
FR;1;2020-12-31;85;0;406;0
FR;1;2021-01-01;71;0;477;0
FR;1;2021-01-02;88;0;565;0
FR;1;2021-01-03;92;0;657;0
FR;1;2021-01-04;1479;0;2136;0
FR;1;2021-01-05;5400;0;7536;0
FR;1;2021-01-06;11323;0;18859;0
FR;1;2021-01-07;28575;0;47434;0
FR;1;2021-01-08;36275;0;83709;0
FR;1;2021-01-09;10929;0;94638;0
FR;1;2021-01-10;5624;0;100262;0
FR;1;2021-01-11;39042;0;139304;0
FR;1;2021-01-12;60946;0;200250;0
FR;1;2021-01-13;63868;0;264118;0
FR;1;2021-01-14;79788;0;343906;0
FR;1;2021-01-15;67323;0;411229;0
FR;1;2021-01-16;19558;78;430787;78
FR;1;2021-01-17;10470;42;441257;120
FR;1;2021-01-18;81524;163;522781;283
FR;1;2021-01-19;124006;127;646787;410
FR;1;2021-01-20;130360;159;777147;569
FR;1;2021-01-21;150381;135;927528;704
FR;1;2021-01-22;113808;162;1041336;866
FR;1;2021-01-23;36108;50;1077444;916
FR;1;2021-01-24;9269;27;1086713;943
FR;1;2021-01-25;73245;1218;1159958;2161
FR;1;2021-01-26;95152;3110;1255110;5271
FR;1;2021-01-27;102259;5598;1357369;10869
FR;1;2021-01-28;118886;14362;1476255;25231
FR;1;2021-01-29;87833;17299;1564088;42530
FR;1;2021-01-30;27593;4226;1591681;46756
FR;1;2021-01-31;4873;1679;1596554;48435
FR;1;2021-02-01;48361;21135;1644915;69570
FR;1;2021-02-02;66426;34574;1711341;104144
FR;1;2021-02-03;65987;36976;1777328;141120
FR;1;2021-02-04;75900;50066;1853228;191186
FR;1;2021-02-05;62533;45341;1915761;236527
FR;1;2021-02-06;19090;10398;1934851;246925
FR;1;2021-02-07;3435;5042;1938286;251967
FR;1;2021-02-08;35857;45992;1974143;297959
FR;1;2021-02-09;49991;72442;2024134;370401
FR;1;2021-02-10;50946;76689;2075080;447090
FR;1;2021-02-11;62287;99104;2137367;546194
FR;1;2021-02-12;54942;74064;2192309;620258
FR;1;2021-02-13;15156;19274;2207465;639532
FR;1;2021-02-14;3430;7191;2210895;646723
FR;1;2021-02-15;23609;73470;2234504;720193
FR;1;2021-02-16;32145;96884;2266649;817077
FR;1;2021-02-17;34398;98581;2301047;915658
FR;1;2021-02-18;48208;113489;2349255;1029147
FR;1;2021-02-19;44493;86425;2393748;1115572
FR;1;2021-02-20;13024;26926;2406772;1142498
FR;1;2021-02-21;2119;6288;2408891;1148786
FR;1;2021-02-22;24070;69425;2432961;1218211
FR;1;2021-02-23;36712;80373;2469673;1298584
FR;1;2021-02-24;39429;77669;2509102;1376253
FR;1;2021-02-25;48986;88011;2558088;1464264
FR;1;2021-02-26;46177;67912;2604265;1532176
FR;1;2021-02-27;15241;20931;2619506;1553107
FR;1;2021-02-28;3233;4386;2622739;1557493
FR;1;2021-03-01;38788;49039;2661527;1606532
FR;1;2021-03-02;54761;61511;2716288;1668043
FR;1;2021-03-03;59652;60657;2775940;1728700
FR;1;2021-03-04;71341;64921;2847281;1793621
FR;1;2021-03-05;73298;59280;2920579;1852901
FR;1;2021-03-06;81442;16093;3002021;1868994
FR;1;2021-03-07;63004;5425;3065025;1874419
FR;1;2021-03-08;58874;42490;3123899;1916909
FR;1;2021-03-09;84469;48326;3208368;1965235
FR;1;2021-03-10;89111;48072;3297479;2013307
FR;1;2021-03-11;103404;53877;3400883;2067184
FR;1;2021-03-12;102192;45272;3503075;2112456
FR;1;2021-03-13;87721;12722;3590796;2125178
FR;1;2021-03-14;43769;3031;3634565;2128209
FR;1;2021-03-15;93849;29156;3728414;2157365
FR;1;2021-03-16;121932;34914;3850346;2192279
FR;1;2021-03-17;127541;34883;3977887;2227162
FR;1;2021-03-18;140970;39754;4118857;2266916
FR;1;2021-03-19;134332;32919;4253189;2299835
FR;1;2021-03-20;74974;10213;4328163;2310048
FR;1;2021-03-21;25777;2477;4353940;2312525
FR;1;2021-03-22;113081;31199;4467021;2343724
FR;1;2021-03-23;141086;38186;4608107;2381910
FR;1;2021-03-24;140039;38802;4748146;2420712
FR;1;2021-03-25;162923;39630;4911069;2460342
FR;1;2021-03-26;164414;37504;5075483;2497846
FR;1;2021-03-27;109961;15259;5185444;2513105
FR;1;2021-03-28;41732;3624;5227176;2516729
FR;1;2021-03-29;128455;49983;5355631;2566712
FR;1;2021-03-30;165744;63620;5521375;2630332
FR;1;2021-03-31;168987;66936;5690362;2697268
FR;1;2021-04-01;191316;79288;5881678;2776556
FR;1;2021-04-02;162378;84352;6044056;2860908
FR;1;2021-04-03;87175;58188;6131231;2919096
FR;1;2021-04-04;32331;17732;6163562;2936828
FR;1;2021-04-05;42438;10178;6206000;2947006
FR;1;2021-04-06;157801;100927;6363801;3047933
FR;1;2021-04-07;194250;108297;6558051;3156230
FR;1;2021-04-08;218835;112457;6776886;3268687
FR;1;2021-04-09;211547;107555;6988433;3376242
FR;1;2021-04-10;116118;73469;7104551;3449711
FR;1;2021-04-11;40071;30289;7144622;3480000
FR;1;2021-04-12;166531;103827;7311153;3583827
FR;1;2021-04-13;201060;128292;7512213;3712119
FR;1;2021-04-14;205530;122867;7717743;3834986
FR;1;2021-04-15;218295;126789;7936038;3961775
FR;1;2021-04-16;203504;125218;8139542;4086993
FR;1;2021-04-17;120979;67492;8260521;4154485
FR;1;2021-04-18;35222;20994;8295743;4175479
FR;1;2021-04-19;161768;121967;8457511;4297446
FR;1;2021-04-20;187240;148828;8644751;4446274
FR;1;2021-04-21;191828;146791;8836579;4593065
FR;1;2021-04-22;206314;162679;9042893;4755744
FR;1;2021-04-23;196461;156991;9239354;4912735
FR;1;2021-04-24;125141;95526;9364495;5008261
FR;1;2021-04-25;52993;30141;9417488;5038402
FR;1;2021-04-26;179646;138312;9597134;5176714
FR;1;2021-04-27;227052;162017;9824186;5338731
FR;1;2021-04-28;256902;155174;10081088;5493905
FR;1;2021-04-29;274914;160138;10356002;5654043
FR;1;2021-04-30;277899;148229;10633901;5802272
FR;1;2021-05-01;142661;40719;10776562;5842991
FR;1;2021-05-02;80403;28162;10856965;5871153
FR;1;2021-05-03;246623;146578;11103588;6017731
FR;1;2021-05-04;261940;186920;11365528;6204651
FR;1;2021-05-05;278733;184653;11644261;6389304
FR;1;2021-05-06;304722;183165;11948983;6572469
FR;1;2021-05-07;280014;195825;12228997;6768294
FR;1;2021-05-08;181123;48362;12410120;6816656
FR;1;2021-05-09;112513;36236;12522633;6852892
FR;1;2021-05-10;250953;194380;12773586;7047272
FR;1;2021-05-11;314698;211511;13088284;7258783
FR;1;2021-05-12;349881;185996;13438165;7444779
FR;1;2021-05-13;277959;47685;13716124;7492464
FR;1;2021-05-14;364884;128970;14081008;7621434
FR;1;2021-05-15;292176;66182;14373184;7687616
FR;1;2021-05-16;155274;15589;14528458;7703205
FR;1;2021-05-17;313061;116827;14841519;7820032
FR;1;2021-05-18;372583;111489;15214102;7931521
FR;1;2021-05-19;387902;103057;15602004;8034578
FR;1;2021-05-20;412385;96498;16014389;8131076
FR;1;2021-05-21;392305;97569;16406694;8228645
FR;1;2021-05-22;271602;42194;16678296;8270839
FR;1;2021-05-23;121131;11248;16799427;8282087
FR;1;2021-05-24;239051;26384;17038478;8308471
FR;1;2021-05-25;358625;132159;17397103;8440630
FR;1;2021-05-26;369586;125968;17766689;8566598
FR;1;2021-05-27;398386;128704;18165075;8695302
FR;1;2021-05-28;358492;145868;18523567;8841170
FR;1;2021-05-29;250559;81108;18774126;8922278
FR;1;2021-05-30;99125;22623;18873251;8944901
FR;1;2021-05-31;309290;148985;19182541;9093886
FR;1;2021-06-01;345851;167124;19528392;9261010
FR;1;2021-06-02;347656;154045;19876048;9415055
FR;1;2021-06-03;378188;148472;20254236;9563527
FR;1;2021-06-04;350688;176223;20604924;9739750
FR;1;2021-06-05;252465;112929;20857389;9852679
FR;1;2021-06-06;123063;37582;20980452;9890261
FR;1;2021-06-07;289617;208907;21270069;10099168
FR;1;2021-06-08;406233;191441;21676302;10290609
FR;1;2021-06-09;443399;212965;22119701;10503574
FR;1;2021-06-10;321151;202531;22440852;10706105
FR;2;2020-12-27;0;0;0;0
FR;2;2020-12-28;0;0;0;0
FR;2;2020-12-29;0;0;0;0
FR;2;2020-12-30;0;0;0;0
FR;2;2020-12-31;0;0;0;0
FR;2;2021-01-01;0;0;0;0
FR;2;2021-01-02;0;0;0;0
FR;2;2021-01-03;0;0;0;0
FR;2;2021-01-04;0;0;0;0
FR;2;2021-01-05;0;0;0;0
FR;2;2021-01-06;0;0;0;0
FR;2;2021-01-07;0;0;0;0
FR;2;2021-01-08;0;0;0;0
FR;2;2021-01-09;0;0;0;0
FR;2;2021-01-10;0;0;0;0
FR;2;2021-01-11;0;0;0;0
FR;2;2021-01-12;0;0;0;0
FR;2;2021-01-13;0;0;0;0
FR;2;2021-01-14;152;0;152;0
FR;2;2021-01-15;218;0;370;0
FR;2;2021-01-16;185;0;555;0
FR;2;2021-01-17;3;0;558;0
FR;2;2021-01-18;2913;0;3471;0
FR;2;2021-01-19;4513;0;7984;0
FR;2;2021-01-20;4921;0;12905;0
FR;2;2021-01-21;5126;0;18031;0
FR;2;2021-01-22;4881;0;22912;0
FR;2;2021-01-23;1735;0;24647;0
FR;2;2021-01-24;102;0;24749;0
FR;2;2021-01-25;3635;0;28384;0
FR;2;2021-01-26;3749;0;32133;0
FR;2;2021-01-27;3440;0;35573;0
FR;2;2021-01-28;3514;0;39087;0
FR;2;2021-01-29;3082;0;42169;0
FR;2;2021-01-30;1064;0;43233;0
FR;2;2021-01-31;0;0;43233;0
FR;2;2021-02-01;3259;0;46492;0
FR;2;2021-02-02;4306;0;50798;0
FR;2;2021-02-03;5031;0;55829;0
FR;2;2021-02-04;4735;3;60564;3
FR;2;2021-02-05;4622;6;65186;9
FR;2;2021-02-06;1930;3;67116;12
FR;2;2021-02-07;42;0;67158;12
FR;2;2021-02-08;7429;8;74587;20
FR;2;2021-02-09;8258;15;82845;35
FR;2;2021-02-10;9138;49;91983;84
FR;2;2021-02-11;10055;67;102038;151
FR;2;2021-02-12;9815;238;111853;389
FR;2;2021-02-13;3016;222;114869;611
FR;2;2021-02-14;296;0;115165;611
FR;2;2021-02-15;3358;3067;118523;3678
FR;2;2021-02-16;4908;3883;123431;7561
FR;2;2021-02-17;4104;4403;127535;11964
FR;2;2021-02-18;5237;5089;132772;17053
FR;2;2021-02-19;5214;4323;137986;21376
FR;2;2021-02-20;1764;1509;139750;22885
FR;2;2021-02-21;197;86;139947;22971
FR;2;2021-02-22;3515;3723;143462;26694
FR;2;2021-02-23;4836;3693;148298;30387
FR;2;2021-02-24;4763;3468;153061;33855
FR;2;2021-02-25;5293;3427;158354;37282
FR;2;2021-02-26;4197;3125;162551;40407
FR;2;2021-02-27;1502;1042;164053;41449
FR;2;2021-02-28;99;28;164152;41477
FR;2;2021-03-01;4961;3764;169113;45241
FR;2;2021-03-02;6308;4728;175421;49969
FR;2;2021-03-03;6244;4883;181665;54852
FR;2;2021-03-04;8072;3968;189737;58820
FR;2;2021-03-05;7769;4060;197506;62880
FR;2;2021-03-06;4621;1682;202127;64562
FR;2;2021-03-07;2284;29;204411;64591
FR;2;2021-03-08;3974;8310;208385;72901
FR;2;2021-03-09;7265;8430;215650;81331
FR;2;2021-03-10;6866;9109;222516;90440
FR;2;2021-03-11;9084;9209;231600;99649
FR;2;2021-03-12;7718;8170;239318;107819
FR;2;2021-03-13;9870;2512;249188;110331
FR;2;2021-03-14;4753;402;253941;110733
FR;2;2021-03-15;10650;3484;264591;114217
FR;2;2021-03-16;16456;4620;281047;118837
FR;2;2021-03-17;19898;3952;300945;122789
FR;2;2021-03-18;22964;4910;323909;127699
FR;2;2021-03-19;22887;4537;346796;132236
FR;2;2021-03-20;25145;1540;371941;133776
FR;2;2021-03-21;17472;147;389413;133923
FR;2;2021-03-22;17398;3078;406811;137001
FR;2;2021-03-23;22268;4184;429079;141185
FR;2;2021-03-24;23555;4988;452634;146173
FR;2;2021-03-25;26280;5020;478914;151193
FR;2;2021-03-26;26592;4260;505506;155453
FR;2;2021-03-27;15641;1309;521147;156762
FR;2;2021-03-28;10396;94;531543;156856
FR;2;2021-03-29;18653;4280;550196;161136
FR;2;2021-03-30;24173;6002;574369;167138
FR;2;2021-03-31;28200;5956;602569;173094
FR;2;2021-04-01;33978;8495;636547;181589
FR;2;2021-04-02;29537;7661;666084;189250
FR;2;2021-04-03;16732;3582;682816;192832
FR;2;2021-04-04;9163;918;691979;193750
FR;2;2021-04-05;12124;811;704103;194561
FR;2;2021-04-06;26780;6935;730883;201496
FR;2;2021-04-07;30593;7174;761476;208670
FR;2;2021-04-08;36505;8817;797981;217487
FR;2;2021-04-09;33405;8602;831386;226089
FR;2;2021-04-10;19451;8968;850837;235057
FR;2;2021-04-11;7818;4271;858655;239328
FR;2;2021-04-12;16817;11254;875472;250582
FR;2;2021-04-13;19109;16426;894581;267008
FR;2;2021-04-14;17674;16285;912255;283293
FR;2;2021-04-15;21851;20761;934106;304054
FR;2;2021-04-16;20405;20075;954511;324129
FR;2;2021-04-17;13050;22462;967561;346591
FR;2;2021-04-18;5786;14406;973347;360997
FR;2;2021-04-19;16507;16263;989854;377260
FR;2;2021-04-20;19000;21595;1008854;398855
FR;2;2021-04-21;19723;21665;1028577;420520
FR;2;2021-04-22;23445;24866;1052022;445386
FR;2;2021-04-23;24258;25352;1076280;470738
FR;2;2021-04-24;25126;15115;1101406;485853
FR;2;2021-04-25;9509;8589;1110915;494442
FR;2;2021-04-26;16993;17205;1127908;511647
FR;2;2021-04-27;19906;24309;1147814;535956
FR;2;2021-04-28;24135;26193;1171949;562149
FR;2;2021-04-29;25843;30142;1197792;592291
FR;2;2021-04-30;25774;27798;1223566;620089
FR;2;2021-05-01;15045;9865;1238611;629954
FR;2;2021-05-02;6509;9184;1245120;639138
FR;2;2021-05-03;19532;19327;1264652;658465
FR;2;2021-05-04;18026;29059;1282678;687524
FR;2;2021-05-05;18029;29430;1300707;716954
FR;2;2021-05-06;23198;35294;1323905;752248
FR;2;2021-05-07;24837;33243;1348742;785491
FR;2;2021-05-08;20235;9706;1368977;795197
FR;2;2021-05-09;12922;7894;1381899;803091
FR;2;2021-05-10;32315;22224;1414214;825315
FR;2;2021-05-11;43035;21079;1457249;846394
FR;2;2021-05-12;49174;19910;1506423;866304
FR;2;2021-05-13;50506;5770;1556929;872074
FR;2;2021-05-14;60459;12957;1617388;885031
FR;2;2021-05-15;65210;7154;1682598;892185
FR;2;2021-05-16;42943;2575;1725541;894760
FR;2;2021-05-17;44065;12593;1769606;907353
FR;2;2021-05-18;53394;12256;1823000;919609
FR;2;2021-05-19;56239;10653;1879239;930262
FR;2;2021-05-20;62461;10933;1941700;941195
FR;2;2021-05-21;63275;11713;2004975;952908
FR;2;2021-05-22;60751;4528;2065726;957436
FR;2;2021-05-23;36913;577;2102639;958013
FR;2;2021-05-24;16820;2033;2119459;960046
FR;2;2021-05-25;20530;12242;2139989;972288
FR;2;2021-05-26;19077;11547;2159066;983835
FR;2;2021-05-27;22391;12679;2181457;996514
FR;2;2021-05-28;28598;15006;2210055;1011520
FR;2;2021-05-29;29851;8191;2239906;1019711
FR;2;2021-05-30;4457;1815;2244363;1021526
FR;2;2021-05-31;27708;18785;2272071;1040311
FR;2;2021-06-01;44008;20086;2316079;1060397
FR;2;2021-06-02;36394;19343;2352473;1079740
FR;2;2021-06-03;50216;23438;2402689;1103178
FR;2;2021-06-04;64275;24168;2466964;1127346
FR;2;2021-06-05;33735;24068;2500699;1151414
FR;2;2021-06-06;4717;6213;2505416;1157627
FR;2;2021-06-07;27448;23206;2532864;1180833
FR;2;2021-06-08;54866;19779;2587730;1200612
FR;2;2021-06-09;44842;20929;2632572;1221541
FR;2;2021-06-10;39773;19159;2672345;1240700
FR;3;2020-12-27;0;0;0;0
FR;3;2020-12-28;0;0;0;0
FR;3;2020-12-29;0;0;0;0
FR;3;2020-12-30;0;0;0;0
FR;3;2020-12-31;0;0;0;0
FR;3;2021-01-01;0;0;0;0
FR;3;2021-01-02;0;0;0;0
FR;3;2021-01-03;0;0;0;0
FR;3;2021-01-04;0;0;0;0
FR;3;2021-01-05;0;0;0;0
FR;3;2021-01-06;0;0;0;0
FR;3;2021-01-07;0;0;0;0
FR;3;2021-01-08;0;0;0;0
FR;3;2021-01-09;0;0;0;0
FR;3;2021-01-10;0;0;0;0
FR;3;2021-01-11;0;0;0;0
FR;3;2021-01-12;0;0;0;0
FR;3;2021-01-13;0;0;0;0
FR;3;2021-01-14;0;0;0;0
FR;3;2021-01-15;0;0;0;0
FR;3;2021-01-16;0;0;0;0
FR;3;2021-01-17;0;0;0;0
FR;3;2021-01-18;0;0;0;0
FR;3;2021-01-19;0;0;0;0
FR;3;2021-01-20;0;0;0;0
FR;3;2021-01-21;0;0;0;0
FR;3;2021-01-22;0;0;0;0
FR;3;2021-01-23;0;0;0;0
FR;3;2021-01-24;0;0;0;0
FR;3;2021-01-25;0;0;0;0
FR;3;2021-01-26;0;0;0;0
FR;3;2021-01-27;0;0;0;0
FR;3;2021-01-28;0;0;0;0
FR;3;2021-01-29;0;0;0;0
FR;3;2021-01-30;0;0;0;0
FR;3;2021-01-31;0;0;0;0
FR;3;2021-02-01;0;0;0;0
FR;3;2021-02-02;0;0;0;0
FR;3;2021-02-03;0;0;0;0
FR;3;2021-02-04;0;0;0;0
FR;3;2021-02-05;0;0;0;0
FR;3;2021-02-06;324;0;324;0
FR;3;2021-02-07;1352;0;1676;0
FR;3;2021-02-08;2635;0;4311;0
FR;3;2021-02-09;6645;0;10956;0
FR;3;2021-02-10;9244;0;20200;0
FR;3;2021-02-11;13365;0;33565;0
FR;3;2021-02-12;13048;0;46613;0
FR;3;2021-02-13;3529;0;50142;0
FR;3;2021-02-14;867;0;51009;0
FR;3;2021-02-15;10140;0;61149;0
FR;3;2021-02-16;12229;0;73378;0
FR;3;2021-02-17;10838;0;84216;0
FR;3;2021-02-18;14583;0;98799;0
FR;3;2021-02-19;14147;0;112946;0
FR;3;2021-02-20;3177;0;116123;0
FR;3;2021-02-21;544;0;116667;0
FR;3;2021-02-22;8923;0;125590;0
FR;3;2021-02-23;11114;0;136704;0
FR;3;2021-02-24;13904;0;150608;0
FR;3;2021-02-25;44396;0;195004;0
FR;3;2021-02-26;61458;0;256462;0
FR;3;2021-02-27;34481;7;290943;7
FR;3;2021-02-28;2348;0;293291;7
FR;3;2021-03-01;19953;10;313244;17
FR;3;2021-03-02;38414;12;351658;29
FR;3;2021-03-03;47979;19;399637;48
FR;3;2021-03-04;81323;20;480960;68
FR;3;2021-03-05;117256;59;598216;127
FR;3;2021-03-06;119222;49;717438;176
FR;3;2021-03-07;54646;28;772084;204
FR;3;2021-03-08;42228;21;814312;225
FR;3;2021-03-09;78328;32;892640;257
FR;3;2021-03-10;80281;39;972921;296
FR;3;2021-03-11;127639;48;1100560;344
FR;3;2021-03-12;181931;69;1282491;413
FR;3;2021-03-13;131400;53;1413891;466
FR;3;2021-03-14;13861;4;1427752;470
FR;3;2021-03-15;52044;38;1479796;508
FR;3;2021-03-16;933;13;1480729;521
FR;3;2021-03-17;647;6;1481376;527
FR;3;2021-03-18;1213;4;1482589;531
FR;3;2021-03-19;70104;35;1552693;566
FR;3;2021-03-20;65076;35;1617769;601
FR;3;2021-03-21;5547;4;1623316;605
FR;3;2021-03-22;37073;31;1660389;636
FR;3;2021-03-23;84604;49;1744993;685
FR;3;2021-03-24;91857;91;1836850;776
FR;3;2021-03-25;149492;113;1986342;889
FR;3;2021-03-26;164756;158;2151098;1047
FR;3;2021-03-27;67783;88;2218881;1135
FR;3;2021-03-28;6218;19;2225099;1154
FR;3;2021-03-29;53681;59;2278780;1213
FR;3;2021-03-30;93373;84;2372153;1297
FR;3;2021-03-31;64140;82;2436293;1379
FR;3;2021-04-01;85378;103;2521671;1482
FR;3;2021-04-02;86334;149;2608005;1631
FR;3;2021-04-03;35430;109;2643435;1740
FR;3;2021-04-04;3406;15;2646841;1755
FR;3;2021-04-05;4277;21;2651118;1776
FR;3;2021-04-06;29451;77;2680569;1853
FR;3;2021-04-07;32628;60;2713197;1913
FR;3;2021-04-08;77825;235;2791022;2148
FR;3;2021-04-09;160189;411;2951211;2559
FR;3;2021-04-10;74665;332;3025876;2891
FR;3;2021-04-11;7036;44;3032912;2935
FR;3;2021-04-12;50633;197;3083545;3132
FR;3;2021-04-13;85223;314;3168768;3446
FR;3;2021-04-14;66673;341;3235441;3787
FR;3;2021-04-15;91754;369;3327195;4156
FR;3;2021-04-16;111102;571;3438297;4727
FR;3;2021-04-17;52253;327;3490550;5054
FR;3;2021-04-18;9434;34;3499984;5088
FR;3;2021-04-19;24455;235;3524439;5323
FR;3;2021-04-20;44856;396;3569295;5719
FR;3;2021-04-21;38063;450;3607358;6169
FR;3;2021-04-22;53708;791;3661066;6960
FR;3;2021-04-23;69474;1022;3730540;7982
FR;3;2021-04-24;36529;976;3767069;8958
FR;3;2021-04-25;5916;158;3772985;9116
FR;3;2021-04-26;19092;664;3792077;9780
FR;3;2021-04-27;33717;1247;3825794;11027
FR;3;2021-04-28;28277;1925;3854071;12952
FR;3;2021-04-29;44548;5957;3898619;18909
FR;3;2021-04-30;54566;8932;3953185;27841
FR;3;2021-05-01;9174;1969;3962359;29810
FR;3;2021-05-02;2797;500;3965156;30310
FR;3;2021-05-03;12501;3883;3977657;34193
FR;3;2021-05-04;22433;8456;4000090;42649
FR;3;2021-05-05;18045;10575;4018135;53224
FR;3;2021-05-06;33873;20909;4052008;74133
FR;3;2021-05-07;43386;28419;4095394;102552
FR;3;2021-05-08;6353;8907;4101747;111459
FR;3;2021-05-09;1562;2660;4103309;114119
FR;3;2021-05-10;14414;12563;4117723;126682
FR;3;2021-05-11;26379;25745;4144102;152427
FR;3;2021-05-12;16705;27460;4160807;179887
FR;3;2021-05-13;2003;3481;4162810;183368
FR;3;2021-05-14;14050;25754;4176860;209122
FR;3;2021-05-15;6907;20739;4183767;229861
FR;3;2021-05-16;811;2680;4184578;232541
FR;3;2021-05-17;7504;19920;4192082;252461
FR;3;2021-05-18;12898;29645;4204980;282106
FR;3;2021-05-19;8797;31870;4213777;313976
FR;3;2021-05-20;12264;53231;4226041;367207
FR;3;2021-05-21;12247;65560;4238288;432767
FR;3;2021-05-22;4646;33304;4242934;466071
FR;3;2021-05-23;537;2665;4243471;468736
FR;3;2021-05-24;578;4920;4244049;473656
FR;3;2021-05-25;4865;45209;4248914;518865
FR;3;2021-05-26;4565;51073;4253479;569938
FR;3;2021-05-27;5938;77881;4259417;647819
FR;3;2021-05-28;7125;99153;4266542;746972
FR;3;2021-05-29;3120;60302;4269662;807274
FR;3;2021-05-30;380;8246;4270042;815520
FR;3;2021-05-31;2084;36030;4272126;851550
FR;3;2021-06-01;2981;64884;4275107;916434
FR;3;2021-06-02;2404;58435;4277511;974869
FR;3;2021-06-03;3193;87671;4280704;1062540
FR;3;2021-06-04;3941;105341;4284645;1167881
FR;3;2021-06-05;1784;52359;4286429;1220240
FR;3;2021-06-06;266;5426;4286695;1225666
FR;3;2021-06-07;1175;31420;4287870;1257086
FR;3;2021-06-08;13127;40517;4300997;1297603
FR;3;2021-06-09;10998;42409;4311995;1340012
FR;3;2021-06-10;1790;68013;4313785;1408025
FR;4;2020-12-27;0;0;0;0
FR;4;2020-12-28;0;0;0;0
FR;4;2020-12-29;0;0;0;0
FR;4;2020-12-30;0;0;0;0
FR;4;2020-12-31;0;0;0;0
FR;4;2021-01-01;0;0;0;0
FR;4;2021-01-02;0;0;0;0
FR;4;2021-01-03;0;0;0;0
FR;4;2021-01-04;0;0;0;0
FR;4;2021-01-05;0;0;0;0
FR;4;2021-01-06;0;0;0;0
FR;4;2021-01-07;0;0;0;0
FR;4;2021-01-08;0;0;0;0
FR;4;2021-01-09;0;0;0;0
FR;4;2021-01-10;0;0;0;0
FR;4;2021-01-11;0;0;0;0
FR;4;2021-01-12;0;0;0;0
FR;4;2021-01-13;0;0;0;0
FR;4;2021-01-14;0;0;0;0
FR;4;2021-01-15;0;0;0;0
FR;4;2021-01-16;0;0;0;0
FR;4;2021-01-17;0;0;0;0
FR;4;2021-01-18;0;0;0;0
FR;4;2021-01-19;0;0;0;0
FR;4;2021-01-20;0;0;0;0
FR;4;2021-01-21;0;0;0;0
FR;4;2021-01-22;0;0;0;0
FR;4;2021-01-23;0;0;0;0
FR;4;2021-01-24;0;0;0;0
FR;4;2021-01-25;0;0;0;0
FR;4;2021-01-26;0;0;0;0
FR;4;2021-01-27;0;0;0;0
FR;4;2021-01-28;0;0;0;0
FR;4;2021-01-29;0;0;0;0
FR;4;2021-01-30;0;0;0;0
FR;4;2021-01-31;0;0;0;0
FR;4;2021-02-01;0;0;0;0
FR;4;2021-02-02;0;0;0;0
FR;4;2021-02-03;0;0;0;0
FR;4;2021-02-04;0;0;0;0
FR;4;2021-02-05;0;0;0;0
FR;4;2021-02-06;0;0;0;0
FR;4;2021-02-07;0;0;0;0
FR;4;2021-02-08;0;0;0;0
FR;4;2021-02-09;0;0;0;0
FR;4;2021-02-10;0;0;0;0
FR;4;2021-02-11;0;0;0;0
FR;4;2021-02-12;0;0;0;0
FR;4;2021-02-13;0;0;0;0
FR;4;2021-02-14;0;0;0;0
FR;4;2021-02-15;0;0;0;0
FR;4;2021-02-16;0;0;0;0
FR;4;2021-02-17;0;0;0;0
FR;4;2021-02-18;0;0;0;0
FR;4;2021-02-19;0;0;0;0
FR;4;2021-02-20;0;0;0;0
FR;4;2021-02-21;0;0;0;0
FR;4;2021-02-22;0;0;0;0
FR;4;2021-02-23;0;0;0;0
FR;4;2021-02-24;0;0;0;0
FR;4;2021-02-25;0;0;0;0
FR;4;2021-02-26;0;0;0;0
FR;4;2021-02-27;0;0;0;0
FR;4;2021-02-28;0;0;0;0
FR;4;2021-03-01;0;0;0;0
FR;4;2021-03-02;0;0;0;0
FR;4;2021-03-03;0;0;0;0
FR;4;2021-03-04;0;0;0;0
FR;4;2021-03-05;0;0;0;0
FR;4;2021-03-06;0;0;0;0
FR;4;2021-03-07;0;0;0;0
FR;4;2021-03-08;0;0;0;0
FR;4;2021-03-09;0;0;0;0
FR;4;2021-03-10;0;0;0;0
FR;4;2021-03-11;0;0;0;0
FR;4;2021-03-12;0;0;0;0
FR;4;2021-03-13;0;0;0;0
FR;4;2021-03-14;0;0;0;0
FR;4;2021-03-15;0;0;0;0
FR;4;2021-03-16;0;0;0;0
FR;4;2021-03-17;0;0;0;0
FR;4;2021-03-18;0;0;0;0
FR;4;2021-03-19;0;0;0;0
FR;4;2021-03-20;0;0;0;0
FR;4;2021-03-21;0;0;0;0
FR;4;2021-03-22;0;0;0;0
FR;4;2021-03-23;0;0;0;0
FR;4;2021-03-24;0;0;0;0
FR;4;2021-03-25;0;0;0;0
FR;4;2021-03-26;0;0;0;0
FR;4;2021-03-27;0;0;0;0
FR;4;2021-03-28;0;0;0;0
FR;4;2021-03-29;0;0;0;0
FR;4;2021-03-30;0;0;0;0
FR;4;2021-03-31;0;0;0;0
FR;4;2021-04-01;0;0;0;0
FR;4;2021-04-02;0;0;0;0
FR;4;2021-04-03;0;0;0;0
FR;4;2021-04-04;0;0;0;0
FR;4;2021-04-05;0;0;0;0
FR;4;2021-04-06;0;0;0;0
FR;4;2021-04-07;0;0;0;0
FR;4;2021-04-08;0;0;0;0
FR;4;2021-04-09;0;0;0;0
FR;4;2021-04-10;0;0;0;0
FR;4;2021-04-11;0;0;0;0
FR;4;2021-04-12;0;0;0;0
FR;4;2021-04-13;0;0;0;0
FR;4;2021-04-14;0;0;0;0
FR;4;2021-04-15;0;0;0;0
FR;4;2021-04-16;0;0;0;0
FR;4;2021-04-17;0;0;0;0
FR;4;2021-04-18;0;0;0;0
FR;4;2021-04-19;0;0;0;0
FR;4;2021-04-20;0;0;0;0
FR;4;2021-04-21;0;0;0;0
FR;4;2021-04-22;0;0;0;0
FR;4;2021-04-23;763;0;763;0
FR;4;2021-04-24;1552;0;2315;0
FR;4;2021-04-25;117;0;2432;0
FR;4;2021-04-26;2829;0;5261;0
FR;4;2021-04-27;9374;3;14635;3
FR;4;2021-04-28;9764;3;24399;6
FR;4;2021-04-29;15872;7;40271;13
FR;4;2021-04-30;19076;7;59347;20
FR;4;2021-05-01;1896;5;61243;25
FR;4;2021-05-02;440;0;61683;25
FR;4;2021-05-03;4927;1;66610;26
FR;4;2021-05-04;8247;8;74857;34
FR;4;2021-05-05;5999;7;80856;41
FR;4;2021-05-06;11254;11;92110;52
FR;4;2021-05-07;18905;8;111015;60
FR;4;2021-05-08;2253;4;113268;64
FR;4;2021-05-09;629;2;113897;66
FR;4;2021-05-10;7086;13;120983;79
FR;4;2021-05-11;14103;12;135086;91
FR;4;2021-05-12;9946;14;145032;105
FR;4;2021-05-13;1440;3;146472;108
FR;4;2021-05-14;7597;8;154069;116
FR;4;2021-05-15;3581;9;157650;125
FR;4;2021-05-16;352;1;158002;126
FR;4;2021-05-17;4257;2;162259;128
FR;4;2021-05-18;8583;10;170842;138
FR;4;2021-05-19;5508;5;176350;143
FR;4;2021-05-20;9173;6;185523;149
FR;4;2021-05-21;12508;25;198031;174
FR;4;2021-05-22;4924;13;202955;187
FR;4;2021-05-23;423;2;203378;189
FR;4;2021-05-24;938;3;204316;192
FR;4;2021-05-25;7378;16;211694;208
FR;4;2021-05-26;7539;12;219233;220
FR;4;2021-05-27;14055;34;233288;254
FR;4;2021-05-28;26207;74;259495;328
FR;4;2021-05-29;11103;18;270598;346
FR;4;2021-05-30;859;2;271457;348
FR;4;2021-05-31;12412;19;283869;367
FR;4;2021-06-01;19767;40;303636;407
FR;4;2021-06-02;14151;33;317787;440
FR;4;2021-06-03;19084;23;336871;463
FR;4;2021-06-04;21961;45;358832;508
FR;4;2021-06-05;9337;27;368169;535
FR;4;2021-06-06;896;0;369065;535
FR;4;2021-06-07;8870;17;377935;552
FR;4;2021-06-08;15521;20;393456;572
FR;4;2021-06-09;14192;24;407648;596
FR;4;2021-06-10;14435;22;422083;618
FR;0;2020-12-27;20;0;20;0
FR;0;2020-12-28;70;0;90;0
FR;0;2020-12-29;108;0;198;0
FR;0;2020-12-30;123;0;321;0
FR;0;2020-12-31;85;0;406;0
FR;0;2021-01-01;71;0;477;0
FR;0;2021-01-02;88;0;565;0
FR;0;2021-01-03;92;0;657;0
FR;0;2021-01-04;1479;0;2136;0
FR;0;2021-01-05;5400;0;7536;0
FR;0;2021-01-06;11323;0;18859;0
FR;0;2021-01-07;28575;0;47434;0
FR;0;2021-01-08;36275;0;83709;0
FR;0;2021-01-09;10929;0;94638;0
FR;0;2021-01-10;5624;0;100262;0
FR;0;2021-01-11;39042;0;139304;0
FR;0;2021-01-12;60946;0;200250;0
FR;0;2021-01-13;63868;0;264118;0
FR;0;2021-01-14;79940;0;344058;0
FR;0;2021-01-15;67541;0;411599;0
FR;0;2021-01-16;19743;78;431342;78
FR;0;2021-01-17;10473;42;441815;120
FR;0;2021-01-18;84437;163;526252;283
FR;0;2021-01-19;128519;127;654771;410
FR;0;2021-01-20;135281;159;790052;569
FR;0;2021-01-21;155507;135;945559;704
FR;0;2021-01-22;118689;162;1064248;866
FR;0;2021-01-23;37843;50;1102091;916
FR;0;2021-01-24;9371;27;1111462;943
FR;0;2021-01-25;76880;1218;1188342;2161
FR;0;2021-01-26;98901;3110;1287243;5271
FR;0;2021-01-27;105699;5598;1392942;10869
FR;0;2021-01-28;122400;14362;1515342;25231
FR;0;2021-01-29;90915;17299;1606257;42530
FR;0;2021-01-30;28657;4226;1634914;46756
FR;0;2021-01-31;4873;1679;1639787;48435
FR;0;2021-02-01;51620;21135;1691407;69570
FR;0;2021-02-02;70732;34574;1762139;104144
FR;0;2021-02-03;71018;36976;1833157;141120
FR;0;2021-02-04;80635;50069;1913792;191189
FR;0;2021-02-05;67155;45347;1980947;236536
FR;0;2021-02-06;21344;10401;2002291;246937
FR;0;2021-02-07;4829;5042;2007120;251979
FR;0;2021-02-08;45921;46000;2053041;297979
FR;0;2021-02-09;64894;72457;2117935;370436
FR;0;2021-02-10;69328;76738;2187263;447174
FR;0;2021-02-11;85707;99171;2272970;546345
FR;0;2021-02-12;77805;74302;2350775;620647
FR;0;2021-02-13;21701;19496;2372476;640143
FR;0;2021-02-14;4593;7191;2377069;647334
FR;0;2021-02-15;37107;76537;2414176;723871
FR;0;2021-02-16;49282;100767;2463458;824638
FR;0;2021-02-17;49340;102984;2512798;927622
FR;0;2021-02-18;68028;118578;2580826;1046200
FR;0;2021-02-19;63854;90748;2644680;1136948
FR;0;2021-02-20;17965;28435;2662645;1165383
FR;0;2021-02-21;2860;6374;2665505;1171757
FR;0;2021-02-22;36508;73148;2702013;1244905
FR;0;2021-02-23;52662;84066;2754675;1328971
FR;0;2021-02-24;58096;81137;2812771;1410108
FR;0;2021-02-25;98675;91438;2911446;1501546
FR;0;2021-02-26;111832;71037;3023278;1572583
FR;0;2021-02-27;51224;21980;3074502;1594563
FR;0;2021-02-28;5680;4414;3080182;1598977
FR;0;2021-03-01;63702;52813;3143884;1651790
FR;0;2021-03-02;99483;66251;3243367;1718041
FR;0;2021-03-03;113875;65559;3357242;1783600
FR;0;2021-03-04;160736;68909;3517978;1852509
FR;0;2021-03-05;198323;63399;3716301;1915908
FR;0;2021-03-06;205285;17824;3921586;1933732
FR;0;2021-03-07;119934;5482;4041520;1939214
FR;0;2021-03-08;105076;50821;4146596;1990035
FR;0;2021-03-09;170062;56788;4316658;2046823
FR;0;2021-03-10;176258;57220;4492916;2104043
FR;0;2021-03-11;240127;63134;4733043;2167177
FR;0;2021-03-12;291841;53511;5024884;2220688
FR;0;2021-03-13;228991;15287;5253875;2235975
FR;0;2021-03-14;62383;3437;5316258;2239412
FR;0;2021-03-15;156543;32678;5472801;2272090
FR;0;2021-03-16;139321;39547;5612122;2311637
FR;0;2021-03-17;148086;38841;5760208;2350478
FR;0;2021-03-18;165147;44668;5925355;2395146
FR;0;2021-03-19;227323;37491;6152678;2432637
FR;0;2021-03-20;165195;11788;6317873;2444425
FR;0;2021-03-21;48796;2628;6366669;2447053
FR;0;2021-03-22;167552;34308;6534221;2481361
FR;0;2021-03-23;247958;42419;6782179;2523780
FR;0;2021-03-24;255451;43881;7037630;2567661
FR;0;2021-03-25;338695;44763;7376325;2612424
FR;0;2021-03-26;355762;41922;7732087;2654346
FR;0;2021-03-27;193385;16656;7925472;2671002
FR;0;2021-03-28;58346;3737;7983818;2674739
FR;0;2021-03-29;200789;54322;8184607;2729061
FR;0;2021-03-30;283290;69706;8467897;2798767
FR;0;2021-03-31;261327;72974;8729224;2871741
FR;0;2021-04-01;310672;87886;9039896;2959627
FR;0;2021-04-02;278249;92162;9318145;3051789
FR;0;2021-04-03;139337;61879;9457482;3113668
FR;0;2021-04-04;44900;18665;9502382;3132333
FR;0;2021-04-05;58839;11010;9561221;3143343
FR;0;2021-04-06;214032;107939;9775253;3251282
FR;0;2021-04-07;257471;115531;10032724;3366813
FR;0;2021-04-08;333165;121509;10365889;3488322
FR;0;2021-04-09;405141;116568;10771030;3604890
FR;0;2021-04-10;210234;82769;10981264;3687659
FR;0;2021-04-11;54925;34604;11036189;3722263
FR;0;2021-04-12;233981;115278;11270170;3837541
FR;0;2021-04-13;305392;145032;11575562;3982573
FR;0;2021-04-14;289877;139493;11865439;4122066
FR;0;2021-04-15;331900;147919;12197339;4269985
FR;0;2021-04-16;335011;145864;12532350;4415849
FR;0;2021-04-17;186282;90281;12718632;4506130
FR;0;2021-04-18;50442;35434;12769074;4541564
FR;0;2021-04-19;202730;138465;12971804;4680029
FR;0;2021-04-20;251096;170819;13222900;4850848
FR;0;2021-04-21;249614;168906;13472514;5019754
FR;0;2021-04-22;283467;188336;13755981;5208090
FR;0;2021-04-23;290956;183365;14046937;5391455
FR;0;2021-04-24;188348;111617;14235285;5503072
FR;0;2021-04-25;68535;38888;14303820;5541960
FR;0;2021-04-26;218560;156181;14522380;5698141
FR;0;2021-04-27;290049;187576;14812429;5885717
FR;0;2021-04-28;319078;183295;15131507;6069012
FR;0;2021-04-29;361177;196244;15492684;6265256
FR;0;2021-04-30;377315;184966;15869999;6450222
FR;0;2021-05-01;168776;52558;16038775;6502780
FR;0;2021-05-02;90149;37846;16128924;6540626
FR;0;2021-05-03;283583;169789;16412507;6710415
FR;0;2021-05-04;310646;224443;16723153;6934858
FR;0;2021-05-05;320806;224665;17043959;7159523
FR;0;2021-05-06;373047;239379;17417006;7398902
FR;0;2021-05-07;367142;257495;17784148;7656397
FR;0;2021-05-08;209964;66979;17994112;7723376
FR;0;2021-05-09;127626;46792;18121738;7770168
FR;0;2021-05-10;304768;229180;18426506;7999348
FR;0;2021-05-11;398215;258347;18824721;8257695
FR;0;2021-05-12;425706;233380;19250427;8491075
FR;0;2021-05-13;331908;56939;19582335;8548014
FR;0;2021-05-14;446990;167689;20029325;8715703
FR;0;2021-05-15;367874;94084;20397199;8809787
FR;0;2021-05-16;199380;20845;20596579;8830632
FR;0;2021-05-17;368887;149342;20965466;8979974
FR;0;2021-05-18;447458;153400;21412924;9133374
FR;0;2021-05-19;458446;145585;21871370;9278959
FR;0;2021-05-20;496283;160668;22367653;9439627
FR;0;2021-05-21;480335;174867;22847988;9614494
FR;0;2021-05-22;341923;80039;23189911;9694533
FR;0;2021-05-23;159004;14492;23348915;9709025
FR;0;2021-05-24;257387;33340;23606302;9742365
FR;0;2021-05-25;391398;189626;23997700;9931991
FR;0;2021-05-26;400767;188600;24398467;10120591
FR;0;2021-05-27;440770;219298;24839237;10339889
FR;0;2021-05-28;420422;260101;25259659;10599990
FR;0;2021-05-29;294633;149619;25554292;10749609
FR;0;2021-05-30;104821;32686;25659113;10782295
FR;0;2021-05-31;351494;203819;26010607;10986114
FR;0;2021-06-01;412607;252134;26423214;11238248
FR;0;2021-06-02;400605;231856;26823819;11470104
FR;0;2021-06-03;450681;259604;27274500;11729708
FR;0;2021-06-04;440865;305777;27715365;12035485
FR;0;2021-06-05;297321;189383;28012686;12224868
FR;0;2021-06-06;128942;49221;28141628;12274089
FR;0;2021-06-07;327110;263550;28468738;12537639
FR;0;2021-06-08;489747;251757;28958485;12789396
FR;0;2021-06-09;513431;276327;29471916;13065723
FR;0;2021-06-10;377149;289725;29849065;13355448
