fra;vaccin;jour;n_dose1;n_dose2;n_cum_dose1;n_cum_dose2
FR;1;2020-12-27;20;0;20;0
FR;1;2020-12-28;71;0;91;0
FR;1;2020-12-29;108;0;199;0
FR;1;2020-12-30;123;0;322;0
FR;1;2020-12-31;88;0;410;0
FR;1;2021-01-01;74;0;484;0
FR;1;2021-01-02;88;0;572;0
FR;1;2021-01-03;92;0;664;0
FR;1;2021-01-04;1479;0;2143;0
FR;1;2021-01-05;5415;0;7558;0
FR;1;2021-01-06;11323;0;18881;0
FR;1;2021-01-07;28582;0;47463;0
FR;1;2021-01-08;36298;0;83761;0
FR;1;2021-01-09;10942;0;94703;0
FR;1;2021-01-10;5639;0;100342;0
FR;1;2021-01-11;39121;0;139463;0
FR;1;2021-01-12;61010;0;200473;0
FR;1;2021-01-13;63942;0;264415;0
FR;1;2021-01-14;79871;0;344286;0
FR;1;2021-01-15;67378;0;411664;0
FR;1;2021-01-16;19563;87;431227;87
FR;1;2021-01-17;10475;42;441702;129
FR;1;2021-01-18;81585;164;523287;293
FR;1;2021-01-19;124048;128;647335;421
FR;1;2021-01-20;130463;160;777798;581
FR;1;2021-01-21;150463;141;928261;722
FR;1;2021-01-22;113947;163;1042208;885
FR;1;2021-01-23;36128;52;1078336;937
FR;1;2021-01-24;9270;28;1087606;965
FR;1;2021-01-25;73306;1219;1160912;2184
FR;1;2021-01-26;95182;3113;1256094;5297
FR;1;2021-01-27;102304;5599;1358398;10896
FR;1;2021-01-28;118969;14361;1477367;25257
FR;1;2021-01-29;87887;17293;1565254;42550
FR;1;2021-01-30;27618;4225;1592872;46775
FR;1;2021-01-31;4872;1679;1597744;48454
FR;1;2021-02-01;48374;21128;1646118;69582
FR;1;2021-02-02;66453;34568;1712571;104150
FR;1;2021-02-03;66032;36961;1778603;141111
FR;1;2021-02-04;75962;50059;1854565;191170
FR;1;2021-02-05;62597;45337;1917162;236507
FR;1;2021-02-06;19090;10396;1936252;246903
FR;1;2021-02-07;3436;5041;1939688;251944
FR;1;2021-02-08;35884;45986;1975572;297930
FR;1;2021-02-09;49970;72392;2025542;370322
FR;1;2021-02-10;50979;76646;2076521;446968
FR;1;2021-02-11;62310;99077;2138831;546045
FR;1;2021-02-12;54979;74038;2193810;620083
FR;1;2021-02-13;15186;19270;2208996;639353
FR;1;2021-02-14;3431;7190;2212427;646543
FR;1;2021-02-15;23602;73440;2236029;719983
FR;1;2021-02-16;32147;96865;2268176;816848
FR;1;2021-02-17;34418;98569;2302594;915417
FR;1;2021-02-18;48283;113473;2350877;1028890
FR;1;2021-02-19;44537;86414;2395414;1115304
FR;1;2021-02-20;13069;26920;2408483;1142224
FR;1;2021-02-21;2119;6287;2410602;1148511
FR;1;2021-02-22;24126;69415;2434728;1217926
FR;1;2021-02-23;36749;80366;2471477;1298292
FR;1;2021-02-24;39494;77662;2510971;1375954
FR;1;2021-02-25;49113;87994;2560084;1463948
FR;1;2021-02-26;46217;67888;2606301;1531836
FR;1;2021-02-27;15247;20931;2621548;1552767
FR;1;2021-02-28;3234;4386;2624782;1557153
FR;1;2021-03-01;38797;49031;2663579;1606184
FR;1;2021-03-02;54780;61506;2718359;1667690
FR;1;2021-03-03;59680;60653;2778039;1728343
FR;1;2021-03-04;71365;64894;2849404;1793237
FR;1;2021-03-05;73320;59275;2922724;1852512
FR;1;2021-03-06;81467;16094;3004191;1868606
FR;1;2021-03-07;63003;5424;3067194;1874030
FR;1;2021-03-08;58921;42480;3126115;1916510
FR;1;2021-03-09;84583;48318;3210698;1964828
FR;1;2021-03-10;89191;48067;3299889;2012895
FR;1;2021-03-11;103419;53866;3403308;2066761
FR;1;2021-03-12;102330;45270;3505638;2112031
FR;1;2021-03-13;87887;12722;3593525;2124753
FR;1;2021-03-14;43752;3031;3637277;2127784
FR;1;2021-03-15;94033;29153;3731310;2156937
FR;1;2021-03-16;122105;34908;3853415;2191845
FR;1;2021-03-17;127708;34869;3981123;2226714
FR;1;2021-03-18;141186;39756;4122309;2266470
FR;1;2021-03-19;134491;32914;4256800;2299384
FR;1;2021-03-20;75078;10212;4331878;2309596
FR;1;2021-03-21;25777;2477;4357655;2312073
FR;1;2021-03-22;113096;31191;4470751;2343264
FR;1;2021-03-23;141156;38176;4611907;2381440
FR;1;2021-03-24;140055;38791;4751962;2420231
FR;1;2021-03-25;162976;39620;4914938;2459851
FR;1;2021-03-26;164467;37500;5079405;2497351
FR;1;2021-03-27;109963;15260;5189368;2512611
FR;1;2021-03-28;41740;3624;5231108;2516235
FR;1;2021-03-29;128450;49969;5359558;2566204
FR;1;2021-03-30;165790;63600;5525348;2629804
FR;1;2021-03-31;169029;66916;5694377;2696720
FR;1;2021-04-01;191419;79256;5885796;2775976
FR;1;2021-04-02;162450;84319;6048246;2860295
FR;1;2021-04-03;87207;58188;6135453;2918483
FR;1;2021-04-04;32342;17733;6167795;2936216
FR;1;2021-04-05;42435;10178;6210230;2946394
FR;1;2021-04-06;157833;100891;6368063;3047285
FR;1;2021-04-07;194309;108272;6562372;3155557
FR;1;2021-04-08;218886;112406;6781258;3267963
FR;1;2021-04-09;211725;107520;6992983;3375483
FR;1;2021-04-10;115995;73465;7108978;3448948
FR;1;2021-04-11;40044;30288;7149022;3479236
FR;1;2021-04-12;166532;103797;7315554;3583033
FR;1;2021-04-13;201149;128263;7516703;3711296
FR;1;2021-04-14;205527;122820;7722230;3834116
FR;1;2021-04-15;218330;126766;7940560;3960882
FR;1;2021-04-16;203861;125155;8144421;4086037
FR;1;2021-04-17;120960;67490;8265381;4153527
FR;1;2021-04-18;35224;20997;8300605;4174524
FR;1;2021-04-19;161897;121935;8462502;4296459
FR;1;2021-04-20;187123;148804;8649625;4445263
FR;1;2021-04-21;191635;146761;8841260;4592024
FR;1;2021-04-22;206388;162652;9047648;4754676
FR;1;2021-04-23;196670;156940;9244318;4911616
FR;1;2021-04-24;125001;95520;9369319;5007136
FR;1;2021-04-25;52878;30144;9422197;5037280
FR;1;2021-04-26;179236;138282;9601433;5175562
FR;1;2021-04-27;219022;162011;9820455;5337573
FR;1;2021-04-28;236129;155142;10056584;5492715
FR;1;2021-04-29;267533;160093;10324117;5652808
FR;1;2021-04-30;269283;148183;10593400;5800991
FR;1;2021-05-01;138198;40719;10731598;5841710
FR;1;2021-05-02;80435;28165;10812033;5869875
FR;1;2021-05-03;247179;146549;11059212;6016424
FR;1;2021-05-04;262504;186879;11321716;6203303
FR;1;2021-05-05;279050;184602;11600766;6387905
FR;1;2021-05-06;305536;183074;11906302;6570979
FR;1;2021-05-07;280663;195761;12186965;6766740
FR;1;2021-05-08;185359;48339;12372324;6815079
FR;1;2021-05-09;112859;36234;12485183;6851313
FR;1;2021-05-10;251941;194295;12737124;7045608
FR;1;2021-05-11;313660;211458;13050784;7257066
FR;1;2021-05-12;348462;185960;13399246;7443026
FR;1;2021-05-13;277862;47685;13677108;7490711
FR;1;2021-05-14;364198;128946;14041306;7619657
FR;1;2021-05-15;292003;66179;14333309;7685836
FR;1;2021-05-16;155433;15588;14488742;7701424
FR;1;2021-05-17;313734;116749;14802476;7818173
FR;1;2021-05-18;373893;111416;15176369;7929589
FR;1;2021-05-19;388357;103020;15564726;8032609
FR;1;2021-05-20;413353;96422;15978079;8129031
FR;1;2021-05-21;392395;97537;16370474;8226568
FR;1;2021-05-22;271571;42191;16642045;8268759
FR;1;2021-05-23;121090;11256;16763135;8280015
FR;1;2021-05-24;239017;26394;17002152;8306409
FR;1;2021-05-25;358719;132082;17360871;8438491
FR;1;2021-05-26;370483;125870;17731354;8564361
FR;1;2021-05-27;399062;128458;18130416;8692819
FR;1;2021-05-28;359639;145744;18490055;8838563
FR;1;2021-05-29;250369;81092;18740424;8919655
FR;1;2021-05-30;99078;22619;18839502;8942274
FR;1;2021-05-31;309183;148973;19148685;9091247
FR;1;2021-06-01;346050;166979;19494735;9258226
FR;1;2021-06-02;347617;153500;19842352;9411726
FR;1;2021-06-03;378289;147941;20220641;9559667
FR;1;2021-06-04;351492;175825;20572133;9735492
FR;1;2021-06-05;253163;112887;20825296;9848379
FR;1;2021-06-06;123174;37572;20948470;9885951
FR;1;2021-06-07;290707;208378;21239177;10094329
FR;1;2021-06-08;324486;224294;21563663;10318623
FR;1;2021-06-09;322786;216736;21886449;10535359
FR;1;2021-06-10;327650;202541;22214099;10737900
FR;1;2021-06-11;301665;235696;22515764;10973596
FR;1;2021-06-12;237865;150986;22753629;11124582
FR;1;2021-06-13;97459;61134;22851088;11185716
FR;1;2021-06-14;197952;289339;23049040;11475055
FR;1;2021-06-15;244416;282767;23293456;11757822
FR;1;2021-06-16;263669;270779;23557125;12028601
FR;1;2021-06-17;258463;244700;23815588;12273301
FR;1;2021-06-18;247598;296343;24063186;12569644
FR;2;2020-12-27;0;0;0;0
FR;2;2020-12-28;0;0;0;0
FR;2;2020-12-29;0;0;0;0
FR;2;2020-12-30;0;0;0;0
FR;2;2020-12-31;0;0;0;0
FR;2;2021-01-01;0;0;0;0
FR;2;2021-01-02;0;0;0;0
FR;2;2021-01-03;0;0;0;0
FR;2;2021-01-04;0;0;0;0
FR;2;2021-01-05;0;0;0;0
FR;2;2021-01-06;0;0;0;0
FR;2;2021-01-07;0;0;0;0
FR;2;2021-01-08;0;0;0;0
FR;2;2021-01-09;0;0;0;0
FR;2;2021-01-10;0;0;0;0
FR;2;2021-01-11;0;0;0;0
FR;2;2021-01-12;0;0;0;0
FR;2;2021-01-13;0;0;0;0
FR;2;2021-01-14;152;0;152;0
FR;2;2021-01-15;218;0;370;0
FR;2;2021-01-16;186;0;556;0
FR;2;2021-01-17;3;0;559;0
FR;2;2021-01-18;2914;0;3473;0
FR;2;2021-01-19;4515;0;7988;0
FR;2;2021-01-20;4921;0;12909;0
FR;2;2021-01-21;5126;0;18035;0
FR;2;2021-01-22;4882;0;22917;0
FR;2;2021-01-23;1734;0;24651;0
FR;2;2021-01-24;102;0;24753;0
FR;2;2021-01-25;3635;0;28388;0
FR;2;2021-01-26;3750;0;32138;0
FR;2;2021-01-27;3442;0;35580;0
FR;2;2021-01-28;3514;0;39094;0
FR;2;2021-01-29;3083;0;42177;0
FR;2;2021-01-30;1064;0;43241;0
FR;2;2021-01-31;0;0;43241;0
FR;2;2021-02-01;3260;0;46501;0
FR;2;2021-02-02;4308;0;50809;0
FR;2;2021-02-03;5032;0;55841;0
FR;2;2021-02-04;4735;4;60576;4
FR;2;2021-02-05;4621;6;65197;10
FR;2;2021-02-06;1931;3;67128;13
FR;2;2021-02-07;42;0;67170;13
FR;2;2021-02-08;7428;8;74598;21
FR;2;2021-02-09;8258;16;82856;37
FR;2;2021-02-10;9142;49;91998;86
FR;2;2021-02-11;10056;67;102054;153
FR;2;2021-02-12;9815;238;111869;391
FR;2;2021-02-13;3017;222;114886;613
FR;2;2021-02-14;296;0;115182;613
FR;2;2021-02-15;3359;3067;118541;3680
FR;2;2021-02-16;4909;3881;123450;7561
FR;2;2021-02-17;4105;4403;127555;11964
FR;2;2021-02-18;5235;5089;132790;17053
FR;2;2021-02-19;5213;4323;138003;21376
FR;2;2021-02-20;1764;1509;139767;22885
FR;2;2021-02-21;197;86;139964;22971
FR;2;2021-02-22;3530;3723;143494;26694
FR;2;2021-02-23;4837;3693;148331;30387
FR;2;2021-02-24;4764;3468;153095;33855
FR;2;2021-02-25;5293;3426;158388;37281
FR;2;2021-02-26;4197;3125;162585;40406
FR;2;2021-02-27;1502;1042;164087;41448
FR;2;2021-02-28;99;28;164186;41476
FR;2;2021-03-01;4962;3764;169148;45240
FR;2;2021-03-02;6308;4727;175456;49967
FR;2;2021-03-03;6245;4883;181701;54850
FR;2;2021-03-04;8073;3967;189774;58817
FR;2;2021-03-05;7769;4060;197543;62877
FR;2;2021-03-06;4621;1682;202164;64559
FR;2;2021-03-07;2284;29;204448;64588
FR;2;2021-03-08;3975;8311;208423;72899
FR;2;2021-03-09;7268;8429;215691;81328
FR;2;2021-03-10;6862;9109;222553;90437
FR;2;2021-03-11;9085;9208;231638;99645
FR;2;2021-03-12;7722;8170;239360;107815
FR;2;2021-03-13;9873;2511;249233;110326
FR;2;2021-03-14;4753;402;253986;110728
FR;2;2021-03-15;10651;3484;264637;114212
FR;2;2021-03-16;16457;4621;281094;118833
FR;2;2021-03-17;19900;3952;300994;122785
FR;2;2021-03-18;22960;4910;323954;127695
FR;2;2021-03-19;22886;4538;346840;132233
FR;2;2021-03-20;25147;1540;371987;133773
FR;2;2021-03-21;17474;147;389461;133920
FR;2;2021-03-22;17400;3078;406861;136998
FR;2;2021-03-23;22269;4183;429130;141181
FR;2;2021-03-24;23553;4988;452683;146169
FR;2;2021-03-25;26280;5022;478963;151191
FR;2;2021-03-26;26592;4262;505555;155453
FR;2;2021-03-27;15639;1309;521194;156762
FR;2;2021-03-28;10395;94;531589;156856
FR;2;2021-03-29;18649;4281;550238;161137
FR;2;2021-03-30;24176;6002;574414;167139
FR;2;2021-03-31;28126;5958;602540;173097
FR;2;2021-04-01;33987;8496;636527;181593
FR;2;2021-04-02;29560;7662;666087;189255
FR;2;2021-04-03;16728;3582;682815;192837
FR;2;2021-04-04;9161;918;691976;193755
FR;2;2021-04-05;12122;811;704098;194566
FR;2;2021-04-06;26769;6933;730867;201499
FR;2;2021-04-07;30583;7174;761450;208673
FR;2;2021-04-08;36499;8818;797949;217491
FR;2;2021-04-09;33398;8602;831347;226093
FR;2;2021-04-10;19449;8969;850796;235062
FR;2;2021-04-11;7816;4272;858612;239334
FR;2;2021-04-12;16807;11255;875419;250589
FR;2;2021-04-13;19112;16426;894531;267015
FR;2;2021-04-14;17672;16285;912203;283300
FR;2;2021-04-15;21857;20757;934060;304057
FR;2;2021-04-16;20398;20073;954458;324130
FR;2;2021-04-17;13057;22462;967515;346592
FR;2;2021-04-18;5785;14405;973300;360997
FR;2;2021-04-19;16483;16263;989783;377260
FR;2;2021-04-20;18995;21595;1008778;398855
FR;2;2021-04-21;19791;21665;1028569;420520
FR;2;2021-04-22;23415;24863;1051984;445383
FR;2;2021-04-23;24217;25352;1076201;470735
FR;2;2021-04-24;25108;15111;1101309;485846
FR;2;2021-04-25;9495;8589;1110804;494435
FR;2;2021-04-26;16907;17196;1127711;511631
FR;2;2021-04-27;19023;24307;1146734;535938
FR;2;2021-04-28;22032;26188;1168766;562126
FR;2;2021-04-29;25206;30137;1193972;592263
FR;2;2021-04-30;25337;27782;1219309;620045
FR;2;2021-05-01;14797;9863;1234106;629908
FR;2;2021-05-02;6519;9184;1240625;639092
FR;2;2021-05-03;19636;19328;1260261;658420
FR;2;2021-05-04;18044;29056;1278305;687476
FR;2;2021-05-05;17993;29415;1296298;716891
FR;2;2021-05-06;23226;35292;1319524;752183
FR;2;2021-05-07;24872;33245;1344396;785428
FR;2;2021-05-08;20567;9705;1364963;795133
FR;2;2021-05-09;12983;7894;1377946;803027
FR;2;2021-05-10;32320;22221;1410266;825248
FR;2;2021-05-11;43030;21078;1453296;846326
FR;2;2021-05-12;48992;19907;1502288;866233
FR;2;2021-05-13;50522;5770;1552810;872003
FR;2;2021-05-14;60484;12957;1613294;884960
FR;2;2021-05-15;65214;7153;1678508;892113
FR;2;2021-05-16;42984;2576;1721492;894689
FR;2;2021-05-17;44104;12591;1765596;907280
FR;2;2021-05-18;53463;12256;1819059;919536
FR;2;2021-05-19;56265;10636;1875324;930172
FR;2;2021-05-20;62474;10900;1937798;941072
FR;2;2021-05-21;63221;11686;2001019;952758
FR;2;2021-05-22;60748;4528;2061767;957286
FR;2;2021-05-23;36928;577;2098695;957863
FR;2;2021-05-24;16826;2033;2115521;959896
FR;2;2021-05-25;20522;12245;2136043;972141
FR;2;2021-05-26;19057;11469;2155100;983610
FR;2;2021-05-27;22434;12670;2177534;996280
FR;2;2021-05-28;28746;14992;2206280;1011272
FR;2;2021-05-29;29959;8191;2236239;1019463
FR;2;2021-05-30;4473;1811;2240712;1021274
FR;2;2021-05-31;28031;18761;2268743;1040035
FR;2;2021-06-01;44318;20077;2313061;1060112
FR;2;2021-06-02;36432;19319;2349493;1079431
FR;2;2021-06-03;50263;23409;2399756;1102840
FR;2;2021-06-04;64387;24107;2464143;1126947
FR;2;2021-06-05;33799;24053;2497942;1151000
FR;2;2021-06-06;4726;6206;2502668;1157206
FR;2;2021-06-07;27480;23113;2530148;1180319
FR;2;2021-06-08;45788;23263;2575936;1203582
FR;2;2021-06-09;33010;21510;2608946;1225092
FR;2;2021-06-10;41030;19162;2649976;1244254
FR;2;2021-06-11;54162;25258;2704138;1269512
FR;2;2021-06-12;29731;19823;2733869;1289335
FR;2;2021-06-13;3094;9190;2736963;1298525
FR;2;2021-06-14;24569;24198;2761532;1322723
FR;2;2021-06-15;37999;22898;2799531;1345621
FR;2;2021-06-16;29312;21552;2828843;1367173
FR;2;2021-06-17;35806;25907;2864649;1393080
FR;2;2021-06-18;44883;28803;2909532;1421883
FR;3;2020-12-27;0;0;0;0
FR;3;2020-12-28;0;0;0;0
FR;3;2020-12-29;0;0;0;0
FR;3;2020-12-30;0;0;0;0
FR;3;2020-12-31;0;0;0;0
FR;3;2021-01-01;0;0;0;0
FR;3;2021-01-02;0;0;0;0
FR;3;2021-01-03;0;0;0;0
FR;3;2021-01-04;0;0;0;0
FR;3;2021-01-05;0;0;0;0
FR;3;2021-01-06;0;0;0;0
FR;3;2021-01-07;0;0;0;0
FR;3;2021-01-08;0;0;0;0
FR;3;2021-01-09;0;0;0;0
FR;3;2021-01-10;0;0;0;0
FR;3;2021-01-11;0;0;0;0
FR;3;2021-01-12;0;0;0;0
FR;3;2021-01-13;0;0;0;0
FR;3;2021-01-14;0;0;0;0
FR;3;2021-01-15;0;0;0;0
FR;3;2021-01-16;0;0;0;0
FR;3;2021-01-17;0;0;0;0
FR;3;2021-01-18;0;0;0;0
FR;3;2021-01-19;0;0;0;0
FR;3;2021-01-20;0;0;0;0
FR;3;2021-01-21;0;0;0;0
FR;3;2021-01-22;0;0;0;0
FR;3;2021-01-23;0;0;0;0
FR;3;2021-01-24;0;0;0;0
FR;3;2021-01-25;0;0;0;0
FR;3;2021-01-26;0;0;0;0
FR;3;2021-01-27;0;0;0;0
FR;3;2021-01-28;0;0;0;0
FR;3;2021-01-29;0;0;0;0
FR;3;2021-01-30;0;0;0;0
FR;3;2021-01-31;0;0;0;0
FR;3;2021-02-01;0;0;0;0
FR;3;2021-02-02;0;0;0;0
FR;3;2021-02-03;0;0;0;0
FR;3;2021-02-04;0;0;0;0
FR;3;2021-02-05;0;0;0;0
FR;3;2021-02-06;332;0;332;0
FR;3;2021-02-07;1348;0;1680;0
FR;3;2021-02-08;2635;0;4315;0
FR;3;2021-02-09;6644;0;10959;0
FR;3;2021-02-10;9240;0;20199;0
FR;3;2021-02-11;13364;0;33563;0
FR;3;2021-02-12;13051;0;46614;0
FR;3;2021-02-13;3517;0;50131;0
FR;3;2021-02-14;869;0;51000;0
FR;3;2021-02-15;10133;0;61133;0
FR;3;2021-02-16;12184;0;73317;0
FR;3;2021-02-17;10823;0;84140;0
FR;3;2021-02-18;14587;0;98727;0
FR;3;2021-02-19;14126;0;112853;0
FR;3;2021-02-20;3183;0;116036;0
FR;3;2021-02-21;544;0;116580;0
FR;3;2021-02-22;8922;0;125502;0
FR;3;2021-02-23;11119;0;136621;0
FR;3;2021-02-24;13914;0;150535;0
FR;3;2021-02-25;44428;0;194963;0
FR;3;2021-02-26;61449;0;256412;0
FR;3;2021-02-27;34486;8;290898;8
FR;3;2021-02-28;2347;0;293245;8
FR;3;2021-03-01;19954;9;313199;17
FR;3;2021-03-02;38370;14;351569;31
FR;3;2021-03-03;47950;18;399519;49
FR;3;2021-03-04;81288;23;480807;72
FR;3;2021-03-05;117160;60;597967;132
FR;3;2021-03-06;119391;51;717358;183
FR;3;2021-03-07;54657;28;772015;211
FR;3;2021-03-08;42155;20;814170;231
FR;3;2021-03-09;78147;31;892317;262
FR;3;2021-03-10;79976;39;972293;301
FR;3;2021-03-11;127360;49;1099653;350
FR;3;2021-03-12;181452;70;1281105;420
FR;3;2021-03-13;131185;56;1412290;476
FR;3;2021-03-14;13797;4;1426087;480
FR;3;2021-03-15;51517;37;1477604;517
FR;3;2021-03-16;940;13;1478544;530
FR;3;2021-03-17;671;6;1479215;536
FR;3;2021-03-18;1230;4;1480445;540
FR;3;2021-03-19;69804;36;1550249;576
FR;3;2021-03-20;64678;38;1614927;614
FR;3;2021-03-21;5519;4;1620446;618
FR;3;2021-03-22;36922;32;1657368;650
FR;3;2021-03-23;83817;50;1741185;700
FR;3;2021-03-24;90183;93;1831368;793
FR;3;2021-03-25;149114;115;1980482;908
FR;3;2021-03-26;164521;155;2145003;1063
FR;3;2021-03-27;67717;90;2212720;1153
FR;3;2021-03-28;6248;19;2218968;1172
FR;3;2021-03-29;53552;61;2272520;1233
FR;3;2021-03-30;92351;88;2364871;1321
FR;3;2021-03-31;62737;82;2427608;1403
FR;3;2021-04-01;85147;103;2512755;1506
FR;3;2021-04-02;86106;147;2598861;1653
FR;3;2021-04-03;35325;109;2634186;1762
FR;3;2021-04-04;3393;15;2637579;1777
FR;3;2021-04-05;4248;21;2641827;1798
FR;3;2021-04-06;29074;76;2670901;1874
FR;3;2021-04-07;31647;60;2702548;1934
FR;3;2021-04-08;77780;234;2780328;2168
FR;3;2021-04-09;160376;409;2940704;2577
FR;3;2021-04-10;74749;331;3015453;2908
FR;3;2021-04-11;7046;44;3022499;2952
FR;3;2021-04-12;50677;197;3073176;3149
FR;3;2021-04-13;85248;315;3158424;3464
FR;3;2021-04-14;66701;341;3225125;3805
FR;3;2021-04-15;91896;369;3317021;4174
FR;3;2021-04-16;111263;571;3428284;4745
FR;3;2021-04-17;52366;327;3480650;5072
FR;3;2021-04-18;9440;32;3490090;5104
FR;3;2021-04-19;24488;234;3514578;5338
FR;3;2021-04-20;44856;394;3559434;5732
FR;3;2021-04-21;38063;450;3597497;6182
FR;3;2021-04-22;53759;791;3651256;6973
FR;3;2021-04-23;69515;1019;3720771;7992
FR;3;2021-04-24;36535;976;3757306;8968
FR;3;2021-04-25;5911;154;3763217;9122
FR;3;2021-04-26;19110;662;3782327;9784
FR;3;2021-04-27;33724;1246;3816051;11030
FR;3;2021-04-28;28285;1925;3844336;12955
FR;3;2021-04-29;44578;5956;3888914;18911
FR;3;2021-04-30;54609;8932;3943523;27843
FR;3;2021-05-01;9182;1968;3952705;29811
FR;3;2021-05-02;2798;500;3955503;30311
FR;3;2021-05-03;12533;3881;3968036;34192
FR;3;2021-05-04;22455;8454;3990491;42646
FR;3;2021-05-05;18056;10574;4008547;53220
FR;3;2021-05-06;33880;20906;4042427;74126
FR;3;2021-05-07;43387;28410;4085814;102536
FR;3;2021-05-08;6357;8901;4092171;111437
FR;3;2021-05-09;1564;2655;4093735;114092
FR;3;2021-05-10;14426;12567;4108161;126659
FR;3;2021-05-11;26403;25738;4134564;152397
FR;3;2021-05-12;16711;27452;4151275;179849
FR;3;2021-05-13;2001;3480;4153276;183329
FR;3;2021-05-14;14065;25742;4167341;209071
FR;3;2021-05-15;6915;20735;4174256;229806
FR;3;2021-05-16;811;2679;4175067;232485
FR;3;2021-05-17;7509;19915;4182576;252400
FR;3;2021-05-18;12913;29634;4195489;282034
FR;3;2021-05-19;8800;31866;4204289;313900
FR;3;2021-05-20;12289;53220;4216578;367120
FR;3;2021-05-21;12247;65540;4228825;432660
FR;3;2021-05-22;4671;33300;4233496;465960
FR;3;2021-05-23;537;2665;4234033;468625
FR;3;2021-05-24;584;4920;4234617;473545
FR;3;2021-05-25;4985;45189;4239602;518734
FR;3;2021-05-26;4562;51055;4244164;569789
FR;3;2021-05-27;5941;77848;4250105;647637
FR;3;2021-05-28;7138;99104;4257243;746741
FR;3;2021-05-29;3069;60285;4260312;807026
FR;3;2021-05-30;380;8243;4260692;815269
FR;3;2021-05-31;2060;36000;4262752;851269
FR;3;2021-06-01;2973;64819;4265725;916088
FR;3;2021-06-02;2356;58361;4268081;974449
FR;3;2021-06-03;3181;87589;4271262;1062038
FR;3;2021-06-04;3848;105129;4275110;1167167
FR;3;2021-06-05;1767;52247;4276877;1219414
FR;3;2021-06-06;263;5400;4277140;1224814
FR;3;2021-06-07;1099;31186;4278239;1256000
FR;3;2021-06-08;2225;47885;4280464;1303885
FR;3;2021-06-09;1394;42455;4281858;1346340
FR;3;2021-06-10;1871;68014;4283729;1414354
FR;3;2021-06-11;2209;96813;4285938;1511167
FR;3;2021-06-12;1003;40841;4286941;1552008
FR;3;2021-06-13;138;3823;4287079;1555831
FR;3;2021-06-14;744;42671;4287823;1598502
FR;3;2021-06-15;1178;80696;4289001;1679198
FR;3;2021-06-16;1019;65787;4290020;1744985
FR;3;2021-06-17;1426;101860;4291446;1846845
FR;3;2021-06-18;1657;117932;4293103;1964777
FR;4;2020-12-27;0;0;0;0
FR;4;2020-12-28;0;0;0;0
FR;4;2020-12-29;0;0;0;0
FR;4;2020-12-30;0;0;0;0
FR;4;2020-12-31;0;0;0;0
FR;4;2021-01-01;0;0;0;0
FR;4;2021-01-02;0;0;0;0
FR;4;2021-01-03;0;0;0;0
FR;4;2021-01-04;0;0;0;0
FR;4;2021-01-05;0;0;0;0
FR;4;2021-01-06;0;0;0;0
FR;4;2021-01-07;0;0;0;0
FR;4;2021-01-08;0;0;0;0
FR;4;2021-01-09;0;0;0;0
FR;4;2021-01-10;0;0;0;0
FR;4;2021-01-11;0;0;0;0
FR;4;2021-01-12;0;0;0;0
FR;4;2021-01-13;0;0;0;0
FR;4;2021-01-14;0;0;0;0
FR;4;2021-01-15;0;0;0;0
FR;4;2021-01-16;0;0;0;0
FR;4;2021-01-17;0;0;0;0
FR;4;2021-01-18;0;0;0;0
FR;4;2021-01-19;0;0;0;0
FR;4;2021-01-20;0;0;0;0
FR;4;2021-01-21;0;0;0;0
FR;4;2021-01-22;0;0;0;0
FR;4;2021-01-23;0;0;0;0
FR;4;2021-01-24;0;0;0;0
FR;4;2021-01-25;0;0;0;0
FR;4;2021-01-26;0;0;0;0
FR;4;2021-01-27;0;0;0;0
FR;4;2021-01-28;0;0;0;0
FR;4;2021-01-29;0;0;0;0
FR;4;2021-01-30;0;0;0;0
FR;4;2021-01-31;0;0;0;0
FR;4;2021-02-01;0;0;0;0
FR;4;2021-02-02;0;0;0;0
FR;4;2021-02-03;0;0;0;0
FR;4;2021-02-04;0;0;0;0
FR;4;2021-02-05;0;0;0;0
FR;4;2021-02-06;0;0;0;0
FR;4;2021-02-07;0;0;0;0
FR;4;2021-02-08;0;0;0;0
FR;4;2021-02-09;0;0;0;0
FR;4;2021-02-10;0;0;0;0
FR;4;2021-02-11;0;0;0;0
FR;4;2021-02-12;0;0;0;0
FR;4;2021-02-13;0;0;0;0
FR;4;2021-02-14;0;0;0;0
FR;4;2021-02-15;0;0;0;0
FR;4;2021-02-16;0;0;0;0
FR;4;2021-02-17;0;0;0;0
FR;4;2021-02-18;0;0;0;0
FR;4;2021-02-19;0;0;0;0
FR;4;2021-02-20;0;0;0;0
FR;4;2021-02-21;0;0;0;0
FR;4;2021-02-22;0;0;0;0
FR;4;2021-02-23;0;0;0;0
FR;4;2021-02-24;0;0;0;0
FR;4;2021-02-25;0;0;0;0
FR;4;2021-02-26;0;0;0;0
FR;4;2021-02-27;0;0;0;0
FR;4;2021-02-28;0;0;0;0
FR;4;2021-03-01;0;0;0;0
FR;4;2021-03-02;0;0;0;0
FR;4;2021-03-03;0;0;0;0
FR;4;2021-03-04;0;0;0;0
FR;4;2021-03-05;0;0;0;0
FR;4;2021-03-06;0;0;0;0
FR;4;2021-03-07;0;0;0;0
FR;4;2021-03-08;0;0;0;0
FR;4;2021-03-09;0;0;0;0
FR;4;2021-03-10;0;0;0;0
FR;4;2021-03-11;0;0;0;0
FR;4;2021-03-12;0;0;0;0
FR;4;2021-03-13;0;0;0;0
FR;4;2021-03-14;0;0;0;0
FR;4;2021-03-15;0;0;0;0
FR;4;2021-03-16;0;0;0;0
FR;4;2021-03-17;0;0;0;0
FR;4;2021-03-18;0;0;0;0
FR;4;2021-03-19;0;0;0;0
FR;4;2021-03-20;0;0;0;0
FR;4;2021-03-21;0;0;0;0
FR;4;2021-03-22;0;0;0;0
FR;4;2021-03-23;0;0;0;0
FR;4;2021-03-24;0;0;0;0
FR;4;2021-03-25;0;0;0;0
FR;4;2021-03-26;0;0;0;0
FR;4;2021-03-27;0;0;0;0
FR;4;2021-03-28;0;0;0;0
FR;4;2021-03-29;0;0;0;0
FR;4;2021-03-30;0;0;0;0
FR;4;2021-03-31;0;0;0;0
FR;4;2021-04-01;0;0;0;0
FR;4;2021-04-02;0;0;0;0
FR;4;2021-04-03;0;0;0;0
FR;4;2021-04-04;0;0;0;0
FR;4;2021-04-05;0;0;0;0
FR;4;2021-04-06;0;0;0;0
FR;4;2021-04-07;0;0;0;0
FR;4;2021-04-08;0;0;0;0
FR;4;2021-04-09;0;1;0;1
FR;4;2021-04-10;0;0;0;1
FR;4;2021-04-11;0;0;0;1
FR;4;2021-04-12;0;0;0;1
FR;4;2021-04-13;0;0;0;1
FR;4;2021-04-14;0;0;0;1
FR;4;2021-04-15;0;0;0;1
FR;4;2021-04-16;0;0;0;1
FR;4;2021-04-17;0;0;0;1
FR;4;2021-04-18;0;0;0;1
FR;4;2021-04-19;0;0;0;1
FR;4;2021-04-20;0;0;0;1
FR;4;2021-04-21;0;0;0;1
FR;4;2021-04-22;0;0;0;1
FR;4;2021-04-23;793;0;793;1
FR;4;2021-04-24;1552;0;2345;1
FR;4;2021-04-25;117;0;2462;1
FR;4;2021-04-26;2830;0;5292;1
FR;4;2021-04-27;9387;4;14679;5
FR;4;2021-04-28;9774;3;24453;8
FR;4;2021-04-29;15886;7;40339;15
FR;4;2021-04-30;19083;7;59422;22
FR;4;2021-05-01;1897;5;61319;27
FR;4;2021-05-02;440;0;61759;27
FR;4;2021-05-03;4928;1;66687;28
FR;4;2021-05-04;8249;8;74936;36
FR;4;2021-05-05;6006;7;80942;43
FR;4;2021-05-06;11257;11;92199;54
FR;4;2021-05-07;18906;8;111105;62
FR;4;2021-05-08;2260;5;113365;67
FR;4;2021-05-09;629;2;113994;69
FR;4;2021-05-10;7094;8;121088;77
FR;4;2021-05-11;14119;12;135207;89
FR;4;2021-05-12;9956;14;145163;103
FR;4;2021-05-13;1441;2;146604;105
FR;4;2021-05-14;7597;8;154201;113
FR;4;2021-05-15;3587;9;157788;122
FR;4;2021-05-16;359;1;158147;123
FR;4;2021-05-17;4347;2;162494;125
FR;4;2021-05-18;8584;10;171078;135
FR;4;2021-05-19;5520;5;176598;140
FR;4;2021-05-20;9217;6;185815;146
FR;4;2021-05-21;12517;26;198332;172
FR;4;2021-05-22;4928;13;203260;185
FR;4;2021-05-23;424;2;203684;187
FR;4;2021-05-24;938;3;204622;190
FR;4;2021-05-25;7396;16;212018;206
FR;4;2021-05-26;7552;12;219570;218
FR;4;2021-05-27;14097;34;233667;252
FR;4;2021-05-28;26246;77;259913;329
FR;4;2021-05-29;11130;20;271043;349
FR;4;2021-05-30;858;2;271901;351
FR;4;2021-05-31;12429;19;284330;370
FR;4;2021-06-01;19813;42;304143;412
FR;4;2021-06-02;14203;34;318346;446
FR;4;2021-06-03;19141;23;337487;469
FR;4;2021-06-04;22081;45;359568;514
FR;4;2021-06-05;9442;28;369010;542
FR;4;2021-06-06;917;0;369927;542
FR;4;2021-06-07;8891;16;378818;558
FR;4;2021-06-08;14235;49;393053;607
FR;4;2021-06-09;11507;423;404560;1030
FR;4;2021-06-10;14933;28;419493;1058
FR;4;2021-06-11;16541;53;436034;1111
FR;4;2021-06-12;7167;26;443201;1137
FR;4;2021-06-13;812;8;444013;1145
FR;4;2021-06-14;6377;22;450390;1167
FR;4;2021-06-15;10493;32;460883;1199
FR;4;2021-06-16;8499;13;469382;1212
FR;4;2021-06-17;10417;26;479799;1238
FR;4;2021-06-18;11667;36;491466;1274
FR;0;2020-12-27;20;0;20;0
FR;0;2020-12-28;71;0;91;0
FR;0;2020-12-29;108;0;199;0
FR;0;2020-12-30;123;0;322;0
FR;0;2020-12-31;88;0;410;0
FR;0;2021-01-01;74;0;484;0
FR;0;2021-01-02;88;0;572;0
FR;0;2021-01-03;92;0;664;0
FR;0;2021-01-04;1479;0;2143;0
FR;0;2021-01-05;5415;0;7558;0
FR;0;2021-01-06;11323;0;18881;0
FR;0;2021-01-07;28582;0;47463;0
FR;0;2021-01-08;36298;0;83761;0
FR;0;2021-01-09;10942;0;94703;0
FR;0;2021-01-10;5639;0;100342;0
FR;0;2021-01-11;39121;0;139463;0
FR;0;2021-01-12;61010;0;200473;0
FR;0;2021-01-13;63942;0;264415;0
FR;0;2021-01-14;80023;0;344438;0
FR;0;2021-01-15;67596;0;412034;0
FR;0;2021-01-16;19749;87;431783;87
FR;0;2021-01-17;10478;42;442261;129
FR;0;2021-01-18;84499;164;526760;293
FR;0;2021-01-19;128563;128;655323;421
FR;0;2021-01-20;135384;160;790707;581
FR;0;2021-01-21;155589;141;946296;722
FR;0;2021-01-22;118829;163;1065125;885
FR;0;2021-01-23;37862;52;1102987;937
FR;0;2021-01-24;9372;28;1112359;965
FR;0;2021-01-25;76941;1219;1189300;2184
FR;0;2021-01-26;98932;3113;1288232;5297
FR;0;2021-01-27;105746;5599;1393978;10896
FR;0;2021-01-28;122483;14361;1516461;25257
FR;0;2021-01-29;90970;17293;1607431;42550
FR;0;2021-01-30;28682;4225;1636113;46775
FR;0;2021-01-31;4872;1679;1640985;48454
FR;0;2021-02-01;51634;21128;1692619;69582
FR;0;2021-02-02;70761;34568;1763380;104150
FR;0;2021-02-03;71064;36961;1834444;141111
FR;0;2021-02-04;80697;50063;1915141;191174
FR;0;2021-02-05;67218;45343;1982359;236517
FR;0;2021-02-06;21353;10399;2003712;246916
FR;0;2021-02-07;4826;5041;2008538;251957
FR;0;2021-02-08;45947;45994;2054485;297951
FR;0;2021-02-09;64872;72408;2119357;370359
FR;0;2021-02-10;69361;76695;2188718;447054
FR;0;2021-02-11;85730;99144;2274448;546198
FR;0;2021-02-12;77845;74276;2352293;620474
FR;0;2021-02-13;21720;19492;2374013;639966
FR;0;2021-02-14;4596;7190;2378609;647156
FR;0;2021-02-15;37094;76507;2415703;723663
FR;0;2021-02-16;49240;100746;2464943;824409
FR;0;2021-02-17;49346;102972;2514289;927381
FR;0;2021-02-18;68105;118562;2582394;1045943
FR;0;2021-02-19;63876;90737;2646270;1136680
FR;0;2021-02-20;18016;28429;2664286;1165109
FR;0;2021-02-21;2860;6373;2667146;1171482
FR;0;2021-02-22;36578;73138;2703724;1244620
FR;0;2021-02-23;52705;84059;2756429;1328679
FR;0;2021-02-24;58172;81130;2814601;1409809
FR;0;2021-02-25;98834;91420;2913435;1501229
FR;0;2021-02-26;111863;71013;3025298;1572242
FR;0;2021-02-27;51235;21981;3076533;1594223
FR;0;2021-02-28;5680;4414;3082213;1598637
FR;0;2021-03-01;63713;52804;3145926;1651441
FR;0;2021-03-02;99458;66247;3245384;1717688
FR;0;2021-03-03;113875;65554;3359259;1783242
FR;0;2021-03-04;160726;68884;3519985;1852126
FR;0;2021-03-05;198249;63395;3718234;1915521
FR;0;2021-03-06;205479;17827;3923713;1933348
FR;0;2021-03-07;119944;5481;4043657;1938829
FR;0;2021-03-08;105051;50811;4148708;1989640
FR;0;2021-03-09;169998;56778;4318706;2046418
FR;0;2021-03-10;176029;57215;4494735;2103633
FR;0;2021-03-11;239864;63123;4734599;2166756
FR;0;2021-03-12;291504;53510;5026103;2220266
FR;0;2021-03-13;228945;15289;5255048;2235555
FR;0;2021-03-14;62302;3437;5317350;2238992
FR;0;2021-03-15;156201;32674;5473551;2271666
FR;0;2021-03-16;139502;39542;5613053;2311208
FR;0;2021-03-17;148279;38827;5761332;2350035
FR;0;2021-03-18;165376;44670;5926708;2394705
FR;0;2021-03-19;227181;37488;6153889;2432193
FR;0;2021-03-20;164903;11790;6318792;2443983
FR;0;2021-03-21;48770;2628;6367562;2446611
FR;0;2021-03-22;167418;34301;6534980;2480912
FR;0;2021-03-23;247242;42409;6782222;2523321
FR;0;2021-03-24;253791;43872;7036013;2567193
FR;0;2021-03-25;338370;44757;7374383;2611950
FR;0;2021-03-26;355580;41917;7729963;2653867
FR;0;2021-03-27;193319;16659;7923282;2670526
FR;0;2021-03-28;58383;3737;7981665;2674263
FR;0;2021-03-29;200651;54311;8182316;2728574
FR;0;2021-03-30;282317;69690;8464633;2798264
FR;0;2021-03-31;259892;72956;8724525;2871220
FR;0;2021-04-01;310553;87855;9035078;2959075
FR;0;2021-04-02;278116;92128;9313194;3051203
FR;0;2021-04-03;139260;61879;9452454;3113082
FR;0;2021-04-04;44896;18666;9497350;3131748
FR;0;2021-04-05;58805;11010;9556155;3142758
FR;0;2021-04-06;213676;107900;9769831;3250658
FR;0;2021-04-07;256539;115506;10026370;3366164
FR;0;2021-04-08;333165;121458;10359535;3487622
FR;0;2021-04-09;405499;116532;10765034;3604154
FR;0;2021-04-10;210193;82765;10975227;3686919
FR;0;2021-04-11;54906;34604;11030133;3721523
FR;0;2021-04-12;234016;115249;11264149;3836772
FR;0;2021-04-13;305509;145004;11569658;3981776
FR;0;2021-04-14;289900;139446;11859558;4121222
FR;0;2021-04-15;332083;147892;12191641;4269114
FR;0;2021-04-16;335522;145799;12527163;4414913
FR;0;2021-04-17;186383;90279;12713546;4505192
FR;0;2021-04-18;50449;35434;12763995;4540626
FR;0;2021-04-19;202868;138432;12966863;4679058
FR;0;2021-04-20;250974;170793;13217837;4849851
FR;0;2021-04-21;249489;168876;13467326;5018727
FR;0;2021-04-22;283562;188306;13750888;5207033
FR;0;2021-04-23;291195;183311;14042083;5390344
FR;0;2021-04-24;188196;111607;14230279;5501951
FR;0;2021-04-25;68401;38887;14298680;5540838
FR;0;2021-04-26;218083;156140;14516763;5696978
FR;0;2021-04-27;281156;187568;14797919;5884546
FR;0;2021-04-28;296220;183258;15094139;6067804
FR;0;2021-04-29;353203;196193;15447342;6263997
FR;0;2021-04-30;368312;184904;15815654;6448901
FR;0;2021-05-01;164074;52555;15979728;6501456
FR;0;2021-05-02;90192;37849;16069920;6539305
FR;0;2021-05-03;284276;169759;16354196;6709064
FR;0;2021-05-04;311252;224397;16665448;6933461
FR;0;2021-05-05;321105;224598;16986553;7158059
FR;0;2021-05-06;373899;239283;17360452;7397342
FR;0;2021-05-07;367828;257424;17728280;7654766
FR;0;2021-05-08;214543;66950;17942823;7721716
FR;0;2021-05-09;128035;46785;18070858;7768501
FR;0;2021-05-10;305781;229091;18376639;7997592
FR;0;2021-05-11;397212;258286;18773851;8255878
FR;0;2021-05-12;424121;233333;19197972;8489211
FR;0;2021-05-13;331826;56937;19529798;8546148
FR;0;2021-05-14;446344;167653;19976142;8713801
FR;0;2021-05-15;367719;94076;20343861;8807877
FR;0;2021-05-16;199587;20844;20543448;8828721
FR;0;2021-05-17;369694;149257;20913142;8977978
FR;0;2021-05-18;448853;153316;21361995;9131294
FR;0;2021-05-19;458942;145527;21820937;9276821
FR;0;2021-05-20;497333;160548;22318270;9437369
FR;0;2021-05-21;480380;174789;22798650;9612158
FR;0;2021-05-22;341918;80032;23140568;9692190
FR;0;2021-05-23;158979;14500;23299547;9706690
FR;0;2021-05-24;257365;33350;23556912;9740040
FR;0;2021-05-25;391622;189532;23948534;9929572
FR;0;2021-05-26;401654;188406;24350188;10117978
FR;0;2021-05-27;441534;219010;24791722;10336988
FR;0;2021-05-28;421769;259917;25213491;10596905
FR;0;2021-05-29;294527;149588;25508018;10746493
FR;0;2021-05-30;104789;32675;25612807;10779168
FR;0;2021-05-31;351703;203753;25964510;10982921
FR;0;2021-06-01;413154;251917;26377664;11234838
FR;0;2021-06-02;400608;231214;26778272;11466052
FR;0;2021-06-03;450874;258962;27229146;11725014
FR;0;2021-06-04;441808;305106;27670954;12030120
FR;0;2021-06-05;298171;189215;27969125;12219335
FR;0;2021-06-06;129080;49178;28098205;12268513
FR;0;2021-06-07;328177;262693;28426382;12531206
FR;0;2021-06-08;386734;295491;28813116;12826697
FR;0;2021-06-09;368697;281124;29181813;13107821
FR;0;2021-06-10;385484;289745;29567297;13397566
FR;0;2021-06-11;374577;357820;29941874;13755386
FR;0;2021-06-12;275766;211676;30217640;13967062
FR;0;2021-06-13;101503;74155;30319143;14041217
FR;0;2021-06-14;229642;356230;30548785;14397447
FR;0;2021-06-15;294086;386393;30842871;14783840
FR;0;2021-06-16;302499;358131;31145370;15141971
FR;0;2021-06-17;306112;372493;31451482;15514464
FR;0;2021-06-18;305805;443114;31757287;15957578
